county,time,date,cases,est_cases,est_omicron_cases,est_other_cases,tests,est_tests,est_omicron_tests,est_other_tests,hospitalizations,deaths,est_deaths,icu,cum_deaths,cum_est_deaths,prev_cum_deaths,prev_cum_est_deaths
Alameda,1,2021-12-22,4292,4295,2127,2168,93655,93735,45970,47765,51,12,12,16,1549,1549,1537,1537
Amador,1,2021-12-22,63,63,24,39,1664,1664,620,1044,4,0,0,2,70,70,70,70
Butte,1,2021-12-22,262,262,144,118,4370,4373,2377,1996,23,5,5,5,361,361,356,356
Calaveras,1,2021-12-22,63,63,26,37,1240,1240,502,738,1,1,1,0,93,93,92,92
Colusa,1,2021-12-22,9,9,4,5,388,388,173,215,2,0,0,0,21,21,21,21
Contra Costa,1,2021-12-22,2514,2515,926,1589,46140,46181,16827,29354,29,2,2,11,1081,1081,1079,1079
Del Norte,1,2021-12-22,15,15,6,9,1366,1366,591,775,0,0,0,0,42,42,42,42
El Dorado,1,2021-12-22,305,305,125,180,4813,4818,1960,2858,8,3,3,2,178,178,175,175
Fresno,1,2021-12-22,1263,1263,480,783,25071,25092,9464,15628,110,19,19,47,2424,2424,2405,2405
Glenn,1,2021-12-22,35,35,15,20,499,499,208,291,0,0,0,0,38,38,38,38
Humboldt,1,2021-12-22,229,229,99,130,3937,3941,1681,2260,7,1,1,1,120,120,119,119
Imperial,1,2021-12-22,643,643,259,384,5732,5737,2303,3434,34,7,7,28,818,818,811,811
Inyo,1,2021-12-22,43,43,19,24,418,418,188,230,2,1,1,0,49,49,48,48
Kern,1,2021-12-22,1072,1072,485,587,24163,24184,10839,13345,78,22,22,27,2029,2029,2007,2007
Kings,1,2021-12-22,265,265,108,157,6238,6243,2519,3724,18,4,4,3,387,387,383,383
Lake,1,2021-12-22,36,36,13,23,1330,1330,498,832,0,0,0,0,116,116,116,116
Lassen,1,2021-12-22,13,13,6,7,2405,2405,1136,1269,1,0,0,0,54,54,54,54
Los Angeles,1,2021-12-22,50524,50566,36073,14493,870988,871725,614503,257222,627,105,105,174,27398,27398,27293,27293
Madera,1,2021-12-22,169,169,64,105,5035,5040,1875,3165,8,1,1,7,333,333,332,332
Marin,1,2021-12-22,843,843,328,515,13812,13823,5313,8510,7,1,1,1,256,256,255,255
Mariposa,1,2021-12-22,26,26,10,16,549,549,201,348,0,0,0,0,21,21,21,21
Mendocino,1,2021-12-22,78,78,25,53,2944,2945,922,2023,2,1,1,1,104,104,103,103
Merced,1,2021-12-22,366,366,163,203,5389,5394,2384,3010,10,8,8,10,696,696,688,688
Modoc,1,2021-12-22,5,5,2,3,66,66,30,36,3,0,0,0,6,6,6,6
Mono,1,2021-12-22,65,65,18,47,456,456,128,328,1,0,0,0,4,4,4,4
Monterey,1,2021-12-22,530,530,147,383,13617,13629,3757,9872,19,2,2,8,643,643,641,641
Napa,1,2021-12-22,373,373,180,193,5486,5491,2615,2876,2,0,0,1,108,108,108,108
Nevada,1,2021-12-22,185,185,70,115,2938,2940,1118,1822,3,1,1,3,111,111,110,110
Orange,1,2021-12-22,7573,7579,3905,3674,109357,109451,55765,53686,159,30,30,58,6003,6003,5973,5973
Placer,1,2021-12-22,682,682,245,437,11356,11366,4055,7311,49,5,5,24,501,501,496,496
Plumas,1,2021-12-22,11,11,4,7,478,478,191,287,0,0,0,0,12,12,12,12
Riverside,1,2021-12-22,7497,7505,3292,4213,82892,82962,36121,46841,288,36,36,81,5587,5587,5551,5551
Sacramento,1,2021-12-22,2776,2777,1168,1609,54183,54229,22588,31641,121,23,23,39,2500,2500,2477,2477
San Benito,1,2021-12-22,147,147,70,77,2098,2098,987,1111,0,4,4,2,82,82,78,78
San Bernardino,1,2021-12-22,6999,7004,3458,3546,86616,86691,42468,44223,296,70,70,124,6526,6526,6456,6456
San Diego,1,2021-12-22,13684,13696,9616,4080,166950,167091,116630,50461,259,29,29,96,4488,4488,4459,4459
San Francisco,1,2021-12-22,4416,4419,1159,3260,64887,64942,16830,48112,25,3,3,12,692,692,689,689
San Joaquin,1,2021-12-22,1229,1229,488,741,23274,23293,9161,14132,39,14,14,22,1977,1977,1963,1963
San Luis Obispo,1,2021-12-22,591,591,273,318,10817,10825,4961,5864,15,2,2,6,371,371,369,369
San Mateo,1,2021-12-22,2399,2400,1235,1165,52073,52118,26506,25612,12,1,1,4,601,601,600,600
Santa Barbara,1,2021-12-22,1038,1038,449,589,15810,15825,6782,9043,17,6,6,13,570,570,564,564
Santa Clara,1,2021-12-22,4341,4344,2992,1352,113781,113878,77743,36135,65,8,8,42,1980,1980,1972,1972
Santa Cruz,1,2021-12-22,481,481,227,254,18040,18055,8385,9670,13,1,1,3,230,230,229,229
Shasta,1,2021-12-22,167,167,70,97,5474,5479,2303,3176,26,6,6,8,449,449,443,443
Siskiyou,1,2021-12-22,13,13,6,7,351,351,170,181,0,2,2,0,63,63,61,61
Solano,1,2021-12-22,657,657,288,369,14986,15001,6531,8470,23,2,2,6,388,388,386,386
Sonoma,1,2021-12-22,985,985,438,547,20618,20635,9102,11533,20,1,1,5,419,419,418,418
Stanislaus,1,2021-12-22,749,749,248,501,11818,11829,3902,7927,81,18,18,23,1439,1439,1421,1421
Sutter,1,2021-12-22,150,150,65,85,2186,2186,940,1246,0,0,0,0,193,193,193,193
Tehama,1,2021-12-22,52,52,18,34,1298,1298,443,855,10,0,0,2,165,165,165,165
Trinity,1,2021-12-22,2,2,1,1,104,104,35,69,0,1,1,0,19,19,18,18
Tulare,1,2021-12-22,461,461,152,309,11879,11891,3882,8009,33,18,18,10,1312,1312,1294,1294
Tuolumne,1,2021-12-22,111,111,42,69,1953,1953,737,1216,8,0,0,0,153,153,153,153
Ventura,1,2021-12-22,2722,2723,1452,1271,38375,38407,20304,18103,57,11,11,14,1219,1219,1208,1208
Yolo,1,2021-12-22,435,435,203,232,25935,25956,11974,13982,4,0,0,3,270,270,270,270
Yuba,1,2021-12-22,99,99,44,55,1836,1836,818,1018,3,0,0,5,101,101,101,101
Alameda,2,2021-12-29,11284,11296,6315,4981,92677,92767,51524,41243,100,9,9,19,1558,1558,1549,1549
Amador,2,2021-12-29,116,116,50,66,1588,1588,693,895,4,1,1,2,71,71,70,70
Butte,2,2021-12-29,697,697,424,273,5032,5036,3058,1978,37,1,1,3,362,362,361,361
Calaveras,2,2021-12-29,121,121,57,64,1017,1017,479,538,1,0,0,1,93,93,93,93
Colusa,2,2021-12-29,41,41,21,20,278,278,145,133,2,0,0,0,21,21,21,21
Contra Costa,2,2021-12-29,8436,8444,3637,4807,53069,53120,22678,30442,51,5,5,20,1086,1086,1081,1081
Del Norte,2,2021-12-29,37,37,18,19,1684,1684,840,844,0,0,0,1,42,42,42,42
El Dorado,2,2021-12-29,770,770,365,405,4654,4658,2201,2457,7,3,3,5,181,181,178,178
Fresno,2,2021-12-29,3707,3710,1653,2057,29358,29387,12992,16395,127,17,17,45,2441,2441,2424,2424
Glenn,2,2021-12-29,66,66,32,34,479,479,231,248,0,0,0,0,38,38,38,38
Humboldt,2,2021-12-29,629,629,309,320,3918,3921,1941,1980,10,1,1,1,121,121,120,120
Imperial,2,2021-12-29,1204,1204,565,639,7127,7134,3331,3803,33,11,11,28,829,829,818,818
Inyo,2,2021-12-29,182,182,94,88,509,509,261,248,0,1,1,0,50,50,49,49
Kern,2,2021-12-29,2951,2954,1537,1417,26195,26220,13567,12653,82,15,15,33,2044,2044,2029,2029
Kings,2,2021-12-29,688,688,324,364,6434,6439,3027,3412,19,1,1,3,388,388,387,387
Lake,2,2021-12-29,99,99,43,56,1229,1229,537,692,0,1,1,0,117,117,116,116
Lassen,2,2021-12-29,32,32,17,15,2593,2593,1391,1202,1,0,0,0,54,54,54,54
Los Angeles,2,2021-12-29,139229,139365,106116,33249,800233,801010,608438,192572,1155,125,125,217,27523,27523,27398,27398
Madera,2,2021-12-29,521,521,230,291,5175,5179,2272,2907,6,1,1,1,334,334,333,333
Marin,2,2021-12-29,2022,2022,903,1119,18158,18175,8075,10100,9,1,1,0,257,257,256,256
Mariposa,2,2021-12-29,52,52,22,30,481,481,204,277,0,0,0,0,21,21,21,21
Mendocino,2,2021-12-29,251,251,94,157,2721,2724,1017,1707,6,0,0,1,104,104,104,104
Merced,2,2021-12-29,992,992,507,485,6374,6380,3251,3129,11,5,5,11,701,701,696,696
Modoc,2,2021-12-29,3,3,2,1,46,46,24,22,0,0,0,0,6,6,6,6
Mono,2,2021-12-29,167,167,56,111,357,357,120,237,0,0,0,0,4,4,4,4
Monterey,2,2021-12-29,1501,1501,499,1002,14623,14636,4849,9787,17,3,3,11,646,646,643,643
Napa,2,2021-12-29,1214,1214,659,555,8517,8525,4617,3908,6,0,0,1,108,108,108,108
Nevada,2,2021-12-29,327,327,146,181,1821,1822,805,1017,3,0,0,1,111,111,111,111
Orange,2,2021-12-29,29372,29401,16996,12405,165523,165684,95356,70328,334,32,32,86,6035,6035,6003,6003
Placer,2,2021-12-29,1806,1806,760,1046,12449,12462,5232,7230,69,4,4,27,505,505,501,501
Plumas,2,2021-12-29,20,20,9,11,317,317,147,170,2,0,0,0,12,12,12,12
Riverside,2,2021-12-29,20331,20351,10245,10106,107051,107155,53773,53382,347,60,60,85,5647,5647,5587,5587
Sacramento,2,2021-12-29,8280,8288,4029,4259,61440,61499,29694,31805,153,22,22,42,2522,2522,2500,2500
San Benito,2,2021-12-29,497,497,267,230,2741,2744,1469,1275,1,3,3,3,85,85,82,82
San Bernardino,2,2021-12-29,23029,23052,12871,10181,105923,106026,58963,47063,425,72,72,141,6598,6598,6526,6526
San Diego,2,2021-12-29,41058,41099,30912,10187,200579,200774,150504,50270,364,32,32,111,4520,4520,4488,4488
San Francisco,2,2021-12-29,8206,8215,2557,5658,68754,68821,21347,47474,54,2,2,11,694,694,692,692
San Joaquin,2,2021-12-29,3808,3811,1762,2049,27031,27057,12421,14636,72,11,11,25,1988,1988,1977,1977
San Luis Obispo,2,2021-12-29,1785,1785,940,845,13067,13080,6856,6224,21,1,1,7,372,372,371,371
San Mateo,2,2021-12-29,7151,7159,4109,3050,61133,61192,34988,26204,22,1,1,6,602,602,601,601
Santa Barbara,2,2021-12-29,3132,3135,1555,1580,18027,18045,8934,9111,42,7,7,8,577,577,570,570
Santa Clara,2,2021-12-29,13136,13149,9725,3424,118613,118728,87597,31131,114,11,11,48,1991,1991,1980,1980
Santa Cruz,2,2021-12-29,1409,1409,756,653,13611,13625,7330,6295,10,1,1,2,231,231,230,230
Shasta,2,2021-12-29,340,340,165,175,4972,4976,2425,2551,27,4,4,15,453,453,449,449
Siskiyou,2,2021-12-29,37,37,20,17,404,404,221,183,0,0,0,0,63,63,63,63
Solano,2,2021-12-29,2662,2664,1349,1315,21901,21921,10974,10947,42,6,6,6,394,394,388,388
Sonoma,2,2021-12-29,2935,2937,1495,1442,25037,25060,12700,12360,20,2,2,4,421,421,419,419
Stanislaus,2,2021-12-29,1906,1906,751,1155,13652,13665,5368,8297,92,11,11,18,1450,1450,1439,1439
Sutter,2,2021-12-29,284,284,141,143,2343,2344,1160,1184,0,2,2,0,195,195,193,193
Tehama,2,2021-12-29,119,119,48,71,1110,1110,448,662,3,2,2,3,167,167,165,165
Trinity,2,2021-12-29,5,5,2,3,93,93,37,56,0,0,0,0,19,19,19,19
Tulare,2,2021-12-29,1169,1169,455,714,12842,12854,4989,7865,34,8,8,9,1320,1320,1312,1312
Tuolumne,2,2021-12-29,212,212,93,119,1735,1735,763,972,7,0,0,1,153,153,153,153
Ventura,2,2021-12-29,8786,8794,5248,3546,47661,47707,28385,19322,78,6,6,19,1225,1225,1219,1219
Yolo,2,2021-12-29,1246,1246,662,584,24339,24363,12921,11442,10,0,0,1,270,270,270,270
Yuba,2,2021-12-29,248,248,128,120,1713,1713,879,834,0,1,1,67,102,102,101,101
Alameda,3,2022-01-05,23140,23164,14305,8859,145026,145180,89574,55606,180,6,6,38,1564,1564,1558,1558
Amador,3,2022-01-05,299,299,149,150,2545,2548,1264,1284,5,0,0,2,71,71,71,71
Butte,3,2022-01-05,1520,1520,1010,510,8391,8400,5583,2817,44,0,0,4,362,362,362,362
Calaveras,3,2022-01-05,325,325,173,152,1908,1909,1023,886,1,2,2,2,95,95,93,93
Colusa,3,2022-01-05,57,57,33,24,520,520,302,218,5,0,0,0,21,21,21,21
Contra Costa,3,2022-01-05,15730,15747,7689,8058,80348,80433,39299,41134,98,9,9,25,1095,1095,1086,1086
Del Norte,3,2022-01-05,123,123,69,54,2211,2212,1231,981,0,0,0,0,42,42,42,42
El Dorado,3,2022-01-05,1651,1651,882,769,7128,7136,3811,3325,10,5,5,5,186,186,181,181
Fresno,3,2022-01-05,8507,8516,4299,4217,45514,45562,22901,22661,216,16,16,36,2457,2457,2441,2441
Glenn,3,2022-01-05,101,101,55,46,707,707,384,323,3,1,1,0,39,39,38,38
Humboldt,3,2022-01-05,1102,1102,612,490,6325,6332,3516,2816,16,2,2,2,123,123,121,121
Imperial,3,2022-01-05,2571,2574,1368,1206,11138,11151,5901,5250,39,18,18,25,847,847,829,829
Inyo,3,2022-01-05,330,330,190,140,959,959,553,406,4,1,1,0,51,51,50,50
Kern,3,2022-01-05,8385,8395,4876,3519,44584,44630,25880,18750,119,16,16,32,2060,2060,2044,2044
Kings,3,2022-01-05,1456,1456,776,680,9797,9808,5211,4597,20,3,3,3,391,391,388,388
Lake,3,2022-01-05,321,321,160,161,2185,2187,1090,1097,3,0,0,1,117,117,117,117
Lassen,3,2022-01-05,87,87,52,35,3092,3094,1846,1248,2,0,0,0,54,54,54,54
Los Angeles,3,2022-01-05,256155,256426,205848,50578,1397718,1399195,1123846,275349,2309,181,181,352,27704,27704,27523,27523
Madera,3,2022-01-05,1221,1221,615,606,8026,8035,4031,4004,19,4,4,7,338,338,334,334
Marin,3,2022-01-05,2641,2644,1344,1300,18114,18133,9202,8931,17,0,0,3,257,257,257,257
Mariposa,3,2022-01-05,155,155,76,79,829,829,405,424,0,1,1,0,22,22,21,21
Mendocino,3,2022-01-05,596,596,258,338,4356,4360,1892,2468,6,1,1,2,105,105,104,104
Merced,3,2022-01-05,2300,2303,1321,982,10644,10656,6086,4570,24,13,13,9,714,714,701,701
Modoc,3,2022-01-05,19,19,11,8,81,81,48,33,0,0,0,0,6,6,6,6
Mono,3,2022-01-05,221,221,86,135,628,628,248,380,3,1,1,0,5,5,4,4
Monterey,3,2022-01-05,3342,3345,1302,2043,25669,25695,9980,15715,46,5,5,11,651,651,646,646
Napa,3,2022-01-05,2284,2287,1376,911,13010,13023,7815,5208,10,2,2,2,110,110,108,108
Nevada,3,2022-01-05,808,808,408,400,3925,3929,1986,1943,9,2,2,4,113,113,111,111
Orange,3,2022-01-05,52280,52336,33123,19213,256120,256390,162388,94002,615,57,57,109,6092,6092,6035,6035
Placer,3,2022-01-05,3684,3688,1774,1914,17140,17158,8244,8914,129,15,15,22,520,520,505,505
Plumas,3,2022-01-05,95,95,50,45,630,630,330,300,3,0,0,0,12,12,12,12
Riverside,3,2022-01-05,39201,39243,22076,17167,154410,154573,86848,67725,649,60,60,123,5707,5707,5647,5647
Sacramento,3,2022-01-05,19956,19976,10920,9056,97807,97912,53313,44599,242,30,30,65,2552,2552,2522,2522
San Benito,3,2022-01-05,823,823,489,334,3618,3622,2152,1470,4,0,0,2,85,85,85,85
San Bernardino,3,2022-01-05,40051,40094,24670,15424,151980,152140,93527,58613,645,97,97,169,6695,6695,6598,6598
San Diego,3,2022-01-05,72589,72665,57644,15021,289314,289620,229659,59961,627,37,37,147,4557,4557,4520,4520
San Francisco,3,2022-01-05,13717,13731,5043,8688,98584,98688,36211,62477,108,7,7,22,701,701,694,694
San Joaquin,3,2022-01-05,9727,9738,5083,4655,46870,46920,24457,22463,97,16,16,26,2004,2004,1988,1988
San Luis Obispo,3,2022-01-05,3176,3179,1865,1314,17546,17564,10259,7305,23,6,6,6,378,378,372,372
San Mateo,3,2022-01-05,12613,12627,7978,4649,94206,94304,59615,34689,59,6,6,7,608,608,602,602
Santa Barbara,3,2022-01-05,6876,6884,3831,3053,35631,35669,19856,15813,55,4,4,8,581,581,577,577
Santa Clara,3,2022-01-05,28473,28502,22327,6175,202681,202895,159050,43845,240,12,12,65,2003,2003,1991,1991
Santa Cruz,3,2022-01-05,3312,3315,1981,1334,28690,28719,17210,11509,15,4,4,2,235,235,231,231
Shasta,3,2022-01-05,789,789,431,358,6830,6837,3746,3091,34,4,4,14,457,457,453,453
Siskiyou,3,2022-01-05,98,98,59,39,761,761,463,298,1,1,1,1,64,64,63,63
Solano,3,2022-01-05,5027,5031,2835,2196,28983,29015,16298,12717,64,3,3,9,397,397,394,394
Sonoma,3,2022-01-05,6509,6515,3720,2795,38074,38114,21677,16437,36,9,9,3,430,430,421,421
Stanislaus,3,2022-01-05,4447,4451,2016,2435,21638,21661,9803,11858,139,10,10,14,1460,1460,1450,1450
Sutter,3,2022-01-05,753,753,420,333,3739,3743,2088,1655,0,3,3,0,198,198,195,195
Tehama,3,2022-01-05,332,332,154,178,1845,1846,860,986,7,1,1,3,168,168,167,167
Trinity,3,2022-01-05,21,21,10,11,178,178,82,96,0,0,0,0,19,19,19,19
Tulare,3,2022-01-05,3069,3072,1382,1690,18280,18299,8192,10107,54,6,6,9,1326,1326,1320,1320
Tuolumne,3,2022-01-05,552,552,278,274,3190,3193,1610,1583,10,3,3,1,156,156,153,153
Ventura,3,2022-01-05,14702,14716,9590,5126,70345,70419,45942,24477,153,11,11,29,1236,1236,1225,1225
Yolo,3,2022-01-05,3032,3035,1792,1243,37156,37195,21995,15200,9,3,3,3,273,273,270,270
Yuba,3,2022-01-05,668,668,385,283,2926,2929,1684,1245,15,1,1,6,103,103,102,102
Alameda,4,2022-01-12,29034,29066,19405,9661,190123,190333,127212,63121,325,18,18,46,1582,1582,1564,1564
Amador,4,2022-01-12,449,449,250,199,3552,3555,1990,1565,6,1,1,2,72,72,71,71
Butte,4,2022-01-12,2140,2140,1529,611,10474,10485,7491,2994,59,3,3,5,365,365,362,362
Calaveras,4,2022-01-12,614,614,363,251,2670,2673,1582,1091,0,0,0,2,95,95,95,95
Colusa,4,2022-01-12,133,133,84,49,783,783,496,287,2,0,0,0,21,21,21,21
Contra Costa,4,2022-01-12,18815,18835,10254,8581,100312,100424,54747,45677,178,16,16,27,1111,1111,1095,1095
Del Norte,4,2022-01-12,182,182,112,70,5235,5241,3223,2018,3,0,0,0,42,42,42,42
El Dorado,4,2022-01-12,2346,2347,1386,961,9472,9483,5599,3884,13,3,3,1,189,189,186,186
Fresno,4,2022-01-12,15084,15099,8494,6605,64662,64734,36344,28390,313,13,13,60,2470,2470,2457,2457
Glenn,4,2022-01-12,282,282,169,113,1048,1048,628,420,2,0,0,0,39,39,39,39
Humboldt,4,2022-01-12,1405,1405,857,548,8994,9005,5505,3500,15,4,4,5,127,127,123,123
Imperial,4,2022-01-12,3723,3728,2185,1543,14201,14218,8331,5887,63,7,7,24,854,854,847,847
Inyo,4,2022-01-12,409,409,258,151,1357,1357,854,503,4,1,1,0,52,52,51,51
Kern,4,2022-01-12,12865,12880,8184,4696,59956,60022,38133,21889,201,29,29,38,2089,2089,2060,2060
Kings,4,2022-01-12,2974,2977,1763,1214,14880,14896,8814,6082,37,2,2,2,393,393,391,391
Lake,4,2022-01-12,523,523,291,232,2765,2769,1540,1229,1,3,3,2,120,120,117,117
Lassen,4,2022-01-12,241,241,158,83,3707,3712,2421,1291,0,0,0,0,54,54,54,54
Los Angeles,4,2022-01-12,296049,296377,247375,49002,1906976,1909093,1595448,313645,3589,332,332,586,28036,28036,27704,27704
Madera,4,2022-01-12,2137,2138,1198,940,10860,10872,6081,4791,28,2,2,6,340,340,338,338
Marin,4,2022-01-12,2711,2713,1534,1179,19867,19889,11235,8654,25,3,3,3,260,260,257,257
Mariposa,4,2022-01-12,183,183,100,83,1187,1187,648,539,0,0,0,0,22,22,22,22
Mendocino,4,2022-01-12,936,936,459,477,5569,5575,2735,2840,9,2,2,2,107,107,105,105
Merced,4,2022-01-12,4073,4078,2556,1522,14877,14894,9320,5574,34,10,10,10,724,724,714,714
Modoc,4,2022-01-12,9,9,6,3,108,108,69,39,0,0,0,0,6,6,6,6
Mono,4,2022-01-12,235,235,105,130,806,806,360,446,0,0,0,0,5,5,5,5
Monterey,4,2022-01-12,5412,5417,2416,3001,31348,31383,13920,17463,53,3,3,15,654,654,651,651
Napa,4,2022-01-12,2452,2454,1607,847,14484,14500,9505,4995,21,0,0,4,110,110,110,110
Nevada,4,2022-01-12,1312,1312,738,574,5565,5571,3143,2428,12,2,2,3,115,115,113,113
Orange,4,2022-01-12,54441,54501,37261,17240,304940,305278,209009,96269,904,105,105,168,6197,6197,6092,6092
Placer,4,2022-01-12,5168,5174,2780,2394,22445,22470,12093,10377,177,8,8,34,528,528,520,520
Plumas,4,2022-01-12,166,166,96,70,832,832,482,350,6,0,0,0,12,12,12,12
Riverside,4,2022-01-12,47234,47286,29236,18050,185725,185931,114958,70973,831,87,87,145,5794,5794,5707,5707
Sacramento,4,2022-01-12,26006,26034,15614,10420,119330,119463,71733,47730,403,47,47,80,2599,2599,2552,2552
San Benito,4,2022-01-12,994,994,645,349,4542,4548,2950,1598,6,1,1,3,86,86,85,85
San Bernardino,4,2022-01-12,48977,49031,32711,16320,190357,190567,127220,63347,884,124,124,196,6819,6819,6695,6695
San Diego,4,2022-01-12,75048,75132,62199,12933,309300,309643,256390,53253,958,75,75,177,4632,4632,4557,4557
San Francisco,4,2022-01-12,13402,13418,5635,7783,109794,109916,46248,63668,182,13,13,37,714,714,701,701
San Joaquin,4,2022-01-12,14754,14770,8530,6240,65722,65795,38000,27795,173,16,16,44,2020,2020,2004,2004
San Luis Obispo,4,2022-01-12,4309,4314,2755,1559,22652,22677,14505,8172,37,4,4,8,382,382,378,378
San Mateo,4,2022-01-12,14897,14915,10206,4709,113633,113760,77904,35856,107,7,7,15,615,615,608,608
Santa Barbara,4,2022-01-12,8114,8122,4969,3153,46804,46857,28666,18191,84,11,11,14,592,592,581,581
Santa Clara,4,2022-01-12,34175,34212,28036,6176,266539,266837,218744,48093,378,24,24,65,2027,2027,2003,2003
Santa Cruz,4,2022-01-12,4319,4325,2804,1521,42216,42261,27403,14858,32,2,2,2,237,237,235,235
Shasta,4,2022-01-12,1188,1188,718,470,9202,9210,5575,3635,49,7,7,11,464,464,457,457
Siskiyou,4,2022-01-12,135,135,90,45,1068,1068,709,359,1,1,1,2,65,65,64,64
Solano,4,2022-01-12,6748,6755,4175,2580,37138,37178,22975,14203,110,6,6,14,403,403,397,397
Sonoma,4,2022-01-12,8521,8532,5327,3205,48151,48205,30123,18082,83,7,7,10,437,437,430,430
Stanislaus,4,2022-01-12,7383,7393,3775,3618,30387,30421,15537,14884,172,12,12,30,1472,1472,1460,1460
Sutter,4,2022-01-12,1380,1380,847,533,5197,5202,3195,2007,0,4,4,0,202,202,198,198
Tehama,4,2022-01-12,600,600,314,286,2625,2627,1372,1255,17,2,2,1,170,170,168,168
Trinity,4,2022-01-12,44,44,23,21,271,271,140,131,0,0,0,0,19,19,19,19
Tulare,4,2022-01-12,6505,6512,3314,3198,26551,26579,13479,13100,68,13,13,12,1339,1339,1326,1326
Tuolumne,4,2022-01-12,840,840,472,368,4325,4330,2431,1899,9,4,4,4,160,160,156,156
Ventura,4,2022-01-12,16110,16128,11308,4820,84564,84659,59433,25226,258,28,28,34,1264,1264,1236,1236
Yolo,4,2022-01-12,3621,3626,2328,1298,46701,46754,30038,16716,13,5,5,3,278,278,273,273
Yuba,4,2022-01-12,1132,1132,713,419,4248,4253,2676,1577,34,0,0,6,103,103,103,103
Alameda,5,2022-01-19,23436,23464,16890,6574,169435,169634,122260,47374,372,37,37,72,1619,1619,1582,1582
Amador,5,2022-01-19,542,542,335,207,3817,3820,2366,1454,14,1,1,3,73,73,72,72
Butte,5,2022-01-19,2113,2113,1611,502,9485,9496,7245,2251,66,8,8,7,373,373,365,365
Calaveras,5,2022-01-19,557,557,361,196,2435,2437,1579,858,4,2,2,2,97,97,95,95
Colusa,5,2022-01-19,174,174,119,55,834,834,574,260,4,0,0,0,21,21,21,21
Contra Costa,5,2022-01-19,15068,15085,9120,5965,84832,84932,51406,33526,279,24,24,49,1135,1135,1111,1111
Del Norte,5,2022-01-19,265,265,179,86,3806,3810,2576,1234,2,0,0,0,42,42,42,42
El Dorado,5,2022-01-19,1724,1724,1118,606,7677,7686,4990,2696,13,3,3,6,192,192,189,189
Fresno,5,2022-01-19,18098,18118,11262,6856,69082,69164,42946,26218,433,33,33,69,2503,2503,2470,2470
Glenn,5,2022-01-19,273,273,178,95,1045,1045,684,361,1,2,2,0,41,41,39,39
Humboldt,5,2022-01-19,1051,1051,701,350,7825,7835,5226,2609,15,3,3,4,130,130,127,127
Imperial,5,2022-01-19,3457,3462,2232,1230,13078,13094,8431,4663,73,14,14,30,868,868,854,854
Inyo,5,2022-01-19,237,237,161,76,811,811,552,259,2,1,1,0,53,53,52,52
Kern,5,2022-01-19,11403,11416,7869,3547,52025,52087,35950,16137,259,37,37,55,2126,2126,2089,2089
Kings,5,2022-01-19,3995,3999,2600,1399,16990,17010,11038,5972,39,4,4,2,397,397,393,393
Lake,5,2022-01-19,678,678,418,260,3614,3619,2228,1391,5,1,1,2,121,121,120,120
Lassen,5,2022-01-19,372,372,264,108,3868,3871,2734,1137,0,0,0,0,54,54,54,54
Los Angeles,5,2022-01-19,202867,203107,176018,27089,1621038,1622951,1407434,215517,4091,546,546,723,28582,28582,28036,28036
Madera,5,2022-01-19,2704,2707,1678,1029,11786,11801,7324,4477,39,6,6,13,346,346,340,340
Marin,5,2022-01-19,2283,2284,1423,861,17964,17985,11228,6757,37,5,5,7,265,265,260,260
Mariposa,5,2022-01-19,152,152,92,60,1066,1066,643,423,0,0,0,0,22,22,22,22
Mendocino,5,2022-01-19,979,979,540,439,5018,5025,2773,2252,27,3,3,3,110,110,107,107
Merced,5,2022-01-19,3593,3598,2448,1150,13189,13205,8987,4218,50,17,17,13,741,741,724,724
Modoc,5,2022-01-19,17,17,12,5,106,106,74,32,0,1,1,0,7,7,6,6
Mono,5,2022-01-19,133,133,66,67,643,643,322,321,0,0,0,0,5,5,5,5
Monterey,5,2022-01-19,5794,5801,2929,2872,30505,30542,15490,15052,88,9,9,15,663,663,654,654
Napa,5,2022-01-19,1793,1793,1271,522,11765,11780,8363,3417,24,3,3,6,113,113,110,110
Nevada,5,2022-01-19,1172,1172,727,445,5135,5140,3197,1943,22,0,0,6,115,115,115,115
Orange,5,2022-01-19,36198,36239,26624,9615,240648,240933,177272,63661,984,116,116,199,6313,6313,6197,6197
Placer,5,2022-01-19,4100,4106,2458,1648,19148,19172,11492,7680,163,10,10,42,538,538,528,528
Plumas,5,2022-01-19,207,207,132,75,836,836,532,304,5,0,0,0,12,12,12,12
Riverside,5,2022-01-19,38024,38068,25646,12422,165316,165513,111652,53861,922,114,114,154,5908,5908,5794,5794
Sacramento,5,2022-01-19,19883,19907,13097,6810,99820,99938,65828,34110,519,57,57,96,2656,2656,2599,2599
San Benito,5,2022-01-19,852,852,600,252,3992,3997,2811,1186,4,2,2,4,88,88,86,86
San Bernardino,5,2022-01-19,33963,34004,24455,9549,159254,159442,114775,44667,1025,146,146,226,6965,6965,6819,6819
San Diego,5,2022-01-19,58465,58534,50393,8141,257708,258013,222090,35923,1089,104,104,214,4736,4736,4632,4632
San Francisco,5,2022-01-19,10353,10365,4994,5371,92383,92491,44678,47813,233,12,12,39,726,726,714,714
San Joaquin,5,2022-01-19,12342,12356,7861,4495,59462,59532,37905,21627,233,27,27,61,2047,2047,2020,2020
San Luis Obispo,5,2022-01-19,3853,3858,2678,1180,21298,21324,14812,6512,43,13,13,11,395,395,382,382
San Mateo,5,2022-01-19,11006,11018,8087,2931,94142,94253,69328,24925,100,10,10,31,625,625,615,615
Santa Barbara,5,2022-01-19,6823,6831,4573,2258,42028,42078,28175,13903,136,12,12,14,604,604,592,592
Santa Clara,5,2022-01-19,25794,25824,22030,3794,224927,225194,192256,32938,456,37,37,91,2064,2064,2027,2027
Santa Cruz,5,2022-01-19,4251,4256,2992,1264,41167,41215,28883,12332,35,3,3,4,240,240,237,237
Shasta,5,2022-01-19,1448,1448,957,491,9582,9593,6350,3243,58,9,9,14,473,473,464,464
Siskiyou,5,2022-01-19,173,173,123,50,872,872,624,248,2,0,0,1,65,65,65,65
Solano,5,2022-01-19,5873,5879,3949,1930,33766,33806,22742,11064,138,9,9,22,412,412,403,403
Sonoma,5,2022-01-19,7444,7453,5072,2381,42307,42357,28834,13523,80,11,11,17,448,448,437,437
Stanislaus,5,2022-01-19,7131,7139,4073,3066,28896,28929,16532,12397,237,16,16,42,1488,1488,1472,1472
Sutter,5,2022-01-19,1208,1208,809,399,4883,4888,3280,1608,0,1,1,0,203,203,202,202
Tehama,5,2022-01-19,593,593,345,248,2488,2490,1453,1037,14,5,5,2,175,175,170,170
Trinity,5,2022-01-19,51,51,30,21,298,298,172,126,0,1,1,0,20,20,19,19
Tulare,5,2022-01-19,7887,7897,4487,3410,28492,28526,16212,12314,119,13,13,15,1352,1352,1339,1339
Tuolumne,5,2022-01-19,907,907,562,345,3785,3789,2347,1442,11,6,6,3,166,166,160,160
Ventura,5,2022-01-19,10973,10986,8251,2735,65633,65711,49418,16293,291,42,42,63,1306,1306,1264,1264
Yolo,5,2022-01-19,2572,2573,1794,779,39041,39087,27266,11821,19,3,3,7,281,281,278,278
Yuba,5,2022-01-19,996,996,683,313,3734,3739,2564,1175,51,3,3,8,106,106,103,103
Alameda,6,2022-01-26,16180,16199,12408,3791,156908,157100,120621,36479,377,39,39,72,1658,1658,1619,1619
Amador,6,2022-01-26,420,420,281,139,3584,3588,2400,1188,11,0,0,4,73,73,73,73
Butte,6,2022-01-26,1566,1566,1257,309,8594,8607,6923,1684,85,7,7,9,380,380,373,373
Calaveras,6,2022-01-26,442,442,308,134,2223,2225,1559,666,6,3,3,3,100,100,97,97
Colusa,6,2022-01-26,151,151,111,40,732,732,537,195,7,0,0,0,21,21,21,21
Contra Costa,6,2022-01-26,11155,11168,7376,3792,80214,80312,53241,27071,237,24,24,69,1159,1159,1135,1135
Del Norte,6,2022-01-26,356,356,258,98,3732,3737,2713,1024,5,0,0,2,42,42,42,42
El Dorado,6,2022-01-26,1100,1100,770,330,6673,6681,4696,1985,16,6,6,7,198,198,192,192
Fresno,6,2022-01-26,14603,14622,9870,4752,64336,64415,43583,20832,491,38,38,81,2541,2541,2503,2503
Glenn,6,2022-01-26,232,232,164,68,870,870,616,254,3,0,0,0,41,41,41,41
Humboldt,6,2022-01-26,748,748,537,211,6787,6795,4887,1908,23,1,1,5,131,131,130,130
Imperial,6,2022-01-26,3225,3230,2251,979,12863,12880,9000,3880,73,15,15,29,883,883,868,868
Inyo,6,2022-01-26,101,101,74,27,552,552,406,146,3,0,0,0,53,53,53,53
Kern,6,2022-01-26,8303,8314,6129,2185,47559,47616,35225,12391,277,47,47,47,2173,2173,2126,2126
Kings,6,2022-01-26,3332,3337,2336,1001,16417,16436,11533,4903,40,3,3,5,400,400,397,397
Lake,6,2022-01-26,672,672,451,221,3232,3236,2183,1053,11,4,4,5,125,125,121,121
Lassen,6,2022-01-26,357,357,269,88,3500,3506,2648,858,5,0,0,0,54,54,54,54
Los Angeles,6,2022-01-26,123589,123739,110345,13394,1480622,1482431,1324078,158353,3577,608,608,746,29190,29190,28582,28582
Madera,6,2022-01-26,2291,2292,1543,749,10636,10650,7200,3450,45,5,5,12,351,351,346,346
Marin,6,2022-01-26,1556,1556,1056,500,15889,15909,10819,5090,40,5,5,12,270,270,265,265
Mariposa,6,2022-01-26,120,120,79,41,869,869,575,294,0,0,0,0,22,22,22,22
Mendocino,6,2022-01-26,749,749,455,294,4140,4145,2530,1615,18,3,3,3,113,113,110,110
Merced,6,2022-01-26,2715,2719,1989,730,11881,11896,8712,3184,55,7,7,14,748,748,741,741
Modoc,6,2022-01-26,13,13,10,3,102,102,76,26,2,0,0,0,7,7,7,7
Mono,6,2022-01-26,73,73,41,32,364,364,206,158,0,0,0,0,5,5,5,5
Monterey,6,2022-01-26,4619,4625,2619,2006,29703,29740,16874,12866,95,7,7,19,670,670,663,663
Napa,6,2022-01-26,1371,1371,1035,336,10854,10868,8223,2645,22,4,4,5,117,117,113,113
Nevada,6,2022-01-26,869,869,588,281,4532,4537,3081,1456,27,4,4,4,119,119,115,115
Orange,6,2022-01-26,20230,20255,15766,4489,208276,208530,162831,45699,883,194,194,184,6507,6507,6313,6313
Placer,6,2022-01-26,3163,3167,2075,1092,17123,17143,11265,5878,208,12,12,49,550,550,538,538
Plumas,6,2022-01-26,186,186,128,58,811,811,558,253,5,0,0,0,12,12,12,12
Riverside,6,2022-01-26,25914,25946,18787,7159,142699,142873,103723,39150,867,113,113,172,6021,6021,5908,5908
Sacramento,6,2022-01-26,14626,14643,10400,4243,90238,90349,64312,26037,526,77,77,103,2733,2733,2656,2656
San Benito,6,2022-01-26,664,664,498,166,3700,3705,2785,920,6,0,0,3,88,88,88,88
San Bernardino,6,2022-01-26,21684,21711,16602,5109,135396,135562,103964,31598,951,182,182,232,7147,7147,6965,6965
San Diego,6,2022-01-26,39791,39840,35322,4518,223689,223963,198771,25192,1051,126,126,219,4862,4862,4736,4736
San Francisco,6,2022-01-26,6722,6730,3649,3081,82128,82229,44816,37413,253,22,22,43,748,748,726,726
San Joaquin,6,2022-01-26,8481,8492,5849,2643,51195,51258,35433,15825,244,30,30,74,2077,2077,2047,2047
San Luis Obispo,6,2022-01-26,2883,2887,2143,744,19327,19350,14398,4952,44,9,9,11,404,404,395,395
San Mateo,6,2022-01-26,6807,6815,5306,1509,87226,87332,68181,19151,139,19,19,31,644,644,625,625
Santa Barbara,6,2022-01-26,5422,5429,3909,1520,39719,39769,28686,11083,120,15,15,16,619,619,604,604
Santa Clara,6,2022-01-26,19327,19351,17050,2301,218123,218390,192652,25738,410,44,44,90,2108,2108,2064,2064
Santa Cruz,6,2022-01-26,5087,5094,3815,1279,51729,51793,38901,12892,41,3,3,3,243,243,240,240
Shasta,6,2022-01-26,1267,1267,901,366,9240,9251,6608,2643,77,6,6,11,479,479,473,473
Siskiyou,6,2022-01-26,121,121,92,29,695,695,529,166,8,3,3,2,68,68,65,65
Solano,6,2022-01-26,4476,4482,3243,1239,30789,30827,22362,8465,132,11,11,27,423,423,412,412
Sonoma,6,2022-01-26,5629,5636,4110,1526,38094,38142,27889,10253,92,6,6,17,454,454,448,448
Stanislaus,6,2022-01-26,5260,5267,3305,1962,25053,25082,15799,9283,291,24,24,50,1512,1512,1488,1488
Sutter,6,2022-01-26,862,862,620,242,4513,4518,3257,1261,0,2,2,0,205,205,203,203
Tehama,6,2022-01-26,491,491,313,178,2337,2340,1497,843,20,4,4,5,179,179,175,175
Trinity,6,2022-01-26,53,53,33,20,283,283,179,104,0,0,0,0,20,20,20,20
Tulare,6,2022-01-26,6379,6387,3989,2398,26463,26496,16595,9901,146,12,12,12,1364,1364,1352,1352
Tuolumne,6,2022-01-26,946,946,640,306,3619,3624,2452,1172,17,3,3,3,169,169,166,166
Ventura,6,2022-01-26,7459,7468,5919,1549,61589,61664,49010,12654,282,30,30,55,1336,1336,1306,1306
Yolo,6,2022-01-26,1923,1923,1435,488,38993,39040,29174,9866,19,10,10,5,291,291,281,281
Yuba,6,2022-01-26,744,744,545,199,3392,3397,2496,901,55,2,2,7,108,108,106,106
Alameda,7,2022-02-02,9089,9100,7351,1749,129323,129486,104820,24666,326,56,56,76,1714,1714,1658,1658
Amador,7,2022-02-02,318,318,229,89,3312,3317,2397,920,13,3,3,4,76,76,73,73
Butte,7,2022-02-02,1046,1046,878,168,7314,7324,6157,1167,77,7,7,7,387,387,380,380
Calaveras,7,2022-02-02,230,230,173,57,1743,1744,1310,434,2,6,6,2,106,106,100,100
Colusa,7,2022-02-02,88,88,68,20,651,651,507,144,8,0,0,0,21,21,21,21
Contra Costa,7,2022-02-02,5801,5808,4149,1659,63060,63140,45239,17901,212,44,44,57,1203,1203,1159,1159
Del Norte,7,2022-02-02,267,267,205,62,4237,4243,3269,974,2,2,2,1,44,44,42,42
El Dorado,7,2022-02-02,602,602,451,151,5606,5611,4221,1390,16,0,0,5,198,198,198,198
Fresno,7,2022-02-02,9044,9056,6581,2475,50290,50354,36679,13675,505,40,40,102,2581,2581,2541,2541
Glenn,7,2022-02-02,171,171,129,42,705,705,534,171,2,0,0,0,41,41,41,41
Humboldt,7,2022-02-02,552,552,423,129,5595,5601,4295,1306,19,3,3,2,134,134,131,131
Imperial,7,2022-02-02,1625,1625,1212,413,10069,10083,7529,2554,70,18,18,24,901,901,883,883
Inyo,7,2022-02-02,54,54,42,12,457,457,357,100,6,3,3,0,56,56,53,53
Kern,7,2022-02-02,4764,4770,3737,1033,39308,39358,30894,8464,193,42,42,41,2215,2215,2173,2173
Kings,7,2022-02-02,1963,1963,1471,492,12447,12462,9351,3111,55,8,8,7,408,408,400,400
Lake,7,2022-02-02,419,419,303,116,2988,2992,2166,826,9,2,2,3,127,127,125,125
Lassen,7,2022-02-02,245,245,194,51,3263,3267,2600,667,6,2,2,0,56,56,54,54
Los Angeles,7,2022-02-02,58481,58555,53512,5043,1236240,1237801,1132687,105114,2728,687,687,670,29877,29877,29190,29190
Madera,7,2022-02-02,1416,1416,1028,388,8634,8646,6294,2352,46,7,7,7,358,358,351,351
Marin,7,2022-02-02,900,900,657,243,13003,13020,9534,3486,28,5,5,7,275,275,270,270
Mariposa,7,2022-02-02,81,81,58,23,767,767,546,221,0,2,2,0,24,24,22,22
Mendocino,7,2022-02-02,367,367,245,122,3118,3123,2087,1036,12,2,2,6,115,115,113,113
Merced,7,2022-02-02,1663,1663,1291,372,9317,9329,7255,2074,51,14,14,14,762,762,748,748
Modoc,7,2022-02-02,17,17,13,4,89,89,70,19,1,0,0,0,7,7,7,7
Mono,7,2022-02-02,41,41,26,15,302,302,188,114,0,0,0,0,5,5,5,5
Monterey,7,2022-02-02,2997,3002,1879,1123,24811,24842,15593,9249,83,11,11,12,681,681,670,670
Napa,7,2022-02-02,883,883,705,178,8723,8734,6984,1750,20,8,8,3,125,125,117,117
Nevada,7,2022-02-02,463,463,337,126,3491,3496,2553,943,30,1,1,6,120,120,119,119
Orange,7,2022-02-02,9597,9608,7870,1738,166851,167061,137177,29884,671,144,144,147,6651,6651,6507,6507
Placer,7,2022-02-02,1870,1870,1325,545,14051,14069,9997,4072,149,26,26,45,576,576,550,550
Plumas,7,2022-02-02,109,109,80,29,631,631,464,167,0,1,1,0,13,13,12,12
Riverside,7,2022-02-02,12311,12327,9504,2823,109839,109977,84988,24989,701,113,113,154,6134,6134,6021,6021
Sacramento,7,2022-02-02,8201,8212,6228,1984,71571,71663,54486,17177,483,85,85,100,2818,2818,2733,2733
San Benito,7,2022-02-02,397,397,316,81,3014,3019,2401,618,4,2,2,3,90,90,88,88
San Bernardino,7,2022-02-02,10722,10735,8663,2072,105945,106079,85749,20330,684,177,177,195,7324,7324,7147,7147
San Diego,7,2022-02-02,19692,19717,17934,1783,167592,167802,152772,15030,899,103,103,206,4965,4965,4862,4862
San Francisco,7,2022-02-02,3197,3202,1934,1268,63279,63360,38357,25003,196,21,21,50,769,769,748,748
San Joaquin,7,2022-02-02,4654,4659,3448,1211,39739,39789,29544,10245,205,41,41,79,2118,2118,2077,2077
San Luis Obispo,7,2022-02-02,1628,1629,1283,346,14182,14200,11201,2999,38,15,15,9,419,419,404,404
San Mateo,7,2022-02-02,3491,3496,2864,632,70089,70176,57584,12592,128,9,9,18,653,653,644,644
Santa Barbara,7,2022-02-02,3107,3112,2391,721,34279,34321,26414,7907,106,19,19,20,638,638,619,619
Santa Clara,7,2022-02-02,11419,11434,10345,1089,192980,193224,174963,18261,420,45,45,88,2153,2153,2108,2108
Santa Cruz,7,2022-02-02,2644,2647,2100,547,45130,45187,35862,9325,29,5,5,7,248,248,243,243
Shasta,7,2022-02-02,805,805,612,193,7704,7714,5878,1836,70,17,17,11,496,496,479,479
Siskiyou,7,2022-02-02,117,117,94,23,736,736,591,145,9,3,3,0,71,71,68,68
Solano,7,2022-02-02,3540,3545,2729,816,27881,27917,21547,6370,115,5,5,27,428,428,423,423
Sonoma,7,2022-02-02,2779,2783,2159,624,29654,29692,23100,6592,72,10,10,16,464,464,454,454
Stanislaus,7,2022-02-02,3198,3203,2194,1009,20953,20980,14400,6580,266,42,42,42,1554,1554,1512,1512
Sutter,7,2022-02-02,548,548,420,128,3673,3678,2831,847,0,5,5,0,210,210,205,205
Tehama,7,2022-02-02,365,365,254,111,1975,1977,1375,602,20,2,2,5,181,181,179,179
Trinity,7,2022-02-02,36,36,25,11,182,182,126,56,0,0,0,0,20,20,20,20
Tulare,7,2022-02-02,3872,3877,2637,1240,20893,20919,14269,6650,146,25,25,21,1389,1389,1364,1364
Tuolumne,7,2022-02-02,543,543,393,150,2948,2952,2146,806,19,1,1,2,170,170,169,169
Ventura,7,2022-02-02,3765,3771,3134,637,47513,47573,39605,7968,240,38,38,48,1374,1374,1336,1336
Yolo,7,2022-02-02,1116,1116,882,234,34891,34933,27630,7303,15,5,5,6,296,296,291,291
Yuba,7,2022-02-02,456,456,355,101,2717,2722,2125,597,72,4,4,11,112,112,108,108
Alameda,8,2022-02-09,4900,4907,4142,765,110571,110714,93557,17157,242,47,47,63,1761,1761,1714,1714
Amador,8,2022-02-09,142,142,109,33,2576,2580,1983,597,14,2,2,4,78,78,76,76
Butte,8,2022-02-09,640,640,557,83,6045,6052,5276,776,76,9,9,10,396,396,387,387
Calaveras,8,2022-02-09,148,148,117,31,1394,1394,1109,285,3,0,0,2,106,106,106,106
Colusa,8,2022-02-09,68,68,56,12,538,538,441,97,0,0,0,0,21,21,21,21
Contra Costa,8,2022-02-09,3351,3356,2560,796,50332,50397,38523,11874,166,28,28,38,1231,1231,1203,1203
Del Norte,8,2022-02-09,269,269,217,52,3844,3851,3127,724,8,0,0,2,44,44,44,44
El Dorado,8,2022-02-09,375,375,298,77,4887,4892,3897,995,18,3,3,2,201,201,198,198
Fresno,8,2022-02-09,5226,5232,4048,1184,40459,40512,31400,9112,447,54,54,90,2635,2635,2581,2581
Glenn,8,2022-02-09,86,86,69,17,557,557,445,112,4,1,1,0,42,42,41,41
Humboldt,8,2022-02-09,433,433,350,83,4681,4686,3793,893,20,1,1,4,135,135,134,134
Imperial,8,2022-02-09,910,910,719,191,7527,7538,5965,1573,48,13,13,25,914,914,901,901
Inyo,8,2022-02-09,27,27,22,5,438,438,359,79,1,0,0,0,56,56,56,56
Kern,8,2022-02-09,2854,2858,2351,507,32242,32284,26605,5679,170,33,33,44,2248,2248,2215,2215
Kings,8,2022-02-09,1076,1076,855,221,9350,9364,7447,1917,52,15,15,4,423,423,408,408
Lake,8,2022-02-09,298,298,229,69,2613,2618,2021,597,12,1,1,4,128,128,127,127
Lassen,8,2022-02-09,118,118,98,20,3078,3083,2569,514,5,1,1,0,57,57,56,56
Los Angeles,8,2022-02-09,30820,30860,28757,2103,1127924,1129397,1053308,76089,1972,591,591,492,30468,30468,29877,29877
Madera,8,2022-02-09,856,856,660,196,7423,7433,5747,1686,26,2,2,12,360,360,358,358
Marin,8,2022-02-09,548,548,426,122,10625,10639,8276,2363,31,7,7,7,282,282,275,275
Mariposa,8,2022-02-09,40,40,30,10,520,520,395,125,0,0,0,0,24,24,24,24
Mendocino,8,2022-02-09,289,289,208,81,2706,2710,1954,756,13,2,2,5,117,117,115,115
Merced,8,2022-02-09,952,952,778,174,7707,7716,6316,1400,45,15,15,10,777,777,762,762
Modoc,8,2022-02-09,23,23,19,4,258,258,213,45,4,0,0,0,7,7,7,7
Mono,8,2022-02-09,27,27,18,9,239,239,162,77,0,0,0,0,5,5,5,5
Monterey,8,2022-02-09,1809,1810,1233,577,20892,20920,14305,6615,68,12,12,15,693,693,681,681
Napa,8,2022-02-09,634,634,529,105,7358,7367,6164,1203,20,5,5,2,130,130,125,125
Nevada,8,2022-02-09,280,280,217,63,3022,3027,2351,676,25,2,2,2,122,122,120,120
Orange,8,2022-02-09,5372,5379,4591,788,148273,148467,126971,21496,463,119,119,118,6770,6770,6651,6651
Placer,8,2022-02-09,1027,1027,777,250,11445,11460,8705,2755,134,13,13,29,589,589,576,576
Plumas,8,2022-02-09,73,73,57,16,493,493,385,108,1,0,0,0,13,13,13,13
Riverside,8,2022-02-09,6703,6712,5453,1259,87702,87816,71453,16363,483,97,97,118,6231,6231,6134,6134
Sacramento,8,2022-02-09,5083,5090,4075,1015,60190,60269,48380,11889,359,65,65,88,2883,2883,2818,2818
San Benito,8,2022-02-09,248,248,207,41,2454,2457,2046,411,5,0,0,4,90,90,90,90
San Bernardino,8,2022-02-09,5624,5631,4749,882,84049,84158,71065,13093,487,133,133,147,7457,7457,7324,7324
San Diego,8,2022-02-09,11520,11535,10708,827,142822,143010,132812,10198,709,112,112,159,5077,5077,4965,4965
San Francisco,8,2022-02-09,2185,2185,1449,736,52452,52520,34837,17683,169,28,28,38,797,797,769,769
San Joaquin,8,2022-02-09,2805,2810,2206,604,34912,34957,27513,7444,167,35,35,62,2153,2153,2118,2118
San Luis Obispo,8,2022-02-09,1055,1055,872,183,11371,11387,9418,1969,27,11,11,8,430,430,419,419
San Mateo,8,2022-02-09,1989,1989,1696,293,59783,59862,51181,8681,69,19,19,14,672,672,653,653
Santa Barbara,8,2022-02-09,1687,1687,1362,325,26279,26313,21280,5033,76,14,14,20,652,652,638,638
Santa Clara,8,2022-02-09,6572,6580,6082,498,167345,167564,154994,12570,331,31,31,64,2184,2184,2153,2153
Santa Cruz,8,2022-02-09,1593,1593,1324,269,36983,37033,30809,6224,39,3,3,4,251,251,248,248
Shasta,8,2022-02-09,598,598,480,118,6603,6611,5320,1291,61,14,14,11,510,510,496,496
Siskiyou,8,2022-02-09,82,82,69,13,614,614,515,99,5,2,2,2,73,73,71,71
Solano,8,2022-02-09,1743,1743,1414,329,22343,22372,18191,4181,79,4,4,23,432,432,428,428
Sonoma,8,2022-02-09,1740,1740,1420,320,25492,25525,20880,4645,49,10,10,15,474,474,464,464
Stanislaus,8,2022-02-09,2064,2066,1518,548,17607,17629,12995,4634,226,32,32,46,1586,1586,1554,1554
Sutter,8,2022-02-09,284,284,229,55,3089,3094,2507,587,0,6,6,0,216,216,210,210
Tehama,8,2022-02-09,230,230,171,59,1491,1491,1113,378,11,5,5,5,186,186,181,181
Trinity,8,2022-02-09,19,19,14,5,132,132,98,34,0,0,0,0,20,20,20,20
Tulare,8,2022-02-09,2226,2229,1633,596,16479,16500,12113,4387,126,27,27,22,1416,1416,1389,1389
Tuolumne,8,2022-02-09,280,280,216,64,2420,2423,1875,548,9,2,2,3,172,172,170,170
Ventura,8,2022-02-09,2209,2210,1908,302,40484,40538,35061,5477,193,48,48,49,1422,1422,1374,1374
Yolo,8,2022-02-09,747,747,619,128,29918,29957,24844,5113,9,12,12,2,308,308,296,296
Yuba,8,2022-02-09,301,301,247,54,2329,2332,1914,418,28,2,2,14,114,114,112,112
Alameda,9,2022-02-16,2829,2833,2476,357,97009,97137,85027,12110,193,30,30,42,1791,1791,1761,1761
Amador,9,2022-02-16,98,98,79,19,2257,2260,1831,429,6,3,3,3,81,81,78,78
Butte,9,2022-02-16,397,397,355,42,4992,4998,4482,516,63,14,14,8,410,410,396,396
Calaveras,9,2022-02-16,62,62,51,11,1053,1053,877,176,2,3,3,2,109,109,106,106
Colusa,9,2022-02-16,27,27,23,4,391,391,333,58,6,0,0,0,21,21,21,21
Contra Costa,9,2022-02-16,2019,2019,1625,394,43278,43336,34962,8374,109,16,16,36,1247,1247,1231,1231
Del Norte,9,2022-02-16,194,194,163,31,3257,3262,2763,499,6,0,0,2,44,44,44,44
El Dorado,9,2022-02-16,208,208,173,35,4167,4172,3479,693,13,3,3,3,204,204,201,201
Fresno,9,2022-02-16,3101,3106,2528,578,32659,32703,26676,6027,352,26,26,62,2661,2661,2635,2635
Glenn,9,2022-02-16,47,47,39,8,471,471,394,77,3,0,0,0,42,42,42,42
Humboldt,9,2022-02-16,282,282,238,44,4027,4032,3407,625,24,1,1,4,136,136,135,135
Imperial,9,2022-02-16,478,478,396,82,5572,5578,4628,950,43,9,9,16,923,923,914,914
Inyo,9,2022-02-16,21,21,18,3,360,360,307,53,1,0,0,0,56,56,56,56
Kern,9,2022-02-16,1768,1768,1513,255,26598,26634,22841,3793,128,30,30,39,2278,2278,2248,2248
Kings,9,2022-02-16,628,628,522,106,7156,7166,5971,1195,37,4,4,5,427,427,423,423
Lake,9,2022-02-16,249,249,202,47,2196,2198,1788,410,9,3,3,3,131,131,128,128
Lassen,9,2022-02-16,151,151,130,21,2593,2596,2243,353,1,2,2,0,59,59,57,57
Los Angeles,9,2022-02-16,17645,17668,16713,955,1018773,1020137,965768,54369,1355,420,420,358,30888,30888,30468,30468
Madera,9,2022-02-16,518,518,421,97,6453,6462,5261,1201,28,2,2,10,362,362,360,360
Marin,9,2022-02-16,321,321,262,59,10250,10264,8397,1867,19,4,4,7,286,286,282,282
Mariposa,9,2022-02-16,26,26,21,5,407,407,327,80,0,0,0,0,24,24,24,24
Mendocino,9,2022-02-16,161,161,123,38,2234,2237,1718,519,13,2,2,4,119,119,117,117
Merced,9,2022-02-16,670,670,570,100,6384,6392,5449,943,37,10,10,9,787,787,777,777
Modoc,9,2022-02-16,15,15,13,2,80,80,69,11,0,0,0,0,7,7,7,7
Mono,9,2022-02-16,9,9,7,2,153,153,112,41,0,0,0,0,5,5,5,5
Monterey,9,2022-02-16,1064,1064,780,284,15924,15945,11729,4216,51,10,10,13,703,703,693,693
Napa,9,2022-02-16,351,351,305,46,6096,6104,5298,806,8,2,2,4,132,132,130,130
Nevada,9,2022-02-16,152,152,124,28,2426,2428,1986,442,17,2,2,4,124,124,122,122
Orange,9,2022-02-16,3508,3513,3099,414,130581,130756,115581,15175,323,97,97,76,6867,6867,6770,6770
Placer,9,2022-02-16,492,492,393,99,9636,9650,7747,1903,104,12,12,19,601,601,589,589
Plumas,9,2022-02-16,27,27,22,5,407,407,334,73,1,0,0,0,13,13,13,13
Riverside,9,2022-02-16,3860,3866,3276,590,70701,70795,60101,10694,340,77,77,92,6308,6308,6231,6231
Sacramento,9,2022-02-16,2885,2890,2422,468,52045,52114,43756,8358,319,50,50,55,2933,2933,2883,2883
San Benito,9,2022-02-16,138,138,119,19,2093,2095,1812,283,2,1,1,3,91,91,90,90
San Bernardino,9,2022-02-16,2970,2974,2597,377,69274,69366,60670,8696,322,108,108,109,7565,7565,7457,7457
San Diego,9,2022-02-16,6732,6741,6358,383,121228,121390,114554,6836,560,81,81,122,5158,5158,5077,5077
San Francisco,9,2022-02-16,1320,1320,944,376,46599,46661,33461,13200,129,19,19,33,816,816,797,797
San Joaquin,9,2022-02-16,1682,1682,1386,296,29137,29176,24102,5074,124,35,35,45,2188,2188,2153,2153
San Luis Obispo,9,2022-02-16,668,668,574,94,9637,9648,8298,1350,22,12,12,5,442,442,430,430
San Mateo,9,2022-02-16,1141,1141,1006,135,53114,53185,46981,6204,55,11,11,12,683,683,672,672
Santa Barbara,9,2022-02-16,982,982,829,153,23184,23215,19631,3584,57,12,12,13,664,664,652,652
Santa Clara,9,2022-02-16,3808,3814,3585,229,148987,149186,140327,8859,273,29,29,58,2213,2213,2184,2184
Santa Cruz,9,2022-02-16,875,875,756,119,30552,30593,26437,4156,17,2,2,6,253,253,251,251
Shasta,9,2022-02-16,407,407,342,65,5630,5637,4742,895,67,9,9,16,519,519,510,510
Siskiyou,9,2022-02-16,65,65,56,9,525,525,456,69,6,1,1,4,74,74,73,73
Solano,9,2022-02-16,1021,1021,865,156,17879,17905,15183,2722,64,3,3,20,435,435,432,432
Sonoma,9,2022-02-16,929,929,790,139,20752,20779,17722,3057,48,3,3,7,477,477,474,474
Stanislaus,9,2022-02-16,1166,1166,910,256,14533,14551,11393,3158,184,34,34,43,1620,1620,1586,1586
Sutter,9,2022-02-16,214,214,181,33,2673,2677,2263,414,0,1,1,0,217,217,216,216
Tehama,9,2022-02-16,151,151,119,32,1357,1357,1072,285,15,3,3,5,189,189,186,186
Trinity,9,2022-02-16,21,21,16,5,196,196,154,42,0,0,0,0,20,20,20,20
Tulare,9,2022-02-16,1189,1189,926,263,14399,14418,11232,3186,98,19,19,15,1435,1435,1416,1416
Tuolumne,9,2022-02-16,166,166,135,31,2239,2243,1828,415,13,5,5,2,177,177,172,172
Ventura,9,2022-02-16,1309,1309,1165,144,33618,33665,30007,3658,137,20,20,28,1442,1442,1422,1422
Yolo,9,2022-02-16,398,398,342,56,25936,25969,22374,3595,8,4,4,5,312,312,308,308
Yuba,9,2022-02-16,186,186,159,27,1922,1924,1643,281,21,0,0,11,114,114,114,114
Alameda,10,2022-02-23,1675,1675,1507,168,72060,72160,64930,7230,121,26,26,28,1817,1817,1791,1791
Amador,10,2022-02-23,61,61,51,10,1913,1915,1619,296,7,3,3,2,84,84,81,81
Butte,10,2022-02-23,230,230,211,19,4469,4474,4106,368,51,9,9,5,419,419,410,410
Calaveras,10,2022-02-23,38,38,33,5,943,943,817,126,1,5,5,0,114,114,109,109
Colusa,10,2022-02-23,17,17,15,2,376,376,331,45,7,0,0,0,21,21,21,21
Contra Costa,10,2022-02-23,1145,1145,963,182,32800,32846,27679,5167,64,18,18,22,1265,1265,1247,1247
Del Norte,10,2022-02-23,104,104,91,13,2792,2796,2453,343,8,1,1,3,45,45,44,44
El Dorado,10,2022-02-23,141,141,122,19,3410,3415,2954,461,6,0,0,6,204,204,204,204
Fresno,10,2022-02-23,1686,1686,1431,255,26467,26504,22540,3964,250,27,27,67,2688,2688,2661,2661
Glenn,10,2022-02-23,20,20,17,3,401,401,348,53,1,0,0,0,42,42,42,42
Humboldt,10,2022-02-23,174,174,152,22,3038,3043,2661,382,18,2,2,1,138,138,136,136
Imperial,10,2022-02-23,349,349,300,49,4891,4897,4223,674,34,8,8,8,931,931,923,923
Inyo,10,2022-02-23,13,13,11,2,311,311,274,37,0,0,0,0,56,56,56,56
Kern,10,2022-02-23,1033,1033,913,120,23496,23527,20827,2700,99,17,17,26,2295,2295,2278,2278
Kings,10,2022-02-23,383,383,331,52,6590,6599,5706,893,31,8,8,4,435,435,427,427
Lake,10,2022-02-23,148,148,125,23,1884,1886,1597,289,5,4,4,1,135,135,131,131
Lassen,10,2022-02-23,99,99,88,11,2175,2178,1940,238,1,1,1,0,60,60,59,59
Los Angeles,10,2022-02-23,10283,10298,9860,438,903639,904894,866984,37910,909,287,287,241,31175,31175,30888,30888
Madera,10,2022-02-23,256,256,217,39,4548,4555,3864,691,31,4,4,7,366,366,362,362
Marin,10,2022-02-23,169,169,144,25,8051,8063,6862,1201,13,4,4,3,290,290,286,286
Mariposa,10,2022-02-23,26,26,22,4,364,364,306,58,0,1,1,0,25,25,24,24
Mendocino,10,2022-02-23,109,109,88,21,1901,1903,1539,364,9,2,2,2,121,121,119,119
Merced,10,2022-02-23,376,376,331,45,5110,5116,4508,608,24,10,10,4,797,797,787,787
Modoc,10,2022-02-23,6,6,5,1,55,55,49,6,1,0,0,0,7,7,7,7
Mono,10,2022-02-23,6,6,5,1,162,162,126,36,0,1,1,0,6,6,5,5
Monterey,10,2022-02-23,629,629,489,140,13555,13574,10612,2962,34,6,6,6,709,709,703,703
Napa,10,2022-02-23,189,189,169,20,4949,4955,4431,524,5,4,4,2,136,136,132,132
Nevada,10,2022-02-23,84,84,71,13,2016,2018,1719,299,14,1,1,6,125,125,124,124
Orange,10,2022-02-23,2136,2137,1936,201,110729,110883,100587,10296,236,69,69,63,6936,6936,6867,6867
Placer,10,2022-02-23,285,285,239,46,8340,8353,7008,1345,94,8,8,13,609,609,601,601
Plumas,10,2022-02-23,24,24,20,4,339,339,289,50,1,0,0,0,13,13,13,13
Riverside,10,2022-02-23,2023,2026,1777,249,62115,62201,54640,7561,253,42,42,58,6350,6350,6308,6308
Sacramento,10,2022-02-23,1570,1570,1363,207,42857,42917,37362,5555,221,35,35,44,2968,2968,2933,2933
San Benito,10,2022-02-23,86,86,76,10,1716,1718,1530,188,0,0,0,2,91,91,91,91
San Bernardino,10,2022-02-23,1565,1565,1406,159,58955,59037,53100,5937,224,78,78,71,7643,7643,7565,7565
San Diego,10,2022-02-23,3839,3845,3673,172,96814,96948,92645,4303,436,48,48,96,5206,5206,5158,5158
San Francisco,10,2022-02-23,930,930,711,219,39088,39141,29905,9236,92,14,14,25,830,830,816,816
San Joaquin,10,2022-02-23,856,856,734,122,24359,24393,20960,3433,75,24,24,29,2212,2212,2188,2188
San Luis Obispo,10,2022-02-23,411,411,364,47,7578,7588,6734,854,14,14,14,2,456,456,442,442
San Mateo,10,2022-02-23,579,579,524,55,38274,38327,34733,3594,45,10,10,7,693,693,683,683
Santa Barbara,10,2022-02-23,464,464,406,58,19718,19744,17293,2451,36,3,3,11,667,667,664,664
Santa Clara,10,2022-02-23,2066,2067,1969,98,97372,97506,92865,4641,213,27,27,56,2240,2240,2213,2213
Santa Cruz,10,2022-02-23,501,501,447,54,24295,24328,21668,2660,18,2,2,5,255,255,253,253
Shasta,10,2022-02-23,192,192,167,25,4785,4791,4176,615,44,10,10,11,529,529,519,519
Siskiyou,10,2022-02-23,42,42,38,4,440,440,393,47,6,4,4,1,78,78,74,74
Solano,10,2022-02-23,552,552,484,68,14432,14452,12680,1772,46,5,5,15,440,440,435,435
Sonoma,10,2022-02-23,547,547,481,66,15261,15282,13471,1811,33,2,2,6,479,479,477,477
Stanislaus,10,2022-02-23,604,604,496,108,12322,12339,10158,2181,152,23,23,27,1643,1643,1620,1620
Sutter,10,2022-02-23,105,105,92,13,2147,2149,1882,267,0,2,2,0,219,219,217,217
Tehama,10,2022-02-23,78,78,64,14,1174,1174,972,202,8,9,9,3,198,198,189,189
Trinity,10,2022-02-23,7,7,6,1,162,162,133,29,0,0,0,0,20,20,20,20
Tulare,10,2022-02-23,619,619,506,113,11277,11293,9267,2026,71,21,21,12,1456,1456,1435,1435
Tuolumne,10,2022-02-23,88,88,75,13,1499,1499,1273,226,7,5,5,3,182,182,177,177
Ventura,10,2022-02-23,760,760,693,67,27764,27803,25400,2403,90,24,24,20,1466,1466,1442,1442
Yolo,10,2022-02-23,254,254,226,28,21829,21860,19439,2421,7,2,2,5,314,314,312,312
Yuba,10,2022-02-23,105,105,93,12,1707,1708,1508,200,18,1,1,6,115,115,114,114
Alameda,11,2022-03-02,1318,1318,1213,105,76006,76117,70070,6047,124,12,12,27,1829,1829,1817,1817
Amador,11,2022-03-02,94,94,83,11,1835,1836,1605,231,6,1,1,1,85,85,84,84
Butte,11,2022-03-02,156,156,146,10,3913,3919,3663,256,37,4,4,2,423,423,419,419
Calaveras,11,2022-03-02,29,29,26,3,1185,1185,1056,129,1,4,4,0,118,118,114,114
Colusa,11,2022-03-02,9,9,8,1,374,374,338,36,6,0,0,0,21,21,21,21
Contra Costa,11,2022-03-02,768,768,669,99,32636,32685,28541,4144,51,16,16,13,1281,1281,1265,1265
Del Norte,11,2022-03-02,65,65,58,7,1878,1880,1691,189,3,2,2,1,47,47,45,45
El Dorado,11,2022-03-02,98,98,87,11,3460,3465,3089,376,2,2,2,5,206,206,204,204
Fresno,11,2022-03-02,1109,1109,974,135,24064,24099,21193,2906,186,26,26,38,2714,2714,2688,2688
Glenn,11,2022-03-02,18,18,16,2,421,421,376,45,1,0,0,0,42,42,42,42
Humboldt,11,2022-03-02,126,126,113,13,2896,2901,2611,290,10,1,1,2,139,139,138,138
Imperial,11,2022-03-02,216,216,192,24,4457,4462,3969,493,14,5,5,11,936,936,931,931
Inyo,11,2022-03-02,9,9,8,1,383,383,346,37,0,0,0,0,56,56,56,56
Kern,11,2022-03-02,643,643,583,60,22563,22596,20523,2073,76,13,13,17,2308,2308,2295,2295
Kings,11,2022-03-02,180,180,160,20,5393,5400,4814,586,17,3,3,2,438,438,435,435
Lake,11,2022-03-02,100,100,87,13,1841,1843,1616,227,0,1,1,1,136,136,135,135
Lassen,11,2022-03-02,93,93,85,8,1945,1947,1777,170,0,2,2,0,62,62,60,60
Los Angeles,11,2022-03-02,7129,7140,6902,238,946637,948023,916582,31441,715,203,203,137,31378,31378,31175,31175
Madera,11,2022-03-02,164,164,144,20,4204,4209,3697,512,17,0,0,4,366,366,366,366
Marin,11,2022-03-02,162,162,143,19,7788,7799,6874,925,14,2,2,2,292,292,290,290
Mariposa,11,2022-03-02,22,22,19,3,331,331,288,43,0,1,1,0,26,26,25,25
Mendocino,11,2022-03-02,62,62,52,10,1785,1787,1510,277,10,1,1,3,122,122,121,121
Merced,11,2022-03-02,243,243,220,23,4777,4784,4332,452,21,6,6,6,803,803,797,797
Modoc,11,2022-03-02,2,2,2,0,52,52,47,5,0,0,0,0,7,7,7,7
Mono,11,2022-03-02,5,5,4,1,155,155,126,29,0,0,0,0,6,6,6,6
Monterey,11,2022-03-02,300,300,246,54,12097,12115,9947,2168,20,8,8,5,717,717,709,709
Napa,11,2022-03-02,184,184,168,16,5254,5260,4815,445,7,2,2,3,138,138,136,136
Nevada,11,2022-03-02,57,57,50,7,1887,1889,1663,226,11,0,0,0,125,125,125,125
Orange,11,2022-03-02,1516,1516,1402,114,115747,115916,107301,8615,172,39,39,34,6975,6975,6936,6936
Placer,11,2022-03-02,217,217,188,29,7889,7902,6876,1026,60,4,4,17,613,613,609,609
Plumas,11,2022-03-02,14,14,12,2,342,342,301,41,0,0,0,0,13,13,13,13
Riverside,11,2022-03-02,1419,1419,1279,140,58111,58196,52531,5665,163,41,41,31,6391,6391,6350,6350
Sacramento,11,2022-03-02,987,987,883,104,41813,41875,37521,4354,152,22,22,33,2990,2990,2968,2968
San Benito,11,2022-03-02,40,40,36,4,1637,1637,1495,142,0,0,0,2,91,91,91,91
San Bernardino,11,2022-03-02,1047,1047,963,84,56962,57045,52474,4571,127,46,46,44,7689,7689,7643,7643
San Diego,11,2022-03-02,2710,2715,2620,95,97942,98085,94670,3415,320,36,36,71,5242,5242,5206,5206
San Francisco,11,2022-03-02,785,785,633,152,39102,39160,31606,7554,70,11,11,16,841,841,830,830
San Joaquin,11,2022-03-02,551,551,488,63,22706,22740,20158,2582,60,8,8,14,2220,2220,2212,2212
San Luis Obispo,11,2022-03-02,299,299,272,27,7685,7697,7003,694,7,4,4,0,460,460,456,456
San Mateo,11,2022-03-02,588,588,544,44,41480,41541,38477,3064,44,1,1,6,694,694,693,693
Santa Barbara,11,2022-03-02,311,311,279,32,19224,19252,17333,1919,39,4,4,7,671,671,667,667
Santa Clara,11,2022-03-02,1639,1639,1578,61,109437,109597,105587,4010,194,13,13,41,2253,2253,2240,2240
Santa Cruz,11,2022-03-02,388,388,354,34,25937,25976,23712,2264,17,1,1,4,256,256,255,255
Shasta,11,2022-03-02,151,151,135,16,4800,4806,4313,493,36,13,13,8,542,542,529,529
Siskiyou,11,2022-03-02,18,18,16,2,438,438,401,37,3,1,1,1,79,79,78,78
Solano,11,2022-03-02,438,438,395,43,15280,15302,13800,1502,48,2,2,19,442,442,440,440
Sonoma,11,2022-03-02,413,413,374,39,15841,15864,14360,1504,24,6,6,7,485,485,479,479
Stanislaus,11,2022-03-02,400,400,342,58,11857,11874,10167,1707,111,12,12,15,1655,1655,1643,1643
Sutter,11,2022-03-02,93,93,84,9,2183,2186,1967,219,0,2,2,0,221,221,219,219
Tehama,11,2022-03-02,56,56,48,8,1189,1190,1025,165,8,1,1,2,199,199,198,198
Trinity,11,2022-03-02,5,5,4,1,102,102,87,15,0,0,0,0,20,20,20,20
Tulare,11,2022-03-02,393,393,335,58,10598,10615,9065,1550,54,7,7,7,1463,1463,1456,1456
Tuolumne,11,2022-03-02,55,55,48,7,1374,1374,1207,167,8,3,3,1,185,185,182,182
Ventura,11,2022-03-02,478,478,445,33,27855,27896,25979,1917,58,6,6,10,1472,1472,1466,1466
Yolo,11,2022-03-02,188,188,171,17,23990,24025,21887,2138,8,3,3,4,317,317,314,314
Yuba,11,2022-03-02,69,69,63,6,1680,1681,1523,158,12,1,1,6,116,116,115,115
Alameda,12,2022-03-09,1054,1054,987,67,70551,70658,66206,4452,83,13,13,15,1842,1842,1829,1829
Amador,12,2022-03-09,38,38,34,4,1410,1410,1270,140,4,1,1,1,86,86,85,85
Butte,12,2022-03-09,84,84,80,4,3790,3795,3599,196,25,3,3,4,426,426,423,423
Calaveras,12,2022-03-09,27,27,25,2,1083,1083,990,93,1,1,1,0,119,119,118,118
Colusa,12,2022-03-09,10,10,9,1,324,324,299,25,3,0,0,0,21,21,21,21
Contra Costa,12,2022-03-09,600,600,539,61,29939,29985,26933,3052,36,5,5,13,1286,1286,1281,1281
Del Norte,12,2022-03-09,51,51,47,4,1666,1668,1533,135,3,1,1,3,48,48,47,47
El Dorado,12,2022-03-09,63,63,57,6,3095,3100,2832,268,3,3,3,3,209,209,206,206
Fresno,12,2022-03-09,705,705,636,69,22010,22045,19922,2123,143,17,17,26,2731,2731,2714,2714
Glenn,12,2022-03-09,17,17,16,1,375,375,343,32,1,0,0,0,42,42,42,42
Humboldt,12,2022-03-09,71,71,65,6,3003,3008,2767,241,4,3,3,2,142,142,139,139
Imperial,12,2022-03-09,115,115,105,10,4839,4845,4419,426,11,3,3,10,939,939,936,936
Inyo,12,2022-03-09,11,11,10,1,243,243,224,19,1,0,0,0,56,56,56,56
Kern,12,2022-03-09,393,393,364,29,20391,20421,18934,1487,63,12,12,11,2320,2320,2308,2308
Kings,12,2022-03-09,211,211,193,18,4791,4797,4382,415,17,4,4,1,442,442,438,438
Lake,12,2022-03-09,63,63,57,6,1728,1731,1560,171,0,2,2,0,138,138,136,136
Lassen,12,2022-03-09,36,36,33,3,1636,1637,1523,114,1,0,0,0,62,62,62,62
Los Angeles,12,2022-03-09,4931,4938,4809,129,861588,862898,840526,22372,520,155,155,113,31533,31533,31378,31378
Madera,12,2022-03-09,107,107,96,11,3868,3873,3495,378,14,1,1,3,367,367,366,366
Marin,12,2022-03-09,178,178,161,17,7063,7075,6399,676,10,2,2,1,294,294,292,292
Mariposa,12,2022-03-09,10,10,9,1,260,260,233,27,0,1,1,0,27,27,26,26
Mendocino,12,2022-03-09,56,56,49,7,1575,1576,1378,198,3,0,0,0,122,122,122,122
Merced,12,2022-03-09,158,158,146,12,4246,4251,3930,321,17,6,6,4,809,809,803,803
Modoc,12,2022-03-09,1,1,1,0,56,56,52,4,1,0,0,0,7,7,7,7
Mono,12,2022-03-09,2,2,2,0,128,128,109,19,0,0,0,0,6,6,6,6
Monterey,12,2022-03-09,206,206,176,30,10769,10786,9220,1566,16,5,5,2,722,722,717,717
Napa,12,2022-03-09,196,196,183,13,4647,4653,4340,313,5,1,1,3,139,139,138,138
Nevada,12,2022-03-09,54,54,49,5,1624,1625,1470,155,4,1,1,0,126,126,125,125
Orange,12,2022-03-09,1098,1098,1033,65,104791,104951,98786,6165,131,27,27,29,7002,7002,6975,6975
Placer,12,2022-03-09,159,159,142,17,7510,7523,6737,786,62,4,4,10,617,617,613,613
Plumas,12,2022-03-09,7,7,6,1,272,272,246,26,0,0,0,0,13,13,13,13
Riverside,12,2022-03-09,858,858,791,67,52396,52477,48417,4060,122,21,21,22,6412,6412,6391,6391
Sacramento,12,2022-03-09,697,697,639,58,38631,38691,35481,3210,127,18,18,23,3008,3008,2990,2990
San Benito,12,2022-03-09,39,39,36,3,1514,1514,1410,104,0,2,2,2,93,93,91,91
San Bernardino,12,2022-03-09,671,671,628,43,53106,53188,49819,3369,98,39,39,35,7728,7728,7689,7689
San Diego,12,2022-03-09,2215,2220,2159,61,98716,98867,96171,2696,209,26,26,52,5268,5268,5242,5242
San Francisco,12,2022-03-09,636,636,536,100,36084,36138,30455,5683,53,7,7,10,848,848,841,841
San Joaquin,12,2022-03-09,370,370,336,34,20547,20579,18718,1861,26,10,10,15,2230,2230,2220,2220
San Luis Obispo,12,2022-03-09,220,220,204,16,7183,7194,6679,515,6,7,7,0,467,467,460,460
San Mateo,12,2022-03-09,515,515,484,31,38354,38411,36155,2256,30,2,2,3,696,696,694,694
Santa Barbara,12,2022-03-09,193,193,178,15,17559,17586,16194,1392,14,6,6,7,677,677,671,671
Santa Clara,12,2022-03-09,1315,1315,1277,38,107450,107614,104489,3125,137,14,14,33,2267,2267,2253,2253
Santa Cruz,12,2022-03-09,301,301,280,21,23713,23750,22104,1646,9,1,1,6,257,257,256,256
Shasta,12,2022-03-09,118,118,108,10,5099,5107,4689,418,18,4,4,3,546,546,542,542
Siskiyou,12,2022-03-09,20,20,19,1,384,384,358,26,0,2,2,1,81,81,79,79
Solano,12,2022-03-09,307,307,283,24,13354,13374,12332,1042,44,2,2,11,444,444,442,442
Sonoma,12,2022-03-09,273,273,252,21,14659,14682,13575,1107,23,0,0,7,485,485,485,485
Stanislaus,12,2022-03-09,243,243,215,28,10394,10410,9208,1202,84,9,9,13,1664,1664,1655,1655
Sutter,12,2022-03-09,71,71,65,6,1928,1930,1777,153,0,1,1,0,222,222,221,221
Tehama,12,2022-03-09,31,31,28,3,1055,1055,937,118,0,2,2,1,201,201,199,199
Trinity,12,2022-03-09,5,5,4,1,118,118,104,14,0,0,0,0,20,20,20,20
Tulare,12,2022-03-09,246,246,217,29,10097,10114,8925,1189,35,11,11,4,1474,1474,1463,1463
Tuolumne,12,2022-03-09,42,42,38,4,1287,1287,1163,124,2,0,0,1,185,185,185,185
Ventura,12,2022-03-09,377,377,356,21,26473,26513,25073,1440,42,4,4,10,1476,1476,1472,1472
Yolo,12,2022-03-09,148,148,138,10,22016,22051,20497,1554,3,0,0,1,317,317,317,317
Yuba,12,2022-03-09,48,48,44,4,1493,1494,1382,112,17,0,0,2,116,116,116,116
Alameda,13,2022-03-16,732,732,695,37,68207,68315,64922,3393,58,10,10,5,1852,1852,1842,1842
Amador,13,2022-03-16,23,23,21,2,1364,1364,1255,109,3,0,0,0,86,86,86,86
Butte,13,2022-03-16,82,82,79,3,3273,3278,3144,134,18,1,1,0,427,427,426,426
Calaveras,13,2022-03-16,12,12,11,1,756,756,703,53,0,0,0,1,119,119,119,119
Colusa,13,2022-03-16,2,2,2,0,249,249,234,15,2,0,0,0,21,21,21,21
Contra Costa,13,2022-03-16,538,538,494,44,28751,28796,26465,2331,16,6,6,11,1292,1292,1286,1286
Del Norte,13,2022-03-16,31,31,29,2,1286,1286,1204,82,0,1,1,2,49,49,48,48
El Dorado,13,2022-03-16,38,38,35,3,2871,2876,2679,197,3,1,1,0,210,210,209,209
Fresno,13,2022-03-16,446,446,411,35,20759,20791,19194,1597,114,8,8,19,2739,2739,2731,2731
Glenn,13,2022-03-16,11,11,10,1,349,349,326,23,1,0,0,0,42,42,42,42
Humboldt,13,2022-03-16,44,44,41,3,2419,2424,2270,154,4,1,1,2,143,143,142,142
Imperial,13,2022-03-16,58,58,54,4,4086,4091,3804,287,6,1,1,4,940,940,939,939
Inyo,13,2022-03-16,1,1,1,0,160,160,150,10,0,0,0,0,56,56,56,56
Kern,13,2022-03-16,237,237,223,14,20081,20112,18951,1161,39,10,10,8,2330,2330,2320,2320
Kings,13,2022-03-16,121,121,112,9,4549,4555,4241,314,10,1,1,2,443,443,442,442
Lake,13,2022-03-16,33,33,30,3,1491,1492,1375,117,2,1,1,1,139,139,138,138
Lassen,13,2022-03-16,5,5,5,0,1552,1553,1468,85,0,0,0,0,62,62,62,62
Los Angeles,13,2022-03-16,3899,3906,3827,79,841108,842428,825320,17108,410,100,100,85,31633,31633,31533,31533
Madera,13,2022-03-16,47,47,43,4,3465,3470,3201,269,10,0,0,1,367,367,367,367
Marin,13,2022-03-16,147,147,136,11,6640,6651,6150,501,6,0,0,0,294,294,294,294
Mariposa,13,2022-03-16,9,9,8,1,248,248,228,20,0,0,0,0,27,27,27,27
Mendocino,13,2022-03-16,33,33,30,3,1373,1374,1236,138,4,2,2,2,124,124,122,122
Merced,13,2022-03-16,109,109,102,7,4019,4024,3783,241,18,3,3,5,812,812,809,809
Modoc,13,2022-03-16,3,3,3,0,55,55,52,3,0,0,0,0,7,7,7,7
Mono,13,2022-03-16,2,2,2,0,118,118,104,14,1,0,0,0,6,6,6,6
Monterey,13,2022-03-16,146,146,129,17,10143,10160,8976,1184,15,2,2,0,724,724,722,722
Napa,13,2022-03-16,87,87,82,5,3788,3793,3591,202,5,1,1,3,140,140,139,139
Nevada,13,2022-03-16,36,36,33,3,1560,1561,1442,119,1,0,0,0,126,126,126,126
Orange,13,2022-03-16,780,780,744,36,100361,100517,95860,4657,110,26,26,27,7028,7028,7002,7002
Placer,13,2022-03-16,125,125,114,11,6956,6968,6385,583,41,1,1,3,618,618,617,617
Plumas,13,2022-03-16,5,5,5,0,291,291,269,22,0,0,0,0,13,13,13,13
Riverside,13,2022-03-16,719,719,675,44,53782,53866,50568,3298,87,12,12,13,6424,6424,6412,6412
Sacramento,13,2022-03-16,534,534,499,35,33815,33868,31634,2234,117,14,14,18,3022,3022,3008,3008
San Benito,13,2022-03-16,23,23,22,1,1384,1384,1309,75,0,0,0,1,93,93,93,93
San Bernardino,13,2022-03-16,520,520,494,26,50965,51045,48495,2550,69,22,22,34,7750,7750,7728,7728
San Diego,13,2022-03-16,1704,1705,1668,37,90875,91017,89067,1950,171,14,14,41,5282,5282,5268,5268
San Francisco,13,2022-03-16,603,603,527,76,34016,34068,29750,4318,31,5,5,10,853,853,848,848
San Joaquin,13,2022-03-16,253,253,235,18,17191,17217,15970,1247,19,5,5,8,2235,2235,2230,2230
San Luis Obispo,13,2022-03-16,126,126,119,7,6683,6693,6315,378,6,6,6,2,473,473,467,467
San Mateo,13,2022-03-16,408,408,389,19,34811,34865,33248,1617,30,0,0,2,696,696,696,696
Santa Barbara,13,2022-03-16,187,187,175,12,16756,16781,15727,1054,16,4,4,1,681,681,677,677
Santa Clara,13,2022-03-16,976,976,954,22,95192,95342,93179,2163,101,7,7,31,2274,2274,2267,2267
Santa Cruz,13,2022-03-16,243,243,230,13,21863,21899,20697,1202,11,2,2,3,259,259,257,257
Shasta,13,2022-03-16,79,79,74,5,4536,4543,4247,296,17,7,7,1,553,553,546,546
Siskiyou,13,2022-03-16,9,9,9,0,373,373,353,20,1,2,2,0,83,83,81,81
Solano,13,2022-03-16,220,220,206,14,12130,12150,11399,751,27,1,1,5,445,445,444,444
Sonoma,13,2022-03-16,213,213,200,13,13331,13351,12557,794,9,2,2,3,487,487,485,485
Stanislaus,13,2022-03-16,186,186,169,17,8795,8809,7992,817,76,11,11,13,1675,1675,1664,1664
Sutter,13,2022-03-16,32,32,30,2,1578,1579,1479,100,0,1,1,0,223,223,222,222
Tehama,13,2022-03-16,13,13,12,1,998,998,909,89,2,3,3,0,204,204,201,201
Trinity,13,2022-03-16,1,1,1,0,98,98,89,9,0,0,0,0,20,20,20,20
Tulare,13,2022-03-16,145,145,131,14,8863,8877,8041,836,31,2,2,6,1476,1476,1474,1474
Tuolumne,13,2022-03-16,16,16,15,1,1247,1247,1151,96,3,0,0,1,185,185,185,185
Ventura,13,2022-03-16,308,308,295,13,24319,24358,23318,1040,36,7,7,5,1483,1483,1476,1476
Yolo,13,2022-03-16,101,101,95,6,21798,21833,20618,1215,1,2,2,1,319,319,317,317
Yuba,13,2022-03-16,43,43,40,3,1328,1328,1249,79,5,0,0,4,116,116,116,116
Alameda,14,2022-03-23,817,817,785,32,61838,61938,59504,2434,51,3,3,6,1855,1855,1852,1852
Amador,14,2022-03-23,25,25,23,2,1416,1416,1326,90,2,0,0,0,86,86,86,86
Butte,14,2022-03-23,73,73,71,2,3118,3123,3023,100,18,0,0,2,427,427,427,427
Calaveras,14,2022-03-23,8,8,8,0,595,595,562,33,0,0,0,0,119,119,119,119
Colusa,14,2022-03-23,3,3,3,0,222,222,211,11,0,0,0,0,21,21,21,21
Contra Costa,14,2022-03-23,433,433,405,28,25558,25599,23953,1646,35,5,5,4,1297,1297,1292,1292
Del Norte,14,2022-03-23,17,17,16,1,1173,1173,1114,59,0,0,0,0,49,49,49,49
El Dorado,14,2022-03-23,54,54,51,3,2805,2810,2657,153,1,2,2,0,212,212,210,210
Fresno,14,2022-03-23,327,327,307,20,19045,19075,17914,1161,96,10,10,13,2749,2749,2739,2739
Glenn,14,2022-03-23,7,7,7,0,364,364,345,19,0,0,0,0,42,42,42,42
Humboldt,14,2022-03-23,31,31,29,2,2580,2585,2456,129,4,1,1,2,144,144,143,143
Imperial,14,2022-03-23,62,62,59,3,3953,3958,3738,220,4,3,3,3,943,943,940,940
Inyo,14,2022-03-23,2,2,2,0,165,165,157,8,0,0,0,0,56,56,56,56
Kern,14,2022-03-23,197,197,188,9,19026,19057,18190,867,33,6,6,7,2336,2336,2330,2330
Kings,14,2022-03-23,68,68,64,4,4376,4382,4143,239,5,3,3,1,446,446,443,443
Lake,14,2022-03-23,15,15,14,1,1317,1317,1235,82,0,0,0,0,139,139,139,139
Lassen,14,2022-03-23,9,9,9,0,1411,1413,1352,61,0,0,0,0,62,62,62,62
Los Angeles,14,2022-03-23,4343,4350,4281,69,794702,795992,783325,12667,299,71,71,52,31704,31704,31633,31633
Madera,14,2022-03-23,33,33,31,2,3338,3343,3137,206,7,1,1,1,368,368,367,367
Marin,14,2022-03-23,151,151,142,9,5857,5867,5516,351,6,1,1,0,295,295,294,294
Mariposa,14,2022-03-23,7,7,7,0,192,192,179,13,0,0,0,0,27,27,27,27
Mendocino,14,2022-03-23,31,31,29,2,1460,1462,1344,118,4,0,0,1,124,124,124,124
Merced,14,2022-03-23,75,75,71,4,3555,3560,3391,169,13,3,3,2,815,815,812,812
Modoc,14,2022-03-23,3,3,3,0,55,55,53,2,0,0,0,0,7,7,7,7
Mono,14,2022-03-23,3,3,3,0,132,132,119,13,0,0,0,0,6,6,6,6
Monterey,14,2022-03-23,173,173,157,16,9559,9575,8679,896,22,0,0,2,724,724,724,724
Napa,14,2022-03-23,50,50,48,2,3294,3299,3161,138,5,1,1,2,141,141,140,140
Nevada,14,2022-03-23,26,26,24,2,1512,1514,1423,91,0,0,0,0,126,126,126,126
Orange,14,2022-03-23,773,773,745,28,92258,92409,89034,3375,103,14,14,24,7042,7042,7028,7028
Placer,14,2022-03-23,107,107,100,7,6331,6343,5922,421,35,3,3,7,621,621,618,618
Plumas,14,2022-03-23,2,2,2,0,254,254,239,15,0,0,0,0,13,13,13,13
Riverside,14,2022-03-23,539,539,513,26,47552,47628,45304,2324,64,9,9,11,6433,6433,6424,6424
Sacramento,14,2022-03-23,453,453,429,24,32988,33042,31323,1719,84,7,7,13,3029,3029,3022,3022
San Benito,14,2022-03-23,16,16,15,1,1307,1307,1251,56,0,1,1,0,94,94,93,93
San Bernardino,14,2022-03-23,480,480,461,19,45102,45177,43383,1794,54,20,20,26,7770,7770,7750,7750
San Diego,14,2022-03-23,1250,1250,1229,21,78735,78863,77534,1329,124,12,12,36,5294,5294,5282,5282
San Francisco,14,2022-03-23,755,755,679,76,32876,32929,29582,3347,30,3,3,5,856,856,853,853
San Joaquin,14,2022-03-23,194,194,183,11,16416,16443,15513,930,21,8,8,6,2243,2243,2235,2235
San Luis Obispo,14,2022-03-23,102,102,97,5,5833,5841,5579,262,4,4,4,0,477,477,473,473
San Mateo,14,2022-03-23,475,475,458,17,34835,34893,33621,1272,27,2,2,3,698,698,696,696
Santa Barbara,14,2022-03-23,130,130,123,7,11119,11138,10573,565,16,6,6,3,687,687,681,681
Santa Clara,14,2022-03-23,1169,1169,1148,21,90452,90599,88984,1615,99,7,7,21,2281,2281,2274,2274
Santa Cruz,14,2022-03-23,148,148,142,6,19127,19158,18327,831,5,0,0,2,259,259,259,259
Shasta,14,2022-03-23,40,40,38,2,3979,3985,3780,205,7,5,5,2,558,558,553,553
Siskiyou,14,2022-03-23,6,6,6,0,326,326,312,14,1,0,0,0,83,83,83,83
Solano,14,2022-03-23,153,153,146,7,11251,11269,10719,550,23,1,1,7,446,446,445,445
Sonoma,14,2022-03-23,220,220,209,11,9336,9352,8903,449,10,1,1,1,488,488,487,487
Stanislaus,14,2022-03-23,138,138,128,10,8440,8455,7832,623,45,10,10,8,1685,1685,1675,1675
Sutter,14,2022-03-23,29,29,28,1,1533,1534,1458,76,0,1,1,0,224,224,223,223
Tehama,14,2022-03-23,11,11,10,1,890,890,827,63,1,0,0,1,204,204,204,204
Trinity,14,2022-03-23,0,0,0,0,104,104,96,8,0,0,0,0,20,20,20,20
Tulare,14,2022-03-23,96,96,89,7,7957,7971,7374,597,21,4,4,4,1480,1480,1476,1476
Tuolumne,14,2022-03-23,14,14,13,1,1075,1075,1010,65,2,0,0,0,185,185,185,185
Ventura,14,2022-03-23,310,310,300,10,22051,22087,21343,744,26,4,4,5,1487,1487,1483,1483
Yolo,14,2022-03-23,113,113,108,5,19763,19795,18917,878,1,0,0,1,319,319,319,319
Yuba,14,2022-03-23,28,28,27,1,1350,1350,1287,63,6,1,1,1,117,117,116,116
Alameda,15,2022-03-30,861,861,834,27,58869,58967,57153,1814,47,5,5,3,1860,1860,1855,1855
Amador,15,2022-03-30,5,5,5,0,1287,1287,1223,64,3,0,0,0,86,86,86,86
Butte,15,2022-03-30,63,63,61,2,2814,2819,2748,71,8,0,0,2,427,427,427,427
Calaveras,15,2022-03-30,13,13,12,1,593,593,567,26,0,0,0,0,119,119,119,119
Colusa,15,2022-03-30,3,3,3,0,210,210,202,8,0,0,0,0,21,21,21,21
Contra Costa,15,2022-03-30,561,561,532,29,24341,24383,23144,1239,21,0,0,4,1297,1297,1297,1297
Del Norte,15,2022-03-30,11,11,11,0,1137,1138,1093,45,1,0,0,0,49,49,49,49
El Dorado,15,2022-03-30,54,54,52,2,2724,2729,2612,117,0,0,0,0,212,212,212,212
Fresno,15,2022-03-30,233,233,222,11,17788,17818,16962,856,82,7,7,12,2756,2756,2749,2749
Glenn,15,2022-03-30,5,5,5,0,317,317,304,13,0,0,0,0,42,42,42,42
Humboldt,15,2022-03-30,18,18,17,1,2599,2604,2501,103,2,0,0,3,144,144,144,144
Imperial,15,2022-03-30,61,61,58,3,3547,3552,3397,155,3,1,1,3,944,944,943,943
Inyo,15,2022-03-30,6,6,6,0,191,191,184,7,0,0,0,0,56,56,56,56
Kern,15,2022-03-30,147,147,142,5,18074,18104,17456,648,20,2,2,8,2338,2338,2336,2336
Kings,15,2022-03-30,51,51,49,2,4391,4397,4208,189,4,0,0,0,446,446,446,446
Lake,15,2022-03-30,12,12,11,1,1020,1020,970,50,0,0,0,0,139,139,139,139
Lassen,15,2022-03-30,4,4,4,0,1284,1286,1242,44,0,0,0,0,62,62,62,62
Los Angeles,15,2022-03-30,4649,4656,4598,58,738808,740035,730832,9203,261,50,50,47,31754,31754,31704,31704
Madera,15,2022-03-30,27,27,26,1,3421,3426,3259,167,2,0,0,1,368,368,368,368
Marin,15,2022-03-30,155,155,148,7,6217,6229,5935,294,2,0,0,0,295,295,295,295
Mariposa,15,2022-03-30,3,3,3,0,187,187,177,10,0,1,1,0,28,28,27,27
Mendocino,15,2022-03-30,24,24,22,2,1316,1317,1233,84,0,1,1,0,125,125,124,124
Merced,15,2022-03-30,64,64,62,2,3363,3368,3243,125,6,1,1,3,816,816,815,815
Modoc,15,2022-03-30,4,4,4,0,40,40,39,1,0,0,0,0,7,7,7,7
Mono,15,2022-03-30,1,1,1,0,148,148,137,11,0,0,0,0,6,6,6,6
Monterey,15,2022-03-30,128,128,118,10,8206,8220,7604,616,16,3,3,0,727,727,724,724
Napa,15,2022-03-30,62,62,60,2,3351,3356,3246,110,3,2,2,1,143,143,141,141
Nevada,15,2022-03-30,25,25,24,1,1409,1410,1343,67,1,2,2,0,128,128,126,126
Orange,15,2022-03-30,795,795,772,23,90695,90847,88245,2602,73,11,11,16,7053,7053,7042,7042
Placer,15,2022-03-30,113,113,107,6,6328,6339,6008,331,32,3,3,5,624,624,621,621
Plumas,15,2022-03-30,5,5,5,0,229,229,218,11,0,0,0,0,13,13,13,13
Riverside,15,2022-03-30,564,564,542,22,42042,42111,40496,1615,45,9,9,10,6442,6442,6433,6433
Sacramento,15,2022-03-30,423,423,406,17,32742,32797,31457,1340,63,5,5,14,3034,3034,3029,3029
San Benito,15,2022-03-30,9,9,9,0,1331,1331,1286,45,0,0,0,0,94,94,94,94
San Bernardino,15,2022-03-30,550,550,533,17,42337,42407,41094,1313,39,16,16,19,7786,7786,7770,7770
San Diego,15,2022-03-30,1388,1388,1370,18,68849,68963,68055,908,101,8,8,32,5302,5302,5294,5294
San Francisco,15,2022-03-30,859,859,790,69,30897,30948,28430,2518,23,4,4,4,860,860,856,856
San Joaquin,15,2022-03-30,203,203,194,9,16647,16673,15925,748,17,2,2,6,2245,2245,2243,2243
San Luis Obispo,15,2022-03-30,104,104,100,4,5964,5975,5765,210,6,0,0,0,477,477,477,477
San Mateo,15,2022-03-30,556,556,540,16,30949,31001,30109,892,17,2,2,8,700,700,698,698
Santa Barbara,15,2022-03-30,154,154,148,6,13213,13235,12726,509,12,1,1,4,688,688,687,687
Santa Clara,15,2022-03-30,1299,1299,1281,18,94720,94878,93556,1322,88,10,10,19,2291,2291,2281,2281
Santa Cruz,15,2022-03-30,142,142,137,5,20519,20554,19859,695,5,0,0,2,259,259,259,259
Shasta,15,2022-03-30,29,29,28,1,3582,3588,3442,146,4,2,2,5,560,560,558,558
Siskiyou,15,2022-03-30,8,8,8,0,295,295,285,10,0,0,0,0,83,83,83,83
Solano,15,2022-03-30,168,168,162,6,10948,10965,10545,420,16,1,1,6,447,447,446,446
Sonoma,15,2022-03-30,267,267,257,10,10029,10045,9674,371,12,1,1,0,489,489,488,488
Stanislaus,15,2022-03-30,97,97,91,6,8044,8058,7589,469,29,2,2,3,1687,1687,1685,1685
Sutter,15,2022-03-30,29,29,28,1,1355,1355,1302,53,0,0,0,0,224,224,224,224
Tehama,15,2022-03-30,9,9,8,1,762,762,719,43,0,2,2,0,206,206,204,204
Trinity,15,2022-03-30,0,0,0,0,71,71,67,4,0,0,0,0,20,20,20,20
Tulare,15,2022-03-30,66,66,62,4,7965,7979,7506,473,16,5,5,0,1485,1485,1480,1480
Tuolumne,15,2022-03-30,9,9,9,0,1033,1033,983,50,0,0,0,0,185,185,185,185
Ventura,15,2022-03-30,309,309,301,8,21257,21291,20729,562,19,5,5,3,1492,1492,1487,1487
Yolo,15,2022-03-30,99,99,96,3,23922,23961,23147,814,2,2,2,1,321,321,319,319
Yuba,15,2022-03-30,25,25,24,1,1093,1093,1053,40,5,1,1,2,118,118,117,117
Alameda,16,2022-04-06,1224,1224,1195,29,50838,50925,49687,1238,47,3,3,7,1863,1863,1860,1860
Amador,16,2022-04-06,4,4,4,0,1052,1052,1011,41,1,0,0,0,86,86,86,86
Butte,16,2022-04-06,35,35,34,1,2369,2374,2327,47,9,2,2,0,429,429,427,427
Calaveras,16,2022-04-06,11,11,11,0,635,635,614,21,0,0,0,0,119,119,119,119
Colusa,16,2022-04-06,5,5,5,0,193,193,187,6,0,0,0,0,21,21,21,21
Contra Costa,16,2022-04-06,569,569,546,23,21049,21085,20231,854,15,2,2,5,1299,1299,1297,1297
Del Norte,16,2022-04-06,8,8,8,0,988,988,957,31,0,0,0,1,49,49,49,49
El Dorado,16,2022-04-06,53,53,51,2,2595,2600,2512,88,0,1,1,1,213,213,212,212
Fresno,16,2022-04-06,186,186,179,7,16568,16597,15971,626,52,1,1,12,2757,2757,2756,2756
Glenn,16,2022-04-06,3,3,3,0,268,268,259,9,0,0,0,0,42,42,42,42
Humboldt,16,2022-04-06,32,32,31,1,2291,2296,2225,71,7,0,0,2,144,144,144,144
Imperial,16,2022-04-06,21,21,20,1,3391,3396,3279,117,2,0,0,2,944,944,944,944
Inyo,16,2022-04-06,7,7,7,0,179,179,174,5,0,0,0,0,56,56,56,56
Kern,16,2022-04-06,137,137,133,4,16634,16662,16195,467,13,2,2,5,2340,2340,2338,2338
Kings,16,2022-04-06,36,36,35,1,4022,4028,3893,135,4,0,0,1,446,446,446,446
Lake,16,2022-04-06,16,16,15,1,865,865,831,34,0,0,0,0,139,139,139,139
Lassen,16,2022-04-06,4,4,4,0,1260,1262,1229,33,0,0,0,0,62,62,62,62
Los Angeles,16,2022-04-06,5937,5947,5889,58,757375,758670,751289,7381,235,50,50,38,31804,31804,31754,31754
Madera,16,2022-04-06,26,26,25,1,3046,3051,2934,117,3,0,0,1,368,368,368,368
Marin,16,2022-04-06,194,194,187,7,5876,5888,5667,221,4,0,0,0,295,295,295,295
Mariposa,16,2022-04-06,7,7,7,0,238,238,228,10,0,0,0,0,28,28,28,28
Mendocino,16,2022-04-06,31,31,29,2,1161,1162,1104,58,0,0,0,0,125,125,125,125
Merced,16,2022-04-06,57,57,55,2,3239,3244,3149,95,4,2,2,0,818,818,816,816
Modoc,16,2022-04-06,1,1,1,0,49,49,48,1,0,0,0,0,7,7,7,7
Mono,16,2022-04-06,2,2,2,0,117,117,110,7,0,0,0,0,6,6,6,6
Monterey,16,2022-04-06,121,121,114,7,7302,7315,6884,431,11,2,2,0,729,729,727,727
Napa,16,2022-04-06,88,88,86,2,3018,3023,2945,78,2,0,0,1,143,143,143,143
Nevada,16,2022-04-06,32,32,31,1,1468,1469,1414,55,2,0,0,0,128,128,128,128
Orange,16,2022-04-06,1056,1056,1032,24,66385,66498,64979,1519,62,14,14,16,7067,7067,7053,7053
Placer,16,2022-04-06,127,127,122,5,6375,6387,6122,265,18,2,2,4,626,626,624,624
Plumas,16,2022-04-06,2,2,2,0,256,256,246,10,0,0,0,0,13,13,13,13
Riverside,16,2022-04-06,700,700,679,21,38479,38545,37389,1156,38,5,5,8,6447,6447,6442,6442
Sacramento,16,2022-04-06,467,467,452,15,31823,31877,30849,1028,58,10,10,9,3044,3044,3034,3034
San Benito,16,2022-04-06,21,21,20,1,1166,1166,1135,31,0,0,0,0,94,94,94,94
San Bernardino,16,2022-04-06,702,702,685,17,41170,41241,40240,1001,40,11,11,8,7797,7797,7786,7786
San Diego,16,2022-04-06,1698,1701,1684,17,69415,69533,68824,709,94,8,8,28,5310,5310,5302,5302
San Francisco,16,2022-04-06,1109,1109,1038,71,28923,28973,27116,1857,20,7,7,4,867,867,860,860
San Joaquin,16,2022-04-06,230,230,222,8,15233,15260,14722,538,8,2,2,6,2247,2247,2245,2245
San Luis Obispo,16,2022-04-06,98,98,95,3,5116,5124,4983,141,2,2,2,1,479,479,477,477
San Mateo,16,2022-04-06,759,759,742,17,30388,30439,29757,682,12,3,3,2,703,703,700,700
Santa Barbara,16,2022-04-06,217,217,210,7,14952,14977,14517,460,7,2,2,1,690,690,688,688
Santa Clara,16,2022-04-06,1553,1554,1537,17,81203,81343,80455,888,84,0,0,12,2291,2291,2291,2291
Santa Cruz,16,2022-04-06,271,271,264,7,12678,12700,12352,348,9,1,1,1,260,260,259,259
Shasta,16,2022-04-06,24,24,23,1,3348,3353,3246,107,1,0,0,4,560,560,560,560
Siskiyou,16,2022-04-06,3,3,3,0,310,310,302,8,0,0,0,0,83,83,83,83
Solano,16,2022-04-06,218,218,212,6,9696,9712,9419,293,17,0,0,4,447,447,447,447
Sonoma,16,2022-04-06,368,368,357,11,10491,10510,10202,308,4,0,0,0,489,489,489,489
Stanislaus,16,2022-04-06,117,117,112,5,7743,7758,7402,356,18,2,2,4,1689,1689,1687,1687
Sutter,16,2022-04-06,23,23,22,1,1317,1318,1278,40,0,1,1,0,225,225,224,224
Tehama,16,2022-04-06,8,8,8,0,789,789,754,35,0,0,0,0,206,206,206,206
Trinity,16,2022-04-06,1,1,1,0,83,83,79,4,0,0,0,0,20,20,20,20
Tulare,16,2022-04-06,51,51,49,2,7831,7846,7481,365,12,4,4,0,1489,1489,1485,1485
Tuolumne,16,2022-04-06,15,15,14,1,1065,1065,1025,40,0,1,1,0,186,186,185,185
Ventura,16,2022-04-06,302,302,296,6,18713,18745,18355,390,15,4,4,4,1496,1496,1492,1492
Yolo,16,2022-04-06,102,102,99,3,21636,21672,21072,600,0,0,0,0,321,321,321,321
Yuba,16,2022-04-06,11,11,11,0,1042,1042,1012,30,3,0,0,1,118,118,118,118
Alameda,17,2022-04-13,1583,1585,1555,30,52793,52887,51889,998,53,4,4,2,1867,1867,1863,1863
Amador,17,2022-04-13,8,8,8,0,1107,1107,1073,34,1,0,0,0,86,86,86,86
Butte,17,2022-04-13,47,47,46,1,2277,2282,2247,35,7,1,1,1,430,430,429,429
Calaveras,17,2022-04-13,17,17,17,0,633,633,616,17,0,0,0,0,119,119,119,119
Colusa,17,2022-04-13,5,5,5,0,199,199,194,5,0,0,0,0,21,21,21,21
Contra Costa,17,2022-04-13,840,840,814,26,23477,23519,22784,735,21,0,0,3,1299,1299,1299,1299
Del Norte,17,2022-04-13,11,11,11,0,1014,1014,989,25,0,0,0,0,49,49,49,49
El Dorado,17,2022-04-13,56,56,55,1,2474,2479,2413,66,0,0,0,0,213,213,213,213
Fresno,17,2022-04-13,192,192,186,6,14620,14646,14207,439,48,4,4,6,2761,2761,2757,2757
Glenn,17,2022-04-13,2,2,2,0,277,277,270,7,0,0,0,0,42,42,42,42
Humboldt,17,2022-04-13,55,55,54,1,2197,2202,2148,54,6,1,1,2,145,145,144,144
Imperial,17,2022-04-13,30,30,29,1,3524,3529,3434,95,4,1,1,1,945,945,944,944
Inyo,17,2022-04-13,3,3,3,0,171,171,167,4,0,0,0,0,56,56,56,56
Kern,17,2022-04-13,138,138,135,3,14695,14721,14393,328,15,2,2,7,2342,2342,2340,2340
Kings,17,2022-04-13,34,34,33,1,3780,3785,3684,101,2,0,0,0,446,446,446,446
Lake,17,2022-04-13,19,19,18,1,858,858,832,26,0,0,0,1,139,139,139,139
Lassen,17,2022-04-13,1,1,1,0,1300,1302,1275,27,1,0,0,0,62,62,62,62
Los Angeles,17,2022-04-13,7111,7123,7069,54,534840,535778,531603,4175,207,38,38,32,31842,31842,31804,31804
Madera,17,2022-04-13,26,26,25,1,2839,2844,2757,87,4,0,0,1,368,368,368,368
Marin,17,2022-04-13,233,233,226,7,5978,5989,5815,174,4,0,0,1,295,295,295,295
Mariposa,17,2022-04-13,7,7,7,0,242,242,234,8,0,0,0,0,28,28,28,28
Mendocino,17,2022-04-13,32,32,31,1,1139,1139,1094,45,0,0,0,1,125,125,125,125
Merced,17,2022-04-13,70,70,68,2,3168,3173,3100,73,7,2,2,1,820,820,818,818
Modoc,17,2022-04-13,0,0,0,0,38,38,37,1,0,0,0,0,7,7,7,7
Mono,17,2022-04-13,9,9,9,0,193,193,184,9,0,0,0,0,6,6,6,6
Monterey,17,2022-04-13,114,114,109,5,6698,6710,6397,313,9,1,1,0,730,730,729,729
Napa,17,2022-04-13,134,134,131,3,2752,2757,2701,56,4,0,0,0,143,143,143,143
Nevada,17,2022-04-13,40,40,39,1,1294,1295,1256,39,2,0,0,1,128,128,128,128
Orange,17,2022-04-13,1270,1270,1248,22,73464,73594,72318,1276,52,6,6,11,7073,7073,7067,7067
Placer,17,2022-04-13,135,135,131,4,5160,5170,5000,170,20,1,1,4,627,627,626,626
Plumas,17,2022-04-13,8,8,8,0,227,227,220,7,0,0,0,0,13,13,13,13
Riverside,17,2022-04-13,786,786,768,18,37643,37709,36823,886,41,5,5,9,6452,6452,6447,6447
Sacramento,17,2022-04-13,550,550,536,14,28596,28646,27918,728,51,8,8,4,3052,3052,3044,3044
San Benito,17,2022-04-13,12,12,12,0,1191,1191,1166,25,0,0,0,0,94,94,94,94
San Bernardino,17,2022-04-13,968,968,950,18,41756,41830,41032,798,33,6,6,5,7803,7803,7797,7797
San Diego,17,2022-04-13,1868,1872,1857,15,73029,73156,72568,588,88,4,4,21,5314,5314,5310,5310
San Francisco,17,2022-04-13,1219,1219,1157,62,29976,30030,28503,1527,22,2,2,5,869,869,867,867
San Joaquin,17,2022-04-13,221,221,215,6,15193,15220,14797,423,7,0,0,5,2247,2247,2247,2247
San Luis Obispo,17,2022-04-13,136,136,133,3,4916,4925,4819,106,2,0,0,0,479,479,479,479
San Mateo,17,2022-04-13,937,937,920,17,29282,29334,28818,516,9,3,3,3,706,706,703,703
Santa Barbara,17,2022-04-13,317,317,309,8,14836,14861,14502,359,4,1,1,0,691,691,690,690
Santa Clara,17,2022-04-13,1764,1767,1752,15,79047,79185,78510,675,83,7,7,14,2298,2298,2291,2291
Santa Cruz,17,2022-04-13,387,387,379,8,13565,13588,13311,277,3,0,0,1,260,260,260,260
Shasta,17,2022-04-13,20,20,19,1,2920,2925,2851,74,2,1,1,2,561,561,560,560
Siskiyou,17,2022-04-13,1,1,1,0,326,326,319,7,0,0,0,1,83,83,83,83
Solano,17,2022-04-13,218,218,213,5,9499,9516,9291,225,13,0,0,1,447,447,447,447
Sonoma,17,2022-04-13,425,425,415,10,11263,11282,11024,258,13,1,1,1,490,490,489,489
Stanislaus,17,2022-04-13,143,143,138,5,7801,7815,7533,282,14,1,1,4,1690,1690,1689,1689
Sutter,17,2022-04-13,19,19,19,0,1173,1173,1145,28,0,0,0,0,225,225,225,225
Tehama,17,2022-04-13,8,8,8,0,735,735,709,26,0,0,0,0,206,206,206,206
Trinity,17,2022-04-13,0,0,0,0,82,82,79,3,0,0,0,0,20,20,20,20
Tulare,17,2022-04-13,61,61,59,2,7134,7147,6883,264,12,2,2,0,1491,1491,1489,1489
Tuolumne,17,2022-04-13,19,19,18,1,1027,1027,996,31,0,0,0,0,186,186,186,186
Ventura,17,2022-04-13,334,334,329,5,16954,16984,16707,277,13,1,1,1,1497,1497,1496,1496
Yolo,17,2022-04-13,179,179,175,4,19065,19098,18690,408,1,0,0,0,321,321,321,321
Yuba,17,2022-04-13,18,18,18,0,1007,1007,984,23,1,0,0,0,118,118,118,118
Alameda,18,2022-04-20,1987,1990,1961,29,54038,54135,53333,802,42,4,4,5,1871,1871,1867,1867
Amador,18,2022-04-20,15,15,15,0,1258,1259,1229,30,0,0,0,1,86,86,86,86
Butte,18,2022-04-20,34,34,34,0,2354,2358,2330,28,7,1,1,1,431,431,430,430
Calaveras,18,2022-04-20,16,16,16,0,609,609,596,13,0,1,1,0,120,120,119,119
Colusa,18,2022-04-20,2,2,2,0,160,160,157,3,0,0,0,0,21,21,21,21
Contra Costa,18,2022-04-20,1206,1206,1176,30,25009,25055,24437,618,27,2,2,4,1301,1301,1299,1299
Del Norte,18,2022-04-20,17,17,17,0,1028,1028,1008,20,0,0,0,0,49,49,49,49
El Dorado,18,2022-04-20,76,76,74,2,2562,2567,2514,53,1,0,0,0,213,213,213,213
Fresno,18,2022-04-20,290,290,283,7,15269,15297,14942,355,39,4,4,4,2765,2765,2761,2761
Glenn,18,2022-04-20,4,4,4,0,270,270,265,5,0,0,0,0,42,42,42,42
Humboldt,18,2022-04-20,149,149,146,3,2319,2324,2280,44,4,1,1,2,146,146,145,145
Imperial,18,2022-04-20,59,59,58,1,3303,3308,3238,70,3,0,0,1,945,945,945,945
Inyo,18,2022-04-20,5,5,5,0,177,177,174,3,0,0,0,0,56,56,56,56
Kern,18,2022-04-20,185,185,182,3,15822,15850,15578,272,10,1,1,6,2343,2343,2342,2342
Kings,18,2022-04-20,51,51,50,1,4167,4174,4088,86,1,1,1,0,447,447,446,446
Lake,18,2022-04-20,19,19,19,0,766,766,748,18,3,1,1,0,140,140,139,139
Lassen,18,2022-04-20,1,1,1,0,1409,1411,1388,23,0,0,0,0,62,62,62,62
Los Angeles,18,2022-04-20,9458,9474,9418,56,656336,657527,653749,3778,202,36,36,22,31878,31878,31842,31842
Madera,18,2022-04-20,26,26,25,1,2739,2744,2679,65,4,0,0,1,368,368,368,368
Marin,18,2022-04-20,325,325,318,7,5849,5859,5724,135,8,0,0,0,295,295,295,295
Mariposa,18,2022-04-20,19,19,19,0,251,251,245,6,0,0,0,0,28,28,28,28
Mendocino,18,2022-04-20,66,66,64,2,1310,1312,1271,41,2,1,1,0,126,126,125,125
Merced,18,2022-04-20,72,72,71,1,2986,2991,2937,54,4,2,2,0,822,822,820,820
Modoc,18,2022-04-20,2,2,2,0,37,37,36,1,0,0,0,0,7,7,7,7
Mono,18,2022-04-20,9,9,9,0,105,105,101,4,0,0,0,0,6,6,6,6
Monterey,18,2022-04-20,206,206,199,7,6813,6827,6579,248,3,1,1,0,731,731,730,730
Napa,18,2022-04-20,182,182,179,3,3103,3108,3059,49,0,0,0,0,143,143,143,143
Nevada,18,2022-04-20,50,50,49,1,1354,1355,1324,31,1,0,0,0,128,128,128,128
Orange,18,2022-04-20,1551,1554,1533,21,80076,80222,79120,1102,48,7,7,15,7080,7080,7073,7073
Placer,18,2022-04-20,181,181,176,5,5324,5334,5199,135,20,0,0,3,627,627,627,627
Plumas,18,2022-04-20,3,3,3,0,230,230,225,5,0,0,0,0,13,13,13,13
Riverside,18,2022-04-20,1051,1051,1032,19,37955,38025,37327,698,46,6,6,6,6458,6458,6452,6452
Sacramento,18,2022-04-20,826,826,810,16,29919,29973,29380,593,49,8,8,8,3060,3060,3052,3052
San Benito,18,2022-04-20,30,30,30,0,1155,1156,1137,19,0,0,0,0,94,94,94,94
San Bernardino,18,2022-04-20,1163,1163,1146,17,40185,40258,39661,597,27,7,7,10,7810,7810,7803,7803
San Diego,18,2022-04-20,2330,2334,2320,14,67594,67716,67294,422,80,8,8,10,5322,5322,5314,5314
San Francisco,18,2022-04-20,1644,1647,1582,65,31096,31153,29904,1249,22,0,0,5,869,869,869,869
San Joaquin,18,2022-04-20,291,291,285,6,15132,15160,14831,329,12,1,1,3,2248,2248,2247,2247
San Luis Obispo,18,2022-04-20,188,188,185,3,4849,4856,4774,82,4,2,2,0,481,481,479,479
San Mateo,18,2022-04-20,1232,1232,1215,17,31525,31582,31148,434,11,0,0,1,706,706,706,706
Santa Barbara,18,2022-04-20,329,329,323,6,14792,14818,14537,281,9,0,0,0,691,691,691,691
Santa Clara,18,2022-04-20,2458,2463,2447,16,67227,67349,66902,447,72,2,2,14,2300,2300,2298,2298
Santa Cruz,18,2022-04-20,422,422,415,7,13270,13294,13085,209,2,1,1,1,261,261,260,260
Shasta,18,2022-04-20,46,46,45,1,2965,2970,2912,58,4,1,1,2,562,562,561,561
Siskiyou,18,2022-04-20,10,10,10,0,343,343,338,5,0,0,0,0,83,83,83,83
Solano,18,2022-04-20,334,334,328,6,9560,9577,9400,177,6,1,1,2,448,448,447,447
Sonoma,18,2022-04-20,577,577,567,10,11317,11338,11135,203,15,1,1,3,491,491,490,490
Stanislaus,18,2022-04-20,164,164,159,5,7536,7550,7335,215,24,0,0,3,1690,1690,1690,1690
Sutter,18,2022-04-20,20,20,20,0,1224,1224,1201,23,0,0,0,0,225,225,225,225
Tehama,18,2022-04-20,9,9,9,0,642,642,624,18,2,0,0,0,206,206,206,206
Trinity,18,2022-04-20,2,2,2,0,78,78,76,2,0,0,0,0,20,20,20,20
Tulare,18,2022-04-20,82,82,80,2,6763,6776,6581,195,11,0,0,0,1491,1491,1491,1491
Tuolumne,18,2022-04-20,29,29,28,1,1089,1089,1064,25,0,1,1,0,187,187,186,186
Ventura,18,2022-04-20,444,444,438,6,17145,17176,16959,217,11,4,4,0,1501,1501,1497,1497
Yolo,18,2022-04-20,243,243,239,4,18228,18260,17955,305,1,1,1,0,322,322,321,321
Yuba,18,2022-04-20,36,36,35,1,1063,1063,1044,19,0,0,0,0,118,118,118,118
Alameda,19,2022-04-27,2810,2815,2783,32,66188,66313,65549,764,39,6,6,5,1877,1877,1871,1871
Amador,19,2022-04-27,27,27,26,1,1312,1313,1288,25,0,0,0,0,86,86,86,86
Butte,19,2022-04-27,87,87,86,1,2549,2554,2530,24,3,1,1,1,432,432,431,431
Calaveras,19,2022-04-27,34,34,33,1,708,708,697,11,1,0,0,0,120,120,120,120
Colusa,19,2022-04-27,2,2,2,0,225,225,222,3,0,0,0,0,21,21,21,21
Contra Costa,19,2022-04-27,1557,1560,1530,30,28079,28132,27589,543,28,3,3,4,1304,1304,1301,1301
Del Norte,19,2022-04-27,32,32,32,0,1143,1143,1126,17,0,0,0,1,49,49,49,49
El Dorado,19,2022-04-27,114,114,112,2,2669,2674,2630,44,0,0,0,1,213,213,213,213
Fresno,19,2022-04-27,406,406,399,7,16449,16478,16178,300,34,2,2,4,2767,2767,2765,2765
Glenn,19,2022-04-27,3,3,3,0,276,276,272,4,0,0,0,0,42,42,42,42
Humboldt,19,2022-04-27,175,175,172,3,2848,2853,2810,43,3,0,0,2,146,146,146,146
Imperial,19,2022-04-27,85,85,84,1,3595,3602,3543,59,3,0,0,1,945,945,945,945
Inyo,19,2022-04-27,4,4,4,0,194,194,191,3,0,0,0,0,56,56,56,56
Kern,19,2022-04-27,258,258,255,3,17938,17973,17730,243,11,2,2,4,2345,2345,2343,2343
Kings,19,2022-04-27,50,50,49,1,4599,4608,4533,75,3,0,0,1,447,447,447,447
Lake,19,2022-04-27,23,23,23,0,979,979,961,18,0,0,0,0,140,140,140,140
Lassen,19,2022-04-27,7,7,7,0,1565,1567,1547,20,0,0,0,0,62,62,62,62
Los Angeles,19,2022-04-27,12548,12572,12514,58,914264,915993,911771,4222,219,26,26,30,31904,31904,31878,31878
Madera,19,2022-04-27,54,54,53,1,3013,3018,2962,56,2,0,0,0,368,368,368,368
Marin,19,2022-04-27,332,332,326,6,6437,6450,6334,116,4,0,0,0,295,295,295,295
Mariposa,19,2022-04-27,7,7,7,0,225,225,221,4,0,0,0,0,28,28,28,28
Mendocino,19,2022-04-27,44,44,43,1,1230,1230,1200,30,0,1,1,0,127,127,126,126
Merced,19,2022-04-27,105,105,104,1,3161,3166,3122,44,4,0,0,0,822,822,822,822
Modoc,19,2022-04-27,0,0,0,0,39,39,38,1,0,0,0,0,7,7,7,7
Mono,19,2022-04-27,3,3,3,0,86,86,83,3,0,0,0,0,6,6,6,6
Monterey,19,2022-04-27,321,321,312,9,8309,8325,8086,239,8,1,1,0,732,732,731,731
Napa,19,2022-04-27,212,212,209,3,3444,3449,3406,43,5,0,0,0,143,143,143,143
Nevada,19,2022-04-27,51,51,50,1,1476,1479,1452,27,2,0,0,0,128,128,128,128
Orange,19,2022-04-27,2218,2222,2198,24,88124,88291,87341,950,58,6,6,12,7086,7086,7080,7080
Placer,19,2022-04-27,239,239,234,5,6051,6064,5943,121,22,0,0,4,627,627,627,627
Plumas,19,2022-04-27,4,4,4,0,253,253,248,5,1,0,0,0,13,13,13,13
Riverside,19,2022-04-27,1481,1484,1463,21,41353,41431,40836,595,38,3,3,7,6461,6461,6458,6458
Sacramento,19,2022-04-27,1087,1087,1070,17,31871,31931,31435,496,44,5,5,9,3065,3065,3060,3060
San Benito,19,2022-04-27,34,34,34,0,1105,1106,1092,14,0,0,0,0,94,94,94,94
San Bernardino,19,2022-04-27,1305,1305,1290,15,43137,43217,42714,503,30,10,10,6,7820,7820,7810,7810
San Diego,19,2022-04-27,3426,3432,3415,17,74078,74219,73856,363,92,2,2,11,5324,5324,5322,5322
San Francisco,19,2022-04-27,2102,2106,2040,66,33571,33635,32579,1056,29,1,1,4,870,870,869,869
San Joaquin,19,2022-04-27,428,428,421,7,14785,14812,14560,252,12,1,1,3,2249,2249,2248,2248
San Luis Obispo,19,2022-04-27,222,222,219,3,5113,5123,5055,68,4,0,0,0,481,481,481,481
San Mateo,19,2022-04-27,1590,1593,1576,17,34650,34716,34344,372,12,2,2,4,708,708,706,706
Santa Barbara,19,2022-04-27,369,369,364,5,15478,15507,15278,229,10,2,2,3,693,693,691,691
Santa Clara,19,2022-04-27,3471,3478,3460,18,86002,86164,85722,442,68,4,4,11,2304,2304,2300,2300
Santa Cruz,19,2022-04-27,555,555,548,7,21149,21189,20919,270,7,0,0,0,261,261,261,261
Shasta,19,2022-04-27,55,55,54,1,3400,3406,3354,52,2,0,0,1,562,562,562,562
Siskiyou,19,2022-04-27,7,7,7,0,309,309,305,4,0,0,0,0,83,83,83,83
Solano,19,2022-04-27,543,543,535,8,11103,11125,10964,161,14,0,0,3,448,448,448,448
Sonoma,19,2022-04-27,699,699,689,10,12237,12259,12087,172,13,0,0,1,491,491,491,491
Stanislaus,19,2022-04-27,264,264,258,6,8088,8103,7923,180,20,3,3,1,1693,1693,1690,1690
Sutter,19,2022-04-27,50,50,49,1,1351,1352,1332,20,0,2,2,0,227,227,225,225
Tehama,19,2022-04-27,21,21,21,0,711,711,696,15,1,0,0,0,206,206,206,206
Trinity,19,2022-04-27,1,1,1,0,64,64,63,1,0,0,0,0,20,20,20,20
Tulare,19,2022-04-27,112,112,110,2,7067,7081,6921,160,9,2,2,0,1493,1493,1491,1491
Tuolumne,19,2022-04-27,62,62,61,1,1151,1151,1130,21,2,0,0,0,187,187,187,187
Ventura,19,2022-04-27,639,639,633,6,19658,19695,19500,195,15,2,2,2,1503,1503,1501,1501
Yolo,19,2022-04-27,291,291,287,4,19400,19436,19182,254,1,0,0,1,322,322,322,322
Yuba,19,2022-04-27,27,27,27,0,1073,1073,1058,15,1,0,0,1,118,118,118,118
Alameda,20,2022-05-04,3580,3587,3555,32,67392,67526,66915,611,45,1,1,7,1878,1878,1877,1877
Amador,20,2022-05-04,19,19,19,0,1405,1407,1386,21,1,0,0,0,86,86,86,86
Butte,20,2022-05-04,97,97,96,1,2338,2343,2326,17,3,2,2,0,434,434,432,432
Calaveras,20,2022-05-04,24,24,24,0,673,673,664,9,1,0,0,0,120,120,120,120
Colusa,20,2022-05-04,3,3,3,0,194,194,192,2,0,0,0,0,21,21,21,21
Contra Costa,20,2022-05-04,2117,2122,2090,32,29171,29230,28788,442,33,3,3,7,1307,1307,1304,1304
Del Norte,20,2022-05-04,38,38,38,0,1237,1237,1222,15,0,0,0,0,49,49,49,49
El Dorado,20,2022-05-04,140,140,138,2,2767,2772,2737,35,1,1,1,0,214,214,213,213
Fresno,20,2022-05-04,549,549,541,8,17457,17492,17242,250,31,4,4,1,2771,2771,2767,2767
Glenn,20,2022-05-04,7,7,7,0,242,242,239,3,0,0,0,0,42,42,42,42
Humboldt,20,2022-05-04,282,282,279,3,3250,3255,3217,38,6,0,0,2,146,146,146,146
Imperial,20,2022-05-04,117,117,115,2,3648,3655,3608,47,1,0,0,1,945,945,945,945
Inyo,20,2022-05-04,5,5,5,0,194,194,192,2,0,0,0,0,56,56,56,56
Kern,20,2022-05-04,363,363,359,4,18119,18156,17964,192,14,1,1,3,2346,2346,2345,2345
Kings,20,2022-05-04,72,72,71,1,4921,4930,4867,63,3,0,0,0,447,447,447,447
Lake,20,2022-05-04,27,27,27,0,1019,1019,1004,15,1,0,0,0,140,140,140,140
Lassen,20,2022-05-04,3,3,3,0,1657,1659,1642,17,0,0,0,0,62,62,62,62
Los Angeles,20,2022-05-04,16199,16232,16174,58,911974,913790,910497,3293,207,21,21,37,31925,31925,31904,31904
Madera,20,2022-05-04,102,102,101,1,3487,3494,3443,51,4,0,0,0,368,368,368,368
Marin,20,2022-05-04,545,545,537,8,6937,6951,6854,97,10,0,0,0,295,295,295,295
Mariposa,20,2022-05-04,20,20,20,0,223,223,220,3,0,0,0,0,28,28,28,28
Mendocino,20,2022-05-04,79,79,78,1,1263,1264,1240,24,1,1,1,1,128,128,127,127
Merced,20,2022-05-04,152,152,150,2,3240,3245,3209,36,3,4,4,0,826,826,822,822
Modoc,20,2022-05-04,2,2,2,0,36,37,36,1,0,0,0,0,7,7,7,7
Mono,20,2022-05-04,10,10,10,0,115,115,112,3,0,0,0,0,6,6,6,6
Monterey,20,2022-05-04,392,392,383,9,8854,8871,8672,199,9,1,1,0,733,733,732,732
Napa,20,2022-05-04,230,230,228,2,3404,3409,3376,33,0,0,0,0,143,143,143,143
Nevada,20,2022-05-04,94,94,93,1,1576,1579,1557,22,1,0,0,0,128,128,128,128
Orange,20,2022-05-04,2881,2888,2864,24,89764,89942,89188,754,72,7,7,18,7093,7093,7086,7086
Placer,20,2022-05-04,387,387,381,6,6569,6582,6479,103,15,0,0,5,627,627,627,627
Plumas,20,2022-05-04,11,11,11,0,251,251,247,4,0,0,0,0,13,13,13,13
Riverside,20,2022-05-04,2226,2231,2206,25,43768,43855,43363,492,32,3,3,6,6464,6464,6461,6461
Sacramento,20,2022-05-04,1600,1603,1584,19,34603,34671,34250,421,54,5,5,11,3070,3070,3065,3065
San Benito,20,2022-05-04,64,64,63,1,1405,1408,1394,14,0,0,0,0,94,94,94,94
San Bernardino,20,2022-05-04,1608,1611,1596,15,44113,44200,43799,401,41,6,6,10,7826,7826,7820,7820
San Diego,20,2022-05-04,4497,4507,4490,17,79438,79596,79295,301,91,4,4,13,5328,5328,5324,5324
San Francisco,20,2022-05-04,2561,2567,2504,63,36386,36457,35557,900,37,4,4,12,874,874,870,870
San Joaquin,20,2022-05-04,599,599,591,8,15180,15211,15008,203,11,0,0,2,2249,2249,2249,2249
San Luis Obispo,20,2022-05-04,271,271,268,3,5212,5223,5169,54,1,2,2,0,483,483,481,481
San Mateo,20,2022-05-04,1923,1926,1910,16,36271,36343,36038,305,20,2,2,4,710,710,708,708
Santa Barbara,20,2022-05-04,507,507,501,6,15228,15258,15081,177,8,0,0,2,693,693,693,693
Santa Clara,20,2022-05-04,4852,4862,4842,20,99953,100152,99748,404,63,4,4,16,2308,2308,2304,2304
Santa Cruz,20,2022-05-04,654,654,648,6,22597,22641,22415,226,3,1,1,0,262,262,261,261
Shasta,20,2022-05-04,81,81,80,1,3461,3467,3425,42,6,0,0,1,562,562,562,562
Siskiyou,20,2022-05-04,11,11,11,0,319,319,316,3,0,0,0,1,83,83,83,83
Solano,20,2022-05-04,733,733,725,8,12108,12132,11994,138,18,0,0,0,448,448,448,448
Sonoma,20,2022-05-04,1033,1033,1022,11,13146,13172,13028,144,18,1,1,3,492,492,491,491
Stanislaus,20,2022-05-04,316,316,310,6,8309,8326,8181,145,22,0,0,2,1693,1693,1693,1693
Sutter,20,2022-05-04,46,46,45,1,1462,1464,1447,17,0,0,0,0,227,227,227,227
Tehama,20,2022-05-04,17,17,17,0,679,679,668,11,1,0,0,0,206,206,206,206
Trinity,20,2022-05-04,2,2,2,0,81,81,80,1,0,0,0,0,20,20,20,20
Tulare,20,2022-05-04,162,162,159,3,7419,7435,7303,132,10,3,3,0,1496,1496,1493,1493
Tuolumne,20,2022-05-04,83,83,82,1,1310,1312,1293,19,3,0,0,0,187,187,187,187
Ventura,20,2022-05-04,856,856,849,7,20177,20217,20061,156,12,1,1,3,1504,1504,1503,1503
Yolo,20,2022-05-04,379,379,375,4,18628,18666,18475,191,0,1,1,0,323,323,322,322
Yuba,20,2022-05-04,51,51,50,1,1130,1131,1119,12,3,0,0,0,118,118,118,118
Alameda,21,2022-05-11,4451,4461,4429,32,73000,73153,72635,518,59,9,9,5,1887,1887,1878,1878
Amador,21,2022-05-11,29,29,29,0,1529,1532,1514,18,0,0,0,0,86,86,86,86
Butte,21,2022-05-11,127,127,126,1,2448,2453,2439,14,4,0,0,0,434,434,434,434
Calaveras,21,2022-05-11,35,35,35,0,741,741,734,7,0,0,0,1,120,120,120,120
Colusa,21,2022-05-11,4,4,4,0,210,210,208,2,0,0,0,0,21,21,21,21
Contra Costa,21,2022-05-11,2704,2710,2678,32,32100,32166,31785,381,43,3,3,7,1310,1310,1307,1307
Del Norte,21,2022-05-11,99,99,98,1,1550,1553,1539,14,0,0,0,1,49,49,49,49
El Dorado,21,2022-05-11,203,203,201,2,3064,3069,3038,31,2,0,0,0,214,214,214,214
Fresno,21,2022-05-11,836,836,827,9,18360,18398,18193,205,39,1,1,4,2772,2772,2771,2771
Glenn,21,2022-05-11,10,10,10,0,238,238,236,2,0,0,0,0,42,42,42,42
Humboldt,21,2022-05-11,275,275,272,3,3142,3147,3118,29,8,0,0,2,146,146,146,146
Imperial,21,2022-05-11,164,164,162,2,3988,3995,3955,40,1,0,0,1,945,945,945,945
Inyo,21,2022-05-11,28,28,28,0,220,220,218,2,0,0,0,0,56,56,56,56
Kern,21,2022-05-11,503,503,499,4,18960,18999,18842,157,16,2,2,2,2348,2348,2346,2346
Kings,21,2022-05-11,124,124,123,1,5074,5084,5034,50,0,0,0,0,447,447,447,447
Lake,21,2022-05-11,35,35,35,0,1028,1029,1017,12,0,0,0,0,140,140,140,140
Lassen,21,2022-05-11,12,12,12,0,1679,1683,1670,13,0,0,0,0,62,62,62,62
Los Angeles,21,2022-05-11,19029,19069,19015,54,930750,932691,930071,2620,242,36,36,25,31961,31961,31925,31925
Madera,21,2022-05-11,149,149,147,2,3754,3761,3718,43,3,0,0,0,368,368,368,368
Marin,21,2022-05-11,703,703,695,8,8089,8105,8016,89,12,0,0,0,295,295,295,295
Mariposa,21,2022-05-11,24,24,24,0,337,337,333,4,0,0,0,0,28,28,28,28
Mendocino,21,2022-05-11,82,82,81,1,1249,1251,1232,19,1,0,0,0,128,128,128,128
Merced,21,2022-05-11,225,225,223,2,3706,3713,3681,32,2,1,1,0,827,827,826,826
Modoc,21,2022-05-11,0,0,0,0,45,46,45,1,0,0,0,0,7,7,7,7
Mono,21,2022-05-11,11,11,11,0,115,115,113,2,0,0,0,0,6,6,6,6
Monterey,21,2022-05-11,467,467,459,8,9351,9371,9206,165,9,0,0,0,733,733,733,733
Napa,21,2022-05-11,246,246,244,2,3240,3245,3220,25,1,0,0,0,143,143,143,143
Nevada,21,2022-05-11,120,120,119,1,1625,1628,1610,18,6,0,0,0,128,128,128,128
Orange,21,2022-05-11,3816,3823,3798,25,91876,92069,91466,603,73,6,6,14,7099,7099,7093,7093
Placer,21,2022-05-11,560,560,553,7,7028,7043,6957,86,29,0,0,2,627,627,627,627
Plumas,21,2022-05-11,26,26,26,0,263,263,260,3,0,0,0,0,13,13,13,13
Riverside,21,2022-05-11,2557,2563,2540,23,45569,45664,45263,401,55,4,4,5,6468,6468,6464,6464
Sacramento,21,2022-05-11,2551,2557,2533,24,37585,37663,37305,358,65,4,4,14,3074,3074,3070,3070
San Benito,21,2022-05-11,84,84,83,1,1469,1472,1461,11,0,0,0,1,94,94,94,94
San Bernardino,21,2022-05-11,2063,2068,2053,15,46849,46948,46614,334,41,5,5,4,7831,7831,7826,7826
San Diego,21,2022-05-11,5512,5524,5508,16,89177,89363,89098,265,90,2,2,20,5330,5330,5328,5328
San Francisco,21,2022-05-11,3234,3241,3178,63,39073,39155,38398,757,58,6,6,6,880,880,874,874
San Joaquin,21,2022-05-11,916,916,907,9,16981,17017,16840,177,16,0,0,0,2249,2249,2249,2249
San Luis Obispo,21,2022-05-11,318,318,315,3,5441,5454,5410,44,2,0,0,1,483,483,483,483
San Mateo,21,2022-05-11,2434,2440,2424,16,37231,37310,37065,245,27,2,2,1,712,712,710,710
Santa Barbara,21,2022-05-11,694,694,688,6,15699,15730,15588,142,12,0,0,2,693,693,693,693
Santa Clara,21,2022-05-11,6030,6042,6023,19,107246,107470,107132,338,99,4,4,23,2312,2312,2308,2308
Santa Cruz,21,2022-05-11,778,778,772,6,24216,24267,24078,189,2,0,0,0,262,262,262,262
Shasta,21,2022-05-11,101,101,100,1,3412,3419,3387,32,8,0,0,0,562,562,562,562
Siskiyou,21,2022-05-11,19,19,19,0,318,318,316,2,0,0,0,0,83,83,83,83
Solano,21,2022-05-11,929,929,921,8,12806,12833,12720,113,18,0,0,2,448,448,448,448
Sonoma,21,2022-05-11,1315,1317,1306,11,14739,14769,14642,127,22,1,1,1,493,493,492,492
Stanislaus,21,2022-05-11,523,523,516,7,9255,9274,9148,126,22,1,1,3,1694,1694,1693,1693
Sutter,21,2022-05-11,81,81,80,1,1613,1616,1601,15,0,0,0,0,227,227,227,227
Tehama,21,2022-05-11,24,24,24,0,727,727,717,10,1,0,0,0,206,206,206,206
Trinity,21,2022-05-11,2,2,2,0,75,75,74,1,0,0,0,0,20,20,20,20
Tulare,21,2022-05-11,221,221,218,3,7764,7780,7672,108,9,1,1,3,1497,1497,1496,1496
Tuolumne,21,2022-05-11,72,72,71,1,1424,1426,1410,16,1,2,2,0,189,189,187,187
Ventura,21,2022-05-11,1254,1254,1246,8,22153,22200,22066,134,14,0,0,2,1504,1504,1504,1504
Yolo,21,2022-05-11,558,558,554,4,20802,20846,20680,166,4,0,0,0,323,323,323,323
Yuba,21,2022-05-11,91,91,90,1,1225,1226,1216,10,5,0,0,0,118,118,118,118
Alameda,22,2022-05-18,5264,5276,5247,29,75957,76123,75702,421,73,6,6,3,1893,1893,1887,1887
Amador,22,2022-05-18,63,63,62,1,1653,1657,1642,15,0,0,0,0,86,86,86,86
Butte,22,2022-05-18,264,264,263,1,2877,2882,2869,13,4,2,2,0,436,436,434,434
Calaveras,22,2022-05-18,46,46,46,0,760,760,754,6,0,1,1,1,121,121,120,120
Colusa,22,2022-05-18,7,7,7,0,230,230,228,2,0,0,0,0,21,21,21,21
Contra Costa,22,2022-05-18,3806,3814,3779,35,34210,34285,33968,317,53,8,8,10,1318,1318,1310,1310
Del Norte,22,2022-05-18,138,138,137,1,1740,1744,1731,13,0,1,1,0,50,50,49,49
El Dorado,22,2022-05-18,307,307,305,2,3112,3117,3093,24,5,1,1,0,215,215,214,214
Fresno,22,2022-05-18,1331,1334,1322,12,20316,20361,20184,177,47,2,2,5,2774,2774,2772,2772
Glenn,22,2022-05-18,17,17,17,0,266,266,264,2,0,0,0,0,42,42,42,42
Humboldt,22,2022-05-18,270,270,268,2,2958,2963,2942,21,10,1,1,3,147,147,146,146
Imperial,22,2022-05-18,246,246,244,2,4442,4452,4417,35,3,0,0,3,945,945,945,945
Inyo,22,2022-05-18,20,20,20,0,243,243,241,2,2,0,0,0,56,56,56,56
Kern,22,2022-05-18,790,790,785,5,20209,20254,20123,131,17,2,2,3,2350,2350,2348,2348
Kings,22,2022-05-18,253,253,251,2,5551,5564,5521,43,0,0,0,0,447,447,447,447
Lake,22,2022-05-18,83,83,82,1,1252,1255,1244,11,1,0,0,0,140,140,140,140
Lassen,22,2022-05-18,23,23,23,0,1729,1733,1722,11,1,0,0,0,62,62,62,62
Los Angeles,22,2022-05-18,23820,23872,23820,52,937389,939438,937379,2059,326,34,34,53,31995,31995,31961,31961
Madera,22,2022-05-18,191,191,189,2,3604,3611,3579,32,3,0,0,1,368,368,368,368
Marin,22,2022-05-18,880,880,872,8,8525,8542,8469,73,14,0,0,1,295,295,295,295
Mariposa,22,2022-05-18,24,24,24,0,344,344,341,3,0,0,0,0,28,28,28,28
Mendocino,22,2022-05-18,127,127,126,1,1520,1522,1504,18,4,1,1,0,129,129,128,128
Merced,22,2022-05-18,366,366,364,2,4032,4040,4013,27,5,1,1,0,828,828,827,827
Modoc,22,2022-05-18,4,4,4,0,41,42,41,1,0,0,0,0,7,7,7,7
Mono,22,2022-05-18,12,12,12,0,132,132,130,2,0,0,0,0,6,6,6,6
Monterey,22,2022-05-18,578,578,570,8,9603,9623,9490,133,8,2,2,1,735,735,733,733
Napa,22,2022-05-18,311,311,309,2,3870,3878,3855,23,2,0,0,0,143,143,143,143
Nevada,22,2022-05-18,146,146,145,1,1875,1880,1864,16,1,0,0,1,128,128,128,128
Orange,22,2022-05-18,4927,4937,4912,25,95132,95340,94852,488,102,10,10,12,7109,7109,7099,7099
Placer,22,2022-05-18,835,835,827,8,7938,7956,7880,76,40,2,2,2,629,629,627,627
Plumas,22,2022-05-18,47,47,47,0,264,264,262,2,0,0,0,0,13,13,13,13
Riverside,22,2022-05-18,3804,3814,3788,26,48835,48941,48605,336,68,1,1,7,6469,6469,6468,6468
Sacramento,22,2022-05-18,3485,3493,3467,26,41350,41440,41133,307,100,8,8,8,3082,3082,3074,3074
San Benito,22,2022-05-18,130,130,129,1,1537,1541,1532,9,1,0,0,0,94,94,94,94
San Bernardino,22,2022-05-18,2746,2753,2738,15,49283,49391,49117,274,38,6,6,8,7837,7837,7831,7831
San Diego,22,2022-05-18,7737,7752,7734,18,98765,98981,98752,229,110,4,4,24,5334,5334,5330,5330
San Francisco,22,2022-05-18,3576,3585,3531,54,39653,39739,39138,601,68,4,4,8,884,884,880,880
San Joaquin,22,2022-05-18,1378,1381,1370,11,19772,19814,19653,161,18,2,2,3,2251,2251,2249,2249
San Luis Obispo,22,2022-05-18,492,492,489,3,6387,6401,6361,40,5,0,0,0,483,483,483,483
San Mateo,22,2022-05-18,2987,2994,2979,15,41027,41117,40906,211,39,1,1,1,713,713,712,712
Santa Barbara,22,2022-05-18,1009,1010,1003,7,17364,17403,17280,123,18,0,0,4,693,693,693,693
Santa Clara,22,2022-05-18,7508,7525,7507,18,111195,111438,111164,274,102,9,9,24,2321,2321,2312,2312
Santa Cruz,22,2022-05-18,697,697,693,4,15724,15758,15658,100,4,0,0,0,262,262,262,262
Shasta,22,2022-05-18,166,166,165,1,3766,3775,3747,28,7,1,1,1,563,563,562,562
Siskiyou,22,2022-05-18,18,18,18,0,355,355,353,2,0,0,0,0,83,83,83,83
Solano,22,2022-05-18,1467,1470,1460,10,14587,14618,14517,101,32,0,0,2,448,448,448,448
Sonoma,22,2022-05-18,1610,1613,1602,11,15677,15711,15606,105,25,1,1,4,494,494,493,493
Stanislaus,22,2022-05-18,844,844,835,9,10239,10261,10152,109,33,3,3,4,1697,1697,1694,1694
Sutter,22,2022-05-18,111,111,110,1,1793,1798,1785,13,0,0,0,0,227,227,227,227
Tehama,22,2022-05-18,52,52,51,1,860,860,851,9,0,1,1,1,207,207,206,206
Trinity,22,2022-05-18,7,7,7,0,79,79,78,1,0,0,0,0,20,20,20,20
Tulare,22,2022-05-18,469,469,464,5,8726,8746,8651,95,20,0,0,0,1497,1497,1497,1497
Tuolumne,22,2022-05-18,167,167,166,1,1545,1547,1533,14,1,0,0,1,189,189,189,189
Ventura,22,2022-05-18,1770,1773,1765,8,23897,23949,23836,113,26,2,2,3,1506,1506,1504,1504
Yolo,22,2022-05-18,748,748,743,5,22814,22864,22722,142,0,0,0,1,323,323,323,323
Yuba,22,2022-05-18,140,140,139,1,1440,1443,1433,10,3,0,0,0,118,118,118,118
Alameda,23,2022-05-25,5579,5591,5567,24,76812,76988,76656,332,84,5,5,4,1898,1898,1893,1893
Amador,23,2022-05-25,100,100,99,1,1441,1444,1434,10,0,1,1,1,87,87,86,86
Butte,23,2022-05-25,266,266,265,1,2798,2804,2794,10,7,1,1,1,437,437,436,436
Calaveras,23,2022-05-25,53,53,53,0,728,728,724,4,0,1,1,0,122,122,121,121
Colusa,23,2022-05-25,8,8,8,0,218,218,217,1,0,0,0,0,21,21,21,21
Contra Costa,23,2022-05-25,3940,3950,3921,29,34618,34698,34447,251,68,10,10,8,1328,1328,1318,1318
Del Norte,23,2022-05-25,47,47,47,0,1223,1226,1219,7,1,0,0,1,50,50,50,50
El Dorado,23,2022-05-25,398,398,396,2,3510,3517,3496,21,5,3,3,1,218,218,215,215
Fresno,23,2022-05-25,1778,1783,1771,12,22332,22384,22232,152,57,3,3,9,2777,2777,2774,2774
Glenn,23,2022-05-25,25,25,25,0,285,285,283,2,0,0,0,0,42,42,42,42
Humboldt,23,2022-05-25,219,219,218,1,2893,2898,2882,16,9,1,1,3,148,148,147,147
Imperial,23,2022-05-25,331,331,329,2,4851,4863,4833,30,5,0,0,1,945,945,945,945
Inyo,23,2022-05-25,32,32,32,0,202,202,201,1,0,0,0,0,56,56,56,56
Kern,23,2022-05-25,1109,1111,1105,6,21341,21391,21283,108,20,0,0,7,2350,2350,2350,2350
Kings,23,2022-05-25,270,270,268,2,5531,5545,5511,34,1,0,0,0,447,447,447,447
Lake,23,2022-05-25,110,110,109,1,1147,1150,1142,8,1,0,0,1,140,140,140,140
Lassen,23,2022-05-25,53,53,53,0,1808,1812,1803,9,1,0,0,0,62,62,62,62
Los Angeles,23,2022-05-25,29557,29625,29575,50,949462,951639,950012,1627,374,37,37,55,32032,32032,31995,31995
Madera,23,2022-05-25,235,235,233,2,3801,3811,3785,26,3,0,0,2,368,368,368,368
Marin,23,2022-05-25,750,750,745,5,8585,8604,8546,58,9,0,0,0,295,295,295,295
Mariposa,23,2022-05-25,35,35,35,0,334,334,332,2,0,0,0,0,28,28,28,28
Mendocino,23,2022-05-25,144,144,143,1,1549,1552,1538,14,2,1,1,0,130,130,129,129
Merced,23,2022-05-25,412,412,410,2,4173,4183,4161,22,6,0,0,0,828,828,828,828
Modoc,23,2022-05-25,4,4,4,0,45,46,45,1,0,0,0,0,7,7,7,7
Mono,23,2022-05-25,10,10,10,0,148,148,146,2,0,0,0,0,6,6,6,6
Monterey,23,2022-05-25,659,659,652,7,9198,9218,9118,100,10,0,0,1,735,735,735,735
Napa,23,2022-05-25,337,337,335,2,4031,4042,4023,19,5,0,0,1,143,143,143,143
Nevada,23,2022-05-25,179,179,178,1,1910,1914,1901,13,1,0,0,0,128,128,128,128
Orange,23,2022-05-25,5852,5865,5842,23,95576,95794,95412,382,109,9,9,17,7118,7118,7109,7109
Placer,23,2022-05-25,852,852,846,6,7557,7574,7517,57,52,2,2,4,631,631,629,629
Plumas,23,2022-05-25,39,39,39,0,263,263,261,2,1,0,0,0,13,13,13,13
Riverside,23,2022-05-25,4442,4452,4428,24,52753,52873,52589,284,79,7,7,11,6476,6476,6469,6469
Sacramento,23,2022-05-25,4011,4021,3998,23,40418,40511,40276,235,118,7,7,16,3089,3089,3082,3082
San Benito,23,2022-05-25,182,182,181,1,1615,1620,1612,8,0,0,0,0,94,94,94,94
San Bernardino,23,2022-05-25,3634,3643,3627,16,50166,50281,50063,218,49,5,5,9,7842,7842,7837,7837
San Diego,23,2022-05-25,9161,9183,9166,17,103160,103396,103209,187,147,7,7,22,5341,5341,5334,5334
San Francisco,23,2022-05-25,3425,3433,3392,41,40222,40315,39835,480,80,9,9,12,893,893,884,884
San Joaquin,23,2022-05-25,1556,1561,1551,10,20758,20806,20673,133,22,2,2,4,2253,2253,2251,2251
San Luis Obispo,23,2022-05-25,768,768,764,4,7232,7248,7212,36,11,3,3,0,486,486,483,483
San Mateo,23,2022-05-25,3186,3193,3180,13,39943,40035,39875,160,35,1,1,1,714,714,713,713
Santa Barbara,23,2022-05-25,1119,1121,1115,6,17751,17793,17694,99,19,1,1,2,694,694,693,693
Santa Clara,23,2022-05-25,7920,7938,7923,15,109096,109346,109136,210,135,7,7,24,2328,2328,2321,2321
Santa Cruz,23,2022-05-25,531,531,528,3,7937,7956,7918,38,11,1,1,0,263,263,262,262
Shasta,23,2022-05-25,173,173,172,1,3669,3677,3656,21,6,1,1,3,564,564,563,563
Siskiyou,23,2022-05-25,48,48,48,0,393,393,391,2,3,0,0,0,83,83,83,83
Solano,23,2022-05-25,1461,1465,1457,8,14587,14619,14540,79,33,1,1,6,449,449,448,448
Sonoma,23,2022-05-25,1379,1381,1374,7,16533,16571,16484,87,42,1,1,2,495,495,494,494
Stanislaus,23,2022-05-25,853,853,846,7,10549,10572,10484,88,38,0,0,4,1697,1697,1697,1697
Sutter,23,2022-05-25,167,167,166,1,1990,1995,1984,11,0,1,1,0,228,228,227,227
Tehama,23,2022-05-25,50,50,50,0,832,832,825,7,2,0,0,0,207,207,207,207
Trinity,23,2022-05-25,5,5,5,0,100,100,99,1,0,0,0,0,20,20,20,20
Tulare,23,2022-05-25,623,623,618,5,9303,9325,9246,79,23,0,0,2,1497,1497,1497,1497
Tuolumne,23,2022-05-25,128,128,127,1,1501,1504,1494,10,0,1,1,0,190,190,189,189
Ventura,23,2022-05-25,1907,1912,1905,7,23493,23546,23459,87,34,1,1,2,1507,1507,1506,1506
Yolo,23,2022-05-25,699,699,696,3,21636,21686,21580,106,3,0,0,0,323,323,323,323
Yuba,23,2022-05-25,156,156,155,1,1401,1404,1397,7,8,0,0,1,118,118,118,118
Alameda,24,2022-06-01,5553,5566,5547,19,62552,62702,62491,211,92,2,2,14,1900,1900,1898,1898
Amador,24,2022-06-01,82,82,82,0,1205,1207,1200,7,1,0,0,0,87,87,87,87
Butte,24,2022-06-01,321,321,320,1,3058,3065,3057,8,24,0,0,2,437,437,437,437
Calaveras,24,2022-06-01,60,60,60,0,664,664,661,3,0,0,0,0,122,122,122,122
Colusa,24,2022-06-01,17,17,17,0,203,203,202,1,1,0,0,0,21,21,21,21
Contra Costa,24,2022-06-01,3514,3523,3503,20,31617,31693,31514,179,68,3,3,10,1331,1331,1328,1328
Del Norte,24,2022-06-01,53,53,53,0,1059,1060,1055,5,0,1,1,0,51,51,50,50
El Dorado,24,2022-06-01,321,321,319,2,3033,3039,3025,14,9,0,0,2,218,218,218,218
Fresno,24,2022-06-01,1874,1878,1868,10,20090,20138,20031,107,84,4,4,7,2781,2781,2777,2777
Glenn,24,2022-06-01,34,34,34,0,306,306,305,1,3,0,0,0,42,42,42,42
Humboldt,24,2022-06-01,208,208,207,1,2538,2544,2533,11,11,1,1,3,149,149,148,148
Imperial,24,2022-06-01,381,381,379,2,4416,4428,4407,21,3,1,1,0,946,946,945,945
Inyo,24,2022-06-01,18,18,18,0,172,172,171,1,1,0,0,0,56,56,56,56
Kern,24,2022-06-01,1186,1188,1183,5,19482,19528,19451,77,25,0,0,4,2350,2350,2350,2350
Kings,24,2022-06-01,323,323,321,2,4882,4894,4871,23,4,0,0,1,447,447,447,447
Lake,24,2022-06-01,101,101,100,1,1010,1011,1005,6,2,0,0,0,140,140,140,140
Lassen,24,2022-06-01,56,56,56,0,1876,1880,1873,7,1,0,0,0,62,62,62,62
Los Angeles,24,2022-06-01,28725,28795,28757,38,838943,840970,839853,1117,465,43,43,59,32075,32075,32032,32032
Madera,24,2022-06-01,277,277,276,1,3506,3516,3497,19,5,0,0,0,368,368,368,368
Marin,24,2022-06-01,661,661,658,3,7281,7298,7260,38,9,4,4,2,299,299,295,295
Mariposa,24,2022-06-01,59,59,59,0,332,332,330,2,0,0,0,0,28,28,28,28
Mendocino,24,2022-06-01,173,173,172,1,1349,1353,1343,10,5,0,0,0,130,130,130,130
Merced,24,2022-06-01,414,414,412,2,3723,3734,3719,15,0,0,0,0,828,828,828,828
Modoc,24,2022-06-01,7,7,7,0,37,38,37,1,0,0,0,0,7,7,7,7
Mono,24,2022-06-01,10,10,10,0,94,94,93,1,0,0,0,0,6,6,6,6
Monterey,24,2022-06-01,685,685,679,6,8351,8372,8302,70,16,2,2,0,737,737,735,735
Napa,24,2022-06-01,379,379,378,1,3231,3239,3227,12,8,0,0,3,143,143,143,143
Nevada,24,2022-06-01,198,198,197,1,1791,1795,1785,10,4,2,2,0,130,130,128,128
Orange,24,2022-06-01,6240,6254,6235,19,73098,73275,73043,232,121,10,10,18,7128,7128,7118,7118
Placer,24,2022-06-01,801,801,796,5,6501,6515,6477,38,61,0,0,11,631,631,631,631
Plumas,24,2022-06-01,36,36,36,0,233,233,232,1,1,0,0,0,13,13,13,13
Riverside,24,2022-06-01,4338,4348,4330,18,47009,47123,46926,197,97,4,4,11,6480,6480,6476,6476
Sacramento,24,2022-06-01,4207,4218,4199,19,36267,36353,36189,164,141,9,9,18,3098,3098,3089,3089
San Benito,24,2022-06-01,200,200,199,1,1509,1512,1506,6,0,0,0,2,94,94,94,94
San Bernardino,24,2022-06-01,3964,3973,3960,13,46241,46353,46196,157,63,4,4,11,7846,7846,7842,7842
San Diego,24,2022-06-01,9199,9222,9209,13,89336,89552,89426,126,172,8,8,27,5349,5349,5341,5341
San Francisco,24,2022-06-01,3308,3317,3286,31,34812,34896,34573,323,76,8,8,15,901,901,893,893
San Joaquin,24,2022-06-01,1627,1631,1623,8,17712,17755,17667,88,33,1,1,11,2254,2254,2253,2253
San Luis Obispo,24,2022-06-01,705,706,703,3,6150,6165,6141,24,14,1,1,0,487,487,486,486
San Mateo,24,2022-06-01,2856,2864,2855,9,32987,33067,32964,103,33,3,3,2,717,717,714,714
Santa Barbara,24,2022-06-01,1112,1114,1109,5,14434,14470,14407,63,21,1,1,4,695,695,694,694
Santa Clara,24,2022-06-01,7421,7440,7429,11,86647,86858,86729,129,171,8,8,17,2336,2336,2328,2328
Santa Cruz,24,2022-06-01,605,605,603,2,6689,6705,6680,25,10,0,0,1,263,263,263,263
Shasta,24,2022-06-01,157,157,156,1,3562,3570,3554,16,5,3,3,2,567,567,564,564
Siskiyou,24,2022-06-01,45,45,45,0,377,377,376,1,2,0,0,0,83,83,83,83
Solano,24,2022-06-01,1345,1347,1341,6,12338,12368,12316,52,30,0,0,5,449,449,449,449
Sonoma,24,2022-06-01,1338,1340,1335,5,12262,12290,12239,51,34,2,2,5,497,497,495,495
Stanislaus,24,2022-06-01,917,918,912,6,9146,9168,9108,60,52,3,3,1,1700,1700,1697,1697
Sutter,24,2022-06-01,164,164,163,1,1786,1791,1783,8,0,0,0,0,228,228,228,228
Tehama,24,2022-06-01,66,66,66,0,825,826,821,5,3,0,0,0,207,207,207,207
Trinity,24,2022-06-01,6,6,6,0,81,81,80,1,0,0,0,0,20,20,20,20
Tulare,24,2022-06-01,655,655,651,4,8091,8112,8059,53,20,0,0,1,1497,1497,1497,1497
Tuolumne,24,2022-06-01,122,122,121,1,1488,1492,1484,8,4,0,0,0,190,190,190,190
Ventura,24,2022-06-01,1733,1737,1732,5,21491,21544,21482,62,41,2,2,1,1509,1509,1507,1507
Yolo,24,2022-06-01,740,740,737,3,18705,18751,18680,71,6,0,0,0,323,323,323,323
Yuba,24,2022-06-01,147,147,146,1,1350,1353,1348,5,5,0,0,2,118,118,118,118
Alameda,25,2022-06-08,5684,5697,5682,15,63803,63965,63796,169,97,6,6,10,1906,1906,1900,1900
Amador,25,2022-06-08,143,143,142,1,1679,1684,1677,7,0,0,0,0,87,87,87,87
Butte,25,2022-06-08,457,457,456,1,3607,3617,3609,8,22,1,1,2,438,438,437,437
Calaveras,25,2022-06-08,72,72,72,0,637,637,635,2,0,2,2,0,124,124,122,122
Colusa,25,2022-06-08,16,16,16,0,304,304,303,1,10,0,0,0,21,21,21,21
Contra Costa,25,2022-06-08,3852,3862,3845,17,31625,31704,31564,140,97,10,10,12,1341,1341,1331,1331
Del Norte,25,2022-06-08,52,52,52,0,916,916,913,3,2,0,0,0,51,51,51,51
El Dorado,25,2022-06-08,386,386,385,1,3465,3475,3462,13,8,1,1,4,219,219,218,218
Fresno,25,2022-06-08,2368,2374,2364,10,21473,21527,21437,90,99,3,3,6,2784,2784,2781,2781
Glenn,25,2022-06-08,43,43,43,0,326,326,325,1,5,0,0,0,42,42,42,42
Humboldt,25,2022-06-08,251,251,250,1,2636,2641,2632,9,12,0,0,3,149,149,149,149
Imperial,25,2022-06-08,452,452,450,2,4517,4530,4513,17,6,0,0,0,946,946,946,946
Inyo,25,2022-06-08,14,14,14,0,199,199,198,1,1,0,0,0,56,56,56,56
Kern,25,2022-06-08,1623,1628,1623,5,21337,21392,21326,66,29,2,2,6,2352,2352,2350,2350
Kings,25,2022-06-08,369,369,368,1,5000,5014,4995,19,11,1,1,1,448,448,447,447
Lake,25,2022-06-08,133,133,132,1,1122,1125,1120,5,4,0,0,3,140,140,140,140
Lassen,25,2022-06-08,61,61,61,0,2095,2100,2094,6,2,0,0,0,62,62,62,62
Los Angeles,25,2022-06-08,32699,32782,32748,34,896651,898936,897994,942,527,40,40,68,32115,32115,32075,32075
Madera,25,2022-06-08,371,371,369,2,4152,4162,4145,17,4,0,0,2,368,368,368,368
Marin,25,2022-06-08,681,681,678,3,7116,7135,7106,29,13,2,2,1,301,301,299,299
Mariposa,25,2022-06-08,46,46,46,0,408,408,406,2,0,0,0,0,28,28,28,28
Mendocino,25,2022-06-08,188,188,187,1,1718,1723,1713,10,6,1,1,2,131,131,130,130
Merced,25,2022-06-08,565,565,563,2,4158,4171,4158,13,16,0,0,0,828,828,828,828
Modoc,25,2022-06-08,8,8,8,0,32,33,32,1,1,0,0,0,7,7,7,7
Mono,25,2022-06-08,13,13,13,0,95,95,94,1,0,0,0,0,6,6,6,6
Monterey,25,2022-06-08,922,922,916,6,9027,9051,8991,60,18,3,3,1,740,740,737,737
Napa,25,2022-06-08,524,524,523,1,4027,4038,4027,11,11,1,1,1,144,144,143,143
Nevada,25,2022-06-08,209,209,208,1,2132,2137,2128,9,5,0,0,0,130,130,130,130
Orange,25,2022-06-08,7111,7130,7113,17,69379,69557,69387,170,168,12,12,18,7140,7140,7128,7128
Placer,25,2022-06-08,836,836,832,4,7228,7246,7213,33,60,0,0,6,631,631,631,631
Plumas,25,2022-06-08,42,42,42,0,298,298,297,1,0,0,0,0,13,13,13,13
Riverside,25,2022-06-08,5089,5101,5084,17,50407,50535,50369,166,95,4,4,7,6484,6484,6480,6480
Sacramento,25,2022-06-08,4627,4639,4623,16,39348,39449,39310,139,153,14,14,24,3112,3112,3098,3098
San Benito,25,2022-06-08,245,245,244,1,1854,1858,1853,5,3,0,0,0,94,94,94,94
San Bernardino,25,2022-06-08,4829,4842,4829,13,50716,50846,50712,134,82,5,5,18,7851,7851,7846,7846
San Diego,25,2022-06-08,10016,10041,10030,11,90061,90291,90191,100,208,8,8,24,5357,5357,5349,5349
San Francisco,25,2022-06-08,3255,3263,3239,24,34341,34428,34178,250,78,4,4,8,905,905,901,901
San Joaquin,25,2022-06-08,2063,2068,2060,8,20642,20694,20613,81,45,5,5,7,2259,2259,2254,2254
San Luis Obispo,25,2022-06-08,754,754,752,2,6429,6446,6426,20,16,1,1,1,488,488,487,487
San Mateo,25,2022-06-08,2859,2866,2859,7,31895,31976,31898,78,39,2,2,2,719,719,717,717
Santa Barbara,25,2022-06-08,1089,1089,1085,4,12420,12452,12410,42,19,1,1,5,696,696,695,695
Santa Clara,25,2022-06-08,7824,7844,7835,9,91099,91332,91225,107,160,6,6,25,2342,2342,2336,2336
Santa Cruz,25,2022-06-08,894,894,891,3,9873,9899,9871,28,21,1,1,2,264,264,263,263
Shasta,25,2022-06-08,209,209,208,1,3652,3659,3646,13,12,1,1,2,568,568,567,567
Siskiyou,25,2022-06-08,43,43,43,0,376,376,375,1,2,0,0,0,83,83,83,83
Solano,25,2022-06-08,1667,1672,1667,5,14044,14079,14033,46,28,2,2,5,451,451,449,449
Sonoma,25,2022-06-08,1527,1532,1527,5,12882,12915,12874,41,31,2,2,5,499,499,497,497
Stanislaus,25,2022-06-08,1152,1153,1147,6,9818,9843,9793,50,62,0,0,7,1700,1700,1700,1700
Sutter,25,2022-06-08,197,197,196,1,1851,1856,1850,6,0,0,0,0,228,228,228,228
Tehama,25,2022-06-08,86,86,86,0,1039,1041,1036,5,2,0,0,0,207,207,207,207
Trinity,25,2022-06-08,8,8,8,0,105,105,104,1,0,0,0,0,20,20,20,20
Tulare,25,2022-06-08,829,829,825,4,10172,10198,10145,53,19,0,0,0,1497,1497,1497,1497
Tuolumne,25,2022-06-08,115,115,115,0,1471,1475,1469,6,3,0,0,2,190,190,190,190
Ventura,25,2022-06-08,1952,1957,1953,4,22496,22553,22502,51,41,3,3,3,1512,1512,1509,1509
Yolo,25,2022-06-08,741,741,739,2,18752,18799,18743,56,2,1,1,1,324,324,323,323
Yuba,25,2022-06-08,198,198,197,1,1518,1523,1518,5,9,0,0,1,118,118,118,118
Alameda,26,2022-06-15,4897,4909,4899,10,53541,53687,53577,110,103,5,5,16,1911,1911,1906,1906
Amador,26,2022-06-15,92,92,92,0,1301,1305,1301,4,2,0,0,0,87,87,87,87
Butte,26,2022-06-15,384,384,383,1,3411,3421,3415,6,27,5,5,0,443,443,438,438
Calaveras,26,2022-06-15,79,79,79,0,626,626,624,2,0,0,0,1,124,124,124,124
Colusa,26,2022-06-15,13,13,13,0,256,256,255,1,14,0,0,0,21,21,21,21
Contra Costa,26,2022-06-15,3304,3314,3303,11,26754,26828,26736,92,83,7,7,12,1348,1348,1341,1341
Del Norte,26,2022-06-15,83,83,83,0,647,647,645,2,4,0,0,1,51,51,51,51
El Dorado,26,2022-06-15,321,321,320,1,3208,3216,3207,9,7,2,2,0,221,221,219,219
Fresno,26,2022-06-15,2403,2410,2402,8,20760,20815,20748,67,110,3,3,17,2787,2787,2784,2784
Glenn,26,2022-06-15,30,30,30,0,323,323,322,1,4,0,0,0,42,42,42,42
Humboldt,26,2022-06-15,289,289,288,1,2319,2324,2318,6,12,0,0,5,149,149,149,149
Imperial,26,2022-06-15,487,487,486,1,4511,4524,4511,13,7,1,1,0,947,947,946,946
Inyo,26,2022-06-15,17,17,17,0,177,178,177,1,0,0,0,0,56,56,56,56
Kern,26,2022-06-15,1551,1556,1552,4,21155,21214,21163,51,35,1,1,9,2353,2353,2352,2352
Kings,26,2022-06-15,376,376,375,1,5228,5243,5228,15,5,1,1,0,449,449,448,448
Lake,26,2022-06-15,144,144,144,0,1209,1212,1208,4,1,0,0,2,140,140,140,140
Lassen,26,2022-06-15,72,72,72,0,1757,1760,1756,4,1,0,0,0,62,62,62,62
Los Angeles,26,2022-06-15,28112,28189,28166,23,485800,487116,486712,404,540,51,51,65,32166,32166,32115,32115
Madera,26,2022-06-15,360,360,359,1,4400,4413,4399,14,8,0,0,1,368,368,368,368
Marin,26,2022-06-15,692,692,690,2,6693,6711,6689,22,16,1,1,1,302,302,301,301
Mariposa,26,2022-06-15,53,53,53,0,339,339,338,1,0,0,0,0,28,28,28,28
Mendocino,26,2022-06-15,152,152,151,1,1490,1495,1488,7,4,0,0,1,131,131,131,131
Merced,26,2022-06-15,509,509,508,1,4063,4076,4066,10,12,1,1,2,829,829,828,828
Modoc,26,2022-06-15,6,6,6,0,35,36,35,1,0,1,1,0,8,8,7,7
Mono,26,2022-06-15,16,16,16,0,99,99,98,1,0,1,1,0,7,7,6,6
Monterey,26,2022-06-15,837,837,833,4,8672,8695,8650,45,25,2,2,1,742,742,740,740
Napa,26,2022-06-15,414,414,413,1,3712,3724,3716,8,4,1,1,1,145,145,144,144
Nevada,26,2022-06-15,193,193,192,1,1704,1709,1704,5,11,0,0,0,130,130,130,130
Orange,26,2022-06-15,7115,7134,7120,14,63923,64097,63975,122,156,13,13,21,7153,7153,7140,7140
Placer,26,2022-06-15,742,742,739,3,6399,6417,6394,23,74,2,2,5,633,633,631,631
Plumas,26,2022-06-15,32,32,32,0,245,245,244,1,0,0,0,0,13,13,13,13
Riverside,26,2022-06-15,4895,4908,4895,13,46406,46532,46413,119,98,3,3,11,6487,6487,6484,6484
Sacramento,26,2022-06-15,3973,3985,3974,11,36214,36314,36214,100,197,13,13,24,3125,3125,3112,3112
San Benito,26,2022-06-15,171,171,171,0,1683,1688,1684,4,0,0,0,1,94,94,94,94
San Bernardino,26,2022-06-15,4615,4628,4618,10,47200,47330,47232,98,106,7,7,20,7858,7858,7851,7851
San Diego,26,2022-06-15,9675,9702,9694,8,82238,82462,82391,71,192,7,7,20,5364,5364,5357,5357
San Francisco,26,2022-06-15,3020,3028,3011,17,30293,30375,30203,172,77,10,10,18,915,915,905,905
San Joaquin,26,2022-06-15,1723,1728,1723,5,18739,18791,18734,57,30,4,4,4,2263,2263,2259,2259
San Luis Obispo,26,2022-06-15,660,660,658,2,6162,6179,6164,15,28,5,5,0,493,493,488,488
San Mateo,26,2022-06-15,2550,2557,2552,5,27315,27389,27337,52,50,2,2,1,721,721,719,719
Santa Barbara,26,2022-06-15,873,873,871,2,8459,8483,8461,22,22,1,1,3,697,697,696,696
Santa Clara,26,2022-06-15,6690,6709,6703,6,66750,66932,66871,61,181,13,13,19,2355,2355,2342,2342
Santa Cruz,26,2022-06-15,851,851,849,2,9519,9545,9524,21,19,1,1,2,265,265,264,264
Shasta,26,2022-06-15,211,211,210,1,3312,3320,3311,9,7,2,2,1,570,570,568,568
Siskiyou,26,2022-06-15,47,47,47,0,381,381,380,1,0,1,1,0,84,84,83,83
Solano,26,2022-06-15,1553,1558,1554,4,12146,12180,12149,31,38,0,0,3,451,451,451,451
Sonoma,26,2022-06-15,1338,1341,1338,3,11248,11279,11251,28,35,1,1,3,500,500,499,499
Stanislaus,26,2022-06-15,1116,1117,1113,4,9389,9415,9377,38,60,4,4,9,1704,1704,1700,1700
Sutter,26,2022-06-15,201,201,200,1,1878,1884,1879,5,0,0,0,0,228,228,228,228
Tehama,26,2022-06-15,97,97,97,0,954,955,951,4,4,0,0,1,207,207,207,207
Trinity,26,2022-06-15,11,11,11,0,99,100,99,1,0,0,0,0,20,20,20,20
Tulare,26,2022-06-15,842,843,840,3,9254,9279,9242,37,27,4,4,2,1501,1501,1497,1497
Tuolumne,26,2022-06-15,159,159,158,1,1407,1411,1406,5,1,0,0,0,190,190,190,190
Ventura,26,2022-06-15,1847,1853,1850,3,19465,19518,19484,34,50,2,2,3,1514,1514,1512,1512
Yolo,26,2022-06-15,739,739,737,2,12201,12235,12207,28,3,0,0,1,324,324,324,324
Yuba,26,2022-06-15,164,164,164,0,1452,1457,1453,4,8,0,0,3,118,118,118,118
Alameda,27,2022-06-22,5125,5139,5131,8,47231,47370,47294,76,113,11,11,14,1922,1922,1911,1911
Amador,27,2022-06-22,98,98,98,0,1278,1282,1279,3,2,0,0,2,87,87,87,87
Butte,27,2022-06-22,422,422,421,1,3556,3568,3563,5,25,2,2,1,445,445,443,443
Calaveras,27,2022-06-22,69,69,69,0,623,623,622,1,0,1,1,0,125,125,124,124
Colusa,27,2022-06-22,18,18,18,0,184,185,184,1,7,1,1,0,22,22,21,21
Contra Costa,27,2022-06-22,3383,3393,3384,9,25439,25515,25446,69,80,12,12,9,1360,1360,1348,1348
Del Norte,27,2022-06-22,105,105,105,0,632,632,631,1,5,1,1,1,52,52,51,51
El Dorado,27,2022-06-22,393,393,392,1,3167,3176,3169,7,7,1,1,2,222,222,221,221
Fresno,27,2022-06-22,2560,2567,2561,6,19741,19799,19749,50,109,3,3,16,2790,2790,2787,2787
Glenn,27,2022-06-22,39,39,39,0,307,307,306,1,3,0,0,0,42,42,42,42
Humboldt,27,2022-06-22,269,269,268,1,2202,2207,2202,5,7,0,0,3,149,149,149,149
Imperial,27,2022-06-22,656,656,655,1,3836,3848,3839,9,6,0,0,0,947,947,947,947
Inyo,27,2022-06-22,18,18,18,0,187,188,187,1,0,0,0,0,56,56,56,56
Kern,27,2022-06-22,1735,1740,1737,3,19897,19956,19919,37,45,4,4,10,2357,2357,2353,2353
Kings,27,2022-06-22,434,434,433,1,4529,4543,4533,10,10,0,0,0,449,449,449,449
Lake,27,2022-06-22,113,113,113,0,1234,1238,1235,3,1,0,0,0,140,140,140,140
Lassen,27,2022-06-22,44,44,44,0,1140,1141,1139,2,0,0,0,0,62,62,62,62
Los Angeles,27,2022-06-22,28680,28764,28746,18,352045,353081,352858,223,619,66,66,69,32232,32232,32166,32166
Madera,27,2022-06-22,361,361,360,1,4188,4201,4190,11,4,0,0,1,368,368,368,368
Marin,27,2022-06-22,667,667,665,2,6370,6389,6373,16,16,0,0,2,302,302,302,302
Mariposa,27,2022-06-22,48,48,48,0,333,333,332,1,0,0,0,0,28,28,28,28
Mendocino,27,2022-06-22,184,184,183,1,1527,1532,1527,5,4,0,0,0,131,131,131,131
Merced,27,2022-06-22,574,574,573,1,4067,4080,4072,8,10,3,3,2,832,832,829,829
Modoc,27,2022-06-22,8,8,8,0,33,34,33,1,0,0,0,0,8,8,8,8
Mono,27,2022-06-22,6,6,6,0,78,79,78,1,0,0,0,0,7,7,7,7
Monterey,27,2022-06-22,925,925,921,4,8648,8673,8638,35,31,0,0,3,742,742,742,742
Napa,27,2022-06-22,353,353,352,1,3014,3023,3018,5,5,2,2,0,147,147,145,145
Nevada,27,2022-06-22,161,161,161,0,1615,1620,1616,4,7,1,1,0,131,131,130,130
Orange,27,2022-06-22,7068,7090,7080,10,58654,58826,58739,87,158,11,11,23,7164,7164,7153,7153
Placer,27,2022-06-22,695,695,693,2,6112,6130,6113,17,78,3,3,6,636,636,633,633
Plumas,27,2022-06-22,44,44,44,0,251,251,250,1,1,0,0,0,13,13,13,13
Riverside,27,2022-06-22,5329,5346,5335,11,42986,43111,43025,86,112,9,9,14,6496,6496,6487,6487
Sacramento,27,2022-06-22,4002,4014,4005,9,35138,35242,35166,76,166,13,13,20,3138,3138,3125,3125
San Benito,27,2022-06-22,192,192,192,0,1551,1556,1553,3,0,1,1,1,95,95,94,94
San Bernardino,27,2022-06-22,4723,4736,4728,8,47001,47140,47064,76,105,15,15,18,7873,7873,7858,7858
San Diego,27,2022-06-22,9943,9972,9965,7,78413,78644,78591,53,238,11,11,25,5375,5375,5364,5364
San Francisco,27,2022-06-22,3137,3146,3132,14,28409,28493,28367,126,88,10,10,20,925,925,915,915
San Joaquin,27,2022-06-22,1775,1780,1776,4,17952,18005,17963,42,40,6,6,6,2269,2269,2263,2263
San Luis Obispo,27,2022-06-22,599,599,598,1,5824,5841,5830,11,25,6,6,0,499,499,493,493
San Mateo,27,2022-06-22,2781,2789,2785,4,26136,26214,26175,39,40,2,2,3,723,723,721,721
Santa Barbara,27,2022-06-22,1019,1022,1020,2,8940,8967,8949,18,37,3,3,5,700,700,697,697
Santa Clara,27,2022-06-22,7068,7089,7084,5,60061,60237,60194,43,162,9,9,17,2364,2364,2355,2355
Santa Cruz,27,2022-06-22,856,857,856,1,9105,9131,9115,16,23,1,1,1,266,266,265,265
Shasta,27,2022-06-22,280,280,279,1,3319,3328,3321,7,15,0,0,3,570,570,570,570
Siskiyou,27,2022-06-22,68,68,68,0,378,378,377,1,2,1,1,0,85,85,84,84
Solano,27,2022-06-22,1496,1501,1498,3,12299,12336,12311,25,52,0,0,4,451,451,451,451
Sonoma,27,2022-06-22,1400,1405,1402,3,10404,10436,10416,20,28,1,1,3,501,501,500,500
Stanislaus,27,2022-06-22,1072,1075,1072,3,8617,8643,8616,27,76,3,3,8,1707,1707,1704,1704
Sutter,27,2022-06-22,185,185,185,0,1854,1860,1856,4,0,0,0,0,228,228,228,228
Tehama,27,2022-06-22,89,89,89,0,865,867,864,3,1,0,0,0,207,207,207,207
Trinity,27,2022-06-22,18,18,18,0,126,127,126,1,0,0,0,0,20,20,20,20
Tulare,27,2022-06-22,864,865,862,3,8404,8429,8402,27,30,6,6,2,1507,1507,1501,1501
Tuolumne,27,2022-06-22,157,157,157,0,1596,1602,1598,4,5,1,1,0,191,191,190,190
Ventura,27,2022-06-22,1909,1916,1913,3,18867,18922,18896,26,55,2,2,4,1516,1516,1514,1514
Yolo,27,2022-06-22,732,732,731,1,10958,10991,10971,20,8,2,2,2,326,326,324,324
Yuba,27,2022-06-22,154,154,154,0,1404,1409,1406,3,8,1,1,4,119,119,118,118
Alameda,28,2022-06-29,5535,5553,5546,7,46999,47148,47089,59,132,9,9,18,1931,1931,1922,1922
Amador,28,2022-06-29,91,91,91,0,1219,1222,1220,2,5,0,0,1,87,87,87,87
Butte,28,2022-06-29,388,388,388,0,3238,3249,3246,3,31,3,3,0,448,448,445,445
Calaveras,28,2022-06-29,78,78,78,0,544,544,543,1,1,1,1,0,126,126,125,125
Colusa,28,2022-06-29,30,30,30,0,282,283,282,1,5,0,0,0,22,22,22,22
Contra Costa,28,2022-06-29,3645,3657,3649,8,25485,25565,25511,54,80,6,6,7,1366,1366,1360,1360
Del Norte,28,2022-06-29,154,154,154,0,643,643,642,1,5,1,1,1,53,53,52,52
El Dorado,28,2022-06-29,401,401,400,1,3181,3191,3185,6,6,0,0,0,222,222,222,222
Fresno,28,2022-06-29,2782,2791,2785,6,19459,19520,19481,39,152,2,2,18,2792,2792,2790,2790
Glenn,28,2022-06-29,31,31,31,0,281,282,281,1,1,0,0,0,42,42,42,42
Humboldt,28,2022-06-29,216,216,216,0,2057,2062,2059,3,13,1,1,5,150,150,149,149
Imperial,28,2022-06-29,709,709,708,1,3824,3837,3830,7,9,1,1,4,948,948,947,947
Inyo,28,2022-06-29,39,39,39,0,329,329,328,1,4,0,0,0,56,56,56,56
Kern,28,2022-06-29,1844,1851,1848,3,16355,16408,16384,24,56,8,8,9,2365,2365,2357,2357
Kings,28,2022-06-29,480,480,479,1,3957,3970,3963,7,4,0,0,0,449,449,449,449
Lake,28,2022-06-29,107,107,107,0,1075,1079,1077,2,0,1,1,0,141,141,140,140
Lassen,28,2022-06-29,52,52,52,0,871,873,872,1,2,0,0,0,62,62,62,62
Los Angeles,28,2022-06-29,34621,34729,34712,17,353350,354471,354297,174,734,70,70,74,32302,32302,32232,32232
Madera,28,2022-06-29,390,390,389,1,4070,4084,4076,8,14,0,0,1,368,368,368,368
Marin,28,2022-06-29,681,681,680,1,5998,6016,6004,12,19,1,1,1,303,303,302,302
Mariposa,28,2022-06-29,52,52,52,0,298,298,297,1,0,0,0,0,28,28,28,28
Mendocino,28,2022-06-29,153,153,153,0,1395,1400,1396,4,2,1,1,4,132,132,131,131
Merced,28,2022-06-29,631,631,630,1,3876,3889,3883,6,12,1,1,0,833,833,832,832
Modoc,28,2022-06-29,10,10,10,0,31,32,31,1,1,0,0,0,8,8,8,8
Mono,28,2022-06-29,30,30,30,0,113,114,113,1,0,0,0,0,7,7,7,7
Monterey,28,2022-06-29,902,903,900,3,8043,8068,8043,25,45,2,2,2,744,744,742,742
Napa,28,2022-06-29,405,405,404,1,3312,3323,3319,4,4,1,1,2,148,148,147,147
Nevada,28,2022-06-29,197,197,197,0,1560,1565,1562,3,7,0,0,1,131,131,131,131
Orange,28,2022-06-29,7778,7802,7793,9,59174,59362,59294,68,201,18,18,29,7182,7182,7164,7164
Placer,28,2022-06-29,837,838,836,2,6107,6126,6113,13,90,4,4,6,640,640,636,636
Plumas,28,2022-06-29,40,40,40,0,227,228,227,1,2,0,0,0,13,13,13,13
Riverside,28,2022-06-29,6631,6653,6643,10,44889,45031,44961,70,142,10,10,11,6506,6506,6496,6496
Sacramento,28,2022-06-29,4151,4164,4157,7,33826,33933,33876,57,168,10,10,23,3148,3148,3138,3138
San Benito,28,2022-06-29,233,233,233,0,1680,1685,1683,2,1,0,0,1,95,95,95,95
San Bernardino,28,2022-06-29,6211,6231,6223,8,47534,47684,47624,60,113,10,10,30,7883,7883,7873,7873
San Diego,28,2022-06-29,10985,11020,11014,6,78119,78367,78326,41,288,7,7,34,5382,5382,5375,5375
San Francisco,28,2022-06-29,3248,3258,3247,11,27802,27890,27794,96,97,9,9,18,934,934,925,925
San Joaquin,28,2022-06-29,1890,1896,1893,3,17247,17301,17269,32,38,2,2,6,2271,2271,2269,2269
San Luis Obispo,28,2022-06-29,663,663,662,1,5534,5551,5543,8,31,2,2,0,501,501,499,499
San Mateo,28,2022-06-29,2793,2802,2799,3,25669,25749,25719,30,48,1,1,2,724,724,723,723
Santa Barbara,28,2022-06-29,1151,1155,1153,2,9572,9602,9587,15,30,3,3,3,703,703,700,700
Santa Clara,28,2022-06-29,7661,7686,7682,4,59178,59364,59331,33,206,11,11,24,2375,2375,2364,2364
Santa Cruz,28,2022-06-29,860,862,861,1,9359,9390,9377,13,23,1,1,2,267,267,266,266
Shasta,28,2022-06-29,345,345,344,1,3277,3286,3281,5,22,0,0,3,570,570,570,570
Siskiyou,28,2022-06-29,59,59,59,0,367,368,367,1,5,0,0,0,85,85,85,85
Solano,28,2022-06-29,1583,1588,1586,2,11947,11985,11966,19,39,0,0,4,451,451,451,451
Sonoma,28,2022-06-29,1296,1301,1299,2,9769,9801,9786,15,35,2,2,1,503,503,501,501
Stanislaus,28,2022-06-29,1262,1267,1264,3,8619,8646,8625,21,107,2,2,9,1709,1709,1707,1707
Sutter,28,2022-06-29,218,218,218,0,1852,1858,1855,3,0,0,0,0,228,228,228,228
Tehama,28,2022-06-29,104,104,104,0,922,926,924,2,2,0,0,1,207,207,207,207
Trinity,28,2022-06-29,18,18,18,0,160,161,160,1,2,0,0,0,20,20,20,20
Tulare,28,2022-06-29,985,988,986,2,7742,7767,7748,19,33,0,0,2,1507,1507,1507,1507
Tuolumne,28,2022-06-29,177,177,177,0,1408,1412,1409,3,2,2,2,1,193,193,191,191
Ventura,28,2022-06-29,2134,2141,2139,2,18372,18430,18410,20,71,2,2,2,1518,1518,1516,1516
Yolo,28,2022-06-29,737,737,736,1,9942,9975,9961,14,7,1,1,1,327,327,326,326
Yuba,28,2022-06-29,180,180,180,0,1300,1305,1303,2,9,1,1,2,120,120,119,119
Alameda,29,2022-07-06,5182,5201,5196,5,40647,40790,40750,40,120,13,13,18,1944,1944,1931,1931
Amador,29,2022-07-06,74,74,74,0,1758,1764,1761,3,2,1,1,1,88,88,87,87
Butte,29,2022-07-06,356,356,356,0,2674,2684,2682,2,28,2,2,3,450,450,448,448
Calaveras,29,2022-07-06,77,77,77,0,507,507,506,1,1,2,2,0,128,128,126,126
Colusa,29,2022-07-06,25,25,25,0,263,265,264,1,4,0,0,0,22,22,22,22
Contra Costa,29,2022-07-06,3376,3388,3382,6,22686,22766,22729,37,87,12,12,8,1378,1378,1366,1366
Del Norte,29,2022-07-06,140,140,140,0,593,594,593,1,2,0,0,2,53,53,53,53
El Dorado,29,2022-07-06,329,329,329,0,2550,2558,2555,3,9,1,1,1,223,223,222,222
Fresno,29,2022-07-06,2796,2805,2801,4,17463,17525,17498,27,156,7,7,18,2799,2799,2792,2792
Glenn,29,2022-07-06,27,27,27,0,177,178,177,1,0,0,0,0,42,42,42,42
Humboldt,29,2022-07-06,242,242,242,0,1840,1845,1843,2,6,1,1,4,151,151,150,150
Imperial,29,2022-07-06,811,813,812,1,3556,3569,3564,5,19,0,0,1,948,948,948,948
Inyo,29,2022-07-06,42,42,42,0,347,348,347,1,0,0,0,0,56,56,56,56
Kern,29,2022-07-06,1987,1996,1994,2,14957,15010,14993,17,74,4,4,12,2369,2369,2365,2365
Kings,29,2022-07-06,547,548,547,1,3612,3625,3620,5,8,0,0,1,449,449,449,449
Lake,29,2022-07-06,113,113,113,0,864,867,866,1,1,1,1,0,142,142,141,141
Lassen,29,2022-07-06,34,34,34,0,660,662,661,1,4,0,0,0,62,62,62,62
Los Angeles,29,2022-07-06,35343,35468,35454,14,307951,309037,308919,118,886,89,89,103,32391,32391,32302,32302
Madera,29,2022-07-06,396,396,395,1,3242,3254,3249,5,9,0,0,1,368,368,368,368
Marin,29,2022-07-06,611,611,610,1,5348,5367,5359,8,24,2,2,2,305,305,303,303
Mariposa,29,2022-07-06,39,39,39,0,230,231,230,1,0,0,0,0,28,28,28,28
Mendocino,29,2022-07-06,187,187,187,0,1224,1228,1225,3,14,2,2,0,134,134,132,132
Merced,29,2022-07-06,635,635,634,1,3375,3389,3385,4,16,2,2,2,835,835,833,833
Modoc,29,2022-07-06,19,19,19,0,46,47,46,1,0,0,0,0,8,8,8,8
Mono,29,2022-07-06,19,19,19,0,85,86,85,1,3,0,0,0,7,7,7,7
Monterey,29,2022-07-06,921,923,921,2,6769,6793,6776,17,38,4,4,3,748,748,744,744
Napa,29,2022-07-06,318,318,318,0,2954,2964,2961,3,8,0,0,3,148,148,148,148
Nevada,29,2022-07-06,197,197,197,0,1448,1453,1451,2,8,0,0,1,131,131,131,131
Orange,29,2022-07-06,7579,7606,7599,7,54164,54354,54305,49,223,24,24,35,7206,7206,7182,7182
Placer,29,2022-07-06,812,814,813,1,5093,5112,5103,9,81,4,4,9,644,644,640,640
Plumas,29,2022-07-06,54,54,54,0,234,235,234,1,3,0,0,0,13,13,13,13
Riverside,29,2022-07-06,7148,7172,7163,9,41348,41493,41443,50,154,3,3,12,6509,6509,6506,6506
Sacramento,29,2022-07-06,3576,3588,3583,5,29144,29247,29209,38,160,18,18,24,3166,3166,3148,3148
San Benito,29,2022-07-06,206,206,206,0,1350,1355,1354,1,2,0,0,0,95,95,95,95
San Bernardino,29,2022-07-06,6761,6784,6777,7,44835,44993,44949,44,176,16,16,18,7899,7899,7883,7883
San Diego,29,2022-07-06,10802,10842,10838,4,71498,71751,71722,29,311,7,7,42,5389,5389,5382,5382
San Francisco,29,2022-07-06,2912,2922,2914,8,23972,24056,23991,65,101,11,11,24,945,945,934,934
San Joaquin,29,2022-07-06,1776,1781,1778,3,15798,15854,15831,23,44,8,8,4,2279,2279,2271,2271
San Luis Obispo,29,2022-07-06,728,730,729,1,4481,4497,4492,5,26,0,0,0,501,501,501,501
San Mateo,29,2022-07-06,2612,2621,2619,2,21385,21461,21442,19,42,2,2,2,726,726,724,724
Santa Barbara,29,2022-07-06,1148,1151,1150,1,8137,8166,8156,10,29,4,4,4,707,707,703,703
Santa Clara,29,2022-07-06,6909,6933,6930,3,51608,51789,51767,22,196,15,15,37,2390,2390,2375,2375
Santa Cruz,29,2022-07-06,803,805,804,1,7521,7547,7539,8,27,0,0,0,267,267,267,267
Shasta,29,2022-07-06,291,291,291,0,2756,2765,2761,4,20,5,5,3,575,575,570,570
Siskiyou,29,2022-07-06,45,45,45,0,321,322,321,1,1,0,0,1,85,85,85,85
Solano,29,2022-07-06,1344,1349,1347,2,10338,10374,10361,13,44,0,0,6,451,451,451,451
Sonoma,29,2022-07-06,1222,1226,1225,1,8712,8743,8733,10,40,2,2,0,505,505,503,503
Stanislaus,29,2022-07-06,1270,1274,1272,2,7415,7441,7427,14,102,7,7,17,1716,1716,1709,1709
Sutter,29,2022-07-06,243,243,243,0,1558,1563,1561,2,0,0,0,0,228,228,228,228
Tehama,29,2022-07-06,141,141,141,0,810,813,812,1,4,1,1,0,208,208,207,207
Trinity,29,2022-07-06,26,26,26,0,124,125,124,1,2,0,0,0,20,20,20,20
Tulare,29,2022-07-06,1054,1056,1054,2,7072,7098,7085,13,38,6,6,2,1513,1513,1507,1507
Tuolumne,29,2022-07-06,174,174,174,0,1019,1021,1019,2,3,0,0,0,193,193,193,193
Ventura,29,2022-07-06,2114,2122,2120,2,16453,16511,16497,14,65,2,2,3,1520,1520,1518,1518
Yolo,29,2022-07-06,475,475,474,1,5952,5973,5966,7,4,0,0,1,327,327,327,327
Yuba,29,2022-07-06,172,172,172,0,1182,1185,1184,1,11,0,0,1,120,120,120,120
Alameda,30,2022-07-13,5334,5355,5351,4,44651,44830,44796,34,130,4,4,22,1948,1948,1944,1944
Amador,30,2022-07-13,104,104,104,0,1412,1418,1416,2,1,0,0,0,88,88,88,88
Butte,30,2022-07-13,420,420,420,0,3001,3014,3012,2,32,1,1,2,451,451,450,450
Calaveras,30,2022-07-13,88,88,88,0,553,553,552,1,0,1,1,1,129,129,128,128
Colusa,30,2022-07-13,23,23,23,0,387,389,388,1,3,0,0,0,22,22,22,22
Contra Costa,30,2022-07-13,3316,3328,3324,4,23774,23868,23838,30,79,8,8,15,1386,1386,1378,1378
Del Norte,30,2022-07-13,193,193,193,0,705,708,707,1,6,0,0,1,53,53,53,53
El Dorado,30,2022-07-13,343,343,343,0,2785,2797,2794,3,6,2,2,4,225,225,223,223
Fresno,30,2022-07-13,3625,3639,3635,4,20740,20823,20798,25,172,8,8,18,2807,2807,2799,2799
Glenn,30,2022-07-13,35,35,35,0,352,353,352,1,0,0,0,0,42,42,42,42
Humboldt,30,2022-07-13,291,291,291,0,1992,1999,1997,2,13,1,1,3,152,152,151,151
Imperial,30,2022-07-13,1102,1107,1106,1,4630,4648,4643,5,21,3,3,0,951,951,948,948
Inyo,30,2022-07-13,32,32,32,0,332,333,332,1,0,1,1,0,57,57,56,56
Kern,30,2022-07-13,2235,2243,2241,2,15888,15951,15937,14,78,4,4,11,2373,2373,2369,2369
Kings,30,2022-07-13,710,712,711,1,4210,4227,4222,5,8,3,3,0,452,452,449,449
Lake,30,2022-07-13,128,128,128,0,981,986,985,1,0,0,0,1,142,142,142,142
Lassen,30,2022-07-13,60,60,60,0,758,760,759,1,1,1,1,0,63,63,62,62
Los Angeles,30,2022-07-13,41770,41936,41923,13,356962,358384,358277,107,1080,103,103,122,32494,32494,32391,32391
Madera,30,2022-07-13,524,524,523,1,3941,3958,3953,5,11,0,0,2,368,368,368,368
Marin,30,2022-07-13,548,548,547,1,5545,5567,5560,7,14,1,1,5,306,306,305,305
Mariposa,30,2022-07-13,51,51,51,0,253,254,253,1,0,0,0,0,28,28,28,28
Mendocino,30,2022-07-13,187,187,187,0,1346,1351,1349,2,4,0,0,1,134,134,134,134
Merced,30,2022-07-13,745,747,746,1,3986,4002,3998,4,18,5,5,1,840,840,835,835
Modoc,30,2022-07-13,20,20,20,0,44,45,44,1,0,0,0,0,8,8,8,8
Mono,30,2022-07-13,9,9,9,0,91,92,91,1,0,0,0,0,7,7,7,7
Monterey,30,2022-07-13,1037,1042,1040,2,7241,7270,7256,14,50,3,3,3,751,751,748,748
Napa,30,2022-07-13,364,364,364,0,3166,3180,3177,3,15,1,1,1,149,149,148,148
Nevada,30,2022-07-13,179,179,179,0,1510,1516,1514,2,11,0,0,2,131,131,131,131
Orange,30,2022-07-13,9347,9384,9377,7,61158,61402,61359,43,260,19,19,36,7225,7225,7206,7206
Placer,30,2022-07-13,722,722,721,1,5560,5583,5576,7,63,1,1,8,645,645,644,644
Plumas,30,2022-07-13,60,60,60,0,260,261,260,1,1,0,0,0,13,13,13,13
Riverside,30,2022-07-13,8802,8837,8829,8,48850,49045,48999,46,231,14,14,11,6523,6523,6509,6509
Sacramento,30,2022-07-13,3899,3914,3910,4,31871,31998,31965,33,176,17,17,24,3183,3183,3166,3166
San Benito,30,2022-07-13,227,227,227,0,1623,1628,1627,1,2,0,0,0,95,95,95,95
San Bernardino,30,2022-07-13,8187,8220,8214,6,54391,54607,54565,42,204,14,14,29,7913,7913,7899,7899
San Diego,30,2022-07-13,13439,13493,13489,4,81303,81628,81602,26,352,12,12,43,5401,5401,5389,5389
San Francisco,30,2022-07-13,2642,2653,2647,6,25318,25419,25366,53,110,8,8,21,953,953,945,945
San Joaquin,30,2022-07-13,2053,2062,2060,2,18307,18381,18360,21,53,4,4,13,2283,2283,2279,2279
San Luis Obispo,30,2022-07-13,592,592,591,1,4868,4887,4883,4,14,3,3,1,504,504,501,501
San Mateo,30,2022-07-13,2533,2544,2542,2,23480,23573,23556,17,40,3,3,4,729,729,726,726
Santa Barbara,30,2022-07-13,1302,1309,1308,1,9228,9265,9256,9,43,4,4,6,711,711,707,707
Santa Clara,30,2022-07-13,6735,6762,6760,2,55711,55932,55913,19,205,11,11,38,2401,2401,2390,2390
Santa Cruz,30,2022-07-13,940,945,944,1,8634,8669,8662,7,18,0,0,1,267,267,267,267
Shasta,30,2022-07-13,328,328,328,0,3180,3192,3189,3,25,3,3,6,578,578,575,575
Siskiyou,30,2022-07-13,44,44,44,0,348,349,348,1,4,1,1,0,86,86,85,85
Solano,30,2022-07-13,1403,1408,1407,1,10134,10173,10163,10,47,2,2,4,453,453,451,451
Sonoma,30,2022-07-13,1112,1118,1117,1,9104,9140,9132,8,39,0,0,6,505,505,505,505
Stanislaus,30,2022-07-13,1436,1443,1441,2,8461,8495,8482,13,107,7,7,10,1723,1723,1716,1716
Sutter,30,2022-07-13,276,276,276,0,1759,1765,1763,2,0,0,0,0,228,228,228,228
Tehama,30,2022-07-13,117,117,117,0,904,908,907,1,8,0,0,1,208,208,208,208
Trinity,30,2022-07-13,31,31,31,0,98,99,98,1,1,0,0,0,20,20,20,20
Tulare,30,2022-07-13,1286,1291,1289,2,8831,8866,8853,13,39,2,2,2,1515,1515,1513,1513
Tuolumne,30,2022-07-13,248,248,248,0,1119,1124,1123,1,8,0,0,0,193,193,193,193
Ventura,30,2022-07-13,2407,2416,2414,2,18994,19070,19058,12,92,6,6,5,1526,1526,1520,1520
Yolo,30,2022-07-13,456,456,456,0,4684,4702,4698,4,4,2,2,2,329,329,327,327
Yuba,30,2022-07-13,214,214,214,0,1340,1345,1344,1,11,0,0,1,120,120,120,120
Alameda,31,2022-07-20,4649,4669,4666,3,41966,42152,42127,25,132,12,12,19,1960,1960,1948,1948
Amador,31,2022-07-20,71,71,71,0,1232,1237,1236,1,3,0,0,0,88,88,88,88
Butte,31,2022-07-20,340,340,340,0,3008,3022,3021,1,30,0,0,1,451,451,451,451
Calaveras,31,2022-07-20,69,69,69,0,541,543,542,1,0,0,0,1,129,129,129,129
Colusa,31,2022-07-20,23,23,23,0,373,375,374,1,2,0,0,0,22,22,22,22
Contra Costa,31,2022-07-20,2979,2991,2988,3,22812,22913,22890,23,83,5,5,19,1391,1391,1386,1386
Del Norte,31,2022-07-20,108,108,108,0,620,622,621,1,6,0,0,2,53,53,53,53
El Dorado,31,2022-07-20,278,278,278,0,2576,2588,2586,2,8,0,0,1,225,225,225,225
Fresno,31,2022-07-20,3659,3675,3672,3,20813,20904,20884,20,185,10,10,19,2817,2817,2807,2807
Glenn,31,2022-07-20,36,36,36,0,276,277,276,1,1,0,0,0,42,42,42,42
Humboldt,31,2022-07-20,259,259,259,0,2017,2026,2024,2,12,1,1,4,153,153,152,152
Imperial,31,2022-07-20,987,992,991,1,4557,4577,4573,4,26,0,0,1,951,951,951,951
Inyo,31,2022-07-20,25,25,25,0,311,312,311,1,0,0,0,0,57,57,57,57
Kern,31,2022-07-20,2213,2222,2220,2,15796,15867,15856,11,87,7,7,13,2380,2380,2373,2373
Kings,31,2022-07-20,656,657,656,1,4123,4142,4139,3,13,1,1,1,453,453,452,452
Lake,31,2022-07-20,137,137,137,0,1013,1018,1017,1,4,0,0,1,142,142,142,142
Lassen,31,2022-07-20,69,69,69,0,1279,1285,1284,1,0,0,0,0,63,63,63,63
Los Angeles,31,2022-07-20,40773,40953,40943,10,351644,353196,353114,82,1187,112,112,142,32606,32606,32494,32494
Madera,31,2022-07-20,542,542,541,1,3612,3628,3625,3,9,0,0,2,368,368,368,368
Marin,31,2022-07-20,494,494,494,0,5406,5430,5425,5,22,0,0,4,306,306,306,306
Mariposa,31,2022-07-20,36,36,36,0,250,251,250,1,0,1,1,0,29,29,28,28
Mendocino,31,2022-07-20,166,166,166,0,1472,1477,1475,2,10,0,0,3,134,134,134,134
Merced,31,2022-07-20,741,744,743,1,3863,3881,3878,3,15,2,2,0,842,842,840,840
Modoc,31,2022-07-20,7,7,7,0,31,32,31,1,0,1,1,0,9,9,8,8
Mono,31,2022-07-20,12,12,12,0,82,83,82,1,1,0,0,0,7,7,7,7
Monterey,31,2022-07-20,975,979,978,1,7242,7274,7263,11,37,6,6,2,757,757,751,751
Napa,31,2022-07-20,299,299,299,0,3032,3044,3042,2,6,4,4,1,153,153,149,149
Nevada,31,2022-07-20,124,124,124,0,1340,1346,1345,1,5,1,1,0,132,132,131,131
Orange,31,2022-07-20,8547,8585,8580,5,59364,59626,59593,33,271,32,32,48,7257,7257,7225,7225
Placer,31,2022-07-20,637,637,636,1,5120,5144,5139,5,86,4,4,8,649,649,645,645
Plumas,31,2022-07-20,58,58,58,0,248,249,248,1,0,0,0,0,13,13,13,13
Riverside,31,2022-07-20,8123,8158,8152,6,47795,48006,47971,35,216,14,14,19,6537,6537,6523,6523
Sacramento,31,2022-07-20,3631,3647,3644,3,30605,30741,30717,24,193,17,17,26,3200,3200,3183,3183
San Benito,31,2022-07-20,198,198,198,0,1562,1568,1567,1,1,1,1,0,96,96,95,95
San Bernardino,31,2022-07-20,7614,7647,7642,5,51988,52218,52187,31,235,18,18,36,7931,7931,7913,7913
San Diego,31,2022-07-20,12759,12815,12812,3,78647,78993,78974,19,412,16,16,49,5417,5417,5401,5401
San Francisco,31,2022-07-20,2416,2427,2423,4,25096,25206,25165,41,114,9,9,30,962,962,953,953
San Joaquin,31,2022-07-20,1956,1965,1963,2,17175,17251,17236,15,71,4,4,12,2287,2287,2283,2283
San Luis Obispo,31,2022-07-20,552,553,553,0,4567,4586,4583,3,12,7,7,1,511,511,504,504
San Mateo,31,2022-07-20,2142,2151,2150,1,21913,22009,21997,12,40,0,0,9,729,729,729,729
Santa Barbara,31,2022-07-20,1281,1288,1287,1,9294,9335,9328,7,51,1,1,2,712,712,711,711
Santa Clara,31,2022-07-20,6082,6110,6108,2,52678,52911,52897,14,203,14,14,33,2415,2415,2401,2401
Santa Cruz,31,2022-07-20,858,862,861,1,7318,7350,7345,5,21,1,1,3,268,268,267,267
Shasta,31,2022-07-20,281,281,281,0,3168,3183,3181,2,41,2,2,6,580,580,578,578
Siskiyou,31,2022-07-20,41,41,41,0,332,333,332,1,3,1,1,0,87,87,86,86
Solano,31,2022-07-20,1259,1265,1264,1,9544,9586,9579,7,45,0,0,7,453,453,453,453
Sonoma,31,2022-07-20,1032,1038,1037,1,8668,8706,8700,6,36,0,0,4,505,505,505,505
Stanislaus,31,2022-07-20,1395,1402,1400,2,8207,8243,8234,9,120,7,7,10,1730,1730,1723,1723
Sutter,31,2022-07-20,239,239,239,0,1714,1721,1720,1,0,0,0,0,228,228,228,228
Tehama,31,2022-07-20,111,111,111,0,895,899,898,1,6,1,1,1,209,209,208,208
Trinity,31,2022-07-20,15,15,15,0,111,112,111,1,0,0,0,0,20,20,20,20
Tulare,31,2022-07-20,1176,1182,1181,1,8048,8084,8075,9,44,1,1,0,1516,1516,1515,1515
Tuolumne,31,2022-07-20,224,224,224,0,1170,1175,1174,1,4,0,0,0,193,193,193,193
Ventura,31,2022-07-20,2326,2336,2335,1,19287,19372,19362,10,82,5,5,8,1531,1531,1526,1526
Yolo,31,2022-07-20,428,428,428,0,4616,4635,4632,3,5,2,2,2,331,331,329,329
Yuba,31,2022-07-20,217,217,217,0,1319,1324,1323,1,16,0,0,0,120,120,120,120
Alameda,32,2022-07-27,4359,4380,4378,2,39690,39884,39866,18,154,12,12,22,1972,1972,1960,1960
Amador,32,2022-07-27,84,84,84,0,1164,1169,1168,1,4,1,1,0,89,89,88,88
Butte,32,2022-07-27,373,373,373,0,2815,2830,2829,1,27,1,1,2,452,452,451,451
Calaveras,32,2022-07-27,82,82,82,0,559,562,561,1,3,3,3,2,132,132,129,129
Colusa,32,2022-07-27,22,22,22,0,362,364,363,1,1,0,0,0,22,22,22,22
Contra Costa,32,2022-07-27,2818,2831,2829,2,21556,21662,21645,17,100,8,8,15,1399,1399,1391,1391
Del Norte,32,2022-07-27,67,67,67,0,528,531,530,1,5,0,0,0,53,53,53,53
El Dorado,32,2022-07-27,260,260,260,0,2475,2488,2486,2,7,3,3,0,228,228,225,225
Fresno,32,2022-07-27,3277,3292,3290,2,20169,20268,20253,15,204,8,8,33,2825,2825,2817,2817
Glenn,32,2022-07-27,34,34,34,0,267,269,268,1,0,0,0,0,42,42,42,42
Humboldt,32,2022-07-27,218,218,218,0,1891,1902,1901,1,17,1,1,5,154,154,153,153
Imperial,32,2022-07-27,812,817,816,1,4077,4097,4094,3,14,3,3,7,954,954,951,951
Inyo,32,2022-07-27,17,17,17,0,285,286,285,1,0,1,1,0,58,58,57,57
Kern,32,2022-07-27,1915,1924,1923,1,15504,15579,15571,8,102,3,3,14,2383,2383,2380,2380
Kings,32,2022-07-27,613,616,616,0,3911,3931,3928,3,7,1,1,0,454,454,453,453
Lake,32,2022-07-27,136,136,136,0,1049,1053,1052,1,3,1,1,1,143,143,142,142
Lassen,32,2022-07-27,50,50,50,0,1017,1021,1020,1,1,0,0,0,63,63,63,63
Los Angeles,32,2022-07-27,34878,35048,35042,6,321651,323226,323167,59,1092,127,127,147,32733,32733,32606,32606
Madera,32,2022-07-27,498,498,498,0,3883,3901,3898,3,8,0,0,5,368,368,368,368
Marin,32,2022-07-27,485,485,485,0,5560,5587,5583,4,31,2,2,2,308,308,306,306
Mariposa,32,2022-07-27,32,32,32,0,213,214,213,1,0,0,0,0,29,29,29,29
Mendocino,32,2022-07-27,198,198,198,0,1406,1411,1410,1,5,1,1,0,135,135,134,134
Merced,32,2022-07-27,702,704,704,0,3859,3878,3876,2,20,3,3,2,845,845,842,842
Modoc,32,2022-07-27,10,10,10,0,28,29,28,1,1,0,0,0,9,9,9,9
Mono,32,2022-07-27,14,14,14,0,81,82,81,1,0,0,0,0,7,7,7,7
Monterey,32,2022-07-27,911,916,915,1,6795,6829,6821,8,42,0,0,1,757,757,757,757
Napa,32,2022-07-27,279,279,279,0,2881,2895,2894,1,9,1,1,2,154,154,153,153
Nevada,32,2022-07-27,123,123,123,0,1408,1415,1414,1,5,0,0,1,132,132,132,132
Orange,32,2022-07-27,7564,7601,7598,3,56017,56292,56268,24,302,31,31,48,7288,7288,7257,7257
Placer,32,2022-07-27,634,637,636,1,5077,5103,5099,4,74,3,3,11,652,652,649,649
Plumas,32,2022-07-27,19,19,19,0,174,175,174,1,0,0,0,0,13,13,13,13
Riverside,32,2022-07-27,7022,7055,7051,4,44344,44561,44535,26,222,14,14,35,6551,6551,6537,6537
Sacramento,32,2022-07-27,3440,3457,3455,2,29081,29225,29207,18,169,15,15,33,3215,3215,3200,3200
San Benito,32,2022-07-27,174,174,174,0,979,984,983,1,1,1,1,0,97,97,96,96
San Bernardino,32,2022-07-27,6882,6916,6913,3,49972,50217,50194,23,210,24,24,20,7955,7955,7931,7931
San Diego,32,2022-07-27,10969,11023,11021,2,73866,74228,74214,14,403,15,15,47,5432,5432,5417,5417
San Francisco,32,2022-07-27,2108,2119,2116,3,23152,23265,23235,30,119,10,10,22,972,972,962,962
San Joaquin,32,2022-07-27,1801,1809,1808,1,16091,16170,16159,11,77,4,4,7,2291,2291,2287,2287
San Luis Obispo,32,2022-07-27,541,543,543,0,4140,4160,4158,2,16,2,2,1,513,513,511,511
San Mateo,32,2022-07-27,1980,1989,1988,1,21572,21679,21670,9,62,1,1,8,730,730,729,729
Santa Barbara,32,2022-07-27,1137,1142,1141,1,8170,8211,8206,5,31,2,2,3,714,714,712,712
Santa Clara,32,2022-07-27,5576,5603,5602,1,48276,48512,48502,10,233,15,15,35,2430,2430,2415,2415
Santa Cruz,32,2022-07-27,786,792,792,0,7549,7586,7582,4,18,1,1,0,269,269,268,268
Shasta,32,2022-07-27,310,310,310,0,3024,3040,3038,2,31,1,1,7,581,581,580,580
Siskiyou,32,2022-07-27,52,52,52,0,328,329,328,1,2,0,0,0,87,87,87,87
Solano,32,2022-07-27,1166,1172,1171,1,9436,9482,9477,5,45,0,0,8,453,453,453,453
Sonoma,32,2022-07-27,1036,1042,1041,1,8656,8699,8694,5,52,1,1,3,506,506,505,505
Stanislaus,32,2022-07-27,1324,1331,1330,1,8125,8166,8159,7,102,11,11,14,1741,1741,1730,1730
Sutter,32,2022-07-27,233,233,233,0,1665,1673,1672,1,0,1,1,0,229,229,228,228
Tehama,32,2022-07-27,103,103,103,0,889,893,892,1,5,2,2,0,211,211,209,209
Trinity,32,2022-07-27,10,10,10,0,88,89,88,1,1,0,0,0,20,20,20,20
Tulare,32,2022-07-27,1107,1114,1113,1,7839,7877,7870,7,44,1,1,1,1517,1517,1516,1516
Tuolumne,32,2022-07-27,178,178,178,0,1152,1157,1156,1,6,0,0,2,193,193,193,193
Ventura,32,2022-07-27,2043,2055,2054,1,17490,17575,17568,7,81,5,5,3,1536,1536,1531,1531
Yolo,32,2022-07-27,392,392,392,0,4404,4426,4424,2,4,2,2,1,333,333,331,331
Yuba,32,2022-07-27,162,162,162,0,1240,1245,1244,1,6,0,0,1,120,120,120,120
Alameda,33,2022-08-03,3644,3665,3664,1,35626,35814,35801,13,172,5,5,23,1977,1977,1972,1972
Amador,33,2022-08-03,48,48,48,0,974,979,978,1,4,0,0,1,89,89,89,89
Butte,33,2022-08-03,328,328,328,0,2656,2671,2670,1,31,1,1,1,453,453,452,452
Calaveras,33,2022-08-03,65,65,65,0,611,614,613,1,2,1,1,0,133,133,132,132
Colusa,33,2022-08-03,31,31,31,0,364,366,365,1,5,0,0,0,22,22,22,22
Contra Costa,33,2022-08-03,2435,2448,2447,1,20149,20257,20245,12,101,10,10,16,1409,1409,1399,1399
Del Norte,33,2022-08-03,47,47,47,0,485,488,487,1,3,0,0,0,53,53,53,53
El Dorado,33,2022-08-03,212,212,212,0,2381,2395,2394,1,3,1,1,1,229,229,228,228
Fresno,33,2022-08-03,2728,2741,2739,2,17831,17925,17915,10,211,5,5,12,2830,2830,2825,2825
Glenn,33,2022-08-03,28,28,28,0,237,239,238,1,2,0,0,0,42,42,42,42
Humboldt,33,2022-08-03,226,226,226,0,1930,1941,1940,1,12,0,0,4,154,154,154,154
Imperial,33,2022-08-03,592,595,595,0,3430,3449,3447,2,17,3,3,2,957,957,954,954
Inyo,33,2022-08-03,22,22,22,0,280,281,280,1,0,0,0,0,58,58,58,58
Kern,33,2022-08-03,1548,1556,1555,1,14333,14408,14402,6,70,6,6,16,2389,2389,2383,2383
Kings,33,2022-08-03,547,549,549,0,3726,3745,3743,2,8,0,0,0,454,454,454,454
Lake,33,2022-08-03,115,115,115,0,947,952,951,1,4,0,0,1,143,143,143,143
Lassen,33,2022-08-03,115,115,115,0,1055,1061,1060,1,0,0,0,0,63,63,63,63
Los Angeles,33,2022-08-03,28741,28893,28889,4,302555,304158,304115,43,1124,135,138,130,32868,32871,32733,32733
Madera,33,2022-08-03,461,461,461,0,3211,3228,3226,2,9,0,0,10,368,368,368,368
Marin,33,2022-08-03,382,382,382,0,4915,4941,4938,3,26,0,0,3,308,308,308,308
Mariposa,33,2022-08-03,25,25,25,0,224,225,224,1,0,0,0,0,29,29,29,29
Mendocino,33,2022-08-03,166,166,166,0,1204,1211,1210,1,5,0,0,1,135,135,135,135
Merced,33,2022-08-03,614,617,617,0,3514,3534,3532,2,21,4,4,3,849,849,845,845
Modoc,33,2022-08-03,9,9,9,0,30,31,30,1,1,0,0,0,9,9,9,9
Mono,33,2022-08-03,6,6,6,0,75,76,75,1,0,0,0,0,7,7,7,7
Monterey,33,2022-08-03,895,900,899,1,6223,6256,6250,6,32,3,3,0,760,760,757,757
Napa,33,2022-08-03,287,287,287,0,2727,2742,2741,1,11,1,1,0,155,155,154,154
Nevada,33,2022-08-03,115,115,115,0,1338,1345,1344,1,9,0,0,1,132,132,132,132
Orange,33,2022-08-03,5935,5966,5964,2,50638,50907,50890,17,222,33,33,36,7321,7321,7288,7288
Placer,33,2022-08-03,538,539,539,0,4562,4587,4584,3,63,0,0,9,652,652,652,652
Plumas,33,2022-08-03,24,24,24,0,193,194,193,1,0,0,0,0,13,13,13,13
Riverside,33,2022-08-03,5925,5956,5953,3,41198,41416,41397,19,186,6,6,25,6557,6557,6551,6551
Sacramento,33,2022-08-03,2878,2892,2891,1,27437,27583,27570,13,183,17,17,29,3232,3232,3215,3215
San Benito,33,2022-08-03,157,157,157,0,672,677,676,1,0,1,1,0,98,98,97,97
San Bernardino,33,2022-08-03,5642,5672,5670,2,46169,46414,46397,17,183,24,24,23,7979,7979,7955,7955
San Diego,33,2022-08-03,8491,8535,8534,1,66380,66732,66722,10,373,11,11,47,5443,5443,5432,5432
San Francisco,33,2022-08-03,1697,1705,1703,2,21174,21287,21266,21,106,12,12,21,984,984,972,972
San Joaquin,33,2022-08-03,1639,1647,1646,1,15837,15922,15914,8,69,7,7,8,2298,2298,2291,2291
San Luis Obispo,33,2022-08-03,573,575,575,0,3877,3897,3895,2,22,1,1,2,514,514,513,513
San Mateo,33,2022-08-03,1645,1653,1652,1,19303,19405,19399,6,75,0,0,6,730,730,730,730
Santa Barbara,33,2022-08-03,1073,1079,1079,0,7903,7945,7941,4,42,1,1,2,715,715,714,714
Santa Clara,33,2022-08-03,4467,4490,4489,1,42275,42499,42492,7,242,18,18,33,2448,2448,2430,2430
Santa Cruz,33,2022-08-03,716,719,719,0,6295,6328,6326,2,29,0,0,2,269,269,269,269
Shasta,33,2022-08-03,205,205,205,0,2998,3014,3013,1,31,0,0,8,581,581,581,581
Siskiyou,33,2022-08-03,58,58,58,0,311,312,311,1,1,1,1,0,88,88,87,87
Solano,33,2022-08-03,1058,1064,1064,0,8746,8792,8788,4,40,0,0,8,453,453,453,453
Sonoma,33,2022-08-03,950,956,956,0,7992,8034,8030,4,40,4,4,5,510,510,506,506
Stanislaus,33,2022-08-03,1151,1158,1157,1,7184,7222,7217,5,98,2,2,10,1743,1743,1741,1741
Sutter,33,2022-08-03,245,245,245,0,1630,1638,1637,1,0,2,2,0,231,231,229,229
Tehama,33,2022-08-03,79,79,79,0,718,722,721,1,2,0,0,0,211,211,211,211
Trinity,33,2022-08-03,9,9,9,0,75,76,75,1,0,0,0,0,20,20,20,20
Tulare,33,2022-08-03,978,984,983,1,7353,7393,7388,5,50,2,2,3,1519,1519,1517,1517
Tuolumne,33,2022-08-03,141,141,141,0,1087,1092,1091,1,6,0,0,1,193,193,193,193
Ventura,33,2022-08-03,1687,1695,1694,1,16706,16795,16790,5,71,7,7,12,1543,1543,1536,1536
Yolo,33,2022-08-03,315,315,315,0,3997,4018,4016,2,5,2,2,4,335,335,333,333
Yuba,33,2022-08-03,148,148,148,0,1139,1145,1144,1,7,0,0,3,120,120,120,120
Alameda,34,2022-08-10,2962,2981,2980,1,34667,34880,34870,10,141,11,11,17,1988,1988,1977,1977
Amador,34,2022-08-10,49,49,49,0,821,827,826,1,4,0,0,0,89,89,89,89
Butte,34,2022-08-10,326,326,326,0,2465,2480,2479,1,25,1,1,1,454,454,453,453
Calaveras,34,2022-08-10,51,51,51,0,558,562,561,1,2,0,0,0,133,133,133,133
Colusa,34,2022-08-10,11,11,11,0,405,409,408,1,0,0,0,0,22,22,22,22
Contra Costa,34,2022-08-10,2072,2085,2084,1,19487,19606,19597,9,89,5,5,12,1414,1414,1409,1409
Del Norte,34,2022-08-10,58,58,58,0,495,499,498,1,3,1,1,0,54,54,53,53
El Dorado,34,2022-08-10,191,191,191,0,2306,2320,2319,1,7,0,0,2,229,229,229,229
Fresno,34,2022-08-10,2204,2217,2216,1,17224,17330,17322,8,143,8,8,38,2838,2838,2830,2830
Glenn,34,2022-08-10,18,18,18,0,252,254,253,1,0,0,0,0,42,42,42,42
Humboldt,34,2022-08-10,196,196,196,0,1830,1842,1841,1,16,1,1,2,155,155,154,154
Imperial,34,2022-08-10,474,475,475,0,3161,3181,3180,1,16,2,2,3,959,959,957,957
Inyo,34,2022-08-10,3,3,3,0,254,256,255,1,0,1,1,0,59,59,58,58
Kern,34,2022-08-10,1276,1284,1284,0,13286,13368,13364,4,62,8,8,13,2397,2397,2389,2389
Kings,34,2022-08-10,419,420,420,0,3232,3252,3251,1,14,0,0,2,454,454,454,454
Lake,34,2022-08-10,106,106,106,0,936,942,941,1,1,0,0,1,143,143,143,143
Lassen,34,2022-08-10,128,128,128,0,1013,1020,1019,1,1,0,0,0,63,63,63,63
Los Angeles,34,2022-08-10,23705,23850,23847,3,287112,288881,288849,32,973,115,119,125,32983,32990,32868,32871
Madera,34,2022-08-10,339,339,339,0,3005,3023,3022,1,19,0,0,3,368,368,368,368
Marin,34,2022-08-10,353,353,353,0,4241,4266,4264,2,24,2,2,4,310,310,308,308
Mariposa,34,2022-08-10,25,25,25,0,209,210,209,1,0,0,0,0,29,29,29,29
Mendocino,34,2022-08-10,106,106,106,0,1055,1060,1059,1,3,1,1,3,136,136,135,135
Merced,34,2022-08-10,473,474,474,0,3421,3442,3441,1,11,1,1,6,850,850,849,849
Modoc,34,2022-08-10,3,3,3,0,21,22,21,1,1,0,0,0,9,9,9,9
Mono,34,2022-08-10,7,7,7,0,82,83,82,1,0,0,0,0,7,7,7,7
Monterey,34,2022-08-10,678,683,683,0,5617,5651,5647,4,33,0,0,0,760,760,760,760
Napa,34,2022-08-10,229,229,229,0,2515,2531,2530,1,12,1,1,2,156,156,155,155
Nevada,34,2022-08-10,91,91,91,0,1219,1225,1224,1,2,0,0,0,132,132,132,132
Orange,34,2022-08-10,5083,5114,5113,1,46048,46331,46319,12,243,32,32,46,7353,7353,7321,7321
Placer,34,2022-08-10,474,475,475,0,4509,4538,4536,2,67,3,3,12,655,655,652,652
Plumas,34,2022-08-10,22,22,22,0,180,181,180,1,0,0,0,0,13,13,13,13
Riverside,34,2022-08-10,5123,5154,5152,2,38999,39238,39224,14,184,8,8,13,6565,6565,6557,6557
Sacramento,34,2022-08-10,2578,2593,2592,1,26259,26420,26410,10,162,15,15,20,3247,3247,3232,3232
San Benito,34,2022-08-10,160,160,160,0,694,701,700,1,1,1,1,1,99,99,98,98
San Bernardino,34,2022-08-10,4750,4780,4779,1,44120,44393,44381,12,166,19,19,23,7998,7998,7979,7979
San Diego,34,2022-08-10,6682,6723,6722,1,61243,61620,61613,7,290,9,9,36,5452,5452,5443,5443
San Francisco,34,2022-08-10,1443,1452,1451,1,19738,19860,19845,15,109,13,13,13,997,997,984,984
San Joaquin,34,2022-08-10,1484,1493,1492,1,15279,15373,15367,6,53,6,6,9,2304,2304,2298,2298
San Luis Obispo,34,2022-08-10,436,437,437,0,3579,3600,3599,1,13,2,2,2,516,516,514,514
San Mateo,34,2022-08-10,1362,1370,1370,0,17379,17486,17481,5,59,0,0,4,730,730,730,730
Santa Barbara,34,2022-08-10,905,911,911,0,7242,7286,7283,3,40,3,3,4,718,718,715,715
Santa Clara,34,2022-08-10,3869,3893,3893,0,38653,38891,38886,5,198,11,11,31,2459,2459,2448,2448
Santa Cruz,34,2022-08-10,572,574,574,0,5951,5988,5986,2,24,1,1,0,270,270,269,269
Shasta,34,2022-08-10,193,193,193,0,2823,2840,2839,1,24,2,2,0,583,583,581,581
Siskiyou,34,2022-08-10,35,35,35,0,289,290,289,1,1,0,0,0,88,88,88,88
Solano,34,2022-08-10,755,760,760,0,7424,7470,7467,3,51,0,0,8,453,453,453,453
Sonoma,34,2022-08-10,705,710,710,0,7531,7578,7575,3,38,4,4,3,514,514,510,510
Stanislaus,34,2022-08-10,965,972,971,1,7321,7367,7363,4,87,7,7,9,1750,1750,1743,1743
Sutter,34,2022-08-10,200,200,200,0,1567,1577,1576,1,0,1,1,0,232,232,231,231
Tehama,34,2022-08-10,72,72,72,0,665,670,669,1,1,0,0,1,211,211,211,211
Trinity,34,2022-08-10,6,6,6,0,60,61,60,1,0,0,0,0,20,20,20,20
Tulare,34,2022-08-10,820,826,826,0,7156,7200,7196,4,35,5,5,5,1524,1524,1519,1519
Tuolumne,34,2022-08-10,105,105,105,0,1042,1049,1048,1,2,0,0,0,193,193,193,193
Ventura,34,2022-08-10,1460,1470,1470,0,15700,15797,15793,4,80,6,6,8,1549,1549,1543,1543
Yolo,34,2022-08-10,279,279,279,0,3761,3785,3784,1,8,0,0,2,335,335,335,335
Yuba,34,2022-08-10,133,133,133,0,1097,1104,1103,1,8,0,0,0,120,120,120,120
Alameda,35,2022-08-17,2426,2444,2443,1,33315,33555,33548,7,102,9,9,22,1997,1997,1988,1988
Amador,35,2022-08-17,56,56,56,0,903,912,911,1,4,0,0,1,89,89,89,89
Butte,35,2022-08-17,219,219,219,0,2191,2207,2206,1,17,0,0,2,454,454,454,454
Calaveras,35,2022-08-17,43,43,43,0,525,530,529,1,0,0,0,0,133,133,133,133
Colusa,35,2022-08-17,17,17,17,0,350,353,352,1,0,0,0,0,22,22,22,22
Contra Costa,35,2022-08-17,1626,1638,1637,1,18997,19133,19126,7,57,6,6,8,1420,1420,1414,1414
Del Norte,35,2022-08-17,34,34,34,0,488,492,491,1,2,0,0,0,54,54,54,54
El Dorado,35,2022-08-17,169,169,169,0,2306,2322,2321,1,7,0,0,2,229,229,229,229
Fresno,35,2022-08-17,1714,1726,1725,1,15948,16064,16058,6,173,5,5,15,2843,2843,2838,2838
Glenn,35,2022-08-17,17,17,17,0,226,228,227,1,2,0,0,0,42,42,42,42
Humboldt,35,2022-08-17,161,161,161,0,1598,1611,1610,1,9,1,1,2,156,156,155,155
Imperial,35,2022-08-17,336,336,336,0,3083,3104,3103,1,15,0,0,0,959,959,959,959
Inyo,35,2022-08-17,16,16,16,0,268,271,270,1,1,0,0,0,59,59,59,59
Kern,35,2022-08-17,1049,1056,1056,0,13370,13466,13463,3,57,5,5,19,2402,2402,2397,2397
Kings,35,2022-08-17,326,327,327,0,3256,3279,3278,1,7,0,0,1,454,454,454,454
Lake,35,2022-08-17,89,89,89,0,988,995,994,1,3,1,1,0,144,144,143,143
Lassen,35,2022-08-17,54,54,54,0,821,829,828,1,0,0,0,0,63,63,63,63
Los Angeles,35,2022-08-17,20156,20300,20298,2,281297,283323,283299,24,887,110,115,109,33093,33105,32983,32990
Madera,35,2022-08-17,300,300,300,0,2887,2909,2908,1,13,1,1,3,369,369,368,368
Marin,35,2022-08-17,262,262,262,0,4017,4046,4045,1,14,0,0,3,310,310,310,310
Mariposa,35,2022-08-17,6,6,6,0,185,186,185,1,0,0,0,0,29,29,29,29
Mendocino,35,2022-08-17,102,102,102,0,1030,1036,1035,1,5,0,0,2,136,136,136,136
Merced,35,2022-08-17,442,444,444,0,3534,3558,3557,1,10,3,3,3,853,853,850,850
Modoc,35,2022-08-17,7,7,7,0,27,28,27,1,0,0,0,0,9,9,9,9
Mono,35,2022-08-17,6,6,6,0,62,63,62,1,0,0,0,0,7,7,7,7
Monterey,35,2022-08-17,637,642,642,0,6048,6091,6088,3,38,0,0,0,760,760,760,760
Napa,35,2022-08-17,191,191,191,0,2129,2145,2144,1,9,1,1,1,157,157,156,156
Nevada,35,2022-08-17,96,96,96,0,1177,1185,1184,1,3,0,0,1,132,132,132,132
Orange,35,2022-08-17,4264,4294,4293,1,41489,41788,41780,8,255,23,23,42,7376,7376,7353,7353
Placer,35,2022-08-17,404,405,405,0,4373,4404,4402,2,62,1,1,13,656,656,655,655
Plumas,35,2022-08-17,15,15,15,0,158,159,158,1,1,0,0,0,13,13,13,13
Riverside,35,2022-08-17,4482,4514,4513,1,37255,37524,37514,10,142,13,13,24,6578,6578,6565,6565
Sacramento,35,2022-08-17,2250,2267,2266,1,24765,24944,24937,7,155,15,15,22,3262,3262,3247,3247
San Benito,35,2022-08-17,119,119,119,0,618,624,623,1,4,1,1,0,100,100,99,99
San Bernardino,35,2022-08-17,4681,4714,4713,1,42895,43206,43197,9,163,16,16,22,8014,8014,7998,7998
San Diego,35,2022-08-17,5155,5192,5192,0,58234,58656,58651,5,265,12,12,36,5464,5464,5452,5452
San Francisco,35,2022-08-17,1103,1111,1110,1,18961,19098,19086,12,117,15,15,9,1012,1012,997,997
San Joaquin,35,2022-08-17,1376,1387,1387,0,15242,15352,15347,5,60,5,5,12,2309,2309,2304,2304
San Luis Obispo,35,2022-08-17,270,270,270,0,3154,3176,3175,1,15,3,3,1,519,519,516,516
San Mateo,35,2022-08-17,1161,1169,1169,0,17001,17123,17120,3,46,0,0,4,730,730,730,730
Santa Barbara,35,2022-08-17,757,764,764,0,7138,7190,7188,2,41,2,2,4,720,720,718,718
Santa Clara,35,2022-08-17,3180,3203,3203,0,39312,39596,39592,4,170,7,7,30,2466,2466,2459,2459
Santa Cruz,35,2022-08-17,474,477,477,0,8697,8760,8758,2,19,3,3,2,273,273,270,270
Shasta,35,2022-08-17,188,188,188,0,2726,2745,2744,1,14,0,0,2,583,583,583,583
Siskiyou,35,2022-08-17,27,27,27,0,263,264,263,1,3,0,0,1,88,88,88,88
Solano,35,2022-08-17,587,592,592,0,7253,7304,7302,2,49,0,0,10,453,453,453,453
Sonoma,35,2022-08-17,595,600,600,0,7232,7284,7282,2,37,2,2,3,516,516,514,514
Stanislaus,35,2022-08-17,939,946,946,0,7581,7636,7633,3,104,10,10,9,1760,1760,1750,1750
Sutter,35,2022-08-17,185,185,185,0,1626,1640,1639,1,0,0,0,0,232,232,232,232
Tehama,35,2022-08-17,50,50,50,0,626,631,630,1,2,0,0,0,211,211,211,211
Trinity,35,2022-08-17,12,12,12,0,61,62,61,1,0,0,0,0,20,20,20,20
Tulare,35,2022-08-17,679,685,685,0,7231,7284,7281,3,30,2,2,3,1526,1526,1524,1524
Tuolumne,35,2022-08-17,106,106,106,0,998,1005,1004,1,1,0,0,0,193,193,193,193
Ventura,35,2022-08-17,1476,1487,1487,0,15159,15269,15266,3,65,3,3,5,1552,1552,1549,1549
Yolo,35,2022-08-17,218,218,218,0,3463,3489,3488,1,4,1,1,0,336,336,335,335
Yuba,35,2022-08-17,127,127,127,0,1084,1092,1091,1,10,0,0,2,120,120,120,120
Alameda,36,2022-08-24,2158,2177,2177,0,33120,33398,33392,6,97,11,11,14,2008,2008,1997,1997
Amador,36,2022-08-24,40,40,40,0,797,806,805,1,1,2,2,1,91,91,89,89
Butte,36,2022-08-24,243,243,243,0,2103,2121,2120,1,22,1,1,2,455,455,454,454
Calaveras,36,2022-08-24,53,53,53,0,592,598,597,1,0,0,0,0,133,133,133,133
Colusa,36,2022-08-24,17,17,17,0,392,396,395,1,0,0,0,0,22,22,22,22
Contra Costa,36,2022-08-24,1429,1441,1441,0,18599,18755,18750,5,48,5,5,7,1425,1425,1420,1420
Del Norte,36,2022-08-24,27,27,27,0,478,484,483,1,1,1,1,0,55,55,54,54
El Dorado,36,2022-08-24,142,142,142,0,2069,2087,2086,1,3,1,1,0,230,230,229,229
Fresno,36,2022-08-24,1510,1522,1522,0,16121,16257,16253,4,156,6,6,12,2849,2849,2843,2843
Glenn,36,2022-08-24,22,22,22,0,213,215,214,1,1,0,0,0,42,42,42,42
Humboldt,36,2022-08-24,131,131,131,0,1749,1765,1764,1,4,0,0,2,156,156,156,156
Imperial,36,2022-08-24,304,306,306,0,2787,2810,2809,1,8,0,0,5,959,959,959,959
Inyo,36,2022-08-24,6,6,6,0,203,204,203,1,0,0,0,0,59,59,59,59
Kern,36,2022-08-24,918,926,926,0,13883,13999,13996,3,54,5,5,6,2407,2407,2402,2402
Kings,36,2022-08-24,353,355,355,0,3772,3803,3802,1,8,1,1,0,455,455,454,454
Lake,36,2022-08-24,108,108,108,0,904,912,911,1,1,1,1,0,145,145,144,144
Lassen,36,2022-08-24,28,28,28,0,811,820,819,1,0,0,0,0,63,63,63,63
Los Angeles,36,2022-08-24,17475,17622,17621,1,276041,278357,278338,19,767,108,115,96,33201,33220,33093,33105
Madera,36,2022-08-24,279,279,279,0,2694,2717,2716,1,3,1,1,0,370,370,369,369
Marin,36,2022-08-24,230,230,230,0,3874,3908,3907,1,18,0,0,2,310,310,310,310
Mariposa,36,2022-08-24,19,19,19,0,189,190,189,1,0,0,0,0,29,29,29,29
Mendocino,36,2022-08-24,120,120,120,0,1133,1143,1142,1,3,0,0,1,136,136,136,136
Merced,36,2022-08-24,421,424,424,0,3531,3561,3560,1,13,3,3,1,856,856,853,853
Modoc,36,2022-08-24,2,2,2,0,21,22,21,1,0,0,0,0,9,9,9,9
Mono,36,2022-08-24,2,2,2,0,57,58,57,1,0,0,0,0,7,7,7,7
Monterey,36,2022-08-24,494,499,499,0,5672,5719,5717,2,6,2,2,20,762,762,760,760
Napa,36,2022-08-24,125,125,125,0,2003,2022,2021,1,5,0,0,1,157,157,157,157
Nevada,36,2022-08-24,83,83,83,0,1194,1206,1205,1,5,0,0,0,132,132,132,132
Orange,36,2022-08-24,3482,3512,3511,1,40155,40493,40487,6,182,21,21,28,7397,7397,7376,7376
Placer,36,2022-08-24,385,388,388,0,4292,4328,4327,1,60,1,1,12,657,657,656,656
Plumas,36,2022-08-24,21,21,21,0,184,185,184,1,0,0,0,0,13,13,13,13
Riverside,36,2022-08-24,4163,4198,4197,1,36894,37204,37196,8,110,12,12,22,6590,6590,6578,6578
Sacramento,36,2022-08-24,2004,2021,2021,0,24825,25033,25027,6,128,10,10,26,3272,3272,3262,3262
San Benito,36,2022-08-24,117,117,117,0,637,643,642,1,2,0,0,1,100,100,100,100
San Bernardino,36,2022-08-24,4345,4380,4379,1,42390,42746,42739,7,136,15,15,16,8029,8029,8014,8014
San Diego,36,2022-08-24,4431,4468,4468,0,57839,58324,58320,4,242,5,5,24,5469,5469,5464,5464
San Francisco,36,2022-08-24,1038,1046,1046,0,17918,18069,18061,8,82,12,12,8,1024,1024,1012,1012
San Joaquin,36,2022-08-24,1096,1105,1105,0,14782,14906,14902,4,36,2,2,8,2311,2311,2309,2309
San Luis Obispo,36,2022-08-24,271,271,271,0,3201,3228,3227,1,20,0,0,0,519,519,519,519
San Mateo,36,2022-08-24,903,910,910,0,16443,16582,16579,3,29,0,0,1,730,730,730,730
Santa Barbara,36,2022-08-24,709,716,716,0,7745,7810,7808,2,37,0,0,1,720,720,720,720
Santa Clara,36,2022-08-24,2798,2821,2821,0,39098,39427,39424,3,171,7,7,29,2473,2473,2466,2466
Santa Cruz,36,2022-08-24,502,507,507,0,13252,13362,13360,2,11,0,0,0,273,273,273,273
Shasta,36,2022-08-24,155,155,155,0,2746,2769,2768,1,14,2,2,2,585,585,583,583
Siskiyou,36,2022-08-24,22,22,22,0,258,259,258,1,3,1,1,0,89,89,88,88
Solano,36,2022-08-24,522,527,527,0,7291,7351,7349,2,41,0,0,8,453,453,453,453
Sonoma,36,2022-08-24,564,569,569,0,7144,7204,7203,1,30,0,0,3,516,516,516,516
Stanislaus,36,2022-08-24,891,898,898,0,7868,7934,7931,3,77,6,6,15,1766,1766,1760,1760
Sutter,36,2022-08-24,186,186,186,0,1579,1594,1593,1,0,0,0,0,232,232,232,232
Tehama,36,2022-08-24,53,53,53,0,654,661,660,1,1,0,0,0,211,211,211,211
Trinity,36,2022-08-24,9,9,9,0,63,64,63,1,0,0,0,0,20,20,20,20
Tulare,36,2022-08-24,731,738,738,0,7172,7233,7231,2,37,2,2,1,1528,1528,1526,1526
Tuolumne,36,2022-08-24,119,119,119,0,1013,1022,1021,1,1,0,0,0,193,193,193,193
Ventura,36,2022-08-24,1144,1153,1153,0,14684,14807,14805,2,69,3,3,5,1555,1555,1552,1552
Yolo,36,2022-08-24,209,209,209,0,3584,3614,3613,1,10,1,1,1,337,337,336,336
Yuba,36,2022-08-24,133,133,133,0,1115,1127,1126,1,10,0,0,2,120,120,120,120
Alameda,37,2022-08-31,1848,1867,1867,0,33724,34057,34053,4,94,11,11,21,2019,2019,2008,2008
Amador,37,2022-08-31,55,55,55,0,817,826,825,1,2,0,0,1,91,91,91,91
Butte,37,2022-08-31,232,233,233,0,2381,2406,2405,1,21,1,1,3,456,456,455,455
Calaveras,37,2022-08-31,43,43,43,0,580,586,585,1,1,0,0,0,133,133,133,133
Colusa,37,2022-08-31,5,5,5,0,288,291,290,1,1,0,0,0,22,22,22,22
Contra Costa,37,2022-08-31,1223,1235,1235,0,18517,18700,18696,4,48,4,4,9,1429,1429,1425,1425
Del Norte,37,2022-08-31,24,24,24,0,391,397,396,1,5,0,0,1,55,55,55,55
El Dorado,37,2022-08-31,130,130,130,0,1933,1954,1953,1,1,0,0,1,230,230,230,230
Fresno,37,2022-08-31,1333,1346,1346,0,15472,15624,15621,3,156,3,3,17,2852,2852,2849,2849
Glenn,37,2022-08-31,17,17,17,0,230,232,231,1,3,0,0,0,42,42,42,42
Humboldt,37,2022-08-31,132,132,132,0,1597,1615,1614,1,5,0,0,0,156,156,156,156
Imperial,37,2022-08-31,263,264,264,0,3016,3046,3045,1,13,1,1,4,960,960,959,959
Inyo,37,2022-08-31,6,6,6,0,173,174,173,1,0,0,0,0,59,59,59,59
Kern,37,2022-08-31,818,826,826,0,13361,13493,13491,2,64,1,1,6,2408,2408,2407,2407
Kings,37,2022-08-31,336,340,340,0,3430,3465,3464,1,7,0,0,0,455,455,455,455
Lake,37,2022-08-31,68,68,68,0,846,855,854,1,5,2,2,0,147,147,145,145
Lassen,37,2022-08-31,31,31,31,0,782,790,789,1,0,0,0,0,63,63,63,63
Los Angeles,37,2022-08-31,14197,14336,14335,1,272269,274959,274945,14,674,78,84,90,33279,33304,33201,33220
Madera,37,2022-08-31,283,284,284,0,3160,3192,3191,1,12,0,0,6,370,370,370,370
Marin,37,2022-08-31,213,213,213,0,3911,3948,3947,1,15,2,2,1,312,312,310,310
Mariposa,37,2022-08-31,18,18,18,0,195,196,195,1,0,0,0,0,29,29,29,29
Mendocino,37,2022-08-31,71,71,71,0,966,978,977,1,2,1,1,1,137,137,136,136
Merced,37,2022-08-31,351,354,354,0,3367,3400,3399,1,11,3,3,0,859,859,856,856
Modoc,37,2022-08-31,2,2,2,0,30,31,30,1,0,0,0,0,9,9,9,9
Mono,37,2022-08-31,5,5,5,0,50,51,50,1,0,0,0,0,7,7,7,7
Monterey,37,2022-08-31,331,333,333,0,5232,5283,5281,2,30,2,2,4,764,764,762,762
Napa,37,2022-08-31,122,122,122,0,2272,2295,2294,1,7,0,0,1,157,157,157,157
Nevada,37,2022-08-31,117,117,117,0,1185,1200,1199,1,5,0,0,0,132,132,132,132
Orange,37,2022-08-31,2711,2739,2739,0,38713,39096,39091,5,168,18,18,40,7415,7415,7397,7397
Placer,37,2022-08-31,302,303,303,0,4146,4186,4185,1,59,1,1,11,658,658,657,657
Plumas,37,2022-08-31,13,13,13,0,159,160,159,1,0,0,0,0,13,13,13,13
Riverside,37,2022-08-31,3374,3407,3406,1,35940,36294,36288,6,127,8,8,16,6598,6598,6590,6590
Sacramento,37,2022-08-31,1653,1670,1670,0,23733,23967,23963,4,141,13,13,18,3285,3285,3272,3272
San Benito,37,2022-08-31,99,99,99,0,670,677,676,1,0,0,0,1,100,100,100,100
San Bernardino,37,2022-08-31,3300,3333,3333,0,40503,40903,40898,5,140,16,16,23,8045,8045,8029,8029
San Diego,37,2022-08-31,3779,3816,3816,0,56262,56820,56817,3,241,15,15,28,5484,5484,5469,5469
San Francisco,37,2022-08-31,778,786,786,0,18441,18622,18615,7,61,9,9,11,1033,1033,1024,1024
San Joaquin,37,2022-08-31,951,960,960,0,13399,13530,13527,3,43,5,5,9,2316,2316,2311,2311
San Luis Obispo,37,2022-08-31,290,291,291,0,3279,3313,3312,1,12,3,3,0,522,522,519,519
San Mateo,37,2022-08-31,787,795,795,0,15820,15977,15975,2,25,0,0,3,730,730,730,730
Santa Barbara,37,2022-08-31,603,609,609,0,7640,7716,7715,1,30,2,2,3,722,722,720,720
Santa Clara,37,2022-08-31,2210,2231,2231,0,38071,38447,38445,2,155,7,7,20,2480,2480,2473,2473
Santa Cruz,37,2022-08-31,363,367,367,0,12596,12721,12719,2,9,0,0,1,273,273,273,273
Shasta,37,2022-08-31,127,127,127,0,2551,2577,2576,1,15,1,1,0,586,586,585,585
Siskiyou,37,2022-08-31,32,32,32,0,235,236,235,1,2,1,1,1,90,90,89,89
Solano,37,2022-08-31,527,533,533,0,7405,7479,7478,1,34,2,2,8,455,455,453,453
Sonoma,37,2022-08-31,463,468,468,0,7327,7399,7398,1,35,1,1,2,517,517,516,516
Stanislaus,37,2022-08-31,782,790,790,0,7970,8048,8046,2,80,6,6,6,1772,1772,1766,1766
Sutter,37,2022-08-31,161,161,161,0,1651,1669,1668,1,0,0,0,0,232,232,232,232
Tehama,37,2022-08-31,65,65,65,0,766,773,772,1,4,1,1,0,212,212,211,211
Trinity,37,2022-08-31,4,4,4,0,53,54,53,1,0,0,0,0,20,20,20,20
Tulare,37,2022-08-31,597,604,604,0,7072,7142,7140,2,39,0,0,2,1528,1528,1528,1528
Tuolumne,37,2022-08-31,82,82,82,0,866,877,876,1,1,0,0,0,193,193,193,193
Ventura,37,2022-08-31,977,987,987,0,14822,14968,14966,2,54,7,7,5,1562,1562,1555,1555
Yolo,37,2022-08-31,182,182,182,0,3306,3339,3338,1,4,3,3,3,340,340,337,337
Yuba,37,2022-08-31,118,118,118,0,1190,1203,1202,1,9,0,0,0,120,120,120,120
Alameda,38,2022-09-07,1412,1427,1427,0,28074,28388,28385,3,93,0,0,18,2019,2019,2019,2019
Amador,38,2022-09-07,26,26,26,0,756,766,765,1,5,0,0,1,91,91,91,91
Butte,38,2022-09-07,190,191,191,0,2183,2209,2208,1,17,2,2,3,458,458,456,456
Calaveras,38,2022-09-07,22,22,22,0,452,458,457,1,0,0,0,0,133,133,133,133
Colusa,38,2022-09-07,16,16,16,0,251,254,253,1,2,0,0,0,22,22,22,22
Contra Costa,38,2022-09-07,963,974,974,0,15841,16019,16016,3,52,4,4,11,1433,1433,1429,1429
Del Norte,38,2022-09-07,18,18,18,0,463,468,467,1,1,0,0,1,55,55,55,55
El Dorado,38,2022-09-07,92,92,92,0,1658,1677,1676,1,1,0,0,1,230,230,230,230
Fresno,38,2022-09-07,1021,1033,1033,0,13367,13518,13516,2,165,12,12,13,2864,2864,2852,2852
Glenn,38,2022-09-07,14,14,14,0,186,188,187,1,1,0,0,0,42,42,42,42
Humboldt,38,2022-09-07,96,96,96,0,1405,1422,1421,1,5,1,1,0,157,157,156,156
Imperial,38,2022-09-07,247,250,250,0,2776,2809,2808,1,13,0,0,1,960,960,960,960
Inyo,38,2022-09-07,14,14,14,0,184,186,185,1,0,0,0,0,59,59,59,59
Kern,38,2022-09-07,642,649,649,0,11067,11191,11190,1,43,3,3,13,2411,2411,2408,2408
Kings,38,2022-09-07,201,202,202,0,2802,2835,2834,1,7,0,0,1,455,455,455,455
Lake,38,2022-09-07,48,48,48,0,757,767,766,1,5,0,0,0,147,147,147,147
Lassen,38,2022-09-07,21,21,21,0,804,814,813,1,0,0,0,0,63,63,63,63
Los Angeles,38,2022-09-07,10506,10625,10625,0,239831,242534,242524,10,679,102,109,101,33381,33413,33279,33304
Madera,38,2022-09-07,213,214,214,0,2483,2512,2511,1,11,0,0,5,370,370,370,370
Marin,38,2022-09-07,179,179,179,0,3683,3724,3723,1,16,0,0,2,312,312,312,312
Mariposa,38,2022-09-07,12,12,12,0,178,180,179,1,0,0,0,0,29,29,29,29
Mendocino,38,2022-09-07,54,54,54,0,876,888,887,1,4,0,0,2,137,137,137,137
Merced,38,2022-09-07,235,236,236,0,2763,2796,2795,1,12,2,2,3,861,861,859,859
Modoc,38,2022-09-07,4,4,4,0,19,20,19,1,0,0,0,0,9,9,9,9
Mono,38,2022-09-07,3,3,3,0,58,59,58,1,0,0,0,0,7,7,7,7
Monterey,38,2022-09-07,252,253,253,0,4479,4529,4528,1,29,2,2,0,766,766,764,764
Napa,38,2022-09-07,105,105,105,0,1859,1881,1880,1,6,1,1,1,158,158,157,157
Nevada,38,2022-09-07,61,61,61,0,979,992,991,1,2,0,0,0,132,132,132,132
Orange,38,2022-09-07,2101,2123,2123,0,32366,32731,32728,3,176,16,17,28,7431,7432,7415,7415
Placer,38,2022-09-07,256,258,258,0,3500,3540,3539,1,40,0,0,4,658,658,658,658
Plumas,38,2022-09-07,12,12,12,0,150,152,151,1,0,0,0,0,13,13,13,13
Riverside,38,2022-09-07,2365,2392,2392,0,28963,29290,29286,4,126,5,5,14,6603,6603,6598,6598
Sacramento,38,2022-09-07,1269,1283,1283,0,20441,20670,20667,3,141,10,10,27,3295,3295,3285,3285
San Benito,38,2022-09-07,79,79,79,0,521,528,527,1,1,0,0,2,100,100,100,100
San Bernardino,38,2022-09-07,1964,1987,1987,0,33305,33679,33676,3,116,13,13,22,8058,8058,8045,8045
San Diego,38,2022-09-07,2774,2806,2806,0,48983,49533,49531,2,207,5,5,31,5489,5489,5484,5484
San Francisco,38,2022-09-07,735,744,744,0,15215,15387,15383,4,69,9,9,10,1042,1042,1033,1033
San Joaquin,38,2022-09-07,758,767,767,0,12463,12604,12602,2,31,5,5,9,2321,2321,2316,2316
San Luis Obispo,38,2022-09-07,195,196,196,0,2819,2851,2850,1,12,2,2,1,524,524,522,522
San Mateo,38,2022-09-07,617,624,624,0,12845,12988,12987,1,23,0,0,1,730,730,730,730
Santa Barbara,38,2022-09-07,431,438,438,0,6924,7002,7001,1,32,3,3,6,725,725,722,722
Santa Clara,38,2022-09-07,1787,1806,1806,0,32313,32677,32676,1,142,7,7,28,2487,2487,2480,2480
Santa Cruz,38,2022-09-07,301,305,305,0,10414,10530,10529,1,13,0,0,0,273,273,273,273
Shasta,38,2022-09-07,137,138,138,0,2220,2246,2245,1,20,0,0,1,586,586,586,586
Siskiyou,38,2022-09-07,27,27,27,0,239,242,241,1,4,0,0,1,90,90,90,90
Solano,38,2022-09-07,358,362,362,0,5957,6023,6022,1,27,0,0,5,455,455,455,455
Sonoma,38,2022-09-07,354,358,358,0,6072,6140,6139,1,41,2,2,2,519,519,517,517
Stanislaus,38,2022-09-07,484,490,490,0,6705,6781,6780,1,79,4,4,4,1776,1776,1772,1772
Sutter,38,2022-09-07,118,118,118,0,1447,1463,1462,1,0,0,0,0,232,232,232,232
Tehama,38,2022-09-07,51,51,51,0,632,640,639,1,2,0,0,0,212,212,212,212
Trinity,38,2022-09-07,3,3,3,0,54,55,54,1,0,0,0,0,20,20,20,20
Tulare,38,2022-09-07,392,396,396,0,5471,5533,5532,1,37,2,2,1,1530,1530,1528,1528
Tuolumne,38,2022-09-07,67,67,67,0,733,743,742,1,1,0,0,1,193,193,193,193
Ventura,38,2022-09-07,866,877,877,0,13081,13228,13227,1,61,5,5,3,1567,1567,1562,1562
Yolo,38,2022-09-07,130,130,130,0,2649,2680,2679,1,1,1,1,2,341,341,340,340
Yuba,38,2022-09-07,100,100,100,0,1000,1014,1013,1,7,0,0,0,120,120,120,120
Alameda,39,2022-09-14,1459,1478,1478,0,29653,30028,30026,2,85,5,5,16,2024,2024,2019,2019
Amador,39,2022-09-14,38,38,38,0,837,849,848,1,3,2,2,1,93,93,91,91
Butte,39,2022-09-14,158,158,158,0,2436,2468,2467,1,21,1,1,1,459,459,458,458
Calaveras,39,2022-09-14,16,16,16,0,475,481,480,1,0,0,0,0,133,133,133,133
Colusa,39,2022-09-14,10,10,10,0,399,404,403,1,2,0,0,0,22,22,22,22
Contra Costa,39,2022-09-14,869,881,881,0,16471,16681,16679,2,65,6,6,8,1439,1439,1433,1433
Del Norte,39,2022-09-14,27,27,27,0,522,528,527,1,2,0,0,1,55,55,55,55
El Dorado,39,2022-09-14,91,91,91,0,1712,1735,1734,1,5,0,0,2,230,230,230,230
Fresno,39,2022-09-14,749,758,758,0,13982,14160,14158,2,129,6,6,11,2870,2870,2864,2864
Glenn,39,2022-09-14,15,15,15,0,203,205,204,1,3,0,0,0,42,42,42,42
Humboldt,39,2022-09-14,105,105,105,0,1566,1586,1585,1,7,0,0,3,157,157,157,157
Imperial,39,2022-09-14,198,199,199,0,3058,3098,3097,1,16,0,0,3,960,960,960,960
Inyo,39,2022-09-14,13,13,13,0,169,172,171,1,0,1,1,0,60,60,59,59
Kern,39,2022-09-14,578,585,585,0,12351,12509,12508,1,51,7,7,7,2418,2418,2411,2411
Kings,39,2022-09-14,183,183,183,0,2902,2939,2938,1,6,2,2,0,457,457,455,455
Lake,39,2022-09-14,50,50,50,0,834,846,845,1,3,0,0,0,147,147,147,147
Lassen,39,2022-09-14,8,8,8,0,732,742,741,1,0,0,0,0,63,63,63,63
Los Angeles,39,2022-09-14,9571,9693,9693,0,255366,258611,258603,8,593,74,82,84,33455,33495,33381,33413
Madera,39,2022-09-14,162,163,163,0,2876,2912,2911,1,16,0,0,3,370,370,370,370
Marin,39,2022-09-14,149,149,149,0,3572,3619,3618,1,15,2,2,2,314,314,312,312
Mariposa,39,2022-09-14,13,13,13,0,194,195,194,1,0,0,0,0,29,29,29,29
Mendocino,39,2022-09-14,40,40,40,0,916,929,928,1,1,0,0,0,137,137,137,137
Merced,39,2022-09-14,194,195,195,0,2946,2985,2984,1,6,4,4,1,865,865,861,861
Modoc,39,2022-09-14,0,0,0,0,20,21,20,1,0,0,0,0,9,9,9,9
Mono,39,2022-09-14,9,9,9,0,70,71,70,1,0,0,0,0,7,7,7,7
Monterey,39,2022-09-14,183,183,183,0,4517,4575,4574,1,13,1,1,1,767,767,766,766
Napa,39,2022-09-14,114,114,114,0,1926,1951,1950,1,5,0,0,0,158,158,158,158
Nevada,39,2022-09-14,61,61,61,0,1104,1120,1119,1,3,0,0,0,132,132,132,132
Orange,39,2022-09-14,1809,1832,1832,0,34026,34460,34457,3,129,16,16,21,7447,7448,7431,7432
Placer,39,2022-09-14,207,207,207,0,3913,3962,3961,1,56,1,1,7,659,659,658,658
Plumas,39,2022-09-14,23,23,23,0,167,169,168,1,0,0,0,0,13,13,13,13
Riverside,39,2022-09-14,1754,1776,1776,0,29420,29793,29790,3,112,7,7,6,6610,6610,6603,6603
Sacramento,39,2022-09-14,1115,1129,1129,0,21723,21999,21997,2,113,13,13,17,3308,3308,3295,3295
San Benito,39,2022-09-14,70,70,70,0,538,545,544,1,1,0,0,0,100,100,100,100
San Bernardino,39,2022-09-14,1764,1786,1786,0,33454,33877,33874,3,99,8,8,25,8066,8066,8058,8058
San Diego,39,2022-09-14,2785,2820,2820,0,54032,54718,54716,2,181,8,8,26,5497,5497,5489,5489
San Francisco,39,2022-09-14,718,727,727,0,16077,16281,16277,4,52,10,10,10,1052,1052,1042,1042
San Joaquin,39,2022-09-14,575,582,582,0,12946,13111,13109,2,27,4,4,3,2325,2325,2321,2321
San Luis Obispo,39,2022-09-14,139,139,139,0,2904,2943,2942,1,12,0,0,1,524,524,524,524
San Mateo,39,2022-09-14,597,604,604,0,13236,13404,13403,1,23,0,0,1,730,730,730,730
Santa Barbara,39,2022-09-14,267,270,270,0,6814,6902,6901,1,23,1,1,2,726,726,725,725
Santa Clara,39,2022-09-14,1738,1759,1759,0,35076,35521,35520,1,137,4,4,28,2491,2491,2487,2487
Santa Cruz,39,2022-09-14,184,184,184,0,12552,12710,12709,1,10,0,0,0,273,273,273,273
Shasta,39,2022-09-14,138,138,138,0,2225,2255,2254,1,24,1,1,3,587,587,586,586
Siskiyou,39,2022-09-14,26,26,26,0,275,280,279,1,3,1,1,1,91,91,90,90
Solano,39,2022-09-14,359,364,364,0,6266,6345,6344,1,24,0,0,5,455,455,455,455
Sonoma,39,2022-09-14,361,366,366,0,6576,6661,6660,1,28,2,2,3,521,521,519,519
Stanislaus,39,2022-09-14,384,390,390,0,7071,7161,7160,1,63,2,2,4,1778,1778,1776,1776
Sutter,39,2022-09-14,91,91,91,0,1488,1508,1507,1,0,0,0,0,232,232,232,232
Tehama,39,2022-09-14,45,45,45,0,634,642,641,1,2,0,0,0,212,212,212,212
Trinity,39,2022-09-14,3,3,3,0,75,76,75,1,0,0,0,0,20,20,20,20
Tulare,39,2022-09-14,290,294,294,0,6577,6661,6660,1,37,5,5,1,1535,1535,1530,1530
Tuolumne,39,2022-09-14,44,44,44,0,788,799,798,1,1,0,0,0,193,193,193,193
Ventura,39,2022-09-14,701,709,709,0,13695,13868,13867,1,49,2,2,5,1569,1569,1567,1567
Yolo,39,2022-09-14,130,130,130,0,3493,3539,3538,1,3,0,0,3,341,341,341,341
Yuba,39,2022-09-14,73,73,73,0,1109,1125,1124,1,5,0,0,0,120,120,120,120
Alameda,40,2022-09-21,1133,1149,1149,0,27856,28258,28256,2,73,5,5,9,2029,2029,2024,2024
Amador,40,2022-09-21,31,31,31,0,749,761,760,1,1,1,1,1,94,94,93,93
Butte,40,2022-09-21,100,100,100,0,1871,1900,1899,1,21,0,0,3,459,459,459,459
Calaveras,40,2022-09-21,28,28,28,0,406,412,411,1,3,0,0,0,133,133,133,133
Colusa,40,2022-09-21,12,12,12,0,296,300,299,1,2,0,0,0,22,22,22,22
Contra Costa,40,2022-09-21,772,782,782,0,16505,16744,16742,2,48,9,9,6,1448,1448,1439,1439
Del Norte,40,2022-09-21,22,22,22,0,481,490,489,1,2,0,0,0,55,55,55,55
El Dorado,40,2022-09-21,67,67,67,0,1570,1594,1593,1,1,0,0,1,230,230,230,230
Fresno,40,2022-09-21,534,541,541,0,12694,12878,12877,1,106,5,5,6,2875,2875,2870,2870
Glenn,40,2022-09-21,11,11,11,0,199,201,200,1,5,0,0,0,42,42,42,42
Humboldt,40,2022-09-21,95,95,95,0,1406,1428,1427,1,8,0,0,2,157,157,157,157
Imperial,40,2022-09-21,142,142,142,0,2782,2824,2823,1,5,0,0,2,960,960,960,960
Inyo,40,2022-09-21,6,6,6,0,185,188,187,1,0,0,0,0,60,60,60,60
Kern,40,2022-09-21,384,391,391,0,11143,11304,11303,1,32,2,2,12,2420,2420,2418,2418
Kings,40,2022-09-21,120,120,120,0,2689,2730,2729,1,3,2,2,0,459,459,457,457
Lake,40,2022-09-21,30,30,30,0,844,858,857,1,0,0,0,1,147,147,147,147
Lassen,40,2022-09-21,14,14,14,0,621,632,631,1,0,0,0,0,63,63,63,63
Los Angeles,40,2022-09-21,8162,8280,8280,0,250602,254235,254229,6,474,65,74,77,33520,33569,33455,33495
Madera,40,2022-09-21,119,119,119,0,2622,2661,2660,1,6,1,1,3,371,371,370,370
Marin,40,2022-09-21,154,154,154,0,3771,3826,3825,1,5,0,0,0,314,314,314,314
Mariposa,40,2022-09-21,5,5,5,0,172,174,173,1,0,1,1,0,30,30,29,29
Mendocino,40,2022-09-21,34,34,34,0,943,957,956,1,2,0,0,0,137,137,137,137
Merced,40,2022-09-21,141,141,141,0,2803,2844,2843,1,8,1,1,1,866,866,865,865
Modoc,40,2022-09-21,2,2,2,0,14,15,14,1,0,0,0,0,9,9,9,9
Mono,40,2022-09-21,0,0,0,0,69,70,69,1,0,0,0,0,7,7,7,7
Monterey,40,2022-09-21,150,151,151,0,4168,4227,4226,1,16,1,1,3,768,768,767,767
Napa,40,2022-09-21,80,80,80,0,1770,1796,1795,1,1,0,0,0,158,158,158,158
Nevada,40,2022-09-21,53,53,53,0,1130,1149,1148,1,2,0,0,0,132,132,132,132
Orange,40,2022-09-21,1676,1699,1699,0,32449,32918,32916,2,103,14,15,21,7461,7463,7447,7448
Placer,40,2022-09-21,203,205,205,0,3647,3700,3699,1,48,0,0,5,659,659,659,659
Plumas,40,2022-09-21,20,20,20,0,181,184,183,1,1,0,0,0,13,13,13,13
Riverside,40,2022-09-21,1333,1352,1352,0,27247,27641,27639,2,76,2,2,15,6612,6612,6610,6610
Sacramento,40,2022-09-21,965,978,978,0,20431,20726,20724,2,101,10,10,17,3318,3318,3308,3308
San Benito,40,2022-09-21,49,49,49,0,514,522,521,1,0,0,0,1,100,100,100,100
San Bernardino,40,2022-09-21,1317,1336,1336,0,29044,29465,29463,2,65,8,8,21,8074,8074,8066,8066
San Diego,40,2022-09-21,2513,2549,2549,0,55383,56186,56185,1,159,8,8,21,5505,5505,5497,5497
San Francisco,40,2022-09-21,628,636,636,0,15844,16072,16069,3,49,6,6,11,1058,1058,1052,1052
San Joaquin,40,2022-09-21,424,430,430,0,11846,12016,12015,1,27,4,4,2,2329,2329,2325,2325
San Luis Obispo,40,2022-09-21,128,128,128,0,2571,2609,2608,1,6,0,0,0,524,524,524,524
San Mateo,40,2022-09-21,578,586,586,0,13359,13553,13552,1,28,0,0,0,730,730,730,730
Santa Barbara,40,2022-09-21,246,250,250,0,6574,6669,6668,1,27,1,1,0,727,727,726,726
Santa Clara,40,2022-09-21,1359,1379,1379,0,36212,36736,36735,1,120,10,11,17,2501,2502,2491,2491
Santa Cruz,40,2022-09-21,146,146,146,0,12687,12871,12870,1,10,0,0,1,273,273,273,273
Shasta,40,2022-09-21,82,82,82,0,1944,1972,1971,1,19,0,0,3,587,587,587,587
Siskiyou,40,2022-09-21,21,21,21,0,205,208,207,1,4,0,0,1,91,91,91,91
Solano,40,2022-09-21,254,258,258,0,5942,6029,6028,1,26,0,0,5,455,455,455,455
Sonoma,40,2022-09-21,315,319,319,0,6340,6433,6432,1,27,1,1,1,522,522,521,521
Stanislaus,40,2022-09-21,308,314,314,0,5897,5982,5981,1,43,3,3,6,1781,1781,1778,1778
Sutter,40,2022-09-21,71,71,71,0,1200,1218,1217,1,0,0,0,0,232,232,232,232
Tehama,40,2022-09-21,27,27,27,0,538,545,544,1,1,1,1,0,213,213,212,212
Trinity,40,2022-09-21,1,1,1,0,40,41,40,1,0,0,0,0,20,20,20,20
Tulare,40,2022-09-21,185,186,186,0,5106,5180,5179,1,23,0,0,1,1535,1535,1535,1535
Tuolumne,40,2022-09-21,54,54,54,0,706,717,716,1,1,0,0,0,193,193,193,193
Ventura,40,2022-09-21,570,578,578,0,12929,13116,13115,1,35,2,2,5,1571,1571,1569,1569
Yolo,40,2022-09-21,88,88,88,0,3831,3888,3887,1,5,5,5,2,346,346,341,341
Yuba,40,2022-09-21,51,51,51,0,961,976,975,1,4,0,0,0,120,120,120,120
Alameda,41,2022-09-28,1151,1171,1171,0,27198,27652,27651,1,65,2,2,8,2031,2031,2029,2029
Amador,41,2022-09-28,18,18,18,0,701,714,713,1,0,0,0,0,94,94,94,94
Butte,41,2022-09-28,82,82,82,0,1718,1748,1747,1,19,0,0,2,459,459,459,459
Calaveras,41,2022-09-28,17,17,17,0,368,376,375,1,1,1,1,0,134,134,133,133
Colusa,41,2022-09-28,8,8,8,0,275,280,279,1,2,0,0,0,22,22,22,22
Contra Costa,41,2022-09-28,761,773,773,0,16081,16350,16349,1,32,3,3,10,1451,1451,1448,1448
Del Norte,41,2022-09-28,14,14,14,0,443,451,450,1,2,0,0,0,55,55,55,55
El Dorado,41,2022-09-28,85,85,85,0,1515,1541,1540,1,5,0,0,0,230,230,230,230
Fresno,41,2022-09-28,486,494,494,0,11632,11826,11825,1,86,3,3,7,2878,2878,2875,2875
Glenn,41,2022-09-28,6,6,6,0,172,174,173,1,5,0,0,0,42,42,42,42
Humboldt,41,2022-09-28,90,90,90,0,1290,1312,1311,1,3,2,2,0,159,159,157,157
Imperial,41,2022-09-28,116,116,116,0,2495,2537,2536,1,7,0,0,0,960,960,960,960
Inyo,41,2022-09-28,5,5,5,0,163,166,165,1,0,0,0,0,60,60,60,60
Kern,41,2022-09-28,327,332,332,0,10113,10281,10280,1,31,2,2,6,2422,2422,2420,2420
Kings,41,2022-09-28,97,97,97,0,2469,2513,2512,1,3,0,0,0,459,459,459,459
Lake,41,2022-09-28,24,24,24,0,793,807,806,1,0,0,0,1,147,147,147,147
Lassen,41,2022-09-28,7,7,7,0,564,576,575,1,0,0,0,0,63,63,63,63
Los Angeles,41,2022-09-28,7441,7564,7564,0,234249,238176,238171,5,441,59,71,58,33579,33640,33520,33569
Madera,41,2022-09-28,75,75,75,0,1867,1898,1897,1,10,0,0,3,371,371,371,371
Marin,41,2022-09-28,176,178,178,0,3690,3753,3752,1,9,0,0,0,314,314,314,314
Mariposa,41,2022-09-28,5,5,5,0,139,140,139,1,0,0,0,0,30,30,30,30
Mendocino,41,2022-09-28,41,41,41,0,800,815,814,1,3,0,0,0,137,137,137,137
Merced,41,2022-09-28,107,107,107,0,2799,2847,2846,1,12,1,1,0,867,867,866,866
Modoc,41,2022-09-28,2,2,2,0,10,11,10,1,1,0,0,0,9,9,9,9
Mono,41,2022-09-28,4,4,4,0,61,62,61,1,0,0,0,0,7,7,7,7
Monterey,41,2022-09-28,116,116,116,0,3933,4001,4000,1,13,0,0,1,768,768,768,768
Napa,41,2022-09-28,96,96,96,0,1915,1949,1948,1,2,0,0,1,158,158,158,158
Nevada,41,2022-09-28,52,52,52,0,1003,1022,1021,1,3,0,0,0,132,132,132,132
Orange,41,2022-09-28,1596,1623,1623,0,29690,30188,30187,1,125,22,27,22,7483,7490,7461,7463
Placer,41,2022-09-28,205,209,209,0,3367,3424,3423,1,41,2,2,6,661,661,659,659
Plumas,41,2022-09-28,20,20,20,0,145,147,146,1,0,0,0,0,13,13,13,13
Riverside,41,2022-09-28,1229,1251,1251,0,23378,23769,23768,1,63,5,5,11,6617,6617,6612,6612
Sacramento,41,2022-09-28,869,883,883,0,18617,18929,18928,1,94,10,10,17,3328,3328,3318,3318
San Benito,41,2022-09-28,38,38,38,0,475,484,483,1,0,1,1,0,101,101,100,100
San Bernardino,41,2022-09-28,1203,1222,1222,0,25284,25708,25707,1,78,1,1,20,8075,8075,8074,8074
San Diego,41,2022-09-28,2455,2496,2496,0,48416,49227,49226,1,182,8,8,19,5513,5513,5505,5505
San Francisco,41,2022-09-28,656,667,667,0,15171,15425,15423,2,42,3,3,6,1061,1061,1058,1058
San Joaquin,41,2022-09-28,362,368,368,0,10052,10219,10218,1,30,2,2,3,2331,2331,2329,2329
San Luis Obispo,41,2022-09-28,149,151,151,0,2483,2524,2523,1,4,0,0,1,524,524,524,524
San Mateo,41,2022-09-28,553,562,562,0,12111,12312,12311,1,22,0,0,0,730,730,730,730
Santa Barbara,41,2022-09-28,256,260,260,0,6293,6400,6399,1,20,2,2,1,729,729,727,727
Santa Clara,41,2022-09-28,1395,1419,1419,0,33709,34274,34273,1,115,8,9,16,2509,2511,2501,2502
Santa Cruz,41,2022-09-28,236,241,241,0,11832,12029,12028,1,8,0,0,0,273,273,273,273
Shasta,41,2022-09-28,55,55,55,0,1565,1592,1591,1,12,0,0,3,587,587,587,587
Siskiyou,41,2022-09-28,13,13,13,0,182,186,185,1,1,1,1,1,92,92,91,91
Solano,41,2022-09-28,298,303,303,0,5575,5669,5668,1,26,1,1,2,456,456,455,455
Sonoma,41,2022-09-28,296,301,301,0,6082,6185,6184,1,28,1,1,0,523,523,522,522
Stanislaus,41,2022-09-28,226,229,229,0,5630,5725,5724,1,44,0,0,5,1781,1781,1781,1781
Sutter,41,2022-09-28,73,73,73,0,1176,1196,1195,1,0,0,0,0,232,232,232,232
Tehama,41,2022-09-28,31,31,31,0,586,596,595,1,1,2,2,0,215,215,213,213
Trinity,41,2022-09-28,3,3,3,0,44,45,44,1,0,0,0,0,20,20,20,20
Tulare,41,2022-09-28,179,181,181,0,4955,5040,5039,1,18,4,4,2,1539,1539,1535,1535
Tuolumne,41,2022-09-28,38,38,38,0,678,690,689,1,0,0,0,0,193,193,193,193
Ventura,41,2022-09-28,522,531,531,0,10982,11165,11164,1,39,3,3,4,1574,1574,1571,1571
Yolo,41,2022-09-28,146,147,147,0,3534,3595,3594,1,6,1,1,2,347,347,346,346
Yuba,41,2022-09-28,36,36,36,0,883,899,898,1,9,0,0,0,120,120,120,120
Alameda,42,2022-10-05,1063,1084,1084,0,24381,24865,24864,1,49,2,2,8,2033,2033,2031,2031
Amador,42,2022-10-05,13,13,13,0,667,682,681,1,0,0,0,1,94,94,94,94
Butte,42,2022-10-05,74,74,74,0,1736,1770,1769,1,12,1,1,1,460,460,459,459
Calaveras,42,2022-10-05,16,16,16,0,325,333,332,1,0,1,1,0,135,135,134,134
Colusa,42,2022-10-05,4,4,4,0,102,103,102,1,0,0,0,0,22,22,22,22
Contra Costa,42,2022-10-05,653,666,666,0,14981,15279,15278,1,32,5,6,5,1456,1457,1451,1451
Del Norte,42,2022-10-05,13,13,13,0,372,381,380,1,1,0,0,1,55,55,55,55
El Dorado,42,2022-10-05,53,53,53,0,1335,1363,1362,1,5,0,0,0,230,230,230,230
Fresno,42,2022-10-05,456,465,465,0,10817,11033,11032,1,70,1,1,6,2879,2879,2878,2878
Glenn,42,2022-10-05,6,6,6,0,145,148,147,1,1,0,0,0,42,42,42,42
Humboldt,42,2022-10-05,83,83,83,0,1151,1175,1174,1,5,1,1,1,160,160,159,159
Imperial,42,2022-10-05,146,148,148,0,2508,2560,2559,1,9,0,0,0,960,960,960,960
Inyo,42,2022-10-05,5,5,5,0,111,113,112,1,0,0,0,0,60,60,60,60
Kern,42,2022-10-05,267,272,272,0,10135,10339,10338,1,20,0,0,8,2422,2422,2422,2422
Kings,42,2022-10-05,92,92,92,0,2448,2498,2497,1,1,0,0,0,459,459,459,459
Lake,42,2022-10-05,33,33,33,0,708,724,723,1,1,0,0,0,147,147,147,147
Lassen,42,2022-10-05,8,8,8,0,483,495,494,1,1,0,0,0,63,63,63,63
Los Angeles,42,2022-10-05,6487,6615,6615,0,201279,205307,205304,3,450,48,59,66,33627,33699,33579,33640
Madera,42,2022-10-05,54,54,54,0,1406,1435,1434,1,6,0,0,2,371,371,371,371
Marin,42,2022-10-05,186,189,189,0,3242,3308,3307,1,6,0,0,1,314,314,314,314
Mariposa,42,2022-10-05,3,3,3,0,135,138,137,1,0,0,0,0,30,30,30,30
Mendocino,42,2022-10-05,36,36,36,0,800,817,816,1,1,0,0,0,137,137,137,137
Merced,42,2022-10-05,104,105,105,0,2520,2572,2571,1,10,2,2,2,869,869,867,867
Modoc,42,2022-10-05,2,2,2,0,17,18,17,1,0,0,0,0,9,9,9,9
Mono,42,2022-10-05,1,1,1,0,65,66,65,1,0,0,0,0,7,7,7,7
Monterey,42,2022-10-05,98,98,98,0,3721,3797,3796,1,7,1,1,2,769,769,768,768
Napa,42,2022-10-05,72,72,72,0,1615,1649,1648,1,2,0,0,2,158,158,158,158
Nevada,42,2022-10-05,38,38,38,0,897,916,915,1,1,0,0,0,132,132,132,132
Orange,42,2022-10-05,1424,1453,1453,0,26018,26540,26539,1,119,17,20,14,7500,7510,7483,7490
Placer,42,2022-10-05,146,148,148,0,3012,3073,3072,1,34,1,1,4,662,662,661,661
Plumas,42,2022-10-05,16,16,16,0,99,101,100,1,2,0,0,0,13,13,13,13
Riverside,42,2022-10-05,1063,1084,1084,0,20761,21177,21176,1,55,6,6,13,6623,6623,6617,6617
Sacramento,42,2022-10-05,796,811,811,0,17018,17360,17359,1,90,7,8,16,3335,3336,3328,3328
San Benito,42,2022-10-05,44,44,44,0,429,438,437,1,0,0,0,0,101,101,101,101
San Bernardino,42,2022-10-05,1078,1100,1100,0,22202,22649,22648,1,94,1,1,14,8076,8076,8075,8075
San Diego,42,2022-10-05,1912,1951,1951,0,45380,46291,46290,1,149,4,4,22,5517,5517,5513,5513
San Francisco,42,2022-10-05,577,588,588,0,14056,14337,14335,2,53,3,3,7,1064,1064,1061,1061
San Joaquin,42,2022-10-05,328,336,336,0,9146,9329,9328,1,28,3,3,5,2334,2334,2331,2331
San Luis Obispo,42,2022-10-05,116,117,117,0,2346,2394,2393,1,5,0,0,0,524,524,524,524
San Mateo,42,2022-10-05,546,557,557,0,11569,11804,11803,1,20,0,0,1,730,730,730,730
Santa Barbara,42,2022-10-05,237,243,243,0,6455,6585,6584,1,15,0,0,3,729,729,729,729
Santa Clara,42,2022-10-05,1331,1357,1357,0,28827,29403,29402,1,92,2,2,18,2511,2513,2509,2511
Santa Cruz,42,2022-10-05,234,239,239,0,10815,11030,11029,1,14,0,0,2,273,273,273,273
Shasta,42,2022-10-05,52,52,52,0,1228,1253,1252,1,15,0,0,2,587,587,587,587
Siskiyou,42,2022-10-05,10,10,10,0,198,204,203,1,1,1,1,1,93,93,92,92
Solano,42,2022-10-05,264,270,270,0,5228,5333,5332,1,19,0,0,1,456,456,456,456
Sonoma,42,2022-10-05,281,288,288,0,5851,5970,5969,1,16,0,0,5,523,523,523,523
Stanislaus,42,2022-10-05,201,206,206,0,5299,5406,5405,1,53,0,0,8,1781,1781,1781,1781
Sutter,42,2022-10-05,46,46,46,0,990,1010,1009,1,0,0,0,0,232,232,232,232
Tehama,42,2022-10-05,20,20,20,0,479,489,488,1,2,0,0,0,215,215,215,215
Trinity,42,2022-10-05,1,1,1,0,46,47,46,1,0,0,0,0,20,20,20,20
Tulare,42,2022-10-05,135,136,136,0,4800,4897,4896,1,13,0,0,1,1539,1539,1539,1539
Tuolumne,42,2022-10-05,21,21,21,0,581,594,593,1,0,0,0,0,193,193,193,193
Ventura,42,2022-10-05,437,445,445,0,10113,10316,10315,1,36,2,2,2,1576,1576,1574,1574
Yolo,42,2022-10-05,101,101,101,0,2894,2954,2953,1,5,2,2,0,349,349,347,347
Yuba,42,2022-10-05,34,34,34,0,748,763,762,1,3,0,0,2,120,120,120,120
Alameda,43,2022-10-12,1106,1135,1135,0,27489,28193,28192,1,53,2,2,11,2035,2035,2033,2033
Amador,43,2022-10-12,16,16,16,0,774,794,793,1,0,0,0,1,94,94,94,94
Butte,43,2022-10-12,64,64,64,0,1508,1547,1546,1,10,0,0,0,460,460,460,460
Calaveras,43,2022-10-12,17,17,17,0,369,381,380,1,0,0,0,1,135,135,135,135
Colusa,43,2022-10-12,4,4,4,0,106,109,108,1,0,0,0,0,22,22,22,22
Contra Costa,43,2022-10-12,773,793,793,0,16573,16999,16998,1,26,5,8,7,1459,1462,1454,1454
Del Norte,43,2022-10-12,14,14,14,0,492,506,505,1,1,0,0,1,55,55,55,55
El Dorado,43,2022-10-12,82,82,82,0,1753,1799,1798,1,7,0,0,2,230,230,230,230
Fresno,43,2022-10-12,468,481,481,0,11272,11562,11561,1,64,3,4,9,2882,2883,2879,2879
Glenn,43,2022-10-12,11,11,11,0,216,221,220,1,2,0,0,0,42,42,42,42
Humboldt,43,2022-10-12,90,91,91,0,1379,1414,1413,1,4,0,0,0,160,160,160,160
Imperial,43,2022-10-12,172,177,177,0,2871,2946,2945,1,7,0,0,0,960,960,960,960
Inyo,43,2022-10-12,3,3,3,0,137,140,139,1,0,0,0,0,60,60,60,60
Kern,43,2022-10-12,265,273,273,0,11327,11619,11618,1,31,0,0,5,2422,2422,2422,2422
Kings,43,2022-10-12,92,92,92,0,2712,2784,2783,1,1,0,0,0,459,459,459,459
Lake,43,2022-10-12,32,32,32,0,978,1003,1002,1,0,0,0,0,147,147,147,147
Lassen,43,2022-10-12,1,1,1,0,553,567,566,1,0,0,0,0,63,63,63,63
Los Angeles,43,2022-10-12,6419,6583,6583,0,226263,232111,232108,3,405,55,79,50,33675,33768,33620,33689
Madera,43,2022-10-12,63,63,63,0,1650,1693,1692,1,7,0,0,1,371,371,371,371
Marin,43,2022-10-12,181,185,185,0,3709,3805,3804,1,11,0,0,1,314,314,314,314
Mariposa,43,2022-10-12,10,10,10,0,114,116,115,1,0,0,0,0,30,30,30,30
Mendocino,43,2022-10-12,35,35,35,0,907,931,930,1,3,0,0,2,137,137,137,137
Merced,43,2022-10-12,117,118,118,0,2639,2709,2708,1,8,0,0,3,869,869,869,869
Modoc,43,2022-10-12,4,4,4,0,9,10,9,1,0,0,0,0,9,9,9,9
Mono,43,2022-10-12,3,3,3,0,50,51,50,1,0,0,0,0,7,7,7,7
Monterey,43,2022-10-12,106,106,106,0,4127,4234,4233,1,12,0,0,1,769,769,769,769
Napa,43,2022-10-12,72,72,72,0,1677,1720,1719,1,3,0,0,2,158,158,158,158
Nevada,43,2022-10-12,40,40,40,0,928,953,952,1,3,0,0,0,132,132,132,132
Orange,43,2022-10-12,1385,1421,1421,0,29045,29794,29793,1,104,12,18,21,7510,7525,7498,7507
Placer,43,2022-10-12,148,151,151,0,3475,3564,3563,1,28,0,0,4,662,662,662,662
Plumas,43,2022-10-12,14,14,14,0,95,96,95,1,0,0,0,0,13,13,13,13
Riverside,43,2022-10-12,1107,1135,1135,0,22939,23530,23529,1,60,0,0,5,6623,6623,6623,6623
Sacramento,43,2022-10-12,896,918,918,0,19414,19915,19914,1,83,5,7,12,3340,3343,3335,3336
San Benito,43,2022-10-12,25,25,25,0,433,446,445,1,3,1,2,0,102,103,101,101
San Bernardino,43,2022-10-12,1041,1068,1068,0,25680,26343,26342,1,74,0,0,13,8076,8076,8076,8076
San Diego,43,2022-10-12,1862,1909,1909,0,50330,51627,51626,1,124,10,15,20,5525,5529,5515,5514
San Francisco,43,2022-10-12,615,629,629,0,15401,15794,15793,1,39,2,3,12,1066,1067,1064,1064
San Joaquin,43,2022-10-12,416,427,427,0,11155,11441,11440,1,14,0,0,6,2334,2334,2334,2334
San Luis Obispo,43,2022-10-12,93,95,95,0,2442,2506,2505,1,1,1,1,1,525,525,524,524
San Mateo,43,2022-10-12,621,637,637,0,13060,13397,13396,1,17,0,0,2,730,730,730,730
Santa Barbara,43,2022-10-12,238,246,246,0,7327,7516,7515,1,15,1,1,3,730,730,729,729
Santa Clara,43,2022-10-12,1363,1398,1398,0,33505,34368,34367,1,105,0,0,19,2511,2513,2511,2513
Santa Cruz,43,2022-10-12,331,341,341,0,11675,11972,11971,1,14,0,0,1,273,273,273,273
Shasta,43,2022-10-12,101,103,103,0,1303,1337,1336,1,12,3,4,0,590,591,587,587
Siskiyou,43,2022-10-12,12,12,12,0,251,259,258,1,2,0,0,1,93,93,93,93
Solano,43,2022-10-12,305,313,313,0,5930,6084,6083,1,32,4,6,2,459,461,455,455
Sonoma,43,2022-10-12,284,292,292,0,6599,6771,6770,1,18,0,0,2,523,523,523,523
Stanislaus,43,2022-10-12,211,217,217,0,5900,6054,6053,1,46,0,0,9,1781,1781,1781,1781
Sutter,43,2022-10-12,57,57,57,0,1116,1145,1144,1,0,0,0,0,232,232,232,232
Tehama,43,2022-10-12,20,20,20,0,532,548,547,1,2,0,0,0,215,215,215,215
Trinity,43,2022-10-12,1,1,1,0,44,45,44,1,0,0,0,0,20,20,20,20
Tulare,43,2022-10-12,162,166,166,0,4928,5056,5055,1,9,2,3,1,1541,1542,1539,1539
Tuolumne,43,2022-10-12,45,45,45,0,665,684,683,1,0,0,0,0,193,193,193,193
Ventura,43,2022-10-12,402,411,411,0,11005,11290,11289,1,35,4,5,1,1579,1580,1575,1575
Yolo,43,2022-10-12,120,123,123,0,2793,2865,2864,1,4,2,3,0,351,352,349,349
Yuba,43,2022-10-12,32,32,32,0,949,975,974,1,2,0,0,0,120,120,120,120
Alameda,44,2022-10-19,858,888,888,0,23296,24130,24129,1,49,5,10,9,2040,2045,2035,2035
Amador,44,2022-10-19,14,14,14,0,578,600,599,1,1,0,0,0,94,94,94,94
Butte,44,2022-10-19,72,74,74,0,1380,1430,1429,1,15,0,0,0,460,460,460,460
Calaveras,44,2022-10-19,22,22,22,0,299,310,309,1,0,0,0,0,135,135,135,135
Colusa,44,2022-10-19,3,3,3,0,92,96,95,1,0,0,0,0,22,22,22,22
Contra Costa,44,2022-10-19,619,641,641,0,14355,14871,14870,1,27,1,3,5,1460,1465,1459,1462
Del Norte,44,2022-10-19,6,6,6,0,379,394,393,1,0,0,0,0,55,55,55,55
El Dorado,44,2022-10-19,67,68,68,0,1306,1355,1354,1,3,0,0,1,230,230,230,230
Fresno,44,2022-10-19,352,364,364,0,9937,10296,10295,1,52,0,0,7,2882,2883,2882,2883
Glenn,44,2022-10-19,6,6,6,0,141,146,145,1,0,0,0,0,42,42,42,42
Humboldt,44,2022-10-19,74,77,77,0,1138,1180,1179,1,4,0,0,1,160,160,160,160
Imperial,44,2022-10-19,124,128,128,0,2289,2375,2374,1,6,0,0,0,960,960,960,960
Inyo,44,2022-10-19,2,2,2,0,103,107,106,1,0,0,0,0,60,60,60,60
Kern,44,2022-10-19,238,248,248,0,9393,9733,9732,1,30,0,0,2,2422,2422,2422,2422
Kings,44,2022-10-19,76,79,79,0,2293,2379,2378,1,1,0,0,0,459,459,459,459
Lake,44,2022-10-19,26,26,26,0,747,774,773,1,1,0,0,0,147,147,147,147
Lassen,44,2022-10-19,11,11,11,0,523,542,541,1,0,0,0,0,63,63,63,63
Los Angeles,44,2022-10-19,4858,5033,5033,0,180780,187375,187373,2,337,25,48,62,33700,33816,33675,33768
Madera,44,2022-10-19,52,53,53,0,1423,1476,1475,1,4,0,0,2,371,371,371,371
Marin,44,2022-10-19,133,139,139,0,3190,3306,3305,1,11,0,0,0,314,314,314,314
Mariposa,44,2022-10-19,7,7,7,0,119,126,125,1,0,0,0,0,30,30,30,30
Mendocino,44,2022-10-19,42,42,42,0,761,791,790,1,1,0,0,0,137,137,137,137
Merced,44,2022-10-19,119,123,123,0,2256,2340,2339,1,8,0,0,3,869,869,869,869
Modoc,44,2022-10-19,0,0,0,0,9,10,9,1,0,0,0,0,9,9,9,9
Mono,44,2022-10-19,5,5,5,0,35,36,35,1,1,0,0,0,7,7,7,7
Monterey,44,2022-10-19,139,145,145,0,3566,3698,3697,1,11,1,2,1,770,771,769,769
Napa,44,2022-10-19,56,56,56,0,1504,1558,1557,1,3,0,0,1,158,158,158,158
Nevada,44,2022-10-19,40,40,40,0,800,831,830,1,5,0,0,0,132,132,132,132
Orange,44,2022-10-19,1069,1108,1108,0,24108,24985,24984,1,105,9,17,11,7519,7542,7510,7525
Placer,44,2022-10-19,111,115,115,0,2716,2814,2813,1,30,0,0,3,662,662,662,662
Plumas,44,2022-10-19,16,16,16,0,98,103,102,1,0,0,0,0,13,13,13,13
Riverside,44,2022-10-19,880,912,912,0,19292,19988,19987,1,79,2,4,6,6625,6627,6623,6623
Sacramento,44,2022-10-19,760,788,788,0,15031,15574,15573,1,96,4,7,18,3344,3350,3340,3343
San Benito,44,2022-10-19,33,33,33,0,394,410,409,1,1,0,0,0,102,103,102,103
San Bernardino,44,2022-10-19,760,787,787,0,20637,21386,21385,1,50,3,7,10,8079,8083,8076,8076
San Diego,44,2022-10-19,1653,1712,1712,0,42522,44062,44061,1,105,4,8,25,5529,5537,5525,5529
San Francisco,44,2022-10-19,497,516,516,0,13484,13968,13967,1,50,1,2,9,1067,1069,1066,1067
San Joaquin,44,2022-10-19,324,336,336,0,8561,8869,8868,1,19,1,2,4,2335,2336,2334,2334
San Luis Obispo,44,2022-10-19,95,98,98,0,2118,2197,2196,1,4,0,0,0,525,525,525,525
San Mateo,44,2022-10-19,502,521,521,0,10846,11239,11238,1,20,0,0,2,730,730,730,730
Santa Barbara,44,2022-10-19,145,150,150,0,5604,5810,5809,1,16,0,0,1,730,730,730,730
Santa Clara,44,2022-10-19,1126,1165,1165,0,27800,28806,28805,1,94,2,4,13,2513,2517,2511,2513
Santa Cruz,44,2022-10-19,274,284,284,0,10686,11071,11070,1,9,1,2,1,274,275,273,273
Shasta,44,2022-10-19,77,79,79,0,1042,1079,1078,1,16,0,0,1,590,591,590,591
Siskiyou,44,2022-10-19,11,11,11,0,180,188,187,1,2,1,2,1,94,95,93,93
Solano,44,2022-10-19,244,253,253,0,4946,5127,5126,1,23,0,0,3,459,461,459,461
Sonoma,44,2022-10-19,243,253,253,0,5416,5612,5611,1,26,1,2,0,524,525,523,523
Stanislaus,44,2022-10-19,195,202,202,0,5081,5265,5264,1,41,0,0,5,1781,1781,1781,1781
Sutter,44,2022-10-19,30,30,30,0,897,930,929,1,0,0,0,0,232,232,232,232
Tehama,44,2022-10-19,27,27,27,0,397,412,411,1,0,0,0,0,215,215,215,215
Trinity,44,2022-10-19,0,0,0,0,42,43,42,1,0,0,0,0,20,20,20,20
Tulare,44,2022-10-19,130,135,135,0,4333,4493,4492,1,14,0,0,1,1541,1542,1541,1542
Tuolumne,44,2022-10-19,33,33,33,0,598,621,620,1,2,0,0,0,193,193,193,193
Ventura,44,2022-10-19,345,358,358,0,9270,9606,9605,1,29,3,7,1,1582,1587,1579,1580
Yolo,44,2022-10-19,99,103,103,0,2102,2179,2178,1,4,2,5,1,353,357,351,352
Yuba,44,2022-10-19,36,36,36,0,710,737,736,1,2,0,0,0,120,120,120,120
Alameda,45,2022-10-26,900,961,961,0,22789,24342,24341,1,45,3,14,7,2043,2059,2040,2045
Amador,45,2022-10-26,12,12,12,0,625,670,669,1,0,0,0,1,94,94,94,94
Butte,45,2022-10-26,68,72,72,0,1452,1551,1550,1,9,1,4,1,461,464,460,460
Calaveras,45,2022-10-26,13,13,13,0,298,319,318,1,1,0,0,0,135,135,135,135
Colusa,45,2022-10-26,4,4,4,0,94,101,100,1,0,0,0,0,22,22,22,22
Contra Costa,45,2022-10-26,610,653,653,0,13358,14272,14271,1,40,0,0,6,1460,1465,1460,1465
Del Norte,45,2022-10-26,8,8,8,0,346,372,371,1,1,0,0,0,55,55,55,55
El Dorado,45,2022-10-26,73,79,79,0,1334,1428,1427,1,2,0,0,0,230,230,230,230
Fresno,45,2022-10-26,350,374,374,0,9462,10114,10113,1,68,0,0,4,2882,2883,2882,2883
Glenn,45,2022-10-26,9,9,9,0,145,156,155,1,0,0,0,0,42,42,42,42
Humboldt,45,2022-10-26,50,52,52,0,1080,1154,1153,1,6,0,0,3,160,160,160,160
Imperial,45,2022-10-26,85,92,92,0,2376,2545,2544,1,6,0,0,0,960,960,960,960
Inyo,45,2022-10-26,3,3,3,0,380,409,408,1,0,0,0,0,60,60,60,60
Kern,45,2022-10-26,242,259,259,0,9769,10453,10452,1,26,0,0,6,2422,2422,2422,2422
Kings,45,2022-10-26,95,102,102,0,2348,2517,2516,1,6,0,0,0,459,459,459,459
Lake,45,2022-10-26,19,19,19,0,629,674,673,1,0,0,0,2,147,147,147,147
Lassen,45,2022-10-26,19,20,20,0,540,582,581,1,0,0,0,0,63,63,63,63
Los Angeles,45,2022-10-26,4982,5326,5326,0,182869,195728,195726,2,353,24,97,37,33724,33913,33700,33816
Madera,45,2022-10-26,56,58,58,0,1398,1496,1495,1,4,0,0,2,371,371,371,371
Marin,45,2022-10-26,140,149,149,0,3164,3387,3386,1,11,0,0,1,314,314,314,314
Mariposa,45,2022-10-26,10,10,10,0,122,131,130,1,0,0,0,0,30,30,30,30
Mendocino,45,2022-10-26,31,32,32,0,741,792,791,1,3,0,0,0,137,137,137,137
Merced,45,2022-10-26,74,79,79,0,2088,2231,2230,1,8,1,3,2,870,872,869,869
Modoc,45,2022-10-26,2,2,2,0,13,14,13,1,0,0,0,0,9,9,9,9
Mono,45,2022-10-26,1,1,1,0,82,88,87,1,0,0,0,0,7,7,7,7
Monterey,45,2022-10-26,94,101,101,0,3653,3910,3909,1,15,0,0,0,770,771,770,771
Napa,45,2022-10-26,45,46,46,0,1453,1554,1553,1,3,0,0,0,158,158,158,158
Nevada,45,2022-10-26,34,36,36,0,769,825,824,1,5,0,0,0,132,132,132,132
Orange,45,2022-10-26,1080,1154,1154,0,25258,27015,27014,1,104,1,5,14,7520,7547,7519,7542
Placer,45,2022-10-26,134,143,143,0,2764,2953,2952,1,47,0,0,4,662,662,662,662
Plumas,45,2022-10-26,8,8,8,0,77,82,81,1,0,0,0,0,13,13,13,13
Riverside,45,2022-10-26,811,867,867,0,18809,20106,20105,1,62,0,0,8,6625,6627,6625,6627
Sacramento,45,2022-10-26,709,757,757,0,14146,15121,15120,1,82,2,10,13,3346,3360,3344,3350
San Benito,45,2022-10-26,34,37,37,0,415,444,443,1,1,0,0,1,102,103,102,103
San Bernardino,45,2022-10-26,803,859,859,0,19528,20901,20900,1,57,1,4,14,8080,8087,8079,8083
San Diego,45,2022-10-26,1527,1633,1633,0,40052,42825,42824,1,154,3,9,21,5532,5546,5529,5537
San Francisco,45,2022-10-26,454,486,486,0,13270,14181,14180,1,46,0,0,7,1067,1069,1067,1069
San Joaquin,45,2022-10-26,286,306,306,0,8319,8894,8893,1,15,0,0,2,2335,2336,2335,2336
San Luis Obispo,45,2022-10-26,77,83,83,0,1991,2133,2132,1,2,0,0,0,525,525,525,525
San Mateo,45,2022-10-26,417,445,445,0,10838,11597,11596,1,20,0,0,2,730,730,730,730
Santa Barbara,45,2022-10-26,158,170,170,0,5811,6221,6220,1,22,2,8,4,732,738,730,730
Santa Clara,45,2022-10-26,1119,1195,1195,0,28867,30894,30893,1,88,0,0,9,2513,2517,2513,2517
Santa Cruz,45,2022-10-26,215,229,229,0,10182,10861,10860,1,13,0,0,0,274,275,274,275
Shasta,45,2022-10-26,60,63,63,0,899,962,961,1,9,0,0,2,590,591,590,591
Siskiyou,45,2022-10-26,12,12,12,0,178,192,191,1,3,0,0,0,94,95,94,95
Solano,45,2022-10-26,254,271,271,0,5167,5529,5528,1,19,0,0,4,459,461,459,461
Sonoma,45,2022-10-26,221,236,236,0,5496,5878,5877,1,30,0,0,3,524,525,524,525
Stanislaus,45,2022-10-26,190,202,202,0,4888,5230,5229,1,36,0,0,6,1781,1781,1781,1781
Sutter,45,2022-10-26,34,35,35,0,893,958,957,1,0,0,0,0,232,232,232,232
Tehama,45,2022-10-26,26,26,26,0,341,366,365,1,1,0,0,0,215,215,215,215
Trinity,45,2022-10-26,2,2,2,0,34,36,35,1,0,0,0,0,20,20,20,20
Tulare,45,2022-10-26,114,123,123,0,4074,4362,4361,1,10,0,0,0,1541,1542,1541,1542
Tuolumne,45,2022-10-26,20,20,20,0,590,632,631,1,0,0,0,0,193,193,193,193
Ventura,45,2022-10-26,263,282,282,0,9029,9659,9658,1,39,0,0,4,1582,1587,1582,1587
Yolo,45,2022-10-26,75,81,81,0,1944,2078,2077,1,3,0,0,1,353,357,353,357
Yuba,45,2022-10-26,49,52,52,0,847,905,904,1,7,0,0,1,120,120,120,120
Alameda,46,2022-10-31,502,673,673,0,12174,15410,15409,1,57,0,0,4,2043,2059,2043,2059
Amador,46,2022-10-31,10,15,15,0,222,290,289,1,2,1,9,0,95,103,94,94
Butte,46,2022-10-31,23,30,30,0,805,1018,1017,1,11,0,0,3,461,464,461,464
Calaveras,46,2022-10-31,7,9,9,0,147,208,207,1,0,0,0,0,135,135,135,135
Colusa,46,2022-10-31,7,7,7,0,44,56,55,1,0,0,0,0,22,22,22,22
Contra Costa,46,2022-10-31,355,480,480,0,7291,9298,9297,1,37,0,0,7,1460,1465,1460,1465
Del Norte,46,2022-10-31,9,11,11,0,155,204,203,1,1,0,0,0,55,55,55,55
El Dorado,46,2022-10-31,50,63,63,0,709,913,912,1,2,0,0,0,230,230,230,230
Fresno,46,2022-10-31,182,240,240,0,5196,6633,6632,1,57,0,0,8,2882,2883,2882,2883
Glenn,46,2022-10-31,5,6,6,0,56,74,73,1,1,0,0,0,42,42,42,42
Humboldt,46,2022-10-31,22,28,28,0,516,656,655,1,6,0,0,2,160,160,160,160
Imperial,46,2022-10-31,61,79,79,0,1447,1960,1959,1,7,0,0,0,960,960,960,960
Inyo,46,2022-10-31,6,7,7,0,97,131,130,1,0,0,0,0,60,60,60,60
Kern,46,2022-10-31,138,172,172,0,3937,4831,4830,1,20,0,0,2,2422,2422,2422,2422
Kings,46,2022-10-31,75,91,91,0,1046,1311,1310,1,3,0,0,1,459,459,459,459
Lake,46,2022-10-31,17,24,24,0,421,559,558,1,1,0,0,1,147,147,147,147
Lassen,46,2022-10-31,5,6,6,0,168,206,205,1,1,0,0,0,63,63,63,63
Los Angeles,46,2022-10-31,2089,2523,2523,0,52905,61602,61601,1,344,5,48,44,33729,33961,33724,33913
Madera,46,2022-10-31,26,34,34,0,686,891,890,1,3,0,0,2,371,371,371,371
Marin,46,2022-10-31,61,83,83,0,1666,2096,2095,1,10,0,0,1,314,314,314,314
Mariposa,46,2022-10-31,5,6,6,0,69,83,82,1,0,0,0,0,30,30,30,30
Mendocino,46,2022-10-31,9,10,10,0,389,523,522,1,1,0,0,2,137,137,137,137
Merced,46,2022-10-31,47,62,62,0,880,1111,1110,1,5,0,0,0,870,872,870,872
Modoc,46,2022-10-31,0,0,0,0,6,8,7,1,0,0,0,0,9,9,9,9
Mono,46,2022-10-31,1,1,1,0,49,68,67,1,1,0,0,0,7,7,7,7
Monterey,46,2022-10-31,54,66,66,0,1626,2108,2107,1,18,0,0,0,770,771,770,771
Napa,46,2022-10-31,25,34,34,0,797,1043,1042,1,2,0,0,0,158,158,158,158
Nevada,46,2022-10-31,10,12,12,0,293,358,357,1,6,0,0,0,132,132,132,132
Orange,46,2022-10-31,527,662,662,0,11805,14964,14963,1,91,0,0,14,7520,7547,7520,7547
Placer,46,2022-10-31,59,75,75,0,1493,1927,1926,1,40,0,0,5,662,662,662,662
Plumas,46,2022-10-31,3,4,4,0,40,57,56,1,0,0,0,0,13,13,13,13
Riverside,46,2022-10-31,425,564,564,0,8307,10427,10426,1,64,2,22,5,6627,6649,6625,6627
Sacramento,46,2022-10-31,379,498,498,0,6831,8721,8720,1,80,0,0,16,3346,3360,3346,3360
San Benito,46,2022-10-31,16,22,22,0,212,272,271,1,1,0,0,1,102,103,102,103
San Bernardino,46,2022-10-31,384,473,473,0,8370,10432,10431,1,64,0,0,11,8080,8087,8080,8087
San Diego,46,2022-10-31,811,1015,1015,0,19592,24671,24670,1,109,0,0,13,5532,5546,5532,5546
San Francisco,46,2022-10-31,269,359,359,0,7471,9433,9432,1,45,0,0,3,1067,1069,1067,1069
San Joaquin,46,2022-10-31,142,189,189,0,3831,4891,4890,1,21,0,0,3,2335,2336,2335,2336
San Luis Obispo,46,2022-10-31,25,31,31,0,784,983,982,1,1,0,0,0,525,525,525,525
San Mateo,46,2022-10-31,276,361,361,0,5412,6979,6978,1,30,0,0,2,730,730,730,730
Santa Barbara,46,2022-10-31,81,100,100,0,2677,3399,3398,1,20,0,0,6,732,738,732,738
Santa Clara,46,2022-10-31,565,747,747,0,13367,16833,16832,1,85,0,0,16,2513,2517,2513,2517
Santa Cruz,46,2022-10-31,55,68,68,0,4020,4682,4681,1,7,0,0,0,274,275,274,275
Shasta,46,2022-10-31,15,18,18,0,319,392,391,1,6,0,0,1,590,591,590,591
Siskiyou,46,2022-10-31,11,14,14,0,122,159,158,1,1,0,0,0,94,95,94,95
Solano,46,2022-10-31,178,240,240,0,2602,3464,3463,1,16,0,0,4,459,461,459,461
Sonoma,46,2022-10-31,100,136,136,0,2982,3839,3838,1,24,0,0,3,524,525,524,525
Stanislaus,46,2022-10-31,119,152,152,0,2442,3187,3186,1,49,0,0,8,1781,1781,1781,1781
Sutter,46,2022-10-31,36,48,48,0,450,590,589,1,0,0,0,0,232,232,232,232
Tehama,46,2022-10-31,4,4,4,0,153,183,182,1,1,0,0,0,215,215,215,215
Trinity,46,2022-10-31,14,18,18,0,51,64,63,1,5,0,0,0,20,20,20,20
Tulare,46,2022-10-31,47,60,60,0,1326,1653,1652,1,12,0,0,0,1541,1542,1541,1542
Tuolumne,46,2022-10-31,12,15,15,0,254,330,329,1,3,0,0,0,193,193,193,193
Ventura,46,2022-10-31,155,192,192,0,4375,5590,5589,1,24,0,0,2,1582,1587,1582,1587
Yolo,46,2022-10-31,27,38,38,0,804,1026,1025,1,3,0,0,1,353,357,353,357
Yuba,46,2022-10-31,20,25,25,0,383,505,504,1,3,0,0,0,120,120,120,120
California,1,2021-12-22,124753,124839,73554,51285,2094134,2095900,1221016,874884,2673,487,487,949,77420,77420,76933,76933
California,2,2021-12-29,360308,360639,232745,127894,2230408,2232548,1408449,824099,4030,502,502,1149,77922,77922,77420,77420
California,3,2022-01-05,682019,682722,471269,211453,3584550,3588326,2472467,1115859,7241,695,695,1430,78617,78617,77922,77922
California,4,2022-01-12,812939,813821,590717,223104,4611097,4616208,3391362,1224846,10969,1067,1067,1958,79684,79684,78617,78617
California,5,2022-01-19,618300,619001,470377,148624,3954780,3959445,3068903,890542,12926,1542,1542,2467,81226,81226,79684,79684
California,6,2022-01-26,417505,417998,331054,86944,3604807,3609215,2934268,674947,12438,1789,1789,2577,83015,83015,81226,81226
California,7,2022-02-02,217766,218021,179520,38501,2949755,2953477,2503698,449779,10277,1936,1936,2366,84951,84951,83015,83015
California,8,2022-02-09,123258,123385,105218,18167,2565360,2568708,2256983,311725,7805,1688,1688,1902,86639,86639,84951,84951
California,9,2022-02-16,71801,71868,63242,8626,2246050,2249039,2031984,217055,5833,1244,1244,1438,87883,87883,86639,86639
California,10,2022-02-23,40737,40763,36828,3935,1879714,1882305,1738076,144229,4184,931,931,1035,88814,88814,87883,87883
California,11,2022-03-02,28629,28645,26449,2196,1933418,1936231,1819985,116246,3144,602,602,680,89416,89416,88814,88814
California,12,2022-03-09,20671,20683,19434,1249,1782881,1785580,1700769,84811,2281,459,459,516,89875,89875,89416,89416
California,13,2022-03-16,15504,15512,14775,737,1699055,1701694,1638343,63351,1763,305,305,384,90180,90180,89875,89875
California,14,2022-03-23,14794,14801,14263,538,1575858,1578400,1532234,46166,1414,233,233,285,90413,90413,90180,90180
California,15,2022-03-30,15529,15536,15098,438,1495470,1497935,1463284,34651,1106,167,167,246,90580,90580,90413,90413
California,16,2022-04-06,19100,19114,18698,416,1435712,1438153,1412667,25486,933,144,144,193,90724,90724,90580,90580
California,17,2022-04-13,22840,22861,22473,388,1211444,1213552,1195309,18243,879,103,103,152,90827,90827,90724,90724
California,18,2022-04-20,30226,30260,29858,402,1329685,1332076,1317157,14919,837,107,107,133,90934,90934,90827,90827
California,19,2022-04-27,40653,40712,40289,423,1675332,1678475,1664508,13967,874,87,87,138,91021,91021,90934,90934
California,20,2022-05-04,53679,53771,53332,439,1715760,1719153,1707842,11311,916,83,83,168,91104,91104,91021,91021
California,21,2022-05-11,67458,67577,67134,443,1791608,1795330,1786004,9326,1121,90,90,152,91194,91194,91104,91104
California,22,2022-05-18,88314,88485,88032,453,1848444,1852471,1844867,7604,1439,117,117,203,91311,91311,91194,91194
California,23,2022-05-25,100967,101179,100785,394,1865408,1869679,1863685,5994,1729,130,130,238,91441,91441,91311,91311
California,24,2022-06-01,99744,99961,99655,306,1617928,1621830,1617784,4046,2057,130,130,272,91571,91571,91441,91441
California,25,2022-06-08,112459,112713,112443,270,1708423,1712774,1709434,3340,2364,145,145,295,91716,91716,91571,91571
California,26,2022-06-15,101796,102046,101854,192,1198921,1202185,1200116,2069,2498,178,178,310,91894,91894,91716,91716
California,27,2022-06-22,105103,105384,105230,154,1022725,1025739,1024286,1453,2669,225,225,324,92119,92119,91894,91894
California,28,2022-06-29,118884,119235,119104,131,1013439,1016648,1015533,1115,3156,207,207,363,92326,92326,92119,92119
California,29,2022-07-06,117240,117625,117525,100,892106,895250,894483,767,3436,278,278,429,92604,92604,92326,92326
California,30,2022-07-13,134311,134822,134735,87,1010754,1014782,1014107,675,3910,283,283,487,92887,92887,92604,92604
California,31,2022-07-20,126325,126857,126791,66,981736,986068,985559,509,4212,320,320,550,93207,93207,92887,92887
California,32,2022-07-27,112016,112543,112501,42,917880,922382,922001,381,4178,342,342,571,93549,93549,93207,93207
California,33,2022-08-03,92856,93318,93291,27,846880,851378,851097,281,4029,326,329,522,93875,93878,93549,93549
California,34,2022-08-10,77224,77671,77656,15,797198,802116,801904,212,3546,306,310,484,94181,94188,93875,93878
California,35,2022-08-17,65437,65882,65872,10,775621,781226,781061,165,3269,276,281,450,94457,94469,94181,94188
California,36,2022-08-24,57742,58201,58197,4,769828,776312,776176,136,2763,248,255,383,94705,94724,94457,94469
California,37,2022-08-31,47604,48049,48047,2,754761,762237,762126,111,2670,228,234,377,94933,94958,94705,94724
California,38,2022-09-07,35398,35776,35776,0,647716,655034,654950,84,2578,218,226,380,95151,95184,94933,94958
California,39,2022-09-14,31453,31816,31816,0,688959,697735,697657,78,2264,196,204,316,95347,95388,95151,95184
California,40,2022-09-21,26013,26353,26353,0,663989,673629,673560,69,1832,168,179,283,95515,95567,95347,95388
California,41,2022-09-28,24547,24930,24930,0,611351,621620,621559,61,1763,150,168,238,95665,95735,95515,95567
California,42,2022-10-05,21517,21922,21922,0,544690,555631,555572,59,1623,111,127,247,95776,95862,95665,95735
California,43,2022-10-12,22167,22711,22711,0,610573,626339,626281,58,1501,112,161,232,95873,96002,95761,95841
California,44,2022-10-19,17736,18361,18361,0,501603,519839,519782,57,1407,66,132,210,95939,96134,95873,96002
California,45,2022-10-26,17181,18349,18349,0,498084,532830,532773,57,1482,38,154,192,95977,96288,95939,96134
California,46,2022-10-31,8556,10900,10900,0,204272,253302,253246,56,1401,8,79,191,95985,96367,95977,96288
