county,time,date,cases,est_cases,est_omicron_cases,est_other_cases,tests,est_tests,est_omicron_tests,est_other_tests,hospitalizations,deaths,est_deaths,icu,cum_deaths,cum_est_deaths,prev_cum_deaths,prev_cum_est_deaths
Alameda,1,2021-12-20,2982,2982,1419,1563,89768,89768,41917,47851,47,9,9,14,1548,1548,1539,1539
Amador,1,2021-12-20,49,49,18,31,1716,1716,602,1114,2,0,0,3,70,70,70,70
Butte,1,2021-12-20,193,193,101,92,4385,4385,2285,2100,24,5,5,1,359,359,354,354
Calaveras,1,2021-12-20,59,59,23,36,1520,1520,582,938,1,2,2,0,92,92,90,90
Colusa,1,2021-12-20,11,11,5,6,397,397,170,227,1,0,0,0,21,21,21,21
Contra Costa,1,2021-12-20,1687,1687,591,1096,43225,43225,14847,28378,27,4,4,7,1080,1080,1076,1076
Del Norte,1,2021-12-20,19,19,8,11,1378,1378,570,808,0,0,0,0,42,42,42,42
El Dorado,1,2021-12-20,238,238,93,145,4466,4466,1729,2737,4,4,4,3,179,179,175,175
Fresno,1,2021-12-20,1057,1057,380,677,24956,24956,8882,16074,131,19,19,45,2419,2419,2400,2400
Glenn,1,2021-12-20,20,20,8,12,462,462,185,277,0,0,0,0,41,41,41,41
Humboldt,1,2021-12-20,164,164,67,97,3772,3772,1529,2243,11,1,1,2,121,121,120,120
Imperial,1,2021-12-20,584,584,225,359,5526,5526,2105,3421,40,9,9,27,817,817,808,808
Inyo,1,2021-12-20,31,31,14,17,358,358,154,204,1,1,1,0,49,49,48,48
Kern,1,2021-12-20,927,927,401,526,26093,26093,11160,14933,84,24,24,27,2023,2023,1999,1999
Kings,1,2021-12-20,244,244,94,150,6912,6912,2638,4274,15,6,6,3,389,389,383,383
Lake,1,2021-12-20,37,37,13,24,1317,1317,464,853,0,0,0,0,116,116,116,116
Lassen,1,2021-12-20,11,11,5,6,2387,2387,1093,1294,0,0,0,0,54,54,54,54
Los Angeles,1,2021-12-20,31635,31635,22013,9622,985581,985599,676243,309356,574,107,107,174,27372,27372,27265,27265
Madera,1,2021-12-20,159,159,56,103,6014,6014,2122,3892,9,3,3,5,334,334,331,331
Marin,1,2021-12-20,566,566,210,356,11811,11811,4295,7516,5,1,1,1,256,256,255,255
Mariposa,1,2021-12-20,21,21,7,14,448,448,154,294,0,0,0,0,21,21,21,21
Mendocino,1,2021-12-20,91,91,27,64,2687,2687,789,1898,3,2,2,4,103,103,101,101
Merced,1,2021-12-20,323,323,138,185,5616,5616,2366,3250,11,6,6,12,693,693,687,687
Modoc,1,2021-12-20,5,5,2,3,67,67,30,37,2,0,0,0,6,6,6,6
Mono,1,2021-12-20,37,37,10,27,313,313,81,232,1,0,0,0,4,4,4,4
Monterey,1,2021-12-20,481,481,126,355,13259,13259,3421,9838,23,3,3,8,642,642,639,639
Napa,1,2021-12-20,229,229,106,123,5390,5390,2432,2958,2,1,1,2,108,108,107,107
Nevada,1,2021-12-20,161,161,58,103,2764,2764,999,1765,4,1,1,2,110,110,109,109
Orange,1,2021-12-20,4866,4866,2405,2461,99380,99380,48406,50974,132,34,34,56,6022,6022,5988,5988
Placer,1,2021-12-20,555,555,190,365,11155,11155,3769,7386,53,6,6,24,501,501,495,495
Plumas,1,2021-12-20,16,16,6,10,513,513,195,318,0,0,0,0,12,12,12,12
Riverside,1,2021-12-20,5609,5609,2352,3257,78332,78332,32448,45884,238,40,40,82,5579,5579,5539,5539
Sacramento,1,2021-12-20,2147,2147,857,1290,53572,53572,21166,32406,101,21,21,41,2490,2490,2469,2469
San Benito,1,2021-12-20,91,91,41,50,1928,1928,860,1068,2,3,3,2,81,81,78,78
San Bernardino,1,2021-12-20,5012,5012,2369,2643,79702,79702,37183,42519,299,66,66,112,6511,6511,6445,6445
San Diego,1,2021-12-20,8682,8682,5934,2748,149629,149630,101537,48093,249,29,29,94,4479,4479,4450,4450
San Francisco,1,2021-12-20,2989,2989,741,2248,57004,57004,13806,43198,28,3,3,10,693,693,690,690
San Joaquin,1,2021-12-20,952,952,359,593,25321,25321,9391,15930,48,13,13,27,1972,1972,1959,1959
San Luis Obispo,1,2021-12-20,426,426,187,239,9993,9993,4349,5644,11,3,3,6,371,371,368,368
San Mateo,1,2021-12-20,1560,1560,771,789,50632,50632,24530,26102,9,0,0,5,601,601,601,601
Santa Barbara,1,2021-12-20,789,789,326,463,15818,15818,6434,9384,18,8,8,12,570,570,562,562
Santa Clara,1,2021-12-20,2949,2949,1982,967,118952,118952,78834,40118,85,8,8,38,1978,1978,1970,1970
Santa Cruz,1,2021-12-20,404,404,182,222,19816,19816,8760,11056,11,2,2,5,230,230,228,228
Shasta,1,2021-12-20,163,163,65,98,6035,6035,2392,3643,28,8,8,8,448,448,440,440
Siskiyou,1,2021-12-20,20,20,9,11,449,449,207,242,2,2,2,2,63,63,61,61
Solano,1,2021-12-20,496,496,207,289,14746,14746,6067,8679,21,4,4,5,389,389,385,385
Sonoma,1,2021-12-20,754,754,320,434,20779,20779,8668,12111,22,1,1,6,420,420,419,419
Stanislaus,1,2021-12-20,670,670,210,460,13019,13019,4035,8984,90,13,13,22,1432,1432,1419,1419
Sutter,1,2021-12-20,123,123,51,72,2315,2315,947,1368,0,2,2,0,193,193,191,191
Tehama,1,2021-12-20,52,52,17,35,1324,1324,425,899,4,0,0,3,165,165,165,165
Trinity,1,2021-12-20,1,1,0,1,98,98,31,67,0,1,1,0,19,19,18,18
Tulare,1,2021-12-20,404,404,125,279,12352,12352,3799,8553,36,19,19,13,1308,1308,1289,1289
Tuolumne,1,2021-12-20,97,97,35,62,1940,1940,693,1247,7,0,0,0,150,150,150,150
Ventura,1,2021-12-20,2046,2046,1052,994,39239,39239,19902,19337,62,9,9,14,1216,1216,1207,1207
Yolo,1,2021-12-20,329,329,146,183,24698,24698,10820,13878,4,0,0,1,294,294,294,294
Yuba,1,2021-12-20,100,100,43,57,1874,1874,799,1075,3,0,0,4,102,102,102,102
Alameda,2,2021-12-27,7510,7510,4024,3486,87415,87415,46205,41210,89,12,12,19,1560,1560,1548,1548
Amador,2,2021-12-27,92,92,38,54,1445,1445,590,855,2,0,0,3,70,70,70,70
Butte,2,2021-12-27,540,540,318,222,4551,4551,2662,1889,37,3,3,3,362,362,359,359
Calaveras,2,2021-12-27,100,100,45,55,989,989,442,547,1,1,1,1,93,93,92,92
Colusa,2,2021-12-27,27,27,14,13,243,243,119,124,4,0,0,0,21,21,21,21
Contra Costa,2,2021-12-27,5146,5146,2108,3038,46333,46333,18594,27739,44,3,3,16,1083,1083,1080,1080
Del Norte,2,2021-12-27,25,25,12,13,1423,1423,679,744,0,0,0,1,42,42,42,42
El Dorado,2,2021-12-27,511,511,231,280,4083,4083,1815,2268,7,0,0,4,179,179,179,179
Fresno,2,2021-12-27,2210,2210,935,1275,23816,23816,9913,13903,122,16,16,41,2435,2435,2419,2419
Glenn,2,2021-12-27,53,53,24,29,451,451,207,244,0,1,1,0,42,42,41,41
Humboldt,2,2021-12-27,501,501,238,263,3456,3456,1617,1839,10,1,1,0,122,122,121,121
Imperial,2,2021-12-27,882,882,396,486,5897,5897,2611,3286,35,10,10,26,827,827,817,817
Inyo,2,2021-12-27,109,109,54,55,447,447,219,228,0,1,1,0,50,50,49,49
Kern,2,2021-12-27,1988,1988,996,992,22592,22592,11165,11427,79,18,18,36,2041,2041,2023,2023
Kings,2,2021-12-27,507,507,230,277,5481,5481,2433,3048,17,1,1,3,390,390,389,389
Lake,2,2021-12-27,67,67,28,39,1203,1203,495,708,0,1,1,0,117,117,116,116
Lassen,2,2021-12-27,21,21,11,10,2242,2242,1160,1082,0,0,0,0,54,54,54,54
Los Angeles,2,2021-12-27,96145,96146,71607,24539,717718,717731,530960,186771,862,115,115,207,27487,27487,27372,27372
Madera,2,2021-12-27,342,342,145,197,4209,4209,1747,2462,9,2,2,4,336,336,334,334
Marin,2,2021-12-27,1606,1606,687,919,16773,16773,7083,9690,3,0,0,1,256,256,256,256
Mariposa,2,2021-12-27,36,36,15,21,493,493,195,298,0,0,0,0,21,21,21,21
Mendocino,2,2021-12-27,152,152,55,97,2496,2496,862,1634,5,0,0,2,103,103,103,103
Merced,2,2021-12-27,653,653,322,331,5100,5100,2471,2629,11,7,7,10,700,700,693,693
Modoc,2,2021-12-27,3,3,1,2,38,38,19,19,1,0,0,0,6,6,6,6
Mono,2,2021-12-27,123,123,38,85,366,366,110,256,1,0,0,0,4,4,4,4
Monterey,2,2021-12-27,1009,1009,318,691,12882,12882,3971,8911,21,3,3,11,645,645,642,642
Napa,2,2021-12-27,809,809,422,387,6660,6660,3443,3217,6,0,0,1,108,108,108,108
Nevada,2,2021-12-27,236,236,100,136,1984,1984,815,1169,6,1,1,1,111,111,110,110
Orange,2,2021-12-27,18033,18033,10059,7974,130306,130307,71860,58447,256,31,31,66,6053,6053,6022,6022
Placer,2,2021-12-27,1251,1251,502,749,10769,10769,4261,6508,63,2,2,27,503,503,501,501
Plumas,2,2021-12-27,18,18,8,10,299,299,129,170,0,0,0,0,12,12,12,12
Riverside,2,2021-12-27,13688,13688,6603,7085,87498,87498,41712,45786,306,53,53,81,5632,5632,5579,5579
Sacramento,2,2021-12-27,5199,5199,2414,2785,52471,52471,23999,28472,135,22,22,44,2512,2512,2490,2490
San Benito,2,2021-12-27,317,317,163,154,2307,2307,1173,1134,1,3,3,3,84,84,81,81
San Bernardino,2,2021-12-27,14403,14403,7739,6664,87891,87891,46454,41437,341,69,69,141,6580,6580,6511,6511
San Diego,2,2021-12-27,27117,27117,19929,7188,177596,177600,129643,47957,315,34,34,96,4513,4513,4479,4479
San Francisco,2,2021-12-27,6859,6859,2010,4849,65931,65931,19043,46888,31,1,1,14,694,694,693,693
San Joaquin,2,2021-12-27,2352,2352,1037,1315,22767,22767,9880,12887,61,15,15,25,1987,1987,1972,1972
San Luis Obispo,2,2021-12-27,1153,1153,583,570,11182,11182,5563,5619,11,1,1,8,372,372,371,371
San Mateo,2,2021-12-27,5284,5284,2933,2351,55544,55544,30397,25147,19,2,2,5,603,603,601,601
Santa Barbara,2,2021-12-27,2142,2142,1022,1120,15278,15278,7172,8106,33,5,5,10,575,575,570,570
Santa Clara,2,2021-12-27,9052,9052,6551,2501,107055,107055,76804,30251,95,10,10,38,1988,1988,1978,1978
Santa Cruz,2,2021-12-27,946,946,489,457,12423,12423,6305,6118,11,0,0,2,230,230,230,230
Shasta,2,2021-12-27,263,263,123,140,4624,4624,2123,2501,32,5,5,12,453,453,448,448
Siskiyou,2,2021-12-27,21,21,11,10,360,360,190,170,0,0,0,0,63,63,63,63
Solano,2,2021-12-27,1301,1301,627,674,17043,17043,8085,8958,25,5,5,5,394,394,389,389
Sonoma,2,2021-12-27,1914,1914,934,980,21663,21663,10424,11239,19,1,1,5,421,421,420,420
Stanislaus,2,2021-12-27,1249,1249,468,781,11151,11151,4114,7037,94,17,17,18,1449,1449,1432,1432
Sutter,2,2021-12-27,226,226,108,118,2131,2131,1006,1125,0,2,2,0,195,195,193,193
Tehama,2,2021-12-27,103,103,40,63,1106,1106,419,687,6,2,2,3,167,167,165,165
Trinity,2,2021-12-27,4,4,2,2,101,101,37,64,0,0,0,0,19,19,19,19
Tulare,2,2021-12-27,815,815,301,514,11116,11116,4057,7059,36,10,10,9,1318,1318,1308,1308
Tuolumne,2,2021-12-27,171,171,72,99,1672,1672,692,980,5,0,0,1,150,150,150,150
Ventura,2,2021-12-27,5721,5721,3307,2414,39329,39329,22501,16828,66,8,8,19,1224,1224,1216,1216
Yolo,2,2021-12-27,818,818,417,401,22121,22121,11082,11039,7,1,1,4,295,295,294,294
Yuba,2,2021-12-27,164,164,81,83,1534,1534,749,785,8,1,1,4,103,103,102,102
Alameda,3,2022-01-03,17659,17659,10481,7178,117281,117282,69467,47815,156,5,5,31,1565,1565,1560,1560
Amador,3,2022-01-03,218,218,104,114,2179,2179,1029,1150,5,1,1,2,71,71,70,70
Butte,3,2022-01-03,1202,1202,778,424,6871,6871,4430,2441,32,0,0,4,362,362,362,362
Calaveras,3,2022-01-03,232,232,120,112,1305,1305,666,639,0,1,1,1,94,94,93,93
Colusa,3,2022-01-03,48,48,26,22,393,393,217,176,5,0,0,0,21,21,21,21
Contra Costa,3,2022-01-03,13524,13524,6291,7233,69128,69128,32071,37057,76,10,10,21,1093,1093,1083,1083
Del Norte,3,2022-01-03,86,86,47,39,2132,2132,1143,989,0,0,0,0,42,42,42,42
El Dorado,3,2022-01-03,1290,1290,660,630,6062,6062,3079,2983,7,4,4,6,183,183,179,179
Fresno,3,2022-01-03,6611,6611,3178,3433,38536,38536,18396,20140,175,14,14,44,2449,2449,2435,2435
Glenn,3,2022-01-03,78,78,40,38,610,610,318,292,0,1,1,0,43,43,42,42
Humboldt,3,2022-01-03,881,881,471,410,5295,5295,2810,2485,9,1,1,3,123,123,122,122
Imperial,3,2022-01-03,1878,1878,956,922,9138,9138,4614,4524,35,14,14,29,841,841,827,827
Inyo,3,2022-01-03,265,265,147,118,713,713,394,319,3,0,0,0,50,50,50,50
Kern,3,2022-01-03,5836,5836,3271,2565,35876,35876,19998,15878,100,16,16,32,2057,2057,2041,2041
Kings,3,2022-01-03,1095,1095,561,534,8511,8511,4310,4201,13,3,3,5,393,393,390,390
Lake,3,2022-01-03,220,220,106,114,1777,1777,847,930,1,0,0,1,117,117,117,117
Lassen,3,2022-01-03,61,61,35,26,3119,3119,1806,1313,2,0,0,0,54,54,54,54
Los Angeles,3,2022-01-03,204162,204167,160570,43597,1088022,1088044,856010,232034,1937,149,149,303,27636,27636,27487,27487
Madera,3,2022-01-03,830,830,398,432,6362,6362,3024,3338,17,3,3,6,339,339,336,336
Marin,3,2022-01-03,2364,2364,1148,1216,17674,17674,8532,9142,15,1,1,3,257,257,256,256
Mariposa,3,2022-01-03,103,103,48,55,657,657,304,353,0,0,0,0,21,21,21,21
Mendocino,3,2022-01-03,453,453,187,266,3572,3572,1454,2118,7,1,1,2,104,104,103,103
Merced,3,2022-01-03,1604,1604,882,722,8548,8548,4667,3881,3,9,9,4,709,709,700,700
Modoc,3,2022-01-03,15,15,8,7,59,59,33,26,0,0,0,0,6,6,6,6
Mono,3,2022-01-03,180,180,65,115,435,435,156,279,2,0,0,0,4,4,4,4
Monterey,3,2022-01-03,2465,2465,908,1557,20639,20639,7547,13092,30,4,4,10,649,649,645,645
Napa,3,2022-01-03,1856,1856,1076,780,11756,11756,6790,4966,9,1,1,3,109,109,108,108
Nevada,3,2022-01-03,647,647,314,333,3071,3071,1485,1586,7,1,1,3,112,112,111,111
Orange,3,2022-01-03,45472,45472,27785,17687,220203,220208,134351,85857,504,34,34,110,6087,6087,6053,6053
Placer,3,2022-01-03,2917,2917,1338,1579,15071,15071,6863,8208,113,15,15,24,518,518,503,503
Plumas,3,2022-01-03,55,55,28,27,496,496,248,248,1,0,0,0,12,12,12,12
Riverside,3,2022-01-03,32051,32051,17312,14739,138453,138454,74449,64005,564,54,54,94,5686,5686,5632,5632
Sacramento,3,2022-01-03,14148,14148,7388,6760,80499,80500,41835,38665,219,25,25,57,2537,2537,2512,2512
San Benito,3,2022-01-03,739,739,422,317,3464,3464,1976,1488,3,1,1,2,85,85,84,84
San Bernardino,3,2022-01-03,33863,33863,20029,13834,135047,135050,79600,55450,571,94,94,136,6674,6674,6580,6580
San Diego,3,2022-01-03,61093,61093,47459,13634,253655,253660,196957,56703,561,35,35,121,4548,4548,4513,4513
San Francisco,3,2022-01-03,11437,11437,3973,7464,85530,85531,29513,56018,78,5,5,22,699,699,694,694
San Joaquin,3,2022-01-03,6977,6977,3479,3498,36105,36105,17888,18217,80,13,13,27,2000,2000,1987,1987
San Luis Obispo,3,2022-01-03,2473,2473,1386,1087,15963,15963,8917,7046,24,5,5,7,377,377,372,372
San Mateo,3,2022-01-03,10628,10628,6507,4121,81981,81982,50097,31885,37,4,4,7,607,607,603,603
Santa Barbara,3,2022-01-03,5327,5327,2851,2476,28193,28193,15053,13140,53,5,5,7,580,580,575,575
Santa Clara,3,2022-01-03,23032,23032,17706,5326,170174,170176,130640,39536,186,10,10,58,1998,1998,1988,1988
Santa Cruz,3,2022-01-03,2410,2410,1388,1022,21662,21662,12485,9177,15,5,5,3,235,235,230,230
Shasta,3,2022-01-03,601,601,318,283,6174,6174,3228,2946,33,2,2,13,455,455,453,453
Siskiyou,3,2022-01-03,74,74,44,30,590,590,348,242,0,0,0,0,63,63,63,63
Solano,3,2022-01-03,4071,4071,2180,1891,26132,26132,13980,12152,54,3,3,9,397,397,394,394
Sonoma,3,2022-01-03,4540,4540,2480,2060,32186,32186,17528,14658,25,7,7,4,428,428,421,421
Stanislaus,3,2022-01-03,3334,3334,1436,1898,17985,17985,7689,10296,129,9,9,20,1458,1458,1449,1449
Sutter,3,2022-01-03,547,547,296,251,2980,2980,1594,1386,0,2,2,0,197,197,195,195
Tehama,3,2022-01-03,216,216,97,119,1474,1474,652,822,4,1,1,2,168,168,167,167
Trinity,3,2022-01-03,14,14,6,8,107,107,46,61,0,0,0,0,19,19,19,19
Tulare,3,2022-01-03,2142,2142,917,1225,16001,16001,6773,9228,57,5,5,7,1323,1323,1318,1318
Tuolumne,3,2022-01-03,383,383,186,197,2544,2544,1227,1317,7,3,3,0,153,153,150,150
Ventura,3,2022-01-03,12671,12671,7986,4685,59673,59673,37562,22111,136,11,11,28,1235,1235,1224,1224
Yolo,3,2022-01-03,2321,2321,1323,998,31707,31707,17935,13772,8,4,4,3,299,299,295,295
Yuba,3,2022-01-03,473,473,262,211,2331,2331,1284,1047,17,1,1,6,104,104,103,103
Alameda,4,2022-01-10,31211,31211,20220,10991,193863,193868,125728,68140,277,14,14,46,1579,1579,1565,1565
Amador,4,2022-01-10,392,392,210,182,2726,2726,1447,1279,4,0,0,4,71,71,71,71
Butte,4,2022-01-10,2002,2002,1397,605,10455,10455,7284,3171,55,2,2,4,364,364,362,362
Calaveras,4,2022-01-10,523,523,299,224,2607,2607,1479,1128,0,1,1,2,95,95,94,94
Colusa,4,2022-01-10,105,105,65,40,756,756,462,294,5,0,0,0,21,21,21,21
Contra Costa,4,2022-01-10,19741,19741,10339,9402,102253,102255,53545,48710,152,12,12,24,1105,1105,1093,1093
Del Norte,4,2022-01-10,177,177,106,71,3958,3958,2363,1595,2,0,0,0,42,42,42,42
El Dorado,4,2022-01-10,2214,2214,1260,954,9363,9363,5325,4038,14,6,6,2,189,189,183,183
Fresno,4,2022-01-10,14417,14417,7791,6626,59855,59855,32275,27580,301,14,14,47,2463,2463,2449,2449
Glenn,4,2022-01-10,219,219,127,92,938,938,544,394,2,0,0,0,43,43,43,43
Humboldt,4,2022-01-10,1401,1401,827,574,8355,8355,4924,3431,18,5,5,2,128,128,123,123
Imperial,4,2022-01-10,3624,3624,2048,1576,13829,13829,7797,6032,58,11,11,25,852,852,841,841
Inyo,4,2022-01-10,408,408,248,160,1356,1356,826,530,4,2,2,0,52,52,50,50
Kern,4,2022-01-10,11945,11945,7345,4600,57114,57114,35081,22033,181,26,26,35,2083,2083,2057,2057
Kings,4,2022-01-10,2412,2412,1380,1032,13012,13012,7401,5611,33,1,1,4,394,394,393,393
Lake,4,2022-01-10,499,499,268,231,2761,2761,1477,1284,0,3,3,1,120,120,117,117
Lassen,4,2022-01-10,196,196,126,70,3438,3438,2185,1253,1,0,0,0,54,54,54,54
Los Angeles,4,2022-01-10,329112,329120,270888,58232,1915125,1915176,1576854,338322,3253,270,270,513,27906,27906,27636,27636
Madera,4,2022-01-10,1915,1915,1030,885,10380,10380,5547,4833,19,1,1,6,340,340,339,339
Marin,4,2022-01-10,2941,2941,1602,1339,21012,21012,11438,9574,18,3,3,5,260,260,257,257
Mariposa,4,2022-01-10,199,199,105,94,1158,1158,607,551,0,1,1,0,22,22,21,21
Mendocino,4,2022-01-10,874,874,410,464,5538,5538,2581,2957,8,2,2,2,106,106,104,104
Merced,4,2022-01-10,3925,3925,2376,1549,14514,14514,8774,5740,33,10,10,11,719,719,709,709
Modoc,4,2022-01-10,13,13,8,5,109,109,67,42,0,0,0,0,6,6,6,6
Mono,4,2022-01-10,253,253,106,147,863,863,360,503,1,1,1,0,5,5,4,4
Monterey,4,2022-01-10,4982,4982,2118,2864,33232,33232,14051,19181,44,5,5,12,654,654,649,649
Napa,4,2022-01-10,2646,2646,1679,967,14352,14352,9103,5249,14,1,1,4,110,110,109,109
Nevada,4,2022-01-10,1189,1189,646,543,5233,5233,2839,2394,10,2,2,3,114,114,112,112
Orange,4,2022-01-10,60096,60096,40000,20096,317673,317681,211518,106163,854,100,100,159,6187,6187,6087,6087
Placer,4,2022-01-10,5196,5196,2692,2504,22555,22555,11665,10890,179,6,6,29,524,524,518,518
Plumas,4,2022-01-10,141,141,79,62,803,803,446,357,5,0,0,0,12,12,12,12
Riverside,4,2022-01-10,48269,48269,28857,19412,187763,187768,112222,75546,762,83,83,139,5769,5769,5686,5686
Sacramento,4,2022-01-10,27530,27530,15930,11600,121782,121787,70480,51307,375,37,37,89,2574,2574,2537,2537
San Benito,4,2022-01-10,1039,1039,655,384,4616,4616,2910,1706,3,1,1,2,86,86,85,85
San Bernardino,4,2022-01-10,50589,50589,32771,17818,192755,192760,124813,67947,784,113,113,187,6787,6787,6674,6674
San Diego,4,2022-01-10,82748,82748,67424,15324,330085,330095,269007,61088,895,66,66,166,4614,4614,4548,4548
San Francisco,4,2022-01-10,15099,15099,6036,9063,117290,117295,46959,70336,158,12,12,35,711,711,699,699
San Joaquin,4,2022-01-10,14516,14516,8088,6428,66807,66807,37164,29643,151,15,15,45,2015,2015,2000,2000
San Luis Obispo,4,2022-01-10,4337,4337,2676,1661,21621,21621,13356,8265,30,2,2,7,379,379,377,377
San Mateo,4,2022-01-10,15023,15023,10006,5017,113103,113106,75329,37777,95,5,5,16,612,612,607,607
Santa Barbara,4,2022-01-10,8538,8538,5054,3484,47382,47382,28051,19331,84,9,9,10,589,589,580,580
Santa Clara,4,2022-01-10,36506,36506,29460,7046,271164,271172,218787,52385,350,26,26,68,2024,2024,1998,1998
Santa Cruz,4,2022-01-10,4543,4543,2861,1682,42815,42815,26980,15835,25,2,2,2,237,237,235,235
Shasta,4,2022-01-10,1060,1060,619,441,8406,8406,4894,3512,37,7,7,12,462,462,455,455
Siskiyou,4,2022-01-10,120,120,77,43,919,919,591,328,3,1,1,1,64,64,63,63
Solano,4,2022-01-10,6925,6925,4126,2799,37117,37117,22127,14990,94,6,6,15,403,403,397,397
Sonoma,4,2022-01-10,8869,8869,5343,3526,47195,47195,28451,18744,72,9,9,8,437,437,428,428
Stanislaus,4,2022-01-10,6753,6753,3308,3445,29317,29317,14323,14994,173,13,13,19,1471,1471,1458,1458
Sutter,4,2022-01-10,1245,1245,743,502,5062,5062,3006,2056,0,2,2,0,199,199,197,197
Tehama,4,2022-01-10,513,513,257,256,2482,2482,1241,1241,13,1,1,1,169,169,168,168
Trinity,4,2022-01-10,38,38,19,19,275,275,135,140,0,0,0,0,19,19,19,19
Tulare,4,2022-01-10,5211,5211,2539,2672,24078,24078,11672,12406,66,9,9,8,1332,1332,1323,1323
Tuolumne,4,2022-01-10,806,806,436,370,4178,4178,2257,1921,13,1,1,1,154,154,153,153
Ventura,4,2022-01-10,17513,17513,11977,5536,88216,88216,60304,27912,227,23,23,34,1258,1258,1235,1235
Yolo,4,2022-01-10,3761,3761,2341,1420,48232,48232,29996,18236,6,4,4,1,303,303,299,299
Yuba,4,2022-01-10,1022,1022,624,398,4108,4108,2504,1604,41,0,0,7,104,104,104,104
Alameda,5,2022-01-17,24713,24713,17336,7377,170500,170505,119538,50967,366,33,33,62,1612,1612,1579,1579
Amador,5,2022-01-17,476,476,282,194,3557,3557,2081,1476,10,2,2,3,73,73,71,71
Butte,5,2022-01-17,2063,2063,1538,525,9327,9327,6949,2378,58,6,6,6,370,370,364,364
Calaveras,5,2022-01-17,564,564,353,211,2472,2472,1542,930,3,2,2,3,97,97,95,95
Colusa,5,2022-01-17,161,161,107,54,719,719,476,243,3,0,0,0,21,21,21,21
Contra Costa,5,2022-01-17,16222,16222,9472,6750,88040,88043,51322,36721,198,22,22,41,1127,1127,1105,1105
Del Norte,5,2022-01-17,200,200,131,69,3758,3758,2429,1329,2,0,0,1,42,42,42,42
El Dorado,5,2022-01-17,1966,1966,1229,737,8063,8063,5041,3022,9,4,4,2,193,193,189,189
Fresno,5,2022-01-17,18274,18274,10945,7329,65974,65974,39477,26497,386,27,27,61,2490,2490,2463,2463
Glenn,5,2022-01-17,306,306,194,112,1076,1076,683,393,3,2,2,0,45,45,43,43
Humboldt,5,2022-01-17,1144,1144,739,405,8323,8323,5365,2958,10,1,1,4,129,129,128,128
Imperial,5,2022-01-17,3416,3416,2124,1292,13220,13220,8218,5002,69,12,12,29,864,864,852,852
Inyo,5,2022-01-17,327,327,216,111,1040,1040,688,352,4,0,0,0,52,52,52,52
Kern,5,2022-01-17,11693,11693,7803,3890,51811,51811,34532,17279,242,29,29,44,2112,2112,2083,2083
Kings,5,2022-01-17,3200,3200,1999,1201,14866,14866,9258,5608,40,4,4,1,398,398,394,394
Lake,5,2022-01-17,583,583,348,235,3245,3245,1935,1310,2,1,1,2,121,121,120,120
Lassen,5,2022-01-17,284,284,196,88,3322,3322,2278,1044,0,0,0,0,54,54,54,54
Los Angeles,5,2022-01-17,218488,218494,186916,31578,1610429,1610483,1376789,233694,4034,504,504,680,28410,28410,27906,27906
Madera,5,2022-01-17,2401,2401,1432,969,10611,10611,6301,4310,32,5,5,10,345,345,340,340
Marin,5,2022-01-17,2421,2421,1461,960,17703,17703,10679,7024,38,4,4,6,264,264,260,260
Mariposa,5,2022-01-17,163,163,95,68,1115,1115,648,467,0,0,0,0,22,22,22,22
Mendocino,5,2022-01-17,922,922,487,435,5015,5015,2630,2385,18,3,3,2,109,109,106,106
Merced,5,2022-01-17,4054,4054,2673,1381,13639,13639,8989,4650,41,18,18,11,737,737,719,719
Modoc,5,2022-01-17,13,13,9,4,102,102,68,34,0,1,1,0,7,7,6,6
Mono,5,2022-01-17,198,198,94,104,809,809,386,423,2,0,0,0,5,5,5,5
Monterey,5,2022-01-17,5904,5904,2861,3043,28328,28328,13710,14618,69,6,6,14,660,660,654,654
Napa,5,2022-01-17,1931,1931,1329,602,11915,11915,8178,3737,21,2,2,5,112,112,110,110
Nevada,5,2022-01-17,1253,1253,753,500,5429,5429,3261,2168,19,1,1,1,115,115,114,114
Orange,5,2022-01-17,41335,41335,29650,11685,251496,251505,180237,71268,998,111,111,199,6298,6298,6187,6187
Placer,5,2022-01-17,4318,4318,2494,1824,19460,19460,11216,8244,178,14,14,36,538,538,524,524
Plumas,5,2022-01-17,194,194,119,75,852,852,524,328,3,0,0,0,12,12,12,12
Riverside,5,2022-01-17,41254,41254,26969,14285,168056,168061,109881,58180,920,97,97,158,5866,5866,5769,5769
Sacramento,5,2022-01-17,21464,21464,13659,7805,101464,101468,64496,36972,473,64,64,97,2638,2638,2574,2574
San Benito,5,2022-01-17,903,903,618,285,4273,4273,2922,1351,4,1,1,4,87,87,86,86
San Bernardino,5,2022-01-17,38489,38489,26924,11565,164351,164356,114968,49388,936,146,146,227,6933,6933,6787,6787
San Diego,5,2022-01-17,60666,60666,51496,9170,265928,265938,225763,40175,1067,103,103,193,4717,4717,4614,4614
San Francisco,5,2022-01-17,11267,11267,5204,6063,94013,94017,43307,50710,212,14,14,44,725,725,711,711
San Joaquin,5,2022-01-17,12719,12719,7803,4916,58085,58085,35642,22443,201,20,20,57,2035,2035,2015,2015
San Luis Obispo,5,2022-01-17,3934,3934,2647,1287,21024,21024,14127,6897,46,12,12,10,391,391,379,379
San Mateo,5,2022-01-17,12487,12487,8948,3539,95951,95955,68674,27281,92,10,10,30,622,622,612,612
Santa Barbara,5,2022-01-17,6854,6854,4446,2408,40486,40486,26230,14256,123,12,12,12,601,601,589,589
Santa Clara,5,2022-01-17,29562,29562,24873,4689,235961,235970,198419,37551,451,24,24,84,2048,2048,2024,2024
Santa Cruz,5,2022-01-17,4187,4187,2870,1317,42205,42205,28863,13342,23,3,3,3,240,240,237,237
Shasta,5,2022-01-17,1347,1347,863,484,9163,9163,5844,3319,55,7,7,14,469,469,462,462
Siskiyou,5,2022-01-17,158,158,110,48,927,927,640,287,3,1,1,2,65,65,64,64
Solano,5,2022-01-17,6431,6431,4198,2233,35199,35199,22970,12229,121,6,6,22,409,409,403,403
Sonoma,5,2022-01-17,7629,7629,5027,2602,42778,42778,28132,14646,73,7,7,15,444,444,437,437
Stanislaus,5,2022-01-17,7328,7328,4019,3309,29058,29058,15916,13142,206,10,10,31,1481,1481,1471,1471
Sutter,5,2022-01-17,1248,1248,812,436,4863,4863,3161,1702,0,4,4,0,203,203,199,199
Tehama,5,2022-01-17,616,616,344,272,2420,2420,1349,1071,15,5,5,2,174,174,169,169
Trinity,5,2022-01-17,41,41,23,18,255,255,140,115,0,1,1,0,20,20,19,19
Tulare,5,2022-01-17,7477,7477,4070,3407,27091,27091,14726,12365,97,16,16,16,1348,1348,1332,1332
Tuolumne,5,2022-01-17,886,886,532,354,3836,3836,2287,1549,10,8,8,1,162,162,154,154
Ventura,5,2022-01-17,11976,11976,8781,3195,66931,66931,49015,17916,300,41,41,56,1299,1299,1258,1258
Yolo,5,2022-01-17,2806,2806,1900,906,39496,39496,26704,12792,15,4,4,4,307,307,303,303
Yuba,5,2022-01-17,1064,1064,707,357,3747,3747,2489,1258,42,2,2,6,106,106,104,104
Alameda,6,2022-01-24,19741,19741,14820,4921,171783,171788,129141,42647,373,41,41,68,1653,1653,1612,1612
Amador,6,2022-01-24,544,544,352,192,4667,4667,3019,1648,8,0,0,5,73,73,73,73
Butte,6,2022-01-24,1906,1906,1503,403,9606,9606,7589,2017,82,10,10,9,380,380,370,370
Calaveras,6,2022-01-24,556,556,378,178,2506,2506,1705,801,6,2,2,2,99,99,97,97
Colusa,6,2022-01-24,177,177,127,50,951,951,680,271,6,0,0,0,21,21,21,21
Contra Costa,6,2022-01-24,13596,13596,8738,4858,85315,85319,54890,30429,217,25,25,64,1152,1152,1127,1127
Del Norte,6,2022-01-24,348,348,246,102,4326,4326,3042,1284,3,0,0,3,42,42,42,42
El Dorado,6,2022-01-24,1400,1400,954,446,7329,7329,5001,2328,17,2,2,6,195,195,193,193
Fresno,6,2022-01-24,17719,17719,11610,6109,68667,68668,45075,23593,491,43,43,83,2533,2533,2490,2490
Glenn,6,2022-01-24,250,250,172,78,971,971,670,301,0,0,0,0,45,45,45,45
Humboldt,6,2022-01-24,915,915,641,274,7714,7714,5409,2305,25,3,3,3,132,132,129,129
Imperial,6,2022-01-24,3620,3620,2457,1163,13168,13168,8955,4213,70,14,14,27,878,878,864,864
Inyo,6,2022-01-24,142,142,102,40,625,625,449,176,1,1,1,0,53,53,52,52
Kern,6,2022-01-24,10554,10554,7599,2955,53946,53946,38889,15057,267,47,47,51,2159,2159,2112,2112
Kings,6,2022-01-24,4306,4306,2925,1381,19064,19064,12977,6087,40,4,4,4,402,402,398,398
Lake,6,2022-01-24,746,746,488,258,3417,3417,2234,1183,6,2,2,3,123,123,121,121
Lassen,6,2022-01-24,418,418,307,111,3982,3982,2932,1050,6,0,0,0,54,54,54,54
Los Angeles,6,2022-01-24,164909,164914,145676,19238,1659203,1659267,1466740,192527,3769,611,611,785,29021,29021,28410,28410
Madera,6,2022-01-24,2715,2715,1771,944,12170,12170,7938,4232,49,7,7,10,352,352,345,345
Marin,6,2022-01-24,1857,1857,1227,630,17548,17548,11608,5940,38,4,4,10,268,268,264,264
Mariposa,6,2022-01-24,133,133,85,48,945,945,605,340,0,0,0,0,22,22,22,22
Mendocino,6,2022-01-24,917,917,538,379,4873,4873,2854,2019,23,2,2,3,111,111,109,109
Merced,6,2022-01-24,3236,3236,2309,927,12907,12907,9214,3693,55,9,9,12,746,746,737,737
Modoc,6,2022-01-24,14,14,10,4,114,114,82,32,2,0,0,0,7,7,7,7
Mono,6,2022-01-24,97,97,52,45,422,422,227,195,1,0,0,0,5,5,5,5
Monterey,6,2022-01-24,5088,5088,2775,2313,31797,31797,17335,14462,80,9,9,17,669,669,660,660
Napa,6,2022-01-24,1672,1672,1236,436,12465,12465,9206,3259,23,5,5,4,117,117,112,112
Nevada,6,2022-01-24,1001,1001,659,342,4806,4806,3170,1636,29,1,1,6,116,116,115,115
Orange,6,2022-01-24,26689,26689,20396,6293,230904,230914,176711,54203,923,177,177,191,6475,6475,6298,6298
Placer,6,2022-01-24,3660,3660,2330,1330,18644,18644,11867,6777,215,8,8,43,546,546,538,538
Plumas,6,2022-01-24,215,215,144,71,836,836,559,277,5,0,0,0,12,12,12,12
Riverside,6,2022-01-24,31908,31908,22576,9332,158776,158781,112465,46316,901,122,122,168,5988,5988,5866,5866
Sacramento,6,2022-01-24,17475,17475,12091,5384,98838,98843,68430,30413,542,64,64,105,2702,2702,2638,2638
San Benito,6,2022-01-24,776,776,570,206,3929,3929,2889,1040,7,1,1,3,88,88,87,87
San Bernardino,6,2022-01-24,28078,28078,21042,7036,153568,153573,115202,38371,975,170,170,223,7103,7103,6933,6933
San Diego,6,2022-01-24,51451,51451,45157,6294,252113,252124,221532,30592,1056,131,131,232,4848,4848,4717,4717
San Francisco,6,2022-01-24,8094,8094,4231,3863,88914,88919,46540,42379,232,19,19,37,744,744,725,725
San Joaquin,6,2022-01-24,11056,11056,7405,3651,59068,59069,39641,19428,241,34,34,71,2069,2069,2035,2035
San Luis Obispo,6,2022-01-24,3561,3561,2582,979,21516,21516,15603,5913,42,10,10,12,401,401,391,391
San Mateo,6,2022-01-24,8510,8510,6501,2009,95138,95143,72744,22399,139,19,19,28,641,641,622,622
Santa Barbara,6,2022-01-24,6484,6484,4559,1925,43826,43826,30822,13004,127,12,12,19,613,613,601,601
Santa Clara,6,2022-01-24,22785,22785,19871,2914,233308,233319,203466,29853,412,48,48,88,2096,2096,2048,2048
Santa Cruz,6,2022-01-24,5045,5045,3710,1335,45621,45621,33575,12046,31,1,1,2,241,241,240,240
Shasta,6,2022-01-24,1486,1486,1032,454,10135,10135,7033,3102,78,7,7,9,476,476,469,469
Siskiyou,6,2022-01-24,159,159,118,41,857,857,635,222,6,3,3,1,68,68,65,65
Solano,6,2022-01-24,5127,5127,3627,1500,32612,32612,23082,9530,143,14,14,26,423,423,409,409
Sonoma,6,2022-01-24,6926,6926,4931,1995,42474,42474,30246,12228,94,7,7,18,451,451,444,444
Stanislaus,6,2022-01-24,6376,6376,3877,2499,28268,28268,17211,11057,277,27,27,44,1508,1508,1481,1481
Sutter,6,2022-01-24,1047,1047,737,310,5002,5002,3521,1481,0,2,2,0,205,205,203,203
Tehama,6,2022-01-24,577,577,357,220,2702,2702,1674,1028,19,4,4,5,178,178,174,174
Trinity,6,2022-01-24,63,63,38,25,322,322,196,126,0,0,0,0,20,20,20,20
Tulare,6,2022-01-24,7678,7678,4632,3046,29521,29521,17850,11671,138,11,11,14,1359,1359,1348,1348
Tuolumne,6,2022-01-24,954,954,628,326,3827,3827,2510,1317,17,2,2,3,164,164,162,162
Ventura,6,2022-01-24,9412,9412,7331,2081,68520,68522,53429,15093,269,28,28,68,1327,1327,1299,1299
Yolo,6,2022-01-24,2300,2300,1677,623,40467,40467,29505,10962,18,12,12,5,319,319,307,307
Yuba,6,2022-01-24,911,911,653,258,3777,3777,2709,1068,54,3,3,10,109,109,106,106
Alameda,7,2022-01-31,10998,10998,8741,2257,137319,137324,109273,28051,336,50,50,75,1703,1703,1653,1653
Amador,7,2022-01-31,350,350,246,104,3226,3226,2273,953,15,1,1,4,74,74,73,73
Butte,7,2022-01-31,1163,1163,963,200,7608,7608,6305,1303,80,6,6,7,386,386,380,380
Calaveras,7,2022-01-31,263,263,193,70,1940,1940,1424,516,3,5,5,2,104,104,99,99
Colusa,7,2022-01-31,106,106,81,25,704,704,540,164,9,0,0,0,21,21,21,21
Contra Costa,7,2022-01-31,7310,7310,5096,2214,68625,68628,47922,20706,207,39,39,54,1191,1191,1152,1152
Del Norte,7,2022-01-31,315,315,237,78,3957,3957,2977,980,6,2,2,2,44,44,42,42
El Dorado,7,2022-01-31,741,741,544,197,6019,6019,4420,1599,13,4,4,5,199,199,195,195
Fresno,7,2022-01-31,10976,10976,7784,3192,54817,54817,38928,15889,503,39,39,98,2572,2572,2533,2533
Glenn,7,2022-01-31,190,190,140,50,759,759,563,196,2,2,2,0,47,47,45,45
Humboldt,7,2022-01-31,583,583,438,145,5790,5790,4348,1442,18,3,3,3,135,135,132,132
Imperial,7,2022-01-31,2197,2197,1602,595,11283,11283,8249,3034,71,17,17,28,895,895,878,878
Inyo,7,2022-01-31,55,55,42,13,467,467,357,110,5,3,3,0,56,56,53,53
Kern,7,2022-01-31,5650,5650,4340,1310,42263,42263,32503,9760,264,47,47,54,2206,2206,2159,2159
Kings,7,2022-01-31,2391,2391,1749,642,13681,13681,10017,3664,55,5,5,4,407,407,402,402
Lake,7,2022-01-31,478,478,338,140,3193,3193,2258,935,4,4,4,4,127,127,123,123
Lassen,7,2022-01-31,311,311,243,68,3624,3624,2838,786,7,1,1,0,55,55,54,54
Los Angeles,7,2022-01-31,74572,74575,67643,6932,1302828,1302885,1182576,120309,2991,640,640,719,29661,29661,29021,29021
Madera,7,2022-01-31,1744,1744,1233,511,9631,9631,6816,2815,50,6,6,7,358,358,352,352
Marin,7,2022-01-31,1063,1063,759,304,13817,13817,9888,3929,26,5,5,9,273,273,268,268
Mariposa,7,2022-01-31,101,101,70,31,840,840,584,256,0,2,2,0,24,24,22,22
Mendocino,7,2022-01-31,464,464,299,165,3486,3486,2252,1234,12,3,3,4,114,114,111,111
Merced,7,2022-01-31,2126,2126,1618,508,10466,10466,7976,2490,54,12,12,14,758,758,746,746
Modoc,7,2022-01-31,12,12,9,3,89,89,68,21,1,0,0,0,7,7,7,7
Mono,7,2022-01-31,41,41,25,16,339,339,203,136,0,0,0,0,5,5,5,5
Monterey,7,2022-01-31,3558,3558,2154,1404,26742,26742,16229,10513,82,9,9,13,678,678,669,669
Napa,7,2022-01-31,989,989,776,213,9376,9376,7355,2021,17,7,7,10,124,124,117,117
Nevada,7,2022-01-31,568,568,404,164,3912,3912,2788,1124,26,3,3,5,119,119,116,116
Orange,7,2022-01-31,11996,11996,9677,2319,177030,177036,142935,34101,708,170,170,164,6645,6645,6475,6475
Placer,7,2022-01-31,2256,2256,1560,696,15375,15375,10647,4728,152,19,19,42,565,565,546,546
Plumas,7,2022-01-31,137,137,98,39,753,753,542,211,1,0,0,0,12,12,12,12
Riverside,7,2022-01-31,15945,15945,12051,3894,121042,121047,91695,29352,740,111,111,171,6099,6099,5988,5988
Sacramento,7,2022-01-31,10143,10143,7526,2617,77585,77589,57654,19935,501,93,93,106,2795,2795,2702,2702
San Benito,7,2022-01-31,474,474,370,104,3323,3323,2596,727,5,2,2,3,90,90,88,88
San Bernardino,7,2022-01-31,13253,13253,10517,2736,116539,116544,92599,23945,744,185,185,207,7288,7288,7103,7103
San Diego,7,2022-01-31,24833,24833,22405,2428,181384,181391,163800,17591,944,105,105,214,4953,4953,4848,4848
San Francisco,7,2022-01-31,4046,4046,2359,1687,69165,69169,40403,28766,208,24,24,45,768,768,744,744
San Joaquin,7,2022-01-31,5701,5701,4124,1577,43647,43647,31642,12005,210,36,36,75,2105,2105,2069,2069
San Luis Obispo,7,2022-01-31,1981,1981,1530,451,16234,16234,12540,3694,40,12,12,10,413,413,401,401
San Mateo,7,2022-01-31,4328,4328,3489,839,75105,75109,60572,14537,131,10,10,19,651,651,641,641
Santa Barbara,7,2022-01-31,3634,3634,2733,901,35026,35026,26385,8641,103,23,23,13,636,636,613,613
Santa Clara,7,2022-01-31,13837,13837,12416,1421,207115,207124,185907,21217,427,54,54,93,2150,2150,2096,2096
Santa Cruz,7,2022-01-31,3441,3441,2682,759,51420,51421,40151,11270,35,5,5,6,246,246,241,241
Shasta,7,2022-01-31,900,900,670,230,8419,8419,6269,2150,59,13,13,11,489,489,476,476
Siskiyou,7,2022-01-31,119,119,94,25,691,691,545,146,8,2,2,2,70,70,68,68
Solano,7,2022-01-31,3812,3812,2885,927,28697,28697,21716,6981,126,6,6,30,429,429,423,423
Sonoma,7,2022-01-31,3569,3569,2711,858,32147,32147,24452,7695,84,12,12,15,463,463,451,451
Stanislaus,7,2022-01-31,3687,3687,2458,1229,22306,22306,14897,7409,261,33,33,53,1541,1541,1508,1508
Sutter,7,2022-01-31,619,619,466,153,3764,3764,2837,927,0,4,4,0,209,209,205,205
Tehama,7,2022-01-31,377,377,256,121,2022,2022,1368,654,17,3,3,5,181,181,178,178
Trinity,7,2022-01-31,43,43,29,14,227,227,151,76,0,0,0,0,20,20,20,20
Tulare,7,2022-01-31,4687,4687,3099,1588,22903,22903,15175,7728,150,22,22,21,1381,1381,1359,1359
Tuolumne,7,2022-01-31,710,710,502,208,3265,3265,2315,950,12,2,2,4,166,166,164,164
Ventura,7,2022-01-31,4599,4599,3766,833,52327,52327,42903,9424,253,39,39,48,1366,1366,1327,1327
Yolo,7,2022-01-31,1353,1353,1049,304,37506,37506,29104,8402,19,5,5,5,324,324,319,319
Yuba,7,2022-01-31,524,524,401,123,2931,2931,2243,688,78,2,2,11,111,111,109,109
Alameda,8,2022-02-07,5970,5970,4971,999,115667,115672,96373,19299,254,44,44,62,1747,1747,1703,1703
Amador,8,2022-02-07,204,204,153,51,2909,2909,2187,722,14,4,4,5,78,78,74,74
Butte,8,2022-02-07,784,784,674,110,6392,6392,5504,888,74,8,8,12,394,394,386,386
Calaveras,8,2022-02-07,183,183,142,41,1427,1427,1112,315,2,2,2,1,106,106,104,104
Colusa,8,2022-02-07,71,71,57,14,555,555,449,106,0,0,0,0,21,21,21,21
Contra Costa,8,2022-02-07,4138,4138,3094,1044,54149,54149,40503,13646,149,32,32,52,1223,1223,1191,1191
Del Norte,8,2022-02-07,286,286,228,58,4003,4003,3184,819,5,0,0,0,44,44,44,44
El Dorado,8,2022-02-07,427,427,333,94,5034,5034,3927,1107,20,1,1,5,200,200,199,199
Fresno,8,2022-02-07,6386,6386,4838,1548,42465,42465,32208,10257,450,49,49,87,2621,2621,2572,2572
Glenn,8,2022-02-07,113,113,88,25,620,620,488,132,4,3,3,0,50,50,47,47
Humboldt,8,2022-02-07,467,467,371,96,4875,4875,3874,1001,15,1,1,2,136,136,135,135
Imperial,8,2022-02-07,1095,1095,851,244,7927,7927,6163,1764,46,12,12,26,907,907,895,895
Inyo,8,2022-02-07,38,38,30,8,447,447,361,86,5,0,0,0,56,56,56,56
Kern,8,2022-02-07,3473,3473,2812,661,34656,34656,28087,6569,190,32,32,43,2238,2238,2206,2206
Kings,8,2022-02-07,1353,1353,1052,301,10247,10247,7976,2271,52,14,14,5,421,421,407,407
Lake,8,2022-02-07,351,351,265,86,2624,2624,1985,639,11,1,1,5,128,128,127,127
Lassen,8,2022-02-07,140,140,115,25,3023,3023,2487,536,5,2,2,0,57,57,55,55
Los Angeles,8,2022-02-07,37352,37352,34595,2757,1151453,1151503,1066949,84554,2155,638,638,547,30299,30299,29661,29661
Madera,8,2022-02-07,1060,1060,802,258,8081,8081,6118,1963,38,4,4,9,362,362,358,358
Marin,8,2022-02-07,655,655,500,155,11291,11291,8617,2674,29,8,8,6,281,281,273,273
Mariposa,8,2022-02-07,51,51,38,13,579,579,431,148,0,0,0,0,24,24,24,24
Mendocino,8,2022-02-07,327,327,229,98,2817,2817,1974,843,12,2,2,5,116,116,114,114
Merced,8,2022-02-07,1210,1210,974,236,8063,8063,6492,1571,53,13,13,12,771,771,758,758
Modoc,8,2022-02-07,25,25,20,5,219,219,179,40,3,0,0,0,7,7,7,7
Mono,8,2022-02-07,44,44,29,15,271,271,178,93,0,0,0,0,5,5,5,5
Monterey,8,2022-02-07,2221,2221,1474,747,22461,22461,14939,7522,68,11,11,14,689,689,678,678
Napa,8,2022-02-07,742,742,611,131,7766,7766,6396,1370,16,6,6,2,130,130,124,124
Nevada,8,2022-02-07,357,357,271,86,3187,3187,2429,758,24,3,3,1,122,122,119,119
Orange,8,2022-02-07,6388,6388,5386,1002,152286,152291,128443,23848,494,118,118,125,6763,6763,6645,6645
Placer,8,2022-02-07,1294,1294,960,334,11887,11887,8831,3056,148,22,22,34,587,587,565,565
Plumas,8,2022-02-07,79,79,60,19,521,521,399,122,1,1,1,0,13,13,12,12
Riverside,8,2022-02-07,8143,8143,6511,1632,93428,93433,74778,18655,548,107,107,116,6206,6206,6099,6099
Sacramento,8,2022-02-07,6078,6078,4786,1292,63990,63992,50431,13561,390,72,72,95,2867,2867,2795,2795
San Benito,8,2022-02-07,311,311,255,56,2660,2660,2184,476,3,0,0,4,90,90,90,90
San Bernardino,8,2022-02-07,7049,7049,5863,1186,90090,90095,74996,15099,528,140,140,156,7428,7428,7288,7288
San Diego,8,2022-02-07,13633,13633,12576,1057,151885,151890,140175,11715,773,116,116,169,5069,5069,4953,4953
San Francisco,8,2022-02-07,2408,2408,1552,856,55776,55776,35911,19865,171,25,25,40,793,793,768,768
San Joaquin,8,2022-02-07,3348,3348,2581,767,36517,36517,28200,8317,186,42,42,62,2147,2147,2105,2105
San Luis Obispo,8,2022-02-07,1204,1204,979,225,12341,12341,10042,2299,23,16,16,7,429,429,413,413
San Mateo,8,2022-02-07,2463,2463,2075,388,62131,62134,52355,9779,83,16,16,18,667,667,651,651
Santa Barbara,8,2022-02-07,2282,2282,1814,468,30723,30723,24432,6291,75,15,15,17,651,651,636,636
Santa Clara,8,2022-02-07,8032,8032,7375,657,175343,175350,161031,14319,377,31,31,74,2181,2181,2150,2150
Santa Cruz,8,2022-02-07,1900,1900,1560,340,38681,38681,31764,6917,28,4,4,5,250,250,246,246
Shasta,8,2022-02-07,677,677,534,143,6857,6857,5413,1444,64,15,15,10,504,504,489,489
Siskiyou,8,2022-02-07,91,91,75,16,720,720,595,125,10,2,2,0,72,72,70,70
Solano,8,2022-02-07,2238,2238,1784,454,24201,24201,19339,4862,91,5,5,28,434,434,429,429
Sonoma,8,2022-02-07,2086,2086,1676,410,27053,27053,21735,5318,57,7,7,11,470,470,463,463
Stanislaus,8,2022-02-07,2491,2491,1792,699,18738,18738,13501,5237,243,43,43,43,1584,1584,1541,1541
Sutter,8,2022-02-07,360,360,286,74,3305,3305,2631,674,0,5,5,0,214,214,209,209
Tehama,8,2022-02-07,282,282,205,77,1644,1644,1197,447,17,3,3,6,184,184,181,181
Trinity,8,2022-02-07,18,18,13,5,136,136,98,38,0,0,0,0,20,20,20,20
Tulare,8,2022-02-07,2704,2704,1933,771,17908,17908,12832,5076,130,27,27,21,1408,1408,1381,1381
Tuolumne,8,2022-02-07,348,348,263,85,2576,2576,1953,623,10,2,2,1,168,168,166,166
Ventura,8,2022-02-07,2696,2696,2301,395,42327,42327,36165,6162,207,40,40,45,1406,1406,1366,1366
Yolo,8,2022-02-07,863,863,705,158,30856,30856,25179,5677,12,11,11,6,335,335,324,324
Yuba,8,2022-02-07,333,333,269,64,2406,2406,1942,464,42,4,4,13,115,115,111,111
Alameda,9,2022-02-14,3404,3404,2943,461,98991,98996,85611,13385,190,40,40,48,1787,1787,1747,1747
Amador,9,2022-02-14,109,109,87,22,2345,2345,1866,479,8,3,3,3,81,81,78,78
Butte,9,2022-02-14,464,464,412,52,5317,5317,4721,596,64,10,10,9,404,404,394,394
Calaveras,9,2022-02-14,79,79,64,15,1162,1162,950,212,4,2,2,2,108,108,106,106
Colusa,9,2022-02-14,35,35,29,6,406,406,341,65,5,0,0,0,21,21,21,21
Contra Costa,9,2022-02-14,2404,2404,1904,500,44860,44860,35540,9320,123,23,23,31,1246,1246,1223,1223
Del Norte,9,2022-02-14,210,210,175,35,3338,3338,2775,563,6,0,0,3,44,44,44,44
El Dorado,9,2022-02-14,260,260,213,47,4433,4433,3631,802,21,4,4,3,204,204,200,200
Fresno,9,2022-02-14,3865,3865,3094,771,34830,34830,27893,6937,375,34,34,75,2655,2655,2621,2621
Glenn,9,2022-02-14,58,58,48,10,482,482,398,84,3,1,1,0,51,51,50,50
Humboldt,9,2022-02-14,331,331,275,56,4202,4202,3495,707,23,0,0,2,136,136,136,136
Imperial,9,2022-02-14,588,588,480,108,5949,5949,4860,1089,44,14,14,18,921,921,907,907
Inyo,9,2022-02-14,29,29,24,5,413,413,348,65,3,0,0,0,56,56,56,56
Kern,9,2022-02-14,2014,2014,1701,313,27232,27232,23011,4221,156,28,28,40,2266,2266,2238,2238
Kings,9,2022-02-14,774,774,633,141,8001,8001,6548,1453,43,8,8,5,429,429,421,421
Lake,9,2022-02-14,256,256,205,51,2307,2307,1842,465,6,2,2,5,130,130,128,128
Lassen,9,2022-02-14,155,155,133,22,2789,2789,2383,406,3,2,2,0,59,59,57,57
Los Angeles,9,2022-02-14,21441,21441,20188,1253,1052395,1052445,991099,61346,1572,490,490,423,30789,30789,30299,30299
Madera,9,2022-02-14,621,621,497,124,6463,6463,5165,1298,29,2,2,7,364,364,362,362
Marin,9,2022-02-14,383,383,309,74,10150,10150,8173,1977,23,5,5,4,286,286,281,281
Mariposa,9,2022-02-14,24,24,19,5,433,433,342,91,0,0,0,0,24,24,24,24
Mendocino,9,2022-02-14,207,207,155,52,2445,2445,1834,611,13,1,1,7,117,117,116,116
Merced,9,2022-02-14,745,745,627,118,6832,6832,5744,1088,37,13,13,8,784,784,771,771
Modoc,9,2022-02-14,17,17,14,3,124,124,104,20,0,0,0,0,7,7,7,7
Mono,9,2022-02-14,10,10,7,3,179,179,127,52,0,0,0,0,5,5,5,5
Monterey,9,2022-02-14,1229,1229,881,348,16949,16949,12154,4795,48,12,12,12,701,701,689,689
Napa,9,2022-02-14,400,400,343,57,6577,6577,5635,942,10,1,1,1,131,131,130,130
Nevada,9,2022-02-14,169,169,136,33,2568,2568,2066,502,19,3,3,5,125,125,122,122
Orange,9,2022-02-14,4000,4000,3495,505,132322,132327,115555,16772,354,115,115,77,6878,6878,6763,6763
Placer,9,2022-02-14,595,595,468,127,9967,9967,7844,2123,105,12,12,23,599,599,587,587
Plumas,9,2022-02-14,43,43,35,8,431,431,348,83,1,0,0,0,13,13,13,13
Riverside,9,2022-02-14,4612,4612,3859,753,74753,74758,62570,12188,400,85,85,86,6291,6291,6206,6206
Sacramento,9,2022-02-14,3418,3418,2824,594,53020,53021,43828,9193,349,59,59,66,2926,2926,2867,2867
San Benito,9,2022-02-14,158,158,135,23,2159,2159,1845,314,0,1,1,3,91,91,90,90
San Bernardino,9,2022-02-14,3704,3704,3199,505,72756,72761,62876,9885,338,117,117,128,7545,7545,7428,7428
San Diego,9,2022-02-14,8074,8074,7577,497,126079,126084,118372,7712,589,89,89,135,5158,5158,5069,5069
San Francisco,9,2022-02-14,1609,1609,1123,486,47602,47602,33263,14339,130,25,25,39,818,818,793,793
San Joaquin,9,2022-02-14,1987,1987,1614,373,30637,30637,24895,5742,123,37,37,53,2184,2184,2147,2147
San Luis Obispo,9,2022-02-14,798,798,677,121,10051,10051,8530,1521,24,9,9,7,438,438,429,429
San Mateo,9,2022-02-14,1345,1345,1174,171,55007,55010,48010,7000,63,16,16,11,683,683,667,667
Santa Barbara,9,2022-02-14,1056,1056,880,176,22481,22481,18752,3729,68,8,8,14,659,659,651,651
Santa Clara,9,2022-02-14,4636,4636,4335,301,155254,155260,145180,10080,296,27,27,59,2208,2208,2181,2181
Santa Cruz,9,2022-02-14,981,981,838,143,30369,30369,25920,4449,23,3,3,4,253,253,250,250
Shasta,9,2022-02-14,442,442,366,76,5851,5851,4841,1010,62,13,13,13,517,517,504,504
Siskiyou,9,2022-02-14,66,66,57,9,520,520,447,73,7,1,1,2,73,73,72,72
Solano,9,2022-02-14,1201,1201,1003,198,18977,18977,15866,3111,73,2,2,20,436,436,434,434
Sonoma,9,2022-02-14,1135,1135,953,182,21176,21176,17763,3413,55,8,8,7,478,478,470,470
Stanislaus,9,2022-02-14,1364,1364,1046,318,15080,15080,11571,3509,206,28,28,41,1612,1612,1584,1584
Sutter,9,2022-02-14,230,230,192,38,2862,2862,2386,476,0,3,3,0,217,217,214,214
Tehama,9,2022-02-14,180,180,139,41,1404,1404,1088,316,15,5,5,5,189,189,184,184
Trinity,9,2022-02-14,22,22,17,5,171,171,131,40,0,0,0,0,20,20,20,20
Tulare,9,2022-02-14,1479,1479,1127,352,15049,15049,11498,3551,116,27,27,19,1435,1435,1408,1408
Tuolumne,9,2022-02-14,192,192,154,38,2221,2221,1778,443,12,4,4,1,172,172,168,168
Ventura,9,2022-02-14,1511,1511,1333,178,35526,35526,31346,4180,141,36,36,26,1442,1442,1406,1406
Yolo,9,2022-02-14,479,479,407,72,26821,26821,22789,4032,10,7,7,3,342,342,335,335
Yuba,9,2022-02-14,220,220,185,35,2109,2109,1777,332,19,0,0,11,115,115,115,115
Alameda,10,2022-02-21,1927,1927,1717,210,77637,77641,69066,8575,138,28,28,26,1815,1815,1787,1787
Amador,10,2022-02-21,70,70,58,12,1921,1921,1598,323,7,3,3,3,84,84,81,81
Butte,10,2022-02-21,256,256,233,23,4424,4424,4025,399,63,12,12,4,416,416,404,404
Calaveras,10,2022-02-21,44,44,37,7,838,838,712,126,3,6,6,0,114,114,108,108
Colusa,10,2022-02-21,26,26,23,3,362,362,315,47,4,0,0,0,21,21,21,21
Contra Costa,10,2022-02-21,1304,1304,1081,223,34147,34147,28269,5878,66,18,18,30,1264,1264,1246,1246
Del Norte,10,2022-02-21,129,129,111,18,2704,2704,2329,375,8,0,0,1,44,44,44,44
El Dorado,10,2022-02-21,155,155,132,23,3612,3612,3078,534,8,1,1,5,205,205,204,204
Fresno,10,2022-02-21,2012,2012,1683,329,26828,26828,22443,4385,272,26,26,54,2681,2681,2655,2655
Glenn,10,2022-02-21,28,28,24,4,405,405,348,57,2,1,1,0,52,52,51,51
Humboldt,10,2022-02-21,193,193,166,27,3331,3331,2873,458,22,3,3,1,139,139,136,136
Imperial,10,2022-02-21,394,394,335,59,4745,4745,4037,708,31,6,6,10,927,927,921,921
Inyo,10,2022-02-21,10,10,9,1,326,326,284,42,1,0,0,0,56,56,56,56
Kern,10,2022-02-21,1285,1285,1123,162,24322,24322,21263,3059,95,23,23,25,2289,2289,2266,2266
Kings,10,2022-02-21,454,454,387,67,6543,6543,5576,967,32,4,4,5,433,433,429,429
Lake,10,2022-02-21,185,185,155,30,1935,1935,1614,321,7,2,2,1,132,132,130,130
Lassen,10,2022-02-21,111,111,98,13,2135,2135,1883,252,1,0,0,0,59,59,59,59
Los Angeles,10,2022-02-21,11810,11810,11263,547,832210,832254,793225,39029,997,322,322,279,31111,31111,30789,30789
Madera,10,2022-02-21,317,317,265,52,5176,5176,4315,861,27,2,2,7,366,366,364,364
Marin,10,2022-02-21,199,199,167,32,8845,8845,7425,1420,13,3,3,4,289,289,286,286
Mariposa,10,2022-02-21,23,23,19,4,372,372,307,65,0,1,1,0,25,25,24,24
Mendocino,10,2022-02-21,113,113,90,23,1942,1942,1539,403,9,2,2,3,119,119,117,117
Merced,10,2022-02-21,427,427,372,55,5160,5160,4489,671,26,10,10,7,794,794,784,784
Modoc,10,2022-02-21,9,9,8,1,65,65,57,8,2,0,0,0,7,7,7,7
Mono,10,2022-02-21,7,7,5,2,162,162,123,39,0,1,1,0,6,6,5,5
Monterey,10,2022-02-21,780,780,596,184,12977,12977,9894,3083,47,5,5,7,706,706,701,701
Napa,10,2022-02-21,229,229,202,27,4985,4985,4405,580,6,4,4,3,135,135,131,131
Nevada,10,2022-02-21,102,102,85,17,1985,1985,1665,320,16,2,2,5,127,127,125,125
Orange,10,2022-02-21,2463,2463,2213,250,110415,110420,99027,11393,256,79,79,69,6957,6957,6878,6878
Placer,10,2022-02-21,328,328,271,57,8679,8679,7157,1522,92,9,9,13,608,608,599,599
Plumas,10,2022-02-21,21,21,18,3,328,328,276,52,0,0,0,0,13,13,13,13
Riverside,10,2022-02-21,2437,2437,2113,324,61414,61417,53277,8140,262,53,53,61,6344,6344,6291,6291
Sacramento,10,2022-02-21,1963,1963,1685,278,42793,42794,36703,6091,249,33,33,47,2959,2959,2926,2926
San Benito,10,2022-02-21,104,104,92,12,1696,1696,1494,202,0,0,0,1,91,91,91,91
San Bernardino,10,2022-02-21,1901,1901,1693,208,60252,60256,53633,6623,251,82,82,78,7627,7627,7545,7545
San Diego,10,2022-02-21,4623,4623,4398,225,100589,100594,95693,4901,468,62,62,106,5220,5220,5158,5158
San Francisco,10,2022-02-21,976,976,730,246,40355,40355,30107,10248,98,11,11,24,829,829,818,818
San Joaquin,10,2022-02-21,1049,1049,888,161,23840,23840,20163,3677,91,25,25,31,2209,2209,2184,2184
San Luis Obispo,10,2022-02-21,441,441,386,55,7650,7650,6704,946,16,16,16,3,454,454,438,438
San Mateo,10,2022-02-21,695,695,624,71,42576,42578,38163,4415,47,8,8,8,691,691,683,683
Santa Barbara,10,2022-02-21,611,611,528,83,19195,19195,16577,2618,40,6,6,10,665,665,659,659
Santa Clara,10,2022-02-21,2515,2515,2385,130,120312,120318,114029,6289,224,25,25,53,2233,2233,2208,2208
Santa Cruz,10,2022-02-21,578,578,509,69,25013,25013,22014,2999,21,1,1,4,254,254,253,253
Shasta,10,2022-02-21,263,263,225,38,4976,4976,4276,700,46,9,9,10,526,526,517,517
Siskiyou,10,2022-02-21,47,47,42,5,450,450,398,52,6,4,4,1,77,77,73,73
Solano,10,2022-02-21,696,696,603,93,15110,15110,13093,2017,51,5,5,15,441,441,436,436
Sonoma,10,2022-02-21,628,628,546,82,16821,16821,14601,2220,36,2,2,8,480,480,478,478
Stanislaus,10,2022-02-21,732,732,590,142,11759,11759,9489,2270,168,29,29,30,1641,1641,1612,1612
Sutter,10,2022-02-21,121,121,105,16,2108,2108,1821,287,0,2,2,0,219,219,217,217
Tehama,10,2022-02-21,96,96,78,18,1219,1219,993,226,8,10,10,2,199,199,189,189
Trinity,10,2022-02-21,15,15,12,3,199,199,160,39,0,0,0,0,20,20,20,20
Tulare,10,2022-02-21,774,774,622,152,10925,10925,8784,2141,86,15,15,9,1450,1450,1435,1435
Tuolumne,10,2022-02-21,107,107,90,17,1784,1784,1491,293,2,6,6,2,178,178,172,172
Ventura,10,2022-02-21,886,886,802,84,27543,27543,24926,2617,107,22,22,22,1464,1464,1442,1442
Yolo,10,2022-02-21,282,282,248,34,20978,20978,18399,2579,7,6,6,3,348,348,342,342
Yuba,10,2022-02-21,134,134,117,17,1679,1679,1466,213,22,1,1,8,116,116,115,115
Alameda,11,2022-02-28,1475,1475,1348,127,78765,78770,71943,6827,113,17,17,23,1832,1832,1815,1815
Amador,11,2022-02-28,56,56,48,8,2077,2077,1796,281,7,0,0,2,84,84,84,84
Butte,11,2022-02-28,187,187,174,13,4475,4475,4156,319,45,6,6,4,422,422,416,416
Calaveras,11,2022-02-28,40,40,35,5,1254,1254,1105,149,0,3,3,0,117,117,114,114
Colusa,11,2022-02-28,10,10,9,1,406,406,364,42,5,0,0,0,21,21,21,21
Contra Costa,11,2022-02-28,935,935,806,129,35020,35021,30195,4826,56,15,15,19,1279,1279,1264,1264
Del Norte,11,2022-02-28,84,84,75,9,2876,2876,2557,319,5,3,3,2,47,47,44,44
El Dorado,11,2022-02-28,105,105,93,12,3686,3686,3252,434,5,2,2,3,207,207,205,205
Fresno,11,2022-02-28,1308,1308,1136,172,26284,26284,22835,3449,196,28,28,44,2709,2709,2681,2681
Glenn,11,2022-02-28,18,18,16,2,435,435,386,49,1,0,0,0,52,52,52,52
Humboldt,11,2022-02-28,157,157,140,17,2957,2957,2633,324,6,1,1,1,140,140,139,139
Imperial,11,2022-02-28,264,264,233,31,4769,4769,4198,571,13,6,6,10,933,933,927,927
Inyo,11,2022-02-28,10,10,9,1,379,379,341,38,0,0,0,0,56,56,56,56
Kern,11,2022-02-28,792,792,713,79,24603,24603,22150,2453,77,16,16,16,2305,2305,2289,2289
Kings,11,2022-02-28,246,246,216,30,6079,6079,5356,723,19,7,7,3,440,440,433,433
Lake,11,2022-02-28,110,110,95,15,1956,1956,1695,261,0,4,4,1,136,136,132,132
Lassen,11,2022-02-28,44,44,40,4,2097,2097,1899,198,1,2,2,0,61,61,59,59
Los Angeles,11,2022-02-28,8218,8218,7920,298,1057289,1057363,1018823,38540,753,222,222,174,31333,31333,31111,31111
Madera,11,2022-02-28,189,189,164,25,4623,4623,4012,611,20,2,2,6,368,368,366,366
Marin,11,2022-02-28,160,160,140,20,7664,7664,6681,983,13,3,3,3,292,292,289,289
Mariposa,11,2022-02-28,29,29,25,4,347,347,298,49,0,1,1,0,26,26,25,25
Mendocino,11,2022-02-28,84,84,70,14,1889,1889,1571,318,11,2,2,2,121,121,119,119
Merced,11,2022-02-28,283,283,254,29,5030,5030,4509,521,25,7,7,5,801,801,794,794
Modoc,11,2022-02-28,6,6,5,1,57,57,51,6,1,0,0,0,7,7,7,7
Mono,11,2022-02-28,5,5,4,1,169,169,136,33,0,0,0,0,6,6,6,6
Monterey,11,2022-02-28,355,355,286,69,14337,14337,11561,2776,28,9,9,5,715,715,706,706
Napa,11,2022-02-28,194,194,176,18,5594,5594,5080,514,8,3,3,2,138,138,135,135
Nevada,11,2022-02-28,71,71,62,9,2016,2016,1753,263,9,0,0,1,127,127,127,127
Orange,11,2022-02-28,1689,1689,1552,137,126368,126377,116113,10264,198,42,42,35,6999,6999,6957,6957
Placer,11,2022-02-28,248,248,213,35,8421,8421,7233,1188,65,4,4,13,612,612,608,608
Plumas,11,2022-02-28,23,23,20,3,370,370,323,47,0,0,0,0,13,13,13,13
Riverside,11,2022-02-28,1686,1686,1507,179,63263,63268,56571,6697,185,37,37,35,6381,6381,6344,6344
Sacramento,11,2022-02-28,1163,1163,1032,131,45700,45704,40522,5182,163,24,24,35,2983,2983,2959,2959
San Benito,11,2022-02-28,55,55,50,5,1809,1809,1638,171,0,0,0,1,91,91,91,91
San Bernardino,11,2022-02-28,1175,1175,1073,102,61096,61101,55781,5320,157,60,60,45,7687,7687,7627,7627
San Diego,11,2022-02-28,3034,3034,2918,116,100026,100033,96229,3804,341,37,37,83,5257,5257,5220,5220
San Francisco,11,2022-02-28,835,835,662,173,40065,40067,31743,8324,74,16,16,19,845,845,829,829
San Joaquin,11,2022-02-28,657,657,576,81,26083,26083,22861,3222,58,11,11,24,2220,2220,2209,2209
San Luis Obispo,11,2022-02-28,378,378,341,37,8504,8504,7672,832,9,5,5,2,459,459,454,454
San Mateo,11,2022-02-28,597,597,549,48,41439,41442,38088,3354,33,4,4,7,695,695,691,691
Santa Barbara,11,2022-02-28,369,369,329,40,21385,21385,19063,2322,36,5,5,10,670,670,665,665
Santa Clara,11,2022-02-28,1730,1730,1660,70,103091,103097,98977,4120,191,22,22,46,2255,2255,2233,2233
Santa Cruz,11,2022-02-28,460,460,416,44,27974,27974,25344,2630,20,2,2,4,256,256,254,254
Shasta,11,2022-02-28,167,167,148,19,4926,4926,4373,553,36,11,11,8,537,537,526,526
Siskiyou,11,2022-02-28,25,25,23,2,475,475,432,43,4,2,2,1,79,79,77,77
Solano,11,2022-02-28,475,475,425,50,15304,15304,13678,1626,47,3,3,17,444,444,441,441
Sonoma,11,2022-02-28,454,454,407,47,16949,16949,15184,1765,28,3,3,5,483,483,480,480
Stanislaus,11,2022-02-28,470,470,396,74,13361,13361,11275,2086,124,11,11,21,1652,1652,1641,1641
Sutter,11,2022-02-28,106,106,95,11,2333,2333,2079,254,0,2,2,0,221,221,219,219
Tehama,11,2022-02-28,60,60,51,9,1221,1221,1039,182,7,1,1,2,200,200,199,199
Trinity,11,2022-02-28,5,5,4,1,118,118,99,19,0,0,0,0,20,20,20,20
Tulare,11,2022-02-28,462,462,389,73,11875,11875,9989,1886,67,15,15,9,1465,1465,1450,1450
Tuolumne,11,2022-02-28,69,69,60,9,1486,1486,1291,195,6,3,3,1,181,181,178,178
Ventura,11,2022-02-28,548,548,507,41,29889,29889,27649,2240,75,10,10,11,1474,1474,1464,1464
Yolo,11,2022-02-28,207,207,187,20,26252,26252,23706,2546,4,5,5,6,353,353,348,348
Yuba,11,2022-02-28,75,75,67,8,1711,1711,1537,174,12,1,1,6,117,117,116,116
Alameda,12,2022-03-07,1094,1094,1019,75,72599,72604,67606,4998,77,12,12,16,1844,1844,1832,1832
Amador,12,2022-03-07,75,75,67,8,1428,1428,1274,154,6,2,2,1,86,86,84,84
Butte,12,2022-03-07,98,98,92,6,3638,3638,3434,204,33,4,4,3,426,426,422,422
Calaveras,12,2022-03-07,25,25,23,2,1048,1048,948,100,1,1,1,0,118,118,117,117
Colusa,12,2022-03-07,9,9,8,1,355,355,326,29,6,0,0,0,21,21,21,21
Contra Costa,12,2022-03-07,627,627,558,69,30971,30971,27546,3425,47,8,8,13,1287,1287,1279,1279
Del Norte,12,2022-03-07,50,50,46,4,1779,1779,1624,155,7,0,0,1,47,47,47,47
El Dorado,12,2022-03-07,77,77,70,7,3200,3200,2899,301,5,3,3,2,210,210,207,207
Fresno,12,2022-03-07,859,859,769,90,22196,22196,19872,2324,145,18,18,27,2727,2727,2709,2709
Glenn,12,2022-03-07,19,19,17,2,395,395,359,36,2,1,1,0,53,53,52,52
Humboldt,12,2022-03-07,81,81,74,7,3045,3045,2779,266,10,3,3,4,143,143,140,140
Imperial,12,2022-03-07,122,122,110,12,4468,4468,4042,426,16,5,5,10,938,938,933,933
Inyo,12,2022-03-07,10,10,9,1,269,269,247,22,0,0,0,0,56,56,56,56
Kern,12,2022-03-07,433,433,398,35,20833,20833,19184,1649,67,12,12,16,2317,2317,2305,2305
Kings,12,2022-03-07,201,201,182,19,4986,4986,4514,472,13,4,4,2,444,444,440,440
Lake,12,2022-03-07,64,64,57,7,1760,1760,1572,188,2,2,2,1,138,138,136,136
Lassen,12,2022-03-07,96,96,89,7,1889,1889,1748,141,0,1,1,0,62,62,61,61
Los Angeles,12,2022-03-07,5536,5536,5379,157,876051,876120,851195,24925,573,171,171,133,31504,31504,31333,31333
Madera,12,2022-03-07,133,133,119,14,3916,3916,3502,414,15,1,1,2,369,369,368,368
Marin,12,2022-03-07,154,154,138,16,7559,7559,6778,781,10,1,1,2,293,293,292,292
Mariposa,12,2022-03-07,11,11,10,1,296,296,263,33,0,1,1,0,27,27,26,26
Mendocino,12,2022-03-07,65,65,56,9,1643,1643,1418,225,6,0,0,2,121,121,121,121
Merced,12,2022-03-07,173,173,159,14,4536,4536,4161,375,17,7,7,5,808,808,801,801
Modoc,12,2022-03-07,0,0,0,0,54,54,50,4,0,0,0,0,7,7,7,7
Mono,12,2022-03-07,2,2,2,0,128,128,108,20,0,0,0,1,6,6,6,6
Monterey,12,2022-03-07,244,244,206,38,11053,11053,9324,1729,19,5,5,2,720,720,715,715
Napa,12,2022-03-07,199,199,185,14,4874,4874,4518,356,2,1,1,2,139,139,138,138
Nevada,12,2022-03-07,50,50,45,5,1751,1751,1569,182,0,2,2,0,129,129,127,127
Orange,12,2022-03-07,1254,1254,1174,80,107456,107464,100559,6905,138,29,29,28,7028,7028,6999,6999
Placer,12,2022-03-07,164,164,145,19,7797,7797,6916,881,54,3,3,11,615,615,612,612
Plumas,12,2022-03-07,7,7,6,1,266,266,239,27,0,0,0,0,13,13,13,13
Riverside,12,2022-03-07,980,980,898,82,53631,53636,49122,4514,125,26,26,30,6407,6407,6381,6381
Sacramento,12,2022-03-07,773,773,704,69,40204,40208,36587,3621,124,18,18,28,3001,3001,2983,2983
San Benito,12,2022-03-07,41,41,38,3,1525,1525,1411,114,0,2,2,1,93,93,91,91
San Bernardino,12,2022-03-07,792,792,737,55,54194,54199,50461,3738,95,43,43,38,7730,7730,7687,7687
San Diego,12,2022-03-07,2337,2337,2267,70,96665,96672,93788,2884,237,31,31,57,5288,5288,5257,5257
San Francisco,12,2022-03-07,700,700,582,118,37419,37423,31065,6358,62,5,5,11,850,850,845,845
San Joaquin,12,2022-03-07,439,439,396,43,21194,21194,19116,2078,33,9,9,19,2229,2229,2220,2220
San Luis Obispo,12,2022-03-07,245,245,226,19,7300,7300,6735,565,7,5,5,1,464,464,459,459
San Mateo,12,2022-03-07,529,529,495,34,40059,40063,37475,2588,30,2,2,3,697,697,695,695
Santa Barbara,12,2022-03-07,203,203,186,17,17714,17714,16186,1528,15,4,4,8,674,674,670,670
Santa Clara,12,2022-03-07,1467,1467,1421,46,112126,112134,108564,3570,128,13,13,38,2268,2268,2255,2255
Santa Cruz,12,2022-03-07,335,335,310,25,24974,24974,23115,1859,11,0,0,7,256,256,256,256
Shasta,12,2022-03-07,140,140,127,13,4940,4940,4498,442,24,8,8,3,545,545,537,537
Siskiyou,12,2022-03-07,12,12,11,1,399,399,370,29,2,1,1,0,80,80,79,79
Solano,12,2022-03-07,351,351,321,30,14064,14064,12873,1191,46,2,2,10,446,446,444,444
Sonoma,12,2022-03-07,321,321,294,27,14921,14921,13684,1237,26,3,3,6,486,486,483,483
Stanislaus,12,2022-03-07,276,276,241,35,10858,10858,9500,1358,94,10,10,13,1662,1662,1652,1652
Sutter,12,2022-03-07,81,81,74,7,1908,1908,1742,166,0,1,1,0,222,222,221,221
Tehama,12,2022-03-07,40,40,35,5,1115,1115,980,135,5,2,2,1,202,202,200,200
Trinity,12,2022-03-07,4,4,3,1,114,114,100,14,0,0,0,0,20,20,20,20
Tulare,12,2022-03-07,302,302,263,39,10282,10282,8974,1308,37,13,13,3,1478,1478,1465,1465
Tuolumne,12,2022-03-07,48,48,43,5,1253,1253,1122,131,2,0,0,1,181,181,181,181
Ventura,12,2022-03-07,417,417,392,25,26717,26717,25137,1580,45,4,4,11,1478,1478,1474,1474
Yolo,12,2022-03-07,160,160,148,12,22153,22153,20449,1704,3,2,2,2,355,355,353,353
Yuba,12,2022-03-07,59,59,54,5,1552,1552,1425,127,13,0,0,6,117,117,117,117
Alameda,13,2022-03-14,878,878,830,48,68953,68958,65207,3751,64,9,9,6,1853,1853,1844,1844
Amador,13,2022-03-14,32,32,29,3,1439,1439,1315,124,4,0,0,0,86,86,86,86
Butte,13,2022-03-14,82,82,78,4,3592,3592,3432,160,24,1,1,0,427,427,426,426
Calaveras,13,2022-03-14,17,17,16,1,990,990,914,76,1,1,1,1,119,119,118,118
Colusa,13,2022-03-14,4,4,4,0,257,257,240,17,4,0,0,0,21,21,21,21
Contra Costa,13,2022-03-14,567,567,517,50,29141,29142,26573,2569,19,5,5,9,1292,1292,1287,1287
Del Norte,13,2022-03-14,31,31,29,2,1415,1415,1317,98,1,2,2,1,49,49,47,47
El Dorado,13,2022-03-14,44,44,41,3,2980,2980,2757,223,4,1,1,0,211,211,210,210
Fresno,13,2022-03-14,526,526,482,44,21102,21102,19339,1763,120,10,10,20,2737,2737,2727,2727
Glenn,13,2022-03-14,11,11,10,1,342,342,318,24,1,0,0,0,53,53,53,53
Humboldt,13,2022-03-14,56,56,52,4,2651,2651,2466,185,3,1,1,2,144,144,143,143
Imperial,13,2022-03-14,74,74,68,6,4541,4541,4194,347,5,2,2,7,940,940,938,938
Inyo,13,2022-03-14,6,6,6,0,165,165,154,11,0,0,0,0,56,56,56,56
Kern,13,2022-03-14,301,301,282,19,20273,20273,19003,1270,42,14,14,12,2331,2331,2317,2317
Kings,13,2022-03-14,156,156,144,12,4695,4695,4341,354,17,1,1,2,445,445,444,444
Lake,13,2022-03-14,48,48,44,4,1570,1570,1436,134,1,1,1,0,139,139,138,138
Lassen,13,2022-03-14,5,5,5,0,1515,1515,1426,89,0,0,0,0,62,62,62,62
Los Angeles,13,2022-03-14,4061,4061,3971,90,845641,845713,826857,18856,412,115,115,91,31619,31619,31504,31504
Madera,13,2022-03-14,52,52,48,4,3575,3575,3272,303,12,0,0,2,369,369,369,369
Marin,13,2022-03-14,170,170,156,14,6532,6532,5997,535,7,1,1,0,294,294,293,293
Mariposa,13,2022-03-14,9,9,8,1,222,222,202,20,0,0,0,0,27,27,27,27
Mendocino,13,2022-03-14,35,35,31,4,1434,1434,1276,158,4,2,2,1,123,123,121,121
Merced,13,2022-03-14,134,134,125,9,4167,4167,3895,272,17,2,2,4,810,810,808,808
Modoc,13,2022-03-14,3,3,3,0,52,52,49,3,1,0,0,0,7,7,7,7
Mono,13,2022-03-14,2,2,2,0,118,118,103,15,0,0,0,0,6,6,6,6
Monterey,13,2022-03-14,156,156,136,20,10115,10115,8836,1279,14,4,4,2,724,724,720,720
Napa,13,2022-03-14,119,119,112,7,4104,4104,3867,237,6,1,1,3,140,140,139,139
Nevada,13,2022-03-14,50,50,46,4,1571,1571,1441,130,2,0,0,0,129,129,129,129
Orange,13,2022-03-14,823,823,781,42,101559,101568,96413,5155,109,32,32,31,7060,7060,7028,7028
Placer,13,2022-03-14,148,148,135,13,7319,7319,6658,661,45,3,3,5,618,618,615,615
Plumas,13,2022-03-14,4,4,4,0,317,317,291,26,0,0,0,0,13,13,13,13
Riverside,13,2022-03-14,739,739,690,49,52736,52741,49224,3517,87,15,15,16,6422,6422,6407,6407
Sacramento,13,2022-03-14,588,588,546,42,35139,35143,32620,2523,122,16,16,22,3017,3017,3001,3001
San Benito,13,2022-03-14,36,36,34,2,1462,1462,1375,87,0,0,0,1,93,93,93,93
San Bernardino,13,2022-03-14,569,569,538,31,51688,51693,48873,2820,68,26,26,32,7756,7756,7730,7730
San Diego,13,2022-03-14,1843,1843,1800,43,96065,96073,93818,2255,174,17,17,47,5305,5305,5288,5288
San Francisco,13,2022-03-14,608,608,525,83,34320,34324,29603,4721,28,7,7,7,857,857,850,850
San Joaquin,13,2022-03-14,268,268,247,21,18873,18873,17388,1485,28,7,7,11,2236,2236,2229,2229
San Luis Obispo,13,2022-03-14,162,162,152,10,6664,6664,6254,410,7,7,7,1,471,471,464,464
San Mateo,13,2022-03-14,441,441,419,22,35834,35838,34004,1834,27,0,0,3,697,697,697,697
Santa Barbara,13,2022-03-14,196,196,183,13,16859,16859,15700,1159,16,7,7,2,681,681,674,674
Santa Clara,13,2022-03-14,1177,1177,1148,29,99875,99882,97384,2498,108,13,13,28,2281,2281,2268,2268
Santa Cruz,13,2022-03-14,239,239,225,14,22176,22176,20869,1307,10,3,3,3,259,259,256,256
Shasta,13,2022-03-14,97,97,90,7,4838,4838,4492,346,16,5,5,2,550,550,545,545
Siskiyou,13,2022-03-14,9,9,8,1,370,370,349,21,0,3,3,0,83,83,80,80
Solano,13,2022-03-14,221,221,206,15,12299,12299,11471,828,34,1,1,6,447,447,446,446
Sonoma,13,2022-03-14,228,228,213,15,13398,13398,12513,885,14,1,1,4,487,487,486,486
Stanislaus,13,2022-03-14,216,216,194,22,9401,9401,8454,947,82,11,11,17,1673,1673,1662,1662
Sutter,13,2022-03-14,41,41,38,3,1815,1815,1689,126,0,0,0,0,222,222,222,222
Tehama,13,2022-03-14,17,17,15,2,981,981,886,95,2,3,3,0,205,205,202,202
Trinity,13,2022-03-14,3,3,3,0,96,96,86,10,0,0,0,0,20,20,20,20
Tulare,13,2022-03-14,174,174,156,18,9301,9301,8348,953,33,0,0,6,1478,1478,1478,1478
Tuolumne,13,2022-03-14,22,22,20,2,1246,1246,1142,104,1,0,0,0,181,181,181,181
Ventura,13,2022-03-14,326,326,311,15,24591,24592,23441,1151,37,6,6,7,1484,1484,1478,1478
Yolo,13,2022-03-14,118,118,111,7,21619,21619,20301,1318,1,3,3,2,358,358,355,355
Yuba,13,2022-03-14,35,35,33,2,1417,1417,1325,92,10,0,0,3,117,117,117,117
Alameda,14,2022-03-21,722,722,691,31,65828,65833,63001,2832,58,7,7,3,1860,1860,1853,1853
Amador,14,2022-03-21,29,29,27,2,1356,1356,1263,93,2,0,0,0,86,86,86,86
Butte,14,2022-03-21,81,81,78,3,3158,3158,3048,110,17,0,0,2,427,427,427,427
Calaveras,14,2022-03-21,8,8,8,0,657,657,618,39,0,0,0,0,119,119,119,119
Colusa,14,2022-03-21,3,3,3,0,231,231,219,12,2,0,0,0,21,21,21,21
Contra Costa,14,2022-03-21,466,466,434,32,26931,26933,25041,1892,27,7,7,9,1299,1299,1292,1292
Del Norte,14,2022-03-21,19,19,18,1,1192,1192,1127,65,0,0,0,0,49,49,49,49
El Dorado,14,2022-03-21,46,46,43,3,2813,2813,2647,166,1,2,2,0,213,213,211,211
Fresno,14,2022-03-21,346,346,323,23,19318,19318,18037,1281,97,11,11,12,2748,2748,2737,2737
Glenn,14,2022-03-21,7,7,7,0,366,366,345,21,1,0,0,0,53,53,53,53
Humboldt,14,2022-03-21,31,31,29,2,2456,2456,2322,134,5,1,1,2,145,145,144,144
Imperial,14,2022-03-21,58,58,54,4,3955,3955,3717,238,4,3,3,4,943,943,940,940
Inyo,14,2022-03-21,1,1,1,0,148,148,140,8,0,0,0,0,56,56,56,56
Kern,14,2022-03-21,206,206,196,10,19490,19491,18526,965,34,4,4,9,2335,2335,2331,2331
Kings,14,2022-03-21,79,79,74,5,4411,4411,4147,264,7,1,1,1,446,446,445,445
Lake,14,2022-03-21,18,18,17,1,1365,1365,1272,93,0,0,0,0,139,139,139,139
Lassen,14,2022-03-21,10,10,10,0,1388,1388,1323,65,0,0,0,0,62,62,62,62
Los Angeles,14,2022-03-21,4131,4131,4060,71,822847,822930,808556,14374,338,76,76,66,31695,31695,31619,31619
Madera,14,2022-03-21,40,40,37,3,3392,3392,3164,228,9,1,1,1,370,370,369,369
Marin,14,2022-03-21,133,133,124,9,6231,6231,5825,406,6,1,1,0,295,295,294,294
Mariposa,14,2022-03-21,7,7,6,1,236,236,219,17,0,0,0,0,27,27,27,27
Mendocino,14,2022-03-21,28,28,26,2,1508,1508,1376,132,4,0,0,1,123,123,123,123
Merced,14,2022-03-21,87,87,82,5,3771,3771,3576,195,13,5,5,1,815,815,810,810
Modoc,14,2022-03-21,2,2,2,0,60,60,57,3,0,0,0,0,7,7,7,7
Mono,14,2022-03-21,4,4,4,0,134,134,120,14,1,0,0,0,6,6,6,6
Monterey,14,2022-03-21,152,152,137,15,10087,10087,9063,1024,22,0,0,1,724,724,724,724
Napa,14,2022-03-21,54,54,52,2,3451,3451,3294,157,6,1,1,2,141,141,140,140
Nevada,14,2022-03-21,18,18,17,1,1528,1528,1428,100,2,0,0,0,129,129,129,129
Orange,14,2022-03-21,756,756,726,30,96133,96143,92290,3853,100,12,12,25,7072,7072,7060,7060
Placer,14,2022-03-21,112,112,104,8,6475,6475,6010,465,40,2,2,6,620,620,618,618
Plumas,14,2022-03-21,2,2,2,0,228,228,213,15,0,0,0,0,13,13,13,13
Riverside,14,2022-03-21,616,616,583,33,51895,51900,49143,2757,69,13,13,18,6435,6435,6422,6422
Sacramento,14,2022-03-21,462,462,436,26,32986,32990,31119,1871,89,13,13,13,3030,3030,3017,3017
San Benito,14,2022-03-21,19,19,18,1,1385,1385,1320,65,0,1,1,0,94,94,93,93
San Bernardino,14,2022-03-21,473,473,453,20,49317,49322,47190,2132,49,20,20,31,7776,7776,7756,7756
San Diego,14,2022-03-21,1371,1371,1346,25,84591,84599,83043,1556,146,15,15,39,5320,5320,5305,5305
San Francisco,14,2022-03-21,687,687,612,75,33568,33573,29860,3713,34,3,3,3,860,860,857,857
San Joaquin,14,2022-03-21,220,220,206,14,15669,15669,14698,971,23,6,6,6,2242,2242,2236,2236
San Luis Obispo,14,2022-03-21,107,107,102,5,6416,6416,6103,313,3,5,5,0,476,476,471,471
San Mateo,14,2022-03-21,368,368,353,15,34927,34931,33527,1404,30,1,1,1,698,698,697,697
Santa Barbara,14,2022-03-21,160,160,151,9,14296,14296,13507,789,17,5,5,4,686,686,681,681
Santa Clara,14,2022-03-21,1099,1099,1078,21,95231,95240,93374,1866,101,5,5,20,2286,2286,2281,2281
Santa Cruz,14,2022-03-21,184,184,175,9,20037,20039,19104,935,8,0,0,3,259,259,259,259
Shasta,14,2022-03-21,41,41,39,2,4136,4136,3902,234,10,6,6,2,556,556,550,550
Siskiyou,14,2022-03-21,9,9,9,0,370,370,353,17,1,0,0,0,83,83,83,83
Solano,14,2022-03-21,187,187,177,10,11748,11748,11123,625,17,1,1,5,448,448,447,447
Sonoma,14,2022-03-21,231,231,219,12,12380,12380,11728,652,15,2,2,2,489,489,487,487
Stanislaus,14,2022-03-21,142,142,131,11,8428,8428,7752,676,59,12,12,8,1685,1685,1673,1673
Sutter,14,2022-03-21,34,34,32,2,1478,1478,1398,80,0,1,1,0,223,223,222,222
Tehama,14,2022-03-21,10,10,9,1,926,926,854,72,2,0,0,0,205,205,205,205
Trinity,14,2022-03-21,0,0,0,0,111,111,102,9,0,0,0,0,20,20,20,20
Tulare,14,2022-03-21,108,108,99,9,8165,8165,7499,666,27,5,5,4,1483,1483,1478,1478
Tuolumne,14,2022-03-21,19,19,18,1,1131,1131,1055,76,2,0,0,0,181,181,181,181
Ventura,14,2022-03-21,289,289,278,11,23283,23284,22424,860,30,5,5,6,1489,1489,1484,1484
Yolo,14,2022-03-21,107,107,102,5,21431,21431,20393,1038,1,0,0,1,358,358,358,358
Yuba,14,2022-03-21,42,42,40,2,1318,1318,1251,67,8,0,0,2,117,117,117,117
Alameda,15,2022-03-28,925,925,894,31,59265,59271,57272,1999,35,4,4,5,1864,1864,1860,1860
Amador,15,2022-03-28,8,8,8,0,1376,1376,1301,75,3,0,0,0,86,86,86,86
Butte,15,2022-03-28,64,64,62,2,2853,2853,2775,78,11,0,0,1,427,427,427,427
Calaveras,15,2022-03-28,15,15,14,1,580,580,553,27,0,0,0,0,119,119,119,119
Colusa,15,2022-03-28,4,4,4,0,207,207,199,8,0,0,0,0,21,21,21,21
Contra Costa,15,2022-03-28,534,534,505,29,24909,24911,23530,1381,29,1,1,6,1300,1300,1299,1299
Del Norte,15,2022-03-28,16,16,15,1,1038,1038,993,45,1,0,0,0,49,49,49,49
El Dorado,15,2022-03-28,60,60,57,3,2810,2810,2679,131,0,0,0,0,213,213,213,213
Fresno,15,2022-03-28,275,275,261,14,17888,17888,16949,939,71,5,5,18,2753,2753,2748,2748
Glenn,15,2022-03-28,8,8,8,0,333,333,318,15,0,0,0,0,53,53,53,53
Humboldt,15,2022-03-28,27,27,26,1,2608,2608,2495,113,4,0,0,3,145,145,145,145
Imperial,15,2022-03-28,63,63,60,3,3532,3532,3364,168,4,1,1,3,944,944,943,943
Inyo,15,2022-03-28,4,4,4,0,186,186,178,8,1,0,0,0,56,56,56,56
Kern,15,2022-03-28,144,144,138,6,18179,18180,17470,710,17,4,4,8,2339,2339,2335,2335
Kings,15,2022-03-28,57,57,54,3,4275,4275,4073,202,6,2,2,0,448,448,446,446
Lake,15,2022-03-28,10,10,9,1,1068,1068,1010,58,0,0,0,0,139,139,139,139
Lassen,15,2022-03-28,4,4,4,0,1284,1284,1236,48,0,0,0,0,62,62,62,62
Los Angeles,15,2022-03-28,4475,4475,4414,61,703830,703914,694186,9728,264,53,53,57,31748,31748,31695,31695
Madera,15,2022-03-28,24,24,23,1,3451,3451,3268,183,4,0,0,2,370,370,370,370
Marin,15,2022-03-28,180,180,171,9,6000,6000,5692,308,3,0,0,0,295,295,295,295
Mariposa,15,2022-03-28,5,5,5,0,179,179,169,10,0,1,1,0,28,28,27,27
Mendocino,15,2022-03-28,31,31,29,2,1314,1314,1223,91,0,1,1,0,124,124,123,123
Merced,15,2022-03-28,64,64,61,3,3359,3359,3223,136,5,1,1,3,816,816,815,815
Modoc,15,2022-03-28,3,3,3,0,45,45,43,2,0,0,0,0,7,7,7,7
Mono,15,2022-03-28,1,1,1,0,134,134,123,11,0,0,0,0,6,6,6,6
Monterey,15,2022-03-28,148,148,136,12,8782,8782,8069,713,14,1,1,0,725,725,724,724
Napa,15,2022-03-28,68,68,66,2,3329,3329,3210,119,1,2,2,1,143,143,141,141
Nevada,15,2022-03-28,27,27,26,1,1431,1431,1357,74,1,1,1,0,130,130,129,129
Orange,15,2022-03-28,809,809,784,25,90210,90220,87384,2836,81,12,12,17,7084,7084,7072,7072
Placer,15,2022-03-28,108,108,102,6,6223,6223,5871,352,26,4,4,6,624,624,620,620
Plumas,15,2022-03-28,3,3,3,0,267,267,253,14,0,0,0,0,13,13,13,13
Riverside,15,2022-03-28,522,522,500,22,43927,43932,42101,1831,47,7,7,10,6442,6442,6435,6435
Sacramento,15,2022-03-28,455,455,435,20,32472,32477,31027,1450,68,6,6,19,3036,3036,3030,3030
San Benito,15,2022-03-28,14,14,13,1,1365,1365,1315,50,0,0,0,0,94,94,94,94
San Bernardino,15,2022-03-28,545,545,527,18,41309,41314,39917,1397,40,18,18,24,7794,7794,7776,7776
San Diego,15,2022-03-28,1327,1327,1308,19,72132,72141,71106,1035,114,9,9,26,5329,5329,5320,5320
San Francisco,15,2022-03-28,844,844,770,74,32805,32810,29915,2895,23,5,5,5,865,865,860,860
San Joaquin,15,2022-03-28,189,189,180,9,17487,17488,16634,854,20,4,4,4,2246,2246,2242,2242
San Luis Obispo,15,2022-03-28,96,96,92,4,5701,5701,5484,217,5,1,1,1,477,477,476,476
San Mateo,15,2022-03-28,582,582,564,18,33959,33964,32889,1075,26,3,3,3,701,701,698,698
Santa Barbara,15,2022-03-28,135,135,129,6,10222,10222,9791,431,15,1,1,4,687,687,686,686
Santa Clara,15,2022-03-28,1276,1276,1257,19,95192,95204,93752,1452,88,10,10,18,2296,2296,2286,2286
Santa Cruz,15,2022-03-28,145,145,140,5,19692,19693,18976,717,3,0,0,2,259,259,259,259
Shasta,15,2022-03-28,34,34,32,2,3879,3879,3706,173,7,2,2,3,558,558,556,556
Siskiyou,15,2022-03-28,5,5,5,0,292,292,282,10,0,0,0,0,83,83,83,83
Solano,15,2022-03-28,169,169,162,7,10930,10930,10474,456,18,0,0,6,448,448,448,448
Sonoma,15,2022-03-28,260,260,250,10,8553,8553,8206,347,13,0,0,1,489,489,489,489
Stanislaus,15,2022-03-28,119,119,111,8,8184,8184,7665,519,28,2,2,3,1687,1687,1685,1685
Sutter,15,2022-03-28,25,25,24,1,1490,1490,1426,64,0,1,1,0,224,224,223,223
Tehama,15,2022-03-28,13,13,12,1,798,798,749,49,3,1,1,0,206,206,205,205
Trinity,15,2022-03-28,0,0,0,0,79,79,74,5,0,0,0,0,20,20,20,20
Tulare,15,2022-03-28,81,81,76,5,7838,7838,7331,507,20,6,6,1,1489,1489,1483,1483
Tuolumne,15,2022-03-28,7,7,7,0,1083,1083,1026,57,3,1,1,0,182,182,181,181
Ventura,15,2022-03-28,335,335,325,10,21204,21205,20591,614,23,6,6,3,1495,1495,1489,1489
Yolo,15,2022-03-28,103,103,99,4,20513,20514,19751,763,3,2,2,0,360,360,358,358
Yuba,15,2022-03-28,26,26,25,1,1214,1214,1165,49,2,2,2,1,119,119,117,117
Alameda,16,2022-04-04,1055,1055,1028,27,56225,56230,54736,1494,40,3,3,3,1867,1867,1864,1864
Amador,16,2022-04-04,2,2,2,0,1107,1107,1060,47,1,0,0,0,86,86,86,86
Butte,16,2022-04-04,44,44,43,1,2582,2582,2526,56,8,2,2,1,429,429,427,427
Calaveras,16,2022-04-04,8,8,8,0,589,589,567,22,0,0,0,0,119,119,119,119
Colusa,16,2022-04-04,2,2,2,0,202,202,196,6,0,0,0,0,21,21,21,21
Contra Costa,16,2022-04-04,545,545,521,24,23560,23564,22528,1036,13,1,1,4,1301,1301,1300,1300
Del Norte,16,2022-04-04,8,8,8,0,1118,1118,1080,38,0,0,0,1,49,49,49,49
El Dorado,16,2022-04-04,50,50,48,2,2717,2717,2617,100,0,1,1,1,214,214,213,213
Fresno,16,2022-04-04,188,188,180,8,16783,16783,16090,693,62,4,4,12,2757,2757,2753,2753
Glenn,16,2022-04-04,3,3,3,0,287,287,277,10,0,0,0,0,53,53,53,53
Humboldt,16,2022-04-04,23,23,22,1,2385,2385,2303,82,5,0,0,2,145,145,145,145
Imperial,16,2022-04-04,39,39,37,2,3441,3441,3312,129,3,0,0,2,944,944,944,944
Inyo,16,2022-04-04,9,9,9,0,182,182,176,6,0,0,0,0,56,56,56,56
Kern,16,2022-04-04,152,152,147,5,16751,16752,16237,515,16,2,2,7,2341,2341,2339,2339
Kings,16,2022-04-04,47,47,45,2,4178,4178,4022,156,2,0,0,1,448,448,448,448
Lake,16,2022-04-04,14,14,13,1,973,973,931,42,0,0,0,0,139,139,139,139
Lassen,16,2022-04-04,5,5,5,0,1284,1284,1247,37,0,0,0,0,62,62,62,62
Los Angeles,16,2022-04-04,5461,5461,5404,57,803352,803457,794848,8609,255,47,47,42,31795,31795,31748,31748
Madera,16,2022-04-04,27,27,26,1,3190,3190,3057,133,3,0,0,1,370,370,370,370
Marin,16,2022-04-04,167,167,160,7,6347,6347,6089,258,3,0,0,1,295,295,295,295
Mariposa,16,2022-04-04,7,7,7,0,235,235,225,10,0,0,0,0,28,28,28,28
Mendocino,16,2022-04-04,25,25,24,1,1196,1196,1130,66,2,0,0,0,124,124,124,124
Merced,16,2022-04-04,58,58,56,2,3350,3350,3243,107,2,2,2,0,818,818,816,816
Modoc,16,2022-04-04,4,4,4,0,43,43,42,1,0,0,0,0,7,7,7,7
Mono,16,2022-04-04,1,1,1,0,142,142,133,9,0,0,0,0,6,6,6,6
Monterey,16,2022-04-04,128,128,120,8,7491,7491,7011,480,8,3,3,0,728,728,725,725
Napa,16,2022-04-04,75,75,73,2,3146,3146,3058,88,1,0,0,1,143,143,143,143
Nevada,16,2022-04-04,30,30,29,1,1447,1447,1388,59,1,1,1,0,131,131,130,130
Orange,16,2022-04-04,989,989,965,24,81527,81536,79504,2032,56,17,17,14,7101,7101,7084,7084
Placer,16,2022-04-04,129,129,123,6,6693,6693,6394,299,19,1,1,5,625,625,624,624
Plumas,16,2022-04-04,4,4,4,0,235,235,225,10,0,0,0,0,13,13,13,13
Riverside,16,2022-04-04,692,692,670,22,38907,38912,37639,1273,36,5,5,8,6447,6447,6442,6442
Sacramento,16,2022-04-04,431,431,416,15,32904,32909,31753,1156,50,8,8,11,3044,3044,3036,3036
San Benito,16,2022-04-04,13,13,13,0,1187,1187,1153,34,0,0,0,0,94,94,94,94
San Bernardino,16,2022-04-04,613,613,597,16,42056,42061,40943,1118,32,11,11,13,7805,7805,7794,7794
San Diego,16,2022-04-04,1544,1544,1527,17,66686,66694,65950,744,88,7,7,29,5336,5336,5329,5329
San Francisco,16,2022-04-04,1001,1001,932,69,28769,28774,26764,2010,20,1,1,3,866,866,865,865
San Joaquin,16,2022-04-04,227,227,218,9,15696,15697,15093,604,9,2,2,8,2248,2248,2246,2246
San Luis Obispo,16,2022-04-04,99,99,96,3,5382,5382,5220,162,2,1,1,1,478,478,477,477
San Mateo,16,2022-04-04,724,724,706,18,29370,29374,28648,726,14,2,2,1,703,703,701,701
Santa Barbara,16,2022-04-04,187,187,181,6,15277,15277,14760,517,7,2,2,1,689,689,687,687
Santa Clara,16,2022-04-04,1492,1492,1474,18,88302,88314,87255,1059,89,2,2,18,2298,2298,2296,2296
Santa Cruz,16,2022-04-04,210,210,204,6,16701,16703,16213,490,4,0,0,2,259,259,259,259
Shasta,16,2022-04-04,29,29,28,1,3320,3320,3203,117,4,1,1,2,559,559,558,558
Siskiyou,16,2022-04-04,2,2,2,0,294,294,286,8,0,0,0,0,83,83,83,83
Solano,16,2022-04-04,173,173,167,6,10220,10220,9884,336,21,1,1,4,449,449,448,448
Sonoma,16,2022-04-04,330,330,320,10,10654,10654,10310,344,9,1,1,1,490,490,489,489
Stanislaus,16,2022-04-04,113,113,107,6,7962,7962,7564,398,21,3,3,5,1690,1690,1687,1687
Sutter,16,2022-04-04,24,24,23,1,1324,1324,1280,44,0,0,0,0,224,224,224,224
Tehama,16,2022-04-04,6,6,6,0,765,765,728,37,0,1,1,0,207,207,206,206
Trinity,16,2022-04-04,1,1,1,0,87,87,83,4,0,0,0,0,20,20,20,20
Tulare,16,2022-04-04,48,48,46,2,7740,7740,7344,396,13,3,3,0,1492,1492,1489,1489
Tuolumne,16,2022-04-04,10,10,10,0,1034,1034,991,43,1,1,1,0,183,183,182,182
Ventura,16,2022-04-04,298,298,291,7,20329,20331,19867,464,19,5,5,5,1500,1500,1495,1495
Yolo,16,2022-04-04,104,104,101,3,26258,26263,25476,787,0,0,0,0,360,360,360,360
Yuba,16,2022-04-04,11,11,11,0,1071,1071,1037,34,4,0,0,1,119,119,119,119
Alameda,17,2022-04-11,1493,1493,1463,30,49842,49848,48819,1029,51,6,6,2,1873,1873,1867,1867
Amador,17,2022-04-11,9,9,9,0,1068,1068,1032,36,1,0,0,0,86,86,86,86
Butte,17,2022-04-11,33,33,32,1,2262,2262,2224,38,3,0,0,1,429,429,429,429
Calaveras,17,2022-04-11,14,14,14,0,649,649,630,19,0,0,0,0,119,119,119,119
Colusa,17,2022-04-11,6,6,6,0,203,203,198,5,0,0,0,0,21,21,21,21
Contra Costa,17,2022-04-11,714,714,690,24,20842,20843,20133,710,15,1,1,5,1302,1302,1301,1301
Del Norte,17,2022-04-11,9,9,9,0,1012,1012,985,27,0,0,0,0,49,49,49,49
El Dorado,17,2022-04-11,48,48,47,1,2508,2508,2436,72,1,0,0,0,214,214,214,214
Fresno,17,2022-04-11,196,196,190,6,15712,15712,15200,512,54,3,3,6,2760,2760,2757,2757
Glenn,17,2022-04-11,2,2,2,0,258,258,251,7,0,0,0,0,53,53,53,53
Humboldt,17,2022-04-11,46,46,45,1,2347,2347,2284,63,5,1,1,2,146,146,145,145
Imperial,17,2022-04-11,28,28,27,1,3442,3442,3341,101,2,1,1,1,945,945,944,944
Inyo,17,2022-04-11,4,4,4,0,188,188,183,5,0,0,0,0,56,56,56,56
Kern,17,2022-04-11,135,135,132,3,16366,16366,15968,398,20,2,2,6,2343,2343,2341,2341
Kings,17,2022-04-11,31,31,30,1,4161,4161,4039,122,3,0,0,0,448,448,448,448
Lake,17,2022-04-11,22,22,21,1,869,869,840,29,0,0,0,0,139,139,139,139
Lassen,17,2022-04-11,1,1,1,0,1292,1292,1263,29,1,0,0,0,62,62,62,62
Los Angeles,17,2022-04-11,6737,6737,6682,55,675660,675761,670054,5707,234,46,46,36,31841,31841,31795,31795
Madera,17,2022-04-11,29,29,28,1,3076,3076,2975,101,4,0,0,2,370,370,370,370
Marin,17,2022-04-11,214,214,207,7,5555,5555,5379,176,6,0,0,1,295,295,295,295
Mariposa,17,2022-04-11,7,7,7,0,246,246,237,9,0,0,0,0,28,28,28,28
Mendocino,17,2022-04-11,32,32,31,1,1158,1158,1108,50,0,0,0,0,124,124,124,124
Merced,17,2022-04-11,68,68,66,2,3222,3222,3141,81,6,2,2,0,820,820,818,818
Modoc,17,2022-04-11,0,0,0,0,40,40,39,1,0,0,0,0,7,7,7,7
Mono,17,2022-04-11,9,9,9,0,170,170,161,9,0,0,0,0,6,6,6,6
Monterey,17,2022-04-11,109,109,103,6,6890,6890,6540,350,9,2,2,0,730,730,728,728
Napa,17,2022-04-11,120,120,117,3,2802,2802,2740,62,1,0,0,0,143,143,143,143
Nevada,17,2022-04-11,45,45,44,1,1431,1431,1385,46,2,0,0,0,131,131,131,131
Orange,17,2022-04-11,1165,1165,1143,22,62009,62018,60839,1179,70,9,9,16,7110,7110,7101,7101
Placer,17,2022-04-11,126,126,122,4,5632,5632,5433,199,18,2,2,2,627,627,625,625
Plumas,17,2022-04-11,7,7,7,0,247,247,239,8,0,0,0,0,13,13,13,13
Riverside,17,2022-04-11,728,728,710,18,37778,37783,36813,970,35,5,5,9,6452,6452,6447,6447
Sacramento,17,2022-04-11,508,508,494,14,30138,30143,29310,833,47,11,11,5,3055,3055,3044,3044
San Benito,17,2022-04-11,16,16,16,0,1182,1182,1155,27,0,0,0,0,94,94,94,94
San Bernardino,17,2022-04-11,916,916,897,19,42013,42018,41142,876,33,5,5,7,7810,7810,7805,7805
San Diego,17,2022-04-11,1833,1833,1817,16,74105,74118,73470,648,91,4,4,22,5340,5340,5336,5336
San Francisco,17,2022-04-11,1182,1182,1117,65,29898,29903,28247,1656,19,6,6,4,872,872,866,866
San Joaquin,17,2022-04-11,221,221,214,7,15222,15223,14762,461,10,0,0,1,2248,2248,2248,2248
San Luis Obispo,17,2022-04-11,120,120,117,3,4908,4908,4792,116,2,1,1,0,479,479,478,478
San Mateo,17,2022-04-11,858,858,842,16,30382,30387,29796,591,8,2,2,1,705,705,703,703
Santa Barbara,17,2022-04-11,303,303,295,8,15120,15120,14718,402,6,2,2,1,691,691,689,689
Santa Clara,17,2022-04-11,1662,1662,1647,15,81519,81532,80772,760,61,4,4,13,2302,2302,2298,2298
Santa Cruz,17,2022-04-11,328,328,321,7,10999,11000,10759,241,7,1,1,0,260,260,259,259
Shasta,17,2022-04-11,18,18,18,0,3123,3123,3036,87,2,1,1,1,560,560,559,559
Siskiyou,17,2022-04-11,1,1,1,0,340,340,332,8,0,0,0,0,83,83,83,83
Solano,17,2022-04-11,249,249,243,6,9417,9417,9174,243,16,0,0,1,449,449,449,449
Sonoma,17,2022-04-11,416,416,406,10,10686,10686,10416,270,8,1,1,0,491,491,490,490
Stanislaus,17,2022-04-11,124,124,119,5,7639,7639,7338,301,22,1,1,1,1691,1691,1690,1690
Sutter,17,2022-04-11,20,20,19,1,1237,1237,1204,33,0,1,1,0,225,225,224,224
Tehama,17,2022-04-11,9,9,9,0,753,753,724,29,1,0,0,0,207,207,207,207
Trinity,17,2022-04-11,0,0,0,0,77,77,74,3,0,0,0,0,20,20,20,20
Tulare,17,2022-04-11,58,58,56,2,7843,7843,7526,317,11,3,3,0,1495,1495,1492,1492
Tuolumne,17,2022-04-11,22,22,21,1,1062,1062,1027,35,1,0,0,0,183,183,183,183
Ventura,17,2022-04-11,323,323,317,6,17587,17588,17275,313,16,2,2,2,1502,1502,1500,1500
Yolo,17,2022-04-11,130,130,127,3,18075,18077,17657,420,1,0,0,0,360,360,360,360
Yuba,17,2022-04-11,15,15,15,0,1019,1019,994,25,2,0,0,0,119,119,119,119
Alameda,18,2022-04-18,1781,1781,1752,29,54180,54192,53310,882,42,4,4,4,1877,1877,1873,1873
Amador,18,2022-04-18,12,12,12,0,1194,1194,1162,32,2,0,0,0,86,86,86,86
Butte,18,2022-04-18,47,47,46,1,2267,2267,2237,30,5,2,2,0,431,431,429,429
Calaveras,18,2022-04-18,16,16,16,0,579,579,566,13,0,1,1,0,120,120,119,119
Colusa,18,2022-04-18,3,3,3,0,157,157,154,3,0,0,0,0,21,21,21,21
Contra Costa,18,2022-04-18,1050,1050,1022,28,24755,24760,24091,669,26,1,1,5,1303,1303,1302,1302
Del Norte,18,2022-04-18,13,13,13,0,1010,1010,989,21,0,0,0,0,49,49,49,49
El Dorado,18,2022-04-18,66,66,65,1,2455,2455,2400,55,0,0,0,0,214,214,214,214
Fresno,18,2022-04-18,247,247,241,6,13859,13860,13509,351,42,4,4,5,2764,2764,2760,2760
Glenn,18,2022-04-18,4,4,4,0,278,278,272,6,0,0,0,0,53,53,53,53
Humboldt,18,2022-04-18,107,107,105,2,2052,2052,2009,43,4,1,1,2,147,147,146,146
Imperial,18,2022-04-18,49,49,48,1,3211,3211,3137,74,2,0,0,1,945,945,945,945
Inyo,18,2022-04-18,2,2,2,0,164,164,161,3,0,0,0,0,56,56,56,56
Kern,18,2022-04-18,150,150,147,3,13634,13636,13379,257,9,1,1,5,2344,2344,2343,2343
Kings,18,2022-04-18,44,44,43,1,3580,3580,3498,82,3,1,1,1,449,449,448,448
Lake,18,2022-04-18,16,16,16,0,782,782,762,20,2,1,1,1,140,140,139,139
Lassen,18,2022-04-18,1,1,1,0,1340,1340,1316,24,0,0,0,0,62,62,62,62
Los Angeles,18,2022-04-18,8318,8318,8265,53,469199,469295,466323,2972,200,35,35,26,31876,31876,31841,31841
Madera,18,2022-04-18,23,23,22,1,2521,2521,2456,65,2,0,0,2,370,370,370,370
Marin,18,2022-04-18,322,322,314,8,5992,5992,5842,150,6,0,0,0,295,295,295,295
Mariposa,18,2022-04-18,18,18,18,0,248,248,241,7,0,0,0,0,28,28,28,28
Mendocino,18,2022-04-18,53,53,51,2,1285,1285,1241,44,0,1,1,0,125,125,124,124
Merced,18,2022-04-18,65,65,64,1,3047,3047,2987,60,3,2,2,0,822,822,820,820
Modoc,18,2022-04-18,1,1,1,0,40,40,39,1,0,0,0,0,7,7,7,7
Mono,18,2022-04-18,9,9,9,0,122,122,117,5,0,0,0,0,6,6,6,6
Monterey,18,2022-04-18,157,157,151,6,6522,6522,6263,259,2,1,1,0,731,731,730,730
Napa,18,2022-04-18,164,164,161,3,2860,2860,2811,49,1,0,0,0,143,143,143,143
Nevada,18,2022-04-18,41,41,40,1,1260,1260,1228,32,1,0,0,0,131,131,131,131
Orange,18,2022-04-18,1446,1446,1425,21,79769,79786,78578,1208,50,6,6,10,7116,7116,7110,7110
Placer,18,2022-04-18,161,161,157,4,4800,4800,4668,132,30,0,0,3,627,627,627,627
Plumas,18,2022-04-18,6,6,6,0,225,225,219,6,0,0,0,0,13,13,13,13
Riverside,18,2022-04-18,938,938,919,19,36721,36727,35987,740,36,7,7,7,6459,6459,6452,6452
Sacramento,18,2022-04-18,716,716,701,15,27855,27860,27259,601,47,9,9,8,3064,3064,3055,3055
San Benito,18,2022-04-18,24,24,24,0,1170,1170,1149,21,0,0,0,0,94,94,94,94
San Bernardino,18,2022-04-18,1058,1058,1041,17,40086,40092,39438,654,35,7,7,8,7817,7817,7810,7810
San Diego,18,2022-04-18,2047,2047,2033,14,67090,67104,66646,458,78,9,9,17,5349,5349,5340,5340
San Francisco,18,2022-04-18,1440,1440,1378,62,30566,30571,29234,1337,27,2,2,2,874,874,872,872
San Joaquin,18,2022-04-18,248,248,242,6,14729,14731,14381,350,8,1,1,4,2249,2249,2248,2248
San Luis Obispo,18,2022-04-18,180,180,177,3,4959,4959,4868,91,2,2,2,0,481,481,479,479
San Mateo,18,2022-04-18,1153,1153,1136,17,30636,30642,30178,464,15,2,2,2,707,707,705,705
Santa Barbara,18,2022-04-18,299,299,293,6,14686,14690,14384,306,8,0,0,0,691,691,691,691
Santa Clara,18,2022-04-18,2238,2238,2222,16,71272,71286,70765,521,67,4,4,16,2306,2306,2302,2302
Santa Cruz,18,2022-04-18,438,438,430,8,12234,12236,12021,215,3,0,0,1,260,260,260,260
Shasta,18,2022-04-18,32,32,31,1,2849,2849,2787,62,2,1,1,2,561,561,560,560
Siskiyou,18,2022-04-18,8,8,8,0,318,318,312,6,0,0,0,0,83,83,83,83
Solano,18,2022-04-18,254,254,249,5,9327,9327,9138,189,6,1,1,1,450,450,449,449
Sonoma,18,2022-04-18,502,502,492,10,11184,11185,10962,223,16,1,1,4,492,492,491,491
Stanislaus,18,2022-04-18,162,162,157,5,7666,7666,7428,238,15,0,0,3,1691,1691,1691,1691
Sutter,18,2022-04-18,24,24,24,0,1173,1173,1149,24,0,0,0,0,225,225,225,225
Tehama,18,2022-04-18,7,7,7,0,685,685,664,21,1,0,0,0,207,207,207,207
Trinity,18,2022-04-18,1,1,1,0,72,72,70,2,0,0,0,0,20,20,20,20
Tulare,18,2022-04-18,78,78,76,2,6658,6658,6448,210,13,0,0,0,1495,1495,1495,1495
Tuolumne,18,2022-04-18,26,26,25,1,1025,1025,999,26,1,0,0,0,183,183,183,183
Ventura,18,2022-04-18,367,367,362,5,16412,16416,16189,227,8,3,3,0,1505,1505,1502,1502
Yolo,18,2022-04-18,217,217,213,4,17914,17919,17590,329,2,1,1,0,361,361,360,360
Yuba,18,2022-04-18,28,28,27,1,996,996,977,19,1,0,0,1,119,119,119,119
Alameda,19,2022-04-25,2539,2539,2507,32,60891,60905,60138,767,44,6,6,4,1883,1883,1877,1877
Amador,19,2022-04-25,26,26,25,1,1316,1316,1289,27,0,0,0,0,86,86,86,86
Butte,19,2022-04-25,66,66,65,1,2596,2596,2569,27,5,1,1,1,432,432,431,431
Calaveras,19,2022-04-25,34,34,33,1,688,688,676,12,0,0,0,0,120,120,120,120
Colusa,19,2022-04-25,3,3,3,0,199,199,196,3,0,0,0,0,21,21,21,21
Contra Costa,19,2022-04-25,1510,1510,1478,32,27265,27271,26697,574,25,3,3,3,1306,1306,1303,1303
Del Norte,19,2022-04-25,25,25,25,0,1104,1104,1086,18,0,0,0,0,49,49,49,49
El Dorado,19,2022-04-25,103,103,101,2,2648,2648,2601,47,1,0,0,0,214,214,214,214
Fresno,19,2022-04-25,336,336,329,7,15799,15804,15489,315,34,3,3,2,2767,2767,2764,2764
Glenn,19,2022-04-25,4,4,4,0,287,287,282,5,0,0,0,0,53,53,53,53
Humboldt,19,2022-04-25,168,168,165,3,2853,2853,2806,47,2,0,0,2,147,147,147,147
Imperial,19,2022-04-25,65,65,64,1,3508,3508,3445,63,4,0,0,1,945,945,945,945
Inyo,19,2022-04-25,7,7,7,0,194,194,191,3,0,0,0,0,56,56,56,56
Kern,19,2022-04-25,251,251,247,4,18299,18304,18033,271,14,2,2,4,2346,2346,2344,2344
Kings,19,2022-04-25,54,54,53,1,4515,4515,4434,81,3,0,0,1,449,449,449,449
Lake,19,2022-04-25,21,21,21,0,887,887,869,18,0,0,0,0,140,140,140,140
Lassen,19,2022-04-25,1,1,1,0,1556,1556,1534,22,0,0,0,0,62,62,62,62
Los Angeles,19,2022-04-25,11370,11371,11314,57,884899,885117,880631,4486,207,29,29,25,31905,31905,31876,31876
Madera,19,2022-04-25,44,44,43,1,2916,2916,2857,59,2,0,0,0,370,370,370,370
Marin,19,2022-04-25,329,329,323,6,6440,6440,6314,126,7,0,0,0,295,295,295,295
Mariposa,19,2022-04-25,9,9,9,0,205,205,201,4,0,0,0,0,28,28,28,28
Mendocino,19,2022-04-25,55,55,54,1,1254,1254,1220,34,0,1,1,0,126,126,125,125
Merced,19,2022-04-25,99,99,98,1,3030,3030,2984,46,5,0,0,0,822,822,822,822
Modoc,19,2022-04-25,1,1,1,0,41,41,40,1,0,0,0,0,7,7,7,7
Mono,19,2022-04-25,4,4,4,0,94,94,91,3,0,0,0,0,6,6,6,6
Monterey,19,2022-04-25,323,323,313,10,8008,8009,7759,250,5,1,1,0,732,732,731,731
Napa,19,2022-04-25,199,199,196,3,3376,3376,3330,46,2,0,0,0,143,143,143,143
Nevada,19,2022-04-25,52,52,51,1,1399,1399,1371,28,1,0,0,1,131,131,131,131
Orange,19,2022-04-25,1969,1969,1946,23,86618,86641,85618,1023,53,7,7,13,7123,7123,7116,7116
Placer,19,2022-04-25,239,239,234,5,6091,6091,5959,132,18,0,0,4,627,627,627,627
Plumas,19,2022-04-25,2,2,2,0,228,228,223,5,0,0,0,0,13,13,13,13
Riverside,19,2022-04-25,1304,1304,1284,20,40534,40545,39906,639,33,4,4,5,6463,6463,6459,6459
Sacramento,19,2022-04-25,1025,1025,1008,17,31869,31875,31336,539,44,4,4,4,3068,3068,3064,3064
San Benito,19,2022-04-25,34,34,34,0,1118,1118,1102,16,0,0,0,0,94,94,94,94
San Bernardino,19,2022-04-25,1293,1293,1277,16,42977,42990,42442,548,21,10,10,7,7827,7827,7817,7817
San Diego,19,2022-04-25,3013,3013,2997,16,74325,74344,73948,396,86,5,5,10,5354,5354,5349,5349
San Francisco,19,2022-04-25,2001,2001,1933,68,32532,32540,31423,1117,23,1,1,3,875,875,874,874
San Joaquin,19,2022-04-25,387,387,380,7,15463,15467,15178,289,12,0,0,1,2249,2249,2249,2249
San Luis Obispo,19,2022-04-25,209,209,206,3,5036,5036,4963,73,6,0,0,0,481,481,481,481
San Mateo,19,2022-04-25,1538,1538,1520,18,32870,32878,32490,388,14,1,1,3,708,708,707,707
Santa Barbara,19,2022-04-25,371,371,365,6,15227,15232,14985,247,7,2,2,1,693,693,691,691
Santa Clara,19,2022-04-25,3142,3142,3124,18,77133,77153,76719,434,73,4,4,9,2310,2310,2306,2306
Santa Cruz,19,2022-04-25,474,474,468,6,20467,20471,20189,282,4,1,1,0,261,261,260,260
Shasta,19,2022-04-25,48,48,47,1,3317,3317,3261,56,3,0,0,1,561,561,561,561
Siskiyou,19,2022-04-25,7,7,7,0,322,322,318,4,0,0,0,0,83,83,83,83
Solano,19,2022-04-25,479,479,471,8,10651,10652,10484,168,11,0,0,2,450,450,450,450
Sonoma,19,2022-04-25,674,674,664,10,12065,12067,11879,188,19,0,0,2,492,492,492,492
Stanislaus,19,2022-04-25,241,241,235,6,7899,7900,7708,192,25,4,4,0,1695,1695,1691,1691
Sutter,19,2022-04-25,39,39,38,1,1399,1399,1376,23,0,1,1,0,226,226,225,225
Tehama,19,2022-04-25,17,17,17,0,711,711,694,17,1,0,0,0,207,207,207,207
Trinity,19,2022-04-25,1,1,1,0,72,72,70,2,0,0,0,0,20,20,20,20
Tulare,19,2022-04-25,93,93,91,2,6912,6912,6740,172,11,1,1,0,1496,1496,1495,1495
Tuolumne,19,2022-04-25,43,43,42,1,1124,1124,1101,23,2,0,0,0,183,183,183,183
Ventura,19,2022-04-25,604,604,597,7,18901,18906,18701,205,10,1,1,3,1506,1506,1505,1505
Yolo,19,2022-04-25,272,272,268,4,19381,19386,19108,278,1,0,0,0,361,361,361,361
Yuba,19,2022-04-25,31,31,31,0,1106,1106,1089,17,0,0,0,0,119,119,119,119
Alameda,20,2022-05-02,3378,3378,3345,33,68021,68043,67366,677,42,2,2,5,1885,1885,1883,1883
Amador,20,2022-05-02,19,19,19,0,1335,1335,1313,22,0,0,0,0,86,86,86,86
Butte,20,2022-05-02,91,91,90,1,2385,2385,2366,19,4,2,2,0,434,434,432,432
Calaveras,20,2022-05-02,23,23,23,0,727,727,717,10,0,0,0,0,120,120,120,120
Colusa,20,2022-05-02,2,2,2,0,203,203,201,2,0,0,0,0,21,21,21,21
Contra Costa,20,2022-05-02,1878,1878,1847,31,29266,29275,28792,483,40,2,2,5,1308,1308,1306,1306
Del Norte,20,2022-05-02,42,42,41,1,1202,1202,1187,15,1,0,0,0,49,49,49,49
El Dorado,20,2022-05-02,140,140,138,2,2756,2756,2718,38,1,1,1,0,215,215,214,214
Fresno,20,2022-05-02,503,503,495,8,16611,16616,16357,259,42,3,3,4,2770,2770,2767,2767
Glenn,20,2022-05-02,4,4,4,0,252,252,249,3,0,0,0,0,53,53,53,53
Humboldt,20,2022-05-02,269,269,266,3,2941,2941,2903,38,6,0,0,2,147,147,147,147
Imperial,20,2022-05-02,123,123,121,2,3638,3638,3587,51,1,0,0,1,945,945,945,945
Inyo,20,2022-05-02,2,2,2,0,179,179,177,2,0,0,0,0,56,56,56,56
Kern,20,2022-05-02,294,294,291,3,17931,17936,17729,207,10,0,0,5,2346,2346,2346,2346
Kings,20,2022-05-02,59,59,58,1,4847,4847,4779,68,3,0,0,1,449,449,449,449
Lake,20,2022-05-02,29,29,29,0,1003,1003,987,16,1,0,0,0,140,140,140,140
Lassen,20,2022-05-02,8,8,8,0,1608,1608,1590,18,0,0,0,0,62,62,62,62
Los Angeles,20,2022-05-02,14811,14816,14758,58,917594,917886,914243,3643,214,23,23,22,31928,31928,31905,31905
Madera,20,2022-05-02,76,76,75,1,3307,3307,3255,52,5,0,0,0,370,370,370,370
Marin,20,2022-05-02,427,427,421,6,6544,6545,6445,100,10,0,0,0,295,295,295,295
Mariposa,20,2022-05-02,7,7,7,0,244,244,240,4,0,0,0,0,28,28,28,28
Mendocino,20,2022-05-02,60,60,59,1,1222,1222,1196,26,0,0,0,0,126,126,126,126
Merced,20,2022-05-02,131,131,129,2,3284,3284,3245,39,8,4,4,0,826,826,822,822
Modoc,20,2022-05-02,0,0,0,0,36,37,36,1,0,0,0,0,7,7,7,7
Mono,20,2022-05-02,6,6,6,0,106,106,103,3,0,0,0,0,6,6,6,6
Monterey,20,2022-05-02,356,356,347,9,8388,8389,8183,206,8,1,1,0,733,733,732,732
Napa,20,2022-05-02,228,228,226,2,3547,3547,3509,38,4,0,0,0,143,143,143,143
Nevada,20,2022-05-02,80,80,79,1,1535,1535,1511,24,2,0,0,0,131,131,131,131
Orange,20,2022-05-02,2640,2640,2616,24,87495,87523,86714,809,61,5,5,13,7128,7128,7123,7123
Placer,20,2022-05-02,306,306,301,5,6373,6374,6266,108,20,0,0,4,627,627,627,627
Plumas,20,2022-05-02,9,9,9,0,256,256,252,4,0,0,0,0,13,13,13,13
Riverside,20,2022-05-02,2050,2050,2025,25,42957,42970,42440,530,37,3,3,5,6466,6466,6463,6463
Sacramento,20,2022-05-02,1396,1396,1378,18,33656,33669,33225,444,43,5,5,9,3073,3073,3068,3068
San Benito,20,2022-05-02,50,50,49,1,1285,1285,1271,14,0,0,0,0,94,94,94,94
San Bernardino,20,2022-05-02,1490,1490,1475,15,43536,43549,43116,433,30,7,7,6,7834,7834,7827,7827
San Diego,20,2022-05-02,4122,4122,4105,17,72931,72955,72653,302,79,3,3,13,5357,5357,5354,5354
San Francisco,20,2022-05-02,2424,2424,2359,65,35539,35552,34593,959,39,3,3,13,878,878,875,875
San Joaquin,20,2022-05-02,546,546,538,8,15207,15212,14990,222,14,1,1,1,2250,2250,2249,2249
San Luis Obispo,20,2022-05-02,249,249,246,3,5109,5109,5051,58,5,2,2,0,483,483,481,481
San Mateo,20,2022-05-02,1819,1819,1802,17,35990,36002,35668,334,22,2,2,5,710,710,708,708
Santa Barbara,20,2022-05-02,440,440,435,5,15309,15314,15119,195,10,0,0,2,693,693,693,693
Santa Clara,20,2022-05-02,4357,4357,4338,19,96570,96599,96170,429,88,5,5,15,2315,2315,2310,2310
Santa Cruz,20,2022-05-02,678,678,671,7,22027,22034,21796,238,2,1,1,0,262,262,261,261
Shasta,20,2022-05-02,68,68,67,1,3451,3451,3405,46,7,0,0,1,561,561,561,561
Siskiyou,20,2022-05-02,9,9,9,0,329,329,326,3,0,0,0,0,83,83,83,83
Solano,20,2022-05-02,624,624,616,8,11785,11790,11644,146,20,0,0,2,450,450,450,450
Sonoma,20,2022-05-02,898,898,887,11,12794,12798,12643,155,16,1,1,4,493,493,492,492
Stanislaus,20,2022-05-02,269,269,264,5,8083,8085,7931,154,22,0,0,3,1695,1695,1695,1695
Sutter,20,2022-05-02,47,47,46,1,1263,1263,1247,16,0,1,1,0,227,227,226,226
Tehama,20,2022-05-02,17,17,17,0,700,700,687,13,0,0,0,0,207,207,207,207
Trinity,20,2022-05-02,1,1,1,0,84,84,82,2,0,0,0,0,20,20,20,20
Tulare,20,2022-05-02,162,162,159,3,7286,7287,7145,142,10,3,3,0,1499,1499,1496,1496
Tuolumne,20,2022-05-02,94,94,93,1,1298,1298,1278,20,5,0,0,0,183,183,183,183
Ventura,20,2022-05-02,744,744,738,6,19920,19926,19757,169,15,4,4,1,1510,1510,1506,1506
Yolo,20,2022-05-02,352,352,348,4,18791,18796,18585,211,1,1,1,0,362,362,361,361
Yuba,20,2022-05-02,46,46,45,1,1052,1052,1040,12,2,0,0,1,119,119,119,119
Alameda,21,2022-05-09,4151,4151,4119,32,71486,71517,70963,554,44,8,8,6,1893,1893,1885,1885
Amador,21,2022-05-09,25,25,25,0,1518,1518,1499,19,0,0,0,0,86,86,86,86
Butte,21,2022-05-09,115,115,114,1,2412,2412,2397,15,5,0,0,0,434,434,434,434
Calaveras,21,2022-05-09,33,33,33,0,689,689,681,8,1,0,0,0,120,120,120,120
Colusa,21,2022-05-09,3,3,3,0,215,215,213,2,0,0,0,0,21,21,21,21
Contra Costa,21,2022-05-09,2516,2516,2484,32,30524,30537,30142,395,48,4,4,12,1312,1312,1308,1308
Del Norte,21,2022-05-09,49,49,49,0,1358,1358,1344,14,0,0,0,0,49,49,49,49
El Dorado,21,2022-05-09,179,179,177,2,2889,2889,2858,31,3,0,0,1,215,215,215,215
Fresno,21,2022-05-09,746,746,737,9,17759,17766,17549,217,29,1,1,1,2771,2771,2770,2770
Glenn,21,2022-05-09,8,8,8,0,228,228,226,2,0,0,0,0,53,53,53,53
Humboldt,21,2022-05-09,273,273,270,3,3149,3149,3117,32,5,0,0,2,147,147,147,147
Imperial,21,2022-05-09,131,131,130,1,3822,3822,3780,42,0,0,0,1,945,945,945,945
Inyo,21,2022-05-09,26,26,26,0,236,236,234,2,0,0,0,0,56,56,56,56
Kern,21,2022-05-09,467,467,463,4,18698,18704,18535,169,18,2,2,2,2348,2348,2346,2346
Kings,21,2022-05-09,91,91,90,1,4936,4936,4882,54,1,0,0,1,449,449,449,449
Lake,21,2022-05-09,30,30,30,0,1029,1029,1016,13,1,0,0,0,140,140,140,140
Lassen,21,2022-05-09,7,7,7,0,1689,1689,1675,14,0,0,0,0,62,62,62,62
Los Angeles,21,2022-05-09,18427,18435,18379,56,926875,927268,924403,2865,225,29,29,27,31957,31957,31928,31928
Madera,21,2022-05-09,132,132,130,2,3725,3725,3679,46,3,0,0,0,370,370,370,370
Marin,21,2022-05-09,711,711,703,8,7781,7785,7692,93,12,0,0,0,295,295,295,295
Mariposa,21,2022-05-09,32,32,32,0,287,287,283,4,0,0,0,0,28,28,28,28
Mendocino,21,2022-05-09,92,92,91,1,1264,1264,1243,21,0,1,1,0,127,127,126,126
Merced,21,2022-05-09,198,198,196,2,3432,3432,3400,32,4,1,1,0,827,827,826,826
Modoc,21,2022-05-09,2,2,2,0,41,42,41,1,0,0,0,0,7,7,7,7
Mono,21,2022-05-09,9,9,9,0,113,113,111,2,0,0,0,0,6,6,6,6
Monterey,21,2022-05-09,440,440,432,8,9377,9382,9201,181,11,0,0,0,733,733,733,733
Napa,21,2022-05-09,233,233,231,2,3121,3121,3095,26,2,0,0,0,143,143,143,143
Nevada,21,2022-05-09,102,102,101,1,1655,1655,1635,20,5,0,0,0,131,131,131,131
Orange,21,2022-05-09,3518,3518,3493,25,91790,91830,91167,663,84,8,8,17,7136,7136,7128,7128
Placer,21,2022-05-09,537,537,530,7,6753,6754,6664,90,25,0,0,2,627,627,627,627
Plumas,21,2022-05-09,13,13,13,0,274,274,271,3,0,0,0,0,13,13,13,13
Riverside,21,2022-05-09,2402,2402,2379,23,45141,45159,44723,436,42,4,4,8,6470,6470,6466,6466
Sacramento,21,2022-05-09,2258,2258,2235,23,36131,36148,35774,374,62,4,4,10,3077,3077,3073,3073
San Benito,21,2022-05-09,74,74,73,1,1433,1433,1421,12,0,0,0,0,94,94,94,94
San Bernardino,21,2022-05-09,1938,1938,1923,15,46593,46612,46250,362,31,5,5,4,7839,7839,7834,7834
San Diego,21,2022-05-09,5222,5222,5205,17,87128,87165,86882,283,98,2,2,11,5359,5359,5357,5357
San Francisco,21,2022-05-09,3050,3050,2986,64,38188,38205,37396,809,52,6,6,9,884,884,878,878
San Joaquin,21,2022-05-09,772,772,763,9,16049,16055,15872,183,11,1,1,3,2251,2251,2250,2250
San Luis Obispo,21,2022-05-09,290,290,287,3,5221,5222,5176,46,0,0,0,0,483,483,483,483
San Mateo,21,2022-05-09,2315,2315,2299,16,37695,37711,37438,273,26,3,3,1,713,713,710,710
Santa Barbara,21,2022-05-09,638,638,632,6,15589,15595,15440,155,10,0,0,3,693,693,693,693
Santa Clara,21,2022-05-09,5624,5625,5606,19,106180,106225,105857,368,87,3,3,23,2318,2318,2315,2315
Santa Cruz,21,2022-05-09,729,729,723,6,23980,23990,23788,202,2,0,0,0,262,262,262,262
Shasta,21,2022-05-09,107,107,106,1,3301,3301,3267,34,7,0,0,0,561,561,561,561
Siskiyou,21,2022-05-09,16,16,16,0,285,285,283,2,0,0,0,0,83,83,83,83
Solano,21,2022-05-09,920,920,911,9,12318,12323,12203,120,20,0,0,1,450,450,450,450
Sonoma,21,2022-05-09,1179,1179,1168,11,13977,13982,13849,133,18,1,1,2,494,494,493,493
Stanislaus,21,2022-05-09,460,460,453,7,8942,8946,8813,133,27,0,0,2,1695,1695,1695,1695
Sutter,21,2022-05-09,61,61,60,1,1565,1565,1549,16,0,0,0,0,227,227,227,227
Tehama,21,2022-05-09,28,28,28,0,692,692,682,10,1,0,0,0,207,207,207,207
Trinity,21,2022-05-09,4,4,4,0,69,69,68,1,0,0,0,0,20,20,20,20
Tulare,21,2022-05-09,184,184,181,3,7633,7636,7520,116,11,1,1,1,1500,1500,1499,1499
Tuolumne,21,2022-05-09,71,71,70,1,1429,1429,1412,17,1,2,2,0,185,185,183,183
Ventura,21,2022-05-09,1151,1151,1143,8,20949,20956,20817,139,15,1,1,2,1511,1511,1510,1510
Yolo,21,2022-05-09,493,493,489,4,19655,19662,19490,172,1,0,0,1,362,362,362,362
Yuba,21,2022-05-09,77,77,76,1,1241,1241,1229,12,2,0,0,0,119,119,119,119
Alameda,22,2022-05-16,4993,4994,4964,30,75029,75068,74613,455,73,8,8,6,1901,1901,1893,1893
Amador,22,2022-05-16,54,54,53,1,1672,1672,1655,17,0,0,0,0,86,86,86,86
Butte,22,2022-05-16,207,207,206,1,2664,2664,2651,13,7,2,2,0,436,436,434,434
Calaveras,22,2022-05-16,43,43,43,0,765,765,758,7,0,1,1,1,121,121,120,120
Colusa,22,2022-05-16,7,7,7,0,217,217,215,2,0,0,0,0,21,21,21,21
Contra Costa,22,2022-05-16,3492,3492,3457,35,33515,33533,33194,339,50,5,5,7,1317,1317,1312,1312
Del Norte,22,2022-05-16,175,175,174,1,1859,1859,1844,15,0,0,0,0,49,49,49,49
El Dorado,22,2022-05-16,266,266,264,2,3040,3040,3014,26,5,0,0,1,215,215,215,215
Fresno,22,2022-05-16,1139,1139,1128,11,18942,18953,18773,180,46,2,2,6,2773,2773,2771,2771
Glenn,22,2022-05-16,15,15,15,0,259,259,257,2,0,0,0,0,53,53,53,53
Humboldt,22,2022-05-16,274,274,272,2,3253,3253,3227,26,9,1,1,2,148,148,147,147
Imperial,22,2022-05-16,207,207,205,2,4267,4268,4231,37,1,0,0,1,945,945,945,945
Inyo,22,2022-05-16,19,19,19,0,228,228,226,2,1,0,0,0,56,56,56,56
Kern,22,2022-05-16,687,687,682,5,19978,19989,19848,141,22,3,3,3,2351,2351,2348,2348
Kings,22,2022-05-16,220,220,218,2,5418,5421,5375,46,0,1,1,0,450,450,449,449
Lake,22,2022-05-16,75,75,74,1,1118,1118,1107,11,2,0,0,0,140,140,140,140
Lassen,22,2022-05-16,21,21,21,0,1704,1704,1693,11,1,0,0,0,62,62,62,62
Los Angeles,22,2022-05-16,21420,21433,21382,51,938072,938561,936299,2262,283,39,39,44,31996,31996,31957,31957
Madera,22,2022-05-16,199,199,197,2,3632,3632,3597,35,2,0,0,0,370,370,370,370
Marin,22,2022-05-16,816,816,808,8,8391,8396,8317,79,12,0,0,0,295,295,295,295
Mariposa,22,2022-05-16,23,23,23,0,340,340,336,4,0,0,0,0,28,28,28,28
Mendocino,22,2022-05-16,99,99,98,1,1326,1326,1309,17,0,1,1,1,128,128,127,127
Merced,22,2022-05-16,314,314,312,2,4010,4010,3981,29,8,1,1,1,828,828,827,827
Modoc,22,2022-05-16,4,4,4,0,43,44,43,1,0,0,0,0,7,7,7,7
Mono,22,2022-05-16,11,11,11,0,112,112,110,2,0,0,0,0,6,6,6,6
Monterey,22,2022-05-16,509,509,501,8,9600,9605,9460,145,6,1,1,0,734,734,733,733
Napa,22,2022-05-16,299,299,297,2,3740,3740,3716,24,3,0,0,0,143,143,143,143
Nevada,22,2022-05-16,146,146,145,1,1834,1834,1817,17,2,0,0,0,131,131,131,131
Orange,22,2022-05-16,4557,4558,4533,25,94692,94740,94207,533,74,7,7,15,7143,7143,7136,7136
Placer,22,2022-05-16,742,742,734,8,7777,7782,7701,81,43,2,2,3,629,629,627,627
Plumas,22,2022-05-16,48,48,48,0,242,242,240,2,1,0,0,0,13,13,13,13
Riverside,22,2022-05-16,3345,3345,3320,25,47986,48013,47652,361,65,1,1,6,6471,6471,6470,6470
Sacramento,22,2022-05-16,3141,3141,3116,25,39842,39862,39540,322,89,8,8,12,3085,3085,3077,3077
San Benito,22,2022-05-16,110,110,109,1,1529,1529,1519,10,1,0,0,0,94,94,94,94
San Bernardino,22,2022-05-16,2473,2473,2458,15,49171,49196,48898,298,44,8,8,5,7847,7847,7839,7839
San Diego,22,2022-05-16,6666,6670,6653,17,94785,94834,94594,240,91,6,6,25,5365,5365,5359,5359
San Francisco,22,2022-05-16,3413,3413,3357,56,39358,39378,38725,653,68,5,5,8,889,889,884,884
San Joaquin,22,2022-05-16,1201,1201,1190,11,19000,19010,18841,169,16,1,1,1,2252,2252,2251,2251
San Luis Obispo,22,2022-05-16,426,426,423,3,6058,6062,6020,42,3,0,0,0,483,483,483,483
San Mateo,22,2022-05-16,2776,2776,2761,15,39916,39938,39713,225,39,1,1,1,714,714,713,713
Santa Barbara,22,2022-05-16,913,913,906,7,17042,17050,16918,132,13,0,0,2,693,693,693,693
Santa Clara,22,2022-05-16,7205,7210,7191,19,113214,113274,112968,306,111,9,9,15,2327,2327,2318,2318
Santa Cruz,22,2022-05-16,808,808,803,5,20748,20758,20618,140,5,0,0,0,262,262,262,262
Shasta,22,2022-05-16,126,126,125,1,3812,3812,3781,31,6,0,0,1,561,561,561,561
Siskiyou,22,2022-05-16,19,19,19,0,372,372,370,2,0,0,0,0,83,83,83,83
Solano,22,2022-05-16,1279,1279,1269,10,14198,14205,14098,107,29,0,0,2,450,450,450,450
Sonoma,22,2022-05-16,1573,1573,1562,11,15543,15551,15436,115,28,0,0,4,494,494,494,494
Stanislaus,22,2022-05-16,749,749,740,9,9951,9956,9840,116,33,2,2,5,1697,1697,1695,1695
Sutter,22,2022-05-16,109,109,108,1,1828,1828,1814,14,0,0,0,0,227,227,227,227
Tehama,22,2022-05-16,38,38,38,0,840,840,831,9,0,1,1,1,208,208,207,207
Trinity,22,2022-05-16,5,5,5,0,69,69,68,1,0,0,0,0,20,20,20,20
Tulare,22,2022-05-16,397,397,392,5,8312,8317,8218,99,14,1,1,0,1501,1501,1500,1500
Tuolumne,22,2022-05-16,139,139,138,1,1448,1448,1434,14,1,1,1,0,186,186,185,185
Ventura,22,2022-05-16,1552,1552,1544,8,23859,23872,23748,124,34,2,2,2,1513,1513,1511,1511
Yolo,22,2022-05-16,688,688,683,5,22154,22166,22014,152,0,0,0,1,362,362,362,362
Yuba,22,2022-05-16,119,119,118,1,1335,1335,1325,10,4,0,0,0,119,119,119,119
Alameda,23,2022-05-23,5603,5606,5580,26,77859,77906,77538,368,76,4,4,4,1905,1905,1901,1901
Amador,23,2022-05-23,80,80,79,1,1441,1441,1430,11,0,0,0,0,86,86,86,86
Butte,23,2022-05-23,284,284,283,1,2766,2766,2755,11,5,1,1,1,437,437,436,436
Calaveras,23,2022-05-23,52,52,52,0,744,744,739,5,0,1,1,0,122,122,121,121
Colusa,23,2022-05-23,7,7,7,0,232,232,231,1,0,0,0,0,21,21,21,21
Contra Costa,23,2022-05-23,3831,3831,3801,30,35375,35395,35115,280,71,10,10,7,1327,1327,1317,1317
Del Norte,23,2022-05-23,67,67,67,0,1346,1346,1338,8,0,1,1,0,50,50,49,49
El Dorado,23,2022-05-23,359,359,357,2,3421,3421,3398,23,6,2,2,0,217,217,215,215
Fresno,23,2022-05-23,1652,1652,1640,12,21269,21282,21124,158,63,2,2,8,2775,2775,2773,2773
Glenn,23,2022-05-23,26,26,26,0,273,273,271,2,0,0,0,0,53,53,53,53
Humboldt,23,2022-05-23,245,245,244,1,2911,2911,2893,18,14,1,1,3,149,149,148,148
Imperial,23,2022-05-23,343,343,341,2,4740,4742,4710,32,2,0,0,1,945,945,945,945
Inyo,23,2022-05-23,27,27,27,0,221,221,220,1,0,0,0,0,56,56,56,56
Kern,23,2022-05-23,1006,1006,1001,5,21275,21288,21171,117,34,0,0,7,2351,2351,2351,2351
Kings,23,2022-05-23,250,250,248,2,5644,5648,5610,38,1,0,0,0,450,450,450,450
Lake,23,2022-05-23,96,96,95,1,1238,1238,1228,10,1,0,0,1,140,140,140,140
Lassen,23,2022-05-23,41,41,41,0,1763,1763,1754,9,0,0,0,0,62,62,62,62
Los Angeles,23,2022-05-23,27748,27765,27713,52,946452,947023,945244,1779,366,31,31,53,32027,32027,31996,31996
Madera,23,2022-05-23,216,216,214,2,3765,3765,3737,28,1,0,0,2,370,370,370,370
Marin,23,2022-05-23,798,798,792,6,8785,8790,8726,64,15,0,0,1,295,295,295,295
Mariposa,23,2022-05-23,32,32,32,0,340,340,337,3,0,0,0,0,28,28,28,28
Mendocino,23,2022-05-23,150,150,149,1,1659,1659,1642,17,3,1,1,1,129,129,128,128
Merced,23,2022-05-23,409,409,407,2,4201,4202,4178,24,4,0,0,0,828,828,828,828
Modoc,23,2022-05-23,2,2,2,0,40,41,40,1,0,0,0,0,7,7,7,7
Mono,23,2022-05-23,14,14,14,0,163,163,161,2,0,0,0,0,6,6,6,6
Monterey,23,2022-05-23,701,701,693,8,9613,9619,9506,113,17,1,1,1,735,735,734,734
Napa,23,2022-05-23,332,332,330,2,3938,3938,3918,20,5,0,0,0,143,143,143,143
Nevada,23,2022-05-23,150,150,149,1,1904,1904,1890,14,2,0,0,0,131,131,131,131
Orange,23,2022-05-23,5625,5628,5604,24,94934,94992,94574,418,111,11,11,20,7154,7154,7143,7143
Placer,23,2022-05-23,888,888,881,7,7838,7843,7779,64,49,2,2,4,631,631,629,629
Plumas,23,2022-05-23,46,46,46,0,279,279,277,2,0,0,0,0,13,13,13,13
Riverside,23,2022-05-23,4456,4457,4431,26,52426,52457,52150,307,73,6,6,10,6477,6477,6471,6471
Sacramento,23,2022-05-23,3899,3900,3875,25,41056,41082,40822,260,122,7,7,10,3092,3092,3085,3085
San Benito,23,2022-05-23,168,168,167,1,1668,1668,1659,9,0,0,0,0,94,94,94,94
San Bernardino,23,2022-05-23,3324,3324,3308,16,50646,50677,50437,240,53,3,3,10,7850,7850,7847,7847
San Diego,23,2022-05-23,8841,8846,8829,17,103288,103351,103147,204,138,4,4,20,5369,5369,5365,5365
San Francisco,23,2022-05-23,3605,3605,3558,47,41637,41663,41123,540,85,6,6,9,895,895,889,889
San Joaquin,23,2022-05-23,1549,1549,1538,11,20954,20968,20822,146,20,3,3,7,2255,2255,2252,2252
San Luis Obispo,23,2022-05-23,669,669,665,4,7272,7277,7238,39,10,3,3,0,486,486,483,483
San Mateo,23,2022-05-23,3155,3155,3141,14,40830,40856,40676,180,35,0,0,0,714,714,714,714
Santa Barbara,23,2022-05-23,1064,1064,1058,6,17776,17787,17679,108,20,0,0,3,693,693,693,693
Santa Clara,23,2022-05-23,7829,7835,7819,16,111312,111379,111144,235,126,7,7,18,2334,2334,2327,2327
Santa Cruz,23,2022-05-23,505,505,502,3,7816,7821,7781,40,16,0,0,0,262,262,262,262
Shasta,23,2022-05-23,195,195,194,1,3606,3607,3584,23,4,1,1,3,562,562,561,561
Siskiyou,23,2022-05-23,29,29,29,0,364,364,362,2,1,0,0,0,83,83,83,83
Solano,23,2022-05-23,1513,1513,1504,9,14914,14923,14835,88,24,1,1,3,451,451,450,450
Sonoma,23,2022-05-23,1488,1488,1479,9,16336,16348,16253,95,34,2,2,3,496,496,494,494
Stanislaus,23,2022-05-23,873,873,865,8,10701,10708,10610,98,37,2,2,3,1699,1699,1697,1697
Sutter,23,2022-05-23,141,141,140,1,1912,1912,1901,11,0,1,1,0,228,228,227,227
Tehama,23,2022-05-23,50,50,50,0,812,812,805,7,1,0,0,1,208,208,208,208
Trinity,23,2022-05-23,3,3,3,0,90,90,89,1,0,0,0,0,20,20,20,20
Tulare,23,2022-05-23,558,558,553,5,9066,9072,8988,84,26,0,0,0,1501,1501,1501,1501
Tuolumne,23,2022-05-23,136,136,135,1,1576,1576,1564,12,0,1,1,0,187,187,186,186
Ventura,23,2022-05-23,1917,1917,1909,8,24020,24034,23937,97,36,1,1,1,1514,1514,1513,1513
Yolo,23,2022-05-23,731,731,727,4,22660,22674,22552,122,1,1,1,1,363,363,362,362
Yuba,23,2022-05-23,151,151,150,1,1453,1453,1445,8,6,0,0,1,119,119,119,119
Alameda,24,2022-05-30,4913,4917,4899,18,60795,60838,60609,229,95,4,4,7,1909,1909,1905,1905
Amador,24,2022-05-30,89,89,88,1,1191,1191,1184,7,0,1,1,0,87,87,86,86
Butte,24,2022-05-30,276,276,275,1,2708,2708,2700,8,20,0,0,1,437,437,437,437
Calaveras,24,2022-05-30,54,54,54,0,617,617,614,3,0,0,0,0,122,122,122,122
Colusa,24,2022-05-30,13,13,13,0,170,170,169,1,0,0,0,0,21,21,21,21
Contra Costa,24,2022-05-30,3322,3323,3302,21,28988,29007,28825,182,65,7,7,9,1334,1334,1327,1327
Del Norte,24,2022-05-30,36,36,36,0,975,975,970,5,2,1,1,0,51,51,50,50
El Dorado,24,2022-05-30,332,332,330,2,2940,2941,2925,16,6,2,2,2,219,219,217,217
Fresno,24,2022-05-30,1669,1669,1659,10,19451,19464,19349,115,71,6,6,7,2781,2781,2775,2775
Glenn,24,2022-05-30,27,27,27,0,290,290,289,1,2,0,0,0,53,53,53,53
Humboldt,24,2022-05-30,181,181,180,1,2296,2296,2285,11,10,0,0,5,149,149,149,149
Imperial,24,2022-05-30,332,332,330,2,4138,4141,4119,22,2,1,1,2,946,946,945,945
Inyo,24,2022-05-30,18,18,18,0,151,151,150,1,0,0,0,0,56,56,56,56
Kern,24,2022-05-30,1078,1078,1073,5,17986,17999,17920,79,36,0,0,6,2351,2351,2351,2351
Kings,24,2022-05-30,292,292,290,2,4664,4667,4642,25,2,0,0,1,450,450,450,450
Lake,24,2022-05-30,89,89,88,1,994,994,988,6,1,0,0,0,140,140,140,140
Lassen,24,2022-05-30,50,50,50,0,1615,1615,1608,7,1,0,0,0,62,62,62,62
Los Angeles,24,2022-05-30,26044,26063,26024,39,746784,747297,746171,1126,425,47,47,54,32074,32074,32027,32027
Madera,24,2022-05-30,235,235,234,1,3314,3314,3294,20,4,0,0,1,370,370,370,370
Marin,24,2022-05-30,651,651,647,4,7154,7158,7116,42,16,3,3,1,298,298,295,295
Mariposa,24,2022-05-30,39,39,39,0,303,303,301,2,0,0,0,0,28,28,28,28
Mendocino,24,2022-05-30,137,137,136,1,1264,1264,1254,10,4,0,0,1,129,129,129,129
Merced,24,2022-05-30,365,365,363,2,3406,3407,3392,15,6,0,0,2,828,828,828,828
Modoc,24,2022-05-30,4,4,4,0,38,39,38,1,0,0,0,0,7,7,7,7
Mono,24,2022-05-30,6,6,6,0,81,81,80,1,0,0,0,0,6,6,6,6
Monterey,24,2022-05-30,526,526,521,5,7149,7153,7086,67,19,1,1,1,736,736,735,735
Napa,24,2022-05-30,313,313,312,1,3181,3183,3170,13,4,0,0,0,143,143,143,143
Nevada,24,2022-05-30,181,181,180,1,1595,1595,1586,9,3,2,2,1,133,133,131,131
Orange,24,2022-05-30,5638,5642,5623,19,82275,82333,82045,288,122,12,12,18,7166,7166,7154,7154
Placer,24,2022-05-30,738,738,733,5,6135,6139,6099,40,52,0,0,8,631,631,631,631
Plumas,24,2022-05-30,35,35,35,0,200,200,199,1,1,0,0,0,13,13,13,13
Riverside,24,2022-05-30,3864,3864,3846,18,43871,43901,43696,205,82,3,3,10,6480,6480,6477,6477
Sacramento,24,2022-05-30,3840,3841,3822,19,33084,33106,32940,166,130,9,9,20,3101,3101,3092,3092
San Benito,24,2022-05-30,154,154,153,1,1276,1276,1271,5,0,0,0,0,94,94,94,94
San Bernardino,24,2022-05-30,3335,3335,3323,12,42870,42899,42738,161,49,5,5,10,7855,7855,7850,7850
San Diego,24,2022-05-30,8414,8420,8407,13,85859,85917,85782,135,153,10,10,26,5379,5379,5369,5369
San Francisco,24,2022-05-30,3133,3133,3101,32,33425,33448,33104,344,88,11,11,14,906,906,895,895
San Joaquin,24,2022-05-30,1399,1399,1391,8,17011,17023,16929,94,25,2,2,9,2257,2257,2255,2255
San Luis Obispo,24,2022-05-30,653,653,650,3,5437,5441,5418,23,12,1,1,0,487,487,486,486
San Mateo,24,2022-05-30,2753,2753,2743,10,31176,31196,31086,110,33,3,3,2,717,717,714,714
Santa Barbara,24,2022-05-30,1032,1032,1027,5,14449,14459,14389,70,23,2,2,5,695,695,693,693
Santa Clara,24,2022-05-30,7030,7037,7025,12,85314,85373,85230,143,154,10,10,22,2344,2344,2334,2334
Santa Cruz,24,2022-05-30,526,526,524,2,6255,6259,6233,26,7,1,1,1,263,263,262,262
Shasta,24,2022-05-30,133,133,132,1,2838,2839,2825,14,4,3,3,4,565,565,562,562
Siskiyou,24,2022-05-30,53,53,53,0,340,340,339,1,3,0,0,0,83,83,83,83
Solano,24,2022-05-30,1185,1185,1179,6,11556,11564,11509,55,28,0,0,7,451,451,451,451
Sonoma,24,2022-05-30,1200,1200,1195,5,13239,13250,13189,61,38,2,2,5,498,498,496,496
Stanislaus,24,2022-05-30,801,801,795,6,8585,8591,8529,62,55,2,2,3,1701,1701,1699,1699
Sutter,24,2022-05-30,158,158,157,1,1701,1701,1693,8,0,0,0,0,228,228,228,228
Tehama,24,2022-05-30,62,62,62,0,757,757,752,5,2,0,0,0,208,208,208,208
Trinity,24,2022-05-30,8,8,8,0,96,96,95,1,0,0,0,0,20,20,20,20
Tulare,24,2022-05-30,597,597,593,4,7482,7487,7431,56,19,0,0,0,1501,1501,1501,1501
Tuolumne,24,2022-05-30,122,122,121,1,1306,1306,1298,8,3,0,0,0,187,187,187,187
Ventura,24,2022-05-30,1681,1681,1676,5,19545,19559,19496,63,30,1,1,4,1515,1515,1514,1514
Yolo,24,2022-05-30,610,610,607,3,17635,17649,17574,75,4,0,0,1,363,363,363,363
Yuba,24,2022-05-30,144,144,143,1,1276,1276,1270,6,7,0,0,2,119,119,119,119
Alameda,25,2022-06-06,6488,6493,6474,19,73237,73293,73081,212,112,5,5,12,1914,1914,1909,1909
Amador,25,2022-06-06,114,114,113,1,1723,1723,1715,8,1,0,0,1,87,87,87,87
Butte,25,2022-06-06,453,453,452,1,3617,3620,3612,8,24,1,1,1,438,438,437,437
Calaveras,25,2022-06-06,73,73,73,0,737,737,734,3,0,2,2,0,124,124,122,122
Colusa,25,2022-06-06,22,22,22,0,275,275,274,1,3,0,0,0,21,21,21,21
Contra Costa,25,2022-06-06,4237,4240,4220,20,35704,35732,35559,173,107,9,9,7,1343,1343,1334,1334
Del Norte,25,2022-06-06,64,64,64,0,1134,1134,1130,4,2,0,0,0,51,51,51,51
El Dorado,25,2022-06-06,413,413,411,2,3637,3639,3624,15,5,0,0,5,219,219,219,219
Fresno,25,2022-06-06,2451,2451,2440,11,22602,22619,22516,103,94,2,2,6,2783,2783,2781,2781
Glenn,25,2022-06-06,41,41,41,0,325,325,324,1,3,0,0,0,53,53,53,53
Humboldt,25,2022-06-06,261,261,260,1,3054,3054,3043,11,14,1,1,3,150,150,149,149
Imperial,25,2022-06-06,466,466,464,2,4861,4866,4846,20,2,0,0,0,946,946,946,946
Inyo,25,2022-06-06,20,20,20,0,213,213,212,1,1,0,0,0,56,56,56,56
Kern,25,2022-06-06,1611,1611,1606,5,22975,22994,22917,77,35,1,1,6,2352,2352,2351,2351
Kings,25,2022-06-06,397,397,395,2,5504,5509,5486,23,10,0,0,1,450,450,450,450
Lake,25,2022-06-06,136,136,135,1,1180,1180,1174,6,5,0,0,2,140,140,140,140
Lassen,25,2022-06-06,71,71,71,0,2398,2398,2390,8,2,0,0,0,62,62,62,62
Los Angeles,25,2022-06-06,35102,35128,35088,40,1041700,1042487,1041284,1203,496,39,39,61,32113,32113,32074,32074
Madera,25,2022-06-06,354,354,352,2,4126,4129,4110,19,7,0,0,1,370,370,370,370
Marin,25,2022-06-06,739,739,736,3,7650,7655,7621,34,10,2,2,5,300,300,298,298
Mariposa,25,2022-06-06,57,57,57,0,403,403,401,2,0,0,0,0,28,28,28,28
Mendocino,25,2022-06-06,209,209,208,1,1711,1711,1700,11,9,1,1,2,130,130,129,129
Merced,25,2022-06-06,532,532,530,2,4530,4533,4517,16,16,0,0,0,828,828,828,828
Modoc,25,2022-06-06,11,11,11,0,37,38,37,1,0,0,0,0,7,7,7,7
Mono,25,2022-06-06,15,15,15,0,120,120,119,1,0,0,0,0,6,6,6,6
Monterey,25,2022-06-06,1002,1002,995,7,10243,10250,10175,75,17,2,2,1,738,738,736,736
Napa,25,2022-06-06,543,543,541,2,4232,4236,4223,13,8,1,1,0,144,144,143,143
Nevada,25,2022-06-06,246,246,245,1,2149,2149,2139,10,5,0,0,0,133,133,133,133
Orange,25,2022-06-06,7580,7587,7567,20,73767,73823,73625,198,140,12,12,18,7178,7178,7166,7166
Placer,25,2022-06-06,868,868,864,4,7605,7610,7572,38,65,0,0,11,631,631,631,631
Plumas,25,2022-06-06,40,40,40,0,321,321,320,1,0,0,0,0,13,13,13,13
Riverside,25,2022-06-06,5356,5361,5342,19,55976,56019,55818,201,88,6,6,10,6486,6486,6480,6480
Sacramento,25,2022-06-06,4951,4955,4936,19,42466,42498,42333,165,149,14,14,20,3115,3115,3101,3101
San Benito,25,2022-06-06,273,273,272,1,2016,2016,2010,6,0,0,0,1,94,94,94,94
San Bernardino,25,2022-06-06,5130,5135,5120,15,55841,55883,55721,162,77,7,7,14,7862,7862,7855,7855
San Diego,25,2022-06-06,10776,10785,10772,13,100461,100537,100415,122,185,8,8,22,5387,5387,5379,5379
San Francisco,25,2022-06-06,3521,3521,3493,28,38262,38291,37986,305,77,0,0,11,906,906,906,906
San Joaquin,25,2022-06-06,2133,2133,2124,9,22156,22174,22080,94,40,4,4,9,2261,2261,2257,2257
San Luis Obispo,25,2022-06-06,901,901,898,3,7531,7536,7511,25,16,1,1,1,488,488,487,487
San Mateo,25,2022-06-06,3214,3214,3205,9,37066,37095,36995,100,36,2,2,4,719,719,717,717
Santa Barbara,25,2022-06-06,1246,1246,1241,5,15070,15083,15027,56,22,1,1,5,696,696,695,695
Santa Clara,25,2022-06-06,8504,8511,8500,11,102648,102726,102594,132,176,6,6,22,2350,2350,2344,2344
Santa Cruz,25,2022-06-06,896,896,893,3,9720,9727,9697,30,24,1,1,3,264,264,263,263
Shasta,25,2022-06-06,210,210,209,1,4425,4428,4411,17,10,2,2,2,567,567,565,565
Siskiyou,25,2022-06-06,41,41,41,0,431,431,430,1,1,0,0,0,83,83,83,83
Solano,25,2022-06-06,1748,1748,1742,6,15180,15192,15137,55,29,2,2,1,453,453,451,451
Sonoma,25,2022-06-06,1636,1636,1630,6,13997,14009,13960,49,38,1,1,1,499,499,498,498
Stanislaus,25,2022-06-06,1183,1183,1176,7,10914,10922,10861,61,60,1,1,2,1702,1702,1701,1701
Sutter,25,2022-06-06,206,206,205,1,1941,1941,1934,7,0,0,0,0,228,228,228,228
Tehama,25,2022-06-06,83,83,83,0,1051,1051,1045,6,2,0,0,0,208,208,208,208
Trinity,25,2022-06-06,7,7,7,0,110,110,109,1,0,0,0,0,20,20,20,20
Tulare,25,2022-06-06,857,857,852,5,10773,10780,10719,61,24,0,0,0,1501,1501,1501,1501
Tuolumne,25,2022-06-06,124,124,123,1,1723,1723,1715,8,4,0,0,1,187,187,187,187
Ventura,25,2022-06-06,1973,1973,1968,5,24765,24783,24722,61,43,3,3,3,1518,1518,1515,1515
Yolo,25,2022-06-06,828,828,825,3,21439,21456,21386,70,2,1,1,0,364,364,363,363
Yuba,25,2022-06-06,187,187,186,1,1556,1556,1551,5,9,0,0,1,119,119,119,119
Alameda,26,2022-06-13,5078,5083,5072,11,55925,55972,55846,126,106,7,7,18,1921,1921,1914,1914
Amador,26,2022-06-13,129,129,129,0,1413,1413,1408,5,1,0,0,0,87,87,87,87
Butte,26,2022-06-13,394,394,393,1,3459,3462,3456,6,31,4,4,0,442,442,438,438
Calaveras,26,2022-06-13,69,69,69,0,658,658,656,2,0,0,0,0,124,124,124,124
Colusa,26,2022-06-13,12,12,12,0,328,328,327,1,17,0,0,0,21,21,21,21
Contra Costa,26,2022-06-13,3414,3416,3403,13,27989,28013,27907,106,89,8,8,12,1351,1351,1343,1343
Del Norte,26,2022-06-13,79,79,79,0,658,658,656,2,4,0,0,0,51,51,51,51
El Dorado,26,2022-06-13,324,324,323,1,3197,3198,3188,10,7,3,3,1,222,222,219,219
Fresno,26,2022-06-13,2398,2398,2390,8,20609,20628,20555,73,103,4,4,13,2787,2787,2783,2783
Glenn,26,2022-06-13,32,32,32,0,329,329,328,1,2,0,0,0,53,53,53,53
Humboldt,26,2022-06-13,262,262,261,1,2325,2325,2318,7,11,0,0,3,150,150,150,150
Imperial,26,2022-06-13,446,446,445,1,4522,4527,4513,14,6,1,1,0,947,947,946,946
Inyo,26,2022-06-13,13,13,13,0,189,189,188,1,0,0,0,0,56,56,56,56
Kern,26,2022-06-13,1565,1565,1561,4,21421,21439,21383,56,38,1,1,5,2353,2353,2352,2352
Kings,26,2022-06-13,357,357,356,1,5156,5161,5145,16,4,1,1,0,451,451,450,450
Lake,26,2022-06-13,138,138,137,1,1227,1227,1223,4,1,0,0,0,140,140,140,140
Lassen,26,2022-06-13,77,77,77,0,1994,1994,1989,5,2,0,0,0,62,62,62,62
Los Angeles,26,2022-06-13,29991,30016,29989,27,660485,661038,660439,599,519,54,54,60,32167,32167,32113,32113
Madera,26,2022-06-13,381,381,380,1,4231,4234,4219,15,7,0,0,2,370,370,370,370
Marin,26,2022-06-13,686,686,684,2,7039,7045,7020,25,16,2,2,2,302,302,300,300
Mariposa,26,2022-06-13,45,45,45,0,372,372,371,1,0,0,0,0,28,28,28,28
Mendocino,26,2022-06-13,162,162,161,1,1567,1567,1559,8,9,0,0,1,130,130,130,130
Merced,26,2022-06-13,561,561,559,2,4169,4173,4162,11,13,0,0,2,828,828,828,828
Modoc,26,2022-06-13,7,7,7,0,34,35,34,1,1,1,1,0,8,8,7,7
Mono,26,2022-06-13,19,19,19,0,92,92,91,1,0,0,0,0,6,6,6,6
Monterey,26,2022-06-13,841,841,836,5,8659,8666,8617,49,25,3,3,1,741,741,738,738
Napa,26,2022-06-13,434,434,433,1,3940,3945,3936,9,2,1,1,1,145,145,144,144
Nevada,26,2022-06-13,186,186,185,1,1874,1874,1867,7,8,0,0,0,133,133,133,133
Orange,26,2022-06-13,7005,7012,6998,14,65234,65289,65153,136,175,15,15,19,7193,7193,7178,7178
Placer,26,2022-06-13,790,790,787,3,6801,6806,6780,26,79,2,2,7,633,633,631,631
Plumas,26,2022-06-13,34,34,34,0,271,271,270,1,0,0,0,0,13,13,13,13
Riverside,26,2022-06-13,5046,5051,5037,14,47851,47891,47757,134,105,3,3,11,6489,6489,6486,6486
Sacramento,26,2022-06-13,4179,4183,4170,13,37540,37572,37459,113,190,13,13,20,3128,3128,3115,3115
San Benito,26,2022-06-13,200,200,200,0,1780,1780,1776,4,1,0,0,1,94,94,94,94
San Bernardino,26,2022-06-13,4674,4679,4669,10,48701,48742,48632,110,96,6,6,15,7868,7868,7862,7862
San Diego,26,2022-06-13,9615,9623,9614,9,84902,84973,84893,80,192,9,9,27,5396,5396,5387,5387
San Francisco,26,2022-06-13,3033,3033,3014,19,31123,31150,30957,193,72,11,11,13,917,917,906,906
San Joaquin,26,2022-06-13,1920,1920,1914,6,19008,19025,18962,63,32,5,5,3,2266,2266,2261,2261
San Luis Obispo,26,2022-06-13,661,661,659,2,6051,6056,6041,15,21,0,0,0,488,488,488,488
San Mateo,26,2022-06-13,2635,2635,2630,5,29175,29201,29140,61,44,3,3,3,722,722,719,719
Santa Barbara,26,2022-06-13,931,931,928,3,9475,9484,9457,27,15,1,1,5,697,697,696,696
Santa Clara,26,2022-06-13,7044,7051,7044,7,76835,76899,76822,77,182,13,13,23,2363,2363,2350,2350
Santa Cruz,26,2022-06-13,842,842,840,2,9962,9970,9946,24,23,0,0,1,264,264,264,264
Shasta,26,2022-06-13,220,220,219,1,3390,3392,3382,10,8,1,1,0,568,568,567,567
Siskiyou,26,2022-06-13,50,50,50,0,372,372,371,1,1,0,0,0,83,83,83,83
Solano,26,2022-06-13,1689,1689,1684,5,12899,12910,12874,36,33,0,0,2,453,453,453,453
Sonoma,26,2022-06-13,1336,1336,1332,4,11651,11662,11630,32,36,3,3,6,502,502,499,499
Stanislaus,26,2022-06-13,1133,1133,1128,5,9453,9461,9420,41,63,1,1,7,1703,1703,1702,1702
Sutter,26,2022-06-13,193,193,192,1,1721,1721,1716,5,0,0,0,0,228,228,228,228
Tehama,26,2022-06-13,88,88,88,0,967,967,963,4,3,0,0,0,208,208,208,208
Trinity,26,2022-06-13,11,11,11,0,84,85,84,1,0,0,0,0,20,20,20,20
Tulare,26,2022-06-13,829,829,825,4,9451,9458,9416,42,26,2,2,1,1503,1503,1501,1501
Tuolumne,26,2022-06-13,148,148,147,1,1445,1445,1440,5,2,0,0,0,187,187,187,187
Ventura,26,2022-06-13,1935,1935,1931,4,20980,20997,20957,40,38,3,3,5,1521,1521,1518,1518
Yolo,26,2022-06-13,767,767,765,2,14397,14410,14373,37,4,1,1,0,365,365,364,364
Yuba,26,2022-06-13,188,188,187,1,1419,1419,1415,4,8,0,0,1,119,119,119,119
Alameda,27,2022-06-20,4955,4960,4951,9,48650,48697,48612,85,105,12,12,14,1933,1933,1921,1921
Amador,27,2022-06-20,104,104,104,0,1247,1247,1243,4,2,0,0,0,87,87,87,87
Butte,27,2022-06-20,414,414,413,1,3562,3567,3562,5,28,4,4,1,446,446,442,442
Calaveras,27,2022-06-20,82,82,82,0,624,624,622,2,0,0,0,0,124,124,124,124
Colusa,27,2022-06-20,16,16,16,0,176,177,176,1,15,1,1,0,22,22,21,21
Contra Costa,27,2022-06-20,3346,3348,3338,10,26021,26046,25969,77,81,7,7,8,1358,1358,1351,1351
Del Norte,27,2022-06-20,82,82,82,0,611,611,610,1,3,1,1,1,52,52,51,51
El Dorado,27,2022-06-20,351,351,350,1,3074,3076,3068,8,5,2,2,1,224,224,222,222
Fresno,27,2022-06-20,2471,2471,2464,7,19408,19427,19373,54,100,2,2,16,2789,2789,2787,2787
Glenn,27,2022-06-20,41,41,41,0,314,314,313,1,3,0,0,0,53,53,53,53
Humboldt,27,2022-06-20,273,273,272,1,2273,2273,2268,5,11,0,0,3,150,150,150,150
Imperial,27,2022-06-20,602,602,601,1,3692,3696,3687,9,5,0,0,0,947,947,947,947
Inyo,27,2022-06-20,19,19,19,0,187,188,187,1,0,0,0,0,56,56,56,56
Kern,27,2022-06-20,1652,1652,1649,3,20136,20156,20115,41,39,5,5,9,2358,2358,2353,2353
Kings,27,2022-06-20,413,413,412,1,4866,4871,4859,12,6,1,1,0,452,452,451,451
Lake,27,2022-06-20,120,120,120,0,1237,1237,1233,4,1,0,0,2,140,140,140,140
Lassen,27,2022-06-20,43,43,43,0,1223,1223,1221,2,1,0,0,0,62,62,62,62
Los Angeles,27,2022-06-20,27528,27554,27535,19,351476,351810,351566,244,596,57,57,68,32224,32224,32167,32167
Madera,27,2022-06-20,340,340,339,1,4163,4166,4154,12,4,0,0,1,370,370,370,370
Marin,27,2022-06-20,693,693,691,2,6328,6334,6317,17,21,0,0,1,302,302,302,302
Mariposa,27,2022-06-20,53,53,53,0,335,335,334,1,0,0,0,0,28,28,28,28
Mendocino,27,2022-06-20,180,180,179,1,1580,1580,1574,6,3,0,0,0,130,130,130,130
Merced,27,2022-06-20,541,541,540,1,3955,3960,3952,8,7,3,3,1,831,831,828,828
Modoc,27,2022-06-20,5,5,5,0,37,38,37,1,0,0,0,0,8,8,8,8
Mono,27,2022-06-20,6,6,6,0,82,83,82,1,1,1,1,0,7,7,6,6
Monterey,27,2022-06-20,894,894,890,4,8905,8913,8874,39,38,1,1,2,742,742,741,741
Napa,27,2022-06-20,365,365,364,1,3129,3133,3127,6,3,1,1,0,146,146,145,145
Nevada,27,2022-06-20,170,170,170,0,1619,1619,1615,4,6,1,1,0,134,134,133,133
Orange,27,2022-06-20,7019,7026,7015,11,60449,60507,60409,98,152,10,10,23,7203,7203,7193,7193
Placer,27,2022-06-20,674,674,672,2,6053,6058,6040,18,69,1,1,7,634,634,633,633
Plumas,27,2022-06-20,38,38,38,0,239,239,238,1,0,0,0,0,13,13,13,13
Riverside,27,2022-06-20,4960,4967,4956,11,43308,43350,43255,95,112,5,5,14,6494,6494,6489,6489
Sacramento,27,2022-06-20,3931,3936,3927,9,34813,34846,34764,82,171,12,12,21,3140,3140,3128,3128
San Benito,27,2022-06-20,173,173,173,0,1598,1598,1595,3,0,1,1,2,95,95,94,94
San Bernardino,27,2022-06-20,4532,4537,4529,8,46252,46296,46215,81,105,12,12,17,7880,7880,7868,7868
San Diego,27,2022-06-20,9698,9708,9701,7,77522,77596,77539,57,203,9,9,17,5405,5405,5396,5396
San Francisco,27,2022-06-20,3059,3060,3045,15,28297,28324,28187,137,72,12,12,14,929,929,917,917
San Joaquin,27,2022-06-20,1670,1670,1666,4,17897,17914,17868,46,38,6,6,6,2272,2272,2266,2266
San Luis Obispo,27,2022-06-20,601,601,600,1,5814,5819,5807,12,27,10,10,0,498,498,488,488
San Mateo,27,2022-06-20,2623,2623,2619,4,25948,25973,25930,43,42,2,2,1,724,724,722,722
Santa Barbara,27,2022-06-20,934,934,932,2,8260,8267,8249,18,33,2,2,6,699,699,697,697
Santa Clara,27,2022-06-20,6809,6816,6811,5,63486,63546,63497,49,170,8,8,21,2371,2371,2363,2363
Santa Cruz,27,2022-06-20,818,818,816,2,9130,9138,9121,17,19,1,1,2,265,265,264,264
Shasta,27,2022-06-20,241,241,240,1,3374,3377,3369,8,9,1,1,1,569,569,568,568
Siskiyou,27,2022-06-20,61,61,61,0,394,394,393,1,5,1,1,0,84,84,83,83
Solano,27,2022-06-20,1420,1420,1417,3,11467,11478,11453,25,41,0,0,5,453,453,453,453
Sonoma,27,2022-06-20,1399,1399,1396,3,10797,10809,10786,23,28,1,1,3,503,503,502,502
Stanislaus,27,2022-06-20,1036,1036,1033,3,8832,8841,8811,30,70,5,5,7,1708,1708,1703,1703
Sutter,27,2022-06-20,197,197,197,0,1858,1859,1855,4,0,0,0,0,228,228,228,228
Tehama,27,2022-06-20,97,97,97,0,889,889,886,3,3,0,0,0,208,208,208,208
Trinity,27,2022-06-20,10,10,10,0,106,107,106,1,0,0,0,0,20,20,20,20
Tulare,27,2022-06-20,889,889,886,3,8726,8733,8703,30,32,8,8,0,1511,1511,1503,1503
Tuolumne,27,2022-06-20,141,141,141,0,1554,1554,1550,4,3,0,0,1,187,187,187,187
Ventura,27,2022-06-20,1835,1835,1832,3,18669,18687,18659,28,50,1,1,7,1522,1522,1521,1521
Yolo,27,2022-06-20,680,680,679,1,10851,10862,10840,22,1,2,2,2,367,367,365,365
Yuba,27,2022-06-20,149,149,149,0,1339,1339,1336,3,13,0,0,5,119,119,119,119
Alameda,28,2022-06-27,5473,5480,5473,7,48327,48378,48312,66,124,8,8,16,1941,1941,1933,1933
Amador,28,2022-06-27,88,88,88,0,1149,1149,1146,3,3,0,0,1,87,87,87,87
Butte,28,2022-06-27,410,410,410,0,3468,3472,3468,4,30,2,2,0,448,448,446,446
Calaveras,28,2022-06-27,69,69,69,0,571,571,570,1,1,2,2,0,126,126,124,124
Colusa,28,2022-06-27,28,28,28,0,282,283,282,1,6,0,0,0,22,22,22,22
Contra Costa,28,2022-06-27,3529,3534,3526,8,25917,25944,25885,59,82,12,12,7,1370,1370,1358,1358
Del Norte,28,2022-06-27,140,140,140,0,669,669,668,1,5,1,1,2,53,53,52,52
El Dorado,28,2022-06-27,427,427,426,1,3357,3361,3355,6,5,0,0,1,224,224,224,224
Fresno,28,2022-06-27,2827,2829,2823,6,19885,19905,19862,43,136,2,2,17,2791,2791,2789,2789
Glenn,28,2022-06-27,28,28,28,0,296,296,295,1,1,0,0,0,53,53,53,53
Humboldt,28,2022-06-27,261,261,261,0,2189,2189,2185,4,10,1,1,2,151,151,150,150
Imperial,28,2022-06-27,705,705,704,1,4018,4023,4015,8,7,0,0,4,947,947,947,947
Inyo,28,2022-06-27,32,32,32,0,311,311,310,1,1,0,0,0,56,56,56,56
Kern,28,2022-06-27,1819,1819,1816,3,17406,17424,17396,28,52,7,7,8,2365,2365,2358,2358
Kings,28,2022-06-27,470,470,469,1,3931,3935,3927,8,9,0,0,0,452,452,452,452
Lake,28,2022-06-27,122,122,122,0,1139,1139,1136,3,2,0,0,0,140,140,140,140
Lassen,28,2022-06-27,51,51,51,0,848,848,847,1,1,0,0,0,62,62,62,62
Los Angeles,28,2022-06-27,32763,32797,32779,18,364326,364706,364509,197,679,73,73,68,32297,32297,32224,32224
Madera,28,2022-06-27,414,414,413,1,4286,4290,4281,9,8,0,0,0,370,370,370,370
Marin,28,2022-06-27,660,660,659,1,6243,6249,6236,13,20,1,1,2,303,303,302,302
Mariposa,28,2022-06-27,55,55,55,0,310,310,309,1,0,0,0,0,28,28,28,28
Mendocino,28,2022-06-27,153,153,153,0,1447,1447,1443,4,5,1,1,1,131,131,130,130
Merced,28,2022-06-27,614,614,613,1,4036,4041,4034,7,14,2,2,0,833,833,831,831
Modoc,28,2022-06-27,7,7,7,0,32,33,32,1,0,0,0,0,8,8,8,8
Mono,28,2022-06-27,25,25,25,0,110,111,110,1,1,0,0,0,7,7,7,7
Monterey,28,2022-06-27,935,935,932,3,8274,8283,8255,28,44,2,2,3,744,744,742,742
Napa,28,2022-06-27,391,391,390,1,3313,3317,3312,5,3,2,2,1,148,148,146,146
Nevada,28,2022-06-27,189,189,189,0,1619,1619,1616,3,4,0,0,3,134,134,134,134
Orange,28,2022-06-27,7551,7559,7550,9,59338,59400,59325,75,183,16,16,26,7219,7219,7203,7203
Placer,28,2022-06-27,808,808,806,2,6185,6191,6176,15,79,6,6,6,640,640,634,634
Plumas,28,2022-06-27,50,50,50,0,257,257,256,1,1,0,0,0,13,13,13,13
Riverside,28,2022-06-27,6195,6202,6192,10,44963,45011,44935,76,141,11,11,17,6505,6505,6494,6494
Sacramento,28,2022-06-27,4164,4169,4161,8,35282,35319,35254,65,173,10,10,25,3150,3150,3140,3140
San Benito,28,2022-06-27,221,221,221,0,1655,1655,1653,2,0,0,0,1,95,95,95,95
San Bernardino,28,2022-06-27,5723,5730,5722,8,48820,48871,48804,67,130,12,12,24,7892,7892,7880,7880
San Diego,28,2022-06-27,10872,10884,10878,6,80651,80736,80690,46,264,9,9,28,5414,5414,5405,5405
San Francisco,28,2022-06-27,3269,3271,3259,12,29257,29287,29177,110,92,5,5,23,934,934,929,929
San Joaquin,28,2022-06-27,1893,1893,1889,4,17962,17981,17945,36,46,2,2,5,2274,2274,2272,2272
San Luis Obispo,28,2022-06-27,645,645,644,1,5644,5649,5640,9,25,3,3,0,501,501,498,498
San Mateo,28,2022-06-27,2890,2893,2889,4,26919,26947,26913,34,36,2,2,2,726,726,724,724
Santa Barbara,28,2022-06-27,1148,1148,1146,2,9812,9824,9807,17,26,2,2,2,701,701,699,699
Santa Clara,28,2022-06-27,7542,7549,7544,5,61418,61482,61445,37,213,11,11,19,2382,2382,2371,2371
Santa Cruz,28,2022-06-27,861,861,860,1,9188,9198,9184,14,26,2,2,1,267,267,265,265
Shasta,28,2022-06-27,339,339,338,1,3308,3311,3305,6,21,0,0,4,569,569,569,569
Siskiyou,28,2022-06-27,63,63,63,0,355,355,354,1,2,1,1,0,85,85,84,84
Solano,28,2022-06-27,1614,1614,1611,3,13043,13057,13035,22,47,0,0,4,453,453,453,453
Sonoma,28,2022-06-27,1368,1368,1366,2,10098,10110,10093,17,33,2,2,3,505,505,503,503
Stanislaus,28,2022-06-27,1212,1212,1209,3,8583,8593,8570,23,96,2,2,6,1710,1710,1708,1708
Sutter,28,2022-06-27,197,197,197,0,1843,1844,1841,3,0,0,0,0,228,228,228,228
Tehama,28,2022-06-27,93,93,93,0,888,888,886,2,3,0,0,0,208,208,208,208
Trinity,28,2022-06-27,24,24,24,0,142,143,142,1,1,0,0,0,20,20,20,20
Tulare,28,2022-06-27,908,908,906,2,7882,7890,7869,21,35,0,0,2,1511,1511,1511,1511
Tuolumne,28,2022-06-27,172,172,172,0,1405,1405,1402,3,1,4,4,1,191,191,187,187
Ventura,28,2022-06-27,2090,2090,2088,2,18528,18548,18526,22,61,3,3,1,1525,1525,1522,1522
Yolo,28,2022-06-27,794,794,793,1,11412,11425,11407,18,8,0,0,1,367,367,367,367
Yuba,28,2022-06-27,172,172,172,0,1435,1435,1433,2,10,2,2,2,121,121,119,119
Alameda,29,2022-07-04,4831,4837,4832,5,38881,38922,38880,42,128,11,11,10,1952,1952,1941,1941
Amador,29,2022-07-04,66,66,66,0,1534,1535,1532,3,3,0,0,1,87,87,87,87
Butte,29,2022-07-04,284,284,284,0,2489,2492,2490,2,28,2,2,1,450,450,448,448
Calaveras,29,2022-07-04,81,81,81,0,486,486,485,1,0,2,2,0,128,128,126,126
Colusa,29,2022-07-04,21,21,21,0,150,151,150,1,4,0,0,0,22,22,22,22
Contra Costa,29,2022-07-04,3320,3324,3318,6,20932,20956,20918,38,76,10,10,12,1380,1380,1370,1370
Del Norte,29,2022-07-04,140,140,140,0,587,587,586,1,3,0,0,0,53,53,53,53
El Dorado,29,2022-07-04,307,307,307,0,2395,2397,2393,4,10,1,1,0,225,225,224,224
Fresno,29,2022-07-04,2468,2469,2465,4,15666,15683,15656,27,158,6,6,17,2797,2797,2791,2791
Glenn,29,2022-07-04,24,24,24,0,157,158,157,1,1,0,0,0,53,53,53,53
Humboldt,29,2022-07-04,188,188,188,0,1584,1584,1582,2,12,2,2,3,153,153,151,151
Imperial,29,2022-07-04,697,697,696,1,3233,3237,3232,5,8,1,1,3,948,948,947,947
Inyo,29,2022-07-04,42,42,42,0,292,293,292,1,1,0,0,0,56,56,56,56
Kern,29,2022-07-04,1794,1794,1792,2,14292,14308,14290,18,63,4,4,9,2369,2369,2365,2365
Kings,29,2022-07-04,436,436,435,1,3446,3450,3445,5,5,0,0,0,452,452,452,452
Lake,29,2022-07-04,107,107,107,0,790,790,789,1,3,2,2,0,142,142,140,140
Lassen,29,2022-07-04,31,31,31,0,640,640,639,1,2,0,0,0,62,62,62,62
Los Angeles,29,2022-07-04,32264,32299,32285,14,285969,286283,286160,123,801,88,88,85,32385,32385,32297,32297
Madera,29,2022-07-04,341,341,340,1,3179,3182,3176,6,9,0,0,1,370,370,370,370
Marin,29,2022-07-04,608,608,607,1,5170,5176,5167,9,25,1,1,2,304,304,303,303
Mariposa,29,2022-07-04,36,36,36,0,222,223,222,1,0,0,0,0,28,28,28,28
Mendocino,29,2022-07-04,164,164,164,0,1119,1119,1116,3,6,2,2,1,133,133,131,131
Merced,29,2022-07-04,596,596,595,1,2920,2924,2920,4,14,2,2,1,835,835,833,833
Modoc,29,2022-07-04,10,10,10,0,31,32,31,1,0,0,0,0,8,8,8,8
Mono,29,2022-07-04,22,22,22,0,81,82,81,1,1,0,0,0,7,7,7,7
Monterey,29,2022-07-04,843,843,841,2,6322,6328,6311,17,39,2,2,4,746,746,744,744
Napa,29,2022-07-04,340,340,340,0,2557,2561,2558,3,13,0,0,1,148,148,148,148
Nevada,29,2022-07-04,177,177,177,0,1268,1268,1266,2,5,0,0,1,134,134,134,134
Orange,29,2022-07-04,6980,6987,6980,7,50727,50783,50732,51,203,25,25,34,7244,7244,7219,7219
Placer,29,2022-07-04,808,808,807,1,5049,5055,5046,9,72,3,3,6,643,643,640,640
Plumas,29,2022-07-04,32,32,32,0,172,173,172,1,0,0,0,0,13,13,13,13
Riverside,29,2022-07-04,6396,6403,6394,9,38526,38568,38516,52,137,5,5,8,6510,6510,6505,6505
Sacramento,29,2022-07-04,3580,3584,3579,5,26534,26562,26523,39,163,19,19,22,3169,3169,3150,3150
San Benito,29,2022-07-04,211,211,211,0,1274,1274,1272,2,3,0,0,0,95,95,95,95
San Bernardino,29,2022-07-04,6065,6072,6065,7,41598,41644,41599,45,147,12,12,26,7904,7904,7892,7892
San Diego,29,2022-07-04,9597,9608,9604,4,65499,65571,65541,30,262,10,10,43,5424,5424,5414,5414
San Francisco,29,2022-07-04,2891,2894,2885,9,24202,24227,24155,72,100,11,11,18,945,945,934,934
San Joaquin,29,2022-07-04,1682,1682,1679,3,14678,14695,14672,23,41,5,5,4,2279,2279,2274,2274
San Luis Obispo,29,2022-07-04,616,616,615,1,4165,4169,4164,5,24,0,0,0,501,501,501,501
San Mateo,29,2022-07-04,2600,2602,2599,3,21595,21620,21598,22,39,1,1,3,727,727,726,726
Santa Barbara,29,2022-07-04,1057,1057,1056,1,7665,7675,7664,11,26,4,4,4,705,705,701,701
Santa Clara,29,2022-07-04,6804,6812,6809,3,50745,50801,50777,24,191,16,16,34,2398,2398,2382,2382
Santa Cruz,29,2022-07-04,733,733,732,1,7158,7165,7156,9,22,0,0,0,267,267,267,267
Shasta,29,2022-07-04,280,280,280,0,2396,2398,2394,4,15,5,5,3,574,574,569,569
Siskiyou,29,2022-07-04,34,34,34,0,326,327,326,1,1,0,0,1,85,85,85,85
Solano,29,2022-07-04,1345,1345,1343,2,9841,9851,9838,13,50,0,0,5,453,453,453,453
Sonoma,29,2022-07-04,1088,1088,1087,1,8092,8102,8091,11,35,2,2,1,507,507,505,505
Stanislaus,29,2022-07-04,1165,1165,1163,2,6990,6998,6983,15,84,7,7,16,1717,1717,1710,1710
Sutter,29,2022-07-04,230,230,230,0,1671,1672,1670,2,0,0,0,0,228,228,228,228
Tehama,29,2022-07-04,132,132,132,0,821,821,819,2,3,1,1,0,209,209,208,208
Trinity,29,2022-07-04,17,17,17,0,143,144,143,1,2,0,0,0,20,20,20,20
Tulare,29,2022-07-04,944,944,942,2,6100,6106,6093,13,40,4,4,1,1515,1515,1511,1511
Tuolumne,29,2022-07-04,165,165,165,0,938,938,936,2,8,0,0,1,191,191,191,191
Ventura,29,2022-07-04,1948,1948,1946,2,15409,15426,15412,14,66,2,2,8,1527,1527,1525,1525
Yolo,29,2022-07-04,535,535,534,1,7261,7269,7260,9,6,3,3,2,370,370,367,367
Yuba,29,2022-07-04,168,168,168,0,1078,1078,1077,1,9,0,0,1,121,121,121,121
Alameda,30,2022-07-11,5794,5801,5796,5,48342,48398,48358,40,119,8,8,16,1960,1960,1952,1952
Amador,30,2022-07-11,92,92,92,0,1504,1505,1503,2,2,0,0,0,87,87,87,87
Butte,30,2022-07-11,497,497,497,0,3298,3303,3301,2,27,1,1,4,451,451,450,450
Calaveras,30,2022-07-11,78,78,78,0,566,566,565,1,0,1,1,1,129,129,128,128
Colusa,30,2022-07-11,26,26,26,0,483,484,483,1,0,0,0,0,22,22,22,22
Contra Costa,30,2022-07-11,3685,3690,3685,5,26543,26574,26537,37,91,11,11,11,1391,1391,1380,1380
Del Norte,30,2022-07-11,174,174,174,0,677,677,676,1,5,0,0,1,53,53,53,53
El Dorado,30,2022-07-11,384,384,384,0,3153,3158,3154,4,12,1,1,3,226,226,225,225
Fresno,30,2022-07-11,3664,3669,3664,5,21553,21578,21550,28,161,7,7,14,2804,2804,2797,2797
Glenn,30,2022-07-11,45,45,45,0,382,383,382,1,0,0,0,0,53,53,53,53
Humboldt,30,2022-07-11,291,291,291,0,2189,2191,2189,2,11,1,1,2,154,154,153,153
Imperial,30,2022-07-11,1118,1118,1117,1,4746,4751,4745,6,14,1,1,1,949,949,948,948
Inyo,30,2022-07-11,40,40,40,0,391,392,391,1,0,1,1,0,57,57,56,56
Kern,30,2022-07-11,2481,2484,2482,2,17066,17086,17069,17,77,2,2,9,2371,2371,2369,2369
Kings,30,2022-07-11,732,732,731,1,4341,4346,4341,5,11,4,4,0,456,456,452,452
Lake,30,2022-07-11,126,126,126,0,1115,1115,1113,2,0,0,0,0,142,142,142,142
Lassen,30,2022-07-11,59,59,59,0,821,821,820,1,2,1,1,0,63,63,62,62
Los Angeles,30,2022-07-11,43325,43376,43362,14,381188,381635,381510,125,1038,90,90,115,32475,32475,32385,32385
Madera,30,2022-07-11,532,532,531,1,4126,4131,4126,5,15,0,0,3,370,370,370,370
Marin,30,2022-07-11,603,603,602,1,5929,5935,5927,8,17,1,1,1,305,305,304,304
Mariposa,30,2022-07-11,52,52,52,0,283,284,283,1,0,0,0,0,28,28,28,28
Mendocino,30,2022-07-11,190,190,190,0,1387,1387,1385,2,4,0,0,0,133,133,133,133
Merced,30,2022-07-11,764,764,763,1,4273,4278,4274,4,16,5,5,1,840,840,835,835
Modoc,30,2022-07-11,28,28,28,0,57,58,57,1,0,0,0,0,8,8,8,8
Mono,30,2022-07-11,11,11,11,0,105,106,105,1,0,0,0,0,7,7,7,7
Monterey,30,2022-07-11,1097,1097,1095,2,7952,7963,7946,17,47,5,5,3,751,751,746,746
Napa,30,2022-07-11,367,367,367,0,3664,3669,3666,3,13,1,1,1,149,149,148,148
Nevada,30,2022-07-11,221,221,221,0,1826,1826,1824,2,7,0,0,1,134,134,134,134
Orange,30,2022-07-11,9751,9763,9756,7,64160,64234,64184,50,257,20,20,30,7264,7264,7244,7244
Placer,30,2022-07-11,784,784,783,1,5963,5969,5960,9,76,2,2,8,645,645,643,643
Plumas,30,2022-07-11,71,71,71,0,282,283,282,1,0,0,0,0,13,13,13,13
Riverside,30,2022-07-11,9210,9222,9213,9,52070,52131,52077,54,225,17,17,12,6527,6527,6510,6510
Sacramento,30,2022-07-11,4212,4218,4213,5,35516,35558,35518,40,184,22,22,24,3191,3191,3169,3169
San Benito,30,2022-07-11,235,235,235,0,1666,1666,1664,2,1,0,0,0,95,95,95,95
San Bernardino,30,2022-07-11,8441,8452,8445,7,57675,57745,57697,48,188,14,14,20,7918,7918,7904,7904
San Diego,30,2022-07-11,13665,13680,13675,5,85550,85650,85620,30,332,11,11,41,5435,5435,5424,5424
San Francisco,30,2022-07-11,2999,3002,2995,7,27844,27877,27813,64,105,11,11,23,956,956,945,945
San Joaquin,30,2022-07-11,2141,2141,2138,3,19356,19378,19354,24,55,7,7,11,2286,2286,2279,2279
San Luis Obispo,30,2022-07-11,754,754,753,1,5272,5277,5272,5,22,3,3,1,504,504,501,501
San Mateo,30,2022-07-11,2778,2781,2779,2,25663,25693,25673,20,42,6,6,4,733,733,727,727
Santa Barbara,30,2022-07-11,1326,1326,1325,1,9703,9716,9706,10,46,5,5,9,710,710,705,705
Santa Clara,30,2022-07-11,7403,7411,7408,3,59984,60055,60033,22,211,12,12,38,2410,2410,2398,2398
Santa Cruz,30,2022-07-11,1031,1031,1030,1,9513,9524,9515,9,16,0,0,0,267,267,267,267
Shasta,30,2022-07-11,328,328,328,0,3565,3569,3565,4,21,2,2,6,576,576,574,574
Siskiyou,30,2022-07-11,29,29,29,0,361,362,361,1,1,1,1,1,86,86,85,85
Solano,30,2022-07-11,1632,1632,1630,2,11657,11672,11660,12,40,1,1,6,454,454,453,453
Sonoma,30,2022-07-11,1300,1300,1299,1,9943,9956,9946,10,50,0,0,7,507,507,507,507
Stanislaus,30,2022-07-11,1494,1494,1492,2,8691,8702,8688,14,103,7,7,11,1724,1724,1717,1717
Sutter,30,2022-07-11,287,287,287,0,1777,1778,1776,2,0,0,0,0,228,228,228,228
Tehama,30,2022-07-11,134,134,134,0,925,925,924,1,5,0,0,1,209,209,209,209
Trinity,30,2022-07-11,35,35,35,0,120,121,120,1,0,0,0,0,20,20,20,20
Tulare,30,2022-07-11,1386,1386,1384,2,9558,9569,9553,16,47,4,4,2,1519,1519,1515,1515
Tuolumne,30,2022-07-11,254,254,254,0,1303,1303,1301,2,6,0,0,0,191,191,191,191
Ventura,30,2022-07-11,2549,2551,2549,2,19713,19736,19722,14,89,9,9,6,1536,1536,1527,1527
Yolo,30,2022-07-11,502,502,502,0,5420,5426,5421,5,4,3,3,4,373,373,370,370
Yuba,30,2022-07-11,218,218,218,0,1402,1402,1401,1,9,0,0,1,121,121,121,121
Alameda,31,2022-07-18,4953,4960,4957,3,42950,43002,42974,28,149,10,10,25,1970,1970,1960,1960
Amador,31,2022-07-18,85,85,85,0,1348,1349,1348,1,6,0,0,1,87,87,87,87
Butte,31,2022-07-18,334,334,334,0,2794,2798,2797,1,25,1,1,3,452,452,451,451
Calaveras,31,2022-07-18,78,78,78,0,545,546,545,1,0,0,0,0,129,129,129,129
Colusa,31,2022-07-18,23,23,23,0,349,350,349,1,2,0,0,0,22,22,22,22
Contra Costa,31,2022-07-18,3059,3064,3061,3,22719,22747,22722,25,88,4,4,16,1395,1395,1391,1391
Del Norte,31,2022-07-18,168,168,168,0,705,705,704,1,7,0,0,0,53,53,53,53
El Dorado,31,2022-07-18,279,279,279,0,2638,2641,2639,2,11,1,1,1,227,227,226,226
Fresno,31,2022-07-18,3705,3710,3706,4,21099,21125,21103,22,199,9,9,15,2813,2813,2804,2804
Glenn,31,2022-07-18,34,34,34,0,263,264,263,1,0,0,0,0,53,53,53,53
Humboldt,31,2022-07-18,295,295,295,0,2026,2027,2025,2,10,0,0,4,154,154,154,154
Imperial,31,2022-07-18,1024,1024,1023,1,4434,4439,4435,4,18,2,2,3,951,951,949,949
Inyo,31,2022-07-18,30,30,30,0,332,333,332,1,0,0,0,0,57,57,57,57
Kern,31,2022-07-18,2318,2320,2318,2,16584,16605,16593,12,72,10,10,14,2381,2381,2371,2371
Kings,31,2022-07-18,708,708,707,1,4154,4159,4155,4,16,1,1,0,457,457,456,456
Lake,31,2022-07-18,132,132,132,0,993,993,992,1,3,0,0,0,142,142,142,142
Lassen,31,2022-07-18,78,78,78,0,1239,1240,1239,1,1,0,0,0,63,63,63,63
Los Angeles,31,2022-07-18,41848,41899,41888,11,352162,352592,352502,90,1162,112,112,137,32587,32587,32475,32475
Madera,31,2022-07-18,529,529,528,1,3632,3637,3633,4,5,0,0,3,370,370,370,370
Marin,31,2022-07-18,516,516,515,1,5504,5510,5504,6,12,1,1,5,306,306,305,305
Mariposa,31,2022-07-18,42,42,42,0,242,243,242,1,0,1,1,0,29,29,28,28
Mendocino,31,2022-07-18,185,185,185,0,1491,1491,1489,2,6,0,0,2,133,133,133,133
Merced,31,2022-07-18,753,753,752,1,3981,3986,3983,3,15,1,1,1,841,841,840,840
Modoc,31,2022-07-18,13,13,13,0,34,35,34,1,1,0,0,0,8,8,8,8
Mono,31,2022-07-18,10,10,10,0,85,86,85,1,1,0,0,0,7,7,7,7
Monterey,31,2022-07-18,985,985,983,2,7190,7199,7187,12,46,6,6,4,757,757,751,751
Napa,31,2022-07-18,318,318,318,0,2954,2958,2956,2,10,2,2,2,151,151,149,149
Nevada,31,2022-07-18,135,135,135,0,1331,1331,1330,1,8,0,0,3,134,134,134,134
Orange,31,2022-07-18,8792,8804,8799,5,59782,59854,59818,36,253,24,24,45,7288,7288,7264,7264
Placer,31,2022-07-18,684,684,683,1,5240,5246,5240,6,89,1,1,5,646,646,645,645
Plumas,31,2022-07-18,60,60,60,0,279,280,279,1,0,0,0,0,13,13,13,13
Riverside,31,2022-07-18,8243,8254,8247,7,48075,48134,48095,39,222,16,16,17,6543,6543,6527,6527
Sacramento,31,2022-07-18,3545,3550,3547,3,30409,30446,30420,26,180,12,12,26,3203,3203,3191,3191
San Benito,31,2022-07-18,199,199,199,0,1588,1588,1587,1,1,1,1,0,96,96,95,95
San Bernardino,31,2022-07-18,7998,8008,8003,5,53739,53806,53771,35,214,13,13,35,7931,7931,7918,7918
San Diego,31,2022-07-18,13080,13096,13092,4,79857,79954,79932,22,402,18,18,52,5453,5453,5435,5435
San Francisco,31,2022-07-18,2491,2493,2489,4,25515,25545,25500,45,111,10,10,24,966,966,956,956
San Joaquin,31,2022-07-18,2053,2053,2051,2,18028,18051,18034,17,66,2,2,11,2288,2288,2286,2286
San Luis Obispo,31,2022-07-18,559,559,559,0,4627,4632,4629,3,17,3,3,1,507,507,504,504
San Mateo,31,2022-07-18,2290,2290,2289,1,23097,23124,23110,14,33,0,0,4,733,733,733,733
Santa Barbara,31,2022-07-18,1298,1298,1297,1,9271,9283,9275,8,47,1,1,6,711,711,710,710
Santa Clara,31,2022-07-18,6194,6201,6199,2,54688,54755,54739,16,199,12,12,30,2422,2422,2410,2410
Santa Cruz,31,2022-07-18,874,874,873,1,7449,7459,7454,5,24,1,1,2,268,268,267,267
Shasta,31,2022-07-18,320,320,320,0,3209,3213,3210,3,40,3,3,3,579,579,576,576
Siskiyou,31,2022-07-18,34,34,34,0,345,346,345,1,3,0,0,0,86,86,86,86
Solano,31,2022-07-18,1246,1246,1245,1,9542,9554,9546,8,49,1,1,6,455,455,454,454
Sonoma,31,2022-07-18,1054,1054,1053,1,8748,8760,8753,7,44,0,0,5,507,507,507,507
Stanislaus,31,2022-07-18,1395,1395,1393,2,8397,8408,8397,11,109,5,5,9,1729,1729,1724,1724
Sutter,31,2022-07-18,253,253,253,0,1673,1674,1673,1,0,0,0,0,228,228,228,228
Tehama,31,2022-07-18,110,110,110,0,896,896,895,1,7,2,2,0,211,211,209,209
Trinity,31,2022-07-18,20,20,20,0,111,112,111,1,1,0,0,0,20,20,20,20
Tulare,31,2022-07-18,1185,1185,1183,2,8085,8094,8084,10,45,0,0,0,1519,1519,1519,1519
Tuolumne,31,2022-07-18,239,239,239,0,1142,1142,1141,1,7,4,4,0,195,195,191,191
Ventura,31,2022-07-18,2324,2325,2324,1,19560,19583,19572,11,92,4,4,7,1540,1540,1536,1536
Yolo,31,2022-07-18,430,430,430,0,4655,4660,4657,3,2,3,3,1,376,376,373,373
Yuba,31,2022-07-18,213,213,213,0,1292,1292,1291,1,18,0,0,0,121,121,121,121
Alameda,32,2022-07-25,4403,4410,4408,2,40434,40486,40466,20,143,12,12,19,1982,1982,1970,1970
Amador,32,2022-07-25,90,90,90,0,1206,1206,1205,1,3,0,0,1,87,87,87,87
Butte,32,2022-07-25,359,359,359,0,2945,2949,2948,1,30,1,1,2,453,453,452,452
Calaveras,32,2022-07-25,82,82,82,0,558,559,558,1,0,2,2,1,131,131,129,129
Colusa,32,2022-07-25,26,26,26,0,373,374,373,1,1,0,0,0,22,22,22,22
Contra Costa,32,2022-07-25,2824,2828,2826,2,21983,22010,21991,19,102,7,7,18,1402,1402,1395,1395
Del Norte,32,2022-07-25,67,67,67,0,534,535,534,1,6,0,0,0,53,53,53,53
El Dorado,32,2022-07-25,270,270,270,0,2485,2488,2486,2,9,1,1,0,228,228,227,227
Fresno,32,2022-07-25,3359,3364,3361,3,20377,20402,20386,16,195,6,6,29,2819,2819,2813,2813
Glenn,32,2022-07-25,31,31,31,0,271,272,271,1,0,0,0,0,53,53,53,53
Humboldt,32,2022-07-25,230,230,230,0,1923,1923,1922,1,13,2,2,4,156,156,154,154
Imperial,32,2022-07-25,873,873,872,1,4338,4343,4340,3,18,1,1,6,952,952,951,951
Inyo,32,2022-07-25,18,18,18,0,284,285,284,1,2,1,1,0,58,58,57,57
Kern,32,2022-07-25,1930,1930,1929,1,15241,15260,15251,9,82,3,3,12,2384,2384,2381,2381
Kings,32,2022-07-25,571,571,571,0,3888,3893,3890,3,15,1,1,0,458,458,457,457
Lake,32,2022-07-25,128,128,128,0,1041,1041,1040,1,5,1,1,2,143,143,142,142
Lassen,32,2022-07-25,53,53,53,0,1071,1071,1070,1,1,0,0,0,63,63,63,63
Los Angeles,32,2022-07-25,37133,37180,37173,7,334168,334589,334522,67,1152,121,121,134,32708,32708,32587,32587
Madera,32,2022-07-25,539,539,539,0,3829,3834,3831,3,11,1,1,5,371,371,370,370
Marin,32,2022-07-25,489,489,489,0,5418,5424,5420,4,26,2,2,2,308,308,306,306
Mariposa,32,2022-07-25,40,40,40,0,232,233,232,1,0,0,0,0,29,29,29,29
Mendocino,32,2022-07-25,196,196,196,0,1426,1426,1424,2,6,0,0,0,133,133,133,133
Merced,32,2022-07-25,732,732,732,0,3917,3922,3920,2,22,2,2,2,843,843,841,841
Modoc,32,2022-07-25,5,5,5,0,28,29,28,1,0,1,1,0,9,9,8,8
Mono,32,2022-07-25,15,15,15,0,85,86,85,1,0,0,0,0,7,7,7,7
Monterey,32,2022-07-25,933,933,932,1,7142,7152,7143,9,39,1,1,3,758,758,757,757
Napa,32,2022-07-25,297,297,297,0,2934,2939,2937,2,6,3,3,0,154,154,151,151
Nevada,32,2022-07-25,116,116,116,0,1316,1316,1315,1,3,1,1,0,135,135,134,134
Orange,32,2022-07-25,8025,8036,8032,4,58149,58222,58195,27,306,37,37,35,7325,7325,7288,7288
Placer,32,2022-07-25,606,606,605,1,5086,5092,5088,4,77,5,5,11,651,651,646,646
Plumas,32,2022-07-25,25,25,25,0,188,189,188,1,0,0,0,0,13,13,13,13
Riverside,32,2022-07-25,7517,7527,7522,5,45936,45994,45965,29,259,16,16,27,6559,6559,6543,6543
Sacramento,32,2022-07-25,3634,3639,3637,2,29836,29874,29854,20,207,18,18,32,3221,3221,3203,3203
San Benito,32,2022-07-25,201,201,201,0,1836,1837,1836,1,0,1,1,0,97,97,96,96
San Bernardino,32,2022-07-25,7100,7109,7105,4,52149,52214,52188,26,214,30,30,23,7961,7961,7931,7931
San Diego,32,2022-07-25,11893,11908,11905,3,76177,76273,76257,16,393,19,19,41,5472,5472,5453,5453
San Francisco,32,2022-07-25,2300,2302,2299,3,24271,24301,24267,34,126,9,9,24,975,975,966,966
San Joaquin,32,2022-07-25,1838,1838,1837,1,16572,16592,16580,12,73,5,5,9,2293,2293,2288,2288
San Luis Obispo,32,2022-07-25,539,539,539,0,4382,4387,4384,3,16,4,4,1,511,511,507,507
San Mateo,32,2022-07-25,2030,2030,2029,1,21689,21716,21706,10,57,1,1,7,734,734,733,733
Santa Barbara,32,2022-07-25,1178,1178,1177,1,8770,8782,8776,6,37,4,4,3,715,715,711,711
Santa Clara,32,2022-07-25,5772,5779,5778,1,50882,50946,50935,11,238,16,16,26,2438,2438,2422,2422
Santa Cruz,32,2022-07-25,832,832,832,0,7665,7676,7672,4,23,0,0,0,268,268,268,268
Shasta,32,2022-07-25,306,306,306,0,3079,3082,3080,2,38,2,2,6,581,581,579,579
Siskiyou,32,2022-07-25,36,36,36,0,333,334,333,1,1,0,0,0,86,86,86,86
Solano,32,2022-07-25,1203,1203,1202,1,9480,9492,9486,6,56,0,0,5,455,455,455,455
Sonoma,32,2022-07-25,1066,1066,1065,1,8654,8666,8661,5,48,2,2,4,509,509,507,507
Stanislaus,32,2022-07-25,1377,1377,1376,1,8160,8171,8163,8,104,8,8,11,1737,1737,1729,1729
Sutter,32,2022-07-25,222,222,222,0,1723,1724,1723,1,0,0,0,0,228,228,228,228
Tehama,32,2022-07-25,103,103,103,0,920,920,919,1,5,2,2,0,213,213,211,211
Trinity,32,2022-07-25,12,12,12,0,102,103,102,1,0,0,0,0,20,20,20,20
Tulare,32,2022-07-25,1144,1144,1143,1,8016,8026,8018,8,42,2,2,2,1521,1521,1519,1519
Tuolumne,32,2022-07-25,200,200,200,0,1150,1150,1149,1,5,1,1,0,196,196,195,195
Ventura,32,2022-07-25,2153,2154,2153,1,18389,18412,18404,8,76,5,5,8,1545,1545,1540,1540
Yolo,32,2022-07-25,414,414,414,0,4394,4399,4397,2,4,3,3,1,379,379,376,376
Yuba,32,2022-07-25,175,175,175,0,1282,1282,1281,1,15,0,0,0,121,121,121,121
Alameda,33,2022-08-01,3818,3823,3822,1,37191,37239,37224,15,176,8,8,21,1990,1990,1982,1982
Amador,33,2022-08-01,53,53,53,0,1133,1133,1132,1,3,1,1,0,88,88,87,87
Butte,33,2022-08-01,368,368,368,0,2841,2844,2843,1,33,2,2,3,455,455,453,453
Calaveras,33,2022-08-01,68,68,68,0,573,574,573,1,2,1,1,2,132,132,131,131
Colusa,33,2022-08-01,26,26,26,0,362,363,362,1,7,0,0,0,22,22,22,22
Contra Costa,33,2022-08-01,2629,2632,2630,2,21022,21049,21035,14,86,13,13,15,1415,1415,1402,1402
Del Norte,33,2022-08-01,53,53,53,0,476,477,476,1,4,0,0,2,53,53,53,53
El Dorado,33,2022-08-01,232,232,232,0,2456,2460,2459,1,4,3,3,2,231,231,228,228
Fresno,33,2022-08-01,2999,3004,3002,2,18295,18319,18308,11,231,10,10,16,2829,2829,2819,2819
Glenn,33,2022-08-01,28,28,28,0,251,252,251,1,0,0,0,0,53,53,53,53
Humboldt,33,2022-08-01,224,224,224,0,1880,1880,1879,1,12,0,0,3,156,156,156,156
Imperial,33,2022-08-01,636,636,636,0,3526,3531,3529,2,22,5,5,3,957,957,952,952
Inyo,33,2022-08-01,20,20,20,0,280,281,280,1,2,0,0,0,58,58,58,58
Kern,33,2022-08-01,1729,1729,1728,1,15102,15120,15113,7,81,6,6,17,2390,2390,2384,2384
Kings,33,2022-08-01,624,624,624,0,4044,4049,4047,2,6,0,0,1,458,458,458,458
Lake,33,2022-08-01,125,125,125,0,994,994,993,1,7,0,0,2,143,143,143,143
Lassen,33,2022-08-01,103,103,103,0,947,949,948,1,0,0,0,0,63,63,63,63
Los Angeles,33,2022-08-01,30602,30642,30637,5,308955,309358,309310,48,1105,129,129,137,32837,32837,32708,32708
Madera,33,2022-08-01,463,463,463,0,3481,3485,3483,2,10,0,0,7,371,371,371,371
Marin,33,2022-08-01,411,411,411,0,5134,5140,5137,3,32,1,1,4,309,309,308,308
Mariposa,33,2022-08-01,22,22,22,0,225,226,225,1,0,0,0,0,29,29,29,29
Mendocino,33,2022-08-01,174,174,174,0,1257,1257,1256,1,6,1,1,1,134,134,133,133
Merced,33,2022-08-01,644,644,644,0,3568,3573,3571,2,22,6,6,2,849,849,843,843
Modoc,33,2022-08-01,16,16,16,0,31,32,31,1,0,0,0,0,9,9,9,9
Mono,33,2022-08-01,9,9,9,0,67,68,67,1,0,0,0,0,7,7,7,7
Monterey,33,2022-08-01,930,930,929,1,6430,6439,6433,6,33,2,2,1,760,760,758,758
Napa,33,2022-08-01,282,282,282,0,2838,2843,2842,1,8,0,0,2,154,154,154,154
Nevada,33,2022-08-01,125,125,125,0,1404,1404,1403,1,12,0,0,0,135,135,135,135
Orange,33,2022-08-01,6506,6514,6512,2,52428,52496,52477,19,246,34,34,49,7359,7359,7325,7325
Placer,33,2022-08-01,588,588,588,0,4744,4750,4747,3,71,1,1,11,652,652,651,651
Plumas,33,2022-08-01,23,23,23,0,162,163,162,1,0,0,0,0,13,13,13,13
Riverside,33,2022-08-01,6127,6134,6131,3,42288,42342,42321,21,200,5,5,23,6564,6564,6559,6559
Sacramento,33,2022-08-01,3096,3101,3099,2,27844,27880,27865,15,179,18,18,26,3239,3239,3221,3221
San Benito,33,2022-08-01,177,177,177,0,1561,1561,1560,1,2,1,1,0,98,98,97,97
San Bernardino,33,2022-08-01,6070,6079,6077,2,48923,48986,48967,19,184,26,26,23,7987,7987,7961,7961
San Diego,33,2022-08-01,9366,9378,9376,2,68645,68735,68724,11,396,16,16,46,5488,5488,5472,5472
San Francisco,33,2022-08-01,1815,1816,1814,2,21993,22021,21997,24,105,13,13,20,988,988,975,975
San Joaquin,33,2022-08-01,1734,1734,1733,1,16113,16134,16125,9,69,7,7,11,2300,2300,2293,2293
San Luis Obispo,33,2022-08-01,578,578,578,0,4141,4146,4144,2,14,3,3,0,514,514,511,511
San Mateo,33,2022-08-01,1774,1774,1773,1,20333,20360,20353,7,67,1,1,3,735,735,734,734
Santa Barbara,33,2022-08-01,1119,1119,1118,1,7779,7790,7786,4,40,1,1,3,716,716,715,715
Santa Clara,33,2022-08-01,4827,4834,4833,1,45490,45549,45541,8,230,19,19,36,2457,2457,2438,2438
Santa Cruz,33,2022-08-01,748,748,748,0,6877,6886,6883,3,20,1,1,3,269,269,268,268
Shasta,33,2022-08-01,247,247,247,0,2968,2972,2970,2,34,1,1,7,582,582,581,581
Siskiyou,33,2022-08-01,29,29,29,0,298,299,298,1,2,0,0,0,86,86,86,86
Solano,33,2022-08-01,1145,1145,1144,1,9145,9157,9152,5,53,0,0,4,455,455,455,455
Sonoma,33,2022-08-01,921,921,921,0,8185,8197,8193,4,46,3,3,3,512,512,509,509
Stanislaus,33,2022-08-01,1233,1233,1232,1,7720,7730,7724,6,115,6,6,8,1743,1743,1737,1737
Sutter,33,2022-08-01,232,232,232,0,1634,1635,1634,1,0,3,3,0,231,231,228,228
Tehama,33,2022-08-01,89,89,89,0,757,757,756,1,4,0,0,0,213,213,213,213
Trinity,33,2022-08-01,11,11,11,0,71,72,71,1,0,1,1,0,21,21,20,20
Tulare,33,2022-08-01,1035,1035,1034,1,7463,7472,7466,6,46,1,1,3,1522,1522,1521,1521
Tuolumne,33,2022-08-01,144,144,144,0,1111,1111,1110,1,4,0,0,1,196,196,196,196
Ventura,33,2022-08-01,1808,1808,1807,1,16969,16991,16985,6,75,10,10,10,1555,1555,1545,1545
Yolo,33,2022-08-01,333,333,333,0,4181,4186,4184,2,3,3,3,1,382,382,379,379
Yuba,33,2022-08-01,159,159,159,0,1215,1215,1214,1,10,0,0,3,121,121,121,121
Alameda,34,2022-08-08,3314,3319,3318,1,35421,35469,35458,11,133,15,15,20,2005,2005,1990,1990
Amador,34,2022-08-08,50,50,50,0,852,853,852,1,3,0,0,1,88,88,88,88
Butte,34,2022-08-08,334,334,334,0,2494,2497,2496,1,33,1,1,1,456,456,455,455
Calaveras,34,2022-08-08,57,57,57,0,559,560,559,1,1,1,1,0,133,133,132,132
Colusa,34,2022-08-08,15,15,15,0,362,363,362,1,0,0,0,0,22,22,22,22
Contra Costa,34,2022-08-08,2179,2181,2180,1,19806,19833,19823,10,102,4,4,14,1419,1419,1415,1415
Del Norte,34,2022-08-08,49,49,49,0,498,499,498,1,4,1,1,1,54,54,53,53
El Dorado,34,2022-08-08,191,191,191,0,2317,2320,2319,1,4,0,0,2,231,231,231,231
Fresno,34,2022-08-08,2421,2425,2424,1,17742,17765,17756,9,207,9,9,25,2838,2838,2829,2829
Glenn,34,2022-08-08,22,22,22,0,249,250,249,1,0,0,0,0,53,53,53,53
Humboldt,34,2022-08-08,208,208,208,0,1920,1922,1921,1,12,1,1,2,157,157,156,156
Imperial,34,2022-08-08,548,548,548,0,3279,3284,3283,1,16,2,2,2,959,959,957,957
Inyo,34,2022-08-08,8,8,8,0,276,277,276,1,1,0,0,1,58,58,58,58
Kern,34,2022-08-08,1339,1339,1339,0,13982,14001,13996,5,61,6,6,16,2396,2396,2390,2390
Kings,34,2022-08-08,467,467,467,0,3326,3331,3330,1,20,1,1,2,459,459,458,458
Lake,34,2022-08-08,106,106,106,0,893,894,893,1,4,0,0,1,143,143,143,143
Lassen,34,2022-08-08,132,132,132,0,1023,1024,1023,1,1,0,0,0,63,63,63,63
Los Angeles,34,2022-08-08,25782,25816,25813,3,293374,293767,293732,35,1030,129,129,121,32966,32966,32837,32837
Madera,34,2022-08-08,380,380,380,0,3175,3180,3178,2,16,0,0,3,371,371,371,371
Marin,34,2022-08-08,361,361,361,0,4485,4491,4489,2,26,2,2,2,311,311,309,309
Mariposa,34,2022-08-08,28,28,28,0,197,198,197,1,0,0,0,0,29,29,29,29
Mendocino,34,2022-08-08,132,132,132,0,1128,1128,1127,1,3,1,1,1,135,135,134,134
Merced,34,2022-08-08,538,538,538,0,3396,3401,3400,1,17,1,1,5,850,850,849,849
Modoc,34,2022-08-08,2,2,2,0,22,23,22,1,0,0,0,0,9,9,9,9
Mono,34,2022-08-08,10,10,10,0,85,86,85,1,0,0,0,0,7,7,7,7
Monterey,34,2022-08-08,736,736,735,1,5773,5781,5777,4,28,1,1,0,761,761,760,760
Napa,34,2022-08-08,252,252,252,0,2614,2619,2618,1,10,2,2,3,156,156,154,154
Nevada,34,2022-08-08,94,94,94,0,1290,1290,1289,1,4,0,0,0,135,135,135,135
Orange,34,2022-08-08,5435,5442,5440,2,48983,49049,49035,14,242,29,29,40,7388,7388,7359,7359
Placer,34,2022-08-08,513,513,513,0,4519,4525,4523,2,65,3,3,9,655,655,652,652
Plumas,34,2022-08-08,23,23,23,0,190,191,190,1,1,0,0,0,13,13,13,13
Riverside,34,2022-08-08,5566,5573,5571,2,40848,40901,40885,16,174,13,13,13,6577,6577,6564,6564
Sacramento,34,2022-08-08,2625,2630,2629,1,26972,27008,26997,11,156,17,17,20,3256,3256,3239,3239
San Benito,34,2022-08-08,186,186,186,0,1433,1434,1433,1,1,0,0,0,98,98,98,98
San Bernardino,34,2022-08-08,5111,5118,5116,2,46297,46358,46344,14,204,20,20,15,8007,8007,7987,7987
San Diego,34,2022-08-08,7269,7280,7279,1,64799,64885,64877,8,337,11,11,30,5499,5499,5488,5488
San Francisco,34,2022-08-08,1495,1495,1494,1,20636,20664,20647,17,94,11,11,21,999,999,988,988
San Joaquin,34,2022-08-08,1522,1522,1521,1,15717,15737,15730,7,55,6,6,12,2306,2306,2300,2300
San Luis Obispo,34,2022-08-08,509,509,509,0,3613,3618,3617,1,14,0,0,2,514,514,514,514
San Mateo,34,2022-08-08,1528,1528,1528,0,18588,18613,18608,5,60,0,0,5,735,735,735,735
Santa Barbara,34,2022-08-08,964,964,964,0,7525,7535,7532,3,46,3,3,4,719,719,716,716
Santa Clara,34,2022-08-08,4184,4191,4190,1,41197,41251,41245,6,203,17,17,40,2474,2474,2457,2457
Santa Cruz,34,2022-08-08,619,619,619,0,6060,6067,6065,2,28,1,1,0,270,270,269,269
Shasta,34,2022-08-08,200,200,200,0,2833,2836,2835,1,33,1,1,3,583,583,582,582
Siskiyou,34,2022-08-08,27,27,27,0,291,292,291,1,0,1,1,0,87,87,86,86
Solano,34,2022-08-08,883,883,883,0,7967,7977,7974,3,54,0,0,9,455,455,455,455
Sonoma,34,2022-08-08,839,839,839,0,7726,7737,7734,3,34,4,4,3,516,516,512,512
Stanislaus,34,2022-08-08,1035,1035,1034,1,7175,7185,7181,4,90,7,7,11,1750,1750,1743,1743
Sutter,34,2022-08-08,223,223,223,0,1552,1553,1552,1,0,0,0,0,231,231,231,231
Tehama,34,2022-08-08,78,78,78,0,681,682,681,1,0,0,0,1,213,213,213,213
Trinity,34,2022-08-08,5,5,5,0,71,72,71,1,0,0,0,0,21,21,21,21
Tulare,34,2022-08-08,885,885,884,1,7321,7330,7326,4,46,4,4,3,1526,1526,1522,1522
Tuolumne,34,2022-08-08,118,118,118,0,1054,1054,1053,1,4,2,2,0,198,198,196,196
Ventura,34,2022-08-08,1503,1503,1503,0,15931,15953,15949,4,67,7,7,7,1562,1562,1555,1555
Yolo,34,2022-08-08,287,287,287,0,3883,3888,3887,1,4,1,1,3,383,383,382,382
Yuba,34,2022-08-08,136,136,136,0,1086,1087,1086,1,6,1,1,0,122,122,121,121
Alameda,35,2022-08-15,2595,2599,2598,1,33888,33935,33927,8,105,9,9,22,2014,2014,2005,2005
Amador,35,2022-08-15,47,47,47,0,848,849,848,1,2,0,0,0,88,88,88,88
Butte,35,2022-08-15,262,262,262,0,2245,2249,2248,1,19,0,0,2,456,456,456,456
Calaveras,35,2022-08-15,46,46,46,0,528,529,528,1,0,0,0,0,133,133,133,133
Colusa,35,2022-08-15,16,16,16,0,359,360,359,1,1,0,0,0,22,22,22,22
Contra Costa,35,2022-08-15,1778,1779,1778,1,18975,19002,18994,8,72,7,7,9,1426,1426,1419,1419
Del Norte,35,2022-08-15,53,53,53,0,499,500,499,1,2,0,0,1,54,54,54,54
El Dorado,35,2022-08-15,178,178,178,0,2304,2306,2305,1,5,0,0,3,231,231,231,231
Fresno,35,2022-08-15,1871,1871,1870,1,16162,16185,16179,6,170,7,7,17,2845,2845,2838,2838
Glenn,35,2022-08-15,15,15,15,0,225,226,225,1,3,0,0,0,53,53,53,53
Humboldt,35,2022-08-15,179,179,179,0,1587,1588,1587,1,16,0,0,2,157,157,157,157
Imperial,35,2022-08-15,365,365,365,0,3101,3106,3105,1,11,0,0,2,959,959,959,959
Inyo,35,2022-08-15,14,14,14,0,238,239,238,1,2,1,1,0,59,59,58,58
Kern,35,2022-08-15,1237,1237,1237,0,13701,13720,13716,4,59,7,7,16,2403,2403,2396,2396
Kings,35,2022-08-15,332,332,332,0,3235,3240,3239,1,9,0,0,1,459,459,459,459
Lake,35,2022-08-15,104,104,104,0,1028,1029,1028,1,3,1,1,2,144,144,143,143
Lassen,35,2022-08-15,59,59,59,0,898,899,898,1,0,0,0,0,63,63,63,63
Los Angeles,35,2022-08-15,20945,20974,20972,2,289521,289922,289895,27,905,110,110,117,33076,33076,32966,32966
Madera,35,2022-08-15,305,305,305,0,2954,2958,2957,1,12,0,0,3,371,371,371,371
Marin,35,2022-08-15,295,295,295,0,4114,4119,4117,2,15,0,0,0,311,311,311,311
Mariposa,35,2022-08-15,15,15,15,0,192,193,192,1,0,0,0,0,29,29,29,29
Mendocino,35,2022-08-15,104,104,104,0,996,996,995,1,7,0,0,3,135,135,135,135
Merced,35,2022-08-15,453,453,453,0,3427,3432,3431,1,12,2,2,1,852,852,850,850
Modoc,35,2022-08-15,4,4,4,0,23,24,23,1,0,0,0,0,9,9,9,9
Mono,35,2022-08-15,4,4,4,0,61,62,61,1,0,0,0,0,7,7,7,7
Monterey,35,2022-08-15,662,662,662,0,5824,5832,5829,3,30,0,0,1,761,761,761,761
Napa,35,2022-08-15,212,212,212,0,2280,2284,2283,1,13,0,0,0,156,156,156,156
Nevada,35,2022-08-15,98,98,98,0,1209,1210,1209,1,7,0,0,0,135,135,135,135
Orange,35,2022-08-15,4662,4669,4668,1,43732,43793,43783,10,270,31,31,44,7419,7419,7388,7388
Placer,35,2022-08-15,411,411,411,0,4469,4475,4473,2,61,1,1,11,656,656,655,655
Plumas,35,2022-08-15,17,17,17,0,184,185,184,1,0,0,0,0,13,13,13,13
Riverside,35,2022-08-15,4599,4606,4605,1,38259,38313,38302,11,143,16,16,22,6593,6593,6577,6577
Sacramento,35,2022-08-15,2359,2362,2361,1,25434,25469,25461,8,149,12,12,22,3268,3268,3256,3256
San Benito,35,2022-08-15,140,140,140,0,1336,1337,1336,1,3,1,1,1,99,99,98,98
San Bernardino,35,2022-08-15,4737,4744,4743,1,44505,44568,44557,11,144,14,14,22,8021,8021,8007,8007
San Diego,35,2022-08-15,5502,5509,5508,1,59786,59867,59861,6,288,14,14,34,5513,5513,5499,5499
San Francisco,35,2022-08-15,1267,1267,1266,1,19587,19615,19602,13,103,15,15,11,1014,1014,999,999
San Joaquin,35,2022-08-15,1443,1443,1442,1,15216,15237,15232,5,64,8,8,8,2314,2314,2306,2306
San Luis Obispo,35,2022-08-15,325,325,325,0,3302,3307,3306,1,15,4,4,3,518,518,514,514
San Mateo,35,2022-08-15,1235,1235,1235,0,17463,17487,17483,4,56,1,1,5,736,736,735,735
Santa Barbara,35,2022-08-15,831,831,831,0,7130,7141,7139,2,44,1,1,4,720,720,719,719
Santa Clara,35,2022-08-15,3400,3405,3405,0,40109,40164,40160,4,200,8,8,24,2482,2482,2474,2474
Santa Cruz,35,2022-08-15,493,493,493,0,7545,7554,7552,2,23,3,3,1,273,273,270,270
Shasta,35,2022-08-15,194,194,194,0,2788,2791,2790,1,19,1,1,1,584,584,583,583
Siskiyou,35,2022-08-15,19,19,19,0,284,285,284,1,3,0,0,1,87,87,87,87
Solano,35,2022-08-15,662,662,662,0,7459,7469,7467,2,45,0,0,10,455,455,455,455
Sonoma,35,2022-08-15,632,632,632,0,7288,7299,7297,2,39,2,2,2,518,518,516,516
Stanislaus,35,2022-08-15,940,940,940,0,7658,7670,7666,4,99,9,9,11,1759,1759,1750,1750
Sutter,35,2022-08-15,197,197,197,0,1587,1589,1588,1,0,1,1,0,232,232,231,231
Tehama,35,2022-08-15,60,60,60,0,645,646,645,1,1,0,0,0,213,213,213,213
Trinity,35,2022-08-15,8,8,8,0,58,59,58,1,0,0,0,0,21,21,21,21
Tulare,35,2022-08-15,735,735,735,0,7328,7337,7334,3,32,3,3,1,1529,1529,1526,1526
Tuolumne,35,2022-08-15,110,110,110,0,991,992,991,1,1,0,0,0,198,198,198,198
Ventura,35,2022-08-15,1494,1494,1494,0,15264,15285,15282,3,70,6,6,7,1568,1568,1562,1562
Yolo,35,2022-08-15,264,264,264,0,3542,3547,3546,1,2,4,4,1,387,387,383,383
Yuba,35,2022-08-15,128,128,128,0,1080,1081,1080,1,9,0,0,0,122,122,122,122
Alameda,36,2022-08-22,2259,2262,2262,0,33321,33369,33363,6,117,9,9,21,2023,2023,2014,2014
Amador,36,2022-08-22,49,49,49,0,817,818,817,1,2,1,1,0,89,89,88,88
Butte,36,2022-08-22,222,222,222,0,2131,2135,2134,1,17,1,1,2,457,457,456,456
Calaveras,36,2022-08-22,43,43,43,0,572,573,572,1,1,0,0,0,133,133,133,133
Colusa,36,2022-08-22,16,16,16,0,394,395,394,1,0,0,0,0,22,22,22,22
Contra Costa,36,2022-08-22,1532,1532,1532,0,18845,18873,18867,6,56,5,5,9,1431,1431,1426,1426
Del Norte,36,2022-08-22,32,32,32,0,462,463,462,1,3,1,1,0,55,55,54,54
El Dorado,36,2022-08-22,152,152,152,0,2220,2223,2222,1,4,1,1,0,232,232,231,231
Fresno,36,2022-08-22,1597,1597,1597,0,15769,15793,15788,5,162,6,6,14,2851,2851,2845,2845
Glenn,36,2022-08-22,23,23,23,0,227,228,227,1,1,0,0,0,53,53,53,53
Humboldt,36,2022-08-22,151,151,151,0,1679,1680,1679,1,6,1,1,3,158,158,157,157
Imperial,36,2022-08-22,291,291,291,0,2846,2851,2850,1,15,0,0,0,959,959,959,959
Inyo,36,2022-08-22,8,8,8,0,214,215,214,1,0,0,0,0,59,59,59,59
Kern,36,2022-08-22,999,999,999,0,13976,13995,13992,3,69,6,6,10,2409,2409,2403,2403
Kings,36,2022-08-22,369,369,369,0,3636,3641,3640,1,10,2,2,0,461,461,459,459
Lake,36,2022-08-22,104,104,104,0,884,885,884,1,5,0,0,0,144,144,144,144
Lassen,36,2022-08-22,37,37,37,0,834,835,834,1,0,0,0,0,63,63,63,63
Los Angeles,36,2022-08-22,18485,18512,18511,1,276782,277187,277167,20,811,121,121,104,33197,33197,33076,33076
Madera,36,2022-08-22,300,300,300,0,2613,2617,2616,1,14,2,2,4,373,373,371,371
Marin,36,2022-08-22,250,250,250,0,3968,3974,3973,1,17,0,0,3,311,311,311,311
Mariposa,36,2022-08-22,14,14,14,0,172,173,172,1,0,0,0,0,29,29,29,29
Mendocino,36,2022-08-22,121,121,121,0,1145,1146,1145,1,3,0,0,2,135,135,135,135
Merced,36,2022-08-22,447,447,447,0,3659,3664,3663,1,12,4,4,1,856,856,852,852
Modoc,36,2022-08-22,6,6,6,0,27,28,27,1,0,0,0,0,9,9,9,9
Mono,36,2022-08-22,4,4,4,0,63,64,63,1,0,0,0,0,7,7,7,7
Monterey,36,2022-08-22,549,549,549,0,5927,5936,5933,3,27,1,1,2,762,762,761,761
Napa,36,2022-08-22,127,127,127,0,2002,2006,2005,1,5,2,2,1,158,158,156,156
Nevada,36,2022-08-22,84,84,84,0,1180,1181,1180,1,6,0,0,0,135,135,135,135
Orange,36,2022-08-22,3895,3901,3900,1,41427,41488,41481,7,224,21,21,35,7440,7440,7419,7419
Placer,36,2022-08-22,384,384,384,0,4307,4313,4312,1,61,1,1,14,657,657,656,656
Plumas,36,2022-08-22,20,20,20,0,175,176,175,1,1,0,0,0,13,13,13,13
Riverside,36,2022-08-22,4420,4427,4426,1,37724,37780,37771,9,142,14,14,19,6607,6607,6593,6593
Sacramento,36,2022-08-22,2089,2091,2090,1,25029,25065,25059,6,144,15,15,25,3283,3283,3268,3268
San Benito,36,2022-08-22,102,102,102,0,1268,1270,1269,1,1,1,1,1,100,100,99,99
San Bernardino,36,2022-08-22,4696,4703,4702,1,44668,44733,44725,8,160,18,18,22,8039,8039,8021,8021
San Diego,36,2022-08-22,4783,4790,4790,0,57812,57899,57895,4,287,6,6,28,5519,5519,5513,5513
San Francisco,36,2022-08-22,1097,1097,1096,1,18875,18903,18893,10,81,16,16,12,1030,1030,1014,1014
San Joaquin,36,2022-08-22,1196,1196,1196,0,15725,15748,15744,4,56,1,1,8,2315,2315,2314,2314
San Luis Obispo,36,2022-08-22,259,259,259,0,3090,3095,3094,1,16,1,1,0,519,519,518,518
San Mateo,36,2022-08-22,1028,1028,1028,0,17321,17346,17343,3,42,0,0,2,736,736,736,736
Santa Barbara,36,2022-08-22,736,736,736,0,7443,7455,7453,2,37,1,1,2,721,721,720,720
Santa Clara,36,2022-08-22,3078,3083,3083,0,40559,40618,40615,3,173,10,10,27,2492,2492,2482,2482
Santa Cruz,36,2022-08-22,502,502,502,0,11965,11983,11981,2,13,0,0,0,273,273,273,273
Shasta,36,2022-08-22,174,174,174,0,2760,2764,2763,1,10,2,2,2,586,586,584,584
Siskiyou,36,2022-08-22,25,25,25,0,249,250,249,1,4,1,1,2,88,88,87,87
Solano,36,2022-08-22,534,534,534,0,7220,7230,7228,2,35,0,0,12,455,455,455,455
Sonoma,36,2022-08-22,605,605,605,0,7374,7386,7384,2,42,1,1,1,519,519,518,518
Stanislaus,36,2022-08-22,894,894,894,0,7650,7662,7659,3,79,7,7,16,1766,1766,1759,1759
Sutter,36,2022-08-22,189,189,189,0,1657,1659,1658,1,0,0,0,0,232,232,232,232
Tehama,36,2022-08-22,53,53,53,0,629,630,629,1,1,0,0,0,213,213,213,213
Trinity,36,2022-08-22,10,10,10,0,63,64,63,1,0,0,0,0,21,21,21,21
Tulare,36,2022-08-22,731,731,731,0,6786,6795,6793,2,33,4,4,1,1533,1533,1529,1529
Tuolumne,36,2022-08-22,106,106,106,0,1018,1019,1018,1,0,1,1,0,199,199,198,198
Ventura,36,2022-08-22,1319,1319,1319,0,15001,15024,15022,2,59,4,4,9,1572,1572,1568,1568
Yolo,36,2022-08-22,200,200,200,0,3495,3500,3499,1,10,1,1,1,388,388,387,387
Yuba,36,2022-08-22,127,127,127,0,1106,1107,1106,1,13,0,0,3,122,122,122,122
Alameda,37,2022-08-29,1990,1992,1992,0,34350,34402,34397,5,99,11,11,20,2034,2034,2023,2023
Amador,37,2022-08-29,46,46,46,0,804,805,804,1,2,1,1,0,90,90,89,89
Butte,37,2022-08-29,236,236,236,0,2173,2178,2177,1,18,0,0,3,457,457,457,457
Calaveras,37,2022-08-29,59,59,59,0,593,594,593,1,1,0,0,0,133,133,133,133
Colusa,37,2022-08-29,11,11,11,0,329,330,329,1,3,0,0,0,22,22,22,22
Contra Costa,37,2022-08-29,1359,1359,1359,0,18808,18838,18833,5,44,5,5,7,1436,1436,1431,1431
Del Norte,37,2022-08-29,28,28,28,0,432,433,432,1,5,0,0,1,55,55,55,55
El Dorado,37,2022-08-29,143,143,143,0,1947,1951,1950,1,1,0,0,1,232,232,232,232
Fresno,37,2022-08-29,1419,1419,1419,0,15724,15747,15743,4,159,3,3,15,2854,2854,2851,2851
Glenn,37,2022-08-29,22,22,22,0,220,221,220,1,1,0,0,0,53,53,53,53
Humboldt,37,2022-08-29,124,124,124,0,1664,1666,1665,1,4,0,0,0,158,158,158,158
Imperial,37,2022-08-29,294,294,294,0,2936,2941,2940,1,14,1,1,2,960,960,959,959
Inyo,37,2022-08-29,8,8,8,0,176,177,176,1,0,0,0,0,59,59,59,59
Kern,37,2022-08-29,906,906,906,0,13447,13466,13464,2,50,0,0,8,2409,2409,2409,2409
Kings,37,2022-08-29,314,314,314,0,3490,3495,3494,1,8,0,0,0,461,461,461,461
Lake,37,2022-08-29,93,93,93,0,870,871,870,1,1,1,1,0,145,145,144,144
Lassen,37,2022-08-29,28,28,28,0,772,773,772,1,0,0,0,0,63,63,63,63
Los Angeles,37,2022-08-29,15564,15587,15586,1,273746,274163,274147,16,753,87,87,83,33284,33284,33197,33197
Madera,37,2022-08-29,302,302,302,0,3019,3023,3022,1,13,0,0,3,373,373,373,373
Marin,37,2022-08-29,215,215,215,0,3848,3854,3853,1,16,2,2,2,313,313,311,311
Mariposa,37,2022-08-29,25,25,25,0,186,187,186,1,0,0,0,0,29,29,29,29
Mendocino,37,2022-08-29,87,87,87,0,969,970,969,1,2,0,0,1,135,135,135,135
Merced,37,2022-08-29,393,393,393,0,3418,3423,3422,1,11,3,3,0,859,859,856,856
Modoc,37,2022-08-29,1,1,1,0,30,31,30,1,0,0,0,0,9,9,9,9
Mono,37,2022-08-29,2,2,2,0,45,46,45,1,0,0,0,0,7,7,7,7
Monterey,37,2022-08-29,395,395,395,0,5383,5390,5388,2,33,2,2,5,764,764,762,762
Napa,37,2022-08-29,129,129,129,0,2161,2165,2164,1,10,0,0,1,158,158,158,158
Nevada,37,2022-08-29,116,116,116,0,1206,1208,1207,1,6,0,0,0,135,135,135,135
Orange,37,2022-08-29,3032,3037,3037,0,39953,40013,40008,5,195,18,18,25,7458,7458,7440,7440
Placer,37,2022-08-29,370,370,370,0,4217,4223,4222,1,55,1,1,12,658,658,657,657
Plumas,37,2022-08-29,17,17,17,0,159,160,159,1,1,0,0,0,13,13,13,13
Riverside,37,2022-08-29,3677,3684,3683,1,37023,37080,37073,7,124,9,9,11,6616,6616,6607,6607
Sacramento,37,2022-08-29,1880,1882,1882,0,24822,24860,24855,5,137,11,11,20,3294,3294,3283,3283
San Benito,37,2022-08-29,120,120,120,0,1410,1412,1411,1,1,0,0,0,100,100,100,100
San Bernardino,37,2022-08-29,3681,3687,3686,1,42583,42647,42641,6,156,14,14,18,8053,8053,8039,8039
San Diego,37,2022-08-29,3932,3939,3939,0,56917,57003,57000,3,222,12,12,25,5531,5531,5519,5519
San Francisco,37,2022-08-29,873,873,873,0,19156,19186,19178,8,57,7,7,12,1037,1037,1030,1030
San Joaquin,37,2022-08-29,1005,1005,1005,0,14298,14320,14317,3,27,5,5,11,2320,2320,2315,2315
San Luis Obispo,37,2022-08-29,326,326,326,0,3217,3222,3221,1,17,3,3,0,522,522,519,519
San Mateo,37,2022-08-29,872,872,872,0,16902,16927,16925,2,26,0,0,5,736,736,736,736
Santa Barbara,37,2022-08-29,638,638,638,0,7627,7638,7637,1,24,1,1,3,722,722,721,721
Santa Clara,37,2022-08-29,2357,2361,2361,0,40001,40062,40059,3,135,5,5,24,2497,2497,2492,2492
Santa Cruz,37,2022-08-29,385,385,385,0,12686,12704,12702,2,16,0,0,1,273,273,273,273
Shasta,37,2022-08-29,134,134,134,0,2578,2582,2581,1,19,1,1,1,587,587,586,586
Siskiyou,37,2022-08-29,24,24,24,0,249,250,249,1,0,1,1,0,89,89,88,88
Solano,37,2022-08-29,549,549,549,0,7289,7302,7301,1,33,1,1,8,456,456,455,455
Sonoma,37,2022-08-29,486,486,486,0,7108,7120,7119,1,37,1,1,4,520,520,519,519
Stanislaus,37,2022-08-29,850,850,850,0,8084,8097,8095,2,79,7,7,6,1773,1773,1766,1766
Sutter,37,2022-08-29,170,170,170,0,1638,1640,1639,1,0,0,0,0,232,232,232,232
Tehama,37,2022-08-29,67,67,67,0,738,739,738,1,4,0,0,1,213,213,213,213
Trinity,37,2022-08-29,9,9,9,0,56,57,56,1,0,0,0,0,21,21,21,21
Tulare,37,2022-08-29,682,682,682,0,7375,7385,7383,2,42,0,0,1,1533,1533,1533,1533
Tuolumne,37,2022-08-29,91,91,91,0,856,857,856,1,1,0,0,0,199,199,199,199
Ventura,37,2022-08-29,1021,1021,1021,0,14607,14630,14628,2,71,6,6,7,1578,1578,1572,1572
Yolo,37,2022-08-29,204,204,204,0,3718,3723,3722,1,5,0,0,3,388,388,388,388
Yuba,37,2022-08-29,135,135,135,0,1176,1177,1176,1,14,0,0,1,122,122,122,122
Alameda,38,2022-09-05,1460,1461,1461,0,28345,28389,28386,3,89,4,4,16,2038,2038,2034,2034
Amador,38,2022-09-05,44,44,44,0,748,749,748,1,3,0,0,2,90,90,90,90
Butte,38,2022-09-05,193,193,193,0,2125,2129,2128,1,14,2,2,2,459,459,457,457
Calaveras,38,2022-09-05,22,22,22,0,452,453,452,1,0,0,0,0,133,133,133,133
Colusa,38,2022-09-05,8,8,8,0,197,198,197,1,2,0,0,0,22,22,22,22
Contra Costa,38,2022-09-05,954,954,954,0,15436,15461,15458,3,62,5,5,9,1441,1441,1436,1436
Del Norte,38,2022-09-05,9,9,9,0,347,348,347,1,1,0,0,1,55,55,55,55
El Dorado,38,2022-09-05,91,91,91,0,1524,1527,1526,1,3,1,1,3,233,233,232,232
Fresno,38,2022-09-05,1087,1087,1087,0,13046,13065,13063,2,162,10,10,16,2864,2864,2854,2854
Glenn,38,2022-09-05,11,11,11,0,188,189,188,1,1,0,0,0,53,53,53,53
Humboldt,38,2022-09-05,110,110,110,0,1295,1296,1295,1,9,1,1,2,159,159,158,158
Imperial,38,2022-09-05,235,235,235,0,2522,2527,2526,1,8,1,1,2,961,961,960,960
Inyo,38,2022-09-05,12,12,12,0,139,140,139,1,0,0,0,1,59,59,59,59
Kern,38,2022-09-05,739,739,739,0,11391,11409,11407,2,50,5,5,8,2414,2414,2409,2409
Kings,38,2022-09-05,229,229,229,0,2869,2874,2873,1,8,0,0,0,461,461,461,461
Lake,38,2022-09-05,62,62,62,0,655,656,655,1,1,3,3,1,148,148,145,145
Lassen,38,2022-09-05,19,19,19,0,633,634,633,1,0,0,0,0,63,63,63,63
Los Angeles,38,2022-09-05,10707,10724,10724,0,224263,224612,224602,10,695,96,96,91,33380,33380,33284,33284
Madera,38,2022-09-05,206,206,206,0,2506,2511,2510,1,12,0,0,4,373,373,373,373
Marin,38,2022-09-05,191,191,191,0,3557,3563,3562,1,12,0,0,1,313,313,313,313
Mariposa,38,2022-09-05,16,16,16,0,166,167,166,1,0,0,0,0,29,29,29,29
Mendocino,38,2022-09-05,57,57,57,0,828,829,828,1,2,1,1,1,136,136,135,135
Merced,38,2022-09-05,251,251,251,0,2640,2645,2644,1,12,2,2,1,861,861,859,859
Modoc,38,2022-09-05,3,3,3,0,17,18,17,1,0,0,0,0,9,9,9,9
Mono,38,2022-09-05,4,4,4,0,52,53,52,1,1,0,0,0,7,7,7,7
Monterey,38,2022-09-05,245,245,245,0,4380,4386,4385,1,24,4,4,0,768,768,764,764
Napa,38,2022-09-05,102,102,102,0,1725,1729,1728,1,6,1,1,2,159,159,158,158
Nevada,38,2022-09-05,81,81,81,0,899,900,899,1,3,0,0,0,135,135,135,135
Orange,38,2022-09-05,2245,2249,2249,0,32843,32894,32890,4,169,13,13,34,7471,7471,7458,7458
Placer,38,2022-09-05,238,238,238,0,3479,3485,3484,1,36,0,0,4,658,658,658,658
Plumas,38,2022-09-05,9,9,9,0,130,131,130,1,0,0,0,0,13,13,13,13
Riverside,38,2022-09-05,2433,2437,2437,0,28763,28806,28802,4,99,7,7,14,6623,6623,6616,6616
Sacramento,38,2022-09-05,1273,1273,1273,0,19822,19852,19849,3,139,12,12,22,3306,3306,3294,3294
San Benito,38,2022-09-05,65,65,65,0,1087,1088,1087,1,0,0,0,2,100,100,100,100
San Bernardino,38,2022-09-05,2368,2372,2372,0,34558,34612,34608,4,122,14,14,19,8067,8067,8053,8053
San Diego,38,2022-09-05,2802,2806,2806,0,48504,48580,48578,2,212,15,15,25,5546,5546,5531,5531
San Francisco,38,2022-09-05,681,681,681,0,15741,15766,15761,5,52,9,9,9,1046,1046,1037,1037
San Joaquin,38,2022-09-05,831,831,831,0,11954,11972,11970,2,43,4,4,10,2324,2324,2320,2320
San Luis Obispo,38,2022-09-05,176,176,176,0,2677,2682,2681,1,7,2,2,1,524,524,522,522
San Mateo,38,2022-09-05,632,632,632,0,13669,13691,13690,1,23,1,1,2,737,737,736,736
Santa Barbara,38,2022-09-05,485,485,485,0,6633,6644,6643,1,39,4,4,3,726,726,722,722
Santa Clara,38,2022-09-05,1929,1931,1931,0,33400,33451,33449,2,127,10,10,20,2507,2507,2497,2497
Santa Cruz,38,2022-09-05,282,282,282,0,10222,10237,10236,1,16,0,0,0,273,273,273,273
Shasta,38,2022-09-05,104,104,104,0,2023,2027,2026,1,15,0,0,0,587,587,587,587
Siskiyou,38,2022-09-05,30,30,30,0,216,217,216,1,0,0,0,0,89,89,89,89
Solano,38,2022-09-05,368,368,368,0,5959,5968,5967,1,34,1,1,11,457,457,456,456
Sonoma,38,2022-09-05,369,369,369,0,6006,6016,6015,1,40,0,0,2,520,520,520,520
Stanislaus,38,2022-09-05,548,548,548,0,6350,6361,6360,1,69,5,5,4,1778,1778,1773,1773
Sutter,38,2022-09-05,118,118,118,0,1482,1484,1483,1,0,0,0,0,232,232,232,232
Tehama,38,2022-09-05,50,50,50,0,581,582,581,1,2,1,1,0,214,214,213,213
Trinity,38,2022-09-05,4,4,4,0,51,52,51,1,0,0,0,0,21,21,21,21
Tulare,38,2022-09-05,431,431,431,0,5164,5171,5170,1,37,2,2,1,1535,1535,1533,1533
Tuolumne,38,2022-09-05,68,68,68,0,737,738,737,1,1,0,0,0,199,199,199,199
Ventura,38,2022-09-05,864,864,864,0,12314,12334,12333,1,48,8,8,1,1586,1586,1578,1578
Yolo,38,2022-09-05,140,140,140,0,2910,2915,2914,1,1,3,3,2,391,391,388,388
Yuba,38,2022-09-05,88,88,88,0,977,978,977,1,14,0,0,1,122,122,122,122
Alameda,39,2022-09-12,1628,1628,1628,0,32247,32298,32295,3,94,5,5,16,2043,2043,2038,2038
Amador,39,2022-09-12,32,32,32,0,874,875,874,1,3,0,0,2,90,90,90,90
Butte,39,2022-09-12,196,196,196,0,2469,2474,2473,1,15,3,3,2,462,462,459,459
Calaveras,39,2022-09-12,14,14,14,0,501,502,501,1,1,0,0,0,133,133,133,133
Colusa,39,2022-09-12,17,17,17,0,414,415,414,1,0,0,0,0,22,22,22,22
Contra Costa,39,2022-09-12,979,979,979,0,17344,17372,17369,3,59,6,6,12,1447,1447,1441,1441
Del Norte,39,2022-09-12,34,34,34,0,595,596,595,1,1,0,0,1,55,55,55,55
El Dorado,39,2022-09-12,104,104,104,0,1904,1908,1907,1,3,0,0,1,233,233,233,233
Fresno,39,2022-09-12,907,907,907,0,14661,14685,14683,2,155,6,6,15,2870,2870,2864,2864
Glenn,39,2022-09-12,15,15,15,0,208,209,208,1,0,0,0,0,53,53,53,53
Humboldt,39,2022-09-12,113,113,113,0,1653,1656,1655,1,6,0,0,5,159,159,159,159
Imperial,39,2022-09-12,259,259,259,0,3287,3293,3292,1,10,0,0,2,961,961,961,961
Inyo,39,2022-09-12,15,15,15,0,194,195,194,1,0,1,1,0,60,60,59,59
Kern,39,2022-09-12,646,646,646,0,12995,13016,13015,1,45,7,7,13,2421,2421,2414,2414
Kings,39,2022-09-12,229,229,229,0,3172,3178,3177,1,6,1,1,0,462,462,461,461
Lake,39,2022-09-12,48,48,48,0,882,883,882,1,3,0,0,1,148,148,148,148
Lassen,39,2022-09-12,20,20,20,0,917,918,917,1,0,0,0,0,63,63,63,63
Los Angeles,39,2022-09-12,11022,11041,11041,0,284786,285246,285236,10,652,84,84,83,33464,33464,33380,33380
Madera,39,2022-09-12,242,242,242,0,2923,2929,2928,1,8,0,0,3,373,373,373,373
Marin,39,2022-09-12,174,174,174,0,3915,3920,3919,1,12,2,2,2,315,315,313,313
Mariposa,39,2022-09-12,16,16,16,0,192,193,192,1,0,0,0,0,29,29,29,29
Mendocino,39,2022-09-12,58,58,58,0,952,953,952,1,2,0,0,1,136,136,136,136
Merced,39,2022-09-12,237,237,237,0,3317,3323,3322,1,6,2,2,1,863,863,861,861
Modoc,39,2022-09-12,2,2,2,0,22,23,22,1,0,0,0,0,9,9,9,9
Mono,39,2022-09-12,7,7,7,0,77,78,77,1,0,0,0,0,7,7,7,7
Monterey,39,2022-09-12,229,229,229,0,5128,5136,5135,1,22,1,1,1,769,769,768,768
Napa,39,2022-09-12,119,119,119,0,2249,2254,2253,1,10,0,0,1,159,159,159,159
Nevada,39,2022-09-12,61,61,61,0,1179,1180,1179,1,2,1,1,0,136,136,135,135
Orange,39,2022-09-12,2153,2157,2157,0,37295,37356,37353,3,159,28,28,22,7499,7499,7471,7471
Placer,39,2022-09-12,240,240,240,0,4091,4097,4096,1,38,0,0,5,658,658,658,658
Plumas,39,2022-09-12,22,22,22,0,194,195,194,1,1,0,0,0,13,13,13,13
Riverside,39,2022-09-12,2264,2267,2267,0,33154,33207,33203,4,124,5,5,12,6628,6628,6623,6623
Sacramento,39,2022-09-12,1301,1301,1301,0,23561,23600,23597,3,119,15,15,15,3321,3321,3306,3306
San Benito,39,2022-09-12,96,96,96,0,1508,1511,1510,1,1,0,0,1,100,100,100,100
San Bernardino,39,2022-09-12,1951,1953,1953,0,38931,38994,38991,3,92,13,13,26,8080,8080,8067,8067
San Diego,39,2022-09-12,3034,3039,3039,0,56054,56143,56141,2,194,7,7,24,5553,5553,5546,5546
San Francisco,39,2022-09-12,815,815,815,0,17436,17464,17460,4,58,8,8,15,1054,1054,1046,1046
San Joaquin,39,2022-09-12,644,644,644,0,14281,14304,14302,2,35,6,6,9,2330,2330,2324,2324
San Luis Obispo,39,2022-09-12,187,187,187,0,3219,3225,3224,1,10,0,0,1,524,524,524,524
San Mateo,39,2022-09-12,671,671,671,0,14330,14353,14352,1,20,1,1,2,738,738,737,737
Santa Barbara,39,2022-09-12,329,329,329,0,7232,7244,7243,1,27,1,1,2,727,727,726,726
Santa Clara,39,2022-09-12,1924,1925,1925,0,38434,38497,38495,2,144,8,8,28,2515,2515,2507,2507
Santa Cruz,39,2022-09-12,272,272,272,0,13349,13370,13369,1,15,0,0,0,273,273,273,273
Shasta,39,2022-09-12,182,182,182,0,2592,2597,2596,1,26,1,1,2,588,588,587,587
Siskiyou,39,2022-09-12,27,27,27,0,289,290,289,1,1,0,0,0,89,89,89,89
Solano,39,2022-09-12,415,415,415,0,6740,6752,6751,1,32,0,0,4,457,457,457,457
Sonoma,39,2022-09-12,399,399,399,0,7021,7033,7032,1,39,3,3,1,523,523,520,520
Stanislaus,39,2022-09-12,447,447,447,0,7742,7756,7755,1,73,1,1,4,1779,1779,1778,1778
Sutter,39,2022-09-12,119,119,119,0,1531,1533,1532,1,0,0,0,0,232,232,232,232
Tehama,39,2022-09-12,48,48,48,0,699,700,699,1,2,0,0,0,214,214,214,214
Trinity,39,2022-09-12,2,2,2,0,74,75,74,1,0,0,0,0,21,21,21,21
Tulare,39,2022-09-12,369,369,369,0,6888,6900,6899,1,39,4,4,0,1539,1539,1535,1535
Tuolumne,39,2022-09-12,61,61,61,0,810,811,810,1,2,0,0,1,199,199,199,199
Ventura,39,2022-09-12,842,842,842,0,14808,14832,14831,1,49,1,1,7,1587,1587,1586,1586
Yolo,39,2022-09-12,143,143,143,0,3459,3466,3465,1,1,2,2,3,393,393,391,391
Yuba,39,2022-09-12,93,93,93,0,1164,1165,1164,1,6,0,0,0,122,122,122,122
Alameda,40,2022-09-19,1237,1237,1237,0,29339,29386,29384,2,80,4,4,7,2047,2047,2043,2043
Amador,40,2022-09-19,33,33,33,0,760,761,760,1,1,3,3,1,93,93,90,90
Butte,40,2022-09-19,121,121,121,0,2122,2126,2125,1,18,0,0,1,462,462,462,462
Calaveras,40,2022-09-19,28,28,28,0,477,478,477,1,0,0,0,0,133,133,133,133
Colusa,40,2022-09-19,13,13,13,0,289,290,289,1,3,0,0,0,22,22,22,22
Contra Costa,40,2022-09-19,826,826,826,0,16785,16813,16811,2,52,8,8,8,1455,1455,1447,1447
Del Norte,40,2022-09-19,22,22,22,0,479,480,479,1,2,0,0,0,55,55,55,55
El Dorado,40,2022-09-19,79,79,79,0,1617,1619,1618,1,3,0,0,0,233,233,233,233
Fresno,40,2022-09-19,604,604,604,0,13290,13312,13311,1,110,7,7,14,2877,2877,2870,2870
Glenn,40,2022-09-19,14,14,14,0,201,202,201,1,2,0,0,0,53,53,53,53
Humboldt,40,2022-09-19,105,105,105,0,1458,1459,1458,1,8,0,0,3,159,159,159,159
Imperial,40,2022-09-19,150,150,150,0,2869,2875,2874,1,11,0,0,2,961,961,961,961
Inyo,40,2022-09-19,8,8,8,0,169,170,169,1,0,0,0,0,60,60,60,60
Kern,40,2022-09-19,445,445,445,0,11650,11668,11667,1,34,2,2,6,2423,2423,2421,2421
Kings,40,2022-09-19,137,137,137,0,2642,2648,2647,1,7,2,2,0,464,464,462,462
Lake,40,2022-09-19,37,37,37,0,903,904,903,1,0,0,0,0,148,148,148,148
Lassen,40,2022-09-19,7,7,7,0,704,705,704,1,0,0,0,0,63,63,63,63
Los Angeles,40,2022-09-19,8552,8566,8566,0,256804,257231,257224,7,564,66,66,69,33530,33530,33464,33464
Madera,40,2022-09-19,109,109,109,0,2692,2698,2697,1,9,1,1,2,374,374,373,373
Marin,40,2022-09-19,137,137,137,0,3702,3709,3708,1,6,0,0,0,315,315,315,315
Mariposa,40,2022-09-19,12,12,12,0,170,171,170,1,0,1,1,0,30,30,29,29
Mendocino,40,2022-09-19,43,43,43,0,928,929,928,1,0,0,0,1,136,136,136,136
Merced,40,2022-09-19,170,170,170,0,2914,2920,2919,1,8,3,3,1,866,866,863,863
Modoc,40,2022-09-19,2,2,2,0,17,18,17,1,0,0,0,0,9,9,9,9
Mono,40,2022-09-19,4,4,4,0,63,64,63,1,0,0,0,0,7,7,7,7
Monterey,40,2022-09-19,162,162,162,0,4272,4279,4278,1,14,1,1,2,770,770,769,769
Napa,40,2022-09-19,101,101,101,0,1772,1775,1774,1,4,0,0,0,159,159,159,159
Nevada,40,2022-09-19,66,66,66,0,1111,1113,1112,1,2,0,0,0,136,136,136,136
Orange,40,2022-09-19,1788,1789,1789,0,34570,34627,34625,2,129,16,16,19,7515,7515,7499,7499
Placer,40,2022-09-19,223,223,223,0,3845,3852,3851,1,51,1,1,4,659,659,658,658
Plumas,40,2022-09-19,22,22,22,0,183,184,183,1,1,0,0,0,13,13,13,13
Riverside,40,2022-09-19,1427,1427,1427,0,29209,29257,29255,2,68,4,4,19,6632,6632,6628,6628
Sacramento,40,2022-09-19,1040,1040,1040,0,21423,21459,21457,2,102,8,8,17,3329,3329,3321,3321
San Benito,40,2022-09-19,54,54,54,0,1231,1233,1232,1,0,0,0,0,100,100,100,100
San Bernardino,40,2022-09-19,1486,1487,1487,0,32837,32892,32890,2,83,7,7,19,8087,8087,8080,8080
San Diego,40,2022-09-19,2563,2568,2568,0,56220,56314,56312,2,175,9,9,19,5562,5562,5553,5553
San Francisco,40,2022-09-19,695,695,695,0,16846,16874,16871,3,43,9,9,11,1063,1063,1054,1054
San Joaquin,40,2022-09-19,459,459,459,0,12860,12880,12879,1,35,5,5,2,2335,2335,2330,2330
San Luis Obispo,40,2022-09-19,155,155,155,0,2766,2772,2771,1,8,0,0,0,524,524,524,524
San Mateo,40,2022-09-19,607,607,607,0,13735,13757,13756,1,20,0,0,2,738,738,738,738
Santa Barbara,40,2022-09-19,269,269,269,0,6792,6804,6803,1,34,2,2,0,729,729,727,727
Santa Clara,40,2022-09-19,1450,1450,1450,0,37367,37429,37428,1,137,7,7,21,2522,2522,2515,2515
Santa Cruz,40,2022-09-19,148,148,148,0,12323,12345,12344,1,5,0,0,1,273,273,273,273
Shasta,40,2022-09-19,101,101,101,0,2113,2118,2117,1,21,0,0,3,588,588,588,588
Siskiyou,40,2022-09-19,21,21,21,0,233,234,233,1,2,1,1,0,90,90,89,89
Solano,40,2022-09-19,274,274,274,0,6124,6135,6134,1,24,1,1,5,458,458,457,457
Sonoma,40,2022-09-19,317,317,317,0,6359,6370,6369,1,27,3,3,1,526,526,523,523
Stanislaus,40,2022-09-19,333,333,333,0,6290,6301,6300,1,57,4,4,4,1783,1783,1779,1779
Sutter,40,2022-09-19,75,75,75,0,1388,1390,1389,1,0,0,0,0,232,232,232,232
Tehama,40,2022-09-19,35,35,35,0,599,600,599,1,2,1,1,0,215,215,214,214
Trinity,40,2022-09-19,3,3,3,0,53,54,53,1,0,0,0,0,21,21,21,21
Tulare,40,2022-09-19,235,235,235,0,5726,5734,5733,1,32,1,1,0,1540,1540,1539,1539
Tuolumne,40,2022-09-19,59,59,59,0,717,718,717,1,0,0,0,0,199,199,199,199
Ventura,40,2022-09-19,616,616,616,0,13383,13405,13404,1,42,2,2,6,1589,1589,1587,1587
Yolo,40,2022-09-19,83,83,83,0,3744,3751,3750,1,2,3,3,2,396,396,393,393
Yuba,40,2022-09-19,60,60,60,0,1029,1030,1029,1,3,0,0,0,122,122,122,122
Alameda,41,2022-09-26,1151,1151,1151,0,27843,27890,27889,1,77,2,2,4,2049,2049,2047,2047
Amador,41,2022-09-26,27,27,27,0,721,722,721,1,1,0,0,1,93,93,93,93
Butte,41,2022-09-26,90,90,90,0,1798,1801,1800,1,23,0,0,1,462,462,462,462
Calaveras,41,2022-09-26,20,20,20,0,390,391,390,1,2,1,1,0,134,134,133,133
Colusa,41,2022-09-26,7,7,7,0,299,300,299,1,1,0,0,0,22,22,22,22
Contra Costa,41,2022-09-26,777,777,777,0,16348,16376,16375,1,48,5,5,7,1460,1460,1455,1455
Del Norte,41,2022-09-26,22,22,22,0,469,470,469,1,2,0,0,0,55,55,55,55
El Dorado,41,2022-09-26,86,86,86,0,1580,1583,1582,1,5,0,0,0,233,233,233,233
Fresno,41,2022-09-26,517,517,517,0,12130,12151,12150,1,84,3,3,13,2880,2880,2877,2877
Glenn,41,2022-09-26,7,7,7,0,176,177,176,1,2,0,0,0,53,53,53,53
Humboldt,41,2022-09-26,98,98,98,0,1312,1313,1312,1,10,2,2,0,161,161,159,159
Imperial,41,2022-09-26,115,115,115,0,2630,2636,2635,1,4,1,1,1,962,962,961,961
Inyo,41,2022-09-26,5,5,5,0,165,166,165,1,0,0,0,0,60,60,60,60
Kern,41,2022-09-26,357,357,357,0,10879,10897,10896,1,32,3,3,7,2426,2426,2423,2423
Kings,41,2022-09-26,107,107,107,0,2621,2627,2626,1,2,0,0,0,464,464,464,464
Lake,41,2022-09-26,26,26,26,0,815,816,815,1,0,0,0,0,148,148,148,148
Lassen,41,2022-09-26,13,13,13,0,533,534,533,1,0,0,0,0,63,63,63,63
Los Angeles,41,2022-09-26,7724,7737,7737,0,241348,241759,241754,5,443,63,63,53,33593,33593,33530,33530
Madera,41,2022-09-26,84,84,84,0,2231,2236,2235,1,8,0,0,2,374,374,374,374
Marin,41,2022-09-26,173,173,173,0,3659,3665,3664,1,10,0,0,0,315,315,315,315
Mariposa,41,2022-09-26,4,4,4,0,155,156,155,1,0,0,0,0,30,30,30,30
Mendocino,41,2022-09-26,41,41,41,0,852,853,852,1,1,0,0,0,136,136,136,136
Merced,41,2022-09-26,127,127,127,0,2855,2861,2860,1,10,1,1,0,867,867,866,866
Modoc,41,2022-09-26,0,0,0,0,13,14,13,1,0,0,0,0,9,9,9,9
Mono,41,2022-09-26,1,1,1,0,60,61,60,1,0,0,0,0,7,7,7,7
Monterey,41,2022-09-26,135,135,135,0,4055,4061,4060,1,14,0,0,2,770,770,770,770
Napa,41,2022-09-26,85,85,85,0,1956,1961,1960,1,5,0,0,1,159,159,159,159
Nevada,41,2022-09-26,49,49,49,0,1077,1078,1077,1,1,0,0,0,136,136,136,136
Orange,41,2022-09-26,1720,1721,1721,0,31542,31596,31594,2,117,19,19,23,7534,7534,7515,7515
Placer,41,2022-09-26,209,209,209,0,3611,3618,3617,1,42,1,1,4,660,660,659,659
Plumas,41,2022-09-26,21,21,21,0,151,152,151,1,1,0,0,0,13,13,13,13
Riverside,41,2022-09-26,1289,1289,1289,0,25891,25935,25933,2,55,8,8,15,6640,6640,6632,6632
Sacramento,41,2022-09-26,930,930,930,0,19275,19307,19306,1,106,11,11,20,3340,3340,3329,3329
San Benito,41,2022-09-26,50,50,50,0,1160,1162,1161,1,0,1,1,2,101,101,100,100
San Bernardino,41,2022-09-26,1239,1239,1239,0,28101,28149,28147,2,75,5,5,12,8092,8092,8087,8087
San Diego,41,2022-09-26,2482,2487,2487,0,51204,51291,51290,1,201,7,7,15,5569,5569,5562,5562
San Francisco,41,2022-09-26,678,678,678,0,16224,16252,16250,2,45,2,2,9,1065,1065,1063,1063
San Joaquin,41,2022-09-26,409,409,409,0,11085,11103,11102,1,35,1,1,3,2336,2336,2335,2335
San Luis Obispo,41,2022-09-26,131,131,131,0,2521,2527,2526,1,7,1,1,0,525,525,524,524
San Mateo,41,2022-09-26,617,617,617,0,13188,13210,13209,1,25,0,0,1,738,738,738,738
Santa Barbara,41,2022-09-26,259,259,259,0,6381,6393,6392,1,22,2,2,0,731,731,729,729
Santa Clara,41,2022-09-26,1401,1401,1401,0,36177,36239,36238,1,113,10,10,17,2532,2532,2522,2522
Santa Cruz,41,2022-09-26,225,225,225,0,12507,12528,12527,1,13,0,0,0,273,273,273,273
Shasta,41,2022-09-26,75,75,75,0,1740,1744,1743,1,14,0,0,3,588,588,588,588
Siskiyou,41,2022-09-26,18,18,18,0,183,184,183,1,1,2,2,0,92,92,90,90
Solano,41,2022-09-26,309,309,309,0,5725,5736,5735,1,23,1,1,2,459,459,458,458
Sonoma,41,2022-09-26,291,291,291,0,6334,6346,6345,1,31,1,1,2,527,527,526,526
Stanislaus,41,2022-09-26,261,261,261,0,5814,5824,5823,1,46,2,2,3,1785,1785,1783,1783
Sutter,41,2022-09-26,69,69,69,0,1147,1148,1147,1,0,0,0,0,232,232,232,232
Tehama,41,2022-09-26,36,36,36,0,550,551,550,1,1,2,2,0,217,217,215,215
Trinity,41,2022-09-26,3,3,3,0,44,45,44,1,0,0,0,0,21,21,21,21
Tulare,41,2022-09-26,168,168,168,0,5091,5099,5098,1,18,3,3,2,1543,1543,1540,1540
Tuolumne,41,2022-09-26,44,44,44,0,689,690,689,1,1,0,0,0,199,199,199,199
Ventura,41,2022-09-26,557,557,557,0,11597,11617,11616,1,33,4,4,1,1593,1593,1589,1589
Yolo,41,2022-09-26,130,130,130,0,3993,4000,3999,1,2,3,3,3,399,399,396,396
Yuba,41,2022-09-26,41,41,41,0,933,934,933,1,6,0,0,1,122,122,122,122
Alameda,42,2022-10-03,1146,1146,1146,0,26323,26370,26369,1,54,3,3,5,2052,2052,2049,2049
Amador,42,2022-10-03,14,14,14,0,691,692,691,1,0,0,0,1,93,93,93,93
Butte,42,2022-10-03,67,67,67,0,1754,1758,1757,1,11,2,2,2,464,464,462,462
Calaveras,42,2022-10-03,19,19,19,0,337,338,337,1,1,0,0,0,134,134,134,134
Colusa,42,2022-10-03,7,7,7,0,188,189,188,1,0,0,0,0,22,22,22,22
Contra Costa,42,2022-10-03,739,739,739,0,15784,15811,15810,1,34,3,3,6,1463,1463,1460,1460
Del Norte,42,2022-10-03,12,12,12,0,382,383,382,1,1,0,0,1,55,55,55,55
El Dorado,42,2022-10-03,80,80,80,0,1450,1452,1451,1,3,0,0,1,233,233,233,233
Fresno,42,2022-10-03,463,463,463,0,11225,11243,11242,1,77,2,2,11,2882,2882,2880,2880
Glenn,42,2022-10-03,7,7,7,0,155,156,155,1,0,0,0,0,53,53,53,53
Humboldt,42,2022-10-03,78,78,78,0,1159,1160,1159,1,6,0,0,1,161,161,161,161
Imperial,42,2022-10-03,141,141,141,0,2563,2569,2568,1,6,0,0,0,962,962,962,962
Inyo,42,2022-10-03,5,5,5,0,159,160,159,1,0,0,0,1,60,60,60,60
Kern,42,2022-10-03,295,295,295,0,10110,10129,10128,1,24,4,4,5,2430,2430,2426,2426
Kings,42,2022-10-03,87,87,87,0,2416,2422,2421,1,2,0,0,0,464,464,464,464
Lake,42,2022-10-03,35,35,35,0,759,760,759,1,3,1,1,0,149,149,148,148
Lassen,42,2022-10-03,7,7,7,0,530,531,530,1,2,0,0,0,63,63,63,63
Los Angeles,42,2022-10-03,7020,7032,7032,0,221727,222116,222112,4,439,50,50,69,33643,33643,33593,33593
Madera,42,2022-10-03,65,65,65,0,1565,1568,1567,1,6,0,0,2,374,374,374,374
Marin,42,2022-10-03,191,191,191,0,3475,3481,3480,1,6,0,0,2,315,315,315,315
Mariposa,42,2022-10-03,5,5,5,0,131,132,131,1,0,0,0,0,30,30,30,30
Mendocino,42,2022-10-03,50,50,50,0,778,779,778,1,4,0,0,0,136,136,136,136
Merced,42,2022-10-03,109,109,109,0,2610,2616,2615,1,5,3,3,1,870,870,867,867
Modoc,42,2022-10-03,2,2,2,0,14,15,14,1,0,0,0,0,9,9,9,9
Mono,42,2022-10-03,4,4,4,0,69,70,69,1,0,0,0,0,7,7,7,7
Monterey,42,2022-10-03,111,111,111,0,3790,3796,3795,1,11,1,1,1,771,771,770,770
Napa,42,2022-10-03,88,88,88,0,1699,1702,1701,1,4,0,0,2,159,159,159,159
Nevada,42,2022-10-03,51,51,51,0,954,955,954,1,1,0,0,4,136,136,136,136
Orange,42,2022-10-03,1572,1572,1572,0,28364,28414,28413,1,131,22,22,16,7556,7556,7534,7534
Placer,42,2022-10-03,208,208,208,0,3350,3357,3356,1,41,2,2,3,662,662,660,660
Plumas,42,2022-10-03,12,12,12,0,107,108,107,1,1,0,0,0,13,13,13,13
Riverside,42,2022-10-03,1146,1146,1146,0,22158,22196,22195,1,59,7,7,12,6647,6647,6640,6640
Sacramento,42,2022-10-03,921,921,921,0,18205,18236,18235,1,88,12,12,19,3352,3352,3340,3340
San Benito,42,2022-10-03,34,34,34,0,1105,1107,1106,1,0,0,0,0,101,101,101,101
San Bernardino,42,2022-10-03,1243,1243,1243,0,25069,25113,25112,1,77,4,4,7,8096,8096,8092,8092
San Diego,42,2022-10-03,2086,2090,2090,0,46921,47003,47002,1,162,9,9,18,5578,5578,5569,5569
San Francisco,42,2022-10-03,655,655,655,0,15385,15412,15410,2,44,3,3,9,1068,1068,1065,1065
San Joaquin,42,2022-10-03,342,342,342,0,9930,9946,9945,1,25,4,4,3,2340,2340,2336,2336
San Luis Obispo,42,2022-10-03,150,150,150,0,2383,2389,2388,1,2,1,1,1,526,526,525,525
San Mateo,42,2022-10-03,560,560,560,0,12421,12443,12442,1,22,0,0,2,738,738,738,738
Santa Barbara,42,2022-10-03,253,253,253,0,6289,6302,6301,1,15,0,0,2,731,731,731,731
Santa Clara,42,2022-10-03,1436,1436,1436,0,32448,32505,32504,1,109,6,6,20,2538,2538,2532,2532
Santa Cruz,42,2022-10-03,227,227,227,0,11231,11250,11249,1,10,0,0,1,273,273,273,273
Shasta,42,2022-10-03,56,56,56,0,1444,1447,1446,1,10,0,0,2,588,588,588,588
Siskiyou,42,2022-10-03,10,10,10,0,204,205,204,1,0,0,0,0,92,92,92,92
Solano,42,2022-10-03,251,251,251,0,5361,5371,5370,1,17,0,0,2,459,459,459,459
Sonoma,42,2022-10-03,323,323,323,0,5934,5946,5945,1,17,0,0,3,527,527,527,527
Stanislaus,42,2022-10-03,200,200,200,0,5355,5366,5365,1,49,1,1,6,1786,1786,1785,1785
Sutter,42,2022-10-03,57,57,57,0,1109,1111,1110,1,0,0,0,0,232,232,232,232
Tehama,42,2022-10-03,20,20,20,0,526,527,526,1,1,0,0,0,217,217,217,217
Trinity,42,2022-10-03,1,1,1,0,43,44,43,1,0,0,0,0,21,21,21,21
Tulare,42,2022-10-03,163,163,163,0,5049,5058,5057,1,19,4,4,1,1547,1547,1543,1543
Tuolumne,42,2022-10-03,26,26,26,0,622,623,622,1,0,1,1,0,200,200,199,199
Ventura,42,2022-10-03,479,479,479,0,10440,10458,10457,1,41,2,2,2,1595,1595,1593,1593
Yolo,42,2022-10-03,123,123,123,0,2988,2995,2994,1,3,2,2,2,401,401,399,399
Yuba,42,2022-10-03,35,35,35,0,802,803,802,1,4,0,0,1,122,122,122,122
Alameda,43,2022-10-10,1159,1159,1159,0,28032,28084,28083,1,45,2,2,7,2054,2054,2052,2052
Amador,43,2022-10-10,15,15,15,0,801,802,801,1,0,0,0,2,93,93,93,93
Butte,43,2022-10-10,65,65,65,0,1754,1758,1757,1,12,3,3,1,466,466,463,463
Calaveras,43,2022-10-10,15,15,15,0,374,375,374,1,0,1,1,0,135,135,134,134
Colusa,43,2022-10-10,1,1,1,0,120,121,120,1,1,0,0,0,22,22,22,22
Contra Costa,43,2022-10-10,774,774,774,0,16874,16904,16903,1,31,7,7,6,1468,1468,1461,1461
Del Norte,43,2022-10-10,10,10,10,0,492,493,492,1,1,0,0,1,55,55,55,55
El Dorado,43,2022-10-10,81,81,81,0,1751,1754,1753,1,7,0,0,4,233,233,233,233
Fresno,43,2022-10-10,481,481,481,0,12481,12504,12503,1,60,3,3,9,2885,2885,2882,2882
Glenn,43,2022-10-10,10,10,10,0,226,227,226,1,1,0,0,0,53,53,53,53
Humboldt,43,2022-10-10,98,98,98,0,1420,1421,1420,1,7,1,1,0,162,162,161,161
Imperial,43,2022-10-10,203,203,203,0,2960,2967,2966,1,7,0,0,0,962,962,962,962
Inyo,43,2022-10-10,4,4,4,0,124,125,124,1,0,0,0,0,60,60,60,60
Kern,43,2022-10-10,338,338,338,0,11848,11870,11869,1,24,2,2,2,2432,2432,2430,2430
Kings,43,2022-10-10,102,102,102,0,2751,2757,2756,1,1,1,1,0,465,465,464,464
Lake,43,2022-10-10,33,33,33,0,920,921,920,1,1,0,0,0,149,149,149,149
Lassen,43,2022-10-10,3,3,3,0,573,574,573,1,0,0,0,0,63,63,63,63
Los Angeles,43,2022-10-10,6753,6766,6766,0,228393,228806,228803,3,436,71,71,51,33706,33706,33635,33635
Madera,43,2022-10-10,68,68,68,0,1718,1720,1719,1,7,1,1,2,375,375,374,374
Marin,43,2022-10-10,207,207,207,0,3779,3787,3786,1,9,0,0,0,315,315,315,315
Mariposa,43,2022-10-10,8,8,8,0,128,129,128,1,0,0,0,0,30,30,30,30
Mendocino,43,2022-10-10,32,32,32,0,975,976,975,1,1,0,0,2,136,136,136,136
Merced,43,2022-10-10,111,111,111,0,2789,2795,2794,1,8,1,1,3,871,871,870,870
Modoc,43,2022-10-10,5,5,5,0,12,13,12,1,0,0,0,0,9,9,9,9
Mono,43,2022-10-10,1,1,1,0,55,56,55,1,0,0,0,0,7,7,7,7
Monterey,43,2022-10-10,108,108,108,0,4375,4383,4382,1,9,0,0,1,771,771,771,771
Napa,43,2022-10-10,78,78,78,0,1766,1769,1768,1,3,0,0,2,159,159,159,159
Nevada,43,2022-10-10,42,42,42,0,981,982,981,1,1,0,0,1,136,136,136,136
Orange,43,2022-10-10,1524,1524,1524,0,30118,30172,30171,1,129,14,14,19,7568,7568,7554,7554
Placer,43,2022-10-10,186,186,186,0,3823,3831,3830,1,24,0,0,7,662,662,662,662
Plumas,43,2022-10-10,20,20,20,0,106,107,106,1,0,0,0,0,13,13,13,13
Riverside,43,2022-10-10,1195,1195,1195,0,24021,24065,24064,1,56,5,5,4,6652,6652,6647,6647
Sacramento,43,2022-10-10,957,957,957,0,20476,20512,20511,1,81,5,5,16,3357,3357,3352,3352
San Benito,43,2022-10-10,35,35,35,0,1268,1269,1268,1,3,0,0,0,101,101,101,101
San Bernardino,43,2022-10-10,1112,1112,1112,0,27423,27473,27472,1,66,0,0,13,8096,8096,8096,8096
San Diego,43,2022-10-10,1989,1993,1993,0,51613,51705,51704,1,130,7,7,21,5583,5583,5576,5576
San Francisco,43,2022-10-10,691,691,691,0,16134,16163,16162,1,37,2,2,9,1070,1070,1068,1068
San Joaquin,43,2022-10-10,431,431,431,0,11585,11608,11607,1,17,2,2,8,2342,2342,2340,2340
San Luis Obispo,43,2022-10-10,88,88,88,0,2568,2575,2574,1,2,2,2,0,528,528,526,526
San Mateo,43,2022-10-10,668,668,668,0,13748,13773,13772,1,19,0,0,0,738,738,738,738
Santa Barbara,43,2022-10-10,242,242,242,0,7844,7859,7858,1,20,1,1,1,732,732,731,731
Santa Clara,43,2022-10-10,1457,1457,1457,0,34357,34421,34420,1,107,4,4,18,2542,2542,2538,2538
Santa Cruz,43,2022-10-10,338,338,338,0,12283,12307,12306,1,9,0,0,1,273,273,273,273
Shasta,43,2022-10-10,99,99,99,0,1294,1295,1294,1,13,3,3,1,591,591,588,588
Siskiyou,43,2022-10-10,9,9,9,0,244,245,244,1,0,1,1,0,93,93,92,92
Solano,43,2022-10-10,333,333,333,0,6279,6291,6290,1,23,0,0,4,459,459,459,459
Sonoma,43,2022-10-10,287,287,287,0,6773,6787,6786,1,15,1,1,3,528,528,527,527
Stanislaus,43,2022-10-10,208,208,208,0,5928,5940,5939,1,51,7,7,7,1791,1791,1784,1784
Sutter,43,2022-10-10,58,58,58,0,1127,1128,1127,1,0,0,0,0,232,232,232,232
Tehama,43,2022-10-10,21,21,21,0,567,568,567,1,1,0,0,0,217,217,217,217
Trinity,43,2022-10-10,1,1,1,0,53,54,53,1,0,0,0,0,21,21,21,21
Tulare,43,2022-10-10,167,167,167,0,4980,4989,4988,1,16,1,1,1,1548,1548,1547,1547
Tuolumne,43,2022-10-10,36,36,36,0,660,661,660,1,1,1,1,0,201,201,200,200
Ventura,43,2022-10-10,438,438,438,0,10998,11018,11017,1,41,4,4,1,1598,1598,1594,1594
Yolo,43,2022-10-10,126,126,126,0,3099,3106,3105,1,4,2,2,0,403,403,401,401
Yuba,43,2022-10-10,23,23,23,0,924,925,924,1,0,0,0,0,122,122,122,122
Alameda,44,2022-10-17,942,942,942,0,24697,24743,24742,1,60,5,5,8,2059,2059,2054,2054
Amador,44,2022-10-17,15,15,15,0,592,593,592,1,1,0,0,0,93,93,93,93
Butte,44,2022-10-17,76,76,76,0,1426,1428,1427,1,13,0,0,0,466,466,466,466
Calaveras,44,2022-10-17,19,19,19,0,306,307,306,1,0,0,0,0,135,135,135,135
Colusa,44,2022-10-17,4,4,4,0,80,81,80,1,0,0,0,0,22,22,22,22
Contra Costa,44,2022-10-17,675,675,675,0,14549,14576,14575,1,30,4,4,6,1472,1472,1468,1468
Del Norte,44,2022-10-17,11,11,11,0,381,382,381,1,1,0,0,0,55,55,55,55
El Dorado,44,2022-10-17,89,89,89,0,1381,1384,1383,1,2,0,0,1,233,233,233,233
Fresno,44,2022-10-17,350,350,350,0,10209,10230,10229,1,62,2,2,11,2887,2887,2885,2885
Glenn,44,2022-10-17,6,6,6,0,141,142,141,1,1,0,0,0,53,53,53,53
Humboldt,44,2022-10-17,70,70,70,0,1147,1149,1148,1,1,0,0,0,162,162,162,162
Imperial,44,2022-10-17,117,117,117,0,2319,2325,2324,1,5,0,0,0,962,962,962,962
Inyo,44,2022-10-17,6,6,6,0,123,124,123,1,1,0,0,0,60,60,60,60
Kern,44,2022-10-17,238,238,238,0,9714,9734,9733,1,32,0,0,1,2432,2432,2432,2432
Kings,44,2022-10-17,70,70,70,0,2320,2326,2325,1,2,1,1,0,466,466,465,465
Lake,44,2022-10-17,25,25,25,0,774,775,774,1,1,0,0,0,149,149,149,149
Lassen,44,2022-10-17,7,7,7,0,513,514,513,1,1,0,0,0,63,63,63,63
Los Angeles,44,2022-10-17,5093,5103,5103,0,189695,190052,190050,2,350,42,42,53,33748,33748,33706,33706
Madera,44,2022-10-17,59,59,59,0,1467,1469,1468,1,3,0,0,2,375,375,375,375
Marin,44,2022-10-17,132,132,132,0,3096,3102,3101,1,8,0,0,1,315,315,315,315
Mariposa,44,2022-10-17,6,6,6,0,119,120,119,1,0,0,0,0,30,30,30,30
Mendocino,44,2022-10-17,48,48,48,0,743,744,743,1,2,0,0,0,136,136,136,136
Merced,44,2022-10-17,129,129,129,0,2344,2350,2349,1,15,0,0,2,871,871,871,871
Modoc,44,2022-10-17,1,1,1,0,7,8,7,1,0,0,0,0,9,9,9,9
Mono,44,2022-10-17,6,6,6,0,42,43,42,1,1,0,0,0,7,7,7,7
Monterey,44,2022-10-17,125,125,125,0,3552,3559,3558,1,12,1,1,1,772,772,771,771
Napa,44,2022-10-17,60,60,60,0,1416,1418,1417,1,2,0,0,1,159,159,159,159
Nevada,44,2022-10-17,49,49,49,0,780,781,780,1,0,0,0,5,136,136,136,136
Orange,44,2022-10-17,1137,1137,1137,0,25139,25185,25184,1,91,21,21,18,7589,7589,7568,7568
Placer,44,2022-10-17,149,149,149,0,2932,2939,2938,1,32,0,0,3,662,662,662,662
Plumas,44,2022-10-17,11,11,11,0,98,99,98,1,0,0,0,0,13,13,13,13
Riverside,44,2022-10-17,898,898,898,0,20799,20838,20837,1,66,2,2,2,6654,6654,6652,6652
Sacramento,44,2022-10-17,871,871,871,0,16205,16236,16235,1,84,11,11,14,3368,3368,3357,3357
San Benito,44,2022-10-17,28,28,28,0,881,882,881,1,0,1,1,0,102,102,101,101
San Bernardino,44,2022-10-17,835,835,835,0,23470,23514,23513,1,63,1,1,9,8097,8097,8096,8096
San Diego,44,2022-10-17,1648,1650,1650,0,43705,43787,43786,1,117,8,8,24,5591,5591,5583,5583
San Francisco,44,2022-10-17,567,567,567,0,14501,14527,14526,1,34,3,3,13,1073,1073,1070,1070
San Joaquin,44,2022-10-17,353,353,353,0,9076,9094,9093,1,8,2,2,8,2344,2344,2342,2342
San Luis Obispo,44,2022-10-17,109,109,109,0,2131,2137,2136,1,4,1,1,0,529,529,528,528
San Mateo,44,2022-10-17,552,552,552,0,11333,11356,11355,1,21,0,0,1,738,738,738,738
Santa Barbara,44,2022-10-17,182,182,182,0,5626,5638,5637,1,18,0,0,2,732,732,732,732
Santa Clara,44,2022-10-17,1170,1170,1170,0,28717,28771,28770,1,93,5,5,16,2547,2547,2542,2542
Santa Cruz,44,2022-10-17,284,284,284,0,10290,10310,10309,1,7,1,1,0,274,274,273,273
Shasta,44,2022-10-17,82,82,82,0,1105,1106,1105,1,12,0,0,2,591,591,591,591
Siskiyou,44,2022-10-17,12,12,12,0,181,182,181,1,2,1,1,0,94,94,93,93
Solano,44,2022-10-17,266,266,266,0,4852,4862,4861,1,25,1,1,3,460,460,459,459
Sonoma,44,2022-10-17,245,245,245,0,5370,5383,5382,1,20,1,1,1,529,529,528,528
Stanislaus,44,2022-10-17,222,222,222,0,5295,5306,5305,1,45,1,1,5,1792,1792,1791,1791
Sutter,44,2022-10-17,40,40,40,0,910,911,910,1,0,0,0,0,232,232,232,232
Tehama,44,2022-10-17,21,21,21,0,397,398,397,1,0,0,0,0,217,217,217,217
Trinity,44,2022-10-17,0,0,0,0,34,35,34,1,0,0,0,0,21,21,21,21
Tulare,44,2022-10-17,136,136,136,0,4271,4279,4278,1,11,1,1,1,1549,1549,1548,1548
Tuolumne,44,2022-10-17,35,35,35,0,620,621,620,1,2,0,0,0,201,201,201,201
Ventura,44,2022-10-17,376,376,376,0,9350,9368,9367,1,32,3,3,1,1601,1601,1598,1598
Yolo,44,2022-10-17,102,102,102,0,2213,2218,2217,1,3,2,2,3,405,405,403,403
Yuba,44,2022-10-17,44,44,44,0,767,768,767,1,1,0,0,0,122,122,122,122
Alameda,45,2022-10-24,953,953,953,0,23425,23472,23471,1,46,8,8,10,2067,2067,2059,2059
Amador,45,2022-10-24,18,18,18,0,635,636,635,1,2,0,0,0,93,93,93,93
Butte,45,2022-10-24,68,68,68,0,1405,1408,1407,1,10,1,1,1,467,467,466,466
Calaveras,45,2022-10-24,20,20,20,0,322,323,322,1,0,0,0,0,135,135,135,135
Colusa,45,2022-10-24,3,3,3,0,95,96,95,1,0,0,0,0,22,22,22,22
Contra Costa,45,2022-10-24,627,627,627,0,13919,13947,13946,1,37,5,5,5,1477,1477,1472,1472
Del Norte,45,2022-10-24,6,6,6,0,361,362,361,1,0,0,0,1,55,55,55,55
El Dorado,45,2022-10-24,91,91,91,0,1520,1524,1523,1,1,0,0,0,233,233,233,233
Fresno,45,2022-10-24,380,380,380,0,9763,9784,9783,1,63,0,0,6,2887,2887,2887,2887
Glenn,45,2022-10-24,9,9,9,0,148,149,148,1,0,0,0,0,53,53,53,53
Humboldt,45,2022-10-24,69,69,69,0,1150,1152,1151,1,7,0,0,2,162,162,162,162
Imperial,45,2022-10-24,96,96,96,0,2344,2350,2349,1,8,1,1,0,963,963,962,962
Inyo,45,2022-10-24,8,8,8,0,273,274,273,1,0,0,0,0,60,60,60,60
Kern,45,2022-10-24,279,279,279,0,9716,9736,9735,1,24,2,2,2,2434,2434,2432,2432
Kings,45,2022-10-24,88,88,88,0,2341,2347,2346,1,8,0,0,0,466,466,466,466
Lake,45,2022-10-24,22,22,22,0,643,644,643,1,1,1,1,1,150,150,149,149
Lassen,45,2022-10-24,16,16,16,0,484,485,484,1,1,0,0,0,63,63,63,63
Los Angeles,45,2022-10-24,5338,5349,5349,0,187323,187695,187693,2,332,54,54,43,33802,33802,33748,33748
Madera,45,2022-10-24,61,61,61,0,1388,1390,1389,1,4,0,0,2,375,375,375,375
Marin,45,2022-10-24,138,138,138,0,3081,3088,3087,1,12,1,1,2,316,316,315,315
Mariposa,45,2022-10-24,12,12,12,0,120,121,120,1,0,0,0,0,30,30,30,30
Mendocino,45,2022-10-24,42,42,42,0,771,772,771,1,2,0,0,0,136,136,136,136
Merced,45,2022-10-24,88,88,88,0,2410,2416,2415,1,7,3,3,3,874,874,871,871
Modoc,45,2022-10-24,1,1,1,0,13,14,13,1,0,0,0,0,9,9,9,9
Mono,45,2022-10-24,3,3,3,0,64,65,64,1,0,1,1,0,8,8,7,7
Monterey,45,2022-10-24,131,131,131,0,3719,3727,3726,1,18,0,0,0,772,772,772,772
Napa,45,2022-10-24,51,51,51,0,1467,1469,1468,1,3,0,0,0,159,159,159,159
Nevada,45,2022-10-24,38,38,38,0,784,785,784,1,6,0,0,0,136,136,136,136
Orange,45,2022-10-24,1162,1162,1162,0,26001,26053,26052,1,84,12,12,14,7601,7601,7589,7589
Placer,45,2022-10-24,192,192,192,0,3034,3042,3041,1,39,0,0,6,662,662,662,662
Plumas,45,2022-10-24,12,12,12,0,91,92,91,1,0,0,0,0,13,13,13,13
Riverside,45,2022-10-24,933,933,933,0,20178,20219,20218,1,53,0,0,6,6654,6654,6654,6654
Sacramento,45,2022-10-24,815,815,815,0,15315,15345,15344,1,84,5,5,19,3373,3373,3368,3368
San Benito,45,2022-10-24,41,41,41,0,845,846,845,1,0,0,0,1,102,102,102,102
San Bernardino,45,2022-10-24,805,805,805,0,21612,21656,21655,1,39,3,3,10,8100,8100,8097,8097
San Diego,45,2022-10-24,1684,1688,1688,0,42118,42201,42200,1,83,5,5,18,5596,5596,5591,5591
San Francisco,45,2022-10-24,511,511,511,0,13947,13974,13973,1,35,1,1,5,1074,1074,1073,1073
San Joaquin,45,2022-10-24,271,271,271,0,8498,8516,8515,1,13,2,2,3,2346,2346,2344,2344
San Luis Obispo,45,2022-10-24,89,89,89,0,2055,2061,2060,1,2,0,0,0,529,529,529,529
San Mateo,45,2022-10-24,473,473,473,0,11148,11172,11171,1,19,0,0,2,738,738,738,738
Santa Barbara,45,2022-10-24,164,164,164,0,5730,5743,5742,1,19,2,2,4,734,734,732,732
Santa Clara,45,2022-10-24,1211,1211,1211,0,29387,29447,29446,1,92,3,3,9,2550,2550,2547,2547
Santa Cruz,45,2022-10-24,240,240,240,0,10203,10223,10222,1,14,1,1,0,275,275,274,274
Shasta,45,2022-10-24,76,76,76,0,984,985,984,1,5,0,0,2,591,591,591,591
Siskiyou,45,2022-10-24,12,12,12,0,171,172,171,1,0,0,0,0,94,94,94,94
Solano,45,2022-10-24,239,239,239,0,5028,5039,5038,1,20,0,0,1,460,460,460,460
Sonoma,45,2022-10-24,244,244,244,0,5438,5451,5450,1,23,0,0,1,529,529,529,529
Stanislaus,45,2022-10-24,199,199,199,0,4851,4861,4860,1,40,3,3,3,1795,1795,1792,1792
Sutter,45,2022-10-24,28,28,28,0,881,882,881,1,0,0,0,0,232,232,232,232
Tehama,45,2022-10-24,36,36,36,0,406,407,406,1,1,0,0,0,217,217,217,217
Trinity,45,2022-10-24,1,1,1,0,35,36,35,1,0,0,0,0,21,21,21,21
Tulare,45,2022-10-24,110,110,110,0,4343,4352,4351,1,16,1,1,1,1550,1550,1549,1549
Tuolumne,45,2022-10-24,33,33,33,0,625,626,625,1,1,1,1,0,202,202,201,201
Ventura,45,2022-10-24,294,294,294,0,9024,9043,9042,1,40,3,3,6,1604,1604,1601,1601
Yolo,45,2022-10-24,91,91,91,0,2050,2055,2054,1,5,1,1,0,406,406,405,405
Yuba,45,2022-10-24,51,51,51,0,799,800,799,1,5,0,0,1,122,122,122,122
Alameda,46,2022-10-31,1056,1056,1056,0,23016,23064,23063,1,57,5,5,4,2072,2072,2067,2067
Amador,46,2022-10-31,18,18,18,0,578,579,578,1,2,1,1,0,94,94,93,93
Butte,46,2022-10-31,82,82,82,0,1458,1461,1460,1,11,0,0,3,467,467,467,467
Calaveras,46,2022-10-31,13,13,13,0,257,258,257,1,0,0,0,0,135,135,135,135
Colusa,46,2022-10-31,11,11,11,0,95,96,95,1,0,0,0,0,22,22,22,22
Contra Costa,46,2022-10-31,747,747,747,0,13901,13930,13929,1,37,6,6,7,1483,1483,1477,1477
Del Norte,46,2022-10-31,16,16,16,0,357,358,357,1,1,0,0,0,55,55,55,55
El Dorado,46,2022-10-31,100,100,100,0,1406,1409,1408,1,2,0,0,0,233,233,233,233
Fresno,46,2022-10-31,427,427,427,0,10499,10522,10521,1,57,4,4,8,2891,2891,2887,2887
Glenn,46,2022-10-31,16,16,16,0,156,157,156,1,1,0,0,0,53,53,53,53
Humboldt,46,2022-10-31,44,44,44,0,1021,1022,1021,1,6,0,0,2,162,162,162,162
Imperial,46,2022-10-31,126,126,126,0,2785,2791,2790,1,7,0,0,0,963,963,963,963
Inyo,46,2022-10-31,7,7,7,0,242,243,242,1,0,0,0,0,60,60,60,60
Kern,46,2022-10-31,341,341,341,0,9872,9893,9892,1,20,2,2,2,2436,2436,2434,2434
Kings,46,2022-10-31,118,118,118,0,2461,2467,2466,1,3,0,0,1,466,466,466,466
Lake,46,2022-10-31,30,30,30,0,752,753,752,1,1,0,0,1,150,150,150,150
Lassen,46,2022-10-31,19,19,19,0,522,523,522,1,1,0,0,0,63,63,63,63
Los Angeles,46,2022-10-31,6228,6241,6241,0,192568,192970,192968,2,344,37,37,44,33839,33839,33802,33802
Madera,46,2022-10-31,54,54,54,0,1433,1435,1434,1,3,0,0,2,375,375,375,375
Marin,46,2022-10-31,137,137,137,0,3509,3516,3515,1,10,1,1,1,317,317,316,316
Mariposa,46,2022-10-31,8,8,8,0,126,127,126,1,0,0,0,0,30,30,30,30
Mendocino,46,2022-10-31,23,23,23,0,709,710,709,1,1,0,0,2,136,136,136,136
Merced,46,2022-10-31,114,114,114,0,2139,2145,2144,1,5,1,1,0,875,875,874,874
Modoc,46,2022-10-31,1,1,1,0,13,14,13,1,0,0,0,0,9,9,9,9
Mono,46,2022-10-31,1,1,1,0,85,86,85,1,1,0,0,0,8,8,8,8
Monterey,46,2022-10-31,150,150,150,0,3693,3703,3702,1,18,2,2,0,774,774,772,772
Napa,46,2022-10-31,54,54,54,0,1505,1509,1508,1,2,0,0,0,159,159,159,159
Nevada,46,2022-10-31,38,38,38,0,775,776,775,1,6,0,0,0,136,136,136,136
Orange,46,2022-10-31,1189,1189,1189,0,27139,27194,27193,1,91,14,14,14,7615,7615,7601,7601
Placer,46,2022-10-31,151,151,151,0,2755,2762,2761,1,40,0,0,5,662,662,662,662
Plumas,46,2022-10-31,5,5,5,0,87,88,87,1,0,0,0,0,13,13,13,13
Riverside,46,2022-10-31,1050,1050,1050,0,19558,19599,19598,1,64,5,5,5,6659,6659,6654,6654
Sacramento,46,2022-10-31,754,754,754,0,14139,14168,14167,1,80,8,8,16,3381,3381,3373,3373
San Benito,46,2022-10-31,33,33,33,0,745,746,745,1,1,0,0,1,102,102,102,102
San Bernardino,46,2022-10-31,1048,1048,1048,0,22481,22527,22526,1,64,2,2,11,8102,8102,8100,8100
San Diego,46,2022-10-31,1772,1777,1777,0,42849,42939,42938,1,109,5,5,13,5601,5601,5596,5596
San Francisco,46,2022-10-31,620,620,620,0,14642,14673,14672,1,45,3,3,3,1077,1077,1074,1074
San Joaquin,46,2022-10-31,332,332,332,0,8598,8617,8616,1,21,6,6,3,2352,2352,2346,2346
San Luis Obispo,46,2022-10-31,81,81,81,0,2013,2019,2018,1,1,1,1,0,530,530,529,529
San Mateo,46,2022-10-31,521,521,521,0,11581,11606,11605,1,30,0,0,2,738,738,738,738
Santa Barbara,46,2022-10-31,181,181,181,0,6036,6049,6048,1,20,1,1,6,735,735,734,734
Santa Clara,46,2022-10-31,1288,1289,1289,0,30978,31044,31043,1,85,3,3,16,2553,2553,2550,2550
Santa Cruz,46,2022-10-31,188,188,188,0,9957,9978,9977,1,7,0,0,0,275,275,275,275
Shasta,46,2022-10-31,66,66,66,0,830,831,830,1,6,2,2,1,593,593,591,591
Siskiyou,46,2022-10-31,17,17,17,0,216,217,216,1,1,1,1,0,95,95,94,94
Solano,46,2022-10-31,311,311,311,0,5255,5268,5267,1,16,0,0,4,460,460,460,460
Sonoma,46,2022-10-31,205,205,205,0,5598,5611,5610,1,24,0,0,3,529,529,529,529
Stanislaus,46,2022-10-31,235,235,235,0,4830,4842,4841,1,49,1,1,8,1796,1796,1795,1795
Sutter,46,2022-10-31,55,55,55,0,902,903,902,1,0,0,0,0,232,232,232,232
Tehama,46,2022-10-31,26,26,26,0,395,396,395,1,1,0,0,0,217,217,217,217
Trinity,46,2022-10-31,18,18,18,0,73,74,73,1,5,0,0,0,21,21,21,21
Tulare,46,2022-10-31,153,153,153,0,3677,3685,3684,1,12,0,0,0,1550,1550,1550,1550
Tuolumne,46,2022-10-31,27,27,27,0,518,519,518,1,3,0,0,0,202,202,202,202
Ventura,46,2022-10-31,378,378,378,0,9550,9571,9570,1,24,2,2,2,1606,1606,1604,1604
Yolo,46,2022-10-31,83,83,83,0,1834,1839,1838,1,3,0,0,1,406,406,406,406
Yuba,46,2022-10-31,46,46,46,0,776,777,776,1,3,0,0,0,122,122,122,122
Alameda,47,2022-11-07,1336,1337,1337,0,24522,24574,24573,1,58,8,8,11,2080,2080,2072,2072
Amador,47,2022-11-07,32,32,32,0,685,687,686,1,3,0,0,0,94,94,94,94
Butte,47,2022-11-07,118,118,118,0,1370,1374,1373,1,11,0,0,2,467,467,467,467
Calaveras,47,2022-11-07,16,16,16,0,334,335,334,1,0,0,0,0,135,135,135,135
Colusa,47,2022-11-07,2,2,2,0,102,103,102,1,0,0,0,0,22,22,22,22
Contra Costa,47,2022-11-07,881,881,881,0,15675,15710,15709,1,43,3,3,4,1486,1486,1483,1483
Del Norte,47,2022-11-07,10,10,10,0,400,401,400,1,0,0,0,0,55,55,55,55
El Dorado,47,2022-11-07,108,108,108,0,1598,1602,1601,1,7,2,2,0,235,235,233,233
Fresno,47,2022-11-07,599,599,599,0,10716,10739,10738,1,61,3,3,9,2894,2894,2891,2891
Glenn,47,2022-11-07,29,29,29,0,131,132,131,1,0,0,0,0,53,53,53,53
Humboldt,47,2022-11-07,85,85,85,0,1025,1026,1025,1,9,0,0,2,162,162,162,162
Imperial,47,2022-11-07,210,210,210,0,3708,3717,3716,1,7,0,0,0,963,963,963,963
Inyo,47,2022-11-07,19,19,19,0,267,268,267,1,0,0,0,0,60,60,60,60
Kern,47,2022-11-07,478,478,478,0,10745,10770,10769,1,29,1,1,5,2437,2437,2436,2436
Kings,47,2022-11-07,148,148,148,0,2457,2463,2462,1,7,1,1,0,467,467,466,466
Lake,47,2022-11-07,51,51,51,0,795,796,795,1,3,0,0,1,150,150,150,150
Lassen,47,2022-11-07,10,10,10,0,451,452,451,1,0,0,0,0,63,63,63,63
Los Angeles,47,2022-11-07,8113,8132,8132,0,192285,192704,192702,2,387,55,55,53,33894,33894,33839,33839
Madera,47,2022-11-07,78,78,78,0,1612,1616,1615,1,3,0,0,4,375,375,375,375
Marin,47,2022-11-07,152,152,152,0,3369,3377,3376,1,9,0,0,0,317,317,317,317
Mariposa,47,2022-11-07,14,14,14,0,121,122,121,1,0,0,0,0,30,30,30,30
Mendocino,47,2022-11-07,37,37,37,0,819,820,819,1,4,1,1,0,137,137,136,136
Merced,47,2022-11-07,142,142,142,0,2592,2598,2597,1,9,4,4,0,879,879,875,875
Modoc,47,2022-11-07,2,2,2,0,6,7,6,1,0,0,0,0,9,9,9,9
Mono,47,2022-11-07,3,3,3,0,96,97,96,1,0,0,0,0,8,8,8,8
Monterey,47,2022-11-07,219,219,219,0,3932,3941,3940,1,18,1,1,0,775,775,774,774
Napa,47,2022-11-07,77,77,77,0,1757,1762,1761,1,6,0,0,0,159,159,159,159
Nevada,47,2022-11-07,60,60,60,0,744,745,744,1,3,0,0,1,136,136,136,136
Orange,47,2022-11-07,1286,1287,1287,0,28967,29030,29029,1,94,11,11,20,7626,7626,7615,7615
Placer,47,2022-11-07,231,231,231,0,3353,3362,3361,1,53,2,2,7,664,664,662,662
Plumas,47,2022-11-07,5,5,5,0,69,70,69,1,0,0,0,0,13,13,13,13
Riverside,47,2022-11-07,1508,1509,1509,0,21687,21735,21734,1,71,2,2,5,6661,6661,6659,6659
Sacramento,47,2022-11-07,1122,1123,1123,0,16054,16089,16088,1,90,7,7,9,3388,3388,3381,3381
San Benito,47,2022-11-07,43,43,43,0,924,925,924,1,1,0,0,0,102,102,102,102
San Bernardino,47,2022-11-07,1463,1465,1465,0,24064,24116,24115,1,76,2,2,17,8104,8104,8102,8102
San Diego,47,2022-11-07,2157,2162,2162,0,45689,45788,45787,1,117,8,8,24,5609,5609,5601,5601
San Francisco,47,2022-11-07,716,716,716,0,14906,14937,14936,1,42,2,2,8,1079,1079,1077,1077
San Joaquin,47,2022-11-07,482,482,482,0,8813,8834,8833,1,24,2,2,3,2354,2354,2352,2352
San Luis Obispo,47,2022-11-07,131,131,131,0,2272,2278,2277,1,4,0,0,2,530,530,530,530
San Mateo,47,2022-11-07,582,582,582,0,12353,12382,12381,1,27,0,0,3,738,738,738,738
Santa Barbara,47,2022-11-07,225,225,225,0,6672,6688,6687,1,18,1,1,2,736,736,735,735
Santa Clara,47,2022-11-07,1675,1679,1679,0,31524,31592,31591,1,76,7,7,19,2560,2560,2553,2553
Santa Cruz,47,2022-11-07,282,282,282,0,11333,11359,11358,1,8,0,0,0,275,275,275,275
Shasta,47,2022-11-07,98,98,98,0,1058,1060,1059,1,11,1,1,3,594,594,593,593
Siskiyou,47,2022-11-07,15,15,15,0,295,296,295,1,1,0,0,0,95,95,95,95
Solano,47,2022-11-07,384,384,384,0,5513,5527,5526,1,22,2,2,3,462,462,460,460
Sonoma,47,2022-11-07,251,251,251,0,5933,5947,5946,1,11,2,2,2,531,531,529,529
Stanislaus,47,2022-11-07,300,300,300,0,4931,4944,4943,1,42,2,2,9,1798,1798,1796,1796
Sutter,47,2022-11-07,86,86,86,0,958,959,958,1,0,0,0,0,232,232,232,232
Tehama,47,2022-11-07,47,47,47,0,472,473,472,1,2,0,0,0,217,217,217,217
Trinity,47,2022-11-07,2,2,2,0,34,35,34,1,0,0,0,0,21,21,21,21
Tulare,47,2022-11-07,160,160,160,0,4366,4376,4375,1,14,0,0,0,1550,1550,1550,1550
Tuolumne,47,2022-11-07,83,83,83,0,682,683,682,1,2,0,0,0,202,202,202,202
Ventura,47,2022-11-07,448,448,448,0,10372,10397,10396,1,36,2,2,1,1608,1608,1606,1606
Yolo,47,2022-11-07,174,174,174,0,2238,2244,2243,1,3,2,2,0,408,408,406,406
Yuba,47,2022-11-07,47,47,47,0,902,903,902,1,3,0,0,2,122,122,122,122
Alameda,48,2022-11-14,1507,1510,1510,0,24311,24366,24365,1,77,3,3,9,2083,2083,2080,2080
Amador,48,2022-11-14,20,20,20,0,656,657,656,1,2,0,0,0,94,94,94,94
Butte,48,2022-11-14,120,120,120,0,1380,1384,1383,1,20,0,0,1,467,467,467,467
Calaveras,48,2022-11-14,30,30,30,0,341,342,341,1,0,0,0,0,135,135,135,135
Colusa,48,2022-11-14,11,11,11,0,100,101,100,1,1,0,0,0,22,22,22,22
Contra Costa,48,2022-11-14,968,968,968,0,15962,15997,15996,1,56,1,1,5,1487,1487,1486,1486
Del Norte,48,2022-11-14,20,20,20,0,429,430,429,1,1,0,0,0,55,55,55,55
El Dorado,48,2022-11-14,143,143,143,0,1591,1596,1595,1,7,0,0,1,235,235,235,235
Fresno,48,2022-11-14,772,772,772,0,11276,11301,11300,1,72,8,8,13,2902,2902,2894,2894
Glenn,48,2022-11-14,20,20,20,0,160,161,160,1,0,0,0,0,53,53,53,53
Humboldt,48,2022-11-14,84,84,84,0,1105,1106,1105,1,6,0,0,0,162,162,162,162
Imperial,48,2022-11-14,251,251,251,0,3221,3230,3229,1,4,0,0,1,963,963,963,963
Inyo,48,2022-11-14,11,11,11,0,543,544,543,1,0,0,0,0,60,60,60,60
Kern,48,2022-11-14,470,470,470,0,10704,10730,10729,1,26,1,1,6,2438,2438,2437,2437
Kings,48,2022-11-14,201,201,201,0,2624,2630,2629,1,6,2,2,0,469,469,467,467
Lake,48,2022-11-14,54,54,54,0,803,804,803,1,2,0,0,1,150,150,150,150
Lassen,48,2022-11-14,35,35,35,0,544,545,544,1,0,1,1,0,64,64,63,63
Los Angeles,48,2022-11-14,9433,9454,9454,0,197233,197684,197682,2,477,49,49,75,33943,33943,33894,33894
Madera,48,2022-11-14,95,95,95,0,1713,1718,1717,1,4,0,0,3,375,375,375,375
Marin,48,2022-11-14,175,175,175,0,3569,3579,3578,1,8,0,0,2,317,317,317,317
Mariposa,48,2022-11-14,18,18,18,0,137,138,137,1,0,0,0,0,30,30,30,30
Mendocino,48,2022-11-14,39,39,39,0,908,910,909,1,3,0,0,1,137,137,137,137
Merced,48,2022-11-14,186,186,186,0,2639,2646,2645,1,6,0,0,0,879,879,879,879
Modoc,48,2022-11-14,3,3,3,0,11,12,11,1,0,0,0,0,9,9,9,9
Mono,48,2022-11-14,10,10,10,0,122,123,122,1,0,0,0,0,8,8,8,8
Monterey,48,2022-11-14,200,200,200,0,4157,4168,4167,1,20,1,1,1,776,776,775,775
Napa,48,2022-11-14,106,106,106,0,1919,1925,1924,1,5,0,0,0,159,159,159,159
Nevada,48,2022-11-14,65,65,65,0,797,799,798,1,3,0,0,2,136,136,136,136
Orange,48,2022-11-14,1618,1622,1622,0,27194,27256,27255,1,118,8,8,21,7634,7634,7626,7626
Placer,48,2022-11-14,320,320,320,0,3855,3864,3863,1,54,1,1,5,665,665,664,664
Plumas,48,2022-11-14,4,4,4,0,80,81,80,1,0,0,0,0,13,13,13,13
Riverside,48,2022-11-14,1662,1666,1666,0,22496,22548,22547,1,95,4,4,10,6665,6665,6661,6661
Sacramento,48,2022-11-14,1213,1214,1214,0,16984,17022,17021,1,82,7,7,18,3395,3395,3388,3388
San Benito,48,2022-11-14,42,42,42,0,979,981,980,1,1,0,0,0,102,102,102,102
San Bernardino,48,2022-11-14,1816,1822,1822,0,24234,24287,24286,1,83,0,0,14,8104,8104,8104,8104
San Diego,48,2022-11-14,2456,2463,2463,0,43913,44013,44012,1,124,7,7,21,5616,5616,5609,5609
San Francisco,48,2022-11-14,717,717,717,0,13762,13793,13792,1,52,7,7,5,1086,1086,1079,1079
San Joaquin,48,2022-11-14,609,609,609,0,9500,9522,9521,1,20,0,0,5,2354,2354,2354,2354
San Luis Obispo,48,2022-11-14,120,120,120,0,2201,2206,2205,1,6,0,0,1,530,530,530,530
San Mateo,48,2022-11-14,662,662,662,0,11419,11446,11445,1,27,0,0,2,738,738,738,738
Santa Barbara,48,2022-11-14,192,192,192,0,5891,5905,5904,1,15,1,1,2,737,737,736,736
Santa Clara,48,2022-11-14,1773,1778,1778,0,30788,30859,30858,1,117,3,3,14,2563,2563,2560,2560
Santa Cruz,48,2022-11-14,249,249,249,0,9607,9629,9628,1,11,1,1,0,276,276,275,275
Shasta,48,2022-11-14,107,107,107,0,1073,1075,1074,1,10,1,1,2,595,595,594,594
Siskiyou,48,2022-11-14,27,27,27,0,397,398,397,1,2,0,0,0,95,95,95,95
Solano,48,2022-11-14,438,438,438,0,5428,5442,5441,1,26,0,0,3,462,462,462,462
Sonoma,48,2022-11-14,268,268,268,0,6037,6051,6050,1,23,1,1,0,532,532,531,531
Stanislaus,48,2022-11-14,328,328,328,0,5223,5236,5235,1,48,0,0,10,1798,1798,1798,1798
Sutter,48,2022-11-14,95,95,95,0,1183,1185,1184,1,0,0,0,0,232,232,232,232
Tehama,48,2022-11-14,50,50,50,0,574,575,574,1,1,0,0,0,217,217,217,217
Trinity,48,2022-11-14,11,11,11,0,52,53,52,1,0,1,1,0,22,22,21,21
Tulare,48,2022-11-14,310,310,310,0,4283,4294,4293,1,16,0,0,1,1550,1550,1550,1550
Tuolumne,48,2022-11-14,77,77,77,0,695,696,695,1,2,0,0,0,202,202,202,202
Ventura,48,2022-11-14,572,572,572,0,10636,10662,10661,1,28,1,1,4,1609,1609,1608,1608
Yolo,48,2022-11-14,152,152,152,0,2166,2172,2171,1,2,6,6,0,414,414,408,408
Yuba,48,2022-11-14,60,60,60,0,987,988,987,1,6,0,0,1,122,122,122,122
Alameda,49,2022-11-21,1743,1748,1748,0,25499,25560,25559,1,82,9,9,16,2092,2092,2083,2083
Amador,49,2022-11-21,28,28,28,0,833,835,834,1,2,0,0,0,94,94,94,94
Butte,49,2022-11-21,143,143,143,0,1328,1333,1332,1,21,0,0,1,467,467,467,467
Calaveras,49,2022-11-21,40,40,40,0,421,422,421,1,2,0,0,0,135,135,135,135
Colusa,49,2022-11-21,9,9,9,0,110,111,110,1,0,0,0,0,22,22,22,22
Contra Costa,49,2022-11-21,1028,1029,1029,0,16521,16560,16559,1,52,3,3,8,1490,1490,1487,1487
Del Norte,49,2022-11-21,18,18,18,0,489,490,489,1,4,0,0,0,55,55,55,55
El Dorado,49,2022-11-21,186,186,186,0,1830,1836,1835,1,10,0,0,1,235,235,235,235
Fresno,49,2022-11-21,1070,1071,1071,0,12150,12180,12179,1,114,5,5,9,2907,2907,2902,2902
Glenn,49,2022-11-21,21,21,21,0,214,215,214,1,0,0,0,0,53,53,53,53
Humboldt,49,2022-11-21,123,123,123,0,1174,1177,1176,1,4,1,1,1,163,163,162,162
Imperial,49,2022-11-21,280,280,280,0,3122,3129,3128,1,3,1,1,1,964,964,963,963
Inyo,49,2022-11-21,29,29,29,0,405,406,405,1,0,1,1,0,61,61,60,60
Kern,49,2022-11-21,506,506,506,0,10333,10359,10358,1,54,3,3,10,2441,2441,2438,2438
Kings,49,2022-11-21,295,295,295,0,2780,2787,2786,1,4,2,2,1,471,471,469,469
Lake,49,2022-11-21,55,55,55,0,928,929,928,1,0,1,1,1,151,151,150,150
Lassen,49,2022-11-21,34,34,34,0,541,542,541,1,0,0,0,0,64,64,64,64
Los Angeles,49,2022-11-21,13234,13265,13265,0,200385,200866,200864,2,648,69,69,93,34012,34012,33943,33943
Madera,49,2022-11-21,168,168,168,0,1861,1867,1866,1,11,0,0,1,375,375,375,375
Marin,49,2022-11-21,179,179,179,0,3353,3362,3361,1,8,0,0,0,317,317,317,317
Mariposa,49,2022-11-21,19,19,19,0,170,171,170,1,0,0,0,0,30,30,30,30
Mendocino,49,2022-11-21,39,39,39,0,890,892,891,1,4,0,0,1,137,137,137,137
Merced,49,2022-11-21,269,269,269,0,2931,2939,2938,1,9,2,2,4,881,881,879,879
Modoc,49,2022-11-21,8,8,8,0,13,14,13,1,0,0,0,0,9,9,9,9
Mono,49,2022-11-21,3,3,3,0,107,108,107,1,0,0,0,0,8,8,8,8
Monterey,49,2022-11-21,227,227,227,0,4444,4456,4455,1,17,1,1,0,777,777,776,776
Napa,49,2022-11-21,146,146,146,0,2040,2046,2045,1,4,0,0,1,159,159,159,159
Nevada,49,2022-11-21,92,92,92,0,935,936,935,1,2,0,0,2,136,136,136,136
Orange,49,2022-11-21,2240,2247,2247,0,28654,28723,28722,1,170,14,14,32,7648,7648,7634,7634
Placer,49,2022-11-21,362,362,362,0,4079,4092,4091,1,53,0,0,6,665,665,665,665
Plumas,49,2022-11-21,7,7,7,0,104,105,104,1,1,0,0,0,13,13,13,13
Riverside,49,2022-11-21,2181,2188,2188,0,24558,24617,24616,1,110,7,7,9,6672,6672,6665,6665
Sacramento,49,2022-11-21,1553,1558,1558,0,19057,19103,19102,1,105,3,3,18,3398,3398,3395,3395
San Benito,49,2022-11-21,64,64,64,0,1157,1159,1158,1,2,0,0,0,102,102,102,102
San Bernardino,49,2022-11-21,2391,2398,2398,0,26915,26980,26979,1,89,1,1,19,8105,8105,8104,8104
San Diego,49,2022-11-21,3174,3182,3182,0,44135,44242,44241,1,198,3,3,26,5619,5619,5616,5616
San Francisco,49,2022-11-21,958,959,959,0,15162,15198,15197,1,54,5,5,7,1091,1091,1086,1086
San Joaquin,49,2022-11-21,764,764,764,0,11080,11107,11106,1,36,1,1,5,2355,2355,2354,2354
San Luis Obispo,49,2022-11-21,170,170,170,0,2352,2358,2357,1,4,1,1,0,531,531,530,530
San Mateo,49,2022-11-21,759,759,759,0,12399,12431,12430,1,36,0,0,1,738,738,738,738
Santa Barbara,49,2022-11-21,321,321,321,0,6109,6125,6124,1,15,3,3,3,740,740,737,737
Santa Clara,49,2022-11-21,2210,2217,2217,0,34650,34735,34734,1,119,10,10,23,2573,2573,2563,2563
Santa Cruz,49,2022-11-21,286,286,286,0,9527,9551,9550,1,12,0,0,2,276,276,276,276
Shasta,49,2022-11-21,99,99,99,0,1056,1059,1058,1,14,0,0,1,595,595,595,595
Siskiyou,49,2022-11-21,24,24,24,0,342,343,342,1,1,0,0,0,95,95,95,95
Solano,49,2022-11-21,490,490,490,0,5667,5682,5681,1,32,1,1,5,463,463,462,462
Sonoma,49,2022-11-21,326,326,326,0,5783,5797,5796,1,22,0,0,4,532,532,532,532
Stanislaus,49,2022-11-21,445,445,445,0,5970,5984,5983,1,51,0,0,10,1798,1798,1798,1798
Sutter,49,2022-11-21,92,92,92,0,1143,1145,1144,1,0,0,0,0,232,232,232,232
Tehama,49,2022-11-21,74,74,74,0,673,674,673,1,3,0,0,2,217,217,217,217
Trinity,49,2022-11-21,5,5,5,0,51,52,51,1,0,0,0,0,22,22,22,22
Tulare,49,2022-11-21,430,430,430,0,5506,5520,5519,1,23,0,0,1,1550,1550,1550,1550
Tuolumne,49,2022-11-21,97,97,97,0,766,767,766,1,3,1,1,0,203,203,202,202
Ventura,49,2022-11-21,728,728,728,0,10731,10756,10755,1,43,1,1,2,1610,1610,1609,1609
Yolo,49,2022-11-21,132,132,132,0,2247,2254,2253,1,7,4,4,2,418,418,414,414
Yuba,49,2022-11-21,70,70,70,0,1027,1028,1027,1,10,0,0,1,122,122,122,122
Alameda,50,2022-11-28,2272,2279,2279,0,22325,22382,22381,1,103,6,6,13,2098,2098,2092,2092
Amador,50,2022-11-28,32,32,32,0,757,758,757,1,5,1,1,1,95,95,94,94
Butte,50,2022-11-28,204,204,204,0,1476,1481,1480,1,41,0,0,1,467,467,467,467
Calaveras,50,2022-11-28,32,32,32,0,402,403,402,1,3,0,0,0,135,135,135,135
Colusa,50,2022-11-28,14,14,14,0,184,185,184,1,0,0,0,0,22,22,22,22
Contra Costa,50,2022-11-28,1472,1475,1475,0,15540,15580,15579,1,67,4,4,8,1494,1494,1490,1490
Del Norte,50,2022-11-28,33,33,33,0,458,459,458,1,1,1,1,0,56,56,55,55
El Dorado,50,2022-11-28,185,185,185,0,1549,1553,1552,1,13,1,1,1,236,236,235,235
Fresno,50,2022-11-28,1322,1323,1323,0,11711,11742,11741,1,136,6,6,19,2913,2913,2907,2907
Glenn,50,2022-11-28,17,17,17,0,194,195,194,1,3,0,0,0,53,53,53,53
Humboldt,50,2022-11-28,114,114,114,0,1045,1048,1047,1,10,0,0,0,163,163,163,163
Imperial,50,2022-11-28,379,379,379,0,2790,2799,2798,1,6,1,1,1,965,965,964,964
Inyo,50,2022-11-28,34,34,34,0,376,377,376,1,2,0,0,0,61,61,61,61
Kern,50,2022-11-28,600,600,600,0,9536,9562,9561,1,60,5,5,6,2446,2446,2441,2441
Kings,50,2022-11-28,245,245,245,0,2545,2553,2552,1,10,0,0,0,471,471,471,471
Lake,50,2022-11-28,49,49,49,0,848,850,849,1,1,0,0,0,151,151,151,151
Lassen,50,2022-11-28,27,27,27,0,493,494,493,1,0,0,0,0,64,64,64,64
Los Angeles,50,2022-11-28,18969,19018,19018,0,185019,185492,185490,2,918,90,90,122,34102,34102,34012,34012
Madera,50,2022-11-28,162,162,162,0,1627,1632,1631,1,13,0,0,2,375,375,375,375
Marin,50,2022-11-28,298,298,298,0,3071,3080,3079,1,19,0,0,1,317,317,317,317
Mariposa,50,2022-11-28,23,23,23,0,136,137,136,1,0,0,0,0,30,30,30,30
Mendocino,50,2022-11-28,49,49,49,0,726,727,726,1,5,0,0,2,137,137,137,137
Merced,50,2022-11-28,349,349,349,0,2552,2560,2559,1,18,5,5,2,886,886,881,881
Modoc,50,2022-11-28,5,5,5,0,10,11,10,1,0,0,0,0,9,9,9,9
Mono,50,2022-11-28,4,4,4,0,94,95,94,1,0,0,0,0,8,8,8,8
Monterey,50,2022-11-28,283,283,283,0,3892,3904,3903,1,26,1,1,0,778,778,777,777
Napa,50,2022-11-28,141,141,141,0,1884,1890,1889,1,6,0,0,3,159,159,159,159
Nevada,50,2022-11-28,118,118,118,0,1008,1011,1010,1,9,0,0,0,136,136,136,136
Orange,50,2022-11-28,3191,3198,3198,0,26616,26684,26683,1,221,17,17,34,7665,7665,7648,7648
Placer,50,2022-11-28,391,391,391,0,3786,3797,3796,1,69,3,3,5,668,668,665,665
Plumas,50,2022-11-28,6,6,6,0,143,144,143,1,0,0,0,0,13,13,13,13
Riverside,50,2022-11-28,3237,3244,3244,0,23436,23496,23495,1,188,12,12,22,6684,6684,6672,6672
Sacramento,50,2022-11-28,1815,1821,1821,0,18077,18124,18123,1,126,9,9,14,3407,3407,3398,3398
San Benito,50,2022-11-28,131,131,131,0,1223,1226,1225,1,1,0,0,0,102,102,102,102
San Bernardino,50,2022-11-28,3368,3375,3375,0,26028,26094,26093,1,146,1,1,20,8106,8106,8105,8105
San Diego,50,2022-11-28,4098,4108,4108,0,32004,32085,32084,1,259,7,7,27,5626,5626,5619,5619
San Francisco,50,2022-11-28,1171,1172,1172,0,12783,12816,12815,1,67,6,6,8,1097,1097,1091,1091
San Joaquin,50,2022-11-28,994,995,995,0,10948,10977,10976,1,50,3,3,11,2358,2358,2355,2355
San Luis Obispo,50,2022-11-28,179,179,179,0,2248,2256,2255,1,9,3,3,1,534,534,531,531
San Mateo,50,2022-11-28,1116,1117,1117,0,11096,11124,11123,1,42,1,1,3,739,739,738,738
Santa Barbara,50,2022-11-28,466,466,466,0,5212,5226,5225,1,27,2,2,5,742,742,740,740
Santa Clara,50,2022-11-28,2941,2948,2948,0,28323,28396,28395,1,159,9,9,22,2582,2582,2573,2573
Santa Cruz,50,2022-11-28,371,371,371,0,6667,6685,6684,1,20,0,0,2,276,276,276,276
Shasta,50,2022-11-28,99,99,99,0,1010,1012,1011,1,16,1,1,3,596,596,595,595
Siskiyou,50,2022-11-28,27,27,27,0,277,278,277,1,2,0,0,0,95,95,95,95
Solano,50,2022-11-28,591,591,591,0,5186,5200,5199,1,34,2,2,7,465,465,463,463
Sonoma,50,2022-11-28,455,455,455,0,5012,5026,5025,1,48,2,2,3,534,534,532,532
Stanislaus,50,2022-11-28,523,523,523,0,5363,5377,5376,1,77,3,3,4,1801,1801,1798,1798
Sutter,50,2022-11-28,83,83,83,0,1120,1123,1122,1,0,0,0,0,232,232,232,232
Tehama,50,2022-11-28,70,70,70,0,632,634,633,1,6,0,0,3,217,217,217,217
Trinity,50,2022-11-28,3,3,3,0,60,61,60,1,0,0,0,0,22,22,22,22
Tulare,50,2022-11-28,509,509,509,0,4933,4947,4946,1,34,0,0,0,1550,1550,1550,1550
Tuolumne,50,2022-11-28,72,72,72,0,676,677,676,1,4,0,0,0,203,203,203,203
Ventura,50,2022-11-28,966,967,967,0,10618,10647,10646,1,58,2,2,2,1612,1612,1610,1610
Yolo,50,2022-11-28,169,169,169,0,2034,2041,2040,1,3,4,4,1,422,422,418,418
Yuba,50,2022-11-28,92,92,92,0,927,929,928,1,12,0,0,0,122,122,122,122
Alameda,51,2022-12-05,2835,2843,2843,0,29280,29359,29358,1,126,7,7,13,2105,2105,2098,2098
Amador,51,2022-12-05,41,41,41,0,812,814,813,1,3,0,0,2,95,95,95,95
Butte,51,2022-12-05,239,239,239,0,1887,1893,1892,1,38,7,7,5,474,474,467,467
Calaveras,51,2022-12-05,45,45,45,0,485,486,485,1,0,0,0,0,135,135,135,135
Colusa,51,2022-12-05,13,13,13,0,206,207,206,1,4,0,0,0,22,22,22,22
Contra Costa,51,2022-12-05,1783,1788,1788,0,19307,19359,19358,1,78,0,0,11,1494,1494,1494,1494
Del Norte,51,2022-12-05,39,39,39,0,566,567,566,1,2,0,0,0,56,56,56,56
El Dorado,51,2022-12-05,182,182,182,0,1577,1583,1582,1,14,1,1,0,237,237,236,236
Fresno,51,2022-12-05,1549,1553,1553,0,14302,14341,14340,1,177,6,6,17,2919,2919,2913,2913
Glenn,51,2022-12-05,24,24,24,0,232,233,232,1,2,0,0,0,53,53,53,53
Humboldt,51,2022-12-05,134,134,134,0,1086,1089,1088,1,17,1,1,2,164,164,163,163
Imperial,51,2022-12-05,587,587,587,0,3397,3407,3406,1,18,2,2,5,967,967,965,965
Inyo,51,2022-12-05,26,26,26,0,333,334,333,1,1,1,1,0,62,62,61,61
Kern,51,2022-12-05,819,819,819,0,10832,10862,10861,1,55,1,1,10,2447,2447,2446,2446
Kings,51,2022-12-05,295,295,295,0,3048,3057,3056,1,8,0,0,0,471,471,471,471
Lake,51,2022-12-05,64,64,64,0,831,832,831,1,2,0,0,0,151,151,151,151
Lassen,51,2022-12-05,14,14,14,0,444,445,444,1,0,0,0,0,64,64,64,64
Los Angeles,51,2022-12-05,22467,22528,22528,0,244821,245485,245482,3,1119,111,111,151,34213,34213,34102,34102
Madera,51,2022-12-05,205,205,205,0,1983,1990,1989,1,12,0,0,3,375,375,375,375
Marin,51,2022-12-05,313,313,313,0,3509,3521,3520,1,14,0,0,2,317,317,317,317
Mariposa,51,2022-12-05,19,19,19,0,174,175,174,1,0,0,0,0,30,30,30,30
Mendocino,51,2022-12-05,47,47,47,0,797,798,797,1,6,1,1,2,138,138,137,137
Merced,51,2022-12-05,352,352,352,0,3211,3221,3220,1,23,2,2,2,888,888,886,886
Modoc,51,2022-12-05,12,12,12,0,13,14,13,1,0,0,0,0,9,9,9,9
Mono,51,2022-12-05,9,9,9,0,91,92,91,1,0,0,0,0,8,8,8,8
Monterey,51,2022-12-05,272,272,272,0,4387,4401,4400,1,34,1,1,0,779,779,778,778
Napa,51,2022-12-05,161,161,161,0,2342,2348,2347,1,7,0,0,0,159,159,159,159
Nevada,51,2022-12-05,115,115,115,0,1126,1130,1129,1,8,0,0,2,136,136,136,136
Orange,51,2022-12-05,4355,4367,4367,0,34729,34823,34822,1,301,22,22,48,7687,7687,7665,7665
Placer,51,2022-12-05,396,396,396,0,4059,4072,4071,1,72,1,1,4,669,669,668,668
Plumas,51,2022-12-05,22,22,22,0,184,185,184,1,1,0,0,0,13,13,13,13
Riverside,51,2022-12-05,4047,4058,4058,0,27545,27620,27619,1,186,13,13,25,6697,6697,6684,6684
Sacramento,51,2022-12-05,2156,2163,2163,0,21271,21327,21326,1,128,9,9,28,3416,3416,3407,3407
San Benito,51,2022-12-05,218,218,218,0,1483,1488,1487,1,6,1,1,3,103,103,102,102
San Bernardino,51,2022-12-05,4125,4137,4137,0,28690,28768,28767,1,167,0,0,34,8106,8106,8106,8106
San Diego,51,2022-12-05,5686,5700,5700,0,44791,44912,44911,1,302,13,13,30,5639,5639,5626,5626
San Francisco,51,2022-12-05,1493,1498,1498,0,16003,16046,16045,1,77,7,7,7,1104,1104,1097,1097
San Joaquin,51,2022-12-05,1121,1124,1124,0,12640,12676,12675,1,70,8,8,16,2366,2366,2358,2358
San Luis Obispo,51,2022-12-05,206,206,206,0,2662,2670,2669,1,15,3,3,1,537,537,534,534
San Mateo,51,2022-12-05,1259,1263,1263,0,13631,13668,13667,1,56,1,1,1,740,740,739,739
Santa Barbara,51,2022-12-05,521,521,521,0,6765,6784,6783,1,38,1,1,9,743,743,742,742
Santa Clara,51,2022-12-05,3530,3539,3539,0,35817,35916,35915,1,207,11,11,26,2593,2593,2582,2582
Santa Cruz,51,2022-12-05,472,472,472,0,12739,12775,12774,1,22,0,0,3,276,276,276,276
Shasta,51,2022-12-05,132,132,132,0,1108,1110,1109,1,23,0,0,5,596,596,596,596
Siskiyou,51,2022-12-05,22,22,22,0,309,310,309,1,2,0,0,0,95,95,95,95
Solano,51,2022-12-05,643,643,643,0,6616,6636,6635,1,33,1,1,7,466,466,465,465
Sonoma,51,2022-12-05,507,507,507,0,5883,5900,5899,1,35,5,5,1,539,539,534,534
Stanislaus,51,2022-12-05,640,640,640,0,6730,6750,6749,1,76,1,1,7,1802,1802,1801,1801
Sutter,51,2022-12-05,96,96,96,0,1173,1176,1175,1,0,1,1,0,233,233,232,232
Tehama,51,2022-12-05,93,93,93,0,817,819,818,1,9,2,2,0,219,219,217,217
Trinity,51,2022-12-05,3,3,3,0,39,40,39,1,0,0,0,0,22,22,22,22
Tulare,51,2022-12-05,527,527,527,0,5949,5966,5965,1,35,0,0,1,1550,1550,1550,1550
Tuolumne,51,2022-12-05,107,107,107,0,852,853,852,1,2,0,0,0,203,203,203,203
Ventura,51,2022-12-05,1102,1104,1104,0,12190,12225,12224,1,71,2,2,6,1614,1614,1612,1612
Yolo,51,2022-12-05,217,217,217,0,2654,2663,2662,1,2,1,1,3,423,423,422,422
Yuba,51,2022-12-05,82,82,82,0,1038,1041,1040,1,11,0,0,1,122,122,122,122
Alameda,52,2022-12-12,2688,2695,2695,0,29592,29679,29678,1,147,11,11,20,2116,2116,2105,2105
Amador,52,2022-12-12,32,32,32,0,790,792,791,1,3,0,0,0,95,95,95,95
Butte,52,2022-12-12,182,182,182,0,1836,1843,1842,1,39,2,2,2,476,476,474,474
Calaveras,52,2022-12-12,41,41,41,0,454,455,454,1,1,0,0,0,135,135,135,135
Colusa,52,2022-12-12,12,12,12,0,272,273,272,1,1,0,0,0,22,22,22,22
Contra Costa,52,2022-12-12,1738,1744,1744,0,18444,18497,18496,1,78,10,10,4,1504,1504,1494,1494
Del Norte,52,2022-12-12,34,34,34,0,534,535,534,1,3,0,0,0,56,56,56,56
El Dorado,52,2022-12-12,146,146,146,0,1410,1416,1415,1,8,1,1,3,238,238,237,237
Fresno,52,2022-12-12,1485,1490,1490,0,13859,13901,13900,1,186,12,12,18,2931,2931,2919,2919
Glenn,52,2022-12-12,17,17,17,0,230,231,230,1,6,0,0,0,53,53,53,53
Humboldt,52,2022-12-12,107,107,107,0,1014,1017,1016,1,13,1,1,2,165,165,164,164
Imperial,52,2022-12-12,455,455,455,0,2940,2950,2949,1,27,3,3,3,970,970,967,967
Inyo,52,2022-12-12,22,22,22,0,303,304,303,1,1,0,0,0,62,62,62,62
Kern,52,2022-12-12,955,957,957,0,11016,11048,11047,1,55,2,2,4,2449,2449,2447,2447
Kings,52,2022-12-12,256,256,256,0,2855,2864,2863,1,8,2,2,0,473,473,471,471
Lake,52,2022-12-12,56,56,56,0,761,762,761,1,3,0,0,1,151,151,151,151
Lassen,52,2022-12-12,15,15,15,0,423,424,423,1,0,0,0,0,64,64,64,64
Los Angeles,52,2022-12-12,17583,17634,17634,0,227437,228102,228099,3,1113,158,158,154,34371,34371,34213,34213
Madera,52,2022-12-12,212,212,212,0,2174,2181,2180,1,15,0,0,2,375,375,375,375
Marin,52,2022-12-12,315,315,315,0,3620,3633,3632,1,24,0,0,2,317,317,317,317
Mariposa,52,2022-12-12,18,18,18,0,122,123,122,1,0,0,0,0,30,30,30,30
Mendocino,52,2022-12-12,53,53,53,0,657,658,657,1,7,1,1,0,139,139,138,138
Merced,52,2022-12-12,318,318,318,0,3324,3335,3334,1,14,0,0,2,888,888,888,888
Modoc,52,2022-12-12,5,5,5,0,10,11,10,1,0,0,0,0,9,9,9,9
Mono,52,2022-12-12,9,9,9,0,122,123,122,1,0,0,0,0,8,8,8,8
Monterey,52,2022-12-12,265,265,265,0,4258,4272,4271,1,25,3,3,2,782,782,779,779
Napa,52,2022-12-12,162,162,162,0,2173,2180,2179,1,9,1,1,0,160,160,159,159
Nevada,52,2022-12-12,90,90,90,0,969,972,971,1,5,0,0,2,136,136,136,136
Orange,52,2022-12-12,3495,3506,3506,0,31464,31556,31555,1,300,35,35,48,7722,7722,7687,7687
Placer,52,2022-12-12,332,332,332,0,3892,3905,3904,1,73,5,5,6,674,674,669,669
Plumas,52,2022-12-12,7,7,7,0,186,187,186,1,2,0,0,0,13,13,13,13
Riverside,52,2022-12-12,3337,3347,3347,0,24681,24753,24752,1,204,19,19,25,6716,6716,6697,6697
Sacramento,52,2022-12-12,1825,1831,1831,0,20160,20218,20217,1,173,7,7,31,3423,3423,3416,3416
San Benito,52,2022-12-12,125,125,125,0,1330,1335,1334,1,2,2,2,2,105,105,103,103
San Bernardino,52,2022-12-12,3602,3614,3614,0,26989,27068,27067,1,226,4,4,36,8110,8110,8106,8106
San Diego,52,2022-12-12,4849,4862,4862,0,40660,40780,40779,1,331,15,15,45,5654,5654,5639,5639
San Francisco,52,2022-12-12,1428,1433,1433,0,16804,16855,16854,1,103,7,7,12,1111,1111,1104,1104
San Joaquin,52,2022-12-12,1000,1001,1001,0,12712,12750,12749,1,68,6,6,19,2372,2372,2366,2366
San Luis Obispo,52,2022-12-12,231,231,231,0,2650,2660,2659,1,10,1,1,0,538,538,537,537
San Mateo,52,2022-12-12,1171,1174,1174,0,12499,12536,12535,1,59,1,1,3,741,741,740,740
Santa Barbara,52,2022-12-12,512,512,512,0,5768,5787,5786,1,36,2,2,6,745,745,743,743
Santa Clara,52,2022-12-12,3260,3269,3269,0,35159,35263,35262,1,198,19,19,30,2612,2612,2593,2593
Santa Cruz,52,2022-12-12,578,578,578,0,12939,12979,12978,1,29,0,0,1,276,276,276,276
Shasta,52,2022-12-12,104,104,104,0,1154,1158,1157,1,22,0,0,5,596,596,596,596
Siskiyou,52,2022-12-12,15,15,15,0,245,246,245,1,2,0,0,0,95,95,95,95
Solano,52,2022-12-12,635,635,635,0,6178,6197,6196,1,42,2,2,7,468,468,466,466
Sonoma,52,2022-12-12,559,559,559,0,5592,5609,5608,1,41,2,2,7,541,541,539,539
Stanislaus,52,2022-12-12,593,593,593,0,6383,6403,6402,1,104,8,8,12,1810,1810,1802,1802
Sutter,52,2022-12-12,114,114,114,0,1156,1159,1158,1,0,0,0,0,233,233,233,233
Tehama,52,2022-12-12,80,80,80,0,774,776,775,1,6,1,1,0,220,220,219,219
Trinity,52,2022-12-12,3,3,3,0,45,46,45,1,0,0,0,0,22,22,22,22
Tulare,52,2022-12-12,439,439,439,0,5891,5909,5908,1,27,2,2,2,1552,1552,1550,1550
Tuolumne,52,2022-12-12,133,133,133,0,936,938,937,1,5,0,0,0,203,203,203,203
Ventura,52,2022-12-12,915,915,915,0,10660,10692,10691,1,72,4,4,7,1618,1618,1614,1614
Yolo,52,2022-12-12,209,209,209,0,2300,2308,2307,1,5,2,2,2,425,425,423,423
Yuba,52,2022-12-12,75,75,75,0,948,951,950,1,13,0,0,0,122,122,122,122
Alameda,53,2022-12-19,2349,2356,2356,0,27041,27126,27125,1,144,11,11,19,2127,2127,2116,2116
Amador,53,2022-12-19,42,42,42,0,807,809,808,1,6,0,0,0,95,95,95,95
Butte,53,2022-12-19,128,128,128,0,1639,1645,1644,1,34,3,3,2,479,479,476,476
Calaveras,53,2022-12-19,29,29,29,0,441,442,441,1,1,1,1,0,136,136,135,135
Colusa,53,2022-12-19,12,12,12,0,214,215,214,1,1,0,0,0,22,22,22,22
Contra Costa,53,2022-12-19,1717,1724,1724,0,17367,17422,17421,1,95,6,6,7,1510,1510,1504,1504
Del Norte,53,2022-12-19,39,39,39,0,553,554,553,1,3,0,0,0,56,56,56,56
El Dorado,53,2022-12-19,160,160,160,0,1632,1638,1637,1,9,1,1,2,239,239,238,238
Fresno,53,2022-12-19,1181,1185,1185,0,12897,12937,12936,1,212,7,7,22,2938,2938,2931,2931
Glenn,53,2022-12-19,21,21,21,0,205,206,205,1,6,0,0,0,53,53,53,53
Humboldt,53,2022-12-19,113,113,113,0,945,947,946,1,9,0,0,1,165,165,165,165
Imperial,53,2022-12-19,262,262,262,0,2547,2556,2555,1,16,1,1,0,971,971,970,970
Inyo,53,2022-12-19,12,12,12,0,324,325,324,1,1,0,0,0,62,62,62,62
Kern,53,2022-12-19,940,943,943,0,10706,10742,10741,1,60,3,3,5,2452,2452,2449,2449
Kings,53,2022-12-19,229,229,229,0,2770,2781,2780,1,6,4,4,1,477,477,473,473
Lake,53,2022-12-19,70,70,70,0,794,795,794,1,4,1,1,0,152,152,151,151
Lassen,53,2022-12-19,8,8,8,0,466,467,466,1,0,0,0,0,64,64,64,64
Los Angeles,53,2022-12-19,15307,15355,15355,0,204070,204711,204709,2,1096,129,129,155,34500,34500,34371,34371
Madera,53,2022-12-19,186,186,186,0,1891,1898,1897,1,10,0,0,1,375,375,375,375
Marin,53,2022-12-19,268,268,268,0,3234,3246,3245,1,17,0,0,0,317,317,317,317
Mariposa,53,2022-12-19,25,25,25,0,133,134,133,1,0,0,0,0,30,30,30,30
Mendocino,53,2022-12-19,66,66,66,0,755,757,756,1,4,0,0,0,139,139,139,139
Merced,53,2022-12-19,262,262,262,0,2773,2783,2782,1,15,2,2,2,890,890,888,888
Modoc,53,2022-12-19,8,8,8,0,21,22,21,1,0,0,0,0,9,9,9,9
Mono,53,2022-12-19,11,11,11,0,121,122,121,1,1,0,0,0,8,8,8,8
Monterey,53,2022-12-19,232,232,232,0,3880,3892,3891,1,13,1,1,1,783,783,782,782
Napa,53,2022-12-19,181,181,181,0,2094,2101,2100,1,8,0,0,0,160,160,160,160
Nevada,53,2022-12-19,72,72,72,0,883,886,885,1,5,0,0,2,136,136,136,136
Orange,53,2022-12-19,3306,3317,3317,0,30248,30344,30343,1,296,33,33,51,7755,7755,7722,7722
Placer,53,2022-12-19,363,363,363,0,3844,3858,3857,1,90,1,1,10,675,675,674,674
Plumas,53,2022-12-19,7,7,7,0,188,189,188,1,0,0,0,0,13,13,13,13
Riverside,53,2022-12-19,3164,3174,3174,0,22873,22945,22944,1,177,21,21,22,6737,6737,6716,6716
Sacramento,53,2022-12-19,1738,1744,1744,0,19755,19816,19815,1,210,15,15,22,3438,3438,3423,3423
San Benito,53,2022-12-19,105,105,105,0,1136,1140,1139,1,0,4,4,1,109,109,105,105
San Bernardino,53,2022-12-19,3216,3227,3227,0,25079,25157,25156,1,200,4,4,38,8114,8114,8110,8110
San Diego,53,2022-12-19,4854,4868,4868,0,39403,39528,39527,1,381,16,16,45,5670,5670,5654,5654
San Francisco,53,2022-12-19,1228,1232,1232,0,15732,15781,15780,1,106,11,11,17,1122,1122,1111,1111
San Joaquin,53,2022-12-19,851,852,852,0,12995,13036,13035,1,58,11,11,19,2383,2383,2372,2372
San Luis Obispo,53,2022-12-19,242,242,242,0,2423,2431,2430,1,17,1,1,0,539,539,538,538
San Mateo,53,2022-12-19,958,960,960,0,11890,11928,11927,1,62,1,1,5,742,742,741,741
Santa Barbara,53,2022-12-19,468,468,468,0,5251,5269,5268,1,35,4,4,5,749,749,745,745
Santa Clara,53,2022-12-19,2836,2845,2845,0,32490,32593,32592,1,205,15,15,30,2627,2627,2612,2612
Santa Cruz,53,2022-12-19,260,260,260,0,11208,11244,11243,1,31,0,0,1,276,276,276,276
Shasta,53,2022-12-19,109,109,109,0,1126,1130,1129,1,24,1,1,4,597,597,596,596
Siskiyou,53,2022-12-19,15,15,15,0,258,259,258,1,2,0,0,0,95,95,95,95
Solano,53,2022-12-19,639,639,639,0,6177,6198,6197,1,41,0,0,6,468,468,468,468
Sonoma,53,2022-12-19,478,478,478,0,5425,5443,5442,1,38,1,1,4,542,542,541,541
Stanislaus,53,2022-12-19,474,474,474,0,5998,6018,6017,1,94,1,1,12,1811,1811,1810,1810
Sutter,53,2022-12-19,81,81,81,0,1074,1077,1076,1,0,1,1,0,234,234,233,233
Tehama,53,2022-12-19,67,67,67,0,676,677,676,1,6,1,1,0,221,221,220,220
Trinity,53,2022-12-19,2,2,2,0,31,32,31,1,0,0,0,0,22,22,22,22
Tulare,53,2022-12-19,467,467,467,0,5382,5400,5399,1,53,5,5,1,1557,1557,1552,1552
Tuolumne,53,2022-12-19,88,88,88,0,841,843,842,1,2,1,1,1,204,204,203,203
Ventura,53,2022-12-19,937,938,938,0,9969,10001,10000,1,81,4,4,9,1622,1622,1618,1618
Yolo,53,2022-12-19,172,172,172,0,1969,1976,1975,1,5,4,4,0,429,429,425,425
Yuba,53,2022-12-19,81,81,81,0,900,903,902,1,7,0,0,0,122,122,122,122
Alameda,54,2022-12-26,1970,1977,1977,0,20710,20781,20780,1,150,11,11,17,2138,2138,2127,2127
Amador,54,2022-12-26,43,43,43,0,758,760,759,1,5,1,1,0,96,96,95,95
Butte,54,2022-12-26,95,95,95,0,1296,1302,1301,1,33,0,0,1,479,479,479,479
Calaveras,54,2022-12-26,24,24,24,0,366,367,366,1,0,1,1,0,137,137,136,136
Colusa,54,2022-12-26,14,14,14,0,150,151,150,1,0,0,0,0,22,22,22,22
Contra Costa,54,2022-12-26,1453,1458,1458,0,13770,13818,13817,1,89,10,10,11,1520,1520,1510,1510
Del Norte,54,2022-12-26,33,33,33,0,420,421,420,1,3,0,0,0,56,56,56,56
El Dorado,54,2022-12-26,152,152,152,0,1317,1323,1322,1,7,1,1,0,240,240,239,239
Fresno,54,2022-12-26,1089,1094,1094,0,10693,10730,10729,1,186,10,10,33,2948,2948,2938,2938
Glenn,54,2022-12-26,12,12,12,0,196,197,196,1,0,0,0,0,53,53,53,53
Humboldt,54,2022-12-26,82,82,82,0,631,632,631,1,5,2,2,2,167,167,165,165
Imperial,54,2022-12-26,234,234,234,0,2164,2172,2171,1,67,2,2,0,973,973,971,971
Inyo,54,2022-12-26,13,13,13,0,158,159,158,1,1,0,0,0,62,62,62,62
Kern,54,2022-12-26,702,703,703,0,8863,8895,8894,1,51,9,9,8,2461,2461,2452,2452
Kings,54,2022-12-26,199,199,199,0,2295,2304,2303,1,5,0,0,2,477,477,477,477
Lake,54,2022-12-26,58,58,58,0,601,602,601,1,3,0,0,1,152,152,152,152
Lassen,54,2022-12-26,27,27,27,0,485,487,486,1,0,0,0,0,64,64,64,64
Los Angeles,54,2022-12-26,13495,13543,13543,0,134566,135031,135029,2,1032,171,171,164,34671,34671,34500,34500
Madera,54,2022-12-26,166,166,166,0,1565,1571,1570,1,6,0,0,1,375,375,375,375
Marin,54,2022-12-26,214,214,214,0,2555,2564,2563,1,29,0,0,2,317,317,317,317
Mariposa,54,2022-12-26,22,22,22,0,105,106,105,1,0,0,0,0,30,30,30,30
Mendocino,54,2022-12-26,75,75,75,0,646,647,646,1,10,0,0,0,139,139,139,139
Merced,54,2022-12-26,212,212,212,0,1965,1972,1971,1,17,5,5,3,895,895,890,890
Modoc,54,2022-12-26,4,4,4,0,11,12,11,1,0,0,0,0,9,9,9,9
Mono,54,2022-12-26,10,10,10,0,83,84,83,1,0,0,0,0,8,8,8,8
Monterey,54,2022-12-26,191,191,191,0,2963,2975,2974,1,21,5,5,0,788,788,783,783
Napa,54,2022-12-26,142,142,142,0,1720,1726,1725,1,12,0,0,0,160,160,160,160
Nevada,54,2022-12-26,66,66,66,0,751,754,753,1,9,0,0,1,136,136,136,136
Orange,54,2022-12-26,3286,3298,3298,0,25031,25118,25117,1,274,38,38,31,7793,7793,7755,7755
Placer,54,2022-12-26,291,291,291,0,3048,3061,3060,1,87,2,2,12,677,677,675,675
Plumas,54,2022-12-26,10,10,10,0,123,124,123,1,0,0,0,0,13,13,13,13
Riverside,54,2022-12-26,2933,2944,2944,0,18672,18737,18736,1,194,12,12,18,6749,6749,6737,6737
Sacramento,54,2022-12-26,1392,1397,1397,0,14558,14608,14607,1,179,14,14,25,3452,3452,3438,3438
San Benito,54,2022-12-26,106,106,106,0,810,813,812,1,1,0,0,1,109,109,109,109
San Bernardino,54,2022-12-26,2957,2969,2969,0,20247,20319,20318,1,210,7,7,26,8121,8121,8114,8114
San Diego,54,2022-12-26,4606,4623,4623,0,28935,29036,29035,1,395,25,25,45,5695,5695,5670,5670
San Francisco,54,2022-12-26,1032,1037,1037,0,11831,11873,11872,1,90,20,20,15,1142,1142,1122,1122
San Joaquin,54,2022-12-26,750,750,750,0,10079,10114,10113,1,60,7,7,10,2390,2390,2383,2383
San Luis Obispo,54,2022-12-26,212,212,212,0,1973,1980,1979,1,20,3,3,0,542,542,539,539
San Mateo,54,2022-12-26,844,846,846,0,8983,9016,9015,1,55,0,0,6,742,742,742,742
Santa Barbara,54,2022-12-26,486,486,486,0,4097,4111,4110,1,40,0,0,4,749,749,749,749
Santa Clara,54,2022-12-26,2341,2348,2348,0,24200,24285,24284,1,179,9,9,35,2636,2636,2627,2627
Santa Cruz,54,2022-12-26,221,221,221,0,4641,4657,4656,1,25,0,0,2,276,276,276,276
Shasta,54,2022-12-26,100,100,100,0,923,927,926,1,18,0,0,1,597,597,597,597
Siskiyou,54,2022-12-26,17,17,17,0,266,267,266,1,1,0,0,0,95,95,95,95
Solano,54,2022-12-26,648,648,648,0,5238,5258,5257,1,59,2,2,7,470,470,468,468
Sonoma,54,2022-12-26,454,454,454,0,4249,4263,4262,1,39,1,1,4,543,543,542,542
Stanislaus,54,2022-12-26,451,451,451,0,4899,4916,4915,1,96,10,10,5,1821,1821,1811,1811
Sutter,54,2022-12-26,128,128,128,0,928,931,930,1,0,0,0,0,234,234,234,234
Tehama,54,2022-12-26,48,48,48,0,607,608,607,1,2,3,3,0,224,224,221,221
Trinity,54,2022-12-26,3,3,3,0,39,40,39,1,0,0,0,0,22,22,22,22
Tulare,54,2022-12-26,441,441,441,0,3938,3953,3952,1,41,7,7,3,1564,1564,1557,1557
Tuolumne,54,2022-12-26,93,93,93,0,758,760,759,1,6,2,2,2,206,206,204,204
Ventura,54,2022-12-26,888,891,891,0,7867,7895,7894,1,71,16,16,11,1638,1638,1622,1622
Yolo,54,2022-12-26,141,141,141,0,1614,1620,1619,1,9,2,2,1,431,431,429,429
Yuba,54,2022-12-26,99,99,99,0,754,756,755,1,14,0,0,0,122,122,122,122
Alameda,55,2023-01-02,1855,1862,1862,0,20045,20124,20123,1,175,14,14,19,2152,2152,2138,2138
Amador,55,2023-01-02,34,34,34,0,677,679,678,1,3,1,1,0,97,97,96,96
Butte,55,2023-01-02,99,99,99,0,1326,1332,1331,1,35,3,3,2,482,482,479,479
Calaveras,55,2023-01-02,33,33,33,0,361,362,361,1,0,2,2,0,139,139,137,137
Colusa,55,2023-01-02,5,5,5,0,94,95,94,1,0,0,0,0,22,22,22,22
Contra Costa,55,2023-01-02,1381,1386,1386,0,14063,14118,14117,1,89,5,5,13,1525,1525,1520,1520
Del Norte,55,2023-01-02,32,32,32,0,408,409,408,1,3,0,0,2,56,56,56,56
El Dorado,55,2023-01-02,147,147,147,0,1408,1414,1413,1,7,1,1,2,241,241,240,240
Fresno,55,2023-01-02,1066,1071,1071,0,11369,11413,11412,1,195,16,16,28,2964,2964,2948,2948
Glenn,55,2023-01-02,12,12,12,0,190,191,190,1,0,0,0,0,53,53,53,53
Humboldt,55,2023-01-02,48,48,48,0,618,619,618,1,2,0,0,2,167,167,167,167
Imperial,55,2023-01-02,205,205,205,0,2033,2041,2040,1,11,0,0,1,973,973,973,973
Inyo,55,2023-01-02,16,16,16,0,226,227,226,1,1,0,0,0,62,62,62,62
Kern,55,2023-01-02,892,896,896,0,9784,9822,9821,1,66,3,3,8,2464,2464,2461,2461
Kings,55,2023-01-02,187,187,187,0,2165,2174,2173,1,4,2,2,1,479,479,477,477
Lake,55,2023-01-02,47,47,47,0,604,605,604,1,3,1,1,0,153,153,152,152
Lassen,55,2023-01-02,13,13,13,0,490,491,490,1,0,0,0,0,64,64,64,64
Los Angeles,55,2023-01-02,13391,13445,13445,0,138206,138750,138748,2,1091,145,145,154,34816,34816,34671,34671
Madera,55,2023-01-02,153,153,153,0,1654,1661,1660,1,7,0,0,0,375,375,375,375
Marin,55,2023-01-02,225,225,225,0,2407,2416,2415,1,24,0,0,2,317,317,317,317
Mariposa,55,2023-01-02,15,15,15,0,94,95,94,1,0,0,0,0,30,30,30,30
Mendocino,55,2023-01-02,59,59,59,0,687,690,689,1,6,1,1,3,140,140,139,139
Merced,55,2023-01-02,194,194,194,0,2013,2023,2022,1,8,2,2,4,897,897,895,895
Modoc,55,2023-01-02,9,9,9,0,14,15,14,1,0,0,0,0,9,9,9,9
Mono,55,2023-01-02,10,10,10,0,66,67,66,1,0,0,0,0,8,8,8,8
Monterey,55,2023-01-02,216,216,216,0,3046,3059,3058,1,27,0,0,0,788,788,788,788
Napa,55,2023-01-02,124,124,124,0,1677,1685,1684,1,8,1,1,1,161,161,160,160
Nevada,55,2023-01-02,54,54,54,0,722,724,723,1,8,0,0,2,136,136,136,136
Orange,55,2023-01-02,3280,3293,3293,0,25265,25365,25364,1,312,37,37,28,7830,7830,7793,7793
Placer,55,2023-01-02,304,304,304,0,3244,3257,3256,1,108,1,1,8,678,678,677,677
Plumas,55,2023-01-02,12,12,12,0,145,146,145,1,1,1,1,0,14,14,13,13
Riverside,55,2023-01-02,3122,3135,3135,0,20086,20165,20164,1,223,9,9,31,6758,6758,6749,6749
Sacramento,55,2023-01-02,1519,1524,1524,0,15307,15367,15366,1,201,19,19,26,3471,3471,3452,3452
San Benito,55,2023-01-02,58,58,58,0,793,797,796,1,1,0,0,1,109,109,109,109
San Bernardino,55,2023-01-02,2872,2883,2883,0,20967,21049,21048,1,183,3,3,31,8124,8124,8121,8121
San Diego,55,2023-01-02,4633,4652,4652,0,29621,29738,29737,1,401,25,25,43,5720,5720,5695,5695
San Francisco,55,2023-01-02,886,890,890,0,10188,10227,10226,1,77,11,11,15,1153,1153,1142,1142
San Joaquin,55,2023-01-02,754,757,757,0,10415,10457,10456,1,62,6,6,12,2396,2396,2390,2390
San Luis Obispo,55,2023-01-02,210,210,210,0,1995,2005,2004,1,17,6,6,0,548,548,542,542
San Mateo,55,2023-01-02,743,746,746,0,8038,8070,8069,1,50,0,0,9,742,742,742,742
Santa Barbara,55,2023-01-02,433,433,433,0,4044,4061,4060,1,47,1,1,5,750,750,749,749
Santa Clara,55,2023-01-02,2443,2453,2453,0,23404,23498,23497,1,200,15,15,32,2651,2651,2636,2636
Santa Cruz,55,2023-01-02,171,171,171,0,3008,3021,3020,1,27,0,0,0,276,276,276,276
Shasta,55,2023-01-02,98,98,98,0,947,952,951,1,20,0,0,1,597,597,597,597
Siskiyou,55,2023-01-02,15,15,15,0,268,269,268,1,1,0,0,0,95,95,95,95
Solano,55,2023-01-02,639,642,642,0,5301,5324,5323,1,60,3,3,11,473,473,470,470
Sonoma,55,2023-01-02,424,424,424,0,4259,4278,4277,1,56,0,0,2,543,543,543,543
Stanislaus,55,2023-01-02,475,475,475,0,5020,5040,5039,1,88,6,6,8,1827,1827,1821,1821
Sutter,55,2023-01-02,97,97,97,0,889,892,891,1,0,0,0,0,234,234,234,234
Tehama,55,2023-01-02,54,54,54,0,621,624,623,1,2,5,5,0,229,229,224,224
Trinity,55,2023-01-02,4,4,4,0,41,42,41,1,0,0,0,0,22,22,22,22
Tulare,55,2023-01-02,469,469,469,0,4718,4738,4737,1,52,3,3,6,1567,1567,1564,1564
Tuolumne,55,2023-01-02,66,66,66,0,662,664,663,1,5,1,1,0,207,207,206,206
Ventura,55,2023-01-02,902,905,905,0,7466,7498,7497,1,87,10,10,13,1648,1648,1638,1638
Yolo,55,2023-01-02,134,134,134,0,1525,1532,1531,1,4,3,3,1,434,434,431,431
Yuba,55,2023-01-02,79,79,79,0,730,733,732,1,19,0,0,1,122,122,122,122
Alameda,56,2023-01-09,1496,1502,1502,0,23344,23447,23446,1,149,12,12,11,2164,2164,2152,2152
Amador,56,2023-01-09,28,28,28,0,706,709,708,1,2,0,0,0,97,97,97,97
Butte,56,2023-01-09,88,88,88,0,1203,1209,1208,1,39,2,2,3,484,484,482,482
Calaveras,56,2023-01-09,19,19,19,0,341,342,341,1,0,0,0,1,139,139,139,139
Colusa,56,2023-01-09,8,8,8,0,92,93,92,1,0,0,0,0,22,22,22,22
Contra Costa,56,2023-01-09,1055,1060,1060,0,15380,15448,15447,1,85,6,6,11,1531,1531,1525,1525
Del Norte,56,2023-01-09,17,17,17,0,367,368,367,1,5,0,0,2,56,56,56,56
El Dorado,56,2023-01-09,87,87,87,0,1453,1460,1459,1,4,0,0,0,241,241,241,241
Fresno,56,2023-01-09,806,810,810,0,11478,11527,11526,1,171,7,7,23,2971,2971,2964,2964
Glenn,56,2023-01-09,8,8,8,0,185,186,185,1,0,0,0,0,53,53,53,53
Humboldt,56,2023-01-09,57,57,57,0,708,711,710,1,7,0,0,4,167,167,167,167
Imperial,56,2023-01-09,161,161,161,0,2438,2451,2450,1,12,2,2,2,975,975,973,973
Inyo,56,2023-01-09,10,10,10,0,205,206,205,1,0,0,0,0,62,62,62,62
Kern,56,2023-01-09,620,622,622,0,10590,10636,10635,1,73,4,4,8,2468,2468,2464,2464
Kings,56,2023-01-09,183,183,183,0,2315,2327,2326,1,9,0,0,0,479,479,479,479
Lake,56,2023-01-09,44,44,44,0,622,624,623,1,3,1,1,0,154,154,153,153
Lassen,56,2023-01-09,19,19,19,0,506,507,506,1,2,0,0,0,64,64,64,64
Los Angeles,56,2023-01-09,10170,10213,10213,0,189797,190627,190625,2,965,142,142,136,34958,34958,34816,34816
Madera,56,2023-01-09,100,100,100,0,1645,1652,1651,1,8,0,0,1,375,375,375,375
Marin,56,2023-01-09,145,145,145,0,2559,2570,2569,1,18,0,0,3,317,317,317,317
Mariposa,56,2023-01-09,9,9,9,0,105,106,105,1,0,1,1,0,31,31,30,30
Mendocino,56,2023-01-09,40,40,40,0,645,649,648,1,10,2,2,3,142,142,140,140
Merced,56,2023-01-09,185,185,185,0,2151,2162,2161,1,11,1,1,1,898,898,897,897
Modoc,56,2023-01-09,8,8,8,0,14,15,14,1,0,0,0,0,9,9,9,9
Mono,56,2023-01-09,12,12,12,0,78,79,78,1,0,0,0,0,8,8,8,8
Monterey,56,2023-01-09,170,170,170,0,3126,3139,3138,1,20,4,4,3,792,792,788,788
Napa,56,2023-01-09,132,132,132,0,1878,1887,1886,1,9,0,0,3,161,161,161,161
Nevada,56,2023-01-09,42,42,42,0,760,763,762,1,6,0,0,0,136,136,136,136
Orange,56,2023-01-09,2448,2458,2458,0,28000,28123,28122,1,267,39,39,34,7869,7869,7830,7830
Placer,56,2023-01-09,260,260,260,0,3405,3421,3420,1,89,0,0,6,678,678,678,678
Plumas,56,2023-01-09,5,5,5,0,89,90,89,1,1,0,0,0,14,14,14,14
Riverside,56,2023-01-09,2002,2011,2011,0,21234,21327,21326,1,186,13,13,26,6771,6771,6758,6758
Sacramento,56,2023-01-09,1023,1028,1028,0,15633,15700,15699,1,178,16,16,28,3487,3487,3471,3471
San Benito,56,2023-01-09,51,51,51,0,817,821,820,1,1,0,0,2,109,109,109,109
San Bernardino,56,2023-01-09,1758,1766,1766,0,20708,20799,20798,1,179,6,6,36,8130,8130,8124,8124
San Diego,56,2023-01-09,3593,3608,3608,0,35162,35317,35316,1,397,25,25,40,5745,5745,5720,5720
San Francisco,56,2023-01-09,791,794,794,0,12768,12824,12823,1,75,7,7,17,1160,1160,1153,1153
San Joaquin,56,2023-01-09,590,590,590,0,10955,11003,11002,1,51,10,10,12,2406,2406,2396,2396
San Luis Obispo,56,2023-01-09,186,186,186,0,2148,2158,2157,1,12,3,3,0,551,551,548,548
San Mateo,56,2023-01-09,614,615,615,0,9704,9747,9746,1,47,0,0,5,742,742,742,742
Santa Barbara,56,2023-01-09,367,367,367,0,4500,4521,4520,1,39,3,3,1,753,753,750,750
Santa Clara,56,2023-01-09,1975,1983,1983,0,28593,28719,28718,1,182,12,12,28,2663,2663,2651,2651
Santa Cruz,56,2023-01-09,152,152,152,0,4064,4083,4082,1,27,0,0,1,276,276,276,276
Shasta,56,2023-01-09,60,60,60,0,890,895,894,1,17,0,0,2,597,597,597,597
Siskiyou,56,2023-01-09,20,20,20,0,233,234,233,1,0,0,0,0,95,95,95,95
Solano,56,2023-01-09,401,401,401,0,5182,5205,5204,1,54,1,1,6,474,474,473,473
Sonoma,56,2023-01-09,286,286,286,0,4752,4773,4772,1,31,3,3,4,546,546,543,543
Stanislaus,56,2023-01-09,303,303,303,0,5178,5201,5200,1,87,6,6,8,1833,1833,1827,1827
Sutter,56,2023-01-09,62,62,62,0,870,874,873,1,0,0,0,0,234,234,234,234
Tehama,56,2023-01-09,28,28,28,0,491,492,491,1,1,2,2,0,231,231,229,229
Trinity,56,2023-01-09,3,3,3,0,30,31,30,1,0,0,0,0,22,22,22,22
Tulare,56,2023-01-09,334,334,334,0,5103,5126,5125,1,53,5,5,2,1572,1572,1567,1567
Tuolumne,56,2023-01-09,74,74,74,0,655,658,657,1,2,1,1,0,208,208,207,207
Ventura,56,2023-01-09,662,663,663,0,9382,9422,9421,1,65,5,5,12,1653,1653,1648,1648
Yolo,56,2023-01-09,108,108,108,0,1666,1675,1674,1,2,2,2,1,436,436,434,434
Yuba,56,2023-01-09,48,48,48,0,735,738,737,1,21,0,0,1,122,122,122,122
Alameda,57,2023-01-16,870,875,875,0,19179,19272,19271,1,105,5,5,11,2169,2169,2164,2164
Amador,57,2023-01-16,20,20,20,0,585,587,586,1,4,0,0,0,97,97,97,97
Butte,57,2023-01-16,60,60,60,0,1159,1166,1165,1,21,1,1,0,485,485,484,484
Calaveras,57,2023-01-16,10,10,10,0,309,310,309,1,2,0,0,1,139,139,139,139
Colusa,57,2023-01-16,7,7,7,0,86,87,86,1,1,0,0,0,22,22,22,22
Contra Costa,57,2023-01-16,615,617,617,0,12115,12174,12173,1,61,5,5,11,1536,1536,1531,1531
Del Norte,57,2023-01-16,10,10,10,0,303,304,303,1,3,2,2,1,58,58,56,56
El Dorado,57,2023-01-16,60,60,60,0,978,984,983,1,2,1,1,1,242,242,241,241
Fresno,57,2023-01-16,462,463,463,0,9736,9784,9783,1,162,7,7,13,2978,2978,2971,2971
Glenn,57,2023-01-16,3,3,3,0,163,164,163,1,0,0,0,0,53,53,53,53
Humboldt,57,2023-01-16,35,35,35,0,498,499,498,1,9,1,1,2,168,168,167,167
Imperial,57,2023-01-16,127,127,127,0,2067,2079,2078,1,10,2,2,2,977,977,975,975
Inyo,57,2023-01-16,11,11,11,0,199,200,199,1,0,0,0,0,62,62,62,62
Kern,57,2023-01-16,386,386,386,0,8285,8327,8326,1,55,4,4,13,2472,2472,2468,2468
Kings,57,2023-01-16,126,126,126,0,1982,1993,1992,1,5,2,2,0,481,481,479,479
Lake,57,2023-01-16,23,23,23,0,576,578,577,1,2,1,1,1,155,155,154,154
Lassen,57,2023-01-16,6,6,6,0,441,443,442,1,0,0,0,0,64,64,64,64
Los Angeles,57,2023-01-16,6121,6151,6151,0,148493,149214,149212,2,855,144,145,113,35102,35103,34958,34958
Madera,57,2023-01-16,67,67,67,0,1350,1358,1357,1,4,0,0,2,375,375,375,375
Marin,57,2023-01-16,125,125,125,0,2138,2150,2149,1,20,0,0,1,317,317,317,317
Mariposa,57,2023-01-16,11,11,11,0,96,97,96,1,0,0,0,0,31,31,31,31
Mendocino,57,2023-01-16,25,25,25,0,499,501,500,1,6,0,0,0,142,142,142,142
Merced,57,2023-01-16,120,120,120,0,1688,1697,1696,1,12,3,3,5,901,901,898,898
Modoc,57,2023-01-16,2,2,2,0,9,10,9,1,0,0,0,0,9,9,9,9
Mono,57,2023-01-16,6,6,6,0,68,69,68,1,0,0,0,0,8,8,8,8
Monterey,57,2023-01-16,112,112,112,0,2603,2617,2616,1,20,3,3,2,795,795,792,792
Napa,57,2023-01-16,63,63,63,0,1511,1519,1518,1,5,0,0,0,161,161,161,161
Nevada,57,2023-01-16,25,25,25,0,565,567,566,1,4,0,0,0,136,136,136,136
Orange,57,2023-01-16,1456,1463,1463,0,24149,24267,24266,1,245,39,39,32,7908,7908,7869,7869
Placer,57,2023-01-16,163,163,163,0,2639,2653,2652,1,68,0,0,6,678,678,678,678
Plumas,57,2023-01-16,2,2,2,0,74,75,74,1,1,0,0,0,14,14,14,14
Riverside,57,2023-01-16,1219,1226,1226,0,17162,17245,17244,1,169,15,15,36,6786,6786,6771,6771
Sacramento,57,2023-01-16,571,572,572,0,12429,12490,12489,1,149,19,19,23,3506,3506,3487,3487
San Benito,57,2023-01-16,28,28,28,0,468,469,468,1,0,1,1,0,110,110,109,109
San Bernardino,57,2023-01-16,993,998,998,0,16755,16837,16836,1,148,2,2,35,8132,8132,8130,8130
San Diego,57,2023-01-16,2065,2075,2075,0,28671,28812,28811,1,327,15,15,39,5760,5760,5745,5745
San Francisco,57,2023-01-16,439,439,439,0,10154,10202,10201,1,75,2,2,12,1162,1162,1160,1160
San Joaquin,57,2023-01-16,356,356,356,0,8785,8830,8829,1,42,8,8,11,2414,2414,2406,2406
San Luis Obispo,57,2023-01-16,108,108,108,0,1777,1786,1785,1,12,2,2,3,553,553,551,551
San Mateo,57,2023-01-16,400,400,400,0,7745,7784,7783,1,37,0,0,3,742,742,742,742
Santa Barbara,57,2023-01-16,242,242,242,0,3919,3940,3939,1,34,2,2,0,755,755,753,753
Santa Clara,57,2023-01-16,1103,1109,1109,0,24074,24192,24191,1,106,16,16,16,2679,2679,2663,2663
Santa Cruz,57,2023-01-16,171,171,171,0,6497,6530,6529,1,23,0,0,1,276,276,276,276
Shasta,57,2023-01-16,40,40,40,0,691,695,694,1,13,2,2,2,599,599,597,597
Siskiyou,57,2023-01-16,6,6,6,0,208,209,208,1,0,0,0,0,95,95,95,95
Solano,57,2023-01-16,222,222,222,0,3710,3729,3728,1,49,0,0,6,474,474,474,474
Sonoma,57,2023-01-16,189,189,189,0,3773,3793,3792,1,26,5,5,2,551,551,546,546
Stanislaus,57,2023-01-16,205,205,205,0,4300,4322,4321,1,72,3,3,3,1836,1836,1833,1833
Sutter,57,2023-01-16,47,47,47,0,714,717,716,1,0,0,0,0,234,234,234,234
Tehama,57,2023-01-16,16,16,16,0,368,369,368,1,1,0,0,0,231,231,231,231
Trinity,57,2023-01-16,3,3,3,0,23,24,23,1,0,0,0,0,22,22,22,22
Tulare,57,2023-01-16,263,263,263,0,4116,4137,4136,1,45,4,4,2,1576,1576,1572,1572
Tuolumne,57,2023-01-16,44,44,44,0,548,550,549,1,1,2,2,0,210,210,208,208
Ventura,57,2023-01-16,413,413,413,0,7843,7882,7881,1,53,4,4,12,1657,1657,1653,1653
Yolo,57,2023-01-16,74,74,74,0,1251,1259,1258,1,2,2,2,0,438,438,436,436
Yuba,57,2023-01-16,38,38,38,0,595,598,597,1,9,0,0,2,122,122,122,122
Alameda,58,2023-01-23,743,748,748,0,21236,21347,21346,1,100,11,11,9,2180,2180,2169,2169
Amador,58,2023-01-23,34,34,34,0,590,595,594,1,1,1,1,0,98,98,97,97
Butte,58,2023-01-23,44,44,44,0,1084,1090,1089,1,13,1,1,0,486,486,485,485
Calaveras,58,2023-01-23,15,15,15,0,280,281,280,1,0,0,0,0,139,139,139,139
Colusa,58,2023-01-23,10,10,10,0,142,143,142,1,0,0,0,0,22,22,22,22
Contra Costa,58,2023-01-23,516,516,516,0,13307,13376,13375,1,61,6,6,6,1542,1542,1536,1536
Del Norte,58,2023-01-23,22,22,22,0,359,360,359,1,1,0,0,0,58,58,58,58
El Dorado,58,2023-01-23,40,40,40,0,1082,1088,1087,1,2,0,0,0,242,242,242,242
Fresno,58,2023-01-23,449,449,449,0,10112,10167,10166,1,117,5,5,19,2983,2983,2978,2978
Glenn,58,2023-01-23,4,4,4,0,154,155,154,1,0,0,0,0,53,53,53,53
Humboldt,58,2023-01-23,34,34,34,0,555,558,557,1,9,1,1,4,169,169,168,168
Imperial,58,2023-01-23,85,85,85,0,2256,2269,2268,1,10,0,0,1,977,977,977,977
Inyo,58,2023-01-23,6,6,6,0,165,166,165,1,0,1,1,0,63,63,62,62
Kern,58,2023-01-23,313,313,313,0,9390,9440,9439,1,34,5,5,8,2477,2477,2472,2472
Kings,58,2023-01-23,107,107,107,0,1985,1997,1996,1,6,0,0,0,481,481,481,481
Lake,58,2023-01-23,28,28,28,0,579,583,582,1,2,2,2,2,157,157,155,155
Lassen,58,2023-01-23,5,5,5,0,465,467,466,1,0,0,0,0,64,64,64,64
Los Angeles,58,2023-01-23,5606,5635,5635,0,169725,170617,170615,2,665,110,111,96,35212,35214,35102,35103
Madera,58,2023-01-23,51,51,51,0,1433,1441,1440,1,6,0,0,2,375,375,375,375
Marin,58,2023-01-23,108,108,108,0,2350,2363,2362,1,18,0,0,3,317,317,317,317
Mariposa,58,2023-01-23,7,7,7,0,104,105,104,1,0,0,0,0,31,31,31,31
Mendocino,58,2023-01-23,21,21,21,0,546,550,549,1,4,0,0,0,142,142,142,142
Merced,58,2023-01-23,126,126,126,0,1924,1935,1934,1,9,2,2,3,903,903,901,901
Modoc,58,2023-01-23,1,1,1,0,11,12,11,1,1,0,0,0,9,9,9,9
Mono,58,2023-01-23,5,5,5,0,73,74,73,1,0,0,0,0,8,8,8,8
Monterey,58,2023-01-23,107,107,107,0,2755,2771,2770,1,15,1,1,2,796,796,795,795
Napa,58,2023-01-23,77,77,77,0,1505,1514,1513,1,4,0,0,1,161,161,161,161
Nevada,58,2023-01-23,20,20,20,0,600,603,602,1,3,0,0,2,136,136,136,136
Orange,58,2023-01-23,1160,1167,1167,0,24079,24205,24204,1,177,26,26,27,7934,7934,7908,7908
Placer,58,2023-01-23,139,139,139,0,2731,2746,2745,1,42,1,1,7,679,679,678,678
Plumas,58,2023-01-23,5,5,5,0,91,92,91,1,1,0,0,0,14,14,14,14
Riverside,58,2023-01-23,1013,1019,1019,0,16227,16312,16311,1,111,14,14,22,6800,6800,6786,6786
Sacramento,58,2023-01-23,599,602,602,0,13719,13791,13790,1,134,9,9,21,3515,3515,3506,3506
San Benito,58,2023-01-23,27,27,27,0,564,567,566,1,0,0,0,0,110,110,110,110
San Bernardino,58,2023-01-23,1030,1037,1037,0,19082,19183,19182,1,127,1,1,33,8133,8133,8132,8132
San Diego,58,2023-01-23,2032,2043,2043,0,33281,33458,33457,1,236,11,11,37,5771,5771,5760,5760
San Francisco,58,2023-01-23,449,449,449,0,11283,11343,11342,1,58,6,6,5,1168,1168,1162,1162
San Joaquin,58,2023-01-23,242,242,242,0,8406,8452,8451,1,29,3,3,8,2417,2417,2414,2414
San Luis Obispo,58,2023-01-23,110,110,110,0,1951,1963,1962,1,8,3,3,2,556,556,553,553
San Mateo,58,2023-01-23,351,351,351,0,8730,8776,8775,1,21,0,0,0,742,742,742,742
Santa Barbara,58,2023-01-23,209,209,209,0,4241,4264,4263,1,28,2,2,4,757,757,755,755
Santa Clara,58,2023-01-23,1019,1026,1026,0,24681,24813,24812,1,119,5,5,23,2684,2684,2679,2679
Santa Cruz,58,2023-01-23,122,122,122,0,9483,9534,9533,1,16,0,0,0,276,276,276,276
Shasta,58,2023-01-23,23,23,23,0,755,760,759,1,6,1,1,1,600,600,599,599
Siskiyou,58,2023-01-23,6,6,6,0,178,179,178,1,0,0,0,0,95,95,95,95
Solano,58,2023-01-23,228,228,228,0,4217,4239,4238,1,33,0,0,2,474,474,474,474
Sonoma,58,2023-01-23,198,198,198,0,4276,4300,4299,1,26,0,0,4,551,551,551,551
Stanislaus,58,2023-01-23,181,181,181,0,4310,4333,4332,1,57,2,2,6,1838,1838,1836,1836
Sutter,58,2023-01-23,41,41,41,0,779,785,784,1,0,1,1,0,235,235,234,234
Tehama,58,2023-01-23,15,15,15,0,340,341,340,1,1,0,0,0,231,231,231,231
Trinity,58,2023-01-23,4,4,4,0,31,32,31,1,0,1,1,0,23,23,22,22
Tulare,58,2023-01-23,221,221,221,0,4167,4190,4189,1,27,3,3,5,1579,1579,1576,1576
Tuolumne,58,2023-01-23,36,36,36,0,484,486,485,1,0,1,1,1,211,211,210,210
Ventura,58,2023-01-23,368,368,368,0,8586,8632,8631,1,57,5,5,3,1662,1662,1657,1657
Yolo,58,2023-01-23,85,85,85,0,1372,1381,1380,1,2,3,3,0,441,441,438,438
Yuba,58,2023-01-23,30,30,30,0,725,731,730,1,3,0,0,0,122,122,122,122
Alameda,59,2023-01-30,848,855,855,0,18454,18565,18564,1,85,4,4,4,2184,2184,2180,2180
Amador,59,2023-01-30,24,24,24,0,620,623,622,1,3,0,0,0,98,98,98,98
Butte,59,2023-01-30,58,58,58,0,1127,1135,1134,1,13,2,2,2,488,488,486,486
Calaveras,59,2023-01-30,16,16,16,0,318,319,318,1,0,1,1,0,140,140,139,139
Colusa,59,2023-01-30,7,7,7,0,169,170,169,1,0,0,0,0,22,22,22,22
Contra Costa,59,2023-01-30,665,670,670,0,12412,12487,12486,1,38,9,9,6,1551,1551,1542,1542
Del Norte,59,2023-01-30,31,31,31,0,382,383,382,1,1,1,1,0,59,59,58,58
El Dorado,59,2023-01-30,61,61,61,0,1190,1198,1197,1,4,2,2,0,244,244,242,242
Fresno,59,2023-01-30,449,449,449,0,9879,9941,9940,1,117,8,8,10,2991,2991,2983,2983
Glenn,59,2023-01-30,3,3,3,0,156,158,157,1,0,0,0,0,53,53,53,53
Humboldt,59,2023-01-30,29,29,29,0,565,570,569,1,6,0,0,1,169,169,169,169
Imperial,59,2023-01-30,104,104,104,0,2068,2083,2082,1,7,1,1,0,978,978,977,977
Inyo,59,2023-01-30,10,10,10,0,202,203,202,1,1,0,0,0,63,63,63,63
Kern,59,2023-01-30,295,295,295,0,8957,9011,9010,1,36,1,1,8,2478,2478,2477,2477
Kings,59,2023-01-30,136,136,136,0,2211,2226,2225,1,7,1,1,1,482,482,481,481
Lake,59,2023-01-30,26,26,26,0,555,559,558,1,5,2,2,1,159,159,157,157
Lassen,59,2023-01-30,4,4,4,0,490,493,492,1,0,0,0,0,64,64,64,64
Los Angeles,59,2023-01-30,5795,5831,5831,0,151711,152628,152626,2,633,110,115,72,35322,35329,35212,35214
Madera,59,2023-01-30,48,48,48,0,1479,1488,1487,1,7,0,0,0,375,375,375,375
Marin,59,2023-01-30,102,102,102,0,2159,2172,2171,1,19,0,0,1,317,317,317,317
Mariposa,59,2023-01-30,5,5,5,0,105,106,105,1,0,0,0,0,31,31,31,31
Mendocino,59,2023-01-30,24,24,24,0,518,521,520,1,2,0,0,1,142,142,142,142
Merced,59,2023-01-30,137,137,137,0,1798,1809,1808,1,11,0,0,3,903,903,903,903
Modoc,59,2023-01-30,0,0,0,0,8,9,8,1,1,0,0,0,9,9,9,9
Mono,59,2023-01-30,2,2,2,0,67,68,67,1,0,0,0,0,8,8,8,8
Monterey,59,2023-01-30,155,155,155,0,2846,2863,2862,1,8,1,1,1,797,797,796,796
Napa,59,2023-01-30,72,72,72,0,1370,1379,1378,1,4,0,0,0,161,161,161,161
Nevada,59,2023-01-30,29,29,29,0,591,596,595,1,2,0,0,1,136,136,136,136
Orange,59,2023-01-30,1192,1199,1199,0,22723,22862,22861,1,136,13,13,25,7947,7947,7934,7934
Placer,59,2023-01-30,170,170,170,0,2707,2724,2723,1,49,2,2,3,681,681,679,679
Plumas,59,2023-01-30,3,3,3,0,75,76,75,1,0,0,0,0,14,14,14,14
Riverside,59,2023-01-30,1070,1077,1077,0,15994,16091,16090,1,84,5,5,17,6805,6805,6800,6800
Sacramento,59,2023-01-30,667,672,672,0,13387,13469,13468,1,117,8,8,13,3523,3523,3515,3515
San Benito,59,2023-01-30,30,30,30,0,563,568,567,1,0,0,0,0,110,110,110,110
San Bernardino,59,2023-01-30,931,938,938,0,17213,17319,17318,1,140,0,0,19,8133,8133,8133,8133
San Diego,59,2023-01-30,1860,1872,1872,0,30190,30374,30373,1,202,11,11,32,5782,5782,5771,5771
San Francisco,59,2023-01-30,473,474,474,0,10900,10965,10964,1,51,2,2,4,1170,1170,1168,1168
San Joaquin,59,2023-01-30,308,308,308,0,7657,7705,7704,1,22,4,4,5,2421,2421,2417,2417
San Luis Obispo,59,2023-01-30,140,140,140,0,1912,1925,1924,1,13,5,5,0,561,561,556,556
San Mateo,59,2023-01-30,431,432,432,0,8644,8698,8697,1,25,0,0,3,742,742,742,742
Santa Barbara,59,2023-01-30,227,227,227,0,4266,4294,4293,1,25,1,1,2,758,758,757,757
Santa Clara,59,2023-01-30,1180,1187,1187,0,23637,23780,23779,1,132,5,5,14,2689,2689,2684,2684
Santa Cruz,59,2023-01-30,133,133,133,0,9330,9388,9387,1,12,0,0,0,276,276,276,276
Shasta,59,2023-01-30,18,18,18,0,665,670,669,1,7,0,0,0,600,600,600,600
Siskiyou,59,2023-01-30,6,6,6,0,195,196,195,1,0,0,0,0,95,95,95,95
Solano,59,2023-01-30,236,236,236,0,4171,4196,4195,1,40,0,0,1,474,474,474,474
Sonoma,59,2023-01-30,157,157,157,0,3596,3620,3619,1,23,1,1,1,552,552,551,551
Stanislaus,59,2023-01-30,231,231,231,0,4127,4153,4152,1,43,2,2,3,1840,1840,1838,1838
Sutter,59,2023-01-30,36,36,36,0,611,615,614,1,0,1,1,0,236,236,235,235
Tehama,59,2023-01-30,8,8,8,0,317,318,317,1,1,1,1,0,232,232,231,231
Trinity,59,2023-01-30,7,7,7,0,26,27,26,1,0,0,0,0,23,23,23,23
Tulare,59,2023-01-30,260,260,260,0,4020,4047,4046,1,28,3,3,3,1582,1582,1579,1579
Tuolumne,59,2023-01-30,45,45,45,0,600,603,602,1,3,0,0,0,211,211,211,211
Ventura,59,2023-01-30,363,363,363,0,8126,8176,8175,1,46,7,7,8,1669,1669,1662,1662
Yolo,59,2023-01-30,87,87,87,0,1299,1308,1307,1,2,1,1,0,442,442,441,441
Yuba,59,2023-01-30,32,32,32,0,656,662,661,1,3,0,0,1,122,122,122,122
Alameda,60,2023-02-06,1105,1113,1113,0,18254,18384,18383,1,86,5,5,9,2189,2189,2184,2184
Amador,60,2023-02-06,29,29,29,0,637,643,642,1,1,0,0,0,98,98,98,98
Butte,60,2023-02-06,84,84,84,0,1209,1219,1218,1,20,0,0,1,488,488,488,488
Calaveras,60,2023-02-06,14,14,14,0,323,325,324,1,0,0,0,0,140,140,140,140
Colusa,60,2023-02-06,6,6,6,0,184,186,185,1,0,0,0,0,22,22,22,22
Contra Costa,60,2023-02-06,715,721,721,0,11856,11941,11940,1,50,2,2,9,1553,1553,1551,1551
Del Norte,60,2023-02-06,58,58,58,0,394,397,396,1,0,0,0,0,59,59,59,59
El Dorado,60,2023-02-06,59,59,59,0,1133,1143,1142,1,3,0,0,0,244,244,244,244
Fresno,60,2023-02-06,514,517,517,0,9047,9113,9112,1,89,4,4,15,2995,2995,2991,2991
Glenn,60,2023-02-06,10,10,10,0,170,172,171,1,0,0,0,0,53,53,53,53
Humboldt,60,2023-02-06,56,56,56,0,566,572,571,1,6,1,1,0,170,170,169,169
Imperial,60,2023-02-06,123,123,123,0,2098,2114,2113,1,7,1,1,0,979,979,978,978
Inyo,60,2023-02-06,9,9,9,0,210,211,210,1,0,0,0,0,63,63,63,63
Kern,60,2023-02-06,327,327,327,0,8599,8661,8660,1,34,2,2,4,2480,2480,2478,2478
Kings,60,2023-02-06,127,127,127,0,2056,2072,2071,1,3,0,0,1,482,482,482,482
Lake,60,2023-02-06,25,25,25,0,561,567,566,1,5,1,1,0,160,160,159,159
Lassen,60,2023-02-06,6,6,6,0,445,448,447,1,0,0,0,0,64,64,64,64
Los Angeles,60,2023-02-06,5902,5945,5945,0,141929,142941,142939,2,609,89,94,83,35411,35423,35322,35329
Madera,60,2023-02-06,55,55,55,0,1308,1319,1318,1,4,1,1,0,376,376,375,375
Marin,60,2023-02-06,144,144,144,0,2132,2147,2146,1,13,0,0,3,317,317,317,317
Mariposa,60,2023-02-06,2,2,2,0,105,106,105,1,0,0,0,0,31,31,31,31
Mendocino,60,2023-02-06,31,31,31,0,513,517,516,1,4,0,0,2,142,142,142,142
Merced,60,2023-02-06,166,166,166,0,1889,1903,1902,1,12,0,0,0,903,903,903,903
Modoc,60,2023-02-06,2,2,2,0,6,7,6,1,0,0,0,0,9,9,9,9
Mono,60,2023-02-06,4,4,4,0,92,93,92,1,0,0,0,0,8,8,8,8
Monterey,60,2023-02-06,227,227,227,0,2938,2960,2959,1,22,3,3,1,800,800,797,797
Napa,60,2023-02-06,110,110,110,0,1404,1415,1414,1,4,0,0,3,161,161,161,161
Nevada,60,2023-02-06,32,32,32,0,572,578,577,1,4,0,0,0,136,136,136,136
Orange,60,2023-02-06,1293,1301,1301,0,22313,22473,22472,1,154,23,23,20,7970,7970,7947,7947
Placer,60,2023-02-06,164,164,164,0,2656,2677,2676,1,41,0,0,4,681,681,681,681
Plumas,60,2023-02-06,2,2,2,0,72,73,72,1,0,1,1,0,15,15,14,14
Riverside,60,2023-02-06,1128,1136,1136,0,15530,15641,15640,1,89,5,5,14,6810,6810,6805,6805
Sacramento,60,2023-02-06,731,738,738,0,13188,13282,13281,1,96,5,5,19,3528,3528,3523,3523
San Benito,60,2023-02-06,50,50,50,0,538,544,543,1,1,0,0,0,110,110,110,110
San Bernardino,60,2023-02-06,1081,1089,1089,0,17430,17556,17555,1,152,0,0,17,8133,8133,8133,8133
San Diego,60,2023-02-06,1873,1886,1886,0,30130,30347,30346,1,230,8,8,23,5790,5790,5782,5782
San Francisco,60,2023-02-06,573,578,578,0,10536,10611,10610,1,58,3,3,2,1173,1173,1170,1170
San Joaquin,60,2023-02-06,435,436,436,0,6930,6981,6980,1,32,1,1,3,2422,2422,2421,2421
San Luis Obispo,60,2023-02-06,150,150,150,0,1906,1920,1919,1,7,1,1,0,562,562,561,561
San Mateo,60,2023-02-06,529,532,532,0,8194,8254,8253,1,42,0,0,1,742,742,742,742
Santa Barbara,60,2023-02-06,239,239,239,0,4365,4398,4397,1,21,1,1,0,759,759,758,758
Santa Clara,60,2023-02-06,1302,1310,1310,0,23467,23636,23635,1,123,9,9,23,2698,2698,2689,2689
Santa Cruz,60,2023-02-06,232,232,232,0,10396,10471,10470,1,11,0,0,0,276,276,276,276
Shasta,60,2023-02-06,24,24,24,0,660,666,665,1,9,0,0,0,600,600,600,600
Siskiyou,60,2023-02-06,11,11,11,0,221,222,221,1,0,0,0,0,95,95,95,95
Solano,60,2023-02-06,288,289,289,0,3852,3881,3880,1,41,0,0,5,474,474,474,474
Sonoma,60,2023-02-06,267,267,267,0,3566,3594,3593,1,17,3,3,1,555,555,552,552
Stanislaus,60,2023-02-06,277,277,277,0,3926,3955,3954,1,54,1,1,6,1841,1841,1840,1840
Sutter,60,2023-02-06,50,50,50,0,706,712,711,1,0,0,0,0,236,236,236,236
Tehama,60,2023-02-06,17,17,17,0,344,346,345,1,2,0,0,0,232,232,232,232
Trinity,60,2023-02-06,1,1,1,0,19,20,19,1,0,0,0,0,23,23,23,23
Tulare,60,2023-02-06,272,272,272,0,4388,4419,4418,1,28,2,2,3,1584,1584,1582,1582
Tuolumne,60,2023-02-06,48,48,48,0,555,561,560,1,1,0,0,0,211,211,211,211
Ventura,60,2023-02-06,326,326,326,0,6929,6979,6978,1,39,1,1,5,1670,1670,1669,1669
Yolo,60,2023-02-06,79,79,79,0,1254,1264,1263,1,4,1,1,2,443,443,442,442
Yuba,60,2023-02-06,22,22,22,0,623,630,629,1,3,0,0,1,122,122,122,122
Alameda,61,2023-02-13,1119,1128,1128,0,17633,17779,17778,1,90,2,2,8,2191,2191,2189,2189
Amador,61,2023-02-13,19,19,19,0,497,503,502,1,0,0,0,0,98,98,98,98
Butte,61,2023-02-13,86,86,86,0,1252,1265,1264,1,25,1,1,2,489,489,488,488
Calaveras,61,2023-02-13,14,14,14,0,295,297,296,1,0,0,0,0,140,140,140,140
Colusa,61,2023-02-13,8,8,8,0,136,138,137,1,0,0,0,0,22,22,22,22
Contra Costa,61,2023-02-13,703,710,710,0,11541,11636,11635,1,44,2,2,10,1555,1555,1553,1553
Del Norte,61,2023-02-13,19,19,19,0,299,300,299,1,2,0,0,0,59,59,59,59
El Dorado,61,2023-02-13,65,65,65,0,1101,1111,1110,1,2,0,0,0,244,244,244,244
Fresno,61,2023-02-13,470,474,474,0,8745,8819,8818,1,106,4,4,7,2999,2999,2995,2995
Glenn,61,2023-02-13,11,11,11,0,175,177,176,1,5,0,0,0,53,53,53,53
Humboldt,61,2023-02-13,37,37,37,0,578,585,584,1,7,0,0,1,170,170,170,170
Imperial,61,2023-02-13,142,142,142,0,1856,1872,1871,1,3,1,1,5,980,980,979,979
Inyo,61,2023-02-13,5,5,5,0,200,201,200,1,0,0,0,0,63,63,63,63
Kern,61,2023-02-13,327,328,328,0,8267,8337,8336,1,37,2,2,6,2482,2482,2480,2480
Kings,61,2023-02-13,88,88,88,0,1900,1917,1916,1,6,1,1,0,483,483,482,482
Lake,61,2023-02-13,20,20,20,0,567,573,572,1,2,0,0,0,160,160,160,160
Lassen,61,2023-02-13,5,5,5,0,361,364,363,1,0,0,0,0,64,64,64,64
Los Angeles,61,2023-02-13,5917,5965,5965,0,130242,131324,131323,1,613,78,82,67,35489,35505,35411,35423
Madera,61,2023-02-13,60,60,60,0,1238,1249,1248,1,7,0,0,2,376,376,376,376
Marin,61,2023-02-13,143,143,143,0,1931,1947,1946,1,19,0,0,3,317,317,317,317
Mariposa,61,2023-02-13,3,3,3,0,102,103,102,1,0,0,0,0,31,31,31,31
Mendocino,61,2023-02-13,28,28,28,0,538,543,542,1,3,2,2,1,144,144,142,142
Merced,61,2023-02-13,167,167,167,0,1857,1872,1871,1,8,0,0,0,903,903,903,903
Modoc,61,2023-02-13,0,0,0,0,2,3,2,1,0,0,0,0,9,9,9,9
Mono,61,2023-02-13,1,1,1,0,66,67,66,1,0,0,0,0,8,8,8,8
Monterey,61,2023-02-13,223,223,223,0,2491,2513,2512,1,25,3,3,1,803,803,800,800
Napa,61,2023-02-13,92,92,92,0,1364,1377,1376,1,4,1,1,0,162,162,161,161
Nevada,61,2023-02-13,37,37,37,0,596,603,602,1,4,0,0,1,136,136,136,136
Orange,61,2023-02-13,1378,1390,1390,0,20601,20771,20770,1,161,12,12,21,7982,7982,7970,7970
Placer,61,2023-02-13,161,161,161,0,2613,2636,2635,1,35,0,0,6,681,681,681,681
Plumas,61,2023-02-13,3,3,3,0,80,81,80,1,1,0,0,0,15,15,15,15
Riverside,61,2023-02-13,1094,1102,1102,0,16095,16229,16228,1,93,7,7,16,6817,6817,6810,6810
Sacramento,61,2023-02-13,819,826,826,0,13050,13159,13158,1,113,5,5,19,3533,3533,3528,3528
San Benito,61,2023-02-13,43,43,43,0,566,572,571,1,1,0,0,0,110,110,110,110
San Bernardino,61,2023-02-13,1020,1028,1028,0,16938,17081,17080,1,134,0,0,18,8133,8133,8133,8133
San Diego,61,2023-02-13,2023,2040,2040,0,29302,29547,29546,1,218,4,4,25,5794,5794,5790,5790
San Francisco,61,2023-02-13,593,599,599,0,10689,10778,10777,1,59,3,3,5,1176,1176,1173,1173
San Joaquin,61,2023-02-13,457,462,462,0,6973,7032,7031,1,28,1,1,3,2423,2423,2422,2422
San Luis Obispo,61,2023-02-13,133,133,133,0,1683,1697,1696,1,4,1,1,4,563,563,562,562
San Mateo,61,2023-02-13,521,526,526,0,8198,8268,8267,1,29,0,0,5,742,742,742,742
Santa Barbara,61,2023-02-13,188,188,188,0,3937,3971,3970,1,16,1,1,5,760,760,759,759
Santa Clara,61,2023-02-13,1373,1385,1385,0,23134,23327,23326,1,114,9,9,25,2707,2707,2698,2698
Santa Cruz,61,2023-02-13,206,207,207,0,9624,9705,9704,1,19,0,0,0,276,276,276,276
Shasta,61,2023-02-13,33,33,33,0,674,680,679,1,7,0,0,0,600,600,600,600
Siskiyou,61,2023-02-13,11,11,11,0,199,200,199,1,0,0,0,0,95,95,95,95
Solano,61,2023-02-13,260,260,260,0,3774,3806,3805,1,28,0,0,3,474,474,474,474
Sonoma,61,2023-02-13,233,234,234,0,3422,3451,3450,1,32,1,1,1,556,556,555,555
Stanislaus,61,2023-02-13,268,268,268,0,3816,3850,3849,1,47,1,1,9,1842,1842,1841,1841
Sutter,61,2023-02-13,46,46,46,0,658,665,664,1,0,1,1,0,237,237,236,236
Tehama,61,2023-02-13,16,16,16,0,346,349,348,1,1,2,2,0,234,234,232,232
Trinity,61,2023-02-13,1,1,1,0,26,27,26,1,0,0,0,0,23,23,23,23
Tulare,61,2023-02-13,247,247,247,0,4116,4151,4150,1,29,3,3,1,1587,1587,1584,1584
Tuolumne,61,2023-02-13,38,38,38,0,508,514,513,1,2,0,0,0,211,211,211,211
Ventura,61,2023-02-13,316,318,318,0,6664,6721,6720,1,29,5,5,6,1675,1675,1670,1670
Yolo,61,2023-02-13,75,75,75,0,1248,1259,1258,1,3,0,0,1,443,443,443,443
Yuba,61,2023-02-13,31,31,31,0,643,650,649,1,8,0,0,0,122,122,122,122
Alameda,62,2023-02-20,1018,1028,1028,0,15445,15595,15594,1,79,3,3,5,2194,2194,2191,2191
Amador,62,2023-02-20,25,25,25,0,496,504,503,1,1,0,0,1,98,98,98,98
Butte,62,2023-02-20,43,43,43,0,1051,1062,1061,1,7,2,2,1,491,491,489,489
Calaveras,62,2023-02-20,17,17,17,0,289,292,291,1,0,0,0,1,140,140,140,140
Colusa,62,2023-02-20,12,12,12,0,92,93,92,1,0,0,0,0,22,22,22,22
Contra Costa,62,2023-02-20,667,674,674,0,10000,10097,10096,1,57,5,5,6,1560,1560,1555,1555
Del Norte,62,2023-02-20,11,11,11,0,258,259,258,1,2,0,0,0,59,59,59,59
El Dorado,62,2023-02-20,51,51,51,0,976,986,985,1,2,1,1,1,245,245,244,244
Fresno,62,2023-02-20,455,461,461,0,8236,8316,8315,1,84,5,5,17,3004,3004,2999,2999
Glenn,62,2023-02-20,5,5,5,0,146,148,147,1,5,0,0,0,53,53,53,53
Humboldt,62,2023-02-20,33,33,33,0,576,584,583,1,7,0,0,1,170,170,170,170
Imperial,62,2023-02-20,121,121,121,0,1782,1800,1799,1,8,0,0,0,980,980,980,980
Inyo,62,2023-02-20,6,6,6,0,162,163,162,1,0,0,0,0,63,63,63,63
Kern,62,2023-02-20,401,404,404,0,7473,7547,7546,1,29,3,3,5,2485,2485,2482,2482
Kings,62,2023-02-20,77,77,77,0,1639,1656,1655,1,5,1,1,0,484,484,483,483
Lake,62,2023-02-20,19,19,19,0,483,490,489,1,2,1,1,1,161,161,160,160
Lassen,62,2023-02-20,2,2,2,0,327,331,330,1,0,0,0,0,64,64,64,64
Los Angeles,62,2023-02-20,5653,5709,5709,0,118396,119543,119542,1,601,80,86,76,35569,35591,35489,35505
Madera,62,2023-02-20,61,61,61,0,1089,1100,1099,1,3,0,0,2,376,376,376,376
Marin,62,2023-02-20,153,153,153,0,1856,1875,1874,1,13,0,0,2,317,317,317,317
Mariposa,62,2023-02-20,6,6,6,0,121,122,121,1,0,0,0,0,31,31,31,31
Mendocino,62,2023-02-20,25,25,25,0,489,495,494,1,3,0,0,0,144,144,144,144
Merced,62,2023-02-20,122,122,122,0,1753,1770,1769,1,19,0,0,1,903,903,903,903
Modoc,62,2023-02-20,1,1,1,0,15,16,15,1,0,0,0,0,9,9,9,9
Mono,62,2023-02-20,2,2,2,0,67,68,67,1,0,0,0,0,8,8,8,8
Monterey,62,2023-02-20,157,157,157,0,2319,2343,2342,1,22,0,0,0,803,803,803,803
Napa,62,2023-02-20,78,78,78,0,1085,1098,1097,1,3,1,1,1,163,163,162,162
Nevada,62,2023-02-20,28,28,28,0,611,619,618,1,7,1,1,1,137,137,136,136
Orange,62,2023-02-20,1327,1339,1339,0,19408,19596,19595,1,158,18,18,21,8000,8000,7982,7982
Placer,62,2023-02-20,162,162,162,0,2422,2445,2444,1,48,1,1,3,682,682,681,681
Plumas,62,2023-02-20,8,8,8,0,75,76,75,1,0,0,0,0,15,15,15,15
Riverside,62,2023-02-20,991,1001,1001,0,15214,15363,15362,1,92,7,7,9,6824,6824,6817,6817
Sacramento,62,2023-02-20,731,738,738,0,11557,11670,11669,1,103,13,13,16,3546,3546,3533,3533
San Benito,62,2023-02-20,28,28,28,0,476,483,482,1,1,2,2,0,112,112,110,110
San Bernardino,62,2023-02-20,904,913,913,0,15186,15335,15334,1,117,0,0,27,8133,8133,8133,8133
San Diego,62,2023-02-20,1764,1782,1782,0,25420,25666,25665,1,201,7,7,25,5801,5801,5794,5794
San Francisco,62,2023-02-20,595,602,602,0,9931,10027,10026,1,79,0,0,7,1176,1176,1176,1176
San Joaquin,62,2023-02-20,414,419,419,0,7369,7440,7439,1,30,1,1,7,2424,2424,2423,2423
San Luis Obispo,62,2023-02-20,96,96,96,0,1435,1449,1448,1,11,0,0,0,563,563,563,563
San Mateo,62,2023-02-20,464,470,470,0,7429,7503,7502,1,44,0,0,3,742,742,742,742
Santa Barbara,62,2023-02-20,206,206,206,0,3629,3666,3665,1,18,0,0,5,760,760,760,760
Santa Clara,62,2023-02-20,1218,1229,1229,0,19503,19692,19691,1,111,11,11,26,2718,2718,2707,2707
Santa Cruz,62,2023-02-20,136,136,136,0,6262,6323,6322,1,20,0,0,2,276,276,276,276
Shasta,62,2023-02-20,18,18,18,0,728,735,734,1,2,0,0,0,600,600,600,600
Siskiyou,62,2023-02-20,14,14,14,0,198,199,198,1,0,0,0,0,95,95,95,95
Solano,62,2023-02-20,229,230,230,0,3263,3296,3295,1,26,0,0,3,474,474,474,474
Sonoma,62,2023-02-20,261,262,262,0,3199,3231,3230,1,24,1,1,4,557,557,556,556
Stanislaus,62,2023-02-20,264,265,265,0,3643,3679,3678,1,55,0,0,4,1842,1842,1842,1842
Sutter,62,2023-02-20,38,38,38,0,539,547,546,1,0,1,1,0,238,238,237,237
Tehama,62,2023-02-20,13,13,13,0,279,281,280,1,0,0,0,0,234,234,234,234
Trinity,62,2023-02-20,0,0,0,0,30,31,30,1,0,0,0,0,23,23,23,23
Tulare,62,2023-02-20,214,215,215,0,3795,3833,3832,1,23,0,0,0,1587,1587,1587,1587
Tuolumne,62,2023-02-20,32,32,32,0,446,452,451,1,0,0,0,0,211,211,211,211
Ventura,62,2023-02-20,283,283,283,0,5625,5680,5679,1,30,4,4,7,1679,1679,1675,1675
Yolo,62,2023-02-20,87,87,87,0,1281,1294,1293,1,1,2,2,1,445,445,443,443
Yuba,62,2023-02-20,25,25,25,0,507,513,512,1,6,0,0,0,122,122,122,122
Alameda,63,2023-02-27,1121,1134,1134,0,18634,18842,18841,1,96,7,7,9,2201,2201,2194,2194
Amador,63,2023-02-27,19,19,19,0,521,529,528,1,1,0,0,1,98,98,98,98
Butte,63,2023-02-27,55,55,55,0,948,959,958,1,8,1,1,1,492,492,491,491
Calaveras,63,2023-02-27,15,15,15,0,306,309,308,1,1,0,0,0,140,140,140,140
Colusa,63,2023-02-27,12,12,12,0,85,86,85,1,0,0,0,0,22,22,22,22
Contra Costa,63,2023-02-27,724,731,731,0,11450,11577,11576,1,63,4,4,11,1564,1564,1560,1560
Del Norte,63,2023-02-27,7,7,7,0,288,291,290,1,0,0,0,0,59,59,59,59
El Dorado,63,2023-02-27,61,61,61,0,1037,1049,1048,1,2,1,1,0,246,246,245,245
Fresno,63,2023-02-27,468,474,474,0,9006,9107,9106,1,93,2,2,7,3006,3006,3004,3004
Glenn,63,2023-02-27,4,4,4,0,144,146,145,1,1,0,0,0,53,53,53,53
Humboldt,63,2023-02-27,29,29,29,0,490,496,495,1,4,0,0,1,170,170,170,170
Imperial,63,2023-02-27,175,175,175,0,1833,1855,1854,1,13,0,0,0,980,980,980,980
Inyo,63,2023-02-27,4,4,4,0,156,158,157,1,0,0,0,0,63,63,63,63
Kern,63,2023-02-27,401,406,406,0,8253,8346,8345,1,42,3,3,7,2488,2488,2485,2485
Kings,63,2023-02-27,61,61,61,0,1687,1705,1704,1,4,1,1,0,485,485,484,484
Lake,63,2023-02-27,21,21,21,0,465,470,469,1,2,1,1,1,162,162,161,161
Lassen,63,2023-02-27,3,3,3,0,352,356,355,1,0,0,0,0,64,64,64,64
Los Angeles,63,2023-02-27,5361,5421,5421,0,134605,136105,136103,2,573,69,76,75,35638,35667,35569,35591
Madera,63,2023-02-27,62,62,62,0,1187,1200,1199,1,7,0,0,1,376,376,376,376
Marin,63,2023-02-27,146,146,146,0,1966,1988,1987,1,16,0,0,3,317,317,317,317
Mariposa,63,2023-02-27,7,7,7,0,97,98,97,1,0,0,0,0,31,31,31,31
Mendocino,63,2023-02-27,21,21,21,0,492,500,499,1,5,1,1,1,145,145,144,144
Merced,63,2023-02-27,124,124,124,0,1885,1907,1906,1,19,0,0,1,903,903,903,903
Modoc,63,2023-02-27,1,1,1,0,8,9,8,1,0,0,0,0,9,9,9,9
Mono,63,2023-02-27,5,5,5,0,52,53,52,1,0,0,0,0,8,8,8,8
Monterey,63,2023-02-27,182,182,182,0,2579,2609,2608,1,30,2,2,1,805,805,803,803
Napa,63,2023-02-27,79,79,79,0,1316,1332,1331,1,7,2,2,4,165,165,163,163
Nevada,63,2023-02-27,25,25,25,0,566,575,574,1,2,0,0,0,137,137,137,137
Orange,63,2023-02-27,1204,1217,1217,0,19613,19831,19830,1,161,19,20,21,8019,8020,8000,8000
Placer,63,2023-02-27,180,180,180,0,2567,2597,2596,1,44,0,0,7,682,682,682,682
Plumas,63,2023-02-27,3,3,3,0,88,89,88,1,0,0,0,0,15,15,15,15
Riverside,63,2023-02-27,915,926,926,0,15463,15636,15635,1,76,7,7,15,6831,6831,6824,6824
Sacramento,63,2023-02-27,933,945,945,0,12781,12925,12924,1,121,6,6,19,3552,3552,3546,3546
San Benito,63,2023-02-27,29,29,29,0,473,479,478,1,2,0,0,0,112,112,112,112
San Bernardino,63,2023-02-27,868,877,877,0,16328,16511,16510,1,111,0,0,24,8133,8133,8133,8133
San Diego,63,2023-02-27,1809,1830,1830,0,27621,27929,27928,1,210,5,5,21,5806,5806,5801,5801
San Francisco,63,2023-02-27,656,663,663,0,11612,11741,11740,1,76,6,6,8,1182,1182,1176,1176
San Joaquin,63,2023-02-27,415,421,421,0,7519,7603,7602,1,33,2,2,3,2426,2426,2424,2424
San Luis Obispo,63,2023-02-27,83,83,83,0,1670,1689,1688,1,11,2,2,0,565,565,563,563
San Mateo,63,2023-02-27,478,484,484,0,7460,7544,7543,1,43,0,0,4,742,742,742,742
Santa Barbara,63,2023-02-27,176,176,176,0,3562,3603,3602,1,18,2,2,8,762,762,760,760
Santa Clara,63,2023-02-27,1340,1355,1355,0,21571,21813,21812,1,126,8,8,26,2726,2726,2718,2718
Santa Cruz,63,2023-02-27,160,161,161,0,8755,8855,8854,1,7,0,0,1,276,276,276,276
Shasta,63,2023-02-27,37,37,37,0,656,664,663,1,9,0,0,1,600,600,600,600
Siskiyou,63,2023-02-27,11,11,11,0,235,237,236,1,0,0,0,0,95,95,95,95
Solano,63,2023-02-27,296,299,299,0,3679,3722,3721,1,30,0,0,8,474,474,474,474
Sonoma,63,2023-02-27,217,217,217,0,3410,3449,3448,1,33,1,1,5,558,558,557,557
Stanislaus,63,2023-02-27,243,245,245,0,3839,3885,3884,1,58,0,0,3,1842,1842,1842,1842
Sutter,63,2023-02-27,46,46,46,0,503,510,509,1,0,0,0,0,238,238,238,238
Tehama,63,2023-02-27,14,14,14,0,267,270,269,1,2,0,0,1,234,234,234,234
Trinity,63,2023-02-27,0,0,0,0,20,21,20,1,0,0,0,0,23,23,23,23
Tulare,63,2023-02-27,216,216,216,0,4010,4056,4055,1,22,3,3,2,1590,1590,1587,1587
Tuolumne,63,2023-02-27,40,40,40,0,472,479,478,1,0,0,0,1,211,211,211,211
Ventura,63,2023-02-27,275,277,277,0,5916,5982,5981,1,35,2,2,7,1681,1681,1679,1679
Yolo,63,2023-02-27,93,93,93,0,1370,1386,1385,1,3,3,3,1,448,448,445,445
Yuba,63,2023-02-27,36,36,36,0,508,515,514,1,0,0,0,0,122,122,122,122
Alameda,64,2023-03-06,926,938,938,0,16589,16799,16798,1,96,4,4,12,2205,2205,2201,2201
Amador,64,2023-03-06,13,13,13,0,461,469,468,1,0,0,0,0,98,98,98,98
Butte,64,2023-03-06,36,36,36,0,591,598,597,1,5,1,1,0,493,493,492,492
Calaveras,64,2023-03-06,19,19,19,0,269,274,273,1,0,2,2,0,142,142,140,140
Colusa,64,2023-03-06,13,13,13,0,161,164,163,1,0,0,0,0,22,22,22,22
Contra Costa,64,2023-03-06,699,709,709,0,10262,10391,10390,1,64,3,3,8,1567,1567,1564,1564
Del Norte,64,2023-03-06,6,6,6,0,253,257,256,1,1,1,1,1,60,60,59,59
El Dorado,64,2023-03-06,52,52,52,0,955,969,968,1,2,0,0,0,246,246,246,246
Fresno,64,2023-03-06,391,397,397,0,7976,8078,8077,1,77,5,5,16,3011,3011,3006,3006
Glenn,64,2023-03-06,4,4,4,0,163,165,164,1,0,0,0,0,53,53,53,53
Humboldt,64,2023-03-06,21,21,21,0,491,498,497,1,1,0,0,1,170,170,170,170
Imperial,64,2023-03-06,170,171,171,0,1608,1630,1629,1,9,0,0,0,980,980,980,980
Inyo,64,2023-03-06,4,4,4,0,136,138,137,1,1,0,0,0,63,63,63,63
Kern,64,2023-03-06,330,334,334,0,7770,7869,7868,1,35,3,3,4,2491,2491,2488,2488
Kings,64,2023-03-06,65,65,65,0,1566,1586,1585,1,1,0,0,0,485,485,485,485
Lake,64,2023-03-06,19,19,19,0,487,495,494,1,1,0,0,0,162,162,162,162
Lassen,64,2023-03-06,4,4,4,0,306,310,309,1,1,0,0,0,64,64,64,64
Los Angeles,64,2023-03-06,4602,4661,4661,0,123343,124895,124894,1,509,69,76,60,35707,35743,35638,35667
Madera,64,2023-03-06,82,82,82,0,1146,1161,1160,1,5,0,0,0,376,376,376,376
Marin,64,2023-03-06,141,141,141,0,1776,1799,1798,1,21,0,0,2,317,317,317,317
Mariposa,64,2023-03-06,0,0,0,0,69,70,69,1,0,0,0,0,31,31,31,31
Mendocino,64,2023-03-06,26,26,26,0,448,455,454,1,7,0,0,1,145,145,145,145
Merced,64,2023-03-06,147,147,147,0,1718,1740,1739,1,14,0,0,2,903,903,903,903
Modoc,64,2023-03-06,1,1,1,0,9,10,9,1,0,0,0,0,9,9,9,9
Mono,64,2023-03-06,5,5,5,0,56,57,56,1,0,0,0,0,8,8,8,8
Monterey,64,2023-03-06,145,145,145,0,2158,2185,2184,1,29,4,4,3,809,809,805,805
Napa,64,2023-03-06,52,52,52,0,1056,1071,1070,1,9,1,1,2,166,166,165,165
Nevada,64,2023-03-06,18,18,18,0,484,491,490,1,2,0,0,0,137,137,137,137
Orange,64,2023-03-06,992,1004,1004,0,18890,19128,19127,1,111,18,19,18,8037,8039,8019,8020
Placer,64,2023-03-06,172,172,172,0,2461,2493,2492,1,62,0,0,5,682,682,682,682
Plumas,64,2023-03-06,1,1,1,0,68,69,68,1,0,0,0,0,15,15,15,15
Riverside,64,2023-03-06,882,894,894,0,13997,14175,14174,1,78,3,3,8,6834,6834,6831,6831
Sacramento,64,2023-03-06,858,868,868,0,11807,11956,11955,1,113,5,5,6,3557,3557,3552,3552
San Benito,64,2023-03-06,16,16,16,0,465,472,471,1,1,0,0,0,112,112,112,112
San Bernardino,64,2023-03-06,745,754,754,0,15026,15215,15214,1,99,0,0,18,8133,8133,8133,8133
San Diego,64,2023-03-06,1409,1426,1426,0,25369,25689,25688,1,179,12,12,13,5818,5818,5806,5806
San Francisco,64,2023-03-06,599,606,606,0,10704,10839,10838,1,73,5,5,11,1187,1187,1182,1182
San Joaquin,64,2023-03-06,381,387,387,0,6810,6898,6897,1,42,0,0,8,2426,2426,2426,2426
San Luis Obispo,64,2023-03-06,92,92,92,0,1309,1327,1326,1,9,4,4,0,569,569,565,565
San Mateo,64,2023-03-06,425,432,432,0,7225,7316,7315,1,28,0,0,3,742,742,742,742
Santa Barbara,64,2023-03-06,149,149,149,0,3681,3728,3727,1,18,2,2,1,764,764,762,762
Santa Clara,64,2023-03-06,1083,1096,1096,0,20931,21195,21194,1,133,6,6,32,2732,2732,2726,2726
Santa Cruz,64,2023-03-06,133,133,133,0,5123,5188,5187,1,20,0,0,0,276,276,276,276
Shasta,64,2023-03-06,24,24,24,0,633,642,641,1,5,0,0,2,600,600,600,600
Siskiyou,64,2023-03-06,6,6,6,0,223,225,224,1,1,0,0,0,95,95,95,95
Solano,64,2023-03-06,256,258,258,0,3342,3384,3383,1,34,0,0,5,474,474,474,474
Sonoma,64,2023-03-06,209,209,209,0,3228,3270,3269,1,23,0,0,2,558,558,558,558
Stanislaus,64,2023-03-06,259,261,261,0,3547,3593,3592,1,67,0,0,9,1842,1842,1842,1842
Sutter,64,2023-03-06,35,35,35,0,593,602,601,1,0,0,0,0,238,238,238,238
Tehama,64,2023-03-06,12,12,12,0,251,255,254,1,5,0,0,1,234,234,234,234
Trinity,64,2023-03-06,2,2,2,0,18,19,18,1,0,0,0,0,23,23,23,23
Tulare,64,2023-03-06,209,209,209,0,3264,3306,3305,1,29,0,0,3,1590,1590,1590,1590
Tuolumne,64,2023-03-06,37,37,37,0,401,408,407,1,1,0,0,0,211,211,211,211
Ventura,64,2023-03-06,252,255,255,0,4970,5034,5033,1,42,2,2,5,1683,1683,1681,1681
Yolo,64,2023-03-06,64,64,64,0,1262,1279,1278,1,4,1,1,0,449,449,448,448
Yuba,64,2023-03-06,38,38,38,0,509,516,515,1,7,0,0,0,122,122,122,122
Alameda,65,2023-03-13,859,871,871,0,15319,15539,15538,1,76,2,2,18,2207,2207,2205,2205
Amador,65,2023-03-13,14,14,14,0,380,388,387,1,5,0,0,1,98,98,98,98
Butte,65,2023-03-13,38,38,38,0,600,609,608,1,9,1,1,1,494,494,493,493
Calaveras,65,2023-03-13,14,14,14,0,243,248,247,1,0,0,0,0,142,142,142,142
Colusa,65,2023-03-13,4,4,4,0,159,162,161,1,0,1,1,0,23,23,22,22
Contra Costa,65,2023-03-13,584,591,591,0,9861,10003,10002,1,44,2,2,7,1569,1569,1567,1567
Del Norte,65,2023-03-13,8,8,8,0,256,261,260,1,1,0,0,0,60,60,60,60
El Dorado,65,2023-03-13,47,47,47,0,897,911,910,1,1,0,0,0,246,246,246,246
Fresno,65,2023-03-13,385,392,392,0,7768,7880,7879,1,79,0,0,10,3011,3011,3011,3011
Glenn,65,2023-03-13,10,10,10,0,141,143,142,1,0,0,0,0,53,53,53,53
Humboldt,65,2023-03-13,28,28,28,0,505,514,513,1,4,0,0,1,170,170,170,170
Imperial,65,2023-03-13,214,216,216,0,2037,2067,2066,1,12,1,1,0,981,981,980,980
Inyo,65,2023-03-13,0,0,0,0,259,263,262,1,0,0,0,0,63,63,63,63
Kern,65,2023-03-13,337,343,343,0,7631,7742,7741,1,52,0,0,12,2491,2491,2491,2491
Kings,65,2023-03-13,60,60,60,0,1437,1458,1457,1,1,0,0,0,485,485,485,485
Lake,65,2023-03-13,11,11,11,0,410,416,415,1,1,0,0,0,162,162,162,162
Lassen,65,2023-03-13,6,6,6,0,335,342,341,1,0,0,0,0,64,64,64,64
Los Angeles,65,2023-03-13,3874,3930,3930,0,120845,122577,122576,1,418,71,80,56,35778,35823,35707,35743
Madera,65,2023-03-13,50,50,50,0,1149,1167,1166,1,6,0,0,0,376,376,376,376
Marin,65,2023-03-13,98,98,98,0,1720,1745,1744,1,21,0,0,1,317,317,317,317
Mariposa,65,2023-03-13,5,5,5,0,93,94,93,1,0,0,0,0,31,31,31,31
Mendocino,65,2023-03-13,17,17,17,0,458,466,465,1,6,0,0,1,145,145,145,145
Merced,65,2023-03-13,102,102,102,0,1506,1529,1528,1,12,0,0,2,903,903,903,903
Modoc,65,2023-03-13,1,1,1,0,12,13,12,1,0,0,0,0,9,9,9,9
Mono,65,2023-03-13,1,1,1,0,50,51,50,1,0,0,0,0,8,8,8,8
Monterey,65,2023-03-13,72,72,72,0,1810,1837,1836,1,27,0,0,2,809,809,809,809
Napa,65,2023-03-13,55,55,55,0,940,955,954,1,4,3,3,2,169,169,166,166
Nevada,65,2023-03-13,18,18,18,0,478,487,486,1,4,0,0,0,137,137,137,137
Orange,65,2023-03-13,912,925,925,0,18056,18316,18315,1,129,28,33,21,8065,8072,8037,8039
Placer,65,2023-03-13,169,170,170,0,2135,2165,2164,1,66,0,0,8,682,682,682,682
Plumas,65,2023-03-13,5,5,5,0,64,65,64,1,0,0,0,0,15,15,15,15
Riverside,65,2023-03-13,904,917,917,0,14720,14932,14931,1,79,6,6,14,6840,6840,6834,6834
Sacramento,65,2023-03-13,707,718,718,0,10735,10891,10890,1,105,6,6,21,3563,3563,3557,3557
San Benito,65,2023-03-13,13,13,13,0,412,420,419,1,0,0,0,0,112,112,112,112
San Bernardino,65,2023-03-13,708,718,718,0,14703,14916,14915,1,94,0,0,20,8133,8133,8133,8133
San Diego,65,2023-03-13,1317,1336,1336,0,23770,24111,24110,1,177,9,9,13,5827,5827,5818,5818
San Francisco,65,2023-03-13,550,558,558,0,9389,9524,9523,1,73,3,3,14,1190,1190,1187,1187
San Joaquin,65,2023-03-13,371,378,378,0,6804,6902,6901,1,34,4,4,6,2430,2430,2426,2426
San Luis Obispo,65,2023-03-13,78,78,78,0,1326,1345,1344,1,9,0,0,0,569,569,569,569
San Mateo,65,2023-03-13,371,378,378,0,6699,6796,6795,1,24,0,0,5,742,742,742,742
Santa Barbara,65,2023-03-13,150,150,150,0,3416,3466,3465,1,12,0,0,1,764,764,764,764
Santa Clara,65,2023-03-13,1040,1054,1054,0,20662,20959,20958,1,139,10,10,20,2742,2742,2732,2732
Santa Cruz,65,2023-03-13,109,109,109,0,3216,3262,3261,1,21,0,0,1,276,276,276,276
Shasta,65,2023-03-13,27,27,27,0,586,596,595,1,6,0,0,1,600,600,600,600
Siskiyou,65,2023-03-13,10,10,10,0,159,161,160,1,0,0,0,0,95,95,95,95
Solano,65,2023-03-13,229,231,231,0,3080,3125,3124,1,27,0,0,4,474,474,474,474
Sonoma,65,2023-03-13,195,197,197,0,2820,2861,2860,1,41,3,3,4,561,561,558,558
Stanislaus,65,2023-03-13,195,197,197,0,3440,3488,3487,1,52,0,0,4,1842,1842,1842,1842
Sutter,65,2023-03-13,27,27,27,0,518,527,526,1,0,0,0,0,238,238,238,238
Tehama,65,2023-03-13,17,17,17,0,229,232,231,1,1,0,0,0,234,234,234,234
Trinity,65,2023-03-13,0,0,0,0,22,23,22,1,0,0,0,0,23,23,23,23
Tulare,65,2023-03-13,164,164,164,0,3263,3312,3311,1,31,3,3,2,1593,1593,1590,1590
Tuolumne,65,2023-03-13,18,18,18,0,367,372,371,1,2,0,0,0,211,211,211,211
Ventura,65,2023-03-13,230,233,233,0,4362,4425,4424,1,25,4,4,5,1687,1687,1683,1683
Yolo,65,2023-03-13,72,72,72,0,1079,1095,1094,1,2,1,1,0,450,450,449,449
Yuba,65,2023-03-13,33,33,33,0,473,482,481,1,7,0,0,0,122,122,122,122
Alameda,66,2023-03-20,762,774,774,0,14842,15089,15088,1,69,7,8,10,2214,2215,2207,2207
Amador,66,2023-03-20,15,15,15,0,396,404,403,1,3,0,0,1,98,98,98,98
Butte,66,2023-03-20,44,44,44,0,502,512,511,1,5,1,1,3,495,495,494,494
Calaveras,66,2023-03-20,9,9,9,0,246,251,250,1,0,0,0,0,142,142,142,142
Colusa,66,2023-03-20,4,4,4,0,153,156,155,1,0,0,0,0,23,23,23,23
Contra Costa,66,2023-03-20,435,442,442,0,9440,9598,9597,1,31,5,5,8,1574,1574,1569,1569
Del Norte,66,2023-03-20,2,2,2,0,224,229,228,1,0,0,0,1,60,60,60,60
El Dorado,66,2023-03-20,46,46,46,0,849,864,863,1,2,0,0,0,246,246,246,246
Fresno,66,2023-03-20,371,378,378,0,7760,7889,7888,1,66,2,2,16,3013,3013,3011,3011
Glenn,66,2023-03-20,4,4,4,0,132,134,133,1,0,0,0,0,53,53,53,53
Humboldt,66,2023-03-20,21,21,21,0,477,486,485,1,4,0,0,2,170,170,170,170
Imperial,66,2023-03-20,156,158,158,0,1628,1656,1655,1,9,0,0,1,981,981,981,981
Inyo,66,2023-03-20,10,10,10,0,281,287,286,1,0,0,0,0,63,63,63,63
Kern,66,2023-03-20,205,209,209,0,7575,7701,7700,1,29,2,2,8,2493,2493,2491,2491
Kings,66,2023-03-20,40,40,40,0,1448,1473,1472,1,1,1,1,0,486,486,485,485
Lake,66,2023-03-20,12,12,12,0,404,411,410,1,2,0,0,0,162,162,162,162
Lassen,66,2023-03-20,4,4,4,0,307,314,313,1,0,0,0,0,64,64,64,64
Los Angeles,66,2023-03-20,3209,3262,3262,0,109712,111528,111527,1,397,58,67,44,35836,35890,35778,35823
Madera,66,2023-03-20,50,50,50,0,1112,1131,1130,1,4,0,0,0,376,376,376,376
Marin,66,2023-03-20,88,88,88,0,1521,1546,1545,1,25,0,0,2,317,317,317,317
Mariposa,66,2023-03-20,2,2,2,0,91,92,91,1,0,0,0,0,31,31,31,31
Mendocino,66,2023-03-20,11,11,11,0,423,431,430,1,2,0,0,0,145,145,145,145
Merced,66,2023-03-20,105,105,105,0,1471,1497,1496,1,6,0,0,2,903,903,903,903
Modoc,66,2023-03-20,1,1,1,0,10,11,10,1,0,0,0,0,9,9,9,9
Mono,66,2023-03-20,4,4,4,0,53,54,53,1,0,0,0,0,8,8,8,8
Monterey,66,2023-03-20,59,59,59,0,1428,1452,1451,1,21,0,0,1,809,809,809,809
Napa,66,2023-03-20,30,30,30,0,905,922,921,1,3,1,1,1,170,170,169,169
Nevada,66,2023-03-20,17,17,17,0,457,465,464,1,4,0,0,0,137,137,137,137
Orange,66,2023-03-20,742,755,755,0,16299,16569,16568,1,115,10,10,25,8075,8082,8065,8072
Placer,66,2023-03-20,124,124,124,0,2146,2181,2180,1,58,0,0,8,682,682,682,682
Plumas,66,2023-03-20,2,2,2,0,52,53,52,1,0,0,0,0,15,15,15,15
Riverside,66,2023-03-20,590,600,600,0,12322,12526,12525,1,57,1,1,7,6841,6841,6840,6840
Sacramento,66,2023-03-20,486,493,493,0,9727,9891,9890,1,85,4,4,16,3567,3567,3563,3563
San Benito,66,2023-03-20,41,41,41,0,555,566,565,1,0,1,1,0,113,113,112,112
San Bernardino,66,2023-03-20,520,528,528,0,13866,14096,14095,1,77,0,0,12,8133,8133,8133,8133
San Diego,66,2023-03-20,1119,1138,1138,0,22789,23164,23163,1,139,9,10,13,5836,5837,5827,5827
San Francisco,66,2023-03-20,419,426,426,0,8429,8570,8569,1,63,4,4,8,1194,1194,1190,1190
San Joaquin,66,2023-03-20,268,273,273,0,5777,5874,5873,1,28,6,7,5,2436,2437,2430,2430
San Luis Obispo,66,2023-03-20,48,48,48,0,1154,1176,1175,1,9,1,1,0,570,570,569,569
San Mateo,66,2023-03-20,310,316,316,0,6304,6409,6408,1,24,0,0,1,742,742,742,742
Santa Barbara,66,2023-03-20,111,111,111,0,3109,3161,3160,1,15,1,1,1,765,765,764,764
Santa Clara,66,2023-03-20,795,809,809,0,16858,17138,17137,1,151,6,6,22,2748,2748,2742,2742
Santa Cruz,66,2023-03-20,120,121,121,0,3045,3096,3095,1,9,0,0,1,276,276,276,276
Shasta,66,2023-03-20,18,18,18,0,569,579,578,1,2,0,0,3,600,600,600,600
Siskiyou,66,2023-03-20,4,4,4,0,157,159,158,1,0,0,0,0,95,95,95,95
Solano,66,2023-03-20,184,187,187,0,2887,2936,2935,1,26,1,1,5,475,475,474,474
Sonoma,66,2023-03-20,183,186,186,0,2729,2774,2773,1,33,0,0,1,561,561,561,561
Stanislaus,66,2023-03-20,199,201,201,0,3278,3333,3332,1,48,0,0,6,1842,1842,1842,1842
Sutter,66,2023-03-20,38,38,38,0,486,494,493,1,0,0,0,0,238,238,238,238
Tehama,66,2023-03-20,14,14,14,0,218,222,221,1,2,1,1,0,235,235,234,234
Trinity,66,2023-03-20,0,0,0,0,17,18,17,1,0,0,0,0,23,23,23,23
Tulare,66,2023-03-20,119,120,120,0,2674,2720,2719,1,25,1,1,0,1594,1594,1593,1593
Tuolumne,66,2023-03-20,14,14,14,0,387,395,394,1,0,0,0,0,211,211,211,211
Ventura,66,2023-03-20,176,176,176,0,4141,4210,4209,1,39,4,4,2,1691,1691,1687,1687
Yolo,66,2023-03-20,54,54,54,0,1062,1080,1079,1,6,0,0,1,450,450,450,450
Yuba,66,2023-03-20,18,18,18,0,461,470,469,1,7,0,0,0,122,122,122,122
Alameda,67,2023-03-27,593,605,605,0,13338,13603,13602,1,91,3,3,9,2217,2218,2214,2215
Amador,67,2023-03-27,10,10,10,0,359,367,366,1,3,0,0,1,98,98,98,98
Butte,67,2023-03-27,30,30,30,0,500,510,509,1,8,1,1,0,496,496,495,495
Calaveras,67,2023-03-27,12,12,12,0,245,251,250,1,0,1,1,0,143,143,142,142
Colusa,67,2023-03-27,4,4,4,0,162,165,164,1,0,0,0,0,23,23,23,23
Contra Costa,67,2023-03-27,399,406,406,0,8885,9061,9060,1,33,1,1,6,1575,1575,1574,1574
Del Norte,67,2023-03-27,6,6,6,0,206,211,210,1,0,0,0,1,60,60,60,60
El Dorado,67,2023-03-27,35,35,35,0,781,797,796,1,2,0,0,0,246,246,246,246
Fresno,67,2023-03-27,249,255,255,0,7259,7402,7401,1,59,1,1,5,3014,3014,3013,3013
Glenn,67,2023-03-27,6,6,6,0,134,137,136,1,0,0,0,0,53,53,53,53
Humboldt,67,2023-03-27,13,13,13,0,447,457,456,1,5,1,1,1,171,171,170,170
Imperial,67,2023-03-27,150,153,153,0,1679,1713,1712,1,10,0,0,1,981,981,981,981
Inyo,67,2023-03-27,10,10,10,0,224,229,228,1,0,0,0,0,63,63,63,63
Kern,67,2023-03-27,186,189,189,0,6956,7094,7093,1,29,1,1,3,2494,2494,2493,2493
Kings,67,2023-03-27,37,37,37,0,1307,1333,1332,1,2,0,0,1,486,486,486,486
Lake,67,2023-03-27,13,13,13,0,349,356,355,1,2,0,0,0,162,162,162,162
Lassen,67,2023-03-27,7,7,7,0,315,323,322,1,0,0,0,0,64,64,64,64
Los Angeles,67,2023-03-27,2429,2477,2477,0,103491,105537,105536,1,348,30,39,46,35866,35929,35836,35890
Madera,67,2023-03-27,33,33,33,0,958,978,977,1,5,0,0,0,376,376,376,376
Marin,67,2023-03-27,78,78,78,0,1286,1313,1312,1,18,0,0,1,317,317,317,317
Mariposa,67,2023-03-27,0,0,0,0,74,75,74,1,0,0,0,0,31,31,31,31
Mendocino,67,2023-03-27,15,15,15,0,410,420,419,1,1,0,0,1,145,145,145,145
Merced,67,2023-03-27,91,91,91,0,1331,1357,1356,1,6,0,0,2,903,903,903,903
Modoc,67,2023-03-27,0,0,0,0,5,6,5,1,0,0,0,0,9,9,9,9
Mono,67,2023-03-27,1,1,1,0,49,50,49,1,0,0,0,0,8,8,8,8
Monterey,67,2023-03-27,52,52,52,0,1695,1730,1729,1,19,0,0,0,809,809,809,809
Napa,67,2023-03-27,42,42,42,0,886,905,904,1,3,0,0,1,170,170,170,170
Nevada,67,2023-03-27,24,24,24,0,473,483,482,1,3,0,0,0,137,137,137,137
Orange,67,2023-03-27,633,645,645,0,15574,15884,15883,1,112,14,18,19,8089,8100,8075,8082
Placer,67,2023-03-27,102,102,102,0,1878,1917,1916,1,43,0,0,6,682,682,682,682
Plumas,67,2023-03-27,1,1,1,0,55,56,55,1,0,0,0,0,15,15,15,15
Riverside,67,2023-03-27,543,554,554,0,11268,11492,11491,1,41,5,6,6,6846,6847,6841,6841
Sacramento,67,2023-03-27,439,447,447,0,9390,9578,9577,1,79,8,9,11,3575,3576,3567,3567
San Benito,67,2023-03-27,23,23,23,0,753,770,769,1,1,0,0,0,113,113,113,113
San Bernardino,67,2023-03-27,426,435,435,0,12622,12874,12873,1,67,0,0,12,8133,8133,8133,8133
San Diego,67,2023-03-27,881,899,899,0,20626,21033,21032,1,137,2,2,7,5838,5839,5836,5837
San Francisco,67,2023-03-27,369,376,376,0,7824,7981,7980,1,45,1,1,5,1195,1195,1194,1194
San Joaquin,67,2023-03-27,244,251,251,0,5543,5655,5654,1,23,2,2,11,2438,2439,2436,2437
San Luis Obispo,67,2023-03-27,39,39,39,0,1138,1162,1161,1,4,0,0,0,570,570,570,570
San Mateo,67,2023-03-27,269,276,276,0,5698,5810,5809,1,29,0,0,1,742,742,742,742
Santa Barbara,67,2023-03-27,88,88,88,0,3228,3293,3292,1,9,0,0,2,765,765,765,765
Santa Clara,67,2023-03-27,693,706,706,0,15848,16162,16161,1,100,5,6,14,2753,2754,2748,2748
Santa Cruz,67,2023-03-27,128,129,129,0,2947,3005,3004,1,8,0,0,1,276,276,276,276
Shasta,67,2023-03-27,16,16,16,0,536,548,547,1,2,0,0,3,600,600,600,600
Siskiyou,67,2023-03-27,1,1,1,0,147,149,148,1,0,0,0,0,95,95,95,95
Solano,67,2023-03-27,168,171,171,0,2660,2714,2713,1,23,0,0,4,475,475,475,475
Sonoma,67,2023-03-27,153,155,155,0,2420,2469,2468,1,29,2,3,4,563,564,561,561
Stanislaus,67,2023-03-27,150,152,152,0,2573,2625,2624,1,39,0,0,6,1842,1842,1842,1842
Sutter,67,2023-03-27,37,37,37,0,419,428,427,1,0,0,0,0,238,238,238,238
Tehama,67,2023-03-27,5,5,5,0,196,201,200,1,2,1,1,0,236,236,235,235
Trinity,67,2023-03-27,0,0,0,0,24,25,24,1,0,0,0,0,23,23,23,23
Tulare,67,2023-03-27,102,102,102,0,2715,2769,2768,1,25,0,0,1,1594,1594,1594,1594
Tuolumne,67,2023-03-27,8,8,8,0,308,316,315,1,1,0,0,0,211,211,211,211
Ventura,67,2023-03-27,146,148,148,0,4099,4181,4180,1,25,4,5,2,1695,1696,1691,1691
Yolo,67,2023-03-27,60,60,60,0,1065,1088,1087,1,6,0,0,1,450,450,450,450
Yuba,67,2023-03-27,14,14,14,0,417,426,425,1,1,0,0,1,122,122,122,122
Alameda,68,2023-04-03,571,585,585,0,12435,12748,12747,1,58,3,5,9,2220,2223,2217,2218
Amador,68,2023-04-03,16,16,16,0,286,294,293,1,2,0,0,0,98,98,98,98
Butte,68,2023-04-03,22,22,22,0,464,477,476,1,7,1,2,0,497,498,496,496
Calaveras,68,2023-04-03,5,5,5,0,203,210,209,1,0,0,0,0,143,143,143,143
Colusa,68,2023-04-03,9,9,9,0,174,179,178,1,2,0,0,0,23,23,23,23
Contra Costa,68,2023-04-03,389,398,398,0,8664,8885,8884,1,37,3,3,4,1578,1578,1575,1575
Del Norte,68,2023-04-03,5,5,5,0,195,203,202,1,0,0,0,0,60,60,60,60
El Dorado,68,2023-04-03,65,65,65,0,745,765,764,1,4,0,0,0,246,246,246,246
Fresno,68,2023-04-03,273,280,280,0,7092,7273,7272,1,54,4,5,12,3018,3019,3014,3014
Glenn,68,2023-04-03,6,6,6,0,127,130,129,1,0,0,0,0,53,53,53,53
Humboldt,68,2023-04-03,20,20,20,0,451,463,462,1,5,0,0,0,171,171,171,171
Imperial,68,2023-04-03,188,193,193,0,1508,1546,1545,1,14,0,0,1,981,981,981,981
Inyo,68,2023-04-03,2,2,2,0,139,142,141,1,0,0,0,0,63,63,63,63
Kern,68,2023-04-03,158,162,162,0,5609,5749,5748,1,28,2,2,1,2496,2496,2494,2494
Kings,68,2023-04-03,33,33,33,0,983,1009,1008,1,5,0,0,0,486,486,486,486
Lake,68,2023-04-03,16,16,16,0,342,351,350,1,0,0,0,0,162,162,162,162
Lassen,68,2023-04-03,3,3,3,0,165,170,169,1,0,0,0,0,64,64,64,64
Los Angeles,68,2023-04-03,2410,2471,2471,0,97540,99986,99985,1,318,34,50,40,35900,35979,35866,35929
Madera,68,2023-04-03,38,38,38,0,852,874,873,1,1,0,0,0,376,376,376,376
Marin,68,2023-04-03,104,106,106,0,1243,1275,1274,1,16,0,0,0,317,317,317,317
Mariposa,68,2023-04-03,6,6,6,0,71,72,71,1,0,0,0,0,31,31,31,31
Mendocino,68,2023-04-03,14,14,14,0,362,372,371,1,3,0,0,1,145,145,145,145
Merced,68,2023-04-03,74,74,74,0,923,948,947,1,6,0,0,0,903,903,903,903
Modoc,68,2023-04-03,4,4,4,0,12,13,12,1,0,0,0,0,9,9,9,9
Mono,68,2023-04-03,2,2,2,0,40,41,40,1,0,0,0,0,8,8,8,8
Monterey,68,2023-04-03,59,59,59,0,1643,1686,1685,1,16,2,3,1,811,812,809,809
Napa,68,2023-04-03,40,40,40,0,804,825,824,1,8,2,2,1,172,172,170,170
Nevada,68,2023-04-03,56,56,56,0,433,445,444,1,4,1,2,0,138,139,137,137
Orange,68,2023-04-03,655,673,673,0,15302,15688,15687,1,93,4,6,14,8093,8106,8089,8100
Placer,68,2023-04-03,101,102,102,0,1866,1914,1913,1,39,0,0,5,682,682,682,682
Plumas,68,2023-04-03,2,2,2,0,57,58,57,1,0,0,0,0,15,15,15,15
Riverside,68,2023-04-03,456,467,467,0,10961,11238,11237,1,61,2,2,8,6848,6849,6846,6847
Sacramento,68,2023-04-03,513,525,525,0,8921,9146,9145,1,70,1,2,16,3576,3578,3575,3576
San Benito,68,2023-04-03,24,24,24,0,550,565,564,1,0,0,0,0,113,113,113,113
San Bernardino,68,2023-04-03,464,476,476,0,11764,12063,12062,1,54,0,0,12,8133,8133,8133,8133
San Diego,68,2023-04-03,770,789,789,0,19467,19958,19957,1,128,6,8,10,5844,5847,5838,5839
San Francisco,68,2023-04-03,329,337,337,0,6759,6930,6929,1,37,2,2,9,1197,1197,1195,1195
San Joaquin,68,2023-04-03,217,224,224,0,4975,5100,5099,1,31,0,0,8,2438,2439,2438,2439
San Luis Obispo,68,2023-04-03,45,45,45,0,965,991,990,1,5,3,4,0,573,574,570,570
San Mateo,68,2023-04-03,259,266,266,0,5632,5774,5773,1,29,0,0,0,742,742,742,742
Santa Barbara,68,2023-04-03,95,95,95,0,2626,2693,2692,1,16,0,0,1,765,765,765,765
Santa Clara,68,2023-04-03,655,671,671,0,15152,15532,15531,1,70,1,1,15,2754,2755,2753,2754
Santa Cruz,68,2023-04-03,127,130,130,0,2408,2469,2468,1,15,0,0,0,276,276,276,276
Shasta,68,2023-04-03,19,19,19,0,500,515,514,1,1,0,0,1,600,600,600,600
Siskiyou,68,2023-04-03,2,2,2,0,93,95,94,1,0,0,0,0,95,95,95,95
Solano,68,2023-04-03,124,128,128,0,2336,2396,2395,1,20,0,0,2,475,475,475,475
Sonoma,68,2023-04-03,139,144,144,0,2084,2138,2137,1,27,2,3,0,565,567,563,564
Stanislaus,68,2023-04-03,116,117,117,0,2507,2572,2571,1,33,0,0,4,1842,1842,1842,1842
Sutter,68,2023-04-03,33,33,33,0,399,408,407,1,0,0,0,0,238,238,238,238
Tehama,68,2023-04-03,10,10,10,0,191,197,196,1,0,0,0,0,236,236,236,236
Trinity,68,2023-04-03,0,0,0,0,11,12,11,1,0,0,0,0,23,23,23,23
Tulare,68,2023-04-03,96,96,96,0,2603,2668,2667,1,19,0,0,1,1594,1594,1594,1594
Tuolumne,68,2023-04-03,6,6,6,0,247,255,254,1,1,0,0,0,211,211,211,211
Ventura,68,2023-04-03,144,147,147,0,3518,3608,3607,1,22,4,5,0,1699,1701,1695,1696
Yolo,68,2023-04-03,52,52,52,0,966,991,990,1,3,1,1,0,451,451,450,450
Yuba,68,2023-04-03,23,23,23,0,397,408,407,1,1,0,0,0,122,122,122,122
Alameda,69,2023-04-10,538,558,558,0,11012,11401,11400,1,58,0,0,10,2220,2223,2220,2223
Amador,69,2023-04-10,9,9,9,0,200,208,207,1,1,0,0,0,98,98,98,98
Butte,69,2023-04-10,19,19,19,0,433,449,448,1,4,0,0,0,497,498,497,498
Calaveras,69,2023-04-10,10,10,10,0,184,192,191,1,0,0,0,0,143,143,143,143
Colusa,69,2023-04-10,1,1,1,0,97,100,99,1,1,0,0,0,23,23,23,23
Contra Costa,69,2023-04-10,413,429,429,0,8196,8484,8483,1,42,0,0,2,1578,1578,1578,1578
Del Norte,69,2023-04-10,2,2,2,0,123,128,127,1,0,0,0,0,60,60,60,60
El Dorado,69,2023-04-10,40,41,41,0,657,682,681,1,3,0,0,1,246,246,246,246
Fresno,69,2023-04-10,269,279,279,0,6165,6383,6382,1,63,1,2,3,3019,3021,3018,3019
Glenn,69,2023-04-10,2,2,2,0,131,135,134,1,1,0,0,0,53,53,53,53
Humboldt,69,2023-04-10,16,16,16,0,428,444,443,1,4,0,0,0,171,171,171,171
Imperial,69,2023-04-10,146,153,153,0,1297,1343,1342,1,7,0,0,3,981,981,981,981
Inyo,69,2023-04-10,4,4,4,0,212,221,220,1,0,0,0,0,63,63,63,63
Kern,69,2023-04-10,153,160,160,0,4942,5114,5113,1,28,0,0,2,2496,2496,2496,2496
Kings,69,2023-04-10,44,45,45,0,853,883,882,1,4,0,0,0,486,486,486,486
Lake,69,2023-04-10,13,13,13,0,296,308,307,1,0,0,0,0,162,162,162,162
Lassen,69,2023-04-10,0,0,0,0,109,114,113,1,0,0,0,0,64,64,64,64
Los Angeles,69,2023-04-10,2413,2500,2500,0,87251,90348,90347,1,299,23,45,35,35923,36024,35900,35979
Madera,69,2023-04-10,75,77,77,0,863,894,893,1,0,0,0,0,376,376,376,376
Marin,69,2023-04-10,98,102,102,0,1179,1222,1221,1,12,0,0,2,317,317,317,317
Mariposa,69,2023-04-10,4,4,4,0,64,66,65,1,0,0,0,0,31,31,31,31
Mendocino,69,2023-04-10,14,14,14,0,350,363,362,1,2,0,0,1,145,145,145,145
Merced,69,2023-04-10,50,50,50,0,753,780,779,1,5,0,0,1,903,903,903,903
Modoc,69,2023-04-10,1,1,1,0,6,7,6,1,0,0,0,0,9,9,9,9
Mono,69,2023-04-10,1,1,1,0,45,46,45,1,0,0,0,0,8,8,8,8
Monterey,69,2023-04-10,53,53,53,0,1285,1331,1330,1,12,0,0,1,811,812,811,812
Napa,69,2023-04-10,31,31,31,0,675,699,698,1,5,0,0,0,172,172,172,172
Nevada,69,2023-04-10,43,43,43,0,352,365,364,1,3,0,0,0,138,139,138,139
Orange,69,2023-04-10,508,525,525,0,15066,15596,15595,1,87,8,17,15,8101,8123,8093,8106
Placer,69,2023-04-10,103,105,105,0,1601,1659,1658,1,32,0,0,7,682,682,682,682
Plumas,69,2023-04-10,4,4,4,0,37,38,37,1,0,0,0,0,15,15,15,15
Riverside,69,2023-04-10,399,412,412,0,10939,11323,11322,1,53,1,2,6,6849,6851,6848,6849
Sacramento,69,2023-04-10,443,459,459,0,7721,7993,7992,1,74,4,7,13,3580,3585,3576,3578
San Benito,69,2023-04-10,22,22,22,0,453,470,469,1,2,0,0,0,113,113,113,113
San Bernardino,69,2023-04-10,483,501,501,0,11496,11900,11899,1,71,0,0,11,8133,8133,8133,8133
San Diego,69,2023-04-10,838,869,869,0,20608,21331,21330,1,114,1,2,17,5845,5849,5844,5847
San Francisco,69,2023-04-10,293,303,303,0,6038,6252,6251,1,39,5,10,6,1202,1207,1197,1197
San Joaquin,69,2023-04-10,182,189,189,0,4545,4707,4706,1,22,0,0,10,2438,2439,2438,2439
San Luis Obispo,69,2023-04-10,60,60,60,0,879,913,912,1,3,1,2,1,574,576,573,574
San Mateo,69,2023-04-10,222,230,230,0,5221,5406,5405,1,21,0,0,1,742,742,742,742
Santa Barbara,69,2023-04-10,98,100,100,0,2756,2855,2854,1,16,0,0,3,765,765,765,765
Santa Clara,69,2023-04-10,624,646,646,0,14254,14747,14746,1,95,0,0,14,2754,2755,2754,2755
Santa Cruz,69,2023-04-10,103,106,106,0,1638,1698,1697,1,17,0,0,0,276,276,276,276
Shasta,69,2023-04-10,24,24,24,0,479,497,496,1,3,0,0,1,600,600,600,600
Siskiyou,69,2023-04-10,7,7,7,0,102,106,105,1,0,0,0,0,95,95,95,95
Solano,69,2023-04-10,137,142,142,0,2013,2083,2082,1,20,0,0,2,475,475,475,475
Sonoma,69,2023-04-10,127,133,133,0,1986,2057,2056,1,18,0,0,2,565,567,565,567
Stanislaus,69,2023-04-10,125,130,130,0,2154,2231,2230,1,25,0,0,2,1842,1842,1842,1842
Sutter,69,2023-04-10,30,30,30,0,416,431,430,1,0,0,0,0,238,238,238,238
Tehama,69,2023-04-10,8,8,8,0,173,180,179,1,1,0,0,0,236,236,236,236
Trinity,69,2023-04-10,2,2,2,0,13,14,13,1,0,0,0,0,23,23,23,23
Tulare,69,2023-04-10,90,93,93,0,2350,2434,2433,1,17,0,0,0,1594,1594,1594,1594
Tuolumne,69,2023-04-10,5,5,5,0,193,201,200,1,0,0,0,0,211,211,211,211
Ventura,69,2023-04-10,138,144,144,0,3230,3344,3343,1,22,0,0,0,1699,1701,1699,1701
Yolo,69,2023-04-10,62,63,63,0,879,911,910,1,3,0,0,1,451,451,451,451
Yuba,69,2023-04-10,23,23,23,0,388,404,403,1,3,0,0,0,122,122,122,122
Alameda,70,2023-04-17,552,590,590,0,10687,11400,11399,1,61,1,3,8,2221,2226,2220,2223
Amador,70,2023-04-17,10,10,10,0,192,205,204,1,1,0,0,0,98,98,98,98
Butte,70,2023-04-17,33,34,34,0,443,476,475,1,8,0,0,0,497,498,497,498
Calaveras,70,2023-04-17,7,7,7,0,175,187,186,1,0,0,0,0,143,143,143,143
Colusa,70,2023-04-17,1,1,1,0,44,47,46,1,0,1,6,0,24,29,23,23
Contra Costa,70,2023-04-17,399,427,427,0,7616,8124,8123,1,34,0,0,1,1578,1578,1578,1578
Del Norte,70,2023-04-17,1,1,1,0,104,112,111,1,0,0,0,0,60,60,60,60
El Dorado,70,2023-04-17,42,43,43,0,630,675,674,1,1,0,0,0,246,246,246,246
Fresno,70,2023-04-17,235,251,251,0,6269,6676,6675,1,59,1,3,4,3020,3024,3019,3021
Glenn,70,2023-04-17,7,7,7,0,119,129,128,1,0,0,0,0,53,53,53,53
Humboldt,70,2023-04-17,7,7,7,0,325,345,344,1,1,0,0,0,171,171,171,171
Imperial,70,2023-04-17,168,178,178,0,1175,1255,1254,1,10,0,0,1,981,981,981,981
Inyo,70,2023-04-17,4,4,4,0,121,130,129,1,0,0,0,0,63,63,63,63
Kern,70,2023-04-17,117,125,125,0,4090,4347,4346,1,18,0,0,6,2496,2496,2496,2496
Kings,70,2023-04-17,41,43,43,0,771,821,820,1,1,0,0,0,486,486,486,486
Lake,70,2023-04-17,13,13,13,0,264,282,281,1,1,0,0,0,162,162,162,162
Lassen,70,2023-04-17,2,2,2,0,64,68,67,1,0,0,0,0,64,64,64,64
Los Angeles,70,2023-04-17,2104,2240,2240,0,64905,68594,68593,1,292,17,81,27,35940,36105,35923,36024
Madera,70,2023-04-17,55,59,59,0,835,890,889,1,0,0,0,0,376,376,376,376
Marin,70,2023-04-17,65,70,70,0,944,1007,1006,1,16,0,0,2,317,317,317,317
Mariposa,70,2023-04-17,2,2,2,0,49,52,51,1,0,0,0,0,31,31,31,31
Mendocino,70,2023-04-17,23,23,23,0,309,329,328,1,2,0,0,2,145,145,145,145
Merced,70,2023-04-17,63,67,67,0,754,805,804,1,8,0,0,0,903,903,903,903
Modoc,70,2023-04-17,1,1,1,0,5,6,5,1,1,0,0,0,9,9,9,9
Mono,70,2023-04-17,1,1,1,0,37,38,37,1,0,0,0,0,8,8,8,8
Monterey,70,2023-04-17,41,43,43,0,1489,1595,1594,1,16,0,0,0,811,812,811,812
Napa,70,2023-04-17,30,31,31,0,719,768,767,1,4,0,0,1,172,172,172,172
Nevada,70,2023-04-17,20,20,20,0,313,335,334,1,4,0,0,0,138,139,138,139
Orange,70,2023-04-17,521,555,555,0,15178,16164,16163,1,91,3,9,9,8104,8132,8101,8123
Placer,70,2023-04-17,92,99,99,0,1486,1585,1584,1,45,0,0,4,682,682,682,682
Plumas,70,2023-04-17,4,4,4,0,51,55,54,1,0,0,0,0,15,15,15,15
Riverside,70,2023-04-17,363,385,385,0,11018,11738,11737,1,55,1,5,4,6850,6856,6849,6851
Sacramento,70,2023-04-17,493,525,525,0,7536,8038,8037,1,73,1,5,10,3581,3590,3580,3585
San Benito,70,2023-04-17,15,15,15,0,442,473,472,1,0,0,0,0,113,113,113,113
San Bernardino,70,2023-04-17,439,468,468,0,11094,11829,11828,1,64,0,0,10,8133,8133,8133,8133
San Diego,70,2023-04-17,819,874,874,0,19246,20485,20484,1,115,1,6,13,5846,5855,5845,5849
San Francisco,70,2023-04-17,287,306,306,0,6143,6549,6548,1,44,0,0,8,1202,1207,1202,1207
San Joaquin,70,2023-04-17,175,186,186,0,4375,4673,4672,1,18,0,0,3,2438,2439,2438,2439
San Luis Obispo,70,2023-04-17,58,62,62,0,856,914,913,1,8,0,0,0,574,576,574,576
San Mateo,70,2023-04-17,185,198,198,0,5118,5455,5454,1,18,0,0,4,742,742,742,742
Santa Barbara,70,2023-04-17,123,132,132,0,2728,2906,2905,1,18,0,0,1,765,765,765,765
Santa Clara,70,2023-04-17,543,579,579,0,12777,13626,13625,1,75,0,0,17,2754,2755,2754,2755
Santa Cruz,70,2023-04-17,93,101,101,0,2158,2299,2298,1,21,0,0,0,276,276,276,276
Shasta,70,2023-04-17,23,23,23,0,465,496,495,1,4,0,0,1,600,600,600,600
Siskiyou,70,2023-04-17,6,6,6,0,77,84,83,1,0,0,0,1,95,95,95,95
Solano,70,2023-04-17,164,175,175,0,1942,2071,2070,1,29,0,0,2,475,475,475,475
Sonoma,70,2023-04-17,161,171,171,0,2171,2317,2316,1,31,0,0,3,565,567,565,567
Stanislaus,70,2023-04-17,112,120,120,0,2055,2195,2194,1,27,0,0,5,1842,1842,1842,1842
Sutter,70,2023-04-17,16,16,16,0,274,293,292,1,0,0,0,0,238,238,238,238
Tehama,70,2023-04-17,11,11,11,0,160,172,171,1,3,0,0,0,236,236,236,236
Trinity,70,2023-04-17,1,1,1,0,13,14,13,1,0,0,0,0,23,23,23,23
Tulare,70,2023-04-17,91,97,97,0,2262,2411,2410,1,14,0,0,1,1594,1594,1594,1594
Tuolumne,70,2023-04-17,6,6,6,0,204,218,217,1,0,0,0,0,211,211,211,211
Ventura,70,2023-04-17,115,123,123,0,3316,3531,3530,1,18,0,0,1,1699,1701,1699,1701
Yolo,70,2023-04-17,50,53,53,0,773,826,825,1,3,0,0,0,451,451,451,451
Yuba,70,2023-04-17,15,15,15,0,266,285,284,1,4,0,0,0,122,122,122,122
Alameda,71,2023-04-24,465,1640,1640,0,8446,23046,23045,1,67,0,0,5,2221,2226,2221,2226
Amador,71,2023-04-24,13,34,34,0,160,372,371,1,0,0,0,0,98,98,98,98
Butte,71,2023-04-24,22,56,56,0,334,846,845,1,11,1,9,1,498,507,497,498
Calaveras,71,2023-04-24,7,24,24,0,150,349,348,1,0,0,0,0,143,143,143,143
Colusa,71,2023-04-24,0,0,0,0,30,85,84,1,0,0,0,0,24,29,24,29
Contra Costa,71,2023-04-24,280,892,892,0,6078,16501,16500,1,37,0,0,4,1578,1578,1578,1578
Del Norte,71,2023-04-24,3,18,18,0,84,272,271,1,0,0,0,0,60,60,60,60
El Dorado,71,2023-04-24,29,100,100,0,491,1294,1293,1,5,0,0,1,246,246,246,246
Fresno,71,2023-04-24,186,660,660,0,5191,13374,13373,1,63,0,0,7,3020,3024,3020,3024
Glenn,71,2023-04-24,3,3,3,0,31,72,71,1,0,0,0,0,53,53,53,53
Humboldt,71,2023-04-24,6,9,9,0,222,618,617,1,0,0,0,0,171,171,171,171
Imperial,71,2023-04-24,103,349,349,0,932,2977,2976,1,7,0,0,0,981,981,981,981
Inyo,71,2023-04-24,5,19,19,0,145,339,338,1,0,0,0,0,63,63,63,63
Kern,71,2023-04-24,69,156,156,0,2792,4674,4673,1,16,0,0,4,2496,2496,2496,2496
Kings,71,2023-04-24,22,91,91,0,614,1604,1603,1,1,0,0,0,486,486,486,486
Lake,71,2023-04-24,9,14,14,0,289,923,922,1,0,0,0,1,162,162,162,162
Lassen,71,2023-04-24,0,0,0,0,64,176,175,1,0,0,0,0,64,64,64,64
Los Angeles,71,2023-04-24,1048,1790,1790,0,5045,11772,11771,1,224,8,85,27,35948,36190,35940,36105
Madera,71,2023-04-24,18,52,52,0,645,1556,1555,1,2,0,0,0,376,376,376,376
Marin,71,2023-04-24,58,211,211,0,842,2420,2419,1,11,0,0,1,317,317,317,317
Mariposa,71,2023-04-24,3,3,3,0,44,106,105,1,0,0,0,0,31,31,31,31
Mendocino,71,2023-04-24,9,29,29,0,238,665,664,1,3,0,0,0,145,145,145,145
Merced,71,2023-04-24,39,96,96,0,566,1282,1281,1,7,0,0,0,903,903,903,903
Modoc,71,2023-04-24,2,2,2,0,7,9,8,1,0,0,0,0,9,9,9,9
Mono,71,2023-04-24,2,16,16,0,39,115,114,1,0,0,0,0,8,8,8,8
Monterey,71,2023-04-24,40,112,112,0,1054,3113,3112,1,14,0,0,2,811,812,811,812
Napa,71,2023-04-24,22,88,88,0,531,1727,1726,1,4,0,0,1,172,172,172,172
Nevada,71,2023-04-24,18,47,47,0,214,344,343,1,1,0,0,1,138,139,138,139
Orange,71,2023-04-24,445,972,972,0,11776,28219,28218,1,88,0,0,11,8104,8132,8104,8132
Placer,71,2023-04-24,88,261,261,0,1237,3768,3767,1,33,0,0,2,682,682,682,682
Plumas,71,2023-04-24,3,31,31,0,72,257,256,1,1,0,0,0,15,15,15,15
Riverside,71,2023-04-24,240,510,510,0,8486,15941,15940,1,49,0,0,5,6850,6856,6850,6856
Sacramento,71,2023-04-24,408,1307,1307,0,6005,16120,16119,1,64,0,0,10,3581,3590,3581,3590
San Benito,71,2023-04-24,9,57,57,0,330,1124,1123,1,1,0,0,0,113,113,113,113
San Bernardino,71,2023-04-24,263,497,497,0,7960,15406,15405,1,132,0,0,15,8133,8133,8133,8133
San Diego,71,2023-04-24,555,1293,1293,0,14438,33164,33163,1,95,2,18,10,5848,5873,5846,5855
San Francisco,71,2023-04-24,284,903,903,0,4850,13473,13472,1,63,0,0,6,1202,1207,1202,1207
San Joaquin,71,2023-04-24,115,317,317,0,3313,8128,8127,1,18,0,0,1,2438,2439,2438,2439
San Luis Obispo,71,2023-04-24,30,66,66,0,657,1586,1585,1,10,0,0,0,574,576,574,576
San Mateo,71,2023-04-24,150,388,388,0,3764,9109,9108,1,19,0,0,1,742,742,742,742
Santa Barbara,71,2023-04-24,78,197,197,0,2503,5749,5748,1,11,0,0,2,765,765,765,765
Santa Clara,71,2023-04-24,433,1605,1605,0,10096,24899,24898,1,82,0,0,17,2754,2755,2754,2755
Santa Cruz,71,2023-04-24,42,68,68,0,1121,2111,2110,1,24,0,0,1,276,276,276,276
Shasta,71,2023-04-24,8,10,10,0,277,466,465,1,2,0,0,0,600,600,600,600
Siskiyou,71,2023-04-24,5,20,20,0,81,161,160,1,3,0,0,0,95,95,95,95
Solano,71,2023-04-24,120,375,375,0,1739,5444,5443,1,18,0,0,6,475,475,475,475
Sonoma,71,2023-04-24,132,452,452,0,1812,5288,5287,1,29,0,0,2,565,567,565,567
Stanislaus,71,2023-04-24,90,306,306,0,1826,5419,5418,1,22,0,0,2,1842,1842,1842,1842
Sutter,71,2023-04-24,25,51,51,0,259,837,836,1,0,0,0,0,238,238,238,238
Tehama,71,2023-04-24,1,1,1,0,92,185,184,1,0,0,0,0,236,236,236,236
Trinity,71,2023-04-24,1,1,1,0,11,16,15,1,0,0,0,0,23,23,23,23
Tulare,71,2023-04-24,53,238,238,0,1535,3557,3556,1,17,0,0,0,1594,1594,1594,1594
Tuolumne,71,2023-04-24,3,8,8,0,135,380,379,1,0,0,0,0,211,211,211,211
Ventura,71,2023-04-24,103,315,315,0,2637,6522,6521,1,18,0,0,2,1699,1701,1699,1701
Yolo,71,2023-04-24,25,81,81,0,682,1712,1711,1,1,0,0,0,451,451,451,451
Yuba,71,2023-04-24,13,64,64,0,234,650,649,1,5,0,0,0,122,122,122,122
California,1,2021-12-20,84323,84323,47200,37123,2163203,2163222,1234297,928925,2585,503,503,932,77358,77358,76855,76855
California,2,2021-12-27,241987,241988,151945,90043,1954054,1954072,1192476,761596,3348,496,496,1030,77854,77854,77358,77358
California,3,2022-01-03,549872,549877,369458,180419,2956101,2956143,1966315,989828,6125,592,592,1280,78446,78446,77854,77854
California,4,2022-01-10,867541,867549,620022,247527,4665954,4666061,3353552,1312509,10002,946,946,1813,79392,79392,78446,78446
California,5,2022-01-17,661980,661986,493228,168758,3983777,3983889,3022093,961796,12343,1432,1432,2311,80824,80824,79392,79392
California,6,2022-01-24,527380,527385,412560,114825,3988770,3988904,3193283,795621,12648,1778,1778,2600,82602,82602,80824,80824
California,7,2022-01-31,270319,270322,219690,50632,3154749,3154859,2635973,518886,10873,1907,1907,2494,84509,84509,82602,82602
California,8,2022-02-07,149322,149322,125786,23536,2670194,2670281,2318122,352159,8405,1779,1779,2007,86288,86288,84509,84509
California,9,2022-02-14,85818,85818,74808,11010,2322827,2322912,2079725,243187,6407,1435,1435,1564,87723,87723,86288,86288
California,10,2022-02-21,48085,48085,43057,5028,1850752,1850826,1692071,158755,4557,1006,1006,1098,88729,88729,87723,87723
California,11,2022-02-28,32657,32657,29949,2708,2098627,2098748,1961825,136923,3357,695,695,772,89424,89424,88729,88729
California,12,2022-03-07,22984,22984,21478,1506,1819520,1819639,1725053,94586,2435,501,501,581,89925,89925,89424,89424
California,13,2022-03-14,16977,16977,16100,877,1725410,1725535,1655198,70337,1844,359,359,419,90284,90284,89925,89925
California,14,2022-03-21,14641,14641,14058,583,1646367,1646511,1593806,52705,1537,253,253,313,90537,90537,90284,90284
California,15,2022-03-28,15471,15471,14990,481,1463265,1463418,1425819,37599,1150,180,180,264,90717,90717,90537,90537
California,16,2022-04-04,17681,17681,17264,417,1525053,1525231,1495696,29535,943,141,141,211,90858,90858,90717,90717
California,17,2022-04-11,21519,21519,21126,393,1343281,1343454,1322609,20845,905,125,125,148,90983,90983,90858,90858
California,18,2022-04-18,26877,26877,26488,389,1131670,1131877,1116988,14889,823,111,111,141,91094,91094,90983,90983
California,19,2022-04-25,37248,37249,36821,428,1622615,1622999,1608143,14856,838,92,92,112,91186,91186,91094,91094
California,20,2022-05-02,48953,48958,48523,435,1701788,1702310,1690078,12232,950,85,85,143,91271,91271,91186,91186
California,21,2022-05-09,63359,63368,62923,445,1770509,1771233,1761195,10038,1050,87,87,153,91358,91358,91271,91271
California,22,2022-05-16,80351,80375,79923,452,1840109,1841050,1832797,8253,1345,120,120,182,91478,91478,91358,91358
California,23,2022-05-23,97929,97965,97544,421,1870620,1871734,1865137,6597,1714,117,117,217,91595,91595,91478,91478
California,24,2022-05-30,90570,90612,90302,310,1499231,1500243,1495993,4250,1918,152,152,272,91747,91747,91595,91595
California,25,2022-06-06,120600,120671,120353,318,1939288,1940743,1936647,4096,2305,138,138,276,91885,91885,91747,91747
California,26,2022-06-13,105296,105364,105147,217,1406799,1407970,1405487,2483,2471,182,182,291,92067,92067,91885,91885
California,27,2022-06-20,101453,101528,101367,161,1026832,1027801,1026211,1590,2552,209,209,310,92276,92276,92067,92067
California,28,2022-06-27,115563,115662,115524,138,1044032,1045115,1043863,1252,3006,221,221,339,92497,92497,92276,92276
California,29,2022-07-04,108341,108436,108334,102,837045,837959,837153,806,3167,271,271,393,92768,92768,92497,92497
California,30,2022-07-11,141425,141568,141469,99,1082612,1083877,1083086,791,3824,298,298,453,93066,93066,92768,92768
California,31,2022-07-18,129820,129954,129881,73,993077,994282,993718,564,4148,297,297,528,93363,93363,93066,93066
California,32,2022-07-25,117710,117833,117785,48,948717,949903,949479,424,4310,360,360,516,93723,93723,93363,93363
California,33,2022-08-01,99347,99449,99416,33,875801,876932,876619,313,4119,362,362,535,94085,94085,93723,93723
California,34,2022-08-08,83523,83612,83592,20,825486,826588,826356,232,3754,336,336,474,94421,94421,94085,94085
California,35,2022-08-15,69112,69182,69170,12,794451,795556,795374,182,3363,299,299,448,94720,94720,94421,94421
California,36,2022-08-22,61523,61587,61581,6,778761,779910,779764,146,3087,289,289,418,95009,95009,94720,94720
California,37,2022-08-29,51896,51952,51949,3,769189,770364,770243,121,2752,219,219,351,95228,95228,95009,95009
California,38,2022-09-05,36779,36815,36815,0,631197,632191,632102,89,2525,247,247,350,95475,95475,95228,95228
California,39,2022-09-12,36473,36507,36507,0,755943,757178,757093,85,2422,223,223,346,95698,95698,95475,95475
California,40,2022-09-19,27822,27843,27843,0,690164,691322,691251,71,2041,182,182,272,95880,95880,95698,95698
California,41,2022-09-26,25510,25529,25529,0,641828,642935,642871,64,1818,167,167,230,96047,96047,95880,95880
California,42,2022-10-03,23487,23503,23503,0,588040,589088,589028,60,1647,149,149,247,96196,96196,96047,96047
California,43,2022-10-10,23544,23561,23561,0,628765,629920,629862,58,1537,155,155,228,96333,96333,96178,96178
California,44,2022-10-17,18803,18815,18815,0,524201,525209,525152,57,1397,121,121,218,96454,96454,96333,96333
California,45,2022-10-24,18673,18688,18688,0,514481,515530,515473,57,1324,120,120,190,96574,96574,96454,96454
California,46,2022-10-31,20812,20831,20831,0,523945,525059,525002,57,1401,113,113,191,96687,96687,96574,96574
California,47,2022-11-07,27032,27066,27066,0,548748,549967,549910,57,1525,134,134,231,96821,96821,96687,96687
California,48,2022-11-14,30995,31046,31046,0,550592,551865,551808,57,1775,115,115,260,96936,96936,96821,96821
California,49,2022-11-21,40444,40524,40524,0,576707,578115,578058,57,2268,153,153,330,97089,97089,96936,96936
California,50,2022-11-28,54566,54674,54674,0,518686,520042,519985,57,3153,208,208,379,97297,97297,97089,97089
California,51,2022-12-05,66439,66596,66596,0,659446,661262,661204,58,3715,244,244,493,97541,97541,97297,97297
California,52,2022-12-12,56897,57038,57038,0,621754,623605,623547,58,3944,351,351,527,97892,97892,97541,97541
California,53,2022-12-19,51136,51274,51274,0,575544,577375,577318,57,3997,326,326,523,98218,98218,97892,97892
California,54,2022-12-26,45775,45915,45915,0,421111,422589,422532,57,3906,408,408,510,98626,98626,98218,98218
California,55,2023-01-02,45418,45580,45580,0,425414,427110,427053,57,4077,362,362,528,98988,98988,98626,98626
California,56,2023-01-09,33923,34043,34043,0,507638,509877,509820,57,3672,343,343,487,99331,99331,98988,98988
California,57,2023-01-16,20384,20458,20458,0,411119,413146,413089,57,3075,324,325,425,99655,99656,99331,99331
California,58,2023-01-23,18527,18602,18602,0,453536,455955,455898,57,2400,244,245,369,99899,99901,99655,99656
California,59,2023-01-30,19436,19531,19531,0,420014,422592,422535,57,2214,215,220,266,100114,100121,99899,99901
California,60,2023-02-06,21406,21528,21528,0,405324,408267,408210,57,2231,174,179,280,100288,100300,100114,100121
California,61,2023-02-13,21396,21549,21549,0,385407,388652,388596,56,2223,153,157,287,100441,100457,100288,100300
California,62,2023-02-20,19771,19942,19942,0,346081,349477,349421,56,2159,171,177,292,100612,100634,100441,100457
California,63,2023-02-27,19966,20165,20165,0,382376,386678,386621,57,2220,160,168,310,100772,100802,100612,100634
California,64,2023-03-06,17331,17523,17523,0,348414,352845,352789,56,2074,151,159,262,100923,100961,100772,100802
California,65,2023-03-13,15533,15735,15735,0,333804,338636,338580,56,1939,158,172,278,101081,101133,100923,100961
California,66,2023-03-20,12432,12616,12616,0,305345,310443,310387,56,1701,127,139,237,101208,101272,101081,101133
California,67,2023-03-27,10263,10444,10444,0,285775,291474,291418,56,1498,83,101,196,101291,101373,101208,101272
California,68,2023-04-03,10064,10293,10293,0,266762,273513,273457,56,1363,78,108,176,101369,101481,101291,101373
California,69,2023-04-10,9622,9952,9952,0,245786,254491,254435,56,1312,44,87,173,101413,101568,101369,101481
California,70,2023-04-17,9025,9606,9606,0,217632,231400,231344,56,1316,26,118,149,101439,101686,101413,101568
California,71,2023-04-24,6203,16905,16905,0,123206,300322,300266,56,1278,11,112,148,101450,101798,101439,101686
