county,time,date,cases,est_cases,est_omicron_cases,est_other_cases,tests,est_tests,est_omicron_tests,est_other_tests,hospitalizations,deaths,est_deaths,icu,cum_deaths,cum_est_deaths,prev_cum_deaths,prev_cum_est_deaths
Alameda,1,2021-12-21,3656,3656,1777,1879,90631,90633,43422,47211,47,10,10,15,1550,1550,1540,1540
Amador,1,2021-12-21,59,59,22,37,1680,1680,607,1073,3,0,0,2,70,70,70,70
Butte,1,2021-12-21,231,231,124,107,4367,4367,2326,2041,22,5,5,4,361,361,356,356
Calaveras,1,2021-12-21,62,62,25,37,1492,1492,583,909,1,2,2,0,92,92,90,90
Colusa,1,2021-12-21,9,9,4,5,407,407,177,230,2,0,0,0,21,21,21,21
Contra Costa,1,2021-12-21,2065,2065,742,1323,44532,44532,15755,28777,31,2,2,7,1080,1080,1078,1078
Del Norte,1,2021-12-21,17,17,7,10,1361,1361,576,785,0,0,0,0,42,42,42,42
El Dorado,1,2021-12-21,275,275,110,165,4616,4616,1833,2783,4,3,3,2,179,179,176,176
Fresno,1,2021-12-21,1148,1148,424,724,24675,24675,9046,15629,126,20,20,46,2423,2423,2403,2403
Glenn,1,2021-12-21,22,22,9,13,483,483,197,286,0,0,0,0,41,41,41,41
Humboldt,1,2021-12-21,177,177,75,102,3777,3777,1571,2206,13,1,1,1,121,121,120,120
Imperial,1,2021-12-21,616,616,243,373,5708,5708,2241,3467,41,9,9,28,818,818,809,809
Inyo,1,2021-12-21,33,33,15,18,375,375,165,210,2,1,1,0,49,49,48,48
Kern,1,2021-12-21,1000,1000,442,558,25041,25041,10994,14047,82,24,24,28,2026,2026,2002,2002
Kings,1,2021-12-21,243,243,96,147,6691,6691,2634,4057,13,6,6,3,389,389,383,383
Lake,1,2021-12-21,40,40,14,26,1264,1264,459,805,0,0,0,0,116,116,116,116
Lassen,1,2021-12-21,12,12,6,6,2416,2416,1125,1291,1,0,0,0,54,54,54,54
Los Angeles,1,2021-12-21,40343,40343,28438,11905,944114,944145,655654,288491,604,110,110,166,27388,27388,27278,27278
Madera,1,2021-12-21,159,159,58,101,5536,5536,2008,3528,8,2,2,6,335,335,333,333
Marin,1,2021-12-21,721,721,275,446,12773,12773,4785,7988,6,1,1,1,256,256,255,255
Mariposa,1,2021-12-21,28,28,10,18,504,504,180,324,0,0,0,0,21,21,21,21
Mendocino,1,2021-12-21,90,90,27,63,2807,2807,856,1951,2,2,2,3,103,103,101,101
Merced,1,2021-12-21,340,340,148,192,5489,5489,2374,3115,11,6,6,12,694,694,688,688
Modoc,1,2021-12-21,4,4,2,2,72,72,32,40,3,0,0,0,6,6,6,6
Mono,1,2021-12-21,53,53,15,38,442,442,119,323,1,0,0,0,4,4,4,4
Monterey,1,2021-12-21,526,526,141,385,13365,13365,3561,9804,19,3,3,8,643,643,640,640
Napa,1,2021-12-21,301,301,142,159,5220,5220,2416,2804,2,1,1,2,108,108,107,107
Nevada,1,2021-12-21,182,182,68,114,3032,3032,1123,1909,3,0,0,2,110,110,110,110
Orange,1,2021-12-21,6004,6004,3031,2973,104735,104740,52159,52581,158,28,28,57,6023,6023,5995,5995
Placer,1,2021-12-21,626,626,220,406,11473,11473,3980,7493,54,5,5,24,501,501,496,496
Plumas,1,2021-12-21,15,15,6,9,507,507,198,309,0,0,0,0,12,12,12,12
Riverside,1,2021-12-21,6475,6475,2777,3698,81323,81325,34542,46783,253,39,39,83,5585,5585,5546,5546
Sacramento,1,2021-12-21,2440,2440,1000,1440,53423,53423,21699,31724,112,23,23,39,2492,2492,2469,2469
San Benito,1,2021-12-21,127,127,59,68,2004,2004,920,1084,2,4,4,2,82,82,78,78
San Bernardino,1,2021-12-21,5971,5971,2889,3082,83894,83896,40138,43758,289,69,69,116,6520,6520,6451,6451
San Diego,1,2021-12-21,11093,11093,7689,3404,159752,159757,109988,49769,263,30,30,100,4484,4484,4454,4454
San Francisco,1,2021-12-21,3777,3777,966,2811,61073,61073,15289,45784,25,3,3,12,693,693,690,690
San Joaquin,1,2021-12-21,1079,1079,417,662,23835,23835,9127,14708,47,14,14,22,1976,1976,1962,1962
San Luis Obispo,1,2021-12-21,490,490,221,269,10627,10627,4749,5878,11,2,2,6,371,371,369,369
San Mateo,1,2021-12-21,1949,1949,984,965,51399,51399,25496,25903,9,1,1,5,602,602,601,601
Santa Barbara,1,2021-12-21,913,913,386,527,15948,15948,6657,9291,19,7,7,13,570,570,563,563
Santa Clara,1,2021-12-21,3646,3646,2482,1164,116100,116105,78120,37985,76,9,9,43,1980,1980,1971,1971
Santa Cruz,1,2021-12-21,430,430,198,232,17074,17074,7756,9318,9,1,1,5,230,230,229,229
Shasta,1,2021-12-21,163,163,67,96,5595,5595,2289,3306,27,6,6,8,449,449,443,443
Siskiyou,1,2021-12-21,17,17,8,9,360,360,170,190,2,2,2,0,63,63,61,61
Solano,1,2021-12-21,549,549,235,314,14654,14654,6217,8437,19,2,2,7,389,389,387,387
Sonoma,1,2021-12-21,848,848,369,479,20359,20359,8754,11605,19,1,1,4,420,420,419,419
Stanislaus,1,2021-12-21,679,679,219,460,12209,12209,3908,8301,87,15,15,23,1436,1436,1421,1421
Sutter,1,2021-12-21,139,139,59,80,2228,2228,937,1291,0,1,1,0,193,193,192,192
Tehama,1,2021-12-21,48,48,16,32,1311,1311,433,878,6,0,0,3,165,165,165,165
Trinity,1,2021-12-21,1,1,0,1,107,107,35,72,0,1,1,0,19,19,18,18
Tulare,1,2021-12-21,440,440,140,300,12168,12168,3868,8300,36,18,18,10,1308,1308,1290,1290
Tuolumne,1,2021-12-21,100,100,37,63,1992,1992,730,1262,8,0,0,0,150,150,150,150
Ventura,1,2021-12-21,2328,2328,1219,1109,38438,38438,19874,18564,63,11,11,14,1218,1218,1207,1207
Yolo,1,2021-12-21,371,371,169,202,24395,24395,10962,13433,4,1,1,1,296,296,295,295
Yuba,1,2021-12-21,98,98,43,55,1878,1878,821,1057,7,0,0,4,102,102,102,102
Alameda,2,2021-12-28,9228,9228,5059,4169,90331,90335,48980,41355,106,11,11,15,1561,1561,1550,1550
Amador,2,2021-12-28,106,106,45,61,1450,1450,610,840,2,0,0,3,70,70,70,70
Butte,2,2021-12-28,614,614,368,246,4737,4737,2825,1912,32,1,1,3,362,362,361,361
Calaveras,2,2021-12-28,115,115,53,62,1002,1002,459,543,1,1,1,1,93,93,92,92
Colusa,2,2021-12-28,37,37,19,18,256,256,128,128,2,0,0,0,21,21,21,21
Contra Costa,2,2021-12-28,6776,6776,2854,3922,49452,49452,20479,28973,36,4,4,20,1084,1084,1080,1080
Del Norte,2,2021-12-28,32,32,16,16,1561,1561,763,798,0,0,0,1,42,42,42,42
El Dorado,2,2021-12-28,611,611,283,328,4372,4372,2006,2366,7,1,1,4,180,180,179,179
Fresno,2,2021-12-28,2935,2935,1278,1657,26504,26504,11402,15102,124,13,13,42,2436,2436,2423,2423
Glenn,2,2021-12-28,55,55,26,29,464,464,218,246,0,1,1,0,42,42,41,41
Humboldt,2,2021-12-28,573,573,277,296,3631,3631,1747,1884,9,1,1,0,122,122,121,121
Imperial,2,2021-12-28,1006,1006,463,543,6318,6318,2886,3432,32,11,11,26,829,829,818,818
Inyo,2,2021-12-28,135,135,68,67,476,476,238,238,0,1,1,0,50,50,49,49
Kern,2,2021-12-28,2439,2439,1247,1192,24301,24301,12334,11967,77,17,17,37,2043,2043,2026,2026
Kings,2,2021-12-28,615,615,284,331,6085,6085,2802,3283,20,1,1,3,390,390,389,389
Lake,2,2021-12-28,85,85,37,48,1211,1211,511,700,0,1,1,0,117,117,116,116
Lassen,2,2021-12-28,25,25,13,12,2380,2380,1256,1124,1,0,0,0,54,54,54,54
Los Angeles,2,2021-12-28,121007,121011,91254,29757,771008,771040,578283,192757,1053,121,121,198,27509,27509,27388,27388
Madera,2,2021-12-28,431,431,186,245,4731,4731,2030,2701,5,1,1,3,336,336,335,335
Marin,2,2021-12-28,1781,1781,780,1001,17304,17304,7499,9805,6,0,0,1,256,256,256,256
Mariposa,2,2021-12-28,42,42,18,24,495,495,203,292,0,0,0,0,21,21,21,21
Mendocino,2,2021-12-28,207,207,76,131,2582,2582,932,1650,4,0,0,2,103,103,103,103
Merced,2,2021-12-28,828,828,416,412,5713,5713,2849,2864,11,7,7,9,701,701,694,694
Modoc,2,2021-12-28,5,5,3,2,37,37,19,18,1,0,0,0,6,6,6,6
Mono,2,2021-12-28,163,163,53,110,414,414,134,280,1,0,0,0,4,4,4,4
Monterey,2,2021-12-28,1213,1213,393,820,13915,13915,4452,9463,17,3,3,11,646,646,643,643
Napa,2,2021-12-28,993,993,529,464,7711,7711,4081,3630,6,0,0,1,108,108,108,108
Nevada,2,2021-12-28,265,265,115,150,1733,1733,736,997,2,1,1,0,111,111,110,110
Orange,2,2021-12-28,23911,23911,13601,10310,148111,148117,83554,64563,304,32,32,72,6055,6055,6023,6023
Placer,2,2021-12-28,1498,1498,616,882,11639,11639,4754,6885,67,4,4,26,505,505,501,501
Plumas,2,2021-12-28,17,17,8,9,305,305,137,168,0,0,0,0,12,12,12,12
Riverside,2,2021-12-28,16816,16816,8295,8521,96582,96586,47320,49266,345,54,54,86,5639,5639,5585,5585
Sacramento,2,2021-12-28,6661,6661,3171,3490,56777,56779,26735,30044,145,22,22,44,2514,2514,2492,2492
San Benito,2,2021-12-28,391,391,206,185,2449,2449,1278,1171,0,2,2,3,84,84,82,82
San Bernardino,2,2021-12-28,18849,18849,10351,8498,96282,96286,52305,43981,385,67,67,139,6587,6587,6520,6520
San Diego,2,2021-12-28,34098,34098,25380,8718,189392,189399,140220,49179,325,30,30,102,4514,4514,4484,4484
San Francisco,2,2021-12-28,7549,7549,2287,5262,68406,68409,20482,47927,43,2,2,11,695,695,693,693
San Joaquin,2,2021-12-28,3031,3031,1371,1660,24711,24711,11062,13649,66,11,11,23,1987,1987,1976,1976
San Luis Obispo,2,2021-12-28,1484,1484,767,717,12184,12184,6239,5945,17,1,1,7,372,372,371,371
San Mateo,2,2021-12-28,6262,6262,3539,2723,58808,58809,32912,25897,19,1,1,6,603,603,602,602
Santa Barbara,2,2021-12-28,2716,2716,1325,1391,17133,17133,8289,8844,37,6,6,9,576,576,570,570
Santa Clara,2,2021-12-28,11097,11097,8127,2970,112758,112762,82078,30684,97,10,10,40,1990,1990,1980,1980
Santa Cruz,2,2021-12-28,1156,1156,609,547,12837,12837,6687,6150,10,1,1,2,231,231,230,230
Shasta,2,2021-12-28,303,303,144,159,4662,4662,2206,2456,30,4,4,15,453,453,449,449
Siskiyou,2,2021-12-28,29,29,16,13,389,389,209,180,0,0,0,0,63,63,63,63
Solano,2,2021-12-28,1906,1906,945,961,19014,19014,9285,9729,25,6,6,6,395,395,389,389
Sonoma,2,2021-12-28,2298,2298,1145,1153,22890,22890,11317,11573,20,2,2,5,422,422,420,420
Stanislaus,2,2021-12-28,1578,1578,607,971,12460,12460,4758,7702,92,14,14,17,1450,1450,1436,1436
Sutter,2,2021-12-28,259,259,126,133,2224,2224,1077,1147,0,2,2,0,195,195,193,193
Tehama,2,2021-12-28,111,111,44,67,1123,1123,439,684,4,2,2,3,167,167,165,165
Trinity,2,2021-12-28,4,4,2,2,85,85,33,52,0,0,0,0,19,19,19,19
Tulare,2,2021-12-28,991,991,377,614,12064,12064,4566,7498,39,9,9,9,1317,1317,1308,1308
Tuolumne,2,2021-12-28,195,195,84,111,1660,1660,708,952,8,0,0,1,150,150,150,150
Ventura,2,2021-12-28,7298,7298,4292,3006,43947,43947,25646,18301,77,7,7,17,1225,1225,1218,1218
Yolo,2,2021-12-28,1016,1016,530,486,23456,23456,12073,11383,10,0,0,3,296,296,296,296
Yuba,2,2021-12-28,209,209,106,103,1631,1631,820,811,7,1,1,6,103,103,102,102
Alameda,3,2022-01-04,21108,21108,12805,8303,133457,133462,80871,52591,164,6,6,35,1567,1567,1561,1561
Amador,3,2022-01-04,252,252,123,129,2493,2493,1207,1286,5,1,1,2,71,71,70,70
Butte,3,2022-01-04,1368,1368,898,470,7734,7734,5069,2665,35,0,0,5,362,362,362,362
Calaveras,3,2022-01-04,268,268,141,127,1683,1683,884,799,1,2,2,2,95,95,93,93
Colusa,3,2022-01-04,47,47,26,21,465,465,263,202,5,0,0,0,21,21,21,21
Contra Costa,3,2022-01-04,14797,14797,7062,7735,75392,75396,35933,39463,98,9,9,21,1093,1093,1084,1084
Del Norte,3,2022-01-04,97,97,53,44,2177,2177,1190,987,0,0,0,0,42,42,42,42
El Dorado,3,2022-01-04,1517,1517,794,723,6652,6652,3471,3181,9,5,5,6,185,185,180,180
Fresno,3,2022-01-04,7838,7838,3870,3968,41758,41758,20500,21258,185,19,19,47,2455,2455,2436,2436
Glenn,3,2022-01-04,100,100,53,47,639,639,339,300,0,1,1,0,43,43,42,42
Humboldt,3,2022-01-04,977,977,532,445,5777,5777,3134,2643,12,2,2,4,124,124,122,122
Imperial,3,2022-01-04,2269,2269,1182,1087,10158,10158,5265,4893,38,16,16,28,845,845,829,829
Inyo,3,2022-01-04,305,305,172,133,788,788,443,345,3,1,1,0,51,51,50,50
Kern,3,2022-01-04,7182,7182,4106,3076,40383,40384,23025,17359,111,15,15,33,2058,2058,2043,2043
Kings,3,2022-01-04,1269,1269,665,604,9093,9093,4743,4350,16,3,3,3,393,393,390,390
Lake,3,2022-01-04,299,299,148,151,2131,2131,1042,1089,2,0,0,1,117,117,117,117
Lassen,3,2022-01-04,73,73,43,30,3180,3180,1872,1308,1,0,0,0,54,54,54,54
Los Angeles,3,2022-01-04,228660,228669,181915,46754,1239301,1239355,986303,253052,2131,158,158,330,27667,27667,27509,27509
Madera,3,2022-01-04,1005,1005,495,510,7509,7509,3692,3817,17,3,3,6,339,339,336,336
Marin,3,2022-01-04,2569,2569,1279,1290,18319,18319,9076,9243,18,1,1,2,257,257,256,256
Mariposa,3,2022-01-04,130,130,63,67,745,745,356,389,0,1,1,0,22,22,21,21
Mendocino,3,2022-01-04,535,535,227,308,3961,3961,1671,2290,6,1,1,2,104,104,103,103
Merced,3,2022-01-04,1954,1954,1100,854,9606,9606,5378,4228,21,10,10,12,711,711,701,701
Modoc,3,2022-01-04,16,16,9,7,85,85,49,36,0,0,0,0,6,6,6,6
Mono,3,2022-01-04,195,195,75,120,521,521,201,320,1,0,0,0,4,4,4,4
Monterey,3,2022-01-04,2992,2992,1136,1856,23902,23902,9049,14853,40,5,5,10,651,651,646,646
Napa,3,2022-01-04,2096,2096,1239,857,12578,12578,7412,5166,11,1,1,4,109,109,108,108
Nevada,3,2022-01-04,742,742,367,375,3586,3586,1772,1814,9,2,2,2,113,113,111,111
Orange,3,2022-01-04,49167,49167,30609,18558,239923,239934,149327,90607,557,46,46,116,6101,6101,6055,6055
Placer,3,2022-01-04,3344,3344,1571,1773,16261,16261,7624,8637,108,13,13,23,518,518,505,505
Plumas,3,2022-01-04,72,72,37,35,568,568,292,276,1,0,0,0,12,12,12,12
Riverside,3,2022-01-04,35949,35949,19833,16116,147658,147664,81244,66420,605,57,57,108,5696,5696,5639,5639
Sacramento,3,2022-01-04,17293,17293,9263,8030,90331,90335,48180,42155,236,28,28,55,2542,2542,2514,2514
San Benito,3,2022-01-04,782,782,455,327,3625,3625,2109,1516,3,1,1,2,85,85,84,84
San Bernardino,3,2022-01-04,36734,36734,22187,14547,144126,144131,86852,57279,581,97,97,162,6684,6684,6587,6587
San Diego,3,2022-01-04,66969,66971,52604,14367,272108,272120,213680,58440,576,39,39,141,4553,4553,4514,4514
San Francisco,3,2022-01-04,12495,12495,4472,8023,91145,91149,32480,58669,91,5,5,23,700,700,695,695
San Joaquin,3,2022-01-04,8374,8374,4279,4095,42848,42849,21869,20980,94,14,14,25,2001,2001,1987,1987
San Luis Obispo,3,2022-01-04,2838,2838,1631,1207,16663,16663,9534,7129,23,5,5,7,377,377,372,372
San Mateo,3,2022-01-04,11819,11819,7364,4455,89490,89494,55707,33787,41,4,4,6,607,607,603,603
Santa Barbara,3,2022-01-04,6003,6003,3284,2719,31404,31404,17168,14236,55,5,5,9,581,581,576,576
Santa Clara,3,2022-01-04,26124,26124,20286,5838,190182,190190,147623,42567,226,10,10,60,2000,2000,1990,1990
Santa Cruz,3,2022-01-04,2927,2927,1719,1208,26680,26680,15707,10973,13,4,4,3,235,235,231,231
Shasta,3,2022-01-04,720,720,388,332,6676,6676,3575,3101,38,2,2,14,455,455,453,453
Siskiyou,3,2022-01-04,92,92,55,37,671,671,403,268,1,1,1,1,64,64,63,63
Solano,3,2022-01-04,4641,4641,2552,2089,28428,28428,15608,12820,54,2,2,9,397,397,395,395
Sonoma,3,2022-01-04,5663,5663,3166,2497,36582,36582,20408,16174,28,9,9,6,431,431,422,422
Stanislaus,3,2022-01-04,3873,3873,1714,2159,19952,19952,8803,11149,131,10,10,18,1460,1460,1450,1450
Sutter,3,2022-01-04,648,648,357,291,3474,3474,1905,1569,0,2,2,0,197,197,195,195
Tehama,3,2022-01-04,274,274,125,149,1682,1682,766,916,3,1,1,2,168,168,167,167
Trinity,3,2022-01-04,19,19,8,11,141,141,63,78,0,0,0,0,19,19,19,19
Tulare,3,2022-01-04,2569,2569,1129,1440,16648,16648,7266,9382,60,5,5,7,1322,1322,1317,1317
Tuolumne,3,2022-01-04,482,482,239,243,2902,2902,1431,1471,12,3,3,1,153,153,150,150
Ventura,3,2022-01-04,13753,13753,8824,4929,65917,65919,42302,23617,142,11,11,27,1236,1236,1225,1225
Yolo,3,2022-01-04,2708,2708,1573,1135,34517,34517,19969,14548,8,4,4,4,300,300,296,296
Yuba,3,2022-01-04,545,545,308,237,2577,2577,1455,1122,16,1,1,6,104,104,103,103
Alameda,4,2022-01-11,30133,30133,19829,10304,192147,192156,126647,65509,280,16,16,45,1583,1583,1567,1567
Amador,4,2022-01-11,432,432,236,196,3309,3309,1816,1493,5,1,1,4,72,72,71,71
Butte,4,2022-01-11,2040,2040,1440,600,10381,10381,7326,3055,58,2,2,5,364,364,362,362
Calaveras,4,2022-01-11,560,560,325,235,2460,2460,1424,1036,0,0,0,2,95,95,95,95
Colusa,4,2022-01-11,125,125,78,47,724,724,449,275,4,0,0,0,21,21,21,21
Contra Costa,4,2022-01-11,19193,19193,10245,8948,100408,100413,53627,46786,179,15,15,27,1108,1108,1093,1093
Del Norte,4,2022-01-11,180,180,109,71,4311,4311,2608,1703,4,0,0,0,42,42,42,42
El Dorado,4,2022-01-11,2365,2365,1375,990,9577,9577,5559,4018,13,4,4,3,189,189,185,185
Fresno,4,2022-01-11,15511,15511,8558,6953,61998,62000,34154,27846,301,12,12,55,2467,2467,2455,2455
Glenn,4,2022-01-11,249,249,147,102,1020,1020,601,419,2,0,0,0,43,43,43,43
Humboldt,4,2022-01-11,1432,1432,859,573,8732,8732,5239,3493,16,4,4,2,128,128,124,124
Imperial,4,2022-01-11,3720,3720,2144,1576,14023,14023,8075,5948,62,7,7,24,852,852,845,845
Inyo,4,2022-01-11,394,394,243,151,1381,1381,852,529,4,1,1,0,52,52,51,51
Kern,4,2022-01-11,12517,12517,7834,4683,58955,58957,36891,22066,193,30,30,40,2088,2088,2058,2058
Kings,4,2022-01-11,2711,2711,1581,1130,13576,13576,7891,5685,34,1,1,2,394,394,393,393
Lake,4,2022-01-11,486,486,267,219,2687,2687,1470,1217,1,3,3,1,120,120,117,117
Lassen,4,2022-01-11,216,216,140,76,3496,3496,2254,1242,1,0,0,0,54,54,54,54
Los Angeles,4,2022-01-11,313804,313817,260116,53701,1916501,1916587,1590088,326499,3376,305,305,536,27972,27972,27667,27667
Madera,4,2022-01-11,2071,2071,1138,933,10342,10342,5676,4666,26,1,1,6,340,340,339,339
Marin,4,2022-01-11,2835,2835,1577,1258,20331,20331,11287,9044,17,3,3,5,260,260,257,257
Mariposa,4,2022-01-11,197,197,106,91,1174,1174,629,545,0,0,0,0,22,22,22,22
Mendocino,4,2022-01-11,898,898,432,466,5681,5681,2723,2958,9,2,2,1,106,106,104,104
Merced,4,2022-01-11,3952,3952,2436,1516,14839,14839,9138,5701,37,11,11,11,722,722,711,711
Modoc,4,2022-01-11,11,11,7,4,105,105,67,38,0,0,0,0,6,6,6,6
Mono,4,2022-01-11,241,241,105,136,801,801,348,453,0,1,1,0,5,5,4,4
Monterey,4,2022-01-11,5110,5110,2227,2883,31713,31713,13758,17955,51,3,3,12,654,654,651,651
Napa,4,2022-01-11,2514,2514,1620,894,14483,14483,9350,5133,13,1,1,9,110,110,109,109
Nevada,4,2022-01-11,1249,1249,691,558,5359,5359,2964,2395,9,2,2,3,115,115,113,113
Orange,4,2022-01-11,57593,57593,38863,18730,311538,311551,210414,101137,902,103,103,169,6204,6204,6101,6101
Placer,4,2022-01-11,5232,5232,2763,2469,22613,22613,11947,10666,183,8,8,32,526,526,518,518
Plumas,4,2022-01-11,157,157,90,67,832,832,473,359,6,0,0,0,12,12,12,12
Riverside,4,2022-01-11,48050,48050,29224,18826,187067,187076,113783,73293,787,83,83,156,5779,5779,5696,5696
Sacramento,4,2022-01-11,26878,26878,15841,11037,120869,120874,71365,49509,382,45,45,82,2587,2587,2542,2542
San Benito,4,2022-01-11,1049,1049,671,378,4632,4632,2963,1669,4,1,1,3,86,86,85,85
San Bernardino,4,2022-01-11,50250,50250,33040,17210,191797,191806,126145,65661,829,117,117,195,6801,6801,6684,6684
San Diego,4,2022-01-11,79345,79350,65168,14182,321344,321358,264033,57325,899,73,73,167,4626,4626,4553,4553
San Francisco,4,2022-01-11,14080,14080,5758,8322,112763,112768,46206,66562,173,14,14,38,714,714,700,700
San Joaquin,4,2022-01-11,14896,14896,8456,6440,65661,65664,37286,28378,172,15,15,46,2016,2016,2001,2001
San Luis Obispo,4,2022-01-11,4344,4344,2728,1616,22106,22106,13906,8200,32,4,4,9,381,381,377,377
San Mateo,4,2022-01-11,14953,14953,10106,4847,112863,112868,76295,36573,99,6,6,15,613,613,607,607
Santa Barbara,4,2022-01-11,8336,8336,5015,3321,47252,47252,28444,18808,86,10,10,12,591,591,581,581
Santa Clara,4,2022-01-11,36462,36462,29657,6805,274530,274542,223337,51205,371,25,25,71,2025,2025,2000,2000
Santa Cruz,4,2022-01-11,4576,4576,2930,1646,44128,44128,28309,15819,32,2,2,2,237,237,235,235
Shasta,4,2022-01-11,1078,1078,641,437,8788,8788,5224,3564,39,7,7,12,462,462,455,455
Siskiyou,4,2022-01-11,126,126,83,43,1028,1028,673,355,3,0,0,1,64,64,64,64
Solano,4,2022-01-11,6663,6663,4038,2625,35986,35986,21849,14137,108,8,8,14,405,405,397,397
Sonoma,4,2022-01-11,8720,8720,5348,3372,47001,47001,28905,18096,73,7,7,7,438,438,431,431
Stanislaus,4,2022-01-11,7088,7088,3546,3542,30025,30025,15024,15001,169,11,11,23,1471,1471,1460,1460
Sutter,4,2022-01-11,1332,1332,807,525,5167,5167,3130,2037,0,3,3,0,200,200,197,197
Tehama,4,2022-01-11,554,554,284,270,2613,2613,1339,1274,17,2,2,2,170,170,168,168
Trinity,4,2022-01-11,37,37,19,18,275,275,138,137,0,0,0,0,19,19,19,19
Tulare,4,2022-01-11,6008,6008,2998,3010,25914,25914,12870,13044,70,11,11,11,1333,1333,1322,1322
Tuolumne,4,2022-01-11,794,794,438,356,4224,4224,2325,1899,7,2,2,2,155,155,153,153
Ventura,4,2022-01-11,16946,16946,11739,5207,86311,86316,59828,26488,233,26,26,32,1262,1262,1236,1236
Yolo,4,2022-01-11,3673,3673,2323,1350,47474,47474,29991,17483,10,6,6,2,306,306,300,300
Yuba,4,2022-01-11,1137,1137,706,431,4297,4297,2666,1631,33,0,0,7,104,104,104,104
Alameda,5,2022-01-18,24305,24305,17296,7009,173321,173329,123433,49896,371,37,37,68,1620,1620,1583,1583
Amador,5,2022-01-18,487,487,295,192,3367,3367,2032,1335,13,1,1,3,73,73,72,72
Butte,5,2022-01-18,2112,2112,1592,520,9450,9450,7126,2324,60,8,8,4,372,372,364,364
Calaveras,5,2022-01-18,597,597,380,217,2714,2714,1727,987,4,2,2,2,97,97,95,95
Colusa,5,2022-01-18,155,155,104,51,768,768,516,252,3,0,0,0,21,21,21,21
Contra Costa,5,2022-01-18,16262,16262,9671,6591,88973,88978,52877,36101,233,24,24,45,1132,1132,1108,1108
Del Norte,5,2022-01-18,228,228,151,77,3983,3983,2625,1358,0,0,0,1,42,42,42,42
El Dorado,5,2022-01-18,1675,1675,1067,608,7631,7631,4866,2765,8,4,4,5,193,193,189,189
Fresno,5,2022-01-18,18807,18807,11480,7327,67268,67273,41048,26225,416,30,30,73,2497,2497,2467,2467
Glenn,5,2022-01-18,301,301,194,107,1098,1098,709,389,1,2,2,0,45,45,43,43
Humboldt,5,2022-01-18,1109,1109,729,380,8237,8237,5402,2835,16,1,1,4,129,129,128,128
Imperial,5,2022-01-18,3372,3372,2138,1234,12891,12891,8165,4726,75,13,13,28,865,865,852,852
Inyo,5,2022-01-18,294,294,196,98,954,954,638,316,1,1,1,0,53,53,52,52
Kern,5,2022-01-18,11662,11662,7921,3741,52378,52379,35603,16776,251,29,29,54,2117,2117,2088,2088
Kings,5,2022-01-18,3712,3712,2374,1338,16600,16600,10581,6019,43,5,5,1,399,399,394,394
Lake,5,2022-01-18,643,643,391,252,3532,3532,2147,1385,1,1,1,3,121,121,120,120
Lassen,5,2022-01-18,339,339,237,102,3795,3795,2649,1146,0,0,0,0,54,54,54,54
Los Angeles,5,2022-01-18,212139,212150,182727,29423,1635537,1635616,1408966,226650,4099,521,521,700,28493,28493,27972,27972
Madera,5,2022-01-18,2604,2604,1587,1017,11429,11429,6963,4466,33,7,7,12,347,347,340,340
Marin,5,2022-01-18,2335,2335,1435,900,17916,17916,11011,6905,37,4,4,6,264,264,260,260
Mariposa,5,2022-01-18,148,148,88,60,1102,1102,654,448,0,0,0,0,22,22,22,22
Mendocino,5,2022-01-18,972,972,526,446,5026,5026,2715,2311,24,3,3,3,109,109,106,106
Merced,5,2022-01-18,3836,3836,2571,1265,13716,13716,9206,4510,48,17,17,13,739,739,722,722
Modoc,5,2022-01-18,16,16,11,5,102,102,70,32,0,1,1,0,7,7,6,6
Mono,5,2022-01-18,155,155,75,80,706,706,345,361,0,0,0,0,5,5,5,5
Monterey,5,2022-01-18,6068,6068,3006,3062,30331,30331,15078,15253,89,8,8,14,662,662,654,654
Napa,5,2022-01-18,1898,1898,1325,573,12113,12113,8474,3639,20,2,2,5,112,112,110,110
Nevada,5,2022-01-18,1215,1215,742,473,5382,5382,3289,2093,24,0,0,1,115,115,115,115
Orange,5,2022-01-18,38586,38586,28022,10564,246988,247000,179441,67559,1025,112,112,207,6316,6316,6204,6204
Placer,5,2022-01-18,4210,4210,2478,1732,19367,19367,11405,7962,174,12,12,38,538,538,526,526
Plumas,5,2022-01-18,205,205,128,77,824,824,517,307,3,0,0,0,12,12,12,12
Riverside,5,2022-01-18,39806,39806,26431,13375,167607,167615,111407,56208,949,110,110,160,5889,5889,5779,5779
Sacramento,5,2022-01-18,21024,21024,13621,7403,101303,101308,65702,35606,496,60,60,92,2647,2647,2587,2587
San Benito,5,2022-01-18,898,898,624,274,4316,4316,2994,1322,4,2,2,4,88,88,86,86
San Bernardino,5,2022-01-18,36473,36473,25881,10592,165044,165052,117241,47811,969,152,152,232,6953,6953,6801,6801
San Diego,5,2022-01-18,60211,60213,51497,8716,262111,262124,224162,37962,1093,109,109,196,4735,4735,4626,4626
San Francisco,5,2022-01-18,11105,11105,5234,5871,95780,95785,45181,50604,225,12,12,37,726,726,714,714
San Joaquin,5,2022-01-18,12880,12880,8066,4814,61085,61087,38296,22791,229,23,23,58,2039,2039,2016,2016
San Luis Obispo,5,2022-01-18,3945,3945,2699,1246,21462,21462,14678,6784,45,11,11,13,392,392,381,381
San Mateo,5,2022-01-18,11812,11812,8574,3238,96700,96705,70250,26455,101,11,11,30,624,624,613,613
Santa Barbara,5,2022-01-18,6913,6913,4558,2355,42024,42024,27720,14304,126,10,10,14,601,601,591,591
Santa Clara,5,2022-01-18,28088,28088,23799,4289,235861,235873,199935,35938,457,30,30,83,2055,2055,2025,2025
Santa Cruz,5,2022-01-18,4118,4118,2865,1253,38714,38714,26849,11865,27,3,3,3,240,240,237,237
Shasta,5,2022-01-18,1430,1430,931,499,9546,9546,6213,3333,58,8,8,15,470,470,462,462
Siskiyou,5,2022-01-18,164,164,116,48,877,877,617,260,1,1,1,1,65,65,64,64
Solano,5,2022-01-18,6434,6434,4258,2176,35662,35662,23636,12026,119,4,4,24,409,409,405,405
Sonoma,5,2022-01-18,7586,7586,5082,2504,43172,43173,28935,14238,86,7,7,19,445,445,438,438
Stanislaus,5,2022-01-18,7301,7301,4086,3215,29106,29106,16312,12794,234,15,15,39,1486,1486,1471,1471
Sutter,5,2022-01-18,1214,1214,802,412,4867,4867,3224,1643,0,3,3,0,203,203,200,200
Tehama,5,2022-01-18,625,625,357,268,2453,2453,1404,1049,15,5,5,2,175,175,170,170
Trinity,5,2022-01-18,50,50,28,22,278,278,156,122,0,1,1,0,20,20,19,19
Tulare,5,2022-01-18,7736,7736,4313,3423,27766,27766,15470,12296,103,17,17,13,1350,1350,1333,1333
Tuolumne,5,2022-01-18,902,902,549,353,3925,3925,2387,1538,15,8,8,2,163,163,155,155
Ventura,5,2022-01-18,11490,11490,8535,2955,66889,66892,49690,17202,290,44,44,63,1306,1306,1262,1262
Yolo,5,2022-01-18,2745,2745,1888,857,40187,40187,27612,12575,18,2,2,6,308,308,306,306
Yuba,5,2022-01-18,1013,1013,685,328,3753,3753,2540,1213,43,2,2,8,106,106,104,104
Alameda,6,2022-01-25,17557,17557,13328,4229,160903,160912,122401,38511,377,39,39,70,1659,1659,1620,1620
Amador,6,2022-01-25,481,481,315,166,4009,4009,2625,1384,12,0,0,4,73,73,73,73
Butte,6,2022-01-25,1745,1745,1388,357,9170,9170,7311,1859,87,8,8,9,380,380,372,372
Calaveras,6,2022-01-25,473,473,326,147,2192,2192,1515,677,3,2,2,2,99,99,97,97
Colusa,6,2022-01-25,173,173,125,48,876,876,632,244,7,0,0,0,21,21,21,21
Contra Costa,6,2022-01-25,12219,12219,7969,4250,80947,80952,52895,28057,209,24,24,74,1156,1156,1132,1132
Del Norte,6,2022-01-25,357,357,255,102,3863,3863,2751,1112,4,0,0,2,42,42,42,42
El Dorado,6,2022-01-25,1319,1319,909,410,7054,7054,4883,2171,20,4,4,7,197,197,193,193
Fresno,6,2022-01-25,16222,16222,10788,5434,66145,66150,44102,22048,499,39,39,82,2536,2536,2497,2497
Glenn,6,2022-01-25,236,236,165,71,889,889,623,266,3,0,0,0,45,45,45,45
Humboldt,6,2022-01-25,820,820,582,238,7158,7158,5084,2074,25,3,3,3,132,132,129,129
Imperial,6,2022-01-25,3473,3473,2389,1084,12824,12824,8844,3980,74,17,17,29,882,882,865,865
Inyo,6,2022-01-25,126,126,91,35,611,611,443,168,3,0,0,0,53,53,53,53
Kern,6,2022-01-25,9326,9326,6800,2526,50287,50290,36772,13518,274,51,51,57,2168,2168,2117,2117
Kings,6,2022-01-25,3746,3746,2585,1161,17227,17227,11916,5311,39,3,3,4,402,402,399,399
Lake,6,2022-01-25,706,706,469,237,3201,3201,2130,1071,8,2,2,4,123,123,121,121
Lassen,6,2022-01-25,409,409,305,104,3647,3647,2726,921,6,0,0,0,54,54,54,54
Los Angeles,6,2022-01-25,142185,142193,126203,15990,1548121,1548206,1375869,172337,3754,616,616,780,29109,29109,28493,28493
Madera,6,2022-01-25,2499,2499,1658,841,11274,11274,7500,3774,51,6,6,11,353,353,347,347
Marin,6,2022-01-25,1685,1685,1130,555,16606,16606,11147,5459,34,5,5,10,269,269,264,264
Mariposa,6,2022-01-25,133,133,87,46,907,907,592,315,0,0,0,0,22,22,22,22
Mendocino,6,2022-01-25,798,798,476,322,4419,4419,2647,1772,21,2,2,3,111,111,109,109
Merced,6,2022-01-25,3041,3041,2198,843,12220,12220,8853,3367,57,8,8,10,747,747,739,739
Modoc,6,2022-01-25,13,13,10,3,107,107,79,28,2,0,0,0,7,7,7,7
Mono,6,2022-01-25,84,84,46,38,400,400,221,179,1,0,0,0,5,5,5,5
Monterey,6,2022-01-25,4827,4827,2691,2136,30402,30402,16959,13443,90,8,8,19,670,670,662,662
Napa,6,2022-01-25,1506,1506,1125,381,11337,11337,8485,2852,21,5,5,5,117,117,112,112
Nevada,6,2022-01-25,942,942,629,313,4601,4601,3080,1521,27,3,3,5,118,118,115,115
Orange,6,2022-01-25,23301,23301,17970,5331,219617,219629,169841,49788,907,187,187,179,6503,6503,6316,6316
Placer,6,2022-01-25,3409,3409,2203,1206,17777,17777,11512,6265,198,9,9,49,547,547,538,538
Plumas,6,2022-01-25,201,201,136,65,812,812,551,261,5,0,0,0,12,12,12,12
Riverside,6,2022-01-25,28828,28828,20642,8186,150240,150248,107794,42454,903,116,116,171,6005,6005,5889,5889
Sacramento,6,2022-01-25,15759,15759,11060,4699,92682,92687,65160,27527,559,71,71,98,2718,2718,2647,2647
San Benito,6,2022-01-25,711,711,528,183,3762,3762,2800,962,5,0,0,3,88,88,88,88
San Bernardino,6,2022-01-25,24504,24504,18552,5952,141973,141979,107763,34216,972,175,175,230,7128,7128,6953,6953
San Diego,6,2022-01-25,44908,44909,39619,5290,236488,236501,208880,27621,1052,132,132,224,4867,4867,4735,4735
San Francisco,6,2022-01-25,7422,7422,3954,3468,84502,84507,45157,39350,235,20,20,36,746,746,726,726
San Joaquin,6,2022-01-25,9519,9519,6474,3045,53878,53881,36787,17094,251,35,35,72,2074,2074,2039,2039
San Luis Obispo,6,2022-01-25,3204,3204,2352,852,20184,20184,14834,5350,43,10,10,12,402,402,392,392
San Mateo,6,2022-01-25,7504,7504,5791,1713,89617,89622,69298,20324,134,20,20,27,644,644,624,624
Santa Barbara,6,2022-01-25,5973,5973,4251,1722,41620,41621,29680,11941,126,16,16,18,617,617,601,601
Santa Clara,6,2022-01-25,21092,21092,18491,2601,222819,222831,195475,27356,419,52,52,87,2107,2107,2055,2055
Santa Cruz,6,2022-01-25,5075,5075,3770,1305,49506,49509,36824,12685,37,2,2,4,242,242,240,240
Shasta,6,2022-01-25,1390,1390,977,413,9629,9629,6787,2842,79,6,6,10,476,476,470,470
Siskiyou,6,2022-01-25,128,128,96,32,735,735,551,184,5,3,3,2,68,68,65,65
Solano,6,2022-01-25,4768,4768,3414,1354,31292,31292,22446,8846,143,14,14,28,423,423,409,409
Sonoma,6,2022-01-25,6334,6334,4566,1768,40467,40467,29252,11215,87,8,8,20,453,453,445,445
Stanislaus,6,2022-01-25,5817,5817,3593,2224,26600,26600,16490,10110,277,23,23,48,1509,1509,1486,1486
Sutter,6,2022-01-25,953,953,678,275,4724,4724,3372,1352,0,2,2,0,205,205,203,203
Tehama,6,2022-01-25,523,523,329,194,2505,2505,1580,925,18,4,4,5,179,179,175,175
Trinity,6,2022-01-25,59,59,36,23,314,314,195,119,0,0,0,0,20,20,20,20
Tulare,6,2022-01-25,6994,6994,4297,2697,27935,27935,17209,10726,145,9,9,13,1359,1359,1350,1350
Tuolumne,6,2022-01-25,935,935,623,312,3640,3640,2427,1213,17,1,1,3,164,164,163,163
Ventura,6,2022-01-25,8319,8319,6539,1780,64200,64205,50565,13640,279,29,29,66,1335,1335,1306,1306
Yolo,6,2022-01-25,2061,2061,1521,540,38866,38866,28697,10169,17,12,12,5,320,320,308,308
Yuba,6,2022-01-25,820,820,595,225,3542,3542,2576,966,49,3,3,9,109,109,106,106
Alameda,7,2022-02-01,9886,9886,7927,1959,132323,132333,106268,26065,325,52,52,78,1711,1711,1659,1659
Amador,7,2022-02-01,351,351,250,101,3373,3373,2399,974,14,2,2,4,75,75,73,73
Butte,7,2022-02-01,1112,1112,927,185,7399,7399,6178,1221,76,6,6,6,386,386,380,380
Calaveras,7,2022-02-01,251,251,186,65,1840,1840,1364,476,3,7,7,2,106,106,99,99
Colusa,7,2022-02-01,96,96,74,22,683,683,526,157,8,0,0,0,21,21,21,21
Contra Costa,7,2022-02-01,6598,6598,4657,1941,65709,65714,46453,19261,212,42,42,51,1198,1198,1156,1156
Del Norte,7,2022-02-01,289,289,219,70,3898,3898,2954,944,4,2,2,1,44,44,42,42
El Dorado,7,2022-02-01,683,683,507,176,5891,5891,4381,1510,14,2,2,5,199,199,197,197
Fresno,7,2022-02-01,10120,10120,7267,2853,52824,52829,38024,14805,506,40,40,100,2576,2576,2536,2536
Glenn,7,2022-02-01,186,186,139,47,740,740,555,185,2,2,2,0,47,47,45,45
Humboldt,7,2022-02-01,562,562,427,135,5689,5689,4318,1371,19,3,3,2,135,135,132,132
Imperial,7,2022-02-01,1871,1871,1380,491,10625,10625,7853,2772,73,16,16,24,898,898,882,882
Inyo,7,2022-02-01,60,60,46,14,471,471,364,107,5,3,3,0,56,56,53,53
Kern,7,2022-02-01,5120,5120,3975,1145,40295,40297,31338,8959,237,41,41,50,2209,2209,2168,2168
Kings,7,2022-02-01,2174,2174,1611,563,13380,13380,9927,3453,49,6,6,5,408,408,402,402
Lake,7,2022-02-01,442,442,317,125,3024,3024,2163,861,6,4,4,5,127,127,123,123
Lassen,7,2022-02-01,258,258,203,55,3420,3420,2703,717,7,2,2,0,56,56,54,54
Los Angeles,7,2022-02-01,66275,66280,60345,5935,1265947,1266036,1153843,112193,2816,668,668,699,29777,29777,29109,29109
Madera,7,2022-02-01,1521,1521,1090,431,8937,8937,6421,2516,47,7,7,7,360,360,353,353
Marin,7,2022-02-01,956,956,691,265,13235,13235,9584,3651,27,6,6,8,275,275,269,269
Mariposa,7,2022-02-01,86,86,61,25,804,804,567,237,0,2,2,0,24,24,22,22
Mendocino,7,2022-02-01,426,426,279,147,3293,3293,2167,1126,14,3,3,4,114,114,111,111
Merced,7,2022-02-01,1909,1909,1469,440,9811,9811,7563,2248,47,12,12,12,759,759,747,747
Modoc,7,2022-02-01,12,12,9,3,74,74,58,16,1,0,0,0,7,7,7,7
Mono,7,2022-02-01,45,45,28,17,329,329,202,127,0,0,0,0,5,5,5,5
Monterey,7,2022-02-01,3151,3151,1942,1209,25621,25621,15847,9774,87,11,11,12,681,681,670,670
Napa,7,2022-02-01,978,978,775,203,9043,9043,7167,1876,20,7,7,4,124,124,117,117
Nevada,7,2022-02-01,518,518,373,145,3676,3676,2649,1027,26,1,1,7,119,119,118,118
Orange,7,2022-02-01,10748,10748,8738,2010,170920,170932,139233,31699,685,159,159,161,6662,6662,6503,6503
Placer,7,2022-02-01,2020,2020,1414,606,14476,14476,10160,4316,147,24,24,46,571,571,547,547
Plumas,7,2022-02-01,118,118,86,32,698,698,508,190,0,1,1,0,13,13,12,12
Riverside,7,2022-02-01,14031,14031,10716,3315,115414,115422,88354,27068,743,116,116,167,6121,6121,6005,6005
Sacramento,7,2022-02-01,9062,9062,6802,2260,73838,73843,55543,18300,501,91,91,102,2809,2809,2718,2718
San Benito,7,2022-02-01,431,431,339,92,3210,3210,2532,678,5,2,2,3,90,90,88,88
San Bernardino,7,2022-02-01,12007,12007,9612,2395,111747,111753,89603,22150,721,183,183,193,7311,7311,7128,7128
San Diego,7,2022-02-01,22116,22116,20036,2080,174859,174871,158585,16286,912,106,106,217,4973,4973,4867,4867
San Francisco,7,2022-02-01,3494,3494,2073,1421,65135,65140,38696,26444,202,25,25,48,771,771,746,746
San Joaquin,7,2022-02-01,5144,5144,3769,1375,41082,41085,30183,10902,212,37,37,75,2111,2111,2074,2074
San Luis Obispo,7,2022-02-01,1764,1764,1377,387,14986,14986,11695,3291,42,16,16,9,418,418,402,402
San Mateo,7,2022-02-01,3870,3870,3145,725,72298,72303,58836,13467,136,7,7,21,651,651,644,644
Santa Barbara,7,2022-02-01,3329,3329,2532,797,34189,34190,26058,8132,100,20,20,13,637,637,617,617
Santa Clara,7,2022-02-01,12629,12629,11380,1249,203215,203231,183223,20008,409,44,44,90,2151,2151,2107,2107
Santa Cruz,7,2022-02-01,3017,3017,2373,644,50184,50189,39560,10629,38,6,6,6,248,248,242,242
Shasta,7,2022-02-01,846,846,637,209,7974,7974,6010,1964,64,16,16,9,492,492,476,476
Siskiyou,7,2022-02-01,127,127,101,26,752,752,598,154,10,3,3,1,71,71,68,68
Solano,7,2022-02-01,3839,3839,2936,903,29007,29007,22201,6806,126,6,6,29,429,429,423,423
Sonoma,7,2022-02-01,3108,3108,2388,720,30294,30294,23344,6950,76,11,11,15,464,464,453,453
Stanislaus,7,2022-02-01,3455,3455,2337,1118,21616,21616,14653,6963,260,39,39,52,1548,1548,1509,1509
Sutter,7,2022-02-01,583,583,443,140,3740,3740,2855,885,0,5,5,0,210,210,205,205
Tehama,7,2022-02-01,370,370,254,116,1997,1997,1373,624,17,2,2,5,181,181,179,179
Trinity,7,2022-02-01,39,39,26,13,194,194,131,63,0,0,0,0,20,20,20,20
Tulare,7,2022-02-01,4241,4241,2847,1394,21717,21717,14613,7104,151,23,23,20,1382,1382,1359,1359
Tuolumne,7,2022-02-01,679,679,486,193,3152,3152,2263,889,18,2,2,2,166,166,164,164
Ventura,7,2022-02-01,4112,4112,3393,719,49832,49837,41180,8657,249,33,33,47,1368,1368,1335,1335
Yolo,7,2022-02-01,1221,1221,956,265,36455,36456,28553,7903,17,6,6,6,326,326,320,320
Yuba,7,2022-02-01,480,480,371,109,2779,2779,2151,628,74,3,3,12,112,112,109,109
Alameda,8,2022-02-08,5331,5331,4471,860,113309,113318,95121,18197,189,46,46,41,1757,1757,1711,1711
Amador,8,2022-02-08,180,180,137,43,2767,2767,2098,669,14,3,3,4,78,78,75,75
Butte,8,2022-02-08,695,695,601,94,6205,6205,5377,828,81,8,8,11,394,394,386,386
Calaveras,8,2022-02-08,169,169,133,36,1420,1420,1117,303,3,0,0,2,106,106,106,106
Colusa,8,2022-02-08,72,72,58,14,549,549,446,103,1,0,0,0,21,21,21,21
Contra Costa,8,2022-02-08,3777,3777,2853,924,52184,52189,39434,12755,146,31,31,48,1229,1229,1198,1198
Del Norte,8,2022-02-08,293,293,235,58,3961,3961,3167,794,7,0,0,1,44,44,44,44
El Dorado,8,2022-02-08,384,384,303,81,4931,4931,3890,1041,18,3,3,5,202,202,199,199
Fresno,8,2022-02-08,5762,5762,4414,1348,41262,41267,31683,9584,454,51,51,86,2627,2627,2576,2576
Glenn,8,2022-02-08,85,85,67,18,569,569,451,118,3,3,3,0,50,50,47,47
Humboldt,8,2022-02-08,452,452,363,89,4812,4812,3861,951,20,1,1,3,136,136,135,135
Imperial,8,2022-02-08,994,994,779,215,7543,7543,5918,1625,50,13,13,25,911,911,898,898
Inyo,8,2022-02-08,32,32,26,6,440,440,358,82,3,0,0,0,56,56,56,56
Kern,8,2022-02-08,3165,3165,2584,581,33677,33679,27545,6134,179,33,33,43,2242,2242,2209,2209
Kings,8,2022-02-08,1179,1179,927,252,9756,9756,7690,2066,51,15,15,4,423,423,408,408
Lake,8,2022-02-08,324,324,247,77,2647,2647,2021,626,14,1,1,5,128,128,127,127
Lassen,8,2022-02-08,127,127,105,22,3056,3056,2534,522,5,1,1,0,57,57,56,56
Los Angeles,8,2022-02-08,33547,33548,31167,2381,1139442,1139532,1059326,80206,2069,618,618,528,30395,30395,29777,29777
Madera,8,2022-02-08,969,969,740,229,7989,7989,6120,1869,27,2,2,9,362,362,360,360
Marin,8,2022-02-08,597,597,459,138,11104,11104,8558,2546,31,6,6,7,281,281,275,275
Mariposa,8,2022-02-08,46,46,35,11,539,539,406,133,0,0,0,0,24,24,24,24
Mendocino,8,2022-02-08,319,319,227,92,2761,2761,1966,795,12,2,2,5,116,116,114,114
Merced,8,2022-02-08,1052,1052,854,198,7856,7856,6385,1471,46,14,14,12,773,773,759,759
Modoc,8,2022-02-08,26,26,21,5,238,238,195,43,4,0,0,0,7,7,7,7
Mono,8,2022-02-08,32,32,21,11,246,246,165,81,0,0,0,0,5,5,5,5
Monterey,8,2022-02-08,2023,2023,1360,663,21603,21603,14594,7009,66,9,9,15,690,690,681,681
Napa,8,2022-02-08,659,659,547,112,7556,7556,6277,1279,18,6,6,2,130,130,124,124
Nevada,8,2022-02-08,316,316,242,74,3102,3102,2384,718,28,3,3,3,122,122,119,119
Orange,8,2022-02-08,5828,5828,4945,883,150432,150444,127815,22629,493,122,122,124,6784,6784,6662,6662
Placer,8,2022-02-08,1172,1172,878,294,11694,11694,8786,2908,160,18,18,31,589,589,571,571
Plumas,8,2022-02-08,77,77,59,18,508,508,393,115,1,0,0,0,13,13,13,13
Riverside,8,2022-02-08,7269,7269,5862,1407,90326,90331,72935,17396,497,98,98,124,6219,6219,6121,6121
Sacramento,8,2022-02-08,5467,5467,4342,1125,61603,61608,49022,12586,386,68,68,93,2877,2877,2809,2809
San Benito,8,2022-02-08,292,292,241,51,2554,2554,2114,440,5,0,0,4,90,90,90,90
San Bernardino,8,2022-02-08,6197,6197,5192,1005,86472,86477,72539,13938,510,141,141,152,7452,7452,7311,7311
San Diego,8,2022-02-08,12441,12441,11513,928,147610,147622,136695,10927,748,111,111,173,5084,5084,4973,4973
San Francisco,8,2022-02-08,2346,2346,1533,813,55096,55101,35978,19123,165,25,25,43,796,796,771,771
San Joaquin,8,2022-02-08,2970,2970,2312,658,35756,35758,27903,7855,163,38,38,60,2149,2149,2111,2111
San Luis Obispo,8,2022-02-08,1120,1120,918,202,11797,11797,9673,2124,26,12,12,7,430,430,418,418
San Mateo,8,2022-02-08,2240,2240,1899,341,60670,60675,51509,9166,79,19,19,17,670,670,651,651
Santa Barbara,8,2022-02-08,1964,1964,1573,391,27671,27671,22179,5492,72,15,15,16,652,652,637,637
Santa Clara,8,2022-02-08,7295,7295,6720,575,172044,172058,158604,13454,352,32,32,68,2183,2183,2151,2151
Santa Cruz,8,2022-02-08,1737,1737,1436,301,37891,37895,31403,6492,34,2,2,4,250,250,248,248
Shasta,8,2022-02-08,637,637,507,130,6703,6703,5344,1359,68,16,16,11,508,508,492,492
Siskiyou,8,2022-02-08,86,86,72,14,653,653,543,110,12,1,1,0,72,72,71,71
Solano,8,2022-02-08,1789,1789,1442,347,22118,22118,17846,4272,74,5,5,26,434,434,429,429
Sonoma,8,2022-02-08,1890,1890,1531,359,26334,26334,21375,4959,51,8,8,15,472,472,464,464
Stanislaus,8,2022-02-08,2224,2224,1618,606,18124,18124,13223,4901,233,38,38,41,1586,1586,1548,1548
Sutter,8,2022-02-08,313,313,251,62,3177,3177,2557,620,0,5,5,0,215,215,210,210
Tehama,8,2022-02-08,261,261,192,69,1544,1544,1140,404,15,4,4,5,185,185,181,181
Trinity,8,2022-02-08,17,17,12,5,132,132,96,36,0,0,0,0,20,20,20,20
Tulare,8,2022-02-08,2434,2434,1763,671,17176,17176,12466,4710,128,28,28,21,1410,1410,1382,1382
Tuolumne,8,2022-02-08,306,306,234,72,2529,2529,1939,590,11,2,2,2,168,168,166,166
Ventura,8,2022-02-08,2476,2476,2126,350,41200,41204,35425,5779,189,44,44,45,1412,1412,1368,1368
Yolo,8,2022-02-08,813,813,669,144,30260,30260,24892,5368,6,14,14,4,340,340,326,326
Yuba,8,2022-02-08,317,317,258,59,2370,2370,1931,439,34,3,3,13,115,115,112,112
Alameda,9,2022-02-15,3118,3118,2711,407,98451,98459,85706,12753,190,35,35,45,1792,1792,1757,1757
Amador,9,2022-02-15,96,96,77,19,2290,2290,1835,455,7,3,3,3,81,81,78,78
Butte,9,2022-02-15,430,430,383,47,5229,5229,4667,562,61,13,13,8,407,407,394,394
Calaveras,9,2022-02-15,70,70,58,12,1144,1144,943,201,4,3,3,3,109,109,106,106
Colusa,9,2022-02-15,27,27,23,4,399,399,337,62,6,0,0,0,21,21,21,21
Contra Costa,9,2022-02-15,2207,2207,1762,445,44492,44497,35560,8937,108,19,19,37,1248,1248,1229,1229
Del Norte,9,2022-02-15,192,192,161,31,3351,3351,2800,551,6,0,0,3,44,44,44,44
El Dorado,9,2022-02-15,233,233,192,41,4283,4283,3541,742,18,2,2,3,204,204,202,202
Fresno,9,2022-02-15,3473,3473,2804,669,33188,33190,26854,6336,362,31,31,67,2658,2658,2627,2627
Glenn,9,2022-02-15,55,55,45,10,490,490,407,83,3,1,1,0,51,51,50,50
Humboldt,9,2022-02-15,296,296,248,48,4038,4038,3385,653,21,0,0,2,136,136,136,136
Imperial,9,2022-02-15,545,545,448,97,5652,5652,4652,1000,44,11,11,17,922,922,911,911
Inyo,9,2022-02-15,25,25,21,4,373,373,316,57,2,0,0,0,56,56,56,56
Kern,9,2022-02-15,1884,1884,1604,280,26993,26994,23004,3990,142,31,31,40,2273,2273,2242,2242
Kings,9,2022-02-15,695,695,573,122,7357,7357,6083,1274,39,6,6,5,429,429,423,423
Lake,9,2022-02-15,247,247,199,48,2193,2193,1765,428,9,2,2,4,130,130,128,128
Lassen,9,2022-02-15,147,147,126,21,2652,2652,2280,372,2,2,2,0,59,59,57,57
Los Angeles,9,2022-02-15,19572,19572,18471,1101,1038935,1039024,981078,57946,1447,436,436,388,30831,30831,30395,30395
Madera,9,2022-02-15,561,561,452,109,6404,6404,5177,1227,29,2,2,8,364,364,362,362
Marin,9,2022-02-15,352,352,286,66,10092,10092,8195,1897,23,5,5,6,286,286,281,281
Mariposa,9,2022-02-15,26,26,21,5,420,420,335,85,0,0,0,0,24,24,24,24
Mendocino,9,2022-02-15,176,176,134,42,2357,2357,1792,565,16,1,1,7,117,117,116,116
Merced,9,2022-02-15,705,705,597,108,6597,6597,5590,1007,36,12,12,10,785,785,773,773
Modoc,9,2022-02-15,18,18,15,3,118,118,100,18,0,0,0,0,7,7,7,7
Mono,9,2022-02-15,9,9,6,3,156,156,113,43,0,0,0,0,5,5,5,5
Monterey,9,2022-02-15,1145,1145,831,314,16276,16276,11838,4438,54,12,12,12,702,702,690,690
Napa,9,2022-02-15,374,374,323,51,6254,6254,5395,859,10,2,2,1,132,132,130,130
Nevada,9,2022-02-15,152,152,123,29,2517,2517,2040,477,17,3,3,4,125,125,122,122
Orange,9,2022-02-15,3741,3741,3285,456,131316,131326,115420,15906,336,104,104,79,6888,6888,6784,6784
Placer,9,2022-02-15,539,539,428,111,9890,9890,7865,2025,106,12,12,24,601,601,589,589
Plumas,9,2022-02-15,34,34,28,6,411,411,335,76,1,0,0,0,13,13,13,13
Riverside,9,2022-02-15,4214,4214,3549,665,72126,72131,60822,11309,379,81,81,93,6300,6300,6219,6219
Sacramento,9,2022-02-15,3176,3176,2643,533,52417,52422,43690,8732,340,52,52,58,2929,2929,2877,2877
San Benito,9,2022-02-15,143,143,123,20,2082,2082,1791,291,0,1,1,3,91,91,90,90
San Bernardino,9,2022-02-15,3322,3322,2885,437,70557,70562,61362,9200,342,109,109,119,7561,7561,7452,7452
San Diego,9,2022-02-15,7328,7328,6894,434,122336,122348,115180,7168,557,88,88,131,5172,5172,5084,5084
San Francisco,9,2022-02-15,1457,1457,1030,427,47046,47051,33306,13745,127,24,24,40,820,820,796,796
San Joaquin,9,2022-02-15,1839,1839,1504,335,29845,29847,24473,5374,136,36,36,47,2185,2185,2149,2149
San Luis Obispo,9,2022-02-15,737,737,629,108,9859,9859,8419,1440,25,12,12,5,442,442,430,430
San Mateo,9,2022-02-15,1223,1223,1074,149,53964,53969,47389,6580,54,14,14,11,684,684,670,670
Santa Barbara,9,2022-02-15,1015,1015,852,163,23633,23633,19846,3787,66,11,11,12,663,663,652,652
Santa Clara,9,2022-02-15,4221,4221,3957,264,153535,153549,144027,9522,288,30,30,56,2213,2213,2183,2183
Santa Cruz,9,2022-02-15,928,928,798,130,29982,29984,25814,4170,22,3,3,4,253,253,250,250
Shasta,9,2022-02-15,439,439,366,73,5789,5789,4832,957,70,9,9,14,517,517,508,508
Siskiyou,9,2022-02-15,68,68,59,9,530,530,458,72,7,1,1,3,73,73,72,72
Solano,9,2022-02-15,1124,1124,946,178,18830,18830,15860,2970,75,2,2,21,436,436,434,434
Sonoma,9,2022-02-15,1017,1017,860,157,20784,20784,17602,3182,50,6,6,8,478,478,472,472
Stanislaus,9,2022-02-15,1283,1283,993,290,14438,14438,11196,3242,191,32,32,44,1618,1618,1586,1586
Sutter,9,2022-02-15,225,225,189,36,2777,2777,2335,442,0,2,2,0,217,217,215,215
Tehama,9,2022-02-15,161,161,126,35,1391,1391,1090,301,18,4,4,5,189,189,185,185
Trinity,9,2022-02-15,21,21,16,5,183,183,142,41,0,0,0,0,20,20,20,20
Tulare,9,2022-02-15,1324,1324,1021,303,14778,14778,11411,3367,105,25,25,16,1435,1435,1410,1410
Tuolumne,9,2022-02-15,173,173,140,33,2168,2168,1752,416,15,4,4,1,172,172,168,168
Ventura,9,2022-02-15,1372,1372,1216,156,34655,34658,30737,3921,146,31,31,24,1443,1443,1412,1412
Yolo,9,2022-02-15,428,428,366,62,26297,26297,22495,3802,8,5,5,1,345,345,340,340
Yuba,9,2022-02-15,203,203,172,31,2035,2035,1728,307,23,0,0,10,115,115,115,115
Alameda,10,2022-02-22,1777,1777,1591,186,74830,74838,66985,7853,130,27,27,24,1819,1819,1792,1792
Amador,10,2022-02-22,61,61,51,10,1959,1959,1640,319,5,3,3,3,84,84,81,81
Butte,10,2022-02-22,243,243,222,21,4483,4483,4099,384,55,11,11,5,418,418,407,407
Calaveras,10,2022-02-22,39,39,33,6,883,883,758,125,2,5,5,0,114,114,109,109
Colusa,10,2022-02-22,25,25,22,3,364,364,318,46,7,0,0,0,21,21,21,21
Contra Costa,10,2022-02-22,1250,1250,1044,206,34210,34213,28583,5630,68,17,17,26,1265,1265,1248,1248
Del Norte,10,2022-02-22,124,124,108,16,2783,2783,2411,372,9,0,0,2,44,44,44,44
El Dorado,10,2022-02-22,147,147,126,21,3554,3554,3053,501,7,1,1,6,205,205,204,204
Fresno,10,2022-02-22,1845,1845,1556,289,26767,26768,22605,4163,268,25,25,58,2683,2683,2658,2658
Glenn,10,2022-02-22,28,28,24,4,412,412,356,56,1,1,1,0,52,52,51,51
Humboldt,10,2022-02-22,195,195,169,26,3296,3296,2863,433,22,3,3,1,139,139,136,136
Imperial,10,2022-02-22,382,382,327,55,5008,5008,4292,716,33,7,7,9,929,929,922,922
Inyo,10,2022-02-22,12,12,11,1,324,324,284,40,0,0,0,0,56,56,56,56
Kern,10,2022-02-22,1135,1135,999,136,23932,23933,21076,2857,97,20,20,26,2293,2293,2273,2273
Kings,10,2022-02-22,414,414,355,59,6604,6604,5675,929,32,5,5,5,434,434,429,429
Lake,10,2022-02-22,170,170,143,27,2037,2037,1712,325,8,5,5,1,135,135,130,130
Lassen,10,2022-02-22,109,109,96,13,2170,2170,1924,246,1,0,0,0,59,59,59,59
Los Angeles,10,2022-02-22,11022,11022,10534,488,888915,889004,849777,39227,935,326,326,269,31157,31157,30831,30831
Madera,10,2022-02-22,289,289,243,46,4765,4765,4013,752,31,4,4,8,368,368,364,364
Marin,10,2022-02-22,187,187,158,29,8614,8614,7284,1330,13,3,3,3,289,289,286,286
Mariposa,10,2022-02-22,19,19,16,3,357,357,298,59,0,1,1,0,25,25,24,24
Mendocino,10,2022-02-22,113,113,91,22,1940,1940,1557,383,8,2,2,2,119,119,117,117
Merced,10,2022-02-22,394,394,345,49,5270,5270,4621,649,25,9,9,6,794,794,785,785
Modoc,10,2022-02-22,5,5,4,1,58,58,51,7,1,0,0,0,7,7,7,7
Mono,10,2022-02-22,7,7,5,2,163,163,125,38,0,1,1,0,6,6,5,5
Monterey,10,2022-02-22,703,703,542,161,13574,13574,10503,3071,41,6,6,6,708,708,702,702
Napa,10,2022-02-22,209,209,186,23,5064,5064,4504,560,7,4,4,3,136,136,132,132
Nevada,10,2022-02-22,94,94,79,15,2080,2080,1758,322,14,2,2,5,127,127,125,125
Orange,10,2022-02-22,2311,2311,2085,226,110306,110316,99532,10784,263,72,72,68,6960,6960,6888,6888
Placer,10,2022-02-22,312,312,260,52,8652,8652,7203,1449,94,7,7,14,608,608,601,601
Plumas,10,2022-02-22,22,22,19,3,341,341,289,52,0,0,0,0,13,13,13,13
Riverside,10,2022-02-22,2262,2262,1974,288,62776,62782,54835,7947,268,48,48,62,6348,6348,6300,6300
Sacramento,10,2022-02-22,1771,1771,1529,242,43691,43695,37788,5907,234,33,33,42,2962,2962,2929,2929
San Benito,10,2022-02-22,93,93,82,11,1815,1815,1609,206,0,0,0,1,91,91,91,91
San Bernardino,10,2022-02-22,1724,1724,1542,182,60763,60768,54398,6370,240,76,76,78,7637,7637,7561,7561
San Diego,10,2022-02-22,4270,4270,4070,200,99664,99674,95047,4627,462,54,54,100,5226,5226,5172,5172
San Francisco,10,2022-02-22,969,969,733,236,40281,40285,30424,9861,101,11,11,27,831,831,820,820
San Joaquin,10,2022-02-22,952,952,811,141,25264,25265,21574,3691,92,25,25,25,2210,2210,2185,2185
San Luis Obispo,10,2022-02-22,423,423,373,50,8120,8120,7165,955,10,14,14,3,456,456,442,442
San Mateo,10,2022-02-22,624,624,562,62,40985,40989,36943,4046,45,8,8,7,692,692,684,684
Santa Barbara,10,2022-02-22,541,541,470,71,20070,20071,17476,2595,38,2,2,9,665,665,663,663
Santa Clara,10,2022-02-22,2309,2309,2195,114,110174,110186,104693,5493,220,26,26,55,2239,2239,2213,2213
Santa Cruz,10,2022-02-22,541,541,480,61,24500,24502,21737,2765,18,2,2,5,255,255,253,253
Shasta,10,2022-02-22,222,222,192,30,4934,4934,4273,661,53,10,10,1,527,527,517,517
Siskiyou,10,2022-02-22,45,45,40,5,465,465,414,51,5,5,5,0,78,78,73,73
Solano,10,2022-02-22,610,610,532,78,14743,14743,12865,1878,49,5,5,14,441,441,436,436
Sonoma,10,2022-02-22,602,602,527,75,16473,16474,14430,2044,35,2,2,7,480,480,478,478
Stanislaus,10,2022-02-22,661,661,538,123,12663,12663,10333,2330,172,25,25,26,1643,1643,1618,1618
Sutter,10,2022-02-22,117,117,102,15,2143,2143,1868,275,0,2,2,0,219,219,217,217
Tehama,10,2022-02-22,87,87,71,16,1171,1171,963,208,7,10,10,2,199,199,189,189
Trinity,10,2022-02-22,13,13,11,2,192,192,156,36,0,0,0,0,20,20,20,20
Tulare,10,2022-02-22,663,663,538,125,11224,11224,9131,2093,78,17,17,11,1452,1452,1435,1435
Tuolumne,10,2022-02-22,89,89,75,14,1653,1653,1393,260,5,6,6,3,178,178,172,172
Ventura,10,2022-02-22,848,848,771,77,28167,28169,25623,2546,104,25,25,19,1468,1468,1443,1443
Yolo,10,2022-02-22,266,266,235,31,21872,21873,19321,2552,3,4,4,1,349,349,345,345
Yuba,10,2022-02-22,124,124,109,15,1704,1704,1498,206,17,1,1,6,116,116,115,115
Alameda,11,2022-03-01,1416,1416,1299,117,76360,76369,70042,6327,117,14,14,23,1833,1833,1819,1819
Amador,11,2022-03-01,56,56,49,7,1973,1973,1714,259,8,1,1,1,85,85,84,84
Butte,11,2022-03-01,165,165,154,11,4141,4141,3859,282,43,4,4,3,422,422,418,418
Calaveras,11,2022-03-01,35,35,31,4,1200,1200,1063,137,0,3,3,0,117,117,114,114
Colusa,11,2022-03-01,9,9,8,1,398,398,358,40,7,0,0,0,21,21,21,21
Contra Costa,11,2022-03-01,812,812,704,108,33258,33263,28866,4397,46,17,17,16,1282,1282,1265,1265
Del Norte,11,2022-03-01,71,71,64,7,2638,2638,2354,284,4,3,3,1,47,47,44,44
El Dorado,11,2022-03-01,87,87,77,10,3516,3516,3119,397,3,2,2,6,207,207,205,205
Fresno,11,2022-03-01,1193,1193,1043,150,24519,24522,21451,3071,187,27,27,43,2710,2710,2683,2683
Glenn,11,2022-03-01,17,17,15,2,407,407,363,44,1,0,0,0,52,52,52,52
Humboldt,11,2022-03-01,129,129,116,13,2845,2845,2548,297,9,1,1,1,140,140,139,139
Imperial,11,2022-03-01,231,231,205,26,4589,4589,4064,525,15,7,7,10,936,936,929,929
Inyo,11,2022-03-01,7,7,6,1,367,367,331,36,0,0,0,0,56,56,56,56
Kern,11,2022-03-01,691,691,625,66,23179,23181,20974,2207,74,13,13,16,2306,2306,2293,2293
Kings,11,2022-03-01,220,220,195,25,5641,5641,5002,639,16,6,6,3,440,440,434,434
Lake,11,2022-03-01,100,100,87,13,1837,1837,1601,236,0,1,1,1,136,136,135,135
Lassen,11,2022-03-01,93,93,85,8,2122,2122,1931,191,1,3,3,0,62,62,59,59
Los Angeles,11,2022-03-01,7610,7610,7346,264,978697,978816,944807,34009,750,212,212,157,31369,31369,31157,31157
Madera,11,2022-03-01,178,178,155,23,4331,4331,3784,547,16,0,0,5,368,368,368,368
Marin,11,2022-03-01,161,161,141,20,7567,7567,6636,931,14,3,3,4,292,292,289,289
Mariposa,11,2022-03-01,29,29,25,4,342,342,296,46,0,1,1,0,26,26,25,25
Mendocino,11,2022-03-01,66,66,55,11,1811,1811,1521,290,10,2,2,3,121,121,119,119
Merced,11,2022-03-01,270,270,243,27,4784,4784,4315,469,11,8,8,18,802,802,794,794
Modoc,11,2022-03-01,5,5,4,1,55,55,50,5,0,0,0,0,7,7,7,7
Mono,11,2022-03-01,4,4,3,1,152,152,123,29,0,0,0,0,6,6,6,6
Monterey,11,2022-03-01,328,328,267,61,12949,12949,10550,2399,24,8,8,5,716,716,708,708
Napa,11,2022-03-01,182,182,166,16,5297,5297,4831,466,8,2,2,4,138,138,136,136
Nevada,11,2022-03-01,65,65,57,8,1947,1947,1704,243,9,1,1,1,128,128,127,127
Orange,11,2022-03-01,1589,1589,1465,124,121468,121484,112049,9435,180,45,45,37,7005,7005,6960,6960
Placer,11,2022-03-01,226,226,195,31,7986,7986,6909,1077,59,5,5,16,613,613,608,608
Plumas,11,2022-03-01,20,20,17,3,355,355,311,44,0,0,0,0,13,13,13,13
Riverside,11,2022-03-01,1508,1508,1354,154,59455,59462,53434,6028,178,40,40,33,6388,6388,6348,6348
Sacramento,11,2022-03-01,1050,1050,936,114,42588,42593,37981,4612,162,21,21,28,2983,2983,2962,2962
San Benito,11,2022-03-01,47,47,43,4,1678,1678,1527,151,0,0,0,1,91,91,91,91
San Bernardino,11,2022-03-01,1121,1121,1028,93,58268,58273,53421,4852,141,58,58,47,7695,7695,7637,7637
San Diego,11,2022-03-01,2808,2808,2705,103,98817,98830,95245,3585,342,35,35,75,5261,5261,5226,5226
San Francisco,11,2022-03-01,815,815,652,163,39193,39198,31354,7844,72,15,15,15,846,846,831,831
San Joaquin,11,2022-03-01,601,601,530,71,23532,23535,20770,2765,54,10,10,18,2220,2220,2210,2210
San Luis Obispo,11,2022-03-01,348,348,315,33,7780,7780,7053,727,12,4,4,1,460,460,456,456
San Mateo,11,2022-03-01,602,602,555,47,41494,41499,38299,3200,38,3,3,7,695,695,692,692
Santa Barbara,11,2022-03-01,336,336,301,35,19894,19895,17837,2058,41,5,5,10,670,670,665,665
Santa Clara,11,2022-03-01,1679,1679,1614,65,107685,107698,103603,4095,194,19,19,44,2258,2258,2239,2239
Santa Cruz,11,2022-03-01,404,404,368,36,26812,26816,24418,2398,19,1,1,3,256,256,255,255
Shasta,11,2022-03-01,147,147,131,16,4751,4751,4243,508,40,11,11,8,538,538,527,527
Siskiyou,11,2022-03-01,17,17,16,1,434,434,396,38,2,1,1,1,79,79,78,78
Solano,11,2022-03-01,451,451,405,46,15073,15073,13539,1534,46,3,3,18,444,444,441,441
Sonoma,11,2022-03-01,409,409,369,40,15900,15900,14335,1565,21,4,4,5,484,484,480,480
Stanislaus,11,2022-03-01,427,427,363,64,12161,12161,10345,1816,115,13,13,19,1656,1656,1643,1643
Sutter,11,2022-03-01,95,95,85,10,2193,2193,1967,226,0,2,2,0,221,221,219,219
Tehama,11,2022-03-01,59,59,51,8,1218,1218,1043,175,6,1,1,2,200,200,199,199
Trinity,11,2022-03-01,4,4,3,1,103,103,87,16,0,0,0,0,20,20,20,20
Tulare,11,2022-03-01,417,417,353,64,10871,10871,9219,1652,66,14,14,8,1466,1466,1452,1452
Tuolumne,11,2022-03-01,68,68,59,9,1429,1429,1249,180,9,3,3,1,181,181,178,178
Ventura,11,2022-03-01,493,493,458,35,28167,28171,26151,2020,64,7,7,12,1475,1475,1468,1468
Yolo,11,2022-03-01,200,200,181,19,24690,24693,22396,2297,7,5,5,5,354,354,349,349
Yuba,11,2022-03-01,71,71,64,7,1677,1677,1514,163,8,1,1,5,117,117,116,116
Alameda,12,2022-03-08,1080,1080,1009,71,72150,72159,67409,4750,79,13,13,16,1846,1846,1833,1833
Amador,12,2022-03-08,72,72,64,8,1421,1421,1273,148,6,1,1,1,86,86,85,85
Butte,12,2022-03-08,94,94,89,5,3741,3741,3541,200,27,4,4,3,426,426,422,422
Calaveras,12,2022-03-08,26,26,24,2,1075,1075,977,98,1,2,2,0,119,119,117,117
Colusa,12,2022-03-08,8,8,7,1,355,355,327,28,5,0,0,0,21,21,21,21
Contra Costa,12,2022-03-08,622,622,556,66,30706,30711,27450,3261,37,5,5,12,1287,1287,1282,1282
Del Norte,12,2022-03-08,49,49,45,4,1730,1730,1584,146,3,0,0,2,47,47,47,47
El Dorado,12,2022-03-08,73,73,66,7,3150,3150,2866,284,4,3,3,3,210,210,207,207
Fresno,12,2022-03-08,749,749,673,76,21950,21952,19756,2196,137,19,19,26,2729,2729,2710,2710
Glenn,12,2022-03-08,18,18,16,2,389,389,355,34,2,1,1,0,53,53,52,52
Humboldt,12,2022-03-08,79,79,72,7,2997,2997,2746,251,9,3,3,3,143,143,140,140
Imperial,12,2022-03-08,117,117,106,11,4663,4663,4240,423,15,2,2,9,938,938,936,936
Inyo,12,2022-03-08,12,12,11,1,261,261,240,21,0,0,0,0,56,56,56,56
Kern,12,2022-03-08,405,405,374,31,20343,20345,18804,1541,64,13,13,13,2319,2319,2306,2306
Kings,12,2022-03-08,191,191,174,17,4824,4824,4388,436,16,4,4,1,444,444,440,440
Lake,12,2022-03-08,64,64,57,7,1720,1720,1542,178,0,2,2,0,138,138,136,136
Lassen,12,2022-03-08,40,40,37,3,1659,1659,1541,118,1,0,0,0,62,62,62,62
Los Angeles,12,2022-03-08,5169,5169,5029,140,866765,866879,843315,23564,544,156,156,122,31525,31525,31369,31369
Madera,12,2022-03-08,117,117,105,12,3905,3905,3510,395,16,1,1,3,369,369,368,368
Marin,12,2022-03-08,166,166,150,16,7371,7371,6640,731,12,1,1,1,293,293,292,292
Mariposa,12,2022-03-08,9,9,8,1,274,274,244,30,0,1,1,0,27,27,26,26
Mendocino,12,2022-03-08,63,63,55,8,1590,1590,1383,207,7,0,0,0,121,121,121,121
Merced,12,2022-03-08,169,169,156,13,4382,4382,4038,344,17,7,7,4,809,809,802,802
Modoc,12,2022-03-08,0,0,0,0,47,47,43,4,1,0,0,0,7,7,7,7
Mono,12,2022-03-08,2,2,2,0,140,140,118,22,1,0,0,0,6,6,6,6
Monterey,12,2022-03-08,211,211,179,32,11084,11084,9426,1658,18,5,5,2,721,721,716,716
Napa,12,2022-03-08,201,201,187,14,4751,4751,4418,333,4,1,1,2,139,139,138,138
Nevada,12,2022-03-08,51,51,46,5,1639,1639,1475,164,5,1,1,0,129,129,128,128
Orange,12,2022-03-08,1173,1173,1101,72,105272,105287,98824,6463,130,25,25,29,7030,7030,7005,7005
Placer,12,2022-03-08,162,162,144,18,7689,7689,6855,834,52,4,4,10,617,617,613,613
Plumas,12,2022-03-08,7,7,6,1,267,267,241,26,0,0,0,0,13,13,13,13
Riverside,12,2022-03-08,915,915,841,74,53049,53054,48772,4282,123,24,24,24,6412,6412,6388,6388
Sacramento,12,2022-03-08,734,734,670,64,39502,39507,36096,3411,119,21,21,22,3004,3004,2983,2983
San Benito,12,2022-03-08,42,42,39,3,1512,1512,1404,108,0,2,2,2,93,93,91,91
San Bernardino,12,2022-03-08,713,713,666,47,54139,54144,50572,3572,99,40,40,36,7735,7735,7695,7695
San Diego,12,2022-03-08,2291,2291,2225,66,97722,97736,94958,2778,214,28,28,58,5289,5289,5261,5261
San Francisco,12,2022-03-08,652,652,546,106,36620,36625,30630,5995,59,6,6,10,852,852,846,846
San Joaquin,12,2022-03-08,406,406,368,38,21004,21006,19040,1966,25,11,11,16,2231,2231,2220,2220
San Luis Obispo,12,2022-03-08,229,229,212,17,7323,7323,6780,543,6,4,4,1,464,464,460,460
San Mateo,12,2022-03-08,507,507,476,31,39121,39126,36718,2408,31,2,2,3,697,697,695,695
Santa Barbara,12,2022-03-08,198,198,182,16,17478,17479,16041,1438,17,6,6,8,676,676,670,670
Santa Clara,12,2022-03-08,1383,1383,1341,42,110155,110170,106834,3336,137,12,12,38,2270,2270,2258,2258
Santa Cruz,12,2022-03-08,315,315,292,23,23921,23925,22227,1698,12,0,0,6,256,256,256,256
Shasta,12,2022-03-08,128,128,117,11,5038,5038,4607,431,22,7,7,3,545,545,538,538
Siskiyou,12,2022-03-08,13,13,12,1,396,396,368,28,1,2,2,0,81,81,79,79
Solano,12,2022-03-08,341,341,313,28,13651,13651,12543,1108,50,2,2,10,446,446,444,444
Sonoma,12,2022-03-08,298,298,274,24,14872,14872,13705,1167,21,2,2,7,486,486,484,484
Stanislaus,12,2022-03-08,251,251,221,30,10664,10664,9384,1280,85,8,8,12,1664,1664,1656,1656
Sutter,12,2022-03-08,79,79,72,7,1933,1933,1774,159,0,1,1,0,222,222,221,221
Tehama,12,2022-03-08,32,32,28,4,1064,1064,940,124,4,2,2,1,202,202,200,200
Trinity,12,2022-03-08,6,6,5,1,120,120,105,15,0,0,0,0,20,20,20,20
Tulare,12,2022-03-08,291,291,255,36,10284,10284,9027,1257,37,11,11,3,1477,1477,1466,1466
Tuolumne,12,2022-03-08,44,44,40,4,1250,1250,1124,126,2,0,0,1,181,181,181,181
Ventura,12,2022-03-08,384,384,362,22,26663,26668,25155,1513,44,4,4,9,1479,1479,1475,1475
Yolo,12,2022-03-08,147,147,136,11,22241,22244,20604,1640,3,2,2,2,356,356,354,354
Yuba,12,2022-03-08,51,51,47,4,1517,1517,1400,117,12,0,0,2,117,117,117,117
Alameda,13,2022-03-15,781,781,740,41,68345,68354,64803,3551,62,10,10,8,1856,1856,1846,1846
Amador,13,2022-03-15,34,34,31,3,1389,1389,1273,116,4,0,0,0,86,86,86,86
Butte,13,2022-03-15,83,83,79,4,3368,3368,3225,143,22,1,1,0,427,427,426,426
Calaveras,13,2022-03-15,14,14,13,1,887,887,822,65,0,0,0,1,119,119,119,119
Colusa,13,2022-03-15,5,5,5,0,248,248,232,16,2,0,0,0,21,21,21,21
Contra Costa,13,2022-03-15,559,559,512,47,28721,28726,26297,2429,18,6,6,11,1293,1293,1287,1287
Del Norte,13,2022-03-15,33,33,31,2,1408,1408,1314,94,3,2,2,1,49,49,47,47
El Dorado,13,2022-03-15,44,44,41,3,2931,2931,2721,210,4,1,1,0,211,211,210,210
Fresno,13,2022-03-15,507,507,466,41,20732,20734,19080,1654,116,7,7,19,2736,2736,2729,2729
Glenn,13,2022-03-15,10,10,9,1,345,345,321,24,1,0,0,0,53,53,53,53
Humboldt,13,2022-03-15,50,50,47,3,2537,2537,2367,170,3,1,1,2,144,144,143,143
Imperial,13,2022-03-15,63,63,58,5,4183,4183,3878,305,6,2,2,6,940,940,938,938
Inyo,13,2022-03-15,4,4,4,0,162,162,152,10,0,0,0,0,56,56,56,56
Kern,13,2022-03-15,272,272,255,17,20608,20610,19375,1235,39,12,12,10,2331,2331,2319,2319
Kings,13,2022-03-15,144,144,133,11,4751,4751,4410,341,14,1,1,1,445,445,444,444
Lake,13,2022-03-15,39,39,36,3,1532,1532,1405,127,3,1,1,0,139,139,138,138
Lassen,13,2022-03-15,4,4,4,0,1542,1542,1455,87,0,0,0,0,62,62,62,62
Los Angeles,13,2022-03-15,3893,3893,3810,83,845943,846070,828055,18015,409,108,108,90,31633,31633,31525,31525
Madera,13,2022-03-15,49,49,45,4,3537,3537,3252,285,10,0,0,1,369,369,369,369
Marin,13,2022-03-15,161,161,148,13,6449,6449,5943,506,6,1,1,0,294,294,293,293
Mariposa,13,2022-03-15,9,9,8,1,237,237,217,20,0,0,0,0,27,27,27,27
Mendocino,13,2022-03-15,33,33,30,3,1393,1393,1248,145,4,2,2,1,123,123,121,121
Merced,13,2022-03-15,113,113,106,7,4053,4053,3801,252,20,1,1,3,810,810,809,809
Modoc,13,2022-03-15,4,4,4,0,58,58,54,4,0,0,0,0,7,7,7,7
Mono,13,2022-03-15,3,3,3,0,103,103,90,13,0,0,0,0,6,6,6,6
Monterey,13,2022-03-15,137,137,120,17,10177,10177,8955,1222,13,3,3,1,724,724,721,721
Napa,13,2022-03-15,105,105,99,6,3943,3943,3724,219,5,1,1,3,140,140,139,139
Nevada,13,2022-03-15,45,45,41,4,1577,1577,1452,125,3,0,0,0,129,129,129,129
Orange,13,2022-03-15,788,788,750,38,101284,101300,96389,4911,104,30,30,29,7060,7060,7030,7030
Placer,13,2022-03-15,137,137,125,12,7184,7184,6561,623,46,1,1,4,618,618,617,617
Plumas,13,2022-03-15,4,4,4,0,297,297,273,24,0,0,0,0,13,13,13,13
Riverside,13,2022-03-15,746,746,698,48,53613,53621,50198,3423,84,11,11,16,6423,6423,6412,6412
Sacramento,13,2022-03-15,569,569,530,39,34640,34645,32267,2378,118,17,17,21,3021,3021,3004,3004
San Benito,13,2022-03-15,35,35,33,2,1449,1449,1367,82,0,0,0,1,93,93,93,93
San Bernardino,13,2022-03-15,551,551,522,29,50993,51000,48342,2658,75,23,23,30,7758,7758,7735,7735
San Diego,13,2022-03-15,1804,1804,1763,41,92997,93011,90929,2082,177,17,17,42,5306,5306,5289,5289
San Francisco,13,2022-03-15,587,587,510,77,34378,34383,29837,4546,35,6,6,10,858,858,852,852
San Joaquin,13,2022-03-15,256,256,237,19,17775,17778,16442,1336,22,5,5,8,2236,2236,2231,2231
San Luis Obispo,13,2022-03-15,145,145,136,9,6744,6744,6349,395,7,9,9,1,473,473,464,464
San Mateo,13,2022-03-15,438,438,417,21,35258,35263,33545,1718,30,0,0,3,697,697,697,697
Santa Barbara,13,2022-03-15,194,194,181,13,16529,16531,15446,1085,19,5,5,1,681,681,676,676
Santa Clara,13,2022-03-15,1173,1173,1145,28,97869,97885,95561,2324,107,11,11,29,2281,2281,2270,2270
Santa Cruz,13,2022-03-15,227,227,214,13,21900,21904,20671,1233,10,3,3,3,259,259,256,256
Shasta,13,2022-03-15,89,89,83,6,4638,4638,4321,317,20,6,6,2,551,551,545,545
Siskiyou,13,2022-03-15,10,10,9,1,380,380,359,21,2,2,2,0,83,83,81,81
Solano,13,2022-03-15,213,213,199,14,12245,12245,11457,788,31,1,1,5,447,447,446,446
Sonoma,13,2022-03-15,218,218,204,14,13029,13030,12218,812,9,2,2,4,488,488,486,486
Stanislaus,13,2022-03-15,212,212,191,21,9171,9171,8286,885,80,11,11,15,1675,1675,1664,1664
Sutter,13,2022-03-15,36,36,34,2,1626,1626,1519,107,0,1,1,0,223,223,222,222
Tehama,13,2022-03-15,14,14,13,1,977,977,886,91,2,3,3,0,205,205,202,202
Trinity,13,2022-03-15,1,1,1,0,98,98,88,10,0,0,0,0,20,20,20,20
Tulare,13,2022-03-15,163,163,147,16,9031,9031,8145,886,32,1,1,6,1478,1478,1477,1477
Tuolumne,13,2022-03-15,17,17,16,1,1250,1250,1150,100,3,0,0,1,181,181,181,181
Ventura,13,2022-03-15,328,328,313,15,24384,24388,23296,1092,40,7,7,6,1486,1486,1479,1479
Yolo,13,2022-03-15,111,111,104,7,21808,21812,20541,1271,1,3,3,2,359,359,356,356
Yuba,13,2022-03-15,40,40,38,2,1350,1350,1267,83,6,0,0,3,117,117,117,117
Alameda,14,2022-03-22,837,837,803,34,64530,64544,61891,2653,55,5,5,4,1861,1861,1856,1856
Amador,14,2022-03-22,27,27,25,2,1435,1435,1340,95,2,0,0,0,86,86,86,86
Butte,14,2022-03-22,76,76,73,3,3150,3150,3045,105,19,0,0,1,427,427,427,427
Calaveras,14,2022-03-22,8,8,8,0,630,630,594,36,0,0,0,0,119,119,119,119
Colusa,14,2022-03-22,2,2,2,0,229,229,217,12,0,0,0,0,21,21,21,21
Contra Costa,14,2022-03-22,438,438,409,29,26226,26231,24462,1769,36,6,6,5,1299,1299,1293,1293
Del Norte,14,2022-03-22,14,14,13,1,1177,1177,1115,62,0,0,0,0,49,49,49,49
El Dorado,14,2022-03-22,51,51,48,3,2806,2806,2647,159,2,2,2,0,213,213,211,211
Fresno,14,2022-03-22,323,323,303,20,18991,18996,17794,1202,91,12,12,13,2748,2748,2736,2736
Glenn,14,2022-03-22,7,7,7,0,376,376,355,21,0,0,0,0,53,53,53,53
Humboldt,14,2022-03-22,34,34,32,2,2561,2561,2427,134,6,1,1,2,145,145,144,144
Imperial,14,2022-03-22,60,60,57,3,3987,3987,3758,229,5,3,3,3,943,943,940,940
Inyo,14,2022-03-22,2,2,2,0,155,155,147,8,0,0,0,0,56,56,56,56
Kern,14,2022-03-22,204,204,194,10,19072,19077,18176,901,31,6,6,8,2337,2337,2331,2331
Kings,14,2022-03-22,75,75,71,4,4377,4377,4129,248,7,1,1,1,446,446,445,445
Lake,14,2022-03-22,17,17,16,1,1349,1349,1260,89,0,0,0,0,139,139,139,139
Lassen,14,2022-03-22,11,11,10,1,1437,1437,1373,64,0,0,0,0,62,62,62,62
Los Angeles,14,2022-03-22,4358,4358,4286,72,807406,807568,794091,13477,324,73,73,54,31706,31706,31633,31633
Madera,14,2022-03-22,39,39,36,3,3357,3357,3142,215,9,1,1,1,370,370,369,369
Marin,14,2022-03-22,149,149,140,9,6286,6286,5894,392,6,1,1,0,295,295,294,294
Mariposa,14,2022-03-22,7,7,7,0,205,205,191,14,0,0,0,0,27,27,27,27
Mendocino,14,2022-03-22,31,31,28,3,1519,1519,1393,126,3,0,0,1,123,123,123,123
Merced,14,2022-03-22,80,80,76,4,3650,3650,3470,180,14,5,5,2,815,815,810,810
Modoc,14,2022-03-22,3,3,3,0,59,59,56,3,0,0,0,0,7,7,7,7
Mono,14,2022-03-22,3,3,3,0,138,138,124,14,0,0,0,0,6,6,6,6
Monterey,14,2022-03-22,186,186,168,18,9564,9564,8639,925,23,0,0,2,724,724,724,724
Napa,14,2022-03-22,48,48,46,2,3395,3395,3247,148,5,1,1,3,141,141,140,140
Nevada,14,2022-03-22,20,20,19,1,1481,1481,1388,93,2,0,0,0,129,129,129,129
Orange,14,2022-03-22,771,771,742,29,93888,93907,90313,3594,97,14,14,26,7074,7074,7060,7060
Placer,14,2022-03-22,114,114,106,8,6320,6320,5885,435,36,3,3,8,621,621,618,618
Plumas,14,2022-03-22,2,2,2,0,249,249,234,15,0,0,0,0,13,13,13,13
Riverside,14,2022-03-22,563,563,534,29,49498,49509,46987,2522,66,12,12,15,6435,6435,6423,6423
Sacramento,14,2022-03-22,469,469,444,25,32559,32564,30799,1765,90,9,9,12,3030,3030,3021,3021
San Benito,14,2022-03-22,20,20,19,1,1373,1373,1312,61,0,1,1,0,94,94,93,93
San Bernardino,14,2022-03-22,474,474,455,19,47304,47315,45354,1961,41,20,20,28,7778,7778,7758,7758
San Diego,14,2022-03-22,1293,1293,1270,23,81250,81266,79837,1429,132,15,15,39,5321,5321,5306,5306
San Francisco,14,2022-03-22,764,764,684,80,33158,33163,29642,3521,32,3,3,7,861,861,858,858
San Joaquin,14,2022-03-22,208,208,195,13,15323,15325,14418,907,18,7,7,6,2243,2243,2236,2236
San Luis Obispo,14,2022-03-22,104,104,99,5,5973,5973,5695,278,4,4,4,0,477,477,473,473
San Mateo,14,2022-03-22,455,455,438,17,34856,34863,33529,1334,31,1,1,3,698,698,697,697
Santa Barbara,14,2022-03-22,138,138,131,7,12707,12709,12034,675,16,6,6,2,687,687,681,681
Santa Clara,14,2022-03-22,1169,1169,1147,22,94153,94172,92418,1754,100,6,6,24,2287,2287,2281,2281
Santa Cruz,14,2022-03-22,182,182,174,8,19876,19880,18996,884,8,0,0,2,259,259,259,259
Shasta,14,2022-03-22,42,42,40,2,4039,4039,3821,218,9,5,5,2,556,556,551,551
Siskiyou,14,2022-03-22,4,4,4,0,341,341,326,15,1,0,0,1,83,83,83,83
Solano,14,2022-03-22,166,166,158,8,11458,11459,10877,582,22,1,1,5,448,448,447,447
Sonoma,14,2022-03-22,239,239,227,12,10821,10821,10277,544,13,1,1,1,489,489,488,488
Stanislaus,14,2022-03-22,142,142,131,11,8251,8251,7618,633,55,10,10,9,1685,1685,1675,1675
Sutter,14,2022-03-22,31,31,29,2,1536,1536,1457,79,0,1,1,0,224,224,223,223
Tehama,14,2022-03-22,12,12,11,1,913,913,845,68,2,0,0,0,205,205,205,205
Trinity,14,2022-03-22,0,0,0,0,105,105,97,8,0,0,0,0,20,20,20,20
Tulare,14,2022-03-22,102,102,94,8,8142,8142,7507,635,25,4,4,2,1482,1482,1478,1478
Tuolumne,14,2022-03-22,18,18,17,1,1128,1128,1056,72,2,0,0,0,181,181,181,181
Ventura,14,2022-03-22,306,306,295,11,22593,22598,21799,799,30,3,3,5,1489,1489,1486,1486
Yolo,14,2022-03-22,107,107,102,5,20237,20242,19301,941,1,0,0,1,359,359,359,359
Yuba,14,2022-03-22,33,33,31,2,1308,1308,1244,64,4,0,0,1,117,117,117,117
Alameda,15,2022-03-29,852,852,825,27,58637,58651,56764,1887,41,4,4,3,1865,1865,1861,1861
Amador,15,2022-03-29,6,6,6,0,1320,1320,1251,69,3,0,0,0,86,86,86,86
Butte,15,2022-03-29,70,70,68,2,2834,2834,2760,74,9,0,0,1,427,427,427,427
Calaveras,15,2022-03-29,14,14,13,1,589,589,563,26,0,0,0,0,119,119,119,119
Colusa,15,2022-03-29,4,4,4,0,203,203,195,8,0,0,0,0,21,21,21,21
Contra Costa,15,2022-03-29,550,550,521,29,25135,25140,23804,1336,22,0,0,6,1299,1299,1299,1299
Del Norte,15,2022-03-29,17,17,16,1,1012,1012,970,42,1,0,0,0,49,49,49,49
El Dorado,15,2022-03-29,56,56,54,2,2808,2808,2683,125,0,0,0,0,213,213,213,213
Fresno,15,2022-03-29,254,254,241,13,17642,17647,16764,883,75,5,5,19,2753,2753,2748,2748
Glenn,15,2022-03-29,7,7,7,0,311,311,298,13,0,0,0,0,53,53,53,53
Humboldt,15,2022-03-29,18,18,17,1,2545,2545,2440,105,3,0,0,3,145,145,145,145
Imperial,15,2022-03-29,60,60,57,3,3480,3480,3323,157,5,1,1,3,944,944,943,943
Inyo,15,2022-03-29,4,4,4,0,186,186,179,7,0,0,0,0,56,56,56,56
Kern,15,2022-03-29,137,137,132,5,17930,17935,17267,668,22,2,2,7,2339,2339,2337,2337
Kings,15,2022-03-29,56,56,53,3,4273,4273,4082,191,4,2,2,0,448,448,446,446
Lake,15,2022-03-29,10,10,9,1,1016,1016,963,53,0,0,0,0,139,139,139,139
Lassen,15,2022-03-29,3,3,3,0,1264,1264,1220,44,0,0,0,0,62,62,62,62
Los Angeles,15,2022-03-29,4485,4485,4427,58,725624,725804,716295,9509,274,55,55,51,31761,31761,31706,31706
Madera,15,2022-03-29,22,22,21,1,3335,3335,3166,169,3,0,0,1,370,370,370,370
Marin,15,2022-03-29,161,161,153,8,5922,5922,5632,290,2,0,0,0,295,295,295,295
Mariposa,15,2022-03-29,5,5,5,0,185,185,175,10,0,1,1,0,28,28,27,27
Mendocino,15,2022-03-29,25,25,23,2,1289,1289,1204,85,0,1,1,0,124,124,123,123
Merced,15,2022-03-29,62,62,60,2,3394,3394,3263,131,6,1,1,2,816,816,815,815
Modoc,15,2022-03-29,2,2,2,0,42,42,40,2,0,0,0,0,7,7,7,7
Mono,15,2022-03-29,1,1,1,0,144,144,133,11,0,0,0,0,6,6,6,6
Monterey,15,2022-03-29,132,132,122,10,8344,8344,7696,648,12,2,2,0,726,726,724,724
Napa,15,2022-03-29,66,66,64,2,3301,3301,3188,113,3,2,2,1,143,143,141,141
Nevada,15,2022-03-29,25,25,24,1,1447,1447,1375,72,1,1,1,0,130,130,129,129
Orange,15,2022-03-29,788,788,764,24,90598,90621,87902,2719,85,10,10,17,7084,7084,7074,7074
Placer,15,2022-03-29,107,107,101,6,6244,6244,5905,339,32,3,3,5,624,624,621,621
Plumas,15,2022-03-29,4,4,4,0,248,248,236,12,0,0,0,0,13,13,13,13
Riverside,15,2022-03-29,541,541,520,21,43324,43336,41604,1732,44,9,9,10,6444,6444,6435,6435
Sacramento,15,2022-03-29,436,436,417,19,32607,32614,31223,1391,62,6,6,17,3036,3036,3030,3030
San Benito,15,2022-03-29,8,8,8,0,1352,1352,1305,47,0,0,0,0,94,94,94,94
San Bernardino,15,2022-03-29,539,539,522,17,41942,41953,40598,1355,42,17,17,19,7795,7795,7778,7778
San Diego,15,2022-03-29,1340,1340,1322,18,70190,70207,69242,965,107,9,9,27,5330,5330,5321,5321
San Francisco,15,2022-03-29,817,817,749,68,32011,32018,29300,2718,24,4,4,4,865,865,861,861
San Joaquin,15,2022-03-29,194,194,185,9,17942,17946,17105,841,18,3,3,4,2246,2246,2243,2243
San Luis Obispo,15,2022-03-29,96,96,93,3,5864,5864,5650,214,5,0,0,1,477,477,477,477
San Mateo,15,2022-03-29,539,539,523,16,32458,32466,31484,982,28,3,3,3,701,701,698,698
Santa Barbara,15,2022-03-29,147,147,141,6,11791,11793,11320,473,12,0,0,5,687,687,687,687
Santa Clara,15,2022-03-29,1243,1243,1225,18,95942,95966,94574,1392,85,10,10,18,2297,2297,2287,2287
Santa Cruz,15,2022-03-29,142,142,137,5,20021,20025,19332,693,4,0,0,2,259,259,259,259
Shasta,15,2022-03-29,29,29,28,1,3787,3787,3626,161,4,3,3,4,559,559,556,556
Siskiyou,15,2022-03-29,6,6,6,0,286,286,276,10,0,0,0,0,83,83,83,83
Solano,15,2022-03-29,169,169,162,7,10926,10928,10492,436,18,0,0,6,448,448,448,448
Sonoma,15,2022-03-29,263,263,253,10,9353,9355,8996,359,11,1,1,1,490,490,489,489
Stanislaus,15,2022-03-29,96,96,90,6,8449,8451,7940,511,33,2,2,2,1687,1687,1685,1685
Sutter,15,2022-03-29,28,28,27,1,1387,1387,1330,57,0,0,0,0,224,224,224,224
Tehama,15,2022-03-29,9,9,8,1,771,771,726,45,0,2,2,0,207,207,205,205
Trinity,15,2022-03-29,0,0,0,0,71,71,67,4,0,0,0,0,20,20,20,20
Tulare,15,2022-03-29,73,73,68,5,7905,7905,7418,487,16,6,6,0,1488,1488,1482,1482
Tuolumne,15,2022-03-29,7,7,7,0,1000,1000,949,51,1,1,1,0,182,182,181,181
Ventura,15,2022-03-29,303,303,295,8,21240,21245,20656,589,22,6,6,3,1495,1495,1489,1489
Yolo,15,2022-03-29,105,105,101,4,22742,22749,21941,808,3,2,2,0,361,361,359,359
Yuba,15,2022-03-29,24,24,23,1,1151,1151,1107,44,3,2,2,1,119,119,117,117
Alameda,16,2022-04-05,1133,1133,1105,28,53916,53934,52562,1372,39,3,3,4,1868,1868,1865,1865
Amador,16,2022-04-05,2,2,2,0,1079,1079,1035,44,1,0,0,0,86,86,86,86
Butte,16,2022-04-05,33,33,32,1,2443,2443,2393,50,6,2,2,1,429,429,427,427
Calaveras,16,2022-04-05,8,8,8,0,580,580,559,21,0,0,0,0,119,119,119,119
Colusa,16,2022-04-05,3,3,3,0,204,204,198,6,0,0,0,0,21,21,21,21
Contra Costa,16,2022-04-05,564,564,541,23,22111,22116,21182,934,20,1,1,6,1300,1300,1299,1299
Del Norte,16,2022-04-05,6,6,6,0,1128,1128,1091,37,0,0,0,1,49,49,49,49
El Dorado,16,2022-04-05,47,47,45,2,2669,2669,2575,94,0,1,1,1,214,214,213,213
Fresno,16,2022-04-05,178,178,171,7,16495,16500,15850,650,58,3,3,11,2756,2756,2753,2753
Glenn,16,2022-04-05,3,3,3,0,284,284,274,10,0,0,0,0,53,53,53,53
Humboldt,16,2022-04-05,30,30,29,1,2348,2348,2271,77,6,0,0,2,145,145,145,145
Imperial,16,2022-04-05,33,33,32,1,3451,3451,3328,123,4,0,0,2,944,944,944,944
Inyo,16,2022-04-05,8,8,8,0,187,187,181,6,0,0,0,0,56,56,56,56
Kern,16,2022-04-05,149,149,145,4,16895,16900,16406,494,14,2,2,5,2341,2341,2339,2339
Kings,16,2022-04-05,40,40,39,1,4120,4120,3975,145,4,0,0,1,448,448,448,448
Lake,16,2022-04-05,17,17,16,1,1013,1013,972,41,0,0,0,0,139,139,139,139
Lassen,16,2022-04-05,5,5,5,0,1283,1283,1248,35,0,0,0,0,62,62,62,62
Los Angeles,16,2022-04-05,5687,5687,5630,57,771613,771860,763966,7894,250,42,42,42,31803,31803,31761,31761
Madera,16,2022-04-05,27,27,26,1,3164,3164,3037,127,2,0,0,1,370,370,370,370
Marin,16,2022-04-05,159,159,153,6,6103,6103,5864,239,4,0,0,1,295,295,295,295
Mariposa,16,2022-04-05,7,7,7,0,246,246,236,10,0,0,0,0,28,28,28,28
Mendocino,16,2022-04-05,29,29,27,2,1189,1189,1127,62,1,0,0,0,124,124,124,124
Merced,16,2022-04-05,59,59,57,2,3231,3231,3133,98,4,2,2,0,818,818,816,816
Modoc,16,2022-04-05,3,3,3,0,46,46,45,1,0,0,0,0,7,7,7,7
Mono,16,2022-04-05,1,1,1,0,127,127,119,8,0,0,0,0,6,6,6,6
Monterey,16,2022-04-05,111,111,104,7,7343,7344,6893,451,11,3,3,0,729,729,726,726
Napa,16,2022-04-05,86,86,84,2,3068,3068,2985,83,2,0,0,1,143,143,143,143
Nevada,16,2022-04-05,32,32,31,1,1463,1463,1406,57,2,1,1,0,131,131,130,130
Orange,16,2022-04-05,1025,1025,1001,24,73861,73884,72117,1767,56,17,17,11,7101,7101,7084,7084
Placer,16,2022-04-05,119,119,114,5,6524,6524,6243,281,19,2,2,5,626,626,624,624
Plumas,16,2022-04-05,4,4,4,0,248,248,238,10,0,0,0,0,13,13,13,13
Riverside,16,2022-04-05,684,684,663,21,38309,38323,37123,1200,40,3,3,7,6447,6447,6444,6444
Sacramento,16,2022-04-05,453,453,438,15,32783,32793,31692,1101,58,11,11,10,3047,3047,3036,3036
San Benito,16,2022-04-05,16,16,16,0,1161,1161,1129,32,0,0,0,0,94,94,94,94
San Bernardino,16,2022-04-05,669,669,652,17,41790,41804,40744,1060,27,12,12,14,7807,7807,7795,7795
San Diego,16,2022-04-05,1628,1628,1611,17,68275,68297,67569,728,80,8,8,30,5338,5338,5330,5330
San Francisco,16,2022-04-05,1060,1060,990,70,28666,28676,26754,1922,19,5,5,4,870,870,865,865
San Joaquin,16,2022-04-05,224,224,216,8,15676,15681,15108,573,8,2,2,5,2248,2248,2246,2246
San Luis Obispo,16,2022-04-05,97,97,94,3,5232,5232,5082,150,3,2,2,1,479,479,477,477
San Mateo,16,2022-04-05,747,747,730,17,30284,30293,29581,712,13,3,3,1,704,704,701,701
Santa Barbara,16,2022-04-05,205,205,199,6,15223,15228,14738,490,8,2,2,1,689,689,687,687
Santa Clara,16,2022-04-05,1532,1532,1515,17,84903,84929,83962,967,85,1,1,17,2298,2298,2297,2297
Santa Cruz,16,2022-04-05,224,224,218,6,13622,13626,13242,384,7,0,0,1,259,259,259,259
Shasta,16,2022-04-05,31,31,30,1,3305,3305,3194,111,4,0,0,2,559,559,559,559
Siskiyou,16,2022-04-05,1,1,1,0,304,304,296,8,0,0,0,0,83,83,83,83
Solano,16,2022-04-05,191,191,185,6,9874,9877,9567,310,19,1,1,4,449,449,448,448
Sonoma,16,2022-04-05,338,338,328,10,10789,10792,10463,329,5,0,0,1,490,490,490,490
Stanislaus,16,2022-04-05,122,122,116,6,7798,7800,7430,370,23,3,3,4,1690,1690,1687,1687
Sutter,16,2022-04-05,21,21,20,1,1324,1324,1282,42,0,0,0,0,224,224,224,224
Tehama,16,2022-04-05,8,8,8,0,778,778,742,36,0,0,0,0,207,207,207,207
Trinity,16,2022-04-05,1,1,1,0,84,84,80,4,0,0,0,0,20,20,20,20
Tulare,16,2022-04-05,45,45,43,2,7693,7695,7321,374,13,4,4,0,1492,1492,1488,1488
Tuolumne,16,2022-04-05,17,17,16,1,1122,1122,1078,44,0,1,1,0,183,183,182,182
Ventura,16,2022-04-05,300,300,293,7,19527,19532,19105,427,17,6,6,4,1501,1501,1495,1495
Yolo,16,2022-04-05,100,100,97,3,23989,23994,23303,691,0,0,0,0,361,361,361,361
Yuba,16,2022-04-05,13,13,13,0,1062,1062,1030,32,4,0,0,1,119,119,119,119
Alameda,17,2022-04-12,1554,1554,1524,30,51900,51921,50899,1022,52,6,6,4,1874,1874,1868,1868
Amador,17,2022-04-12,9,9,9,0,1101,1101,1065,36,1,0,0,0,86,86,86,86
Butte,17,2022-04-12,40,40,39,1,2293,2293,2256,37,5,0,0,1,429,429,429,429
Calaveras,17,2022-04-12,17,17,17,0,647,647,629,18,0,0,0,0,119,119,119,119
Colusa,17,2022-04-12,7,7,7,0,206,206,201,5,0,0,0,0,21,21,21,21
Contra Costa,17,2022-04-12,781,781,756,25,21845,21854,21140,714,21,1,1,4,1301,1301,1300,1300
Del Norte,17,2022-04-12,10,10,10,0,1032,1032,1006,26,0,0,0,0,49,49,49,49
El Dorado,17,2022-04-12,56,56,54,2,2494,2494,2425,69,1,0,0,0,214,214,214,214
Fresno,17,2022-04-12,200,200,194,6,15000,15006,14538,468,53,3,3,6,2759,2759,2756,2756
Glenn,17,2022-04-12,2,2,2,0,259,259,252,7,0,0,0,0,53,53,53,53
Humboldt,17,2022-04-12,53,53,52,1,2325,2325,2265,60,6,1,1,2,146,146,145,145
Imperial,17,2022-04-12,28,28,27,1,3437,3437,3341,96,3,1,1,1,945,945,944,944
Inyo,17,2022-04-12,4,4,4,0,176,176,172,4,0,0,0,0,56,56,56,56
Kern,17,2022-04-12,137,137,134,3,15632,15637,15275,362,16,2,2,6,2343,2343,2341,2341
Kings,17,2022-04-12,29,29,28,1,3970,3970,3859,111,4,0,0,0,448,448,448,448
Lake,17,2022-04-12,18,18,17,1,806,806,780,26,0,0,0,1,139,139,139,139
Lassen,17,2022-04-12,1,1,1,0,1294,1294,1266,28,1,0,0,0,62,62,62,62
Los Angeles,17,2022-04-12,6894,6896,6842,54,610985,611240,606263,4977,221,47,47,35,31850,31850,31803,31803
Madera,17,2022-04-12,32,32,31,1,2960,2960,2867,93,5,0,0,1,370,370,370,370
Marin,17,2022-04-12,255,255,247,8,5659,5660,5488,172,6,0,0,1,295,295,295,295
Mariposa,17,2022-04-12,7,7,7,0,231,231,223,8,0,0,0,0,28,28,28,28
Mendocino,17,2022-04-12,30,30,29,1,1114,1114,1068,46,2,0,0,0,124,124,124,124
Merced,17,2022-04-12,68,68,66,2,3203,3203,3127,76,5,2,2,1,820,820,818,818
Modoc,17,2022-04-12,0,0,0,0,37,37,36,1,0,0,0,0,7,7,7,7
Mono,17,2022-04-12,10,10,10,0,174,174,165,9,0,0,0,0,6,6,6,6
Monterey,17,2022-04-12,113,113,107,6,6791,6793,6463,330,9,1,1,0,730,730,729,729
Napa,17,2022-04-12,120,120,117,3,2775,2775,2716,59,1,0,0,0,143,143,143,143
Nevada,17,2022-04-12,45,45,44,1,1394,1394,1351,43,2,0,0,1,131,131,131,131
Orange,17,2022-04-12,1205,1205,1183,22,68601,68630,67389,1241,65,7,7,13,7108,7108,7101,7101
Placer,17,2022-04-12,138,138,133,5,5412,5412,5227,185,18,1,1,2,627,627,626,626
Plumas,17,2022-04-12,8,8,8,0,231,231,224,7,0,0,0,0,13,13,13,13
Riverside,17,2022-04-12,764,764,745,19,37795,37811,36882,929,42,6,6,7,6453,6453,6447,6447
Sacramento,17,2022-04-12,515,515,501,14,29058,29071,28303,768,46,9,9,4,3056,3056,3047,3047
San Benito,17,2022-04-12,14,14,14,0,1207,1207,1181,26,0,0,0,0,94,94,94,94
San Bernardino,17,2022-04-12,928,928,910,18,41992,42011,41175,836,36,6,6,6,7813,7813,7807,7807
San Diego,17,2022-04-12,1840,1840,1825,15,73684,73716,73099,617,84,2,2,22,5340,5340,5338,5338
San Francisco,17,2022-04-12,1212,1212,1148,64,30219,30233,28625,1608,20,2,2,4,872,872,870,870
San Joaquin,17,2022-04-12,233,233,226,7,15213,15220,14782,438,7,0,0,6,2248,2248,2248,2248
San Luis Obispo,17,2022-04-12,120,120,117,3,4836,4837,4728,109,1,0,0,0,479,479,479,479
San Mateo,17,2022-04-12,910,910,893,17,29210,29224,28682,542,8,1,1,3,705,705,704,704
Santa Barbara,17,2022-04-12,307,307,299,8,14954,14959,14581,378,5,2,2,0,691,691,689,689
Santa Clara,17,2022-04-12,1738,1738,1723,15,81176,81212,80492,720,68,5,5,14,2303,2303,2298,2298
Santa Cruz,17,2022-04-12,376,376,368,8,13462,13467,13186,281,4,1,1,1,260,260,259,259
Shasta,17,2022-04-12,20,20,19,1,2969,2969,2890,79,3,1,1,1,560,560,559,559
Siskiyou,17,2022-04-12,1,1,1,0,347,347,340,7,0,0,0,0,83,83,83,83
Solano,17,2022-04-12,231,231,225,6,9477,9482,9248,234,14,0,0,1,449,449,449,449
Sonoma,17,2022-04-12,430,430,420,10,11034,11039,10776,263,11,1,1,2,491,491,490,490
Stanislaus,17,2022-04-12,138,138,133,5,7692,7694,7406,288,12,1,1,4,1691,1691,1690,1690
Sutter,17,2022-04-12,20,20,19,1,1224,1224,1193,31,0,1,1,0,225,225,224,224
Tehama,17,2022-04-12,8,8,8,0,738,738,711,27,1,0,0,0,207,207,207,207
Trinity,17,2022-04-12,0,0,0,0,81,81,78,3,0,0,0,0,20,20,20,20
Tulare,17,2022-04-12,60,60,58,2,7539,7542,7251,291,9,2,2,0,1494,1494,1492,1492
Tuolumne,17,2022-04-12,18,18,17,1,1021,1021,989,32,1,0,0,0,183,183,183,183
Ventura,17,2022-04-12,342,342,336,6,17550,17556,17256,300,12,1,1,2,1502,1502,1501,1501
Yolo,17,2022-04-12,153,153,150,3,18600,18607,18194,413,1,0,0,0,361,361,361,361
Yuba,17,2022-04-12,15,15,15,0,999,999,975,24,2,0,0,0,119,119,119,119
Alameda,18,2022-04-19,1876,1876,1847,29,53111,53140,52315,825,46,4,4,4,1878,1878,1874,1874
Amador,18,2022-04-19,12,12,12,0,1217,1217,1186,31,0,0,0,1,86,86,86,86
Butte,18,2022-04-19,38,38,38,0,2300,2300,2271,29,6,2,2,0,431,431,429,429
Calaveras,18,2022-04-19,17,17,17,0,598,598,585,13,0,1,1,0,120,120,119,119
Colusa,18,2022-04-19,2,2,2,0,154,154,151,3,0,0,0,0,21,21,21,21
Contra Costa,18,2022-04-19,1117,1117,1088,29,24717,24730,24088,642,24,1,1,4,1302,1302,1301,1301
Del Norte,18,2022-04-19,17,17,17,0,1013,1013,993,20,0,0,0,0,49,49,49,49
El Dorado,18,2022-04-19,71,71,69,2,2512,2512,2458,54,1,0,0,0,214,214,214,214
Fresno,18,2022-04-19,268,268,262,6,14391,14399,14051,348,36,5,5,5,2764,2764,2759,2759
Glenn,18,2022-04-19,3,3,3,0,278,278,272,6,0,0,0,0,53,53,53,53
Humboldt,18,2022-04-19,121,121,119,2,2133,2133,2091,42,3,1,1,2,147,147,146,146
Imperial,18,2022-04-19,56,56,55,1,3254,3254,3183,71,2,0,0,1,945,945,945,945
Inyo,18,2022-04-19,2,2,2,0,174,174,171,3,0,0,0,0,56,56,56,56
Kern,18,2022-04-19,170,170,167,3,14903,14910,14645,265,9,1,1,6,2344,2344,2343,2343
Kings,18,2022-04-19,45,45,44,1,3844,3845,3762,83,1,1,1,1,449,449,448,448
Lake,18,2022-04-19,19,19,19,0,790,790,770,20,3,1,1,0,140,140,139,139
Lassen,18,2022-04-19,1,1,1,0,1366,1366,1343,23,0,0,0,0,62,62,62,62
Los Angeles,18,2022-04-19,8890,8895,8841,54,559659,559958,556594,3364,202,33,33,28,31883,31883,31850,31850
Madera,18,2022-04-19,24,24,23,1,2637,2637,2572,65,4,0,0,2,370,370,370,370
Marin,18,2022-04-19,327,327,319,8,6062,6066,5920,146,7,0,0,0,295,295,295,295
Mariposa,18,2022-04-19,19,19,19,0,253,253,246,7,0,0,0,0,28,28,28,28
Mendocino,18,2022-04-19,66,66,64,2,1312,1312,1269,43,2,1,1,0,125,125,124,124
Merced,18,2022-04-19,67,67,66,1,2999,2999,2943,56,2,2,2,0,822,822,820,820
Modoc,18,2022-04-19,2,2,2,0,42,42,41,1,0,0,0,0,7,7,7,7
Mono,18,2022-04-19,9,9,9,0,127,127,122,5,0,0,0,0,6,6,6,6
Monterey,18,2022-04-19,211,211,203,8,6723,6726,6471,255,2,1,1,0,731,731,730,730
Napa,18,2022-04-19,183,183,180,3,3082,3082,3031,51,1,0,0,0,143,143,143,143
Nevada,18,2022-04-19,47,47,46,1,1285,1285,1254,31,3,0,0,0,131,131,131,131
Orange,18,2022-04-19,1526,1526,1504,22,79355,79397,78254,1143,51,6,6,15,7114,7114,7108,7108
Placer,18,2022-04-19,173,173,168,5,5046,5048,4915,133,24,0,0,3,627,627,627,627
Plumas,18,2022-04-19,4,4,4,0,230,230,224,6,0,0,0,0,13,13,13,13
Riverside,18,2022-04-19,1020,1020,1001,19,37368,37387,36668,719,41,6,6,6,6459,6459,6453,6453
Sacramento,18,2022-04-19,772,772,756,16,28602,28617,28028,589,47,8,8,9,3064,3064,3056,3056
San Benito,18,2022-04-19,29,29,29,0,1171,1171,1151,20,0,0,0,0,94,94,94,94
San Bernardino,18,2022-04-19,1118,1118,1101,17,40133,40155,39531,624,31,4,4,11,7817,7817,7813,7813
San Diego,18,2022-04-19,2190,2190,2176,14,67413,67449,67010,439,84,11,11,16,5351,5351,5340,5340
San Francisco,18,2022-04-19,1528,1528,1465,63,31046,31063,29762,1301,22,2,2,5,874,874,872,872
San Joaquin,18,2022-04-19,269,269,263,6,15073,15080,14741,339,11,1,1,4,2249,2249,2248,2248
San Luis Obispo,18,2022-04-19,186,186,183,3,4983,4985,4897,88,2,2,2,1,481,481,479,479
San Mateo,18,2022-04-19,1196,1196,1179,17,31209,31226,30774,452,12,2,2,2,707,707,705,705
Santa Barbara,18,2022-04-19,321,321,315,6,14672,14679,14388,291,8,0,0,0,691,691,691,691
Santa Clara,18,2022-04-19,2339,2339,2323,16,69405,69441,68960,481,65,3,3,17,2306,2306,2303,2303
Santa Cruz,18,2022-04-19,448,448,441,7,12617,12623,12418,205,3,1,1,0,261,261,260,260
Shasta,18,2022-04-19,33,33,32,1,2968,2968,2907,61,3,1,1,2,561,561,560,560
Siskiyou,18,2022-04-19,9,9,9,0,317,317,312,5,0,0,0,0,83,83,83,83
Solano,18,2022-04-19,291,291,285,6,9406,9411,9229,182,6,1,1,2,450,450,449,449
Sonoma,18,2022-04-19,534,534,524,10,11317,11323,11111,212,13,1,1,4,492,492,491,491
Stanislaus,18,2022-04-19,156,156,151,5,7587,7592,7368,224,20,0,0,2,1691,1691,1691,1691
Sutter,18,2022-04-19,23,23,23,0,1194,1194,1171,23,0,0,0,0,225,225,225,225
Tehama,18,2022-04-19,10,10,10,0,682,682,662,20,2,0,0,0,207,207,207,207
Trinity,18,2022-04-19,1,1,1,0,79,79,77,2,0,0,0,0,20,20,20,20
Tulare,18,2022-04-19,81,81,79,2,6756,6760,6557,203,10,0,0,0,1494,1494,1494,1494
Tuolumne,18,2022-04-19,30,30,29,1,1067,1067,1041,26,0,0,0,0,183,183,183,183
Ventura,18,2022-04-19,399,399,394,5,16795,16802,16580,222,9,4,4,0,1506,1506,1502,1502
Yolo,18,2022-04-19,238,238,234,4,18136,18146,17829,317,1,1,1,0,362,362,361,361
Yuba,18,2022-04-19,34,34,33,1,1055,1055,1036,19,0,0,0,0,119,119,119,119
Alameda,19,2022-04-26,2665,2665,2633,32,63800,63840,63071,769,44,6,6,6,1884,1884,1878,1878
Amador,19,2022-04-26,28,28,27,1,1307,1307,1281,26,0,0,0,0,86,86,86,86
Butte,19,2022-04-26,78,78,77,1,2548,2548,2523,25,4,1,1,1,432,432,431,431
Calaveras,19,2022-04-26,33,33,32,1,692,692,680,12,1,0,0,0,120,120,120,120
Colusa,19,2022-04-26,2,2,2,0,214,214,211,3,0,0,0,0,21,21,21,21
Contra Costa,19,2022-04-26,1539,1539,1508,31,27850,27866,27302,564,28,3,3,3,1305,1305,1302,1302
Del Norte,19,2022-04-26,26,26,26,0,1107,1107,1090,17,1,0,0,0,49,49,49,49
El Dorado,19,2022-04-26,108,108,106,2,2646,2646,2601,45,0,0,0,0,214,214,214,214
Fresno,19,2022-04-26,384,384,377,7,15884,15893,15591,302,31,2,2,3,2766,2766,2764,2764
Glenn,19,2022-04-26,4,4,4,0,282,282,277,5,0,0,0,0,53,53,53,53
Humboldt,19,2022-04-26,181,181,178,3,2869,2869,2824,45,3,0,0,2,147,147,147,147
Imperial,19,2022-04-26,73,73,72,1,3549,3551,3490,61,4,0,0,1,945,945,945,945
Inyo,19,2022-04-26,7,7,7,0,193,193,190,3,0,0,0,0,56,56,56,56
Kern,19,2022-04-26,250,250,246,4,18038,18050,17796,254,15,2,2,4,2346,2346,2344,2344
Kings,19,2022-04-26,58,58,57,1,4506,4508,4431,77,2,0,0,1,449,449,449,449
Lake,19,2022-04-26,20,20,20,0,936,936,918,18,0,0,0,0,140,140,140,140
Lassen,19,2022-04-26,2,2,2,0,1545,1545,1525,20,0,0,0,0,62,62,62,62
Los Angeles,19,2022-04-26,11923,11931,11874,57,900945,901489,897129,4360,207,28,28,28,31911,31911,31883,31883
Madera,19,2022-04-26,50,50,49,1,2930,2930,2874,56,2,0,0,1,370,370,370,370
Marin,19,2022-04-26,330,330,324,6,6488,6493,6371,122,5,0,0,0,295,295,295,295
Mariposa,19,2022-04-26,7,7,7,0,223,223,218,5,0,0,0,0,28,28,28,28
Mendocino,19,2022-04-26,48,48,47,1,1226,1226,1195,31,0,1,1,0,126,126,125,125
Merced,19,2022-04-26,101,101,100,1,3105,3105,3060,45,5,0,0,0,822,822,822,822
Modoc,19,2022-04-26,0,0,0,0,36,36,35,1,0,0,0,0,7,7,7,7
Mono,19,2022-04-26,3,3,3,0,86,86,83,3,0,0,0,0,6,6,6,6
Monterey,19,2022-04-26,287,287,278,9,8134,8139,7896,243,6,1,1,0,732,732,731,731
Napa,19,2022-04-26,204,204,201,3,3323,3323,3280,43,4,0,0,0,143,143,143,143
Nevada,19,2022-04-26,48,48,47,1,1416,1416,1389,27,2,0,0,0,131,131,131,131
Orange,19,2022-04-26,2091,2091,2068,23,87783,87837,86848,989,55,7,7,13,7121,7121,7114,7114
Placer,19,2022-04-26,240,240,235,5,6074,6078,5952,126,22,0,0,5,627,627,627,627
Plumas,19,2022-04-26,4,4,4,0,231,231,227,4,0,0,0,0,13,13,13,13
Riverside,19,2022-04-26,1358,1358,1338,20,40804,40827,40212,615,34,4,4,6,6463,6463,6459,6459
Sacramento,19,2022-04-26,1032,1032,1015,17,31991,32010,31492,518,49,5,5,8,3069,3069,3064,3064
San Benito,19,2022-04-26,35,35,35,0,1102,1102,1087,15,0,0,0,0,94,94,94,94
San Bernardino,19,2022-04-26,1314,1314,1298,16,42827,42852,42330,522,32,12,12,7,7829,7829,7817,7817
San Diego,19,2022-04-26,3218,3218,3202,16,74117,74163,73785,378,91,2,2,11,5353,5353,5351,5351
San Francisco,19,2022-04-26,2044,2044,1977,67,32599,32618,31546,1072,27,1,1,3,875,875,874,874
San Joaquin,19,2022-04-26,412,412,405,7,15006,15013,14748,265,11,0,0,3,2249,2249,2249,2249
San Luis Obispo,19,2022-04-26,229,229,226,3,5037,5039,4970,69,5,0,0,0,481,481,481,481
San Mateo,19,2022-04-26,1579,1579,1561,18,34184,34206,33821,385,15,2,2,5,709,709,707,707
Santa Barbara,19,2022-04-26,361,361,355,6,15245,15253,15017,236,11,2,2,2,693,693,691,691
Santa Clara,19,2022-04-26,3343,3343,3325,18,82752,82803,82361,442,70,4,4,10,2310,2310,2306,2306
Santa Cruz,19,2022-04-26,511,511,504,7,20812,20824,20551,273,6,0,0,0,261,261,261,261
Shasta,19,2022-04-26,54,54,53,1,3354,3355,3301,54,1,0,0,1,561,561,561,561
Siskiyou,19,2022-04-26,6,6,6,0,318,318,314,4,0,0,0,0,83,83,83,83
Solano,19,2022-04-26,532,532,524,8,11005,11010,10844,166,13,0,0,2,450,450,450,450
Sonoma,19,2022-04-26,698,698,688,10,11967,11973,11798,175,20,0,0,2,492,492,492,492
Stanislaus,19,2022-04-26,257,257,251,6,8055,8060,7874,186,23,4,4,1,1695,1695,1691,1691
Sutter,19,2022-04-26,40,40,39,1,1346,1346,1325,21,0,2,2,0,227,227,225,225
Tehama,19,2022-04-26,13,13,13,0,697,697,681,16,1,0,0,0,207,207,207,207
Trinity,19,2022-04-26,2,2,2,0,65,65,63,2,0,0,0,0,20,20,20,20
Tulare,19,2022-04-26,100,100,98,2,6948,6953,6789,164,10,2,2,0,1496,1496,1494,1494
Tuolumne,19,2022-04-26,46,46,45,1,1123,1123,1102,21,2,0,0,0,183,183,183,183
Ventura,19,2022-04-26,623,623,617,6,19242,19255,19056,199,14,0,0,2,1506,1506,1506,1506
Yolo,19,2022-04-26,277,277,273,4,19192,19203,18940,263,0,0,0,0,362,362,362,362
Yuba,19,2022-04-26,32,32,32,0,1065,1065,1050,15,1,0,0,0,119,119,119,119
Alameda,20,2022-05-03,3502,3502,3469,33,67813,67860,67216,644,44,3,3,5,1887,1887,1884,1884
Amador,20,2022-05-03,19,19,19,0,1366,1366,1345,21,1,0,0,0,86,86,86,86
Butte,20,2022-05-03,98,98,97,1,2394,2394,2376,18,4,2,2,0,434,434,432,432
Calaveras,20,2022-05-03,21,21,21,0,720,720,710,10,0,0,0,0,120,120,120,120
Colusa,20,2022-05-03,2,2,2,0,191,191,189,2,0,0,0,0,21,21,21,21
Contra Costa,20,2022-05-03,1988,1988,1957,31,29242,29262,28798,464,35,2,2,5,1307,1307,1305,1305
Del Norte,20,2022-05-03,41,41,40,1,1239,1239,1224,15,0,0,0,0,49,49,49,49
El Dorado,20,2022-05-03,142,142,140,2,2778,2778,2741,37,2,1,1,0,215,215,214,214
Fresno,20,2022-05-03,524,524,516,8,16772,16784,16534,250,40,4,4,4,2770,2770,2766,2766
Glenn,20,2022-05-03,6,6,6,0,250,250,247,3,0,0,0,0,53,53,53,53
Humboldt,20,2022-05-03,278,278,275,3,3107,3107,3069,38,5,0,0,2,147,147,147,147
Imperial,20,2022-05-03,116,116,114,2,3668,3670,3621,49,1,0,0,1,945,945,945,945
Inyo,20,2022-05-03,3,3,3,0,185,185,183,2,0,0,0,0,56,56,56,56
Kern,20,2022-05-03,334,334,330,4,17922,17936,17739,197,15,1,1,5,2347,2347,2346,2346
Kings,20,2022-05-03,67,67,66,1,4891,4895,4830,65,3,0,0,0,449,449,449,449
Lake,20,2022-05-03,30,30,30,0,991,991,976,15,1,0,0,0,140,140,140,140
Lassen,20,2022-05-03,9,9,9,0,1663,1663,1646,17,0,0,0,0,62,62,62,62
Los Angeles,20,2022-05-03,15452,15463,15405,58,913342,913979,910518,3461,221,25,25,27,31936,31936,31911,31911
Madera,20,2022-05-03,79,79,78,1,3385,3385,3334,51,5,0,0,0,370,370,370,370
Marin,20,2022-05-03,489,489,482,7,6788,6793,6694,99,13,0,0,0,295,295,295,295
Mariposa,20,2022-05-03,12,12,12,0,224,224,220,4,0,0,0,0,28,28,28,28
Mendocino,20,2022-05-03,68,68,67,1,1268,1268,1243,25,1,0,0,0,126,126,126,126
Merced,20,2022-05-03,148,148,146,2,3273,3274,3237,37,5,4,4,0,826,826,822,822
Modoc,20,2022-05-03,1,1,1,0,37,38,37,1,0,0,0,0,7,7,7,7
Mono,20,2022-05-03,8,8,8,0,112,112,109,3,0,0,0,0,6,6,6,6
Monterey,20,2022-05-03,395,395,386,9,8804,8810,8604,206,10,1,1,0,733,733,732,732
Napa,20,2022-05-03,226,226,224,2,3467,3468,3433,35,1,0,0,0,143,143,143,143
Nevada,20,2022-05-03,92,92,91,1,1567,1567,1544,23,1,0,0,0,131,131,131,131
Orange,20,2022-05-03,2772,2772,2748,24,87393,87454,86684,770,67,5,5,12,7126,7126,7121,7121
Placer,20,2022-05-03,327,327,322,5,6476,6481,6376,105,20,0,0,4,627,627,627,627
Plumas,20,2022-05-03,7,7,7,0,260,260,256,4,0,0,0,0,13,13,13,13
Riverside,20,2022-05-03,2177,2177,2152,25,43769,43801,43286,515,33,3,3,5,6466,6466,6463,6463
Sacramento,20,2022-05-03,1534,1534,1515,19,34244,34268,33836,432,48,4,4,12,3073,3073,3069,3069
San Benito,20,2022-05-03,55,55,54,1,1348,1348,1334,14,0,0,0,0,94,94,94,94
San Bernardino,20,2022-05-03,1547,1547,1532,15,44355,44387,43965,422,36,5,5,7,7834,7834,7829,7829
San Diego,20,2022-05-03,4307,4309,4292,17,75883,75935,75635,300,87,3,3,13,5356,5356,5353,5353
San Francisco,20,2022-05-03,2499,2499,2435,64,36201,36228,35291,937,42,3,3,10,878,878,875,875
San Joaquin,20,2022-05-03,579,579,571,8,15056,15067,14858,209,14,1,1,2,2250,2250,2249,2249
San Luis Obispo,20,2022-05-03,253,253,250,3,5102,5106,5051,55,4,2,2,0,483,483,481,481
San Mateo,20,2022-05-03,1870,1870,1854,16,35875,35899,35582,317,19,2,2,4,711,711,709,709
Santa Barbara,20,2022-05-03,480,480,474,6,15499,15509,15321,188,9,0,0,2,693,693,693,693
Santa Clara,20,2022-05-03,4626,4628,4609,19,99066,99134,98717,417,85,6,6,16,2316,2316,2310,2310
Santa Cruz,20,2022-05-03,662,662,655,7,22231,22246,22017,229,1,1,1,0,262,262,261,261
Shasta,20,2022-05-03,75,75,74,1,3407,3408,3365,43,6,0,0,1,561,561,561,561
Siskiyou,20,2022-05-03,12,12,12,0,325,325,322,3,1,0,0,0,83,83,83,83
Solano,20,2022-05-03,647,647,639,8,11963,11971,11830,141,18,0,0,0,450,450,450,450
Sonoma,20,2022-05-03,955,955,944,11,13164,13172,13022,150,18,1,1,4,493,493,492,492
Stanislaus,20,2022-05-03,297,297,292,5,8222,8227,8078,149,21,0,0,1,1695,1695,1695,1695
Sutter,20,2022-05-03,51,51,50,1,1427,1427,1410,17,0,0,0,0,227,227,227,227
Tehama,20,2022-05-03,22,22,22,0,703,703,691,12,0,0,0,0,207,207,207,207
Trinity,20,2022-05-03,1,1,1,0,86,86,84,2,0,0,0,0,20,20,20,20
Tulare,20,2022-05-03,160,160,157,3,7342,7347,7211,136,9,3,3,0,1499,1499,1496,1496
Tuolumne,20,2022-05-03,89,89,88,1,1293,1293,1274,19,4,1,1,0,184,184,183,183
Ventura,20,2022-05-03,797,797,791,6,20058,20072,19910,162,15,4,4,0,1510,1510,1506,1506
Yolo,20,2022-05-03,367,367,363,4,19030,19043,18839,204,0,1,1,0,363,363,362,362
Yuba,20,2022-05-03,41,41,41,0,1124,1124,1111,13,2,0,0,0,119,119,119,119
Alameda,21,2022-05-10,4297,4299,4267,32,72596,72651,72113,538,53,8,8,4,1895,1895,1887,1887
Amador,21,2022-05-10,28,28,28,0,1575,1575,1556,19,1,0,0,0,86,86,86,86
Butte,21,2022-05-10,118,118,117,1,2449,2449,2434,15,7,0,0,0,434,434,434,434
Calaveras,21,2022-05-10,38,38,38,0,709,709,702,7,0,0,0,0,120,120,120,120
Colusa,21,2022-05-10,5,5,5,0,214,214,212,2,0,0,0,0,21,21,21,21
Contra Costa,21,2022-05-10,2615,2615,2583,32,31249,31273,30885,388,48,4,4,9,1311,1311,1307,1307
Del Norte,21,2022-05-10,53,53,52,1,1366,1366,1353,13,0,0,0,1,49,49,49,49
El Dorado,21,2022-05-10,187,187,185,2,2954,2955,2924,31,3,0,0,0,215,215,215,215
Fresno,21,2022-05-10,790,790,781,9,17843,17857,17649,208,38,1,1,1,2771,2771,2770,2770
Glenn,21,2022-05-10,8,8,8,0,236,236,234,2,0,0,0,0,53,53,53,53
Humboldt,21,2022-05-10,273,273,270,3,3125,3126,3096,30,7,0,0,2,147,147,147,147
Imperial,21,2022-05-10,152,152,150,2,3735,3737,3698,39,0,0,0,1,945,945,945,945
Inyo,21,2022-05-10,28,28,28,0,221,221,219,2,0,0,0,0,56,56,56,56
Kern,21,2022-05-10,480,480,476,4,18936,18950,18787,163,17,2,2,3,2349,2349,2347,2347
Kings,21,2022-05-10,105,105,104,1,4962,4966,4914,52,0,0,0,0,449,449,449,449
Lake,21,2022-05-10,34,34,34,0,1054,1054,1041,13,0,0,0,0,140,140,140,140
Lassen,21,2022-05-10,7,7,7,0,1662,1662,1649,13,0,0,0,0,62,62,62,62
Los Angeles,21,2022-05-10,18749,18763,18708,55,927931,928639,925899,2740,225,33,33,24,31969,31969,31936,31936
Madera,21,2022-05-10,147,147,145,2,3786,3789,3744,45,3,0,0,0,370,370,370,370
Marin,21,2022-05-10,702,702,694,8,7824,7830,7740,90,10,0,0,1,295,295,295,295
Mariposa,21,2022-05-10,32,32,32,0,336,336,332,4,0,0,0,0,28,28,28,28
Mendocino,21,2022-05-10,85,85,84,1,1242,1242,1223,19,1,1,1,0,127,127,126,126
Merced,21,2022-05-10,206,206,204,2,3521,3523,3492,31,5,1,1,0,827,827,826,826
Modoc,21,2022-05-10,1,1,1,0,43,44,43,1,0,0,0,0,7,7,7,7
Mono,21,2022-05-10,9,9,9,0,109,109,107,2,0,0,0,0,6,6,6,6
Monterey,21,2022-05-10,454,454,446,8,9324,9331,9160,171,11,0,0,0,733,733,733,733
Napa,21,2022-05-10,244,244,242,2,3239,3240,3214,26,1,0,0,0,143,143,143,143
Nevada,21,2022-05-10,112,112,111,1,1654,1654,1635,19,4,0,0,1,131,131,131,131
Orange,21,2022-05-10,3647,3649,3624,25,91724,91794,91162,632,77,8,8,13,7134,7134,7126,7126
Placer,21,2022-05-10,542,542,535,7,6901,6906,6818,88,27,0,0,2,627,627,627,627
Plumas,21,2022-05-10,22,22,22,0,277,277,274,3,0,0,0,0,13,13,13,13
Riverside,21,2022-05-10,2501,2501,2478,23,44962,44996,44582,414,50,4,4,7,6470,6470,6466,6466
Sacramento,21,2022-05-10,2380,2380,2357,23,36615,36643,36281,362,61,4,4,13,3077,3077,3073,3073
San Benito,21,2022-05-10,81,81,80,1,1440,1440,1428,12,0,0,0,0,94,94,94,94
San Bernardino,21,2022-05-10,1990,1990,1975,15,46761,46798,46451,347,39,7,7,5,7841,7841,7834,7834
San Diego,21,2022-05-10,5330,5335,5318,17,87957,88023,87750,273,96,3,3,14,5359,5359,5356,5356
San Francisco,21,2022-05-10,3172,3173,3109,64,38690,38721,37936,785,58,7,7,3,885,885,878,878
San Joaquin,21,2022-05-10,840,840,831,9,16954,16968,16785,183,12,1,1,2,2251,2251,2250,2250
San Luis Obispo,21,2022-05-10,290,290,288,2,5349,5354,5309,45,0,0,0,1,483,483,483,483
San Mateo,21,2022-05-10,2417,2417,2400,17,37897,37926,37664,262,28,2,2,1,713,713,711,711
Santa Barbara,21,2022-05-10,667,667,661,6,15455,15467,15321,146,11,0,0,3,693,693,693,693
Santa Clara,21,2022-05-10,5849,5854,5835,19,105973,106055,105706,349,95,3,3,26,2319,2319,2316,2316
Santa Cruz,21,2022-05-10,744,744,738,6,24266,24285,24090,195,2,0,0,0,262,262,262,262
Shasta,21,2022-05-10,101,101,100,1,3371,3374,3341,33,9,0,0,0,561,561,561,561
Siskiyou,21,2022-05-10,15,15,15,0,297,297,295,2,0,0,0,0,83,83,83,83
Solano,21,2022-05-10,938,938,929,9,12531,12541,12425,116,24,0,0,2,450,450,450,450
Sonoma,21,2022-05-10,1260,1260,1249,11,14335,14348,14220,128,17,1,1,1,494,494,493,493
Stanislaus,21,2022-05-10,483,483,476,7,9060,9068,8940,128,24,1,1,3,1696,1696,1695,1695
Sutter,21,2022-05-10,67,67,66,1,1591,1591,1576,15,0,0,0,0,227,227,227,227
Tehama,21,2022-05-10,25,25,25,0,699,699,689,10,1,0,0,1,207,207,207,207
Trinity,21,2022-05-10,3,3,3,0,70,70,69,1,0,0,0,0,20,20,20,20
Tulare,21,2022-05-10,209,209,206,3,7667,7672,7561,111,13,1,1,1,1500,1500,1499,1499
Tuolumne,21,2022-05-10,73,73,72,1,1483,1483,1466,17,1,2,2,0,186,186,184,184
Ventura,21,2022-05-10,1205,1205,1197,8,21654,21670,21533,137,14,1,1,3,1511,1511,1510,1510
Yolo,21,2022-05-10,524,524,520,4,20316,20332,20163,169,3,0,0,0,363,363,363,363
Yuba,21,2022-05-10,81,81,80,1,1213,1213,1202,11,2,0,0,0,119,119,119,119
Alameda,22,2022-05-17,5224,5229,5199,30,76154,76219,75779,440,71,7,7,4,1902,1902,1895,1895
Amador,22,2022-05-17,58,58,57,1,1661,1661,1645,16,0,0,0,0,86,86,86,86
Butte,22,2022-05-17,239,239,238,1,2716,2717,2704,13,9,2,2,0,436,436,434,434
Calaveras,22,2022-05-17,43,43,43,0,784,784,778,6,0,1,1,2,121,121,120,120
Colusa,22,2022-05-17,6,6,6,0,222,222,220,2,0,0,0,0,21,21,21,21
Contra Costa,22,2022-05-17,3660,3662,3627,35,33932,33960,33631,329,52,5,5,7,1316,1316,1311,1311
Del Norte,22,2022-05-17,179,179,178,1,1929,1929,1914,15,0,1,1,0,50,50,49,49
El Dorado,22,2022-05-17,293,293,291,2,3107,3109,3084,25,6,1,1,0,216,216,215,215
Fresno,22,2022-05-17,1247,1247,1236,11,19494,19509,19332,177,41,2,2,6,2773,2773,2771,2771
Glenn,22,2022-05-17,18,18,18,0,260,260,258,2,0,0,0,0,53,53,53,53
Humboldt,22,2022-05-17,269,269,267,2,3104,3106,3083,23,11,1,1,4,148,148,147,147
Imperial,22,2022-05-17,237,237,235,2,4432,4437,4401,36,3,0,0,1,945,945,945,945
Inyo,22,2022-05-17,20,20,20,0,242,242,240,2,1,0,0,0,56,56,56,56
Kern,22,2022-05-17,742,742,737,5,20139,20156,20021,135,18,2,2,3,2351,2351,2349,2349
Kings,22,2022-05-17,239,239,237,2,5589,5594,5548,46,0,1,1,0,450,450,449,449
Lake,22,2022-05-17,74,74,73,1,1214,1214,1203,11,2,0,0,0,140,140,140,140
Lassen,22,2022-05-17,24,24,24,0,1737,1737,1726,11,1,0,0,0,62,62,62,62
Los Angeles,22,2022-05-17,22492,22513,22462,51,936827,937620,935461,2159,308,37,37,55,32006,32006,31969,31969
Madera,22,2022-05-17,198,198,196,2,3599,3603,3570,33,4,0,0,1,370,370,370,370
Marin,22,2022-05-17,863,863,855,8,8473,8480,8404,76,15,0,0,0,295,295,295,295
Mariposa,22,2022-05-17,19,19,19,0,331,331,328,3,0,0,0,0,28,28,28,28
Mendocino,22,2022-05-17,114,114,113,1,1400,1400,1383,17,2,1,1,2,128,128,127,127
Merced,22,2022-05-17,345,345,343,2,4048,4052,4024,28,5,1,1,1,828,828,827,827
Modoc,22,2022-05-17,4,4,4,0,43,44,43,1,0,0,0,0,7,7,7,7
Mono,22,2022-05-17,12,12,12,0,116,116,114,2,0,0,0,0,6,6,6,6
Monterey,22,2022-05-17,529,529,521,8,9549,9557,9420,137,5,2,2,1,735,735,733,733
Napa,22,2022-05-17,300,300,298,2,3798,3802,3779,23,3,0,0,0,143,143,143,143
Nevada,22,2022-05-17,137,137,136,1,1837,1837,1820,17,2,0,0,0,131,131,131,131
Orange,22,2022-05-17,4742,4747,4722,25,96028,96109,95593,516,98,8,8,14,7142,7142,7134,7134
Placer,22,2022-05-17,791,791,783,8,7812,7818,7740,78,43,2,2,2,629,629,627,627
Plumas,22,2022-05-17,49,49,49,0,251,251,249,2,1,0,0,0,13,13,13,13
Riverside,22,2022-05-17,3569,3571,3546,25,48993,49034,48682,352,69,1,1,7,6471,6471,6470,6470
Sacramento,22,2022-05-17,3374,3376,3350,26,40710,40745,40431,314,94,8,8,12,3085,3085,3077,3077
San Benito,22,2022-05-17,109,109,108,1,1531,1531,1521,10,1,0,0,0,94,94,94,94
San Bernardino,22,2022-05-17,2607,2607,2592,15,49229,49270,48984,286,40,6,6,6,7847,7847,7841,7841
San Diego,22,2022-05-17,7233,7240,7223,17,97154,97236,97001,235,98,5,5,22,5364,5364,5359,5359
San Francisco,22,2022-05-17,3556,3558,3502,56,39575,39608,38980,628,66,4,4,10,889,889,885,885
San Joaquin,22,2022-05-17,1296,1296,1285,11,19575,19592,19427,165,19,2,2,2,2253,2253,2251,2251
San Luis Obispo,22,2022-05-17,476,476,473,3,6296,6301,6260,41,5,0,0,0,483,483,483,483
San Mateo,22,2022-05-17,2896,2896,2881,15,41143,41179,40958,221,42,1,1,1,714,714,713,713
Santa Barbara,22,2022-05-17,927,927,920,7,17226,17241,17114,127,15,0,0,3,693,693,693,693
Santa Clara,22,2022-05-17,7388,7395,7376,19,113176,113273,112982,291,118,9,9,17,2328,2328,2319,2319
Santa Cruz,22,2022-05-17,746,746,741,5,17217,17231,17119,112,5,0,0,0,262,262,262,262
Shasta,22,2022-05-17,146,146,145,1,3839,3843,3813,30,5,0,0,1,561,561,561,561
Siskiyou,22,2022-05-17,20,20,20,0,377,377,375,2,0,0,0,0,83,83,83,83
Solano,22,2022-05-17,1381,1381,1371,10,14403,14417,14313,104,29,0,0,3,450,450,450,450
Sonoma,22,2022-05-17,1611,1611,1600,11,15554,15568,15459,109,23,0,0,4,494,494,494,494
Stanislaus,22,2022-05-17,797,797,788,9,10266,10275,10161,114,35,1,1,4,1697,1697,1696,1696
Sutter,22,2022-05-17,110,110,109,1,1777,1777,1764,13,0,0,0,0,227,227,227,227
Tehama,22,2022-05-17,44,44,44,0,841,841,832,9,0,1,1,1,208,208,207,207
Trinity,22,2022-05-17,6,6,6,0,78,78,77,1,0,0,0,0,20,20,20,20
Tulare,22,2022-05-17,430,430,425,5,8474,8481,8385,96,17,0,0,0,1500,1500,1500,1500
Tuolumne,22,2022-05-17,164,164,163,1,1522,1522,1508,14,1,0,0,0,186,186,186,186
Ventura,22,2022-05-17,1666,1666,1658,8,23971,23990,23872,118,28,2,2,3,1513,1513,1511,1511
Yolo,22,2022-05-17,714,714,709,5,22229,22247,22102,145,0,0,0,1,363,363,363,363
Yuba,22,2022-05-17,137,137,136,1,1368,1368,1359,9,4,0,0,0,119,119,119,119
Alameda,23,2022-05-24,5536,5542,5517,25,77235,77308,76960,348,91,5,5,5,1907,1907,1902,1902
Amador,23,2022-05-24,103,103,102,1,1492,1492,1481,11,1,1,1,1,87,87,86,86
Butte,23,2022-05-24,274,274,273,1,2768,2770,2760,10,9,1,1,0,437,437,436,436
Calaveras,23,2022-05-24,53,53,53,0,712,712,707,5,0,1,1,0,122,122,121,121
Colusa,23,2022-05-24,7,7,7,0,220,220,219,1,0,0,0,0,21,21,21,21
Contra Costa,23,2022-05-24,3930,3935,3905,30,35272,35305,35037,268,62,13,13,8,1329,1329,1316,1316
Del Norte,23,2022-05-24,59,59,59,0,1262,1262,1255,7,2,0,0,0,50,50,50,50
El Dorado,23,2022-05-24,383,383,381,2,3512,3515,3493,22,4,2,2,2,218,218,216,216
Fresno,23,2022-05-24,1733,1733,1721,12,21962,21983,21827,156,56,1,1,10,2774,2774,2773,2773
Glenn,23,2022-05-24,25,25,25,0,275,275,273,2,0,0,0,0,53,53,53,53
Humboldt,23,2022-05-24,226,226,225,1,2887,2889,2872,17,12,1,1,3,149,149,148,148
Imperial,23,2022-05-24,322,322,320,2,4730,4735,4705,30,6,0,0,1,945,945,945,945
Inyo,23,2022-05-24,26,26,26,0,213,213,212,1,0,0,0,0,56,56,56,56
Kern,23,2022-05-24,1072,1072,1066,6,21304,21325,21214,111,25,0,0,6,2351,2351,2351,2351
Kings,23,2022-05-24,249,249,247,2,5626,5631,5595,36,4,0,0,0,450,450,450,450
Lake,23,2022-05-24,108,108,107,1,1163,1163,1154,9,0,0,0,2,140,140,140,140
Lassen,23,2022-05-24,44,44,44,0,1773,1773,1764,9,0,0,0,0,62,62,62,62
Los Angeles,23,2022-05-24,28730,28758,28707,51,950449,951357,949650,1707,358,35,35,52,32041,32041,32006,32006
Madera,23,2022-05-24,216,216,214,2,3767,3771,3744,27,2,0,0,2,370,370,370,370
Marin,23,2022-05-24,776,776,771,5,8772,8781,8719,62,11,0,0,1,295,295,295,295
Mariposa,23,2022-05-24,33,33,33,0,336,336,333,3,0,0,0,0,28,28,28,28
Mendocino,23,2022-05-24,146,146,145,1,1661,1661,1645,16,2,1,1,1,129,129,128,128
Merced,23,2022-05-24,416,416,414,2,4228,4233,4210,23,5,0,0,0,828,828,828,828
Modoc,23,2022-05-24,3,3,3,0,39,40,39,1,0,0,0,0,7,7,7,7
Mono,23,2022-05-24,11,11,11,0,161,161,159,2,0,0,0,0,6,6,6,6
Monterey,23,2022-05-24,690,690,682,8,9422,9431,9325,106,16,0,0,1,735,735,735,735
Napa,23,2022-05-24,338,338,336,2,3989,3994,3975,19,3,0,0,0,143,143,143,143
Nevada,23,2022-05-24,166,166,165,1,1923,1923,1909,14,1,0,0,0,131,131,131,131
Orange,23,2022-05-24,5787,5794,5770,24,95414,95505,95105,400,111,11,11,18,7153,7153,7142,7142
Placer,23,2022-05-24,915,915,908,7,7936,7943,7881,62,44,2,2,5,631,631,629,629
Plumas,23,2022-05-24,39,39,39,0,268,268,266,2,1,0,0,0,13,13,13,13
Riverside,23,2022-05-24,4470,4475,4450,25,52695,52745,52449,296,84,6,6,9,6477,6477,6471,6471
Sacramento,23,2022-05-24,3973,3977,3953,24,40919,40959,40712,247,123,8,8,15,3093,3093,3085,3085
San Benito,23,2022-05-24,185,185,184,1,1650,1650,1642,8,0,0,0,0,94,94,94,94
San Bernardino,23,2022-05-24,3490,3492,3476,16,50907,50957,50726,231,52,4,4,8,7851,7851,7847,7847
San Diego,23,2022-05-24,9016,9025,9008,17,104102,104202,104005,197,145,5,5,22,5369,5369,5364,5364
San Francisco,23,2022-05-24,3471,3474,3431,43,41224,41263,40750,513,79,9,9,9,898,898,889,889
San Joaquin,23,2022-05-24,1543,1543,1533,10,20611,20631,20495,136,24,2,2,4,2255,2255,2253,2253
San Luis Obispo,23,2022-05-24,712,712,708,4,7323,7329,7291,38,10,3,3,0,486,486,483,483
San Mateo,23,2022-05-24,3189,3191,3178,13,39550,39588,39422,166,36,0,0,1,714,714,714,714
Santa Barbara,23,2022-05-24,1154,1154,1147,7,17901,17919,17815,104,17,1,1,2,694,694,693,693
Santa Clara,23,2022-05-24,7888,7895,7879,16,110778,110883,110661,222,137,7,7,19,2335,2335,2328,2328
Santa Cruz,23,2022-05-24,529,529,526,3,7877,7884,7845,39,17,0,0,0,262,262,262,262
Shasta,23,2022-05-24,185,185,184,1,3619,3622,3600,22,5,1,1,4,562,562,561,561
Siskiyou,23,2022-05-24,40,40,40,0,374,374,372,2,1,0,0,0,83,83,83,83
Solano,23,2022-05-24,1525,1525,1516,9,14858,14872,14788,84,29,1,1,6,451,451,450,450
Sonoma,23,2022-05-24,1416,1416,1408,8,16636,16651,16560,91,37,2,2,2,496,496,494,494
Stanislaus,23,2022-05-24,869,869,861,8,10548,10557,10466,91,40,2,2,3,1699,1699,1697,1697
Sutter,23,2022-05-24,167,167,166,1,2029,2029,2017,12,0,1,1,0,228,228,227,227
Tehama,23,2022-05-24,54,54,54,0,841,841,834,7,1,0,0,0,208,208,208,208
Trinity,23,2022-05-24,3,3,3,0,94,94,93,1,0,0,0,0,20,20,20,20
Tulare,23,2022-05-24,599,599,594,5,9397,9404,9321,83,27,0,0,0,1500,1500,1500,1500
Tuolumne,23,2022-05-24,127,127,126,1,1539,1539,1528,11,0,1,1,0,187,187,186,186
Ventura,23,2022-05-24,1917,1917,1910,7,23796,23819,23727,92,37,1,1,1,1514,1514,1513,1513
Yolo,23,2022-05-24,729,729,725,4,22179,22201,22088,113,3,1,1,0,364,364,363,363
Yuba,23,2022-05-24,154,154,153,1,1431,1431,1423,8,7,0,0,1,119,119,119,119
Alameda,24,2022-05-31,5355,5360,5341,19,64235,64302,64074,228,86,3,3,12,1910,1910,1907,1907
Amador,24,2022-05-31,71,71,71,0,1179,1179,1172,7,0,0,0,0,87,87,87,87
Butte,24,2022-05-31,305,305,304,1,2924,2928,2920,8,23,0,0,2,437,437,437,437
Calaveras,24,2022-05-31,56,56,56,0,644,644,641,3,0,0,0,0,122,122,122,122
Colusa,24,2022-05-31,14,14,14,0,191,191,190,1,0,0,0,0,21,21,21,21
Contra Costa,24,2022-05-31,3423,3426,3406,20,31337,31369,31183,186,63,4,4,9,1333,1333,1329,1329
Del Norte,24,2022-05-31,49,49,49,0,1042,1042,1037,5,0,1,1,0,51,51,50,50
El Dorado,24,2022-05-31,327,327,325,2,3006,3010,2995,15,8,1,1,1,219,219,218,218
Fresno,24,2022-05-31,1790,1791,1781,10,19985,20007,19895,112,77,6,6,6,2780,2780,2774,2774
Glenn,24,2022-05-31,28,28,28,0,311,311,310,1,3,0,0,0,53,53,53,53
Humboldt,24,2022-05-31,208,208,207,1,2448,2451,2440,11,11,0,0,3,149,149,149,149
Imperial,24,2022-05-31,370,370,368,2,4403,4408,4386,22,2,1,1,1,946,946,945,945
Inyo,24,2022-05-31,20,20,20,0,154,154,153,1,0,0,0,0,56,56,56,56
Kern,24,2022-05-31,1141,1141,1136,5,19181,19201,19122,79,38,0,0,4,2351,2351,2351,2351
Kings,24,2022-05-31,338,338,336,2,4747,4751,4727,24,2,0,0,1,450,450,450,450
Lake,24,2022-05-31,99,99,98,1,1040,1040,1034,6,1,0,0,0,140,140,140,140
Lassen,24,2022-05-31,58,58,58,0,1815,1816,1809,7,1,0,0,0,62,62,62,62
Los Angeles,24,2022-05-31,27933,27961,27922,39,816614,817469,816318,1151,449,42,42,53,32083,32083,32041,32041
Madera,24,2022-05-31,260,260,259,1,3411,3414,3395,19,3,0,0,0,370,370,370,370
Marin,24,2022-05-31,634,634,631,3,7295,7303,7263,40,11,3,3,2,298,298,295,295
Mariposa,24,2022-05-31,60,60,60,0,324,324,322,2,0,0,0,0,28,28,28,28
Mendocino,24,2022-05-31,162,162,161,1,1284,1284,1274,10,3,0,0,1,129,129,129,129
Merced,24,2022-05-31,384,384,382,2,3712,3716,3700,16,8,0,0,2,828,828,828,828
Modoc,24,2022-05-31,6,6,6,0,46,47,46,1,0,0,0,0,7,7,7,7
Mono,24,2022-05-31,9,9,9,0,97,97,96,1,0,0,0,0,6,6,6,6
Monterey,24,2022-05-31,616,616,611,5,8174,8183,8111,72,19,2,2,0,737,737,735,735
Napa,24,2022-05-31,332,332,331,1,3313,3317,3304,13,6,0,0,2,143,143,143,143
Nevada,24,2022-05-31,193,193,192,1,1757,1758,1748,10,4,2,2,0,133,133,131,131
Orange,24,2022-05-31,6087,6095,6075,20,78557,78639,78377,262,120,12,12,19,7165,7165,7153,7153
Placer,24,2022-05-31,740,740,735,5,6152,6158,6120,38,61,0,0,9,631,631,631,631
Plumas,24,2022-05-31,38,38,38,0,209,209,208,1,1,0,0,0,13,13,13,13
Riverside,24,2022-05-31,4147,4151,4133,18,46344,46392,46188,204,96,4,4,8,6481,6481,6477,6477
Sacramento,24,2022-05-31,4045,4049,4030,19,35026,35063,34898,165,147,9,9,15,3102,3102,3093,3093
San Benito,24,2022-05-31,181,181,180,1,1466,1467,1461,6,0,0,0,0,94,94,94,94
San Bernardino,24,2022-05-31,3671,3675,3662,13,46331,46381,46217,164,61,5,5,9,7856,7856,7851,7851
San Diego,24,2022-05-31,8964,8974,8961,13,89183,89276,89144,132,169,10,10,24,5379,5379,5369,5369
San Francisco,24,2022-05-31,3220,3223,3192,31,34543,34580,34243,337,85,8,8,11,906,906,898,898
San Joaquin,24,2022-05-31,1524,1524,1516,8,17434,17452,17361,91,33,2,2,11,2257,2257,2255,2255
San Luis Obispo,24,2022-05-31,714,714,711,3,5893,5898,5874,24,11,1,1,0,487,487,486,486
San Mateo,24,2022-05-31,2854,2856,2847,9,32951,32986,32877,109,37,4,4,1,718,718,714,714
Santa Barbara,24,2022-05-31,1053,1053,1048,5,14981,14997,14929,68,26,1,1,3,695,695,694,694
Santa Clara,24,2022-05-31,7201,7209,7198,11,87703,87795,87657,138,161,9,9,19,2344,2344,2335,2335
Santa Cruz,24,2022-05-31,561,561,559,2,6726,6732,6706,26,6,1,1,1,263,263,262,262
Shasta,24,2022-05-31,149,149,148,1,3456,3458,3442,16,4,3,3,3,565,565,562,562
Siskiyou,24,2022-05-31,48,48,48,0,373,373,372,1,1,0,0,0,83,83,83,83
Solano,24,2022-05-31,1261,1261,1255,6,12301,12314,12259,55,34,0,0,4,451,451,451,451
Sonoma,24,2022-05-31,1259,1259,1254,5,12679,12693,12638,55,36,2,2,4,498,498,496,496
Stanislaus,24,2022-05-31,851,851,845,6,8962,8972,8911,61,56,2,2,0,1701,1701,1699,1699
Sutter,24,2022-05-31,157,157,156,1,1768,1769,1761,8,0,0,0,0,228,228,228,228
Tehama,24,2022-05-31,66,66,66,0,813,813,808,5,3,0,0,0,208,208,208,208
Trinity,24,2022-05-31,8,8,8,0,89,89,88,1,0,0,0,0,20,20,20,20
Tulare,24,2022-05-31,634,634,630,4,8086,8094,8038,56,17,0,0,0,1500,1500,1500,1500
Tuolumne,24,2022-05-31,123,123,122,1,1425,1425,1417,8,3,0,0,0,187,187,187,187
Ventura,24,2022-05-31,1723,1723,1718,5,21118,21140,21076,64,40,1,1,1,1515,1515,1514,1514
Yolo,24,2022-05-31,664,664,661,3,18786,18806,18731,75,5,0,0,0,364,364,364,364
Yuba,24,2022-05-31,142,142,141,1,1360,1360,1354,6,8,0,0,1,119,119,119,119
Alameda,25,2022-06-07,6003,6010,5993,17,66870,66944,66760,184,105,4,4,14,1914,1914,1910,1910
Amador,25,2022-06-07,150,150,149,1,1688,1688,1680,8,1,0,0,0,87,87,87,87
Butte,25,2022-06-07,440,440,439,1,3544,3548,3540,8,24,1,1,1,438,438,437,437
Calaveras,25,2022-06-07,75,75,75,0,686,686,683,3,0,2,2,0,124,124,122,122
Colusa,25,2022-06-07,21,21,21,0,332,332,331,1,10,0,0,0,21,21,21,21
Contra Costa,25,2022-06-07,4048,4053,4034,19,32836,32872,32720,152,99,11,11,8,1344,1344,1333,1333
Del Norte,25,2022-06-07,54,54,54,0,959,959,956,3,3,0,0,0,51,51,51,51
El Dorado,25,2022-06-07,382,382,381,1,3394,3399,3386,13,6,0,0,5,219,219,219,219
Fresno,25,2022-06-07,2405,2406,2396,10,21221,21245,21153,92,92,3,3,8,2783,2783,2780,2780
Glenn,25,2022-06-07,44,44,44,0,311,311,310,1,5,0,0,0,53,53,53,53
Humboldt,25,2022-06-07,245,245,244,1,2880,2885,2875,10,14,1,1,2,150,150,149,149
Imperial,25,2022-06-07,458,458,456,2,4500,4505,4487,18,4,0,0,0,946,946,946,946
Inyo,25,2022-06-07,19,19,19,0,208,208,207,1,1,0,0,0,56,56,56,56
Kern,25,2022-06-07,1613,1613,1608,5,21717,21741,21672,69,28,1,1,7,2352,2352,2351,2351
Kings,25,2022-06-07,359,359,358,1,5255,5260,5240,20,11,0,0,1,450,450,450,450
Lake,25,2022-06-07,127,127,126,1,1128,1128,1123,5,4,0,0,3,140,140,140,140
Lassen,25,2022-06-07,65,65,65,0,2215,2216,2209,7,2,0,0,0,62,62,62,62
Los Angeles,25,2022-06-07,33437,33474,33438,36,952200,953254,952206,1048,491,41,41,64,32124,32124,32083,32083
Madera,25,2022-06-07,365,365,363,2,4444,4449,4430,19,7,0,0,2,370,370,370,370
Marin,25,2022-06-07,739,739,736,3,7378,7387,7355,32,13,3,3,3,301,301,298,298
Mariposa,25,2022-06-07,44,44,44,0,406,406,404,2,0,0,0,0,28,28,28,28
Mendocino,25,2022-06-07,191,191,190,1,1688,1688,1678,10,7,1,1,2,130,130,129,129
Merced,25,2022-06-07,555,555,553,2,4169,4174,4160,14,17,0,0,0,828,828,828,828
Modoc,25,2022-06-07,10,10,10,0,31,32,31,1,1,0,0,0,7,7,7,7
Mono,25,2022-06-07,15,15,15,0,102,102,101,1,0,0,0,0,6,6,6,6
Monterey,25,2022-06-07,955,955,948,7,9204,9215,9151,64,15,2,2,1,739,739,737,737
Napa,25,2022-06-07,545,545,543,2,3986,3991,3979,12,7,1,1,0,144,144,143,143
Nevada,25,2022-06-07,227,227,226,1,1990,1991,1982,9,5,0,0,0,133,133,133,133
Orange,25,2022-06-07,7251,7258,7239,19,71384,71465,71283,182,161,12,12,18,7177,7177,7165,7165
Placer,25,2022-06-07,846,846,842,4,7353,7361,7326,35,65,0,0,7,631,631,631,631
Plumas,25,2022-06-07,41,41,41,0,322,322,321,1,0,0,0,0,13,13,13,13
Riverside,25,2022-06-07,5139,5146,5128,18,52969,53028,52846,182,94,5,5,7,6486,6486,6481,6481
Sacramento,25,2022-06-07,4774,4780,4762,18,40227,40272,40124,148,145,15,15,22,3117,3117,3102,3102
San Benito,25,2022-06-07,259,259,258,1,1929,1929,1923,6,3,0,0,0,94,94,94,94
San Bernardino,25,2022-06-07,4929,4936,4922,14,52381,52440,52296,144,76,6,6,18,7862,7862,7856,7856
San Diego,25,2022-06-07,10299,10311,10299,12,93669,93772,93664,108,188,7,7,25,5386,5386,5379,5379
San Francisco,25,2022-06-07,3386,3390,3364,26,35947,35987,35713,274,81,2,2,11,908,908,906,906
San Joaquin,25,2022-06-07,2119,2119,2110,9,21127,21151,21065,86,44,5,5,8,2262,2262,2257,2257
San Luis Obispo,25,2022-06-07,803,803,800,3,6768,6774,6753,21,18,1,1,1,488,488,487,487
San Mateo,25,2022-06-07,3017,3021,3013,8,34095,34133,34045,88,37,2,2,3,720,720,718,718
Santa Barbara,25,2022-06-07,1167,1167,1163,4,13131,13147,13100,47,20,1,1,5,696,696,695,695
Santa Clara,25,2022-06-07,8213,8222,8212,10,95863,95970,95853,117,159,6,6,33,2350,2350,2344,2344
Santa Cruz,25,2022-06-07,913,913,910,3,9537,9547,9519,28,21,1,1,2,264,264,263,263
Shasta,25,2022-06-07,206,206,205,1,3650,3654,3641,13,12,2,2,2,567,567,565,565
Siskiyou,25,2022-06-07,42,42,42,0,387,387,386,1,2,0,0,0,83,83,83,83
Solano,25,2022-06-07,1691,1691,1685,6,14173,14190,14141,49,30,2,2,5,453,453,451,451
Sonoma,25,2022-06-07,1591,1591,1586,5,12791,12805,12762,43,36,1,1,2,499,499,498,498
Stanislaus,25,2022-06-07,1180,1180,1174,6,10049,10061,10007,54,60,1,1,4,1702,1702,1701,1701
Sutter,25,2022-06-07,197,197,196,1,1804,1804,1798,6,0,0,0,0,228,228,228,228
Tehama,25,2022-06-07,79,79,79,0,979,979,974,5,2,0,0,0,208,208,208,208
Trinity,25,2022-06-07,8,8,8,0,105,105,104,1,0,0,0,0,20,20,20,20
Tulare,25,2022-06-07,840,840,835,5,10165,10176,10121,55,23,0,0,0,1500,1500,1500,1500
Tuolumne,25,2022-06-07,118,118,117,1,1555,1555,1548,7,2,0,0,1,187,187,187,187
Ventura,25,2022-06-07,1907,1907,1903,4,22751,22777,22723,54,39,3,3,3,1518,1518,1515,1515
Yolo,25,2022-06-07,797,797,795,2,19808,19829,19767,62,2,1,1,1,365,365,364,364
Yuba,25,2022-06-07,202,202,201,1,1484,1484,1479,5,9,0,0,1,119,119,119,119
Alameda,26,2022-06-14,5022,5028,5017,11,54719,54784,54667,117,109,7,7,19,1921,1921,1914,1914
Amador,26,2022-06-14,85,85,85,0,1310,1310,1305,5,1,0,0,0,87,87,87,87
Butte,26,2022-06-14,408,408,407,1,3496,3501,3495,6,25,4,4,0,442,442,438,438
Calaveras,26,2022-06-14,76,76,76,0,644,644,642,2,0,0,0,0,124,124,124,124
Colusa,26,2022-06-14,11,11,11,0,255,255,254,1,13,0,0,0,21,21,21,21
Contra Costa,26,2022-06-14,3335,3340,3328,12,27717,27749,27649,100,81,7,7,10,1351,1351,1344,1344
Del Norte,26,2022-06-14,83,83,83,0,672,672,670,2,3,0,0,1,51,51,51,51
El Dorado,26,2022-06-14,327,327,326,1,3324,3329,3319,10,6,3,3,0,222,222,219,219
Fresno,26,2022-06-14,2401,2403,2395,8,20570,20593,20523,70,113,3,3,16,2786,2786,2783,2783
Glenn,26,2022-06-14,28,28,28,0,323,323,322,1,4,0,0,0,53,53,53,53
Humboldt,26,2022-06-14,277,277,276,1,2324,2326,2320,6,13,0,0,3,150,150,150,150
Imperial,26,2022-06-14,473,473,472,1,4544,4549,4535,14,5,1,1,0,947,947,946,946
Inyo,26,2022-06-14,13,13,13,0,186,187,186,1,0,0,0,0,56,56,56,56
Kern,26,2022-06-14,1551,1551,1547,4,21196,21222,21169,53,40,1,1,8,2353,2353,2352,2352
Kings,26,2022-06-14,366,366,365,1,5121,5126,5111,15,3,1,1,0,451,451,450,450
Lake,26,2022-06-14,143,143,143,0,1227,1227,1223,4,0,0,0,1,140,140,140,140
Lassen,26,2022-06-14,75,75,75,0,1815,1817,1813,4,1,0,0,0,62,62,62,62
Los Angeles,26,2022-06-14,28932,28966,28941,25,575852,576527,576026,501,541,52,52,65,32176,32176,32124,32124
Madera,26,2022-06-14,380,380,379,1,3965,3970,3957,13,8,0,0,1,370,370,370,370
Marin,26,2022-06-14,670,670,668,2,6746,6753,6730,23,18,1,1,2,302,302,301,301
Mariposa,26,2022-06-14,49,49,49,0,345,345,344,1,0,0,0,0,28,28,28,28
Mendocino,26,2022-06-14,158,158,157,1,1517,1517,1510,7,6,0,0,1,130,130,130,130
Merced,26,2022-06-14,517,517,516,1,4080,4085,4074,11,9,1,1,3,829,829,828,828
Modoc,26,2022-06-14,6,6,6,0,34,35,34,1,1,1,1,0,8,8,7,7
Mono,26,2022-06-14,18,18,18,0,98,98,97,1,0,1,1,0,7,7,6,6
Monterey,26,2022-06-14,832,832,828,4,8519,8531,8485,46,26,2,2,0,741,741,739,739
Napa,26,2022-06-14,425,425,424,1,3858,3863,3854,9,5,1,1,1,145,145,144,144
Nevada,26,2022-06-14,189,189,188,1,1821,1823,1817,6,10,0,0,1,133,133,133,133
Orange,26,2022-06-14,7108,7116,7102,14,65290,65368,65238,130,170,14,14,15,7191,7191,7177,7177
Placer,26,2022-06-14,769,769,766,3,6703,6710,6685,25,77,2,2,6,633,633,631,631
Plumas,26,2022-06-14,32,32,32,0,247,247,246,1,0,0,0,0,13,13,13,13
Riverside,26,2022-06-14,4997,5004,4991,13,47181,47237,47111,126,107,3,3,11,6489,6489,6486,6486
Sacramento,26,2022-06-14,4082,4087,4075,12,36910,36952,36846,106,187,11,11,23,3128,3128,3117,3117
San Benito,26,2022-06-14,179,179,179,0,1679,1679,1675,4,0,0,0,1,94,94,94,94
San Bernardino,26,2022-06-14,4701,4707,4697,10,48377,48434,48330,104,92,7,7,21,7869,7869,7862,7862
San Diego,26,2022-06-14,9530,9542,9533,9,83126,83225,83150,75,196,10,10,22,5396,5396,5386,5386
San Francisco,26,2022-06-14,3053,3056,3038,18,30877,30915,30732,183,72,9,9,14,917,917,908,908
San Joaquin,26,2022-06-14,1799,1799,1793,6,18967,18989,18929,60,32,4,4,4,2266,2266,2262,2262
San Luis Obispo,26,2022-06-14,655,655,653,2,6077,6083,6068,15,27,5,5,0,493,493,488,488
San Mateo,26,2022-06-14,2590,2592,2587,5,28426,28459,28402,57,44,2,2,4,722,722,720,720
Santa Barbara,26,2022-06-14,883,883,881,2,8977,8988,8963,25,26,1,1,5,697,697,696,696
Santa Clara,26,2022-06-14,6806,6813,6807,6,71567,71650,71582,68,188,15,15,17,2365,2365,2350,2350
Santa Cruz,26,2022-06-14,825,825,823,2,9767,9779,9756,23,20,1,1,1,265,265,264,264
Shasta,26,2022-06-14,218,218,217,1,3410,3414,3404,10,8,2,2,0,569,569,567,567
Siskiyou,26,2022-06-14,44,44,44,0,373,373,372,1,0,0,0,0,83,83,83,83
Solano,26,2022-06-14,1635,1635,1631,4,12538,12554,12520,34,34,0,0,4,453,453,453,453
Sonoma,26,2022-06-14,1352,1352,1348,4,11655,11670,11640,30,37,3,3,3,502,502,499,499
Stanislaus,26,2022-06-14,1111,1111,1106,5,9481,9493,9454,39,57,2,2,9,1704,1704,1702,1702
Sutter,26,2022-06-14,191,191,190,1,1905,1906,1901,5,0,0,0,0,228,228,228,228
Tehama,26,2022-06-14,95,95,95,0,997,997,993,4,4,0,0,0,208,208,208,208
Trinity,26,2022-06-14,11,11,11,0,91,92,91,1,0,0,0,0,20,20,20,20
Tulare,26,2022-06-14,837,837,833,4,9270,9280,9241,39,24,2,2,1,1502,1502,1500,1500
Tuolumne,26,2022-06-14,152,152,151,1,1399,1399,1394,5,1,0,0,0,187,187,187,187
Ventura,26,2022-06-14,1920,1920,1916,4,20255,20279,20242,37,43,3,3,4,1521,1521,1518,1518
Yolo,26,2022-06-14,748,748,746,2,13229,13244,13212,32,1,1,1,0,366,366,365,365
Yuba,26,2022-06-14,163,163,163,0,1446,1446,1442,4,10,0,0,1,119,119,119,119
Alameda,27,2022-06-21,5033,5040,5032,8,47978,48037,47957,80,111,13,13,11,1934,1934,1921,1921
Amador,27,2022-06-21,107,107,107,0,1276,1276,1273,3,4,0,0,0,87,87,87,87
Butte,27,2022-06-21,405,405,404,1,3543,3548,3543,5,29,4,4,1,446,446,442,442
Calaveras,27,2022-06-21,72,72,72,0,625,625,624,1,0,0,0,0,124,124,124,124
Colusa,27,2022-06-21,17,17,17,0,190,191,190,1,12,1,1,0,22,22,21,21
Contra Costa,27,2022-06-21,3368,3373,3364,9,25752,25783,25711,72,80,9,9,11,1360,1360,1351,1351
Del Norte,27,2022-06-21,82,82,82,0,587,587,586,1,3,1,1,1,52,52,51,51
El Dorado,27,2022-06-21,371,371,370,1,3115,3120,3113,7,6,2,2,1,224,224,222,222
Fresno,27,2022-06-21,2534,2536,2529,7,19615,19639,19587,52,100,2,2,15,2788,2788,2786,2786
Glenn,27,2022-06-21,41,41,41,0,318,318,317,1,2,0,0,0,53,53,53,53
Humboldt,27,2022-06-21,268,268,267,1,2262,2264,2259,5,10,1,1,2,151,151,150,150
Imperial,27,2022-06-21,635,635,634,1,3837,3842,3833,9,7,0,0,0,947,947,947,947
Inyo,27,2022-06-21,19,19,19,0,188,189,188,1,0,0,0,0,56,56,56,56
Kern,27,2022-06-21,1680,1680,1677,3,19902,19927,19888,39,44,5,5,9,2358,2358,2353,2353
Kings,27,2022-06-21,428,428,427,1,4781,4786,4775,11,13,1,1,0,452,452,451,451
Lake,27,2022-06-21,117,117,117,0,1258,1258,1255,3,2,0,0,1,140,140,140,140
Lassen,27,2022-06-21,40,40,40,0,1146,1147,1145,2,0,0,0,0,62,62,62,62
Los Angeles,27,2022-06-21,28365,28399,28380,19,353457,353888,353655,233,612,63,63,67,32239,32239,32176,32176
Madera,27,2022-06-21,335,335,334,1,4171,4175,4164,11,3,0,0,1,370,370,370,370
Marin,27,2022-06-21,690,690,688,2,6445,6451,6434,17,15,0,0,1,302,302,302,302
Mariposa,27,2022-06-21,53,53,53,0,327,327,326,1,0,0,0,0,28,28,28,28
Mendocino,27,2022-06-21,184,184,183,1,1588,1588,1582,6,2,0,0,0,130,130,130,130
Merced,27,2022-06-21,558,558,557,1,4057,4062,4054,8,6,2,2,1,831,831,829,829
Modoc,27,2022-06-21,5,5,5,0,36,37,36,1,0,0,0,0,8,8,8,8
Mono,27,2022-06-21,5,5,5,0,79,80,79,1,1,0,0,0,7,7,7,7
Monterey,27,2022-06-21,907,907,903,4,8878,8890,8853,37,39,1,1,4,742,742,741,741
Napa,27,2022-06-21,366,366,365,1,3139,3144,3138,6,4,1,1,1,146,146,145,145
Nevada,27,2022-06-21,164,164,164,0,1621,1621,1617,4,6,1,1,1,134,134,133,133
Orange,27,2022-06-21,7052,7061,7050,11,59254,59328,59236,92,169,10,10,20,7201,7201,7191,7191
Placer,27,2022-06-21,697,697,695,2,6139,6146,6128,18,65,3,3,8,636,636,633,633
Plumas,27,2022-06-21,39,39,39,0,254,254,253,1,0,0,0,0,13,13,13,13
Riverside,27,2022-06-21,5156,5163,5152,11,43375,43427,43337,90,111,8,8,12,6497,6497,6489,6489
Sacramento,27,2022-06-21,3956,3961,3952,9,35203,35246,35167,79,160,11,11,19,3139,3139,3128,3128
San Benito,27,2022-06-21,192,192,192,0,1601,1601,1598,3,0,1,1,2,95,95,94,94
San Bernardino,27,2022-06-21,4637,4644,4636,8,47422,47480,47401,79,109,12,12,18,7881,7881,7869,7869
San Diego,27,2022-06-21,9980,9992,9985,7,78992,79089,79034,55,202,10,10,20,5406,5406,5396,5396
San Francisco,27,2022-06-21,3138,3143,3129,14,28638,28672,28539,133,83,13,13,18,930,930,917,917
San Joaquin,27,2022-06-21,1733,1733,1729,4,18169,18192,18147,45,42,6,6,5,2272,2272,2266,2266
San Luis Obispo,27,2022-06-21,602,602,601,1,5737,5743,5732,11,26,6,6,0,499,499,493,493
San Mateo,27,2022-06-21,2691,2693,2689,4,26221,26255,26214,41,35,2,2,2,724,724,722,722
Santa Barbara,27,2022-06-21,990,990,988,2,8688,8700,8681,19,35,2,2,5,699,699,697,697
Santa Clara,27,2022-06-21,6988,6995,6990,5,63003,63079,63032,47,161,7,7,17,2372,2372,2365,2365
Santa Cruz,27,2022-06-21,853,853,851,2,9107,9119,9102,17,21,1,1,0,266,266,265,265
Shasta,27,2022-06-21,265,265,264,1,3414,3418,3410,8,7,0,0,1,569,569,569,569
Siskiyou,27,2022-06-21,70,70,70,0,394,394,393,1,3,1,1,0,84,84,83,83
Solano,27,2022-06-21,1510,1510,1507,3,12220,12236,12211,25,46,0,0,6,453,453,453,453
Sonoma,27,2022-06-21,1381,1381,1378,3,10554,10566,10544,22,31,1,1,4,503,503,502,502
Stanislaus,27,2022-06-21,1055,1055,1052,3,8661,8672,8644,28,73,4,4,8,1708,1708,1704,1704
Sutter,27,2022-06-21,200,200,200,0,1875,1876,1872,4,0,0,0,0,228,228,228,228
Tehama,27,2022-06-21,93,93,93,0,903,903,900,3,3,0,0,0,208,208,208,208
Trinity,27,2022-06-21,13,13,13,0,111,112,111,1,0,0,0,0,20,20,20,20
Tulare,27,2022-06-21,883,883,880,3,8427,8438,8410,28,30,8,8,1,1510,1510,1502,1502
Tuolumne,27,2022-06-21,154,154,154,0,1575,1575,1571,4,4,0,0,1,187,187,187,187
Ventura,27,2022-06-21,1879,1879,1876,3,18681,18704,18677,27,53,1,1,4,1522,1522,1521,1521
Yolo,27,2022-06-21,704,704,703,1,11232,11246,11225,21,4,2,2,2,368,368,366,366
Yuba,27,2022-06-21,157,157,157,0,1388,1388,1385,3,16,1,1,4,120,120,119,119
Alameda,28,2022-06-28,5517,5524,5517,7,47455,47515,47453,62,124,8,8,13,1942,1942,1934,1934
Amador,28,2022-06-28,93,93,93,0,1249,1249,1246,3,3,0,0,2,87,87,87,87
Butte,28,2022-06-28,394,394,394,0,3351,3355,3351,4,34,2,2,0,448,448,446,446
Calaveras,28,2022-06-28,75,75,75,0,568,568,567,1,0,2,2,0,126,126,124,124
Colusa,28,2022-06-28,31,31,31,0,280,281,280,1,5,0,0,0,22,22,22,22
Contra Costa,28,2022-06-28,3605,3610,3602,8,25614,25646,25590,56,81,8,8,6,1368,1368,1360,1360
Del Norte,28,2022-06-28,149,149,149,0,669,669,668,1,3,1,1,1,53,53,52,52
El Dorado,28,2022-06-28,422,422,421,1,3214,3219,3213,6,6,0,0,1,224,224,224,224
Fresno,28,2022-06-28,2809,2814,2808,6,19409,19434,19394,40,143,2,2,18,2790,2790,2788,2788
Glenn,28,2022-06-28,30,30,30,0,285,285,284,1,1,0,0,0,53,53,53,53
Humboldt,28,2022-06-28,248,248,248,0,2098,2100,2096,4,9,0,0,3,151,151,151,151
Imperial,28,2022-06-28,710,710,709,1,3865,3870,3863,7,6,0,0,4,947,947,947,947
Inyo,28,2022-06-28,38,38,38,0,328,328,327,1,0,0,0,0,56,56,56,56
Kern,28,2022-06-28,1889,1889,1886,3,17076,17097,17071,26,56,8,8,7,2366,2366,2358,2358
Kings,28,2022-06-28,476,476,475,1,3893,3898,3891,7,8,0,0,0,452,452,452,452
Lake,28,2022-06-28,119,119,119,0,1077,1077,1075,2,0,1,1,0,141,141,140,140
Lassen,28,2022-06-28,55,55,55,0,916,916,915,1,2,0,0,0,62,62,62,62
Los Angeles,28,2022-06-28,33553,33595,33578,17,355680,356129,355946,183,702,71,71,77,32310,32310,32239,32239
Madera,28,2022-06-28,417,417,416,1,4226,4231,4222,9,11,0,0,1,370,370,370,370
Marin,28,2022-06-28,664,664,663,1,6055,6061,6049,12,19,1,1,2,303,303,302,302
Mariposa,28,2022-06-28,50,50,50,0,309,309,308,1,0,0,0,0,28,28,28,28
Mendocino,28,2022-06-28,154,154,154,0,1428,1428,1424,4,6,1,1,2,131,131,130,130
Merced,28,2022-06-28,630,630,629,1,3893,3898,3892,6,16,2,2,0,833,833,831,831
Modoc,28,2022-06-28,11,11,11,0,31,32,31,1,1,0,0,0,8,8,8,8
Mono,28,2022-06-28,25,25,25,0,110,111,110,1,0,0,0,0,7,7,7,7
Monterey,28,2022-06-28,937,937,934,3,8137,8149,8122,27,46,2,2,2,744,744,742,742
Napa,28,2022-06-28,388,388,387,1,3302,3307,3302,5,4,2,2,3,148,148,146,146
Nevada,28,2022-06-28,194,194,194,0,1573,1573,1570,3,6,0,0,3,134,134,134,134
Orange,28,2022-06-28,7647,7656,7647,9,59610,59685,59613,72,190,18,18,23,7219,7219,7201,7201
Placer,28,2022-06-28,803,803,801,2,6055,6062,6048,14,88,4,4,5,640,640,636,636
Plumas,28,2022-06-28,49,49,49,0,241,242,241,1,2,0,0,0,13,13,13,13
Riverside,28,2022-06-28,6408,6416,6406,10,44970,45026,44953,73,142,10,10,14,6507,6507,6497,6497
Sacramento,28,2022-06-28,4183,4188,4181,7,34405,34447,34387,60,169,13,13,18,3152,3152,3139,3139
San Benito,28,2022-06-28,230,230,230,0,1692,1692,1690,2,0,0,0,1,95,95,95,95
San Bernardino,28,2022-06-28,5932,5940,5932,8,47649,47709,47647,62,127,13,13,26,7894,7894,7881,7881
San Diego,28,2022-06-28,10808,10821,10815,6,78696,78795,78752,43,264,9,9,36,5415,5415,5406,5406
San Francisco,28,2022-06-28,3208,3213,3202,11,28445,28480,28377,103,99,6,6,20,936,936,930,930
San Joaquin,28,2022-06-28,1911,1911,1907,4,17749,17772,17738,34,39,2,2,6,2274,2274,2272,2272
San Luis Obispo,28,2022-06-28,656,656,655,1,5628,5634,5626,8,31,2,2,0,501,501,499,499
San Mateo,28,2022-06-28,2860,2864,2861,3,26352,26386,26354,32,44,2,2,1,726,726,724,724
Santa Barbara,28,2022-06-28,1150,1150,1148,2,9635,9647,9631,16,26,3,3,3,702,702,699,699
Santa Clara,28,2022-06-28,7762,7771,7767,4,60867,60944,60909,35,211,12,12,19,2384,2384,2372,2372
Santa Cruz,28,2022-06-28,858,858,857,1,9378,9390,9377,13,18,1,1,2,267,267,266,266
Shasta,28,2022-06-28,343,343,342,1,3257,3262,3256,6,22,0,0,2,569,569,569,569
Siskiyou,28,2022-06-28,60,60,60,0,357,358,357,1,5,1,1,0,85,85,84,84
Solano,28,2022-06-28,1593,1593,1590,3,12368,12384,12364,20,46,0,0,4,453,453,453,453
Sonoma,28,2022-06-28,1322,1322,1320,2,9920,9933,9917,16,26,2,2,6,505,505,503,503
Stanislaus,28,2022-06-28,1251,1251,1248,3,8648,8659,8637,22,103,2,2,8,1710,1710,1708,1708
Sutter,28,2022-06-28,206,206,206,0,1853,1854,1851,3,0,0,0,0,228,228,228,228
Tehama,28,2022-06-28,100,100,100,0,894,894,892,2,2,0,0,1,208,208,208,208
Trinity,28,2022-06-28,21,21,21,0,145,146,145,1,2,0,0,0,20,20,20,20
Tulare,28,2022-06-28,940,940,938,2,7843,7851,7831,20,33,0,0,2,1510,1510,1510,1510
Tuolumne,28,2022-06-28,171,171,171,0,1455,1455,1452,3,2,4,4,1,191,191,187,187
Ventura,28,2022-06-28,2134,2135,2133,2,18428,18451,18430,21,67,3,3,1,1525,1525,1522,1522
Yolo,28,2022-06-28,758,758,757,1,10264,10276,10261,15,6,1,1,1,369,369,368,368
Yuba,28,2022-06-28,174,174,174,0,1374,1374,1372,2,8,1,1,2,121,121,120,120
Alameda,29,2022-07-05,5046,5053,5048,5,41059,41113,41071,42,130,12,12,15,1954,1954,1942,1942
Amador,29,2022-07-05,64,64,64,0,1484,1485,1482,3,3,0,0,1,87,87,87,87
Butte,29,2022-07-05,340,340,340,0,2583,2586,2584,2,25,2,2,1,450,450,448,448
Calaveras,29,2022-07-05,77,77,77,0,500,500,499,1,1,2,2,0,128,128,126,126
Colusa,29,2022-07-05,21,21,21,0,155,156,155,1,4,0,0,0,22,22,22,22
Contra Costa,29,2022-07-05,3354,3358,3352,6,22513,22542,22504,38,83,11,11,10,1379,1379,1368,1368
Del Norte,29,2022-07-05,152,152,152,0,614,614,613,1,3,0,0,0,53,53,53,53
El Dorado,29,2022-07-05,326,326,326,0,2595,2599,2595,4,9,1,1,0,225,225,224,224
Fresno,29,2022-07-05,2640,2644,2640,4,16596,16618,16591,27,163,6,6,17,2796,2796,2790,2790
Glenn,29,2022-07-05,26,26,26,0,168,169,168,1,1,0,0,0,53,53,53,53
Humboldt,29,2022-07-05,224,224,224,0,1738,1739,1737,2,10,2,2,3,153,153,151,151
Imperial,29,2022-07-05,770,770,769,1,3440,3444,3439,5,19,1,1,2,948,948,947,947
Inyo,29,2022-07-05,36,36,36,0,321,322,321,1,0,0,0,0,56,56,56,56
Kern,29,2022-07-05,1883,1884,1882,2,14626,14644,14627,17,66,4,4,11,2370,2370,2366,2366
Kings,29,2022-07-05,500,500,499,1,3462,3466,3461,5,9,0,0,0,452,452,452,452
Lake,29,2022-07-05,101,101,101,0,847,847,846,1,4,1,1,0,142,142,141,141
Lassen,29,2022-07-05,30,30,30,0,604,604,603,1,4,0,0,0,62,62,62,62
Los Angeles,29,2022-07-05,34551,34597,34583,14,305349,305745,305622,123,831,86,86,89,32396,32396,32310,32310
Madera,29,2022-07-05,370,370,369,1,3221,3224,3219,5,9,0,0,1,370,370,370,370
Marin,29,2022-07-05,618,618,617,1,5302,5308,5300,8,28,1,1,2,304,304,303,303
Mariposa,29,2022-07-05,37,37,37,0,228,229,228,1,0,0,0,0,28,28,28,28
Mendocino,29,2022-07-05,170,170,170,0,1183,1183,1180,3,10,2,2,2,133,133,131,131
Merced,29,2022-07-05,617,617,616,1,3305,3309,3305,4,16,2,2,2,835,835,833,833
Modoc,29,2022-07-05,13,13,13,0,34,35,34,1,0,0,0,0,8,8,8,8
Mono,29,2022-07-05,23,23,23,0,91,92,91,1,1,0,0,0,7,7,7,7
Monterey,29,2022-07-05,886,886,884,2,6644,6653,6636,17,32,2,2,3,746,746,744,744
Napa,29,2022-07-05,336,336,336,0,2859,2863,2860,3,9,0,0,1,148,148,148,148
Nevada,29,2022-07-05,189,189,189,0,1412,1412,1410,2,8,0,0,0,134,134,134,134
Orange,29,2022-07-05,7419,7430,7423,7,52741,52810,52760,50,215,27,27,34,7246,7246,7219,7219
Placer,29,2022-07-05,867,867,865,2,5191,5197,5188,9,72,3,3,7,643,643,640,640
Plumas,29,2022-07-05,45,45,45,0,199,200,199,1,3,0,0,0,13,13,13,13
Riverside,29,2022-07-05,6887,6896,6887,9,40644,40697,40645,52,149,5,5,21,6512,6512,6507,6507
Sacramento,29,2022-07-05,3634,3638,3633,5,28273,28310,28271,39,171,19,19,29,3171,3171,3152,3152
San Benito,29,2022-07-05,212,212,212,0,1338,1339,1338,1,2,0,0,0,95,95,95,95
San Bernardino,29,2022-07-05,6563,6571,6564,7,45476,45535,45489,46,154,12,12,22,7906,7906,7894,7894
San Diego,29,2022-07-05,10302,10314,10310,4,69291,69381,69352,29,296,9,9,45,5424,5424,5415,5415
San Francisco,29,2022-07-05,2964,2968,2960,8,24666,24698,24628,70,98,10,10,19,946,946,936,936
San Joaquin,29,2022-07-05,1743,1744,1741,3,15479,15499,15476,23,41,7,7,4,2281,2281,2274,2274
San Luis Obispo,29,2022-07-05,690,690,689,1,4367,4372,4367,5,20,0,0,0,501,501,501,501
San Mateo,29,2022-07-05,2646,2649,2646,3,21788,21817,21796,21,41,2,2,3,728,728,726,726
Santa Barbara,29,2022-07-05,1094,1094,1093,1,8156,8168,8157,11,29,4,4,4,706,706,702,702
Santa Clara,29,2022-07-05,6875,6883,6880,3,52636,52705,52681,24,203,16,16,36,2400,2400,2384,2384
Santa Cruz,29,2022-07-05,761,761,760,1,7466,7476,7468,8,23,0,0,0,267,267,267,267
Shasta,29,2022-07-05,296,296,296,0,2787,2790,2786,4,18,5,5,3,574,574,569,569
Siskiyou,29,2022-07-05,30,30,30,0,310,311,310,1,1,0,0,1,85,85,85,85
Solano,29,2022-07-05,1387,1387,1385,2,10138,10151,10138,13,48,0,0,6,453,453,453,453
Sonoma,29,2022-07-05,1189,1189,1188,1,8501,8513,8502,11,38,2,2,0,507,507,505,505
Stanislaus,29,2022-07-05,1229,1229,1227,2,7239,7249,7235,14,92,7,7,17,1717,1717,1710,1710
Sutter,29,2022-07-05,236,236,236,0,1530,1531,1529,2,0,0,0,0,228,228,228,228
Tehama,29,2022-07-05,136,136,136,0,815,815,813,2,4,1,1,0,209,209,208,208
Trinity,29,2022-07-05,20,20,20,0,134,135,134,1,2,0,0,0,20,20,20,20
Tulare,29,2022-07-05,1006,1006,1004,2,6919,6928,6914,14,38,5,5,1,1515,1515,1510,1510
Tuolumne,29,2022-07-05,173,173,173,0,941,941,939,2,7,0,0,0,191,191,191,191
Ventura,29,2022-07-05,2038,2039,2037,2,16151,16171,16157,14,73,3,3,3,1528,1528,1525,1525
Yolo,29,2022-07-05,503,503,502,1,6848,6856,6848,8,6,2,2,1,371,371,369,369
Yuba,29,2022-07-05,179,179,179,0,1124,1124,1123,1,10,0,0,1,121,121,121,121
Alameda,30,2022-07-12,5567,5574,5570,4,45372,45432,45396,36,138,7,7,21,1961,1961,1954,1954
Amador,30,2022-07-12,87,87,87,0,1415,1416,1414,2,1,0,0,0,87,87,87,87
Butte,30,2022-07-12,446,446,446,0,3164,3169,3167,2,25,2,2,5,452,452,450,450
Calaveras,30,2022-07-12,84,84,84,0,551,551,550,1,0,1,1,1,129,129,128,128
Colusa,30,2022-07-12,26,26,26,0,479,480,479,1,1,0,0,0,22,22,22,22
Contra Costa,30,2022-07-12,3446,3451,3446,5,24551,24583,24550,33,85,11,11,15,1390,1390,1379,1379
Del Norte,30,2022-07-12,172,172,172,0,660,660,659,1,6,0,0,2,53,53,53,53
El Dorado,30,2022-07-12,357,357,357,0,2917,2922,2919,3,9,2,2,3,227,227,225,225
Fresno,30,2022-07-12,3694,3699,3694,5,21078,21105,21079,26,170,8,8,13,2804,2804,2796,2796
Glenn,30,2022-07-12,40,40,40,0,365,366,365,1,0,0,0,0,53,53,53,53
Humboldt,30,2022-07-12,279,279,279,0,2066,2068,2066,2,10,1,1,3,154,154,153,153
Imperial,30,2022-07-12,1067,1067,1066,1,4532,4537,4532,5,17,3,3,1,951,951,948,948
Inyo,30,2022-07-12,39,39,39,0,358,359,358,1,0,1,1,0,57,57,56,56
Kern,30,2022-07-12,2364,2366,2364,2,16649,16670,16655,15,73,2,2,9,2372,2372,2370,2370
Kings,30,2022-07-12,731,731,730,1,4380,4385,4380,5,12,4,4,1,456,456,452,452
Lake,30,2022-07-12,139,139,139,0,1030,1030,1029,1,0,0,0,1,142,142,142,142
Lassen,30,2022-07-12,58,58,58,0,804,804,803,1,0,1,1,0,63,63,62,62
Los Angeles,30,2022-07-12,41990,42047,42034,13,360923,361406,361293,113,1047,103,103,123,32499,32499,32396,32396
Madera,30,2022-07-12,525,525,524,1,3994,3999,3994,5,11,0,0,3,370,370,370,370
Marin,30,2022-07-12,575,575,574,1,5743,5749,5742,7,12,2,2,4,306,306,304,304
Mariposa,30,2022-07-12,50,50,50,0,258,259,258,1,0,0,0,0,28,28,28,28
Mendocino,30,2022-07-12,193,193,193,0,1345,1345,1343,2,3,0,0,1,133,133,133,133
Merced,30,2022-07-12,760,760,759,1,4026,4031,4027,4,15,5,5,2,840,840,835,835
Modoc,30,2022-07-12,26,26,26,0,52,53,52,1,0,0,0,0,8,8,8,8
Mono,30,2022-07-12,9,9,9,0,95,96,95,1,0,0,0,0,7,7,7,7
Monterey,30,2022-07-12,1071,1071,1069,2,7652,7663,7648,15,43,6,6,3,752,752,746,746
Napa,30,2022-07-12,363,363,363,0,3364,3369,3366,3,14,1,1,1,149,149,148,148
Nevada,30,2022-07-12,196,196,196,0,1682,1684,1682,2,9,0,0,2,134,134,134,134
Orange,30,2022-07-12,9521,9533,9526,7,62616,62699,62653,46,274,19,19,27,7265,7265,7246,7246
Placer,30,2022-07-12,719,719,718,1,5645,5653,5645,8,75,2,2,7,645,645,643,643
Plumas,30,2022-07-12,64,64,64,0,275,276,275,1,0,0,0,0,13,13,13,13
Riverside,30,2022-07-12,9001,9013,9004,9,49988,50054,50005,49,223,15,15,13,6527,6527,6512,6512
Sacramento,30,2022-07-12,3969,3975,3971,4,33105,33149,33114,35,197,20,20,25,3191,3191,3171,3171
San Benito,30,2022-07-12,217,217,217,0,1608,1609,1608,1,2,0,0,0,95,95,95,95
San Bernardino,30,2022-07-12,8220,8232,8225,7,55342,55416,55372,44,200,17,17,28,7923,7923,7906,7906
San Diego,30,2022-07-12,13417,13435,13431,4,83104,83216,83188,28,353,13,13,45,5437,5437,5424,5424
San Francisco,30,2022-07-12,2801,2806,2800,6,26787,26824,26765,59,106,12,12,24,958,958,946,946
San Joaquin,30,2022-07-12,2117,2119,2117,2,18717,18742,18720,22,56,6,6,17,2287,2287,2281,2281
San Luis Obispo,30,2022-07-12,674,674,673,1,4968,4973,4968,5,18,3,3,0,504,504,501,501
San Mateo,30,2022-07-12,2658,2662,2660,2,24663,24696,24678,18,33,5,5,6,733,733,728,728
Santa Barbara,30,2022-07-12,1311,1311,1310,1,9065,9077,9068,9,43,4,4,5,710,710,706,706
Santa Clara,30,2022-07-12,6974,6983,6981,2,57106,57182,57162,20,211,10,10,41,2410,2410,2400,2400
Santa Cruz,30,2022-07-12,983,983,982,1,8806,8818,8810,8,20,0,0,1,267,267,267,267
Shasta,30,2022-07-12,307,307,307,0,3271,3275,3272,3,26,3,3,6,577,577,574,574
Siskiyou,30,2022-07-12,29,29,29,0,360,361,360,1,3,1,1,1,86,86,85,85
Solano,30,2022-07-12,1493,1493,1492,1,10855,10870,10859,11,42,1,1,5,454,454,453,453
Sonoma,30,2022-07-12,1200,1200,1199,1,9520,9532,9523,9,39,0,0,6,507,507,507,507
Stanislaus,30,2022-07-12,1428,1428,1426,2,8583,8595,8582,13,99,8,8,8,1725,1725,1717,1717
Sutter,30,2022-07-12,284,284,284,0,1822,1823,1821,2,0,0,0,0,228,228,228,228
Tehama,30,2022-07-12,122,122,122,0,910,910,909,1,8,0,0,1,209,209,209,209
Trinity,30,2022-07-12,32,32,32,0,116,117,116,1,1,0,0,0,20,20,20,20
Tulare,30,2022-07-12,1336,1336,1334,2,8868,8879,8865,14,45,3,3,2,1518,1518,1515,1515
Tuolumne,30,2022-07-12,251,251,251,0,1217,1217,1215,2,7,0,0,0,191,191,191,191
Ventura,30,2022-07-12,2475,2479,2477,2,19306,19333,19320,13,89,8,8,6,1536,1536,1528,1528
Yolo,30,2022-07-12,475,475,475,0,4908,4913,4909,4,8,3,3,2,374,374,371,371
Yuba,30,2022-07-12,215,215,215,0,1347,1347,1346,1,9,0,0,0,121,121,121,121
Alameda,31,2022-07-19,4771,4778,4775,3,43005,43065,43039,26,148,11,11,23,1972,1972,1961,1961
Amador,31,2022-07-19,92,92,92,0,1372,1373,1372,1,4,0,0,1,87,87,87,87
Butte,31,2022-07-19,345,345,345,0,2945,2949,2948,1,29,0,0,1,452,452,452,452
Calaveras,31,2022-07-19,73,73,73,0,543,544,543,1,0,0,0,1,129,129,129,129
Colusa,31,2022-07-19,22,22,22,0,348,349,348,1,3,0,0,0,22,22,22,22
Contra Costa,31,2022-07-19,3046,3051,3048,3,22923,22955,22931,24,83,6,6,18,1396,1396,1390,1390
Del Norte,31,2022-07-19,148,148,148,0,685,685,684,1,9,0,0,1,53,53,53,53
El Dorado,31,2022-07-19,274,274,274,0,2597,2602,2600,2,11,0,0,2,227,227,227,227
Fresno,31,2022-07-19,3620,3626,3622,4,20986,21015,20995,20,201,11,11,18,2815,2815,2804,2804
Glenn,31,2022-07-19,33,33,33,0,273,274,273,1,2,0,0,0,53,53,53,53
Humboldt,31,2022-07-19,277,277,277,0,2003,2005,2003,2,11,0,0,3,154,154,154,154
Imperial,31,2022-07-19,1028,1028,1027,1,4508,4513,4509,4,24,0,0,2,951,951,951,951
Inyo,31,2022-07-19,31,31,31,0,328,329,328,1,1,0,0,0,57,57,57,57
Kern,31,2022-07-19,2297,2299,2297,2,16170,16191,16179,12,86,10,10,13,2382,2382,2372,2372
Kings,31,2022-07-19,665,665,664,1,4133,4138,4134,4,18,1,1,0,457,457,456,456
Lake,31,2022-07-19,128,128,128,0,1008,1008,1007,1,4,0,0,0,142,142,142,142
Lassen,31,2022-07-19,75,75,75,0,1289,1290,1289,1,0,0,0,0,63,63,63,63
Los Angeles,31,2022-07-19,41535,41593,41583,10,352284,352773,352687,86,1191,107,107,137,32606,32606,32499,32499
Madera,31,2022-07-19,548,548,547,1,3699,3704,3700,4,7,0,0,2,370,370,370,370
Marin,31,2022-07-19,508,508,508,0,5411,5417,5412,5,17,0,0,5,306,306,306,306
Mariposa,31,2022-07-19,42,42,42,0,259,260,259,1,0,1,1,0,29,29,28,28
Mendocino,31,2022-07-19,175,175,175,0,1488,1488,1486,2,6,0,0,2,133,133,133,133
Merced,31,2022-07-19,749,749,748,1,3940,3945,3942,3,13,1,1,0,841,841,840,840
Modoc,31,2022-07-19,8,8,8,0,34,35,34,1,1,1,1,0,9,9,8,8
Mono,31,2022-07-19,11,11,11,0,80,81,80,1,2,0,0,0,7,7,7,7
Monterey,31,2022-07-19,980,980,978,2,7207,7218,7207,11,42,6,6,4,758,758,752,752
Napa,31,2022-07-19,297,297,297,0,3012,3017,3015,2,7,2,2,2,151,151,149,149
Nevada,31,2022-07-19,132,132,132,0,1345,1346,1345,1,8,0,0,0,134,134,134,134
Orange,31,2022-07-19,8703,8715,8710,5,59410,59493,59459,34,260,25,25,47,7290,7290,7265,7265
Placer,31,2022-07-19,662,662,661,1,5214,5220,5214,6,94,1,1,7,646,646,645,645
Plumas,31,2022-07-19,58,58,58,0,262,263,262,1,0,0,0,0,13,13,13,13
Riverside,31,2022-07-19,8095,8107,8101,6,47736,47803,47766,37,231,18,18,20,6545,6545,6527,6527
Sacramento,31,2022-07-19,3615,3621,3618,3,30712,30754,30729,25,175,14,14,30,3205,3205,3191,3191
San Benito,31,2022-07-19,202,202,202,0,1585,1586,1585,1,0,1,1,0,96,96,95,95
San Bernardino,31,2022-07-19,7875,7887,7882,5,53343,53417,53384,33,230,13,13,38,7936,7936,7923,7923
San Diego,31,2022-07-19,13018,13036,13033,3,79369,79478,79458,20,401,17,17,46,5454,5454,5437,5437
San Francisco,31,2022-07-19,2483,2487,2483,4,25553,25588,25544,44,117,8,8,25,966,966,958,958
San Joaquin,31,2022-07-19,2005,2006,2004,2,17708,17733,17717,16,72,3,3,15,2290,2290,2287,2287
San Luis Obispo,31,2022-07-19,547,547,547,0,4682,4687,4684,3,18,3,3,1,507,507,504,504
San Mateo,31,2022-07-19,2261,2264,2263,1,22893,22925,22912,13,28,0,0,8,733,733,733,733
Santa Barbara,31,2022-07-19,1287,1287,1286,1,9290,9303,9296,7,55,3,3,2,713,713,710,710
Santa Clara,31,2022-07-19,6107,6114,6112,2,54183,54259,54244,15,206,16,16,34,2426,2426,2410,2410
Santa Cruz,31,2022-07-19,873,873,872,1,7348,7358,7353,5,24,1,1,4,268,268,267,267
Shasta,31,2022-07-19,313,313,313,0,3146,3150,3147,3,39,2,2,2,579,579,577,577
Siskiyou,31,2022-07-19,32,32,32,0,337,338,337,1,3,0,0,0,86,86,86,86
Solano,31,2022-07-19,1267,1267,1266,1,9558,9571,9564,7,49,1,1,6,455,455,454,454
Sonoma,31,2022-07-19,1038,1038,1037,1,8726,8739,8732,7,43,0,0,4,507,507,507,507
Stanislaus,31,2022-07-19,1394,1394,1392,2,8292,8304,8294,10,109,5,5,12,1730,1730,1725,1725
Sutter,31,2022-07-19,244,244,244,0,1699,1700,1699,1,0,0,0,0,228,228,228,228
Tehama,31,2022-07-19,117,117,117,0,910,910,909,1,5,1,1,1,210,210,209,209
Trinity,31,2022-07-19,20,20,20,0,110,111,110,1,0,0,0,0,20,20,20,20
Tulare,31,2022-07-19,1192,1192,1191,1,8085,8096,8086,10,47,0,0,0,1518,1518,1518,1518
Tuolumne,31,2022-07-19,235,235,235,0,1168,1168,1167,1,6,4,4,0,195,195,191,191
Ventura,31,2022-07-19,2311,2313,2312,1,19210,19238,19228,10,86,5,5,6,1541,1541,1536,1536
Yolo,31,2022-07-19,433,433,433,0,4682,4687,4684,3,1,3,3,0,377,377,374,374
Yuba,31,2022-07-19,212,212,212,0,1323,1323,1322,1,20,0,0,0,121,121,121,121
Alameda,32,2022-07-26,4381,4388,4386,2,39964,40022,40003,19,148,12,12,23,1984,1984,1972,1972
Amador,32,2022-07-26,88,88,88,0,1182,1182,1181,1,3,1,1,1,88,88,87,87
Butte,32,2022-07-26,365,365,365,0,2880,2884,2883,1,24,1,1,2,453,453,452,452
Calaveras,32,2022-07-26,82,82,82,0,544,545,544,1,3,2,2,1,131,131,129,129
Colusa,32,2022-07-26,25,25,25,0,379,380,379,1,1,0,0,0,22,22,22,22
Contra Costa,32,2022-07-26,2842,2847,2845,2,21667,21698,21680,18,104,5,5,16,1401,1401,1396,1396
Del Norte,32,2022-07-26,64,64,64,0,535,536,535,1,6,0,0,0,53,53,53,53
El Dorado,32,2022-07-26,257,257,257,0,2447,2451,2449,2,7,1,1,0,228,228,227,227
Fresno,32,2022-07-26,3362,3367,3364,3,20080,20110,20095,15,216,7,7,25,2822,2822,2815,2815
Glenn,32,2022-07-26,37,37,37,0,273,274,273,1,0,0,0,0,53,53,53,53
Humboldt,32,2022-07-26,222,222,222,0,1927,1929,1928,1,15,2,2,4,156,156,154,154
Imperial,32,2022-07-26,827,827,826,1,4164,4169,4166,3,19,2,2,7,953,953,951,951
Inyo,32,2022-07-26,16,16,16,0,286,287,286,1,2,1,1,0,58,58,57,57
Kern,32,2022-07-26,1910,1911,1910,1,15453,15476,15467,9,90,2,2,16,2384,2384,2382,2382
Kings,32,2022-07-26,600,600,600,0,3890,3895,3892,3,9,1,1,0,458,458,457,457
Lake,32,2022-07-26,127,127,127,0,1066,1066,1065,1,3,1,1,1,143,143,142,142
Lassen,32,2022-07-26,56,56,56,0,1037,1038,1037,1,1,0,0,0,63,63,63,63
Los Angeles,32,2022-07-26,36139,36192,36185,7,327250,327730,327668,62,1143,124,124,137,32730,32730,32606,32606
Madera,32,2022-07-26,520,520,520,0,3904,3909,3906,3,11,1,1,5,371,371,370,370
Marin,32,2022-07-26,482,482,482,0,5624,5632,5628,4,30,2,2,2,308,308,306,306
Mariposa,32,2022-07-26,35,35,35,0,216,217,216,1,0,0,0,0,29,29,29,29
Mendocino,32,2022-07-26,206,206,206,0,1412,1412,1411,1,5,0,0,0,133,133,133,133
Merced,32,2022-07-26,723,723,723,0,3830,3835,3833,2,18,3,3,2,844,844,841,841
Modoc,32,2022-07-26,9,9,9,0,27,28,27,1,1,0,0,0,9,9,9,9
Mono,32,2022-07-26,16,16,16,0,85,86,85,1,0,0,0,0,7,7,7,7
Monterey,32,2022-07-26,925,925,924,1,6923,6934,6926,8,39,0,0,2,758,758,758,758
Napa,32,2022-07-26,301,301,301,0,2886,2891,2890,1,4,3,3,2,154,154,151,151
Nevada,32,2022-07-26,114,114,114,0,1325,1325,1324,1,5,1,1,1,135,135,134,134
Orange,32,2022-07-26,7792,7804,7801,3,56845,56927,56902,25,302,35,35,39,7325,7325,7290,7290
Placer,32,2022-07-26,602,602,601,1,5074,5081,5077,4,80,5,5,11,651,651,646,646
Plumas,32,2022-07-26,22,22,22,0,177,178,177,1,0,0,0,0,13,13,13,13
Riverside,32,2022-07-26,7318,7330,7326,4,45909,45975,45947,28,240,14,14,33,6559,6559,6545,6545
Sacramento,32,2022-07-26,3546,3552,3550,2,29320,29363,29344,19,192,16,16,33,3221,3221,3205,3205
San Benito,32,2022-07-26,194,194,194,0,1848,1850,1849,1,1,1,1,0,97,97,96,96
San Bernardino,32,2022-07-26,7008,7019,7016,3,52037,52112,52087,25,217,27,27,20,7963,7963,7936,7936
San Diego,32,2022-07-26,11359,11376,11374,2,74424,74533,74518,15,389,23,23,48,5477,5477,5454,5454
San Francisco,32,2022-07-26,2197,2200,2197,3,23938,23974,23942,32,120,11,11,28,977,977,966,966
San Joaquin,32,2022-07-26,1797,1798,1797,1,16261,16286,16274,12,77,5,5,7,2295,2295,2290,2290
San Luis Obispo,32,2022-07-26,547,547,547,0,4297,4302,4300,2,17,5,5,1,512,512,507,507
San Mateo,32,2022-07-26,2029,2031,2030,1,21802,21835,21825,10,58,1,1,10,734,734,733,733
Santa Barbara,32,2022-07-26,1175,1175,1174,1,8537,8550,8545,5,38,2,2,3,715,715,713,713
Santa Clara,32,2022-07-26,5688,5695,5694,1,50140,50213,50202,11,243,16,16,25,2442,2442,2426,2426
Santa Cruz,32,2022-07-26,804,804,804,0,7754,7765,7761,4,23,0,0,0,268,268,268,268
Shasta,32,2022-07-26,309,309,309,0,3012,3017,3015,2,30,2,2,7,581,581,579,579
Siskiyou,32,2022-07-26,35,35,35,0,340,341,340,1,3,0,0,0,86,86,86,86
Solano,32,2022-07-26,1215,1215,1214,1,9565,9579,9573,6,50,0,0,6,455,455,455,455
Sonoma,32,2022-07-26,1046,1046,1045,1,8623,8636,8631,5,53,2,2,4,509,509,507,507
Stanislaus,32,2022-07-26,1353,1353,1352,1,8018,8031,8024,7,109,11,11,12,1741,1741,1730,1730
Sutter,32,2022-07-26,234,234,234,0,1689,1690,1689,1,0,0,0,0,228,228,228,228
Tehama,32,2022-07-26,99,99,99,0,913,913,912,1,5,2,2,0,212,212,210,210
Trinity,32,2022-07-26,12,12,12,0,100,101,100,1,1,0,0,0,20,20,20,20
Tulare,32,2022-07-26,1160,1160,1159,1,8026,8036,8028,8,45,2,2,1,1520,1520,1518,1518
Tuolumne,32,2022-07-26,183,183,183,0,1115,1115,1114,1,4,1,1,1,196,196,195,195
Ventura,32,2022-07-26,2078,2079,2078,1,18025,18051,18044,7,83,7,7,6,1548,1548,1541,1541
Yolo,32,2022-07-26,408,408,408,0,4507,4512,4510,2,2,4,4,1,381,381,377,377
Yuba,32,2022-07-26,178,178,178,0,1274,1274,1273,1,11,0,0,0,121,121,121,121
Alameda,33,2022-08-02,3763,3770,3769,1,36166,36221,36207,14,161,8,8,25,1992,1992,1984,1984
Amador,33,2022-08-02,47,47,47,0,1148,1148,1147,1,3,0,0,1,88,88,88,88
Butte,33,2022-08-02,350,350,350,0,2695,2699,2698,1,31,2,2,1,455,455,453,453
Calaveras,33,2022-08-02,60,60,60,0,583,584,583,1,2,2,2,1,133,133,131,131
Colusa,33,2022-08-02,28,28,28,0,365,366,365,1,5,0,0,0,22,22,22,22
Contra Costa,33,2022-08-02,2535,2540,2538,2,20532,20563,20550,13,91,13,13,16,1414,1414,1401,1401
Del Norte,33,2022-08-02,50,50,50,0,476,477,476,1,5,0,0,0,53,53,53,53
El Dorado,33,2022-08-02,220,220,220,0,2442,2447,2446,1,5,3,3,1,231,231,228,228
Fresno,33,2022-08-02,2863,2868,2866,2,18141,18168,18157,11,218,6,6,19,2828,2828,2822,2822
Glenn,33,2022-08-02,28,28,28,0,246,247,246,1,1,0,0,0,53,53,53,53
Humboldt,33,2022-08-02,224,224,224,0,1912,1915,1914,1,13,0,0,3,156,156,156,156
Imperial,33,2022-08-02,630,630,630,0,3545,3550,3548,2,16,4,4,3,957,957,953,953
Inyo,33,2022-08-02,22,22,22,0,271,272,271,1,0,0,0,0,58,58,58,58
Kern,33,2022-08-02,1677,1677,1676,1,14918,14940,14933,7,70,7,7,14,2391,2391,2384,2384
Kings,33,2022-08-02,581,581,581,0,3896,3901,3899,2,9,0,0,1,458,458,458,458
Lake,33,2022-08-02,134,134,134,0,961,961,960,1,5,0,0,1,143,143,143,143
Lassen,33,2022-08-02,116,116,116,0,1002,1004,1003,1,0,0,0,0,63,63,63,63
Los Angeles,33,2022-08-02,29492,29537,29533,4,305876,306341,306296,45,1135,128,128,138,32858,32858,32730,32730
Madera,33,2022-08-02,459,459,459,0,3317,3322,3320,2,8,0,0,9,371,371,371,371
Marin,33,2022-08-02,391,391,391,0,4994,5000,4997,3,29,1,1,3,309,309,308,308
Mariposa,33,2022-08-02,24,24,24,0,228,229,228,1,0,0,0,0,29,29,29,29
Mendocino,33,2022-08-02,160,160,160,0,1225,1225,1224,1,7,1,1,2,134,134,133,133
Merced,33,2022-08-02,642,642,642,0,3606,3611,3609,2,22,5,5,3,849,849,844,844
Modoc,33,2022-08-02,11,11,11,0,31,32,31,1,1,0,0,0,9,9,9,9
Mono,33,2022-08-02,8,8,8,0,71,72,71,1,0,0,0,0,7,7,7,7
Monterey,33,2022-08-02,917,917,916,1,6292,6303,6297,6,33,3,3,0,761,761,758,758
Napa,33,2022-08-02,287,287,287,0,2666,2671,2670,1,12,1,1,1,155,155,154,154
Nevada,33,2022-08-02,125,125,125,0,1343,1344,1343,1,10,0,0,2,135,135,135,135
Orange,33,2022-08-02,6220,6231,6229,2,51454,51531,51513,18,237,35,35,37,7360,7360,7325,7325
Placer,33,2022-08-02,573,573,573,0,4696,4703,4700,3,61,1,1,11,652,652,651,651
Plumas,33,2022-08-02,21,21,21,0,183,184,183,1,0,0,0,0,13,13,13,13
Riverside,33,2022-08-02,6054,6065,6062,3,41895,41959,41939,20,198,6,6,25,6565,6565,6559,6559
Sacramento,33,2022-08-02,3002,3007,3005,2,27611,27653,27639,14,189,19,19,25,3240,3240,3221,3221
San Benito,33,2022-08-02,164,164,164,0,1403,1404,1403,1,0,1,1,0,98,98,97,97
San Bernardino,33,2022-08-02,5834,5842,5840,2,48329,48402,48384,18,185,26,26,21,7989,7989,7963,7963
San Diego,33,2022-08-02,9009,9022,9021,1,68478,68582,68571,11,375,12,12,53,5489,5489,5477,5477
San Francisco,33,2022-08-02,1755,1756,1754,2,21511,21545,21523,22,99,11,11,22,988,988,977,977
San Joaquin,33,2022-08-02,1713,1714,1713,1,16117,16141,16132,9,67,6,6,9,2301,2301,2295,2295
San Luis Obispo,33,2022-08-02,572,572,572,0,4048,4053,4051,2,17,2,2,0,514,514,512,512
San Mateo,33,2022-08-02,1696,1696,1695,1,19964,19994,19987,7,68,1,1,4,735,735,734,734
Santa Barbara,33,2022-08-02,1099,1099,1098,1,7882,7894,7890,4,34,1,1,4,716,716,715,715
Santa Clara,33,2022-08-02,4718,4725,4724,1,44609,44676,44669,7,241,17,17,37,2459,2459,2442,2442
Santa Cruz,33,2022-08-02,733,733,733,0,6526,6537,6534,3,27,1,1,3,269,269,268,268
Shasta,33,2022-08-02,221,221,221,0,2975,2979,2978,1,34,1,1,5,582,582,581,581
Siskiyou,33,2022-08-02,32,32,32,0,295,296,295,1,1,1,1,0,87,87,86,86
Solano,33,2022-08-02,1081,1081,1080,1,8894,8907,8903,4,47,0,0,7,455,455,455,455
Sonoma,33,2022-08-02,931,931,931,0,8127,8140,8136,4,45,4,4,4,513,513,509,509
Stanislaus,33,2022-08-02,1209,1209,1208,1,7452,7465,7460,5,104,2,2,9,1743,1743,1741,1741
Sutter,33,2022-08-02,241,241,241,0,1645,1646,1645,1,0,3,3,0,231,231,228,228
Tehama,33,2022-08-02,88,88,88,0,669,670,669,1,2,0,0,0,212,212,212,212
Trinity,33,2022-08-02,10,10,10,0,80,81,80,1,0,1,1,0,21,21,20,20
Tulare,33,2022-08-02,1001,1001,1000,1,7237,7247,7242,5,44,2,2,5,1522,1522,1520,1520
Tuolumne,33,2022-08-02,144,144,144,0,1096,1096,1095,1,6,0,0,2,196,196,196,196
Ventura,33,2022-08-02,1757,1757,1756,1,16935,16960,16955,5,76,8,8,12,1556,1556,1548,1548
Yolo,33,2022-08-02,320,320,320,0,4072,4077,4075,2,2,2,2,2,383,383,381,381
Yuba,33,2022-08-02,145,145,145,0,1171,1171,1170,1,11,0,0,2,121,121,121,121
Alameda,34,2022-08-09,3110,3115,3114,1,35419,35473,35463,10,132,13,13,21,2005,2005,1992,1992
Amador,34,2022-08-09,49,49,49,0,819,820,819,1,2,0,0,1,88,88,88,88
Butte,34,2022-08-09,330,330,330,0,2479,2484,2483,1,24,1,1,2,456,456,455,455
Calaveras,34,2022-08-09,59,59,59,0,559,560,559,1,2,0,0,0,133,133,133,133
Colusa,34,2022-08-09,11,11,11,0,352,353,352,1,0,0,0,0,22,22,22,22
Contra Costa,34,2022-08-09,2158,2162,2161,1,19754,19785,19775,10,90,5,5,20,1419,1419,1414,1414
Del Norte,34,2022-08-09,52,52,52,0,495,496,495,1,4,1,1,0,54,54,53,53
El Dorado,34,2022-08-09,192,192,192,0,2326,2331,2330,1,4,0,0,3,231,231,231,231
Fresno,34,2022-08-09,2329,2334,2333,1,17310,17338,17330,8,186,10,10,26,2838,2838,2828,2828
Glenn,34,2022-08-09,20,20,20,0,248,249,248,1,0,0,0,0,53,53,53,53
Humboldt,34,2022-08-09,215,215,215,0,1816,1818,1817,1,15,1,1,2,157,157,156,156
Imperial,34,2022-08-09,495,495,495,0,3122,3127,3126,1,15,2,2,2,959,959,957,957
Inyo,34,2022-08-09,5,5,5,0,263,264,263,1,0,1,1,1,59,59,58,58
Kern,34,2022-08-09,1359,1359,1359,0,13873,13894,13889,5,69,6,6,14,2397,2397,2391,2391
Kings,34,2022-08-09,434,434,434,0,3258,3263,3262,1,16,1,1,2,459,459,458,458
Lake,34,2022-08-09,98,98,98,0,899,900,899,1,2,0,0,2,143,143,143,143
Lassen,34,2022-08-09,125,125,125,0,1071,1073,1072,1,1,0,0,0,63,63,63,63
Los Angeles,34,2022-08-09,24680,24719,24716,3,291181,291638,291604,34,983,127,127,122,32985,32985,32858,32858
Madera,34,2022-08-09,355,355,355,0,3064,3069,3068,1,19,0,0,3,371,371,371,371
Marin,34,2022-08-09,363,363,363,0,4355,4361,4359,2,23,2,2,4,311,311,309,309
Mariposa,34,2022-08-09,28,28,28,0,180,181,180,1,0,0,0,0,29,29,29,29
Mendocino,34,2022-08-09,122,122,122,0,1058,1058,1057,1,3,1,1,1,135,135,134,134
Merced,34,2022-08-09,496,496,496,0,3339,3344,3343,1,14,1,1,7,850,850,849,849
Modoc,34,2022-08-09,3,3,3,0,23,24,23,1,1,0,0,0,9,9,9,9
Mono,34,2022-08-09,9,9,9,0,81,82,81,1,0,0,0,0,7,7,7,7
Monterey,34,2022-08-09,693,693,692,1,5836,5846,5842,4,31,0,0,0,761,761,761,761
Napa,34,2022-08-09,239,239,239,0,2661,2666,2665,1,10,1,1,2,156,156,155,155
Nevada,34,2022-08-09,99,99,99,0,1308,1309,1308,1,1,0,0,0,135,135,135,135
Orange,34,2022-08-09,5322,5329,5328,1,48246,48321,48308,13,236,32,32,50,7392,7392,7360,7360
Placer,34,2022-08-09,505,505,505,0,4525,4532,4530,2,66,3,3,10,655,655,652,652
Plumas,34,2022-08-09,22,22,22,0,181,182,181,1,0,0,0,0,13,13,13,13
Riverside,34,2022-08-09,5354,5361,5359,2,40199,40262,40247,15,167,14,14,15,6579,6579,6565,6565
Sacramento,34,2022-08-09,2584,2589,2588,1,26784,26826,26816,10,162,17,17,21,3257,3257,3240,3240
San Benito,34,2022-08-09,193,193,193,0,1426,1428,1427,1,2,1,1,0,99,99,98,98
San Bernardino,34,2022-08-09,5024,5031,5030,1,45788,45861,45848,13,188,19,19,17,8008,8008,7989,7989
San Diego,34,2022-08-09,6938,6950,6949,1,63635,63735,63727,8,300,12,12,26,5501,5501,5489,5489
San Francisco,34,2022-08-09,1463,1463,1462,1,20454,20486,20469,17,104,13,13,20,1001,1001,988,988
San Joaquin,34,2022-08-09,1515,1515,1514,1,15654,15679,15672,7,61,6,6,9,2307,2307,2301,2301
San Luis Obispo,34,2022-08-09,476,476,476,0,3508,3513,3512,1,14,1,1,2,515,515,514,514
San Mateo,34,2022-08-09,1449,1449,1449,0,18254,18283,18278,5,60,0,0,4,735,735,735,735
Santa Barbara,34,2022-08-09,923,923,923,0,7278,7290,7287,3,45,3,3,5,719,719,716,716
Santa Clara,34,2022-08-09,4021,4028,4027,1,40956,41019,41014,5,188,17,17,35,2476,2476,2459,2459
Santa Cruz,34,2022-08-09,589,589,589,0,6056,6065,6063,2,28,1,1,0,270,270,269,269
Shasta,34,2022-08-09,200,200,200,0,2903,2907,2906,1,24,2,2,4,584,584,582,582
Siskiyou,34,2022-08-09,24,24,24,0,288,289,288,1,0,0,0,0,87,87,87,87
Solano,34,2022-08-09,845,845,845,0,7707,7720,7717,3,47,0,0,10,455,455,455,455
Sonoma,34,2022-08-09,782,782,782,0,7527,7539,7536,3,37,3,3,3,516,516,513,513
Stanislaus,34,2022-08-09,984,984,983,1,7201,7214,7210,4,93,7,7,12,1750,1750,1743,1743
Sutter,34,2022-08-09,204,204,204,0,1563,1564,1563,1,0,0,0,0,231,231,231,231
Tehama,34,2022-08-09,71,71,71,0,698,699,698,1,0,0,0,1,212,212,212,212
Trinity,34,2022-08-09,4,4,4,0,59,60,59,1,0,0,0,0,21,21,21,21
Tulare,34,2022-08-09,852,852,852,0,7293,7303,7299,4,48,3,3,5,1525,1525,1522,1522
Tuolumne,34,2022-08-09,107,107,107,0,1051,1052,1051,1,1,2,2,0,198,198,196,196
Ventura,34,2022-08-09,1493,1493,1493,0,15692,15716,15712,4,78,8,8,6,1564,1564,1556,1556
Yolo,34,2022-08-09,290,290,290,0,3852,3857,3856,1,6,1,1,1,384,384,383,383
Yuba,34,2022-08-09,136,136,136,0,1098,1099,1098,1,7,1,1,0,122,122,121,121
Alameda,35,2022-08-16,2511,2516,2515,1,33946,34002,33994,8,106,9,9,21,2014,2014,2005,2005
Amador,35,2022-08-16,53,53,53,0,906,907,906,1,3,0,0,0,88,88,88,88
Butte,35,2022-08-16,231,231,231,0,2204,2209,2208,1,20,0,0,2,456,456,456,456
Calaveras,35,2022-08-16,43,43,43,0,527,528,527,1,0,0,0,0,133,133,133,133
Colusa,35,2022-08-16,19,19,19,0,377,378,377,1,0,0,0,0,22,22,22,22
Contra Costa,35,2022-08-16,1686,1686,1685,1,18848,18878,18871,7,56,7,7,10,1426,1426,1419,1419
Del Norte,35,2022-08-16,50,50,50,0,508,509,508,1,2,0,0,0,54,54,54,54
El Dorado,35,2022-08-16,182,182,182,0,2288,2293,2292,1,4,0,0,3,231,231,231,231
Fresno,35,2022-08-16,1813,1815,1814,1,16246,16273,16267,6,172,6,6,14,2844,2844,2838,2838
Glenn,35,2022-08-16,17,17,17,0,228,229,228,1,2,0,0,0,53,53,53,53
Humboldt,35,2022-08-16,161,161,161,0,1619,1621,1620,1,12,0,0,2,157,157,157,157
Imperial,35,2022-08-16,352,352,352,0,3218,3223,3222,1,10,0,0,0,959,959,959,959
Inyo,35,2022-08-16,14,14,14,0,258,259,258,1,3,0,0,0,59,59,59,59
Kern,35,2022-08-16,1167,1167,1167,0,13746,13767,13763,4,56,7,7,16,2404,2404,2397,2397
Kings,35,2022-08-16,346,346,346,0,3287,3292,3291,1,9,0,0,1,459,459,459,459
Lake,35,2022-08-16,99,99,99,0,1006,1007,1006,1,3,1,1,2,144,144,143,143
Lassen,35,2022-08-16,47,47,47,0,829,830,829,1,0,0,0,0,63,63,63,63
Los Angeles,35,2022-08-16,20713,20747,20745,2,287676,288143,288117,26,886,114,114,123,33099,33099,32985,32985
Madera,35,2022-08-16,302,302,302,0,2867,2872,2871,1,9,0,0,3,371,371,371,371
Marin,35,2022-08-16,283,283,283,0,4021,4027,4026,1,13,0,0,2,311,311,311,311
Mariposa,35,2022-08-16,12,12,12,0,187,188,187,1,0,0,0,0,29,29,29,29
Mendocino,35,2022-08-16,109,109,109,0,998,999,998,1,7,0,0,3,135,135,135,135
Merced,35,2022-08-16,454,454,454,0,3460,3465,3464,1,14,3,3,3,853,853,850,850
Modoc,35,2022-08-16,7,7,7,0,23,24,23,1,0,0,0,0,9,9,9,9
Mono,35,2022-08-16,6,6,6,0,66,67,66,1,0,0,0,0,7,7,7,7
Monterey,35,2022-08-16,674,674,674,0,6014,6024,6021,3,37,0,0,2,761,761,761,761
Napa,35,2022-08-16,202,202,202,0,2184,2189,2188,1,12,0,0,0,156,156,156,156
Nevada,35,2022-08-16,95,95,95,0,1182,1184,1183,1,5,0,0,1,135,135,135,135
Orange,35,2022-08-16,4527,4534,4533,1,42600,42669,42660,9,269,27,27,45,7419,7419,7392,7392
Placer,35,2022-08-16,411,411,411,0,4426,4433,4431,2,64,1,1,11,656,656,655,655
Plumas,35,2022-08-16,18,18,18,0,174,175,174,1,0,0,0,0,13,13,13,13
Riverside,35,2022-08-16,4589,4596,4595,1,37699,37760,37749,11,143,15,15,24,6594,6594,6579,6579
Sacramento,35,2022-08-16,2356,2361,2360,1,25183,25224,25216,8,157,12,12,22,3269,3269,3257,3257
San Benito,35,2022-08-16,128,128,128,0,1316,1318,1317,1,3,0,0,1,99,99,99,99
San Bernardino,35,2022-08-16,4739,4746,4745,1,44364,44435,44425,10,158,17,17,25,8025,8025,8008,8008
San Diego,35,2022-08-16,5253,5260,5259,1,58869,58965,58959,6,275,13,13,35,5514,5514,5501,5501
San Francisco,35,2022-08-16,1224,1224,1223,1,19614,19646,19634,12,106,16,16,11,1017,1017,1001,1001
San Joaquin,35,2022-08-16,1386,1386,1386,0,15150,15174,15169,5,63,7,7,7,2314,2314,2307,2307
San Luis Obispo,35,2022-08-16,297,297,297,0,3287,3292,3291,1,17,4,4,2,519,519,515,515
San Mateo,35,2022-08-16,1223,1223,1223,0,17507,17536,17532,4,52,1,1,4,736,736,735,735
Santa Barbara,35,2022-08-16,795,795,795,0,7154,7166,7164,2,40,2,2,4,721,721,719,719
Santa Clara,35,2022-08-16,3315,3322,3322,0,40318,40384,40380,4,181,8,8,27,2484,2484,2476,2476
Santa Cruz,35,2022-08-16,497,497,497,0,8512,8526,8524,2,20,3,3,3,273,273,270,270
Shasta,35,2022-08-16,188,188,188,0,2711,2715,2714,1,18,0,0,2,584,584,584,584
Siskiyou,35,2022-08-16,19,19,19,0,280,281,280,1,3,0,0,1,87,87,87,87
Solano,35,2022-08-16,630,630,630,0,7377,7389,7387,2,49,0,0,11,455,455,455,455
Sonoma,35,2022-08-16,610,610,610,0,7222,7234,7232,2,31,3,3,2,519,519,516,516
Stanislaus,35,2022-08-16,957,957,957,0,7675,7688,7685,3,105,10,10,10,1760,1760,1750,1750
Sutter,35,2022-08-16,193,193,193,0,1553,1555,1554,1,0,1,1,0,232,232,231,231
Tehama,35,2022-08-16,58,58,58,0,649,650,649,1,1,0,0,0,212,212,212,212
Trinity,35,2022-08-16,11,11,11,0,61,62,61,1,0,0,0,0,21,21,21,21
Tulare,35,2022-08-16,730,730,730,0,7240,7251,7248,3,32,3,3,1,1528,1528,1525,1525
Tuolumne,35,2022-08-16,110,110,110,0,981,982,981,1,1,0,0,0,198,198,198,198
Ventura,35,2022-08-16,1501,1501,1501,0,15194,15218,15215,3,76,4,4,4,1568,1568,1564,1564
Yolo,35,2022-08-16,244,244,244,0,3455,3460,3459,1,3,4,4,2,388,388,384,384
Yuba,35,2022-08-16,127,127,127,0,1099,1100,1099,1,9,0,0,0,122,122,122,122
Alameda,36,2022-08-23,2247,2251,2251,0,33742,33798,33792,6,110,12,12,16,2026,2026,2014,2014
Amador,36,2022-08-23,42,42,42,0,813,814,813,1,2,1,1,1,89,89,88,88
Butte,36,2022-08-23,248,248,248,0,2103,2108,2107,1,18,1,1,1,457,457,456,456
Calaveras,36,2022-08-23,52,52,52,0,590,591,590,1,0,0,0,0,133,133,133,133
Colusa,36,2022-08-23,15,15,15,0,366,367,366,1,0,0,0,0,22,22,22,22
Contra Costa,36,2022-08-23,1496,1496,1496,0,18686,18717,18711,6,50,5,5,10,1431,1431,1426,1426
Del Norte,36,2022-08-23,28,28,28,0,466,467,466,1,2,1,1,0,55,55,54,54
El Dorado,36,2022-08-23,143,143,143,0,2108,2113,2112,1,5,1,1,0,232,232,231,231
Fresno,36,2022-08-23,1528,1528,1528,0,15615,15641,15637,4,162,6,6,15,2850,2850,2844,2844
Glenn,36,2022-08-23,16,16,16,0,204,205,204,1,1,0,0,0,53,53,53,53
Humboldt,36,2022-08-23,150,150,150,0,1728,1732,1731,1,5,1,1,4,158,158,157,157
Imperial,36,2022-08-23,319,319,319,0,2825,2830,2829,1,14,0,0,1,959,959,959,959
Inyo,36,2022-08-23,9,9,9,0,210,211,210,1,0,0,0,0,59,59,59,59
Kern,36,2022-08-23,962,962,962,0,13864,13888,13885,3,60,5,5,11,2409,2409,2404,2404
Kings,36,2022-08-23,347,347,347,0,3704,3709,3708,1,10,2,2,0,461,461,459,459
Lake,36,2022-08-23,111,111,111,0,883,884,883,1,2,0,0,0,144,144,144,144
Lassen,36,2022-08-23,38,38,38,0,792,793,792,1,0,0,0,0,63,63,63,63
Los Angeles,36,2022-08-23,17989,18019,18018,1,277853,278314,278295,19,844,111,111,106,33210,33210,33099,33099
Madera,36,2022-08-23,299,299,299,0,2661,2665,2664,1,10,2,2,4,373,373,371,371
Marin,36,2022-08-23,238,238,238,0,3957,3963,3962,1,15,0,0,3,311,311,311,311
Mariposa,36,2022-08-23,19,19,19,0,188,189,188,1,0,0,0,0,29,29,29,29
Mendocino,36,2022-08-23,124,124,124,0,1159,1160,1159,1,2,0,0,1,135,135,135,135
Merced,36,2022-08-23,452,452,452,0,3560,3565,3564,1,11,3,3,3,856,856,853,853
Modoc,36,2022-08-23,2,2,2,0,23,24,23,1,0,0,0,0,9,9,9,9
Mono,36,2022-08-23,2,2,2,0,53,54,53,1,0,0,0,0,7,7,7,7
Monterey,36,2022-08-23,512,512,512,0,5739,5749,5746,3,26,2,2,2,763,763,761,761
Napa,36,2022-08-23,129,129,129,0,1975,1980,1979,1,6,2,2,2,158,158,156,156
Nevada,36,2022-08-23,88,88,88,0,1178,1180,1179,1,3,0,0,0,135,135,135,135
Orange,36,2022-08-23,3770,3777,3776,1,41431,41500,41493,7,221,22,22,37,7441,7441,7419,7419
Placer,36,2022-08-23,401,401,401,0,4304,4311,4310,1,62,1,1,11,657,657,656,656
Plumas,36,2022-08-23,17,17,17,0,183,184,183,1,1,0,0,0,13,13,13,13
Riverside,36,2022-08-23,4290,4297,4296,1,38144,38208,38200,8,136,13,13,17,6607,6607,6594,6594
Sacramento,36,2022-08-23,2027,2031,2031,0,24926,24968,24962,6,140,15,15,28,3284,3284,3269,3269
San Benito,36,2022-08-23,108,108,108,0,1302,1304,1303,1,1,1,1,1,100,100,99,99
San Bernardino,36,2022-08-23,4591,4598,4597,1,44623,44698,44690,8,156,15,15,20,8040,8040,8025,8025
San Diego,36,2022-08-23,4626,4633,4633,0,57953,58049,58045,4,283,6,6,25,5520,5520,5514,5514
San Francisco,36,2022-08-23,1068,1068,1067,1,18749,18781,18772,9,90,13,13,13,1030,1030,1017,1017
San Joaquin,36,2022-08-23,1167,1167,1167,0,15172,15198,15194,4,50,2,2,7,2316,2316,2314,2314
San Luis Obispo,36,2022-08-23,274,274,274,0,3144,3149,3148,1,19,0,0,0,519,519,519,519
San Mateo,36,2022-08-23,971,971,971,0,17185,17214,17211,3,41,0,0,0,736,736,736,736
Santa Barbara,36,2022-08-23,760,760,760,0,7578,7591,7589,2,36,0,0,1,721,721,721,721
Santa Clara,36,2022-08-23,2980,2986,2986,0,40632,40701,40698,3,167,8,8,30,2492,2492,2484,2484
Santa Cruz,36,2022-08-23,506,506,506,0,12964,12986,12984,2,17,0,0,0,273,273,273,273
Shasta,36,2022-08-23,166,166,166,0,2751,2755,2754,1,17,2,2,1,586,586,584,584
Siskiyou,36,2022-08-23,26,26,26,0,260,261,260,1,2,1,1,2,88,88,87,87
Solano,36,2022-08-23,511,511,511,0,7170,7183,7181,2,41,0,0,11,455,455,455,455
Sonoma,36,2022-08-23,597,597,597,0,7252,7264,7262,2,30,0,0,4,519,519,519,519
Stanislaus,36,2022-08-23,918,918,918,0,7878,7892,7889,3,81,6,6,16,1766,1766,1760,1760
Sutter,36,2022-08-23,192,192,192,0,1600,1602,1601,1,0,0,0,0,232,232,232,232
Tehama,36,2022-08-23,51,51,51,0,631,632,631,1,1,0,0,0,212,212,212,212
Trinity,36,2022-08-23,12,12,12,0,65,66,65,1,0,0,0,0,21,21,21,21
Tulare,36,2022-08-23,724,724,724,0,6864,6875,6873,2,34,4,4,1,1532,1532,1528,1528
Tuolumne,36,2022-08-23,121,121,121,0,1003,1004,1003,1,1,1,1,0,199,199,198,198
Ventura,36,2022-08-23,1227,1227,1227,0,14832,14856,14854,2,62,4,4,8,1572,1572,1568,1568
Yolo,36,2022-08-23,204,204,204,0,3536,3541,3540,1,7,1,1,1,389,389,388,388
Yuba,36,2022-08-23,131,131,131,0,1050,1051,1050,1,11,0,0,2,122,122,122,122
Alameda,37,2022-08-30,1955,1960,1960,0,34038,34097,34092,5,85,10,10,36,2036,2036,2026,2026
Amador,37,2022-08-30,55,55,55,0,822,823,822,1,2,1,1,0,90,90,89,89
Butte,37,2022-08-30,229,229,229,0,2257,2262,2261,1,22,0,0,3,457,457,457,457
Calaveras,37,2022-08-30,49,49,49,0,575,576,575,1,1,0,0,0,133,133,133,133
Colusa,37,2022-08-30,9,9,9,0,328,329,328,1,1,0,0,0,22,22,22,22
Contra Costa,37,2022-08-30,1286,1286,1286,0,18715,18747,18743,4,48,5,5,9,1436,1436,1431,1431
Del Norte,37,2022-08-30,28,28,28,0,390,391,390,1,5,0,0,1,55,55,55,55
El Dorado,37,2022-08-30,136,136,136,0,1963,1968,1967,1,0,0,0,0,232,232,232,232
Fresno,37,2022-08-30,1405,1405,1405,0,15715,15743,15740,3,162,4,4,16,2854,2854,2850,2850
Glenn,37,2022-08-30,23,23,23,0,231,232,231,1,3,0,0,0,53,53,53,53
Humboldt,37,2022-08-30,126,126,126,0,1563,1565,1564,1,4,0,0,0,158,158,158,158
Imperial,37,2022-08-30,264,264,264,0,2914,2919,2918,1,20,1,1,0,960,960,959,959
Inyo,37,2022-08-30,7,7,7,0,168,169,168,1,0,0,0,0,59,59,59,59
Kern,37,2022-08-30,920,920,920,0,13595,13618,13616,2,57,1,1,6,2410,2410,2409,2409
Kings,37,2022-08-30,332,332,332,0,3480,3485,3484,1,7,0,0,0,461,461,461,461
Lake,37,2022-08-30,83,83,83,0,849,850,849,1,3,3,3,0,147,147,144,144
Lassen,37,2022-08-30,32,32,32,0,811,812,811,1,0,0,0,0,63,63,63,63
Los Angeles,37,2022-08-30,14868,14893,14892,1,276238,276711,276696,15,717,84,84,79,33294,33294,33210,33210
Madera,37,2022-08-30,287,287,287,0,3106,3111,3110,1,15,0,0,5,373,373,373,373
Marin,37,2022-08-30,216,216,216,0,3849,3855,3854,1,18,2,2,1,313,313,311,311
Mariposa,37,2022-08-30,22,22,22,0,175,176,175,1,0,0,0,0,29,29,29,29
Mendocino,37,2022-08-30,80,80,80,0,954,955,954,1,3,0,0,1,135,135,135,135
Merced,37,2022-08-30,377,377,377,0,3427,3432,3431,1,11,3,3,0,859,859,856,856
Modoc,37,2022-08-30,2,2,2,0,34,35,34,1,0,0,0,0,9,9,9,9
Mono,37,2022-08-30,3,3,3,0,51,52,51,1,0,0,0,0,7,7,7,7
Monterey,37,2022-08-30,358,358,358,0,5308,5318,5316,2,28,1,1,4,764,764,763,763
Napa,37,2022-08-30,123,123,123,0,2220,2226,2225,1,9,0,0,0,158,158,158,158
Nevada,37,2022-08-30,114,114,114,0,1214,1216,1215,1,6,0,0,0,135,135,135,135
Orange,37,2022-08-30,2879,2884,2884,0,39740,39809,39804,5,177,18,18,27,7459,7459,7441,7441
Placer,37,2022-08-30,331,331,331,0,4257,4264,4263,1,60,1,1,12,658,658,657,657
Plumas,37,2022-08-30,17,17,17,0,160,161,160,1,0,0,0,0,13,13,13,13
Riverside,37,2022-08-30,3580,3587,3586,1,36754,36817,36811,6,126,10,10,14,6617,6617,6607,6607
Sacramento,37,2022-08-30,1816,1818,1818,0,24434,24475,24470,5,145,13,13,20,3297,3297,3284,3284
San Benito,37,2022-08-30,111,111,111,0,1406,1409,1408,1,0,0,0,0,100,100,100,100
San Bernardino,37,2022-08-30,3525,3532,3532,0,42622,42695,42689,6,152,14,14,17,8054,8054,8040,8040
San Diego,37,2022-08-30,3875,3882,3882,0,56817,56914,56911,3,226,14,14,28,5534,5534,5520,5520
San Francisco,37,2022-08-30,827,827,827,0,18964,18995,18988,7,53,8,8,11,1038,1038,1030,1030
San Joaquin,37,2022-08-30,970,970,970,0,14159,14182,14179,3,43,4,4,7,2320,2320,2316,2316
San Luis Obispo,37,2022-08-30,306,306,306,0,3194,3199,3198,1,18,3,3,0,522,522,519,519
San Mateo,37,2022-08-30,832,832,832,0,16460,16488,16486,2,29,0,0,5,736,736,736,736
Santa Barbara,37,2022-08-30,611,611,611,0,7585,7597,7596,1,31,2,2,2,723,723,721,721
Santa Clara,37,2022-08-30,2319,2324,2324,0,39995,40065,40063,2,146,7,7,26,2499,2499,2492,2492
Santa Cruz,37,2022-08-30,368,368,368,0,12559,12580,12578,2,8,0,0,1,273,273,273,273
Shasta,37,2022-08-30,133,133,133,0,2561,2566,2565,1,19,1,1,0,587,587,586,586
Siskiyou,37,2022-08-30,24,24,24,0,231,232,231,1,1,1,1,0,89,89,88,88
Solano,37,2022-08-30,540,540,540,0,7472,7485,7484,1,38,2,2,8,457,457,455,455
Sonoma,37,2022-08-30,485,485,485,0,7152,7165,7164,1,36,1,1,2,520,520,519,519
Stanislaus,37,2022-08-30,804,804,804,0,8008,8021,8019,2,79,8,8,7,1774,1774,1766,1766
Sutter,37,2022-08-30,163,163,163,0,1649,1652,1651,1,0,0,0,0,232,232,232,232
Tehama,37,2022-08-30,70,70,70,0,730,731,730,1,4,1,1,1,213,213,212,212
Trinity,37,2022-08-30,5,5,5,0,52,53,52,1,0,0,0,0,21,21,21,21
Tulare,37,2022-08-30,645,645,645,0,7159,7170,7168,2,40,0,0,2,1532,1532,1532,1532
Tuolumne,37,2022-08-30,83,83,83,0,844,845,844,1,0,0,0,0,199,199,199,199
Ventura,37,2022-08-30,1007,1007,1007,0,14758,14783,14781,2,59,7,7,6,1579,1579,1572,1572
Yolo,37,2022-08-30,192,192,192,0,3564,3569,3568,1,5,1,1,6,390,390,389,389
Yuba,37,2022-08-30,126,126,126,0,1183,1184,1183,1,10,0,0,0,122,122,122,122
Alameda,38,2022-09-06,1424,1425,1425,0,29340,29393,29390,3,104,2,2,17,2038,2038,2036,2036
Amador,38,2022-09-06,34,34,34,0,675,676,675,1,5,0,0,1,90,90,90,90
Butte,38,2022-09-06,198,198,198,0,2243,2247,2246,1,17,3,3,3,460,460,457,457
Calaveras,38,2022-09-06,24,24,24,0,475,476,475,1,0,0,0,0,133,133,133,133
Colusa,38,2022-09-06,15,15,15,0,292,293,292,1,2,0,0,0,22,22,22,22
Contra Costa,38,2022-09-06,966,966,966,0,15958,15985,15982,3,47,4,4,9,1440,1440,1436,1436
Del Norte,38,2022-09-06,13,13,13,0,402,403,402,1,1,0,0,1,55,55,55,55
El Dorado,38,2022-09-06,98,98,98,0,1670,1673,1672,1,2,1,1,3,233,233,232,232
Fresno,38,2022-09-06,1092,1092,1092,0,13451,13475,13473,2,158,11,11,17,2865,2865,2854,2854
Glenn,38,2022-09-06,12,12,12,0,191,192,191,1,1,0,0,0,53,53,53,53
Humboldt,38,2022-09-06,103,103,103,0,1376,1378,1377,1,14,1,1,1,159,159,158,158
Imperial,38,2022-09-06,245,245,245,0,2631,2636,2635,1,11,1,1,0,961,961,960,960
Inyo,38,2022-09-06,13,13,13,0,170,171,170,1,0,0,0,0,59,59,59,59
Kern,38,2022-09-06,704,704,704,0,11368,11387,11386,1,43,4,4,7,2414,2414,2410,2410
Kings,38,2022-09-06,217,217,217,0,2766,2771,2770,1,6,0,0,3,461,461,461,461
Lake,38,2022-09-06,55,55,55,0,785,786,785,1,6,1,1,0,148,148,147,147
Lassen,38,2022-09-06,22,22,22,0,640,641,640,1,0,0,0,0,63,63,63,63
Los Angeles,38,2022-09-06,10893,10913,10913,0,241565,241989,241979,10,678,100,100,105,33394,33394,33294,33294
Madera,38,2022-09-06,223,223,223,0,2513,2518,2517,1,11,0,0,4,373,373,373,373
Marin,38,2022-09-06,186,186,186,0,3725,3732,3731,1,20,0,0,0,313,313,313,313
Mariposa,38,2022-09-06,17,17,17,0,177,178,177,1,0,0,0,0,29,29,29,29
Mendocino,38,2022-09-06,63,63,63,0,859,860,859,1,4,1,1,2,136,136,135,135
Merced,38,2022-09-06,254,254,254,0,2876,2881,2880,1,9,2,2,2,861,861,859,859
Modoc,38,2022-09-06,3,3,3,0,19,20,19,1,0,0,0,0,9,9,9,9
Mono,38,2022-09-06,5,5,5,0,52,53,52,1,0,0,0,0,7,7,7,7
Monterey,38,2022-09-06,275,275,275,0,4651,4660,4659,1,24,4,4,0,768,768,764,764
Napa,38,2022-09-06,111,111,111,0,1790,1795,1794,1,6,2,2,0,160,160,158,158
Nevada,38,2022-09-06,72,72,72,0,984,985,984,1,3,1,1,0,136,136,135,135
Orange,38,2022-09-06,2283,2287,2287,0,33647,33705,33702,3,182,14,14,31,7473,7473,7459,7459
Placer,38,2022-09-06,251,251,251,0,3549,3555,3554,1,49,0,0,8,658,658,658,658
Plumas,38,2022-09-06,9,9,9,0,140,141,140,1,0,0,0,0,13,13,13,13
Riverside,38,2022-09-06,2374,2378,2378,0,29658,29710,29706,4,123,5,5,14,6622,6622,6617,6617
Sacramento,38,2022-09-06,1290,1291,1291,0,20813,20851,20848,3,140,11,11,25,3308,3308,3297,3297
San Benito,38,2022-09-06,78,78,78,0,1256,1258,1257,1,1,0,0,2,100,100,100,100
San Bernardino,38,2022-09-06,2225,2229,2229,0,35381,35443,35439,4,113,18,18,22,8072,8072,8054,8054
San Diego,38,2022-09-06,2798,2802,2802,0,49556,49644,49642,2,208,12,12,29,5546,5546,5534,5534
San Francisco,38,2022-09-06,739,739,739,0,15994,16022,16017,5,52,8,8,13,1046,1046,1038,1038
San Joaquin,38,2022-09-06,827,827,827,0,12651,12673,12671,2,37,4,4,9,2324,2324,2320,2320
San Luis Obispo,38,2022-09-06,198,198,198,0,2850,2856,2855,1,8,2,2,1,524,524,522,522
San Mateo,38,2022-09-06,644,644,644,0,13829,13853,13852,1,20,1,1,4,737,737,736,736
Santa Barbara,38,2022-09-06,477,477,477,0,6959,6972,6971,1,39,3,3,5,726,726,723,723
Santa Clara,38,2022-09-06,1904,1908,1908,0,35233,35294,35292,2,149,9,9,21,2508,2508,2499,2499
Santa Cruz,38,2022-09-06,274,274,274,0,10433,10451,10450,1,12,0,0,0,273,273,273,273
Shasta,38,2022-09-06,117,117,117,0,2202,2206,2205,1,18,0,0,0,587,587,587,587
Siskiyou,38,2022-09-06,32,32,32,0,233,234,233,1,1,0,0,0,89,89,89,89
Solano,38,2022-09-06,383,383,383,0,6091,6103,6102,1,36,0,0,5,457,457,457,457
Sonoma,38,2022-09-06,360,360,360,0,6223,6235,6234,1,41,1,1,2,521,521,520,520
Stanislaus,38,2022-09-06,525,525,525,0,6712,6724,6723,1,84,4,4,8,1778,1778,1774,1774
Sutter,38,2022-09-06,114,114,114,0,1475,1478,1477,1,0,0,0,0,232,232,232,232
Tehama,38,2022-09-06,49,49,49,0,645,646,645,1,2,0,0,0,213,213,213,213
Trinity,38,2022-09-06,3,3,3,0,50,51,50,1,0,0,0,0,21,21,21,21
Tulare,38,2022-09-06,436,436,436,0,5759,5767,5766,1,35,2,2,2,1534,1534,1532,1532
Tuolumne,38,2022-09-06,72,72,72,0,770,771,770,1,0,0,0,0,199,199,199,199
Ventura,38,2022-09-06,893,893,893,0,12899,12920,12919,1,68,7,7,3,1586,1586,1579,1579
Yolo,38,2022-09-06,138,138,138,0,2837,2842,2841,1,1,3,3,2,393,393,390,390
Yuba,38,2022-09-06,92,92,92,0,1007,1008,1007,1,11,0,0,0,122,122,122,122
Alameda,39,2022-09-13,1556,1556,1556,0,30549,30605,30602,3,86,5,5,21,2043,2043,2038,2038
Amador,39,2022-09-13,36,36,36,0,920,921,920,1,3,1,1,1,91,91,90,90
Butte,39,2022-09-13,168,168,168,0,2337,2342,2341,1,18,2,2,0,462,462,460,460
Calaveras,39,2022-09-13,15,15,15,0,486,487,486,1,0,0,0,0,133,133,133,133
Colusa,39,2022-09-13,11,11,11,0,322,323,322,1,0,0,0,0,22,22,22,22
Contra Costa,39,2022-09-13,921,921,921,0,16679,16709,16707,2,60,6,6,10,1446,1446,1440,1440
Del Norte,39,2022-09-13,32,32,32,0,573,574,573,1,3,0,0,0,55,55,55,55
El Dorado,39,2022-09-13,97,97,97,0,1765,1770,1769,1,4,0,0,2,233,233,233,233
Fresno,39,2022-09-13,800,800,800,0,14108,14134,14132,2,136,6,6,17,2871,2871,2865,2865
Glenn,39,2022-09-13,16,16,16,0,200,201,200,1,0,0,0,0,53,53,53,53
Humboldt,39,2022-09-13,113,113,113,0,1569,1573,1572,1,10,0,0,2,159,159,159,159
Imperial,39,2022-09-13,228,228,228,0,3173,3179,3178,1,12,0,0,1,961,961,961,961
Inyo,39,2022-09-13,15,15,15,0,183,184,183,1,0,1,1,0,60,60,59,59
Kern,39,2022-09-13,587,587,587,0,12698,12721,12720,1,51,7,7,9,2421,2421,2414,2414
Kings,39,2022-09-13,188,188,188,0,3129,3135,3134,1,5,1,1,0,462,462,461,461
Lake,39,2022-09-13,50,50,50,0,789,790,789,1,3,0,0,1,148,148,148,148
Lassen,39,2022-09-13,12,12,12,0,898,899,898,1,0,0,0,0,63,63,63,63
Los Angeles,39,2022-09-13,10122,10141,10141,0,263274,263749,263740,9,628,80,80,89,33474,33474,33394,33394
Madera,39,2022-09-13,198,198,198,0,2894,2900,2899,1,14,0,0,2,373,373,373,373
Marin,39,2022-09-13,165,165,165,0,3682,3689,3688,1,17,2,2,1,315,315,313,313
Mariposa,39,2022-09-13,16,16,16,0,183,184,183,1,0,0,0,0,29,29,29,29
Mendocino,39,2022-09-13,48,48,48,0,916,917,916,1,2,0,0,0,136,136,136,136
Merced,39,2022-09-13,214,214,214,0,3023,3029,3028,1,6,3,3,0,864,864,861,861
Modoc,39,2022-09-13,1,1,1,0,17,18,17,1,0,0,0,0,9,9,9,9
Mono,39,2022-09-13,9,9,9,0,78,79,78,1,0,0,0,0,7,7,7,7
Monterey,39,2022-09-13,195,195,195,0,4683,4693,4692,1,18,1,1,1,769,769,768,768
Napa,39,2022-09-13,112,112,112,0,2110,2116,2115,1,8,0,0,0,160,160,160,160
Nevada,39,2022-09-13,63,63,63,0,1048,1050,1049,1,2,0,0,0,136,136,136,136
Orange,39,2022-09-13,1971,1976,1976,0,35473,35536,35533,3,142,25,25,27,7498,7498,7473,7473
Placer,39,2022-09-13,220,220,220,0,3971,3977,3976,1,50,0,0,7,658,658,658,658
Plumas,39,2022-09-13,24,24,24,0,168,169,168,1,1,0,0,0,13,13,13,13
Riverside,39,2022-09-13,2037,2041,2041,0,31178,31234,31231,3,111,6,6,7,6628,6628,6622,6622
Sacramento,39,2022-09-13,1179,1179,1179,0,22388,22429,22426,3,121,13,13,16,3321,3321,3308,3308
San Benito,39,2022-09-13,83,83,83,0,1309,1312,1311,1,0,0,0,0,100,100,100,100
San Bernardino,39,2022-09-13,1823,1827,1827,0,36500,36566,36563,3,97,9,9,25,8081,8081,8072,8072
San Diego,39,2022-09-13,2893,2898,2898,0,54785,54884,54882,2,197,8,8,24,5554,5554,5546,5546
San Francisco,39,2022-09-13,771,771,771,0,16794,16824,16820,4,55,10,10,10,1056,1056,1046,1046
San Joaquin,39,2022-09-13,600,600,600,0,13887,13911,13909,2,29,7,7,7,2331,2331,2324,2324
San Luis Obispo,39,2022-09-13,162,162,162,0,2956,2962,2961,1,13,0,0,1,524,524,524,524
San Mateo,39,2022-09-13,648,648,648,0,13782,13808,13807,1,27,1,1,1,738,738,737,737
Santa Barbara,39,2022-09-13,279,279,279,0,6742,6755,6754,1,27,2,2,3,728,728,726,726
Santa Clara,39,2022-09-13,1811,1813,1813,0,36005,36069,36068,1,140,7,7,24,2515,2515,2508,2508
Santa Cruz,39,2022-09-13,241,241,241,0,12811,12834,12833,1,13,0,0,0,273,273,273,273
Shasta,39,2022-09-13,171,171,171,0,2358,2363,2362,1,25,1,1,2,588,588,587,587
Siskiyou,39,2022-09-13,24,24,24,0,277,278,277,1,2,0,0,1,89,89,89,89
Solano,39,2022-09-13,373,373,373,0,6340,6353,6352,1,20,0,0,3,457,457,457,457
Sonoma,39,2022-09-13,374,374,374,0,6530,6542,6541,1,29,3,3,1,524,524,521,521
Stanislaus,39,2022-09-13,408,408,408,0,7216,7229,7228,1,63,2,2,5,1780,1780,1778,1778
Sutter,39,2022-09-13,106,106,106,0,1496,1498,1497,1,0,0,0,0,232,232,232,232
Tehama,39,2022-09-13,46,46,46,0,630,631,630,1,2,0,0,0,213,213,213,213
Trinity,39,2022-09-13,3,3,3,0,74,75,74,1,0,0,0,0,21,21,21,21
Tulare,39,2022-09-13,329,329,329,0,6378,6389,6388,1,42,4,4,1,1538,1538,1534,1534
Tuolumne,39,2022-09-13,51,51,51,0,786,787,786,1,1,0,0,0,199,199,199,199
Ventura,39,2022-09-13,775,775,775,0,14057,14082,14081,1,59,2,2,6,1588,1588,1586,1586
Yolo,39,2022-09-13,134,134,134,0,3535,3542,3541,1,4,1,1,1,394,394,393,393
Yuba,39,2022-09-13,85,85,85,0,1119,1120,1119,1,4,0,0,0,122,122,122,122
Alameda,40,2022-09-20,1188,1188,1188,0,28710,28764,28762,2,71,5,5,10,2048,2048,2043,2043
Amador,40,2022-09-20,29,29,29,0,762,763,762,1,1,2,2,1,93,93,91,91
Butte,40,2022-09-20,115,115,115,0,1946,1951,1950,1,18,0,0,2,462,462,462,462
Calaveras,40,2022-09-20,29,29,29,0,450,451,450,1,1,0,0,0,133,133,133,133
Colusa,40,2022-09-20,14,14,14,0,293,294,293,1,3,0,0,0,22,22,22,22
Contra Costa,40,2022-09-20,791,791,791,0,16942,16975,16973,2,54,9,9,7,1455,1455,1446,1446
Del Norte,40,2022-09-20,22,22,22,0,491,492,491,1,2,0,0,0,55,55,55,55
El Dorado,40,2022-09-20,71,71,71,0,1565,1569,1568,1,1,0,0,2,233,233,233,233
Fresno,40,2022-09-20,565,565,565,0,12908,12932,12931,1,109,6,6,11,2877,2877,2871,2871
Glenn,40,2022-09-20,11,11,11,0,195,196,195,1,3,0,0,0,53,53,53,53
Humboldt,40,2022-09-20,102,102,102,0,1459,1462,1461,1,8,0,0,3,159,159,159,159
Imperial,40,2022-09-20,145,145,145,0,2835,2841,2840,1,8,0,0,0,961,961,961,961
Inyo,40,2022-09-20,7,7,7,0,182,183,182,1,0,0,0,0,60,60,60,60
Kern,40,2022-09-20,431,431,431,0,11558,11580,11579,1,34,2,2,7,2423,2423,2421,2421
Kings,40,2022-09-20,134,134,134,0,2635,2641,2640,1,5,2,2,0,464,464,462,462
Lake,40,2022-09-20,34,34,34,0,878,879,878,1,0,0,0,1,148,148,148,148
Lassen,40,2022-09-20,11,11,11,0,637,638,637,1,0,0,0,0,63,63,63,63
Los Angeles,40,2022-09-20,8407,8423,8423,0,255339,255822,255815,7,490,63,63,83,33537,33537,33474,33474
Madera,40,2022-09-20,123,123,123,0,2721,2727,2726,1,5,1,1,3,374,374,373,373
Marin,40,2022-09-20,147,147,147,0,3636,3643,3642,1,4,0,0,0,315,315,315,315
Mariposa,40,2022-09-20,7,7,7,0,171,172,171,1,0,1,1,0,30,30,29,29
Mendocino,40,2022-09-20,39,39,39,0,924,925,924,1,0,0,0,0,136,136,136,136
Merced,40,2022-09-20,145,145,145,0,2869,2875,2874,1,10,2,2,1,866,866,864,864
Modoc,40,2022-09-20,2,2,2,0,16,17,16,1,0,0,0,0,9,9,9,9
Mono,40,2022-09-20,0,0,0,0,64,65,64,1,0,0,0,0,7,7,7,7
Monterey,40,2022-09-20,162,162,162,0,4264,4273,4272,1,17,1,1,3,770,770,769,769
Napa,40,2022-09-20,94,94,94,0,1766,1772,1771,1,4,0,0,0,160,160,160,160
Nevada,40,2022-09-20,63,63,63,0,1157,1159,1158,1,2,0,0,0,136,136,136,136
Orange,40,2022-09-20,1768,1772,1772,0,34045,34108,34106,2,105,16,16,19,7514,7514,7498,7498
Placer,40,2022-09-20,214,214,214,0,3705,3713,3712,1,49,1,1,4,659,659,658,658
Plumas,40,2022-09-20,21,21,21,0,181,182,181,1,1,0,0,0,13,13,13,13
Riverside,40,2022-09-20,1377,1377,1377,0,28916,28970,28968,2,73,4,4,14,6632,6632,6628,6628
Sacramento,40,2022-09-20,1017,1017,1017,0,20956,20995,20993,2,100,9,9,18,3330,3330,3321,3321
San Benito,40,2022-09-20,51,51,51,0,1209,1212,1211,1,0,0,0,0,100,100,100,100
San Bernardino,40,2022-09-20,1399,1399,1399,0,31629,31689,31687,2,86,7,7,19,8088,8088,8081,8081
San Diego,40,2022-09-20,2508,2514,2514,0,55936,56041,56039,2,163,7,7,18,5561,5561,5554,5554
San Francisco,40,2022-09-20,669,669,669,0,16601,16632,16629,3,50,7,7,6,1063,1063,1056,1056
San Joaquin,40,2022-09-20,456,456,456,0,12387,12412,12411,1,30,4,4,2,2335,2335,2331,2331
San Luis Obispo,40,2022-09-20,147,147,147,0,2597,2603,2602,1,6,0,0,0,524,524,524,524
San Mateo,40,2022-09-20,611,611,611,0,13943,13969,13968,1,21,0,0,1,738,738,738,738
Santa Barbara,40,2022-09-20,274,274,274,0,6792,6805,6804,1,31,1,1,0,729,729,728,728
Santa Clara,40,2022-09-20,1429,1429,1429,0,37729,37801,37800,1,127,11,11,17,2526,2526,2515,2515
Santa Cruz,40,2022-09-20,150,150,150,0,12339,12363,12362,1,9,0,0,1,273,273,273,273
Shasta,40,2022-09-20,99,99,99,0,2072,2077,2076,1,20,0,0,4,588,588,588,588
Siskiyou,40,2022-09-20,21,21,21,0,221,222,221,1,2,1,1,1,90,90,89,89
Solano,40,2022-09-20,266,266,266,0,6006,6019,6018,1,30,1,1,4,458,458,457,457
Sonoma,40,2022-09-20,327,327,327,0,6398,6410,6409,1,27,2,2,1,526,526,524,524
Stanislaus,40,2022-09-20,321,321,321,0,6143,6155,6154,1,50,4,4,4,1784,1784,1780,1780
Sutter,40,2022-09-20,78,78,78,0,1263,1265,1264,1,0,0,0,0,232,232,232,232
Tehama,40,2022-09-20,34,34,34,0,594,595,594,1,3,1,1,0,214,214,213,213
Trinity,40,2022-09-20,2,2,2,0,51,52,51,1,0,0,0,0,21,21,21,21
Tulare,40,2022-09-20,206,206,206,0,5421,5430,5429,1,31,1,1,1,1539,1539,1538,1538
Tuolumne,40,2022-09-20,56,56,56,0,696,697,696,1,1,0,0,0,199,199,199,199
Ventura,40,2022-09-20,605,605,605,0,13211,13236,13235,1,36,2,2,5,1590,1590,1588,1588
Yolo,40,2022-09-20,83,83,83,0,3863,3872,3871,1,3,4,4,2,398,398,394,394
Yuba,40,2022-09-20,56,56,56,0,981,982,981,1,5,0,0,0,122,122,122,122
Alameda,41,2022-09-27,1170,1170,1170,0,27563,27618,27617,1,78,1,1,7,2049,2049,2048,2048
Amador,41,2022-09-27,24,24,24,0,730,731,730,1,0,0,0,0,93,93,93,93
Butte,41,2022-09-27,89,89,89,0,1780,1785,1784,1,21,0,0,2,462,462,462,462
Calaveras,41,2022-09-27,18,18,18,0,393,394,393,1,1,1,1,0,134,134,133,133
Colusa,41,2022-09-27,8,8,8,0,282,283,282,1,2,0,0,0,22,22,22,22
Contra Costa,41,2022-09-27,816,816,816,0,16088,16120,16119,1,34,4,4,9,1459,1459,1455,1455
Del Norte,41,2022-09-27,20,20,20,0,434,435,434,1,2,0,0,0,55,55,55,55
El Dorado,41,2022-09-27,95,95,95,0,1591,1595,1594,1,5,0,0,0,233,233,233,233
Fresno,41,2022-09-27,503,503,503,0,11831,11854,11853,1,87,3,3,9,2880,2880,2877,2877
Glenn,41,2022-09-27,6,6,6,0,179,180,179,1,4,0,0,0,53,53,53,53
Humboldt,41,2022-09-27,97,97,97,0,1299,1301,1300,1,4,2,2,0,161,161,159,159
Imperial,41,2022-09-27,117,117,117,0,2585,2591,2590,1,8,1,1,0,962,962,961,961
Inyo,41,2022-09-27,4,4,4,0,163,164,163,1,0,0,0,0,60,60,60,60
Kern,41,2022-09-27,354,354,354,0,10484,10504,10503,1,30,3,3,10,2426,2426,2423,2423
Kings,41,2022-09-27,105,105,105,0,2559,2565,2564,1,2,0,0,0,464,464,464,464
Lake,41,2022-09-27,26,26,26,0,810,811,810,1,1,1,1,1,149,149,148,148
Lassen,41,2022-09-27,8,8,8,0,556,557,556,1,0,0,0,0,63,63,63,63
Los Angeles,41,2022-09-27,7531,7545,7545,0,240150,240628,240623,5,411,69,69,60,33606,33606,33537,33537
Madera,41,2022-09-27,77,77,77,0,1921,1926,1925,1,7,0,0,3,374,374,374,374
Marin,41,2022-09-27,174,174,174,0,3710,3718,3717,1,12,0,0,0,315,315,315,315
Mariposa,41,2022-09-27,5,5,5,0,140,141,140,1,0,0,0,0,30,30,30,30
Mendocino,41,2022-09-27,44,44,44,0,824,825,824,1,3,0,0,0,136,136,136,136
Merced,41,2022-09-27,125,125,125,0,2888,2894,2893,1,13,1,1,0,867,867,866,866
Modoc,41,2022-09-27,2,2,2,0,12,13,12,1,1,0,0,0,9,9,9,9
Mono,41,2022-09-27,3,3,3,0,56,57,56,1,0,0,0,0,7,7,7,7
Monterey,41,2022-09-27,118,118,118,0,3960,3969,3968,1,15,0,0,2,770,770,770,770
Napa,41,2022-09-27,88,88,88,0,1940,1946,1945,1,2,0,0,1,160,160,160,160
Nevada,41,2022-09-27,52,52,52,0,1052,1054,1053,1,3,0,0,0,136,136,136,136
Orange,41,2022-09-27,1698,1702,1702,0,30978,31039,31038,1,113,21,21,22,7535,7535,7514,7514
Placer,41,2022-09-27,223,223,223,0,3639,3647,3646,1,37,1,1,7,660,660,659,659
Plumas,41,2022-09-27,19,19,19,0,147,148,147,1,2,0,0,0,13,13,13,13
Riverside,41,2022-09-27,1255,1255,1255,0,24825,24873,24871,2,54,8,8,10,6640,6640,6632,6632
Sacramento,41,2022-09-27,945,945,945,0,19097,19136,19135,1,102,11,11,16,3341,3341,3330,3330
San Benito,41,2022-09-27,47,47,47,0,1146,1149,1148,1,0,1,1,1,101,101,100,100
San Bernardino,41,2022-09-27,1213,1213,1213,0,27296,27351,27350,1,82,4,4,14,8092,8092,8088,8088
San Diego,41,2022-09-27,2477,2482,2482,0,50223,50322,50321,1,194,9,9,17,5570,5570,5561,5561
San Francisco,41,2022-09-27,689,689,689,0,16360,16391,16389,2,48,3,3,8,1066,1066,1063,1063
San Joaquin,41,2022-09-27,381,381,381,0,10772,10794,10793,1,35,2,2,5,2337,2337,2335,2335
San Luis Obispo,41,2022-09-27,141,141,141,0,2520,2526,2525,1,6,1,1,1,525,525,524,524
San Mateo,41,2022-09-27,610,610,610,0,13024,13050,13049,1,23,0,0,1,738,738,738,738
Santa Barbara,41,2022-09-27,256,256,256,0,6449,6462,6461,1,20,2,2,0,731,731,729,729
Santa Clara,41,2022-09-27,1419,1421,1421,0,35493,35565,35564,1,109,7,7,21,2533,2533,2526,2526
Santa Cruz,41,2022-09-27,234,234,234,0,12180,12204,12203,1,12,0,0,0,273,273,273,273
Shasta,41,2022-09-27,65,65,65,0,1653,1657,1656,1,14,0,0,4,588,588,588,588
Siskiyou,41,2022-09-27,15,15,15,0,186,187,186,1,1,2,2,1,92,92,90,90
Solano,41,2022-09-27,308,308,308,0,5702,5715,5714,1,28,1,1,1,459,459,458,458
Sonoma,41,2022-09-27,303,303,303,0,6249,6263,6262,1,21,1,1,2,527,527,526,526
Stanislaus,41,2022-09-27,245,245,245,0,5764,5777,5776,1,40,1,1,3,1785,1785,1784,1784
Sutter,41,2022-09-27,64,64,64,0,1182,1184,1183,1,0,0,0,0,232,232,232,232
Tehama,41,2022-09-27,34,34,34,0,526,527,526,1,1,2,2,0,216,216,214,214
Trinity,41,2022-09-27,3,3,3,0,42,43,42,1,0,0,0,0,21,21,21,21
Tulare,41,2022-09-27,179,179,179,0,5017,5027,5026,1,19,3,3,2,1542,1542,1539,1539
Tuolumne,41,2022-09-27,40,40,40,0,692,693,692,1,0,0,0,0,199,199,199,199
Ventura,41,2022-09-27,550,550,550,0,11267,11290,11289,1,36,3,3,2,1593,1593,1590,1590
Yolo,41,2022-09-27,139,139,139,0,3798,3807,3806,1,7,2,2,0,400,400,398,398
Yuba,41,2022-09-27,37,37,37,0,944,945,944,1,6,0,0,1,122,122,122,122
Alameda,42,2022-10-04,1139,1139,1139,0,25783,25837,25836,1,56,3,3,6,2052,2052,2049,2049
Amador,42,2022-10-04,15,15,15,0,573,574,573,1,0,0,0,1,93,93,93,93
Butte,42,2022-10-04,70,70,70,0,1780,1785,1784,1,11,2,2,2,464,464,462,462
Calaveras,42,2022-10-04,17,17,17,0,330,331,330,1,1,1,1,0,135,135,134,134
Colusa,42,2022-10-04,4,4,4,0,190,191,190,1,0,0,0,0,22,22,22,22
Contra Costa,42,2022-10-04,720,720,720,0,15567,15598,15597,1,34,5,5,6,1464,1464,1459,1459
Del Norte,42,2022-10-04,12,12,12,0,370,371,370,1,1,0,0,1,55,55,55,55
El Dorado,42,2022-10-04,70,70,70,0,1363,1367,1366,1,4,0,0,1,233,233,233,233
Fresno,42,2022-10-04,452,452,452,0,11230,11253,11252,1,75,1,1,11,2881,2881,2880,2880
Glenn,42,2022-10-04,7,7,7,0,152,153,152,1,0,0,0,0,53,53,53,53
Humboldt,42,2022-10-04,81,81,81,0,1174,1176,1175,1,6,1,1,0,162,162,161,161
Imperial,42,2022-10-04,138,138,138,0,2522,2528,2527,1,7,0,0,0,962,962,962,962
Inyo,42,2022-10-04,6,6,6,0,113,114,113,1,0,0,0,0,60,60,60,60
Kern,42,2022-10-04,294,294,294,0,10199,10221,10220,1,33,4,4,6,2430,2430,2426,2426
Kings,42,2022-10-04,93,93,93,0,2456,2462,2461,1,2,0,0,0,464,464,464,464
Lake,42,2022-10-04,33,33,33,0,733,734,733,1,3,0,0,0,149,149,149,149
Lassen,42,2022-10-04,9,9,9,0,495,496,495,1,2,0,0,0,63,63,63,63
Los Angeles,42,2022-10-04,6860,6873,6873,0,212295,212736,212733,3,436,48,48,65,33654,33654,33606,33606
Madera,42,2022-10-04,54,54,54,0,1543,1547,1546,1,8,1,1,2,375,375,374,374
Marin,42,2022-10-04,189,189,189,0,3428,3435,3434,1,7,0,0,1,315,315,315,315
Mariposa,42,2022-10-04,4,4,4,0,135,136,135,1,0,0,0,0,30,30,30,30
Mendocino,42,2022-10-04,47,47,47,0,803,804,803,1,1,0,0,0,136,136,136,136
Merced,42,2022-10-04,110,110,110,0,2556,2562,2561,1,11,3,3,0,870,870,867,867
Modoc,42,2022-10-04,2,2,2,0,17,18,17,1,1,0,0,0,9,9,9,9
Mono,42,2022-10-04,2,2,2,0,71,72,71,1,0,0,0,0,7,7,7,7
Monterey,42,2022-10-04,109,109,109,0,3847,3858,3857,1,8,1,1,2,771,771,770,770
Napa,42,2022-10-04,85,85,85,0,1689,1695,1694,1,3,0,0,2,160,160,160,160
Nevada,42,2022-10-04,49,49,49,0,935,937,936,1,3,0,0,0,136,136,136,136
Orange,42,2022-10-04,1529,1531,1531,0,27721,27778,27777,1,131,20,20,11,7555,7555,7535,7535
Placer,42,2022-10-04,192,192,192,0,3322,3330,3329,1,38,2,2,2,662,662,660,660
Plumas,42,2022-10-04,13,13,13,0,106,107,106,1,2,0,0,0,13,13,13,13
Riverside,42,2022-10-04,1113,1113,1113,0,21804,21849,21848,1,59,7,7,10,6647,6647,6640,6640
Sacramento,42,2022-10-04,902,902,902,0,17841,17878,17877,1,100,10,10,14,3351,3351,3341,3341
San Benito,42,2022-10-04,34,34,34,0,1127,1130,1129,1,0,0,0,0,101,101,101,101
San Bernardino,42,2022-10-04,1223,1225,1225,0,24909,24960,24959,1,76,4,4,11,8096,8096,8092,8092
San Diego,42,2022-10-04,1984,1989,1989,0,45879,45975,45974,1,159,8,8,18,5578,5578,5570,5570
San Francisco,42,2022-10-04,666,666,666,0,15161,15192,15190,2,51,3,3,6,1069,1069,1066,1066
San Joaquin,42,2022-10-04,341,341,341,0,9688,9709,9708,1,30,3,3,5,2340,2340,2337,2337
San Luis Obispo,42,2022-10-04,134,134,134,0,2393,2399,2398,1,5,2,2,0,527,527,525,525
San Mateo,42,2022-10-04,550,550,550,0,12130,12157,12156,1,21,0,0,2,738,738,738,738
Santa Barbara,42,2022-10-04,255,255,255,0,6328,6342,6341,1,19,0,0,0,731,731,731,731
Santa Clara,42,2022-10-04,1407,1407,1407,0,31088,31153,31152,1,107,6,6,19,2539,2539,2533,2533
Santa Cruz,42,2022-10-04,235,235,235,0,11089,11112,11111,1,13,0,0,0,273,273,273,273
Shasta,42,2022-10-04,54,54,54,0,1319,1321,1320,1,13,0,0,4,588,588,588,588
Siskiyou,42,2022-10-04,10,10,10,0,194,195,194,1,1,1,1,0,93,93,92,92
Solano,42,2022-10-04,266,266,266,0,5363,5377,5376,1,17,0,0,2,459,459,459,459
Sonoma,42,2022-10-04,296,296,296,0,5905,5918,5917,1,12,0,0,6,527,527,527,527
Stanislaus,42,2022-10-04,204,204,204,0,5302,5313,5312,1,47,1,1,8,1786,1786,1785,1785
Sutter,42,2022-10-04,50,50,50,0,1028,1030,1029,1,0,0,0,0,232,232,232,232
Tehama,42,2022-10-04,20,20,20,0,526,527,526,1,1,0,0,0,216,216,216,216
Trinity,42,2022-10-04,1,1,1,0,42,43,42,1,0,0,0,0,21,21,21,21
Tulare,42,2022-10-04,143,143,143,0,4935,4947,4946,1,16,4,4,1,1546,1546,1542,1542
Tuolumne,42,2022-10-04,27,27,27,0,605,606,605,1,0,1,1,0,200,200,199,199
Ventura,42,2022-10-04,458,458,458,0,10237,10260,10259,1,33,3,3,1,1596,1596,1593,1593
Yolo,42,2022-10-04,114,114,114,0,2909,2916,2915,1,1,2,2,1,402,402,400,400
Yuba,42,2022-10-04,32,32,32,0,795,796,795,1,2,0,0,2,122,122,122,122
Alameda,43,2022-10-11,1125,1125,1125,0,28008,28069,28068,1,57,2,2,7,2054,2054,2052,2052
Amador,43,2022-10-11,16,16,16,0,901,902,901,1,1,0,0,1,93,93,93,93
Butte,43,2022-10-11,61,61,61,0,1703,1707,1706,1,13,3,3,0,466,466,463,463
Calaveras,43,2022-10-11,14,14,14,0,360,361,360,1,0,0,0,1,135,135,135,135
Colusa,43,2022-10-11,2,2,2,0,109,110,109,1,0,0,0,0,22,22,22,22
Contra Costa,43,2022-10-11,780,780,780,0,16858,16895,16894,1,28,4,4,6,1466,1466,1462,1462
Del Norte,43,2022-10-11,12,12,12,0,493,494,493,1,1,0,0,0,55,55,55,55
El Dorado,43,2022-10-11,88,88,88,0,1805,1811,1810,1,8,0,0,2,233,233,233,233
Fresno,43,2022-10-11,483,483,483,0,12160,12186,12185,1,64,4,4,10,2885,2885,2881,2881
Glenn,43,2022-10-11,11,11,11,0,221,222,221,1,1,0,0,0,53,53,53,53
Humboldt,43,2022-10-11,102,102,102,0,1418,1420,1419,1,7,0,0,0,162,162,162,162
Imperial,43,2022-10-11,202,202,202,0,2956,2963,2962,1,9,0,0,0,962,962,962,962
Inyo,43,2022-10-11,4,4,4,0,140,141,140,1,0,0,0,0,60,60,60,60
Kern,43,2022-10-11,322,322,322,0,11824,11852,11851,1,27,2,2,5,2432,2432,2430,2430
Kings,43,2022-10-11,93,93,93,0,2607,2614,2613,1,3,1,1,0,465,465,464,464
Lake,43,2022-10-11,33,33,33,0,953,954,953,1,0,0,0,0,149,149,149,149
Lassen,43,2022-10-11,1,1,1,0,566,567,566,1,0,0,0,0,63,63,63,63
Los Angeles,43,2022-10-11,6597,6611,6611,0,229472,229973,229970,3,403,68,68,56,33714,33714,33646,33646
Madera,43,2022-10-11,72,72,72,0,1737,1741,1740,1,8,0,0,1,375,375,375,375
Marin,43,2022-10-11,196,196,196,0,3744,3752,3751,1,11,0,0,0,315,315,315,315
Mariposa,43,2022-10-11,10,10,10,0,125,126,125,1,0,0,0,0,30,30,30,30
Mendocino,43,2022-10-11,38,38,38,0,937,938,937,1,3,0,0,1,136,136,136,136
Merced,43,2022-10-11,115,115,115,0,2756,2763,2762,1,10,1,1,3,871,871,870,870
Modoc,43,2022-10-11,3,3,3,0,10,11,10,1,0,0,0,0,9,9,9,9
Mono,43,2022-10-11,3,3,3,0,51,52,51,1,0,0,0,0,7,7,7,7
Monterey,43,2022-10-11,110,110,110,0,4260,4271,4270,1,11,0,0,1,771,771,771,771
Napa,43,2022-10-11,74,74,74,0,1714,1720,1719,1,4,0,0,2,160,160,160,160
Nevada,43,2022-10-11,39,39,39,0,957,958,957,1,1,0,0,1,136,136,136,136
Orange,43,2022-10-11,1495,1497,1497,0,29822,29887,29886,1,118,14,14,19,7567,7567,7553,7553
Placer,43,2022-10-11,192,192,192,0,3742,3751,3750,1,25,0,0,6,662,662,662,662
Plumas,43,2022-10-11,20,20,20,0,102,103,102,1,0,0,0,0,13,13,13,13
Riverside,43,2022-10-11,1177,1177,1177,0,23890,23940,23939,1,55,4,4,5,6651,6651,6647,6647
Sacramento,43,2022-10-11,935,935,935,0,20097,20140,20139,1,91,7,7,13,3358,3358,3351,3351
San Benito,43,2022-10-11,32,32,32,0,1216,1220,1219,1,4,1,1,0,102,102,101,101
San Bernardino,43,2022-10-11,1086,1086,1086,0,27418,27478,27477,1,70,0,0,10,8096,8096,8096,8096
San Diego,43,2022-10-11,1932,1937,1937,0,51334,51445,51444,1,125,8,8,20,5584,5584,5576,5576
San Francisco,43,2022-10-11,670,670,670,0,16119,16154,16153,1,40,1,1,10,1070,1070,1069,1069
San Joaquin,43,2022-10-11,427,427,427,0,11456,11481,11480,1,15,2,2,7,2342,2342,2340,2340
San Luis Obispo,43,2022-10-11,95,95,95,0,2527,2534,2533,1,1,1,1,0,528,528,527,527
San Mateo,43,2022-10-11,672,672,672,0,13845,13876,13875,1,21,0,0,1,738,738,738,738
Santa Barbara,43,2022-10-11,246,246,246,0,7673,7691,7690,1,13,1,1,2,732,732,731,731
Santa Clara,43,2022-10-11,1445,1445,1445,0,34631,34709,34708,1,117,3,3,15,2542,2542,2539,2539
Santa Cruz,43,2022-10-11,326,326,326,0,11738,11763,11762,1,10,0,0,1,273,273,273,273
Shasta,43,2022-10-11,108,108,108,0,1291,1294,1293,1,16,3,3,1,591,591,588,588
Siskiyou,43,2022-10-11,12,12,12,0,254,255,254,1,1,0,0,0,93,93,93,93
Solano,43,2022-10-11,322,322,322,0,6136,6153,6152,1,21,1,1,2,460,460,459,459
Sonoma,43,2022-10-11,280,280,280,0,6618,6635,6634,1,16,1,1,2,528,528,527,527
Stanislaus,43,2022-10-11,216,216,216,0,5929,5944,5943,1,50,7,7,6,1791,1791,1784,1784
Sutter,43,2022-10-11,65,65,65,0,1112,1113,1112,1,0,0,0,0,232,232,232,232
Tehama,43,2022-10-11,22,22,22,0,564,565,564,1,2,0,0,0,216,216,216,216
Trinity,43,2022-10-11,1,1,1,0,52,53,52,1,0,0,0,0,21,21,21,21
Tulare,43,2022-10-11,165,165,165,0,4950,4962,4961,1,9,1,1,1,1547,1547,1546,1546
Tuolumne,43,2022-10-11,39,39,39,0,667,668,667,1,0,1,1,0,201,201,200,200
Ventura,43,2022-10-11,439,439,439,0,11075,11101,11100,1,44,3,3,0,1598,1598,1595,1595
Yolo,43,2022-10-11,132,132,132,0,2971,2978,2977,1,5,3,3,0,405,405,402,402
Yuba,43,2022-10-11,26,26,26,0,899,900,899,1,2,0,0,0,122,122,122,122
Alameda,44,2022-10-18,943,943,943,0,24242,24297,24296,1,57,6,6,10,2060,2060,2054,2054
Amador,44,2022-10-18,16,16,16,0,579,580,579,1,1,0,0,0,93,93,93,93
Butte,44,2022-10-18,80,80,80,0,1401,1405,1404,1,13,0,0,0,466,466,466,466
Calaveras,44,2022-10-18,23,23,23,0,308,309,308,1,0,0,0,0,135,135,135,135
Colusa,44,2022-10-18,3,3,3,0,93,94,93,1,0,0,0,0,22,22,22,22
Contra Costa,44,2022-10-18,659,659,659,0,14380,14412,14411,1,27,5,5,4,1471,1471,1466,1466
Del Norte,44,2022-10-18,8,8,8,0,403,404,403,1,1,0,0,0,55,55,55,55
El Dorado,44,2022-10-18,88,88,88,0,1370,1375,1374,1,2,0,0,2,233,233,233,233
Fresno,44,2022-10-18,359,359,359,0,10513,10539,10538,1,58,1,1,7,2886,2886,2885,2885
Glenn,44,2022-10-18,8,8,8,0,143,144,143,1,1,0,0,0,53,53,53,53
Humboldt,44,2022-10-18,64,64,64,0,1147,1150,1149,1,2,0,0,1,162,162,162,162
Imperial,44,2022-10-18,117,117,117,0,2320,2326,2325,1,5,1,1,2,963,963,962,962
Inyo,44,2022-10-18,5,5,5,0,109,110,109,1,0,0,0,0,60,60,60,60
Kern,44,2022-10-18,241,241,241,0,9448,9471,9470,1,31,0,0,2,2432,2432,2432,2432
Kings,44,2022-10-18,72,72,72,0,2416,2422,2421,1,2,1,1,0,466,466,465,465
Lake,44,2022-10-18,24,24,24,0,749,750,749,1,1,1,1,0,150,150,149,149
Lassen,44,2022-10-18,9,9,9,0,515,516,515,1,1,0,0,0,63,63,63,63
Los Angeles,44,2022-10-18,5114,5126,5126,0,185745,186170,186168,2,328,42,42,51,33756,33756,33714,33714
Madera,44,2022-10-18,52,52,52,0,1383,1386,1385,1,3,0,0,2,375,375,375,375
Marin,44,2022-10-18,132,132,132,0,3213,3221,3220,1,10,0,0,0,315,315,315,315
Mariposa,44,2022-10-18,6,6,6,0,120,121,120,1,0,0,0,0,30,30,30,30
Mendocino,44,2022-10-18,41,41,41,0,766,767,766,1,0,0,0,0,136,136,136,136
Merced,44,2022-10-18,129,129,129,0,2364,2370,2369,1,14,0,0,3,871,871,871,871
Modoc,44,2022-10-18,1,1,1,0,9,10,9,1,0,0,0,0,9,9,9,9
Mono,44,2022-10-18,4,4,4,0,42,43,42,1,0,0,0,0,7,7,7,7
Monterey,44,2022-10-18,132,132,132,0,3630,3640,3639,1,15,1,1,1,772,772,771,771
Napa,44,2022-10-18,58,58,58,0,1430,1435,1434,1,4,0,0,0,160,160,160,160
Nevada,44,2022-10-18,50,50,50,0,810,811,810,1,5,0,0,1,136,136,136,136
Orange,44,2022-10-18,1117,1117,1117,0,25382,25441,25440,1,91,22,22,13,7589,7589,7567,7567
Placer,44,2022-10-18,154,154,154,0,2951,2959,2958,1,30,0,0,5,662,662,662,662
Plumas,44,2022-10-18,15,15,15,0,99,100,99,1,0,0,0,0,13,13,13,13
Riverside,44,2022-10-18,900,900,900,0,20393,20440,20439,1,75,2,2,8,6653,6653,6651,6651
Sacramento,44,2022-10-18,888,888,888,0,16132,16169,16168,1,89,8,8,16,3366,3366,3358,3358
San Benito,44,2022-10-18,36,36,36,0,922,924,923,1,1,0,0,0,102,102,102,102
San Bernardino,44,2022-10-18,822,822,822,0,22450,22501,22500,1,55,3,3,8,8099,8099,8096,8096
San Diego,44,2022-10-18,1688,1692,1692,0,43940,44041,44040,1,106,6,6,24,5590,5590,5584,5584
San Francisco,44,2022-10-18,563,563,563,0,14408,14440,14439,1,41,3,3,11,1073,1073,1070,1070
San Joaquin,44,2022-10-18,340,340,340,0,8951,8973,8972,1,16,2,2,7,2344,2344,2342,2342
San Luis Obispo,44,2022-10-18,101,101,101,0,2117,2123,2122,1,4,1,1,0,529,529,528,528
San Mateo,44,2022-10-18,529,529,529,0,11304,11331,11330,1,19,0,0,2,738,738,738,738
Santa Barbara,44,2022-10-18,157,157,157,0,5620,5635,5634,1,19,0,0,1,732,732,732,732
Santa Clara,44,2022-10-18,1182,1183,1183,0,28882,28949,28948,1,94,5,5,14,2547,2547,2542,2542
Santa Cruz,44,2022-10-18,298,298,298,0,10842,10869,10868,1,9,1,1,1,274,274,273,273
Shasta,44,2022-10-18,88,88,88,0,1066,1067,1066,1,17,0,0,1,591,591,591,591
Siskiyou,44,2022-10-18,12,12,12,0,183,184,183,1,2,1,1,0,94,94,93,93
Solano,44,2022-10-18,257,257,257,0,4861,4875,4874,1,22,0,0,3,460,460,460,460
Sonoma,44,2022-10-18,248,248,248,0,5429,5442,5441,1,24,1,1,2,529,529,528,528
Stanislaus,44,2022-10-18,210,210,210,0,5184,5198,5197,1,44,1,1,6,1792,1792,1791,1791
Sutter,44,2022-10-18,32,32,32,0,879,880,879,1,0,0,0,0,232,232,232,232
Tehama,44,2022-10-18,21,21,21,0,396,397,396,1,2,0,0,0,216,216,216,216
Trinity,44,2022-10-18,0,0,0,0,38,39,38,1,0,0,0,0,21,21,21,21
Tulare,44,2022-10-18,136,136,136,0,4331,4341,4340,1,12,1,1,1,1548,1548,1547,1547
Tuolumne,44,2022-10-18,36,36,36,0,620,621,620,1,1,0,0,0,201,201,201,201
Ventura,44,2022-10-18,347,347,347,0,9259,9282,9281,1,30,5,5,2,1603,1603,1598,1598
Yolo,44,2022-10-18,103,103,103,0,2193,2199,2198,1,4,1,1,1,406,406,405,405
Yuba,44,2022-10-18,44,44,44,0,771,772,771,1,1,0,0,0,122,122,122,122
Alameda,45,2022-10-25,961,961,961,0,23463,23519,23518,1,42,9,9,9,2069,2069,2060,2060
Amador,45,2022-10-25,16,16,16,0,624,625,624,1,1,0,0,0,93,93,93,93
Butte,45,2022-10-25,67,67,67,0,1421,1425,1424,1,9,1,1,1,467,467,466,466
Calaveras,45,2022-10-25,16,16,16,0,311,312,311,1,0,0,0,1,135,135,135,135
Colusa,45,2022-10-25,5,5,5,0,94,95,94,1,0,0,0,0,22,22,22,22
Contra Costa,45,2022-10-25,637,637,637,0,13853,13887,13886,1,43,6,6,7,1477,1477,1471,1471
Del Norte,45,2022-10-25,11,11,11,0,346,347,346,1,1,0,0,0,55,55,55,55
El Dorado,45,2022-10-25,91,91,91,0,1444,1450,1449,1,0,0,0,0,233,233,233,233
Fresno,45,2022-10-25,376,376,376,0,9664,9688,9687,1,62,0,0,7,2886,2886,2886,2886
Glenn,45,2022-10-25,7,7,7,0,144,145,144,1,0,0,0,0,53,53,53,53
Humboldt,45,2022-10-25,62,62,62,0,1105,1108,1107,1,6,0,0,3,162,162,162,162
Imperial,45,2022-10-25,99,99,99,0,2375,2381,2380,1,8,0,0,0,963,963,963,963
Inyo,45,2022-10-25,9,9,9,0,287,288,287,1,0,0,0,0,60,60,60,60
Kern,45,2022-10-25,285,285,285,0,9937,9963,9962,1,24,2,2,4,2434,2434,2432,2432
Kings,45,2022-10-25,95,95,95,0,2395,2402,2401,1,6,0,0,0,466,466,466,466
Lake,45,2022-10-25,24,24,24,0,640,641,640,1,1,0,0,2,150,150,150,150
Lassen,45,2022-10-25,14,14,14,0,485,486,485,1,1,0,0,0,63,63,63,63
Los Angeles,45,2022-10-25,5438,5450,5450,0,189772,190230,190228,2,328,57,57,40,33813,33813,33756,33756
Madera,45,2022-10-25,61,61,61,0,1503,1507,1506,1,4,0,0,2,375,375,375,375
Marin,45,2022-10-25,149,149,149,0,3070,3078,3077,1,9,2,2,2,317,317,315,315
Mariposa,45,2022-10-25,12,12,12,0,126,127,126,1,0,0,0,0,30,30,30,30
Mendocino,45,2022-10-25,40,40,40,0,743,744,743,1,3,0,0,0,136,136,136,136
Merced,45,2022-10-25,83,83,83,0,2402,2408,2407,1,9,3,3,2,874,874,871,871
Modoc,45,2022-10-25,2,2,2,0,12,13,12,1,0,0,0,0,9,9,9,9
Mono,45,2022-10-25,3,3,3,0,66,67,66,1,0,1,1,0,8,8,7,7
Monterey,45,2022-10-25,129,129,129,0,3700,3710,3709,1,13,0,0,0,772,772,772,772
Napa,45,2022-10-25,46,46,46,0,1465,1471,1470,1,5,0,0,0,160,160,160,160
Nevada,45,2022-10-25,41,41,41,0,776,778,777,1,6,0,0,0,136,136,136,136
Orange,45,2022-10-25,1171,1173,1173,0,26394,26458,26457,1,91,13,13,17,7602,7602,7589,7589
Placer,45,2022-10-25,192,192,192,0,2974,2983,2982,1,44,0,0,3,662,662,662,662
Plumas,45,2022-10-25,8,8,8,0,96,97,96,1,0,0,0,0,13,13,13,13
Riverside,45,2022-10-25,912,912,912,0,20175,20224,20223,1,48,1,1,8,6654,6654,6653,6653
Sacramento,45,2022-10-25,797,797,797,0,15143,15179,15178,1,86,7,7,16,3373,3373,3366,3366
San Benito,45,2022-10-25,35,35,35,0,822,823,822,1,0,0,0,2,102,102,102,102
San Bernardino,45,2022-10-25,840,840,840,0,22268,22322,22321,1,42,1,1,12,8100,8100,8099,8099
San Diego,45,2022-10-25,1656,1660,1660,0,42233,42334,42333,1,90,5,5,21,5595,5595,5590,5590
San Francisco,45,2022-10-25,533,533,533,0,13986,14020,14019,1,37,1,1,7,1074,1074,1073,1073
San Joaquin,45,2022-10-25,280,280,280,0,8715,8737,8736,1,16,2,2,3,2346,2346,2344,2344
San Luis Obispo,45,2022-10-25,86,86,86,0,2074,2080,2079,1,3,1,1,0,530,530,529,529
San Mateo,45,2022-10-25,472,472,472,0,11275,11304,11303,1,23,0,0,2,738,738,738,738
Santa Barbara,45,2022-10-25,167,167,167,0,5805,5820,5819,1,19,2,2,4,734,734,732,732
Santa Clara,45,2022-10-25,1201,1203,1203,0,29447,29519,29518,1,85,3,3,7,2550,2550,2547,2547
Santa Cruz,45,2022-10-25,214,214,214,0,10295,10321,10320,1,14,1,1,0,275,275,274,274
Shasta,45,2022-10-25,67,67,67,0,976,978,977,1,7,0,0,2,591,591,591,591
Siskiyou,45,2022-10-25,11,11,11,0,171,172,171,1,2,0,0,1,94,94,94,94
Solano,45,2022-10-25,249,249,249,0,5149,5163,5162,1,16,0,0,2,460,460,460,460
Sonoma,45,2022-10-25,237,237,237,0,5475,5489,5488,1,31,0,0,1,529,529,529,529
Stanislaus,45,2022-10-25,196,196,196,0,4853,4867,4866,1,43,3,3,5,1795,1795,1792,1792
Sutter,45,2022-10-25,32,32,32,0,886,887,886,1,0,0,0,0,232,232,232,232
Tehama,45,2022-10-25,34,34,34,0,408,409,408,1,1,0,0,0,216,216,216,216
Trinity,45,2022-10-25,2,2,2,0,36,37,36,1,0,0,0,0,21,21,21,21
Tulare,45,2022-10-25,113,113,113,0,4163,4174,4173,1,12,1,1,0,1549,1549,1548,1548
Tuolumne,45,2022-10-25,29,29,29,0,620,621,620,1,1,1,1,0,202,202,201,201
Ventura,45,2022-10-25,301,301,301,0,9197,9219,9218,1,37,1,1,4,1604,1604,1603,1603
Yolo,45,2022-10-25,79,79,79,0,1976,1982,1981,1,5,1,1,0,407,407,406,406
Yuba,45,2022-10-25,54,54,54,0,799,800,799,1,5,0,0,1,122,122,122,122
Alameda,46,2022-11-01,1114,1116,1116,0,23127,23187,23186,1,52,3,3,3,2072,2072,2069,2069
Amador,46,2022-11-01,17,17,17,0,641,643,642,1,2,1,1,0,94,94,93,93
Butte,46,2022-11-01,86,86,86,0,1453,1458,1457,1,8,0,0,1,467,467,467,467
Calaveras,46,2022-11-01,15,15,15,0,275,276,275,1,0,0,0,0,135,135,135,135
Colusa,46,2022-11-01,9,9,9,0,104,105,104,1,0,0,0,0,22,22,22,22
Contra Costa,46,2022-11-01,776,776,776,0,14186,14223,14222,1,33,4,4,6,1481,1481,1477,1477
Del Norte,46,2022-11-01,14,14,14,0,373,374,373,1,2,0,0,0,55,55,55,55
El Dorado,46,2022-11-01,104,104,104,0,1415,1421,1420,1,2,0,0,0,233,233,233,233
Fresno,46,2022-11-01,473,473,473,0,10542,10569,10568,1,60,4,4,10,2890,2890,2886,2886
Glenn,46,2022-11-01,16,16,16,0,157,158,157,1,1,0,0,0,53,53,53,53
Humboldt,46,2022-11-01,50,50,50,0,987,988,987,1,4,0,0,2,162,162,162,162
Imperial,46,2022-11-01,140,140,140,0,2984,2993,2992,1,8,0,0,0,963,963,963,963
Inyo,46,2022-11-01,11,11,11,0,262,263,262,1,0,0,0,0,60,60,60,60
Kern,46,2022-11-01,391,391,391,0,10063,10090,10089,1,25,3,3,2,2437,2437,2434,2434
Kings,46,2022-11-01,123,123,123,0,2402,2409,2408,1,4,0,0,1,466,466,466,466
Lake,46,2022-11-01,40,40,40,0,775,776,775,1,0,0,0,1,150,150,150,150
Lassen,46,2022-11-01,20,20,20,0,510,511,510,1,0,0,0,0,63,63,63,63
Los Angeles,46,2022-11-01,6461,6477,6477,0,191345,191833,191831,2,384,33,33,48,33846,33846,33813,33813
Madera,46,2022-11-01,62,62,62,0,1402,1405,1404,1,5,0,0,1,375,375,375,375
Marin,46,2022-11-01,132,132,132,0,3548,3559,3558,1,13,0,0,0,317,317,317,317
Mariposa,46,2022-11-01,9,9,9,0,124,125,124,1,0,0,0,0,30,30,30,30
Mendocino,46,2022-11-01,27,27,27,0,721,722,721,1,1,0,0,2,136,136,136,136
Merced,46,2022-11-01,119,119,119,0,2182,2188,2187,1,5,3,3,0,877,877,874,874
Modoc,46,2022-11-01,1,1,1,0,11,12,11,1,0,0,0,0,9,9,9,9
Mono,46,2022-11-01,1,1,1,0,95,96,95,1,1,0,0,0,8,8,8,8
Monterey,46,2022-11-01,163,163,163,0,3621,3632,3631,1,17,2,2,0,774,774,772,772
Napa,46,2022-11-01,64,64,64,0,1610,1616,1615,1,1,0,0,1,160,160,160,160
Nevada,46,2022-11-01,32,32,32,0,740,741,740,1,6,0,0,0,136,136,136,136
Orange,46,2022-11-01,1196,1197,1197,0,27747,27818,27817,1,106,12,12,19,7614,7614,7602,7602
Placer,46,2022-11-01,139,139,139,0,2802,2810,2809,1,37,1,1,5,663,663,662,662
Plumas,46,2022-11-01,5,5,5,0,73,74,73,1,1,0,0,0,13,13,13,13
Riverside,46,2022-11-01,1138,1140,1140,0,20149,20200,20199,1,63,4,4,5,6658,6658,6654,6654
Sacramento,46,2022-11-01,787,787,787,0,14125,14162,14161,1,71,5,5,13,3378,3378,3373,3373
San Benito,46,2022-11-01,33,33,33,0,777,778,777,1,1,0,0,0,102,102,102,102
San Bernardino,46,2022-11-01,1121,1123,1123,0,22672,22729,22728,1,64,3,3,12,8103,8103,8100,8100
San Diego,46,2022-11-01,1830,1835,1835,0,42612,42720,42719,1,105,5,5,12,5600,5600,5595,5595
San Francisco,46,2022-11-01,623,623,623,0,14539,14576,14575,1,53,3,3,6,1077,1077,1074,1074
San Joaquin,46,2022-11-01,351,351,351,0,8561,8583,8582,1,25,6,6,3,2352,2352,2346,2346
San Luis Obispo,46,2022-11-01,94,94,94,0,2062,2068,2067,1,1,0,0,0,530,530,530,530
San Mateo,46,2022-11-01,561,561,561,0,11547,11578,11577,1,33,0,0,4,738,738,738,738
Santa Barbara,46,2022-11-01,196,196,196,0,5954,5970,5969,1,18,2,2,5,736,736,734,734
Santa Clara,46,2022-11-01,1346,1348,1348,0,30532,30611,30610,1,86,4,4,12,2554,2554,2550,2550
Santa Cruz,46,2022-11-01,206,206,206,0,9580,9605,9604,1,4,0,0,0,275,275,275,275
Shasta,46,2022-11-01,71,71,71,0,848,849,848,1,6,2,2,1,593,593,591,591
Siskiyou,46,2022-11-01,19,19,19,0,218,219,218,1,1,1,1,0,95,95,94,94
Solano,46,2022-11-01,320,320,320,0,5367,5382,5381,1,12,0,0,5,460,460,460,460
Sonoma,46,2022-11-01,213,213,213,0,5678,5693,5692,1,23,1,1,4,530,530,529,529
Stanislaus,46,2022-11-01,259,259,259,0,4758,4771,4770,1,43,2,2,10,1797,1797,1795,1795
Sutter,46,2022-11-01,65,65,65,0,928,930,929,1,0,0,0,0,232,232,232,232
Tehama,46,2022-11-01,34,34,34,0,396,397,396,1,2,0,0,0,216,216,216,216
Trinity,46,2022-11-01,18,18,18,0,70,71,70,1,5,0,0,0,21,21,21,21
Tulare,46,2022-11-01,149,149,149,0,3748,3758,3757,1,11,0,0,0,1549,1549,1549,1549
Tuolumne,46,2022-11-01,59,59,59,0,553,554,553,1,3,0,0,0,202,202,202,202
Ventura,46,2022-11-01,404,404,404,0,9541,9567,9566,1,25,2,2,4,1606,1606,1604,1604
Yolo,46,2022-11-01,140,140,140,0,2012,2017,2016,1,0,0,0,2,407,407,407,407
Yuba,46,2022-11-01,45,45,45,0,794,795,794,1,1,0,0,0,122,122,122,122
Alameda,47,2022-11-08,1352,1356,1356,0,24471,24538,24537,1,50,8,8,11,2080,2080,2072,2072
Amador,47,2022-11-08,35,35,35,0,622,623,622,1,3,0,0,0,94,94,94,94
Butte,47,2022-11-08,117,117,117,0,1424,1430,1429,1,14,0,0,2,467,467,467,467
Calaveras,47,2022-11-08,20,20,20,0,330,331,330,1,1,0,0,0,135,135,135,135
Colusa,47,2022-11-08,3,3,3,0,99,100,99,1,0,0,0,0,22,22,22,22
Contra Costa,47,2022-11-08,879,879,879,0,15896,15939,15938,1,38,3,3,4,1484,1484,1481,1481
Del Norte,47,2022-11-08,11,11,11,0,406,407,406,1,1,0,0,0,55,55,55,55
El Dorado,47,2022-11-08,107,107,107,0,1618,1624,1623,1,7,2,2,0,235,235,233,233
Fresno,47,2022-11-08,608,608,608,0,10707,10738,10737,1,63,3,3,10,2893,2893,2890,2890
Glenn,47,2022-11-08,30,30,30,0,131,132,131,1,1,0,0,0,53,53,53,53
Humboldt,47,2022-11-08,89,89,89,0,1038,1041,1040,1,7,0,0,2,162,162,162,162
Imperial,47,2022-11-08,212,212,212,0,3681,3693,3692,1,8,0,0,3,963,963,963,963
Inyo,47,2022-11-08,15,15,15,0,356,357,356,1,0,0,0,0,60,60,60,60
Kern,47,2022-11-08,437,437,437,0,10753,10783,10782,1,34,0,0,6,2437,2437,2437,2437
Kings,47,2022-11-08,147,147,147,0,2504,2512,2511,1,5,1,1,1,467,467,466,466
Lake,47,2022-11-08,44,44,44,0,797,799,798,1,3,0,0,1,150,150,150,150
Lassen,47,2022-11-08,13,13,13,0,469,470,469,1,0,0,0,0,63,63,63,63
Los Angeles,47,2022-11-08,8237,8259,8259,0,190462,190981,190979,2,449,54,54,43,33900,33900,33846,33846
Madera,47,2022-11-08,73,73,73,0,1632,1639,1638,1,6,0,0,4,375,375,375,375
Marin,47,2022-11-08,155,155,155,0,3451,3462,3461,1,9,0,0,0,317,317,317,317
Mariposa,47,2022-11-08,16,16,16,0,118,119,118,1,0,0,0,0,30,30,30,30
Mendocino,47,2022-11-08,32,32,32,0,794,795,794,1,4,1,1,0,137,137,136,136
Merced,47,2022-11-08,159,159,159,0,2554,2562,2561,1,7,2,2,1,879,879,877,877
Modoc,47,2022-11-08,1,1,1,0,8,9,8,1,0,0,0,0,9,9,9,9
Mono,47,2022-11-08,5,5,5,0,96,97,96,1,0,0,0,0,8,8,8,8
Monterey,47,2022-11-08,212,212,212,0,3916,3927,3926,1,20,1,1,0,775,775,774,774
Napa,47,2022-11-08,83,83,83,0,1752,1758,1757,1,9,0,0,0,160,160,160,160
Nevada,47,2022-11-08,63,63,63,0,756,758,757,1,5,0,0,2,136,136,136,136
Orange,47,2022-11-08,1330,1334,1334,0,27736,27812,27811,1,95,12,12,20,7626,7626,7614,7614
Placer,47,2022-11-08,255,255,255,0,3500,3511,3510,1,55,1,1,8,664,664,663,663
Plumas,47,2022-11-08,4,4,4,0,71,72,71,1,0,0,0,0,13,13,13,13
Riverside,47,2022-11-08,1544,1549,1549,0,21397,21455,21454,1,71,2,2,8,6660,6660,6658,6658
Sacramento,47,2022-11-08,1150,1152,1152,0,16282,16326,16325,1,88,8,8,9,3386,3386,3378,3378
San Benito,47,2022-11-08,45,45,45,0,904,906,905,1,1,0,0,0,102,102,102,102
San Bernardino,47,2022-11-08,1494,1499,1499,0,23850,23914,23913,1,91,1,1,12,8104,8104,8103,8103
San Diego,47,2022-11-08,2191,2198,2198,0,45267,45391,45390,1,116,8,8,24,5608,5608,5600,5600
San Francisco,47,2022-11-08,714,714,714,0,14881,14922,14921,1,47,2,2,6,1079,1079,1077,1077
San Joaquin,47,2022-11-08,489,489,489,0,8819,8844,8843,1,24,2,2,4,2354,2354,2352,2352
San Luis Obispo,47,2022-11-08,127,127,127,0,2208,2214,2213,1,4,0,0,2,530,530,530,530
San Mateo,47,2022-11-08,575,575,575,0,12274,12310,12309,1,30,0,0,2,738,738,738,738
Santa Barbara,47,2022-11-08,208,208,208,0,6565,6584,6583,1,23,1,1,0,737,737,736,736
Santa Clara,47,2022-11-08,1661,1668,1668,0,31342,31430,31429,1,83,7,7,18,2561,2561,2554,2554
Santa Cruz,47,2022-11-08,290,290,290,0,11577,11610,11609,1,7,1,1,0,276,276,275,275
Shasta,47,2022-11-08,88,88,88,0,1048,1050,1049,1,9,1,1,2,594,594,593,593
Siskiyou,47,2022-11-08,19,19,19,0,321,322,321,1,1,0,0,0,95,95,95,95
Solano,47,2022-11-08,411,411,411,0,5370,5386,5385,1,23,2,2,4,462,462,460,460
Sonoma,47,2022-11-08,249,249,249,0,5934,5951,5950,1,13,1,1,1,531,531,530,530
Stanislaus,47,2022-11-08,287,287,287,0,4920,4934,4933,1,40,1,1,12,1798,1798,1797,1797
Sutter,47,2022-11-08,89,89,89,0,1021,1023,1022,1,0,0,0,0,232,232,232,232
Tehama,47,2022-11-08,42,42,42,0,493,494,493,1,3,0,0,0,216,216,216,216
Trinity,47,2022-11-08,1,1,1,0,41,42,41,1,0,0,0,0,21,21,21,21
Tulare,47,2022-11-08,172,172,172,0,4375,4387,4386,1,14,0,0,0,1549,1549,1549,1549
Tuolumne,47,2022-11-08,59,59,59,0,680,681,680,1,3,0,0,0,202,202,202,202
Ventura,47,2022-11-08,454,454,454,0,10360,10388,10387,1,37,2,2,1,1608,1608,1606,1606
Yolo,47,2022-11-08,136,136,136,0,2210,2217,2216,1,4,4,4,0,411,411,407,407
Yuba,47,2022-11-08,47,47,47,0,937,939,938,1,4,0,0,2,122,122,122,122
Alameda,48,2022-11-15,1545,1550,1550,0,24978,25050,25049,1,68,5,5,10,2085,2085,2080,2080
Amador,48,2022-11-15,16,16,16,0,714,716,715,1,3,0,0,0,94,94,94,94
Butte,48,2022-11-15,128,128,128,0,1327,1331,1330,1,22,0,0,0,467,467,467,467
Calaveras,48,2022-11-15,30,30,30,0,363,364,363,1,0,0,0,0,135,135,135,135
Colusa,48,2022-11-15,10,10,10,0,94,95,94,1,1,0,0,0,22,22,22,22
Contra Costa,48,2022-11-15,974,975,975,0,16152,16199,16198,1,46,1,1,6,1485,1485,1484,1484
Del Norte,48,2022-11-15,17,17,17,0,437,438,437,1,1,0,0,0,55,55,55,55
El Dorado,48,2022-11-15,148,148,148,0,1630,1636,1635,1,6,0,0,1,235,235,235,235
Fresno,48,2022-11-15,798,799,799,0,11392,11426,11425,1,73,9,9,13,2902,2902,2893,2893
Glenn,48,2022-11-15,20,20,20,0,174,175,174,1,0,0,0,0,53,53,53,53
Humboldt,48,2022-11-15,92,92,92,0,1091,1095,1094,1,6,1,1,0,163,163,162,162
Imperial,48,2022-11-15,261,261,261,0,3286,3297,3296,1,0,0,0,6,963,963,963,963
Inyo,48,2022-11-15,12,12,12,0,460,461,460,1,0,0,0,0,60,60,60,60
Kern,48,2022-11-15,483,483,483,0,10707,10740,10739,1,47,2,2,4,2439,2439,2437,2437
Kings,48,2022-11-15,253,253,253,0,2750,2760,2759,1,7,2,2,0,469,469,467,467
Lake,48,2022-11-15,53,53,53,0,843,846,845,1,2,0,0,0,150,150,150,150
Lassen,48,2022-11-15,45,45,45,0,598,600,599,1,0,1,1,0,64,64,63,63
Los Angeles,48,2022-11-15,9811,9840,9840,0,201188,201780,201778,2,514,56,56,75,33956,33956,33900,33900
Madera,48,2022-11-15,104,104,104,0,1751,1759,1758,1,7,0,0,2,375,375,375,375
Marin,48,2022-11-15,178,178,178,0,3427,3439,3438,1,8,0,0,0,317,317,317,317
Mariposa,48,2022-11-15,13,13,13,0,150,151,150,1,0,0,0,0,30,30,30,30
Mendocino,48,2022-11-15,46,46,46,0,1004,1007,1006,1,3,0,0,1,137,137,137,137
Merced,48,2022-11-15,179,179,179,0,2741,2751,2750,1,5,0,0,1,879,879,879,879
Modoc,48,2022-11-15,3,3,3,0,12,13,12,1,1,0,0,0,9,9,9,9
Mono,48,2022-11-15,8,8,8,0,124,125,124,1,0,0,0,0,8,8,8,8
Monterey,48,2022-11-15,209,209,209,0,4315,4328,4327,1,19,2,2,1,777,777,775,775
Napa,48,2022-11-15,106,106,106,0,1891,1897,1896,1,8,0,0,0,160,160,160,160
Nevada,48,2022-11-15,68,68,68,0,837,839,838,1,3,0,0,2,136,136,136,136
Orange,48,2022-11-15,1682,1687,1687,0,27452,27534,27533,1,111,8,8,24,7634,7634,7626,7626
Placer,48,2022-11-15,338,338,338,0,3933,3946,3945,1,55,1,1,8,665,665,664,664
Plumas,48,2022-11-15,4,4,4,0,86,87,86,1,1,0,0,0,13,13,13,13
Riverside,48,2022-11-15,1743,1749,1749,0,23120,23187,23186,1,96,4,4,8,6664,6664,6660,6660
Sacramento,48,2022-11-15,1279,1282,1282,0,17551,17602,17601,1,81,6,6,11,3392,3392,3386,3386
San Benito,48,2022-11-15,43,43,43,0,1027,1031,1030,1,0,0,0,0,102,102,102,102
San Bernardino,48,2022-11-15,1933,1940,1940,0,24991,25065,25064,1,85,0,0,15,8104,8104,8104,8104
San Diego,48,2022-11-15,2675,2684,2684,0,44809,44939,44938,1,138,7,7,23,5615,5615,5608,5608
San Francisco,48,2022-11-15,761,761,761,0,13835,13877,13876,1,48,8,8,7,1087,1087,1079,1079
San Joaquin,48,2022-11-15,642,642,642,0,9841,9872,9871,1,19,1,1,6,2355,2355,2354,2354
San Luis Obispo,48,2022-11-15,129,129,129,0,2247,2254,2253,1,8,0,0,0,530,530,530,530
San Mateo,48,2022-11-15,710,710,710,0,11402,11435,11434,1,29,0,0,2,738,738,738,738
Santa Barbara,48,2022-11-15,230,230,230,0,6103,6122,6121,1,17,1,1,4,738,738,737,737
Santa Clara,48,2022-11-15,1856,1863,1863,0,31446,31540,31539,1,117,3,3,13,2564,2564,2561,2561
Santa Cruz,48,2022-11-15,256,256,256,0,9734,9765,9764,1,10,0,0,0,276,276,276,276
Shasta,48,2022-11-15,113,113,113,0,1136,1139,1138,1,10,1,1,2,595,595,594,594
Siskiyou,48,2022-11-15,22,22,22,0,403,404,403,1,2,0,0,0,95,95,95,95
Solano,48,2022-11-15,426,426,426,0,5534,5552,5551,1,25,0,0,4,462,462,462,462
Sonoma,48,2022-11-15,288,288,288,0,6112,6131,6130,1,27,1,1,1,532,532,531,531
Stanislaus,48,2022-11-15,346,346,346,0,5387,5404,5403,1,44,0,0,12,1798,1798,1798,1798
Sutter,48,2022-11-15,99,99,99,0,1177,1181,1180,1,0,0,0,0,232,232,232,232
Tehama,48,2022-11-15,56,56,56,0,604,605,604,1,2,0,0,0,216,216,216,216
Trinity,48,2022-11-15,12,12,12,0,48,49,48,1,0,1,1,0,22,22,21,21
Tulare,48,2022-11-15,361,361,361,0,4534,4549,4548,1,17,0,0,0,1549,1549,1549,1549
Tuolumne,48,2022-11-15,84,84,84,0,711,713,712,1,0,0,0,0,202,202,202,202
Ventura,48,2022-11-15,601,601,601,0,10787,10821,10820,1,30,1,1,2,1609,1609,1608,1608
Yolo,48,2022-11-15,135,135,135,0,2149,2156,2155,1,3,5,5,1,416,416,411,411
Yuba,48,2022-11-15,61,61,61,0,985,989,988,1,4,0,0,1,122,122,122,122
Alameda,49,2022-11-22,1751,1758,1758,0,24889,24967,24966,1,75,7,7,15,2092,2092,2085,2085
Amador,49,2022-11-22,33,33,33,0,797,800,799,1,0,0,0,1,94,94,94,94
Butte,49,2022-11-22,152,152,152,0,1380,1386,1385,1,28,0,0,1,467,467,467,467
Calaveras,49,2022-11-22,39,39,39,0,430,431,430,1,1,0,0,0,135,135,135,135
Colusa,49,2022-11-22,11,11,11,0,113,114,113,1,0,0,0,0,22,22,22,22
Contra Costa,49,2022-11-22,1055,1057,1057,0,15998,16048,16047,1,47,3,3,6,1488,1488,1485,1485
Del Norte,49,2022-11-22,19,19,19,0,471,472,471,1,1,0,0,1,55,55,55,55
El Dorado,49,2022-11-22,192,192,192,0,1801,1808,1807,1,13,0,0,0,235,235,235,235
Fresno,49,2022-11-22,1094,1098,1098,0,12097,12135,12134,1,116,6,6,11,2908,2908,2902,2902
Glenn,49,2022-11-22,22,22,22,0,212,213,212,1,0,0,0,0,53,53,53,53
Humboldt,49,2022-11-22,121,121,121,0,1192,1196,1195,1,4,0,0,1,163,163,163,163
Imperial,49,2022-11-22,285,285,285,0,2930,2942,2941,1,0,2,2,7,965,965,963,963
Inyo,49,2022-11-22,33,33,33,0,435,436,435,1,0,1,1,0,61,61,60,60
Kern,49,2022-11-22,531,531,531,0,10299,10333,10332,1,51,2,2,9,2441,2441,2439,2439
Kings,49,2022-11-22,254,254,254,0,2651,2660,2659,1,4,2,2,1,471,471,469,469
Lake,49,2022-11-22,57,57,57,0,943,947,946,1,1,1,1,1,151,151,150,150
Lassen,49,2022-11-22,24,24,24,0,487,488,487,1,0,0,0,0,64,64,64,64
Los Angeles,49,2022-11-22,14033,14078,14078,0,193608,194219,194217,2,693,66,66,101,34022,34022,33956,33956
Madera,49,2022-11-22,169,169,169,0,1796,1804,1803,1,8,0,0,1,375,375,375,375
Marin,49,2022-11-22,195,195,195,0,3364,3377,3376,1,8,0,0,1,317,317,317,317
Mariposa,49,2022-11-22,26,26,26,0,170,171,170,1,0,0,0,0,30,30,30,30
Mendocino,49,2022-11-22,37,37,37,0,819,820,819,1,3,0,0,1,137,137,137,137
Merced,49,2022-11-22,282,282,282,0,2824,2834,2833,1,11,2,2,3,881,881,879,879
Modoc,49,2022-11-22,10,10,10,0,11,12,11,1,2,0,0,0,9,9,9,9
Mono,49,2022-11-22,3,3,3,0,110,111,110,1,0,0,0,0,8,8,8,8
Monterey,49,2022-11-22,230,230,230,0,4333,4347,4346,1,21,0,0,0,777,777,777,777
Napa,49,2022-11-22,145,145,145,0,2198,2205,2204,1,3,0,0,1,160,160,160,160
Nevada,49,2022-11-22,105,105,105,0,1000,1003,1002,1,4,0,0,1,136,136,136,136
Orange,49,2022-11-22,2419,2428,2428,0,28479,28570,28569,1,171,16,16,32,7650,7650,7634,7634
Placer,49,2022-11-22,356,356,356,0,4020,4034,4033,1,64,0,0,7,665,665,665,665
Plumas,49,2022-11-22,7,7,7,0,115,116,115,1,0,0,0,0,13,13,13,13
Riverside,49,2022-11-22,2283,2290,2290,0,24512,24590,24589,1,123,8,8,15,6672,6672,6664,6664
Sacramento,49,2022-11-22,1601,1607,1607,0,19282,19343,19342,1,105,2,2,16,3394,3394,3392,3392
San Benito,49,2022-11-22,67,67,67,0,1131,1135,1134,1,2,0,0,0,102,102,102,102
San Bernardino,49,2022-11-22,2507,2516,2516,0,26735,26819,26818,1,94,1,1,21,8105,8105,8104,8104
San Diego,49,2022-11-22,3181,3190,3190,0,41313,41443,41442,1,185,4,4,20,5619,5619,5615,5615
San Francisco,49,2022-11-22,982,984,984,0,15314,15361,15360,1,59,6,6,8,1093,1093,1087,1087
San Joaquin,49,2022-11-22,777,777,777,0,11090,11126,11125,1,34,0,0,5,2355,2355,2355,2355
San Luis Obispo,49,2022-11-22,168,168,168,0,2387,2396,2395,1,3,1,1,0,531,531,530,530
San Mateo,49,2022-11-22,745,745,745,0,12282,12321,12320,1,32,0,0,1,738,738,738,738
Santa Barbara,49,2022-11-22,337,337,337,0,5856,5876,5875,1,19,2,2,4,740,740,738,738
Santa Clara,49,2022-11-22,2284,2291,2291,0,34119,34228,34227,1,123,9,9,22,2573,2573,2564,2564
Santa Cruz,49,2022-11-22,275,275,275,0,8761,8790,8789,1,19,0,0,1,276,276,276,276
Shasta,49,2022-11-22,88,88,88,0,1019,1022,1021,1,17,0,0,2,595,595,595,595
Siskiyou,49,2022-11-22,26,26,26,0,319,320,319,1,0,0,0,0,95,95,95,95
Solano,49,2022-11-22,522,522,522,0,5625,5644,5643,1,32,2,2,9,464,464,462,462
Sonoma,49,2022-11-22,350,350,350,0,5610,5629,5628,1,24,0,0,4,532,532,532,532
Stanislaus,49,2022-11-22,466,466,466,0,6069,6090,6089,1,62,1,1,8,1799,1799,1798,1798
Sutter,49,2022-11-22,85,85,85,0,1100,1104,1103,1,0,0,0,0,232,232,232,232
Tehama,49,2022-11-22,68,68,68,0,660,661,660,1,2,0,0,2,216,216,216,216
Trinity,49,2022-11-22,5,5,5,0,54,55,54,1,0,0,0,0,22,22,22,22
Tulare,49,2022-11-22,422,422,422,0,5415,5433,5432,1,18,0,0,1,1549,1549,1549,1549
Tuolumne,49,2022-11-22,84,84,84,0,729,730,729,1,2,1,1,0,203,203,202,202
Ventura,49,2022-11-22,759,759,759,0,10680,10714,10713,1,40,1,1,2,1610,1610,1609,1609
Yolo,49,2022-11-22,146,146,146,0,2218,2226,2225,1,5,4,4,2,420,420,416,416
Yuba,49,2022-11-22,81,81,81,0,1008,1012,1011,1,3,0,0,1,122,122,122,122
Alameda,50,2022-11-29,2444,2453,2453,0,23517,23599,23598,1,108,6,6,14,2098,2098,2092,2092
Amador,50,2022-11-29,35,35,35,0,815,818,817,1,4,1,1,1,95,95,94,94
Butte,50,2022-11-29,209,209,209,0,1622,1628,1627,1,37,1,1,2,468,468,467,467
Calaveras,50,2022-11-29,36,36,36,0,388,389,388,1,1,0,0,1,135,135,135,135
Colusa,50,2022-11-29,17,17,17,0,191,192,191,1,5,0,0,0,22,22,22,22
Contra Costa,50,2022-11-29,1596,1602,1602,0,16782,16841,16840,1,64,4,4,5,1492,1492,1488,1488
Del Norte,50,2022-11-29,40,40,40,0,493,494,493,1,1,1,1,0,56,56,55,55
El Dorado,50,2022-11-29,190,190,190,0,1612,1619,1618,1,12,1,1,2,236,236,235,235
Fresno,50,2022-11-29,1423,1429,1429,0,12404,12447,12446,1,152,4,4,21,2912,2912,2908,2908
Glenn,50,2022-11-29,18,18,18,0,191,192,191,1,2,0,0,0,53,53,53,53
Humboldt,50,2022-11-29,114,114,114,0,1033,1037,1036,1,13,0,0,0,163,163,163,163
Imperial,50,2022-11-29,470,471,471,0,3029,3041,3040,1,0,0,0,6,965,965,965,965
Inyo,50,2022-11-29,35,35,35,0,350,351,350,1,0,1,1,0,62,62,61,61
Kern,50,2022-11-29,658,660,660,0,9656,9692,9691,1,65,4,4,5,2445,2445,2441,2441
Kings,50,2022-11-29,274,274,274,0,2731,2742,2741,1,12,0,0,0,471,471,471,471
Lake,50,2022-11-29,53,53,53,0,816,819,818,1,0,0,0,0,151,151,151,151
Lassen,50,2022-11-29,24,24,24,0,499,500,499,1,0,0,0,0,64,64,64,64
Los Angeles,50,2022-11-29,20618,20692,20692,0,201003,201720,201718,2,1010,96,96,122,34118,34118,34022,34022
Madera,50,2022-11-29,175,175,175,0,1732,1739,1738,1,10,0,0,2,375,375,375,375
Marin,50,2022-11-29,294,294,294,0,3080,3091,3090,1,22,0,0,0,317,317,317,317
Mariposa,50,2022-11-29,18,18,18,0,132,133,132,1,0,0,0,0,30,30,30,30
Mendocino,50,2022-11-29,48,48,48,0,740,743,742,1,8,0,0,0,137,137,137,137
Merced,50,2022-11-29,370,370,370,0,2734,2745,2744,1,19,6,6,2,887,887,881,881
Modoc,50,2022-11-29,5,5,5,0,11,12,11,1,2,0,0,0,9,9,9,9
Mono,50,2022-11-29,4,4,4,0,89,90,89,1,0,0,0,0,8,8,8,8
Monterey,50,2022-11-29,295,295,295,0,3920,3936,3935,1,28,1,1,0,778,778,777,777
Napa,50,2022-11-29,149,149,149,0,1797,1804,1803,1,8,0,0,3,160,160,160,160
Nevada,50,2022-11-29,123,123,123,0,1061,1064,1063,1,11,0,0,0,136,136,136,136
Orange,50,2022-11-29,3568,3580,3580,0,28408,28510,28509,1,246,15,15,32,7665,7665,7650,7650
Placer,50,2022-11-29,384,384,384,0,3815,3830,3829,1,77,3,3,6,668,668,665,665
Plumas,50,2022-11-29,8,8,8,0,148,149,148,1,0,0,0,0,13,13,13,13
Riverside,50,2022-11-29,3452,3464,3464,0,23723,23807,23806,1,192,12,12,23,6684,6684,6672,6672
Sacramento,50,2022-11-29,1901,1908,1908,0,18484,18550,18549,1,120,10,10,17,3404,3404,3394,3394
San Benito,50,2022-11-29,165,165,165,0,1302,1306,1305,1,4,0,0,0,102,102,102,102
San Bernardino,50,2022-11-29,3563,3575,3575,0,26245,26337,26336,1,155,1,1,21,8106,8106,8105,8105
San Diego,50,2022-11-29,4543,4561,4561,0,34525,34648,34647,1,268,7,7,30,5626,5626,5619,5619
San Francisco,50,2022-11-29,1251,1256,1256,0,12953,12998,12997,1,74,5,5,5,1098,1098,1093,1093
San Joaquin,50,2022-11-29,1054,1057,1057,0,11279,11319,11318,1,55,5,5,6,2360,2360,2355,2355
San Luis Obispo,50,2022-11-29,185,185,185,0,2239,2248,2247,1,14,3,3,0,534,534,531,531
San Mateo,50,2022-11-29,1224,1228,1228,0,11614,11656,11655,1,35,1,1,6,739,739,738,738
Santa Barbara,50,2022-11-29,489,489,489,0,5647,5668,5667,1,25,2,2,3,742,742,740,740
Santa Clara,50,2022-11-29,3132,3144,3144,0,29564,29670,29669,1,173,10,10,25,2583,2583,2573,2573
Santa Cruz,50,2022-11-29,420,421,421,0,7333,7362,7361,1,33,0,0,3,276,276,276,276
Shasta,50,2022-11-29,107,107,107,0,993,997,996,1,17,1,1,2,596,596,595,595
Siskiyou,50,2022-11-29,27,27,27,0,292,293,292,1,1,0,0,0,95,95,95,95
Solano,50,2022-11-29,606,607,607,0,5425,5446,5445,1,33,1,1,6,465,465,464,464
Sonoma,50,2022-11-29,460,460,460,0,5072,5091,5090,1,46,2,2,3,534,534,532,532
Stanislaus,50,2022-11-29,561,561,561,0,5490,5510,5509,1,80,2,2,4,1801,1801,1799,1799
Sutter,50,2022-11-29,81,81,81,0,1184,1188,1187,1,0,0,0,0,232,232,232,232
Tehama,50,2022-11-29,80,80,80,0,651,653,652,1,5,0,0,2,216,216,216,216
Trinity,50,2022-11-29,2,2,2,0,54,55,54,1,0,0,0,0,22,22,22,22
Tulare,50,2022-11-29,511,512,512,0,5084,5104,5103,1,37,0,0,0,1549,1549,1549,1549
Tuolumne,50,2022-11-29,77,77,77,0,722,725,724,1,3,0,0,0,203,203,203,203
Ventura,50,2022-11-29,1035,1038,1038,0,11033,11072,11071,1,57,2,2,3,1612,1612,1610,1610
Yolo,50,2022-11-29,174,174,174,0,2139,2148,2147,1,1,3,3,1,423,423,420,420
Yuba,50,2022-11-29,86,86,86,0,968,971,970,1,9,0,0,0,122,122,122,122
Alameda,51,2022-12-06,2831,2843,2843,0,29222,29339,29338,1,137,8,8,12,2106,2106,2098,2098
Amador,51,2022-12-06,38,38,38,0,762,765,764,1,3,0,0,1,95,95,95,95
Butte,51,2022-12-06,238,238,238,0,1926,1935,1934,1,44,7,7,3,475,475,468,468
Calaveras,51,2022-12-06,42,42,42,0,489,490,489,1,2,0,0,1,135,135,135,135
Colusa,51,2022-12-06,9,9,9,0,249,250,249,1,4,0,0,0,22,22,22,22
Contra Costa,51,2022-12-06,1748,1755,1755,0,19046,19122,19121,1,94,2,2,11,1494,1494,1492,1492
Del Norte,51,2022-12-06,38,38,38,0,540,541,540,1,2,0,0,0,56,56,56,56
El Dorado,51,2022-12-06,167,167,167,0,1445,1452,1451,1,11,1,1,0,237,237,236,236
Fresno,51,2022-12-06,1542,1549,1549,0,14193,14250,14249,1,161,5,5,16,2917,2917,2912,2912
Glenn,51,2022-12-06,23,23,23,0,244,245,244,1,2,0,0,0,53,53,53,53
Humboldt,51,2022-12-06,130,130,130,0,1091,1097,1096,1,16,1,1,2,164,164,163,163
Imperial,51,2022-12-06,546,546,546,0,3186,3200,3199,1,16,2,2,5,967,967,965,965
Inyo,51,2022-12-06,22,22,22,0,327,328,327,1,0,0,0,0,62,62,62,62
Kern,51,2022-12-06,858,861,861,0,10914,10957,10956,1,65,1,1,6,2446,2446,2445,2445
Kings,51,2022-12-06,296,296,296,0,2898,2912,2911,1,6,2,2,0,473,473,471,471
Lake,51,2022-12-06,61,61,61,0,812,816,815,1,2,0,0,0,151,151,151,151
Lassen,51,2022-12-06,18,18,18,0,421,422,421,1,0,0,0,0,64,64,64,64
Los Angeles,51,2022-12-06,21209,21293,21293,0,239247,240198,240195,3,1151,114,114,142,34232,34232,34118,34118
Madera,51,2022-12-06,218,218,218,0,1989,1998,1997,1,11,0,0,3,375,375,375,375
Marin,51,2022-12-06,327,327,327,0,3508,3523,3522,1,16,0,0,2,317,317,317,317
Mariposa,51,2022-12-06,23,23,23,0,157,158,157,1,0,0,0,0,30,30,30,30
Mendocino,51,2022-12-06,52,52,52,0,773,778,777,1,8,1,1,2,138,138,137,137
Merced,51,2022-12-06,344,344,344,0,3242,3257,3256,1,17,1,1,2,888,888,887,887
Modoc,51,2022-12-06,11,11,11,0,11,12,11,1,0,0,0,0,9,9,9,9
Mono,51,2022-12-06,11,11,11,0,99,100,99,1,0,0,0,0,8,8,8,8
Monterey,51,2022-12-06,266,266,266,0,4362,4381,4380,1,28,1,1,3,779,779,778,778
Napa,51,2022-12-06,155,155,155,0,2448,2459,2458,1,12,0,0,0,160,160,160,160
Nevada,51,2022-12-06,98,98,98,0,1073,1078,1077,1,10,0,0,0,136,136,136,136
Orange,51,2022-12-06,4132,4149,4149,0,34331,34467,34466,1,311,29,29,48,7694,7694,7665,7665
Placer,51,2022-12-06,396,396,396,0,4114,4131,4130,1,83,1,1,4,669,669,668,668
Plumas,51,2022-12-06,21,21,21,0,197,198,197,1,1,0,0,0,13,13,13,13
Riverside,51,2022-12-06,3975,3991,3991,0,27051,27159,27158,1,191,13,13,25,6697,6697,6684,6684
Sacramento,51,2022-12-06,2064,2071,2071,0,21102,21186,21185,1,160,7,7,24,3411,3411,3404,3404
San Benito,51,2022-12-06,210,210,210,0,1457,1463,1462,1,6,2,2,3,104,104,102,102
San Bernardino,51,2022-12-06,4061,4076,4076,0,28246,28358,28357,1,192,2,2,32,8108,8108,8106,8106
San Diego,51,2022-12-06,5493,5514,5514,0,44392,44567,44566,1,312,14,14,33,5640,5640,5626,5626
San Francisco,51,2022-12-06,1488,1494,1494,0,16046,16109,16108,1,92,6,6,7,1104,1104,1098,1098
San Joaquin,51,2022-12-06,1104,1109,1109,0,12462,12513,12512,1,69,7,7,6,2367,2367,2360,2360
San Luis Obispo,51,2022-12-06,216,216,216,0,2738,2750,2749,1,16,3,3,0,537,537,534,534
San Mateo,51,2022-12-06,1231,1238,1238,0,13329,13383,13382,1,55,1,1,0,740,740,739,739
Santa Barbara,51,2022-12-06,507,507,507,0,6473,6499,6498,1,45,2,2,6,744,744,742,742
Santa Clara,51,2022-12-06,3484,3497,3497,0,35662,35805,35804,1,194,13,13,26,2596,2596,2583,2583
Santa Cruz,51,2022-12-06,502,503,503,0,12969,13023,13022,1,30,0,0,4,276,276,276,276
Shasta,51,2022-12-06,122,122,122,0,1128,1134,1133,1,19,0,0,3,596,596,596,596
Siskiyou,51,2022-12-06,18,18,18,0,284,285,284,1,0,0,0,0,95,95,95,95
Solano,51,2022-12-06,625,626,626,0,6627,6655,6654,1,29,1,1,11,466,466,465,465
Sonoma,51,2022-12-06,513,513,513,0,6039,6063,6062,1,38,5,5,3,539,539,534,534
Stanislaus,51,2022-12-06,638,638,638,0,6714,6742,6741,1,74,2,2,11,1803,1803,1801,1801
Sutter,51,2022-12-06,105,105,105,0,1206,1212,1211,1,0,1,1,0,233,233,232,232
Tehama,51,2022-12-06,91,91,91,0,826,831,830,1,6,3,3,1,219,219,216,216
Trinity,51,2022-12-06,3,3,3,0,41,42,41,1,0,0,0,0,22,22,22,22
Tulare,51,2022-12-06,539,539,539,0,6155,6180,6179,1,31,0,0,1,1549,1549,1549,1549
Tuolumne,51,2022-12-06,116,116,116,0,869,872,871,1,2,0,0,0,203,203,203,203
Ventura,51,2022-12-06,1059,1064,1064,0,11799,11848,11847,1,68,2,2,3,1614,1614,1612,1612
Yolo,51,2022-12-06,215,215,215,0,2549,2561,2560,1,3,1,1,1,424,424,423,423
Yuba,51,2022-12-06,80,80,80,0,1015,1021,1020,1,13,0,0,0,122,122,122,122
Alameda,52,2022-12-13,2634,2646,2646,0,29043,29171,29170,1,149,11,11,20,2117,2117,2106,2106
Amador,52,2022-12-13,35,35,35,0,767,770,769,1,3,0,0,0,95,95,95,95
Butte,52,2022-12-13,167,167,167,0,1915,1926,1925,1,38,1,1,3,476,476,475,475
Calaveras,52,2022-12-13,39,39,39,0,457,458,457,1,1,0,0,1,135,135,135,135
Colusa,52,2022-12-13,12,12,12,0,231,232,231,1,4,0,0,0,22,22,22,22
Contra Costa,52,2022-12-13,1752,1760,1760,0,18213,18293,18292,1,76,10,10,7,1504,1504,1494,1494
Del Norte,52,2022-12-13,33,33,33,0,535,536,535,1,2,0,0,0,56,56,56,56
El Dorado,52,2022-12-13,154,154,154,0,1593,1601,1600,1,10,2,2,2,239,239,237,237
Fresno,52,2022-12-13,1415,1421,1421,0,13753,13813,13812,1,202,13,13,22,2930,2930,2917,2917
Glenn,52,2022-12-13,22,22,22,0,230,231,230,1,2,0,0,0,53,53,53,53
Humboldt,52,2022-12-13,107,107,107,0,961,967,966,1,13,1,1,2,165,165,164,164
Imperial,52,2022-12-13,410,410,410,0,2872,2886,2885,1,21,3,3,3,970,970,967,967
Inyo,52,2022-12-13,21,21,21,0,308,309,308,1,1,0,0,0,62,62,62,62
Kern,52,2022-12-13,924,928,928,0,10768,10817,10816,1,45,2,2,2,2448,2448,2446,2446
Kings,52,2022-12-13,239,239,239,0,2852,2866,2865,1,5,0,0,0,473,473,473,473
Lake,52,2022-12-13,54,54,54,0,780,785,784,1,4,0,0,2,151,151,151,151
Lassen,52,2022-12-13,10,10,10,0,442,444,443,1,0,0,0,0,64,64,64,64
Los Angeles,52,2022-12-13,17211,17286,17286,0,228070,229078,229075,3,1169,159,159,135,34391,34391,34232,34232
Madera,52,2022-12-13,200,200,200,0,2183,2194,2193,1,11,0,0,1,375,375,375,375
Marin,52,2022-12-13,298,298,298,0,3615,3631,3630,1,21,0,0,1,317,317,317,317
Mariposa,52,2022-12-13,19,19,19,0,134,135,134,1,0,0,0,0,30,30,30,30
Mendocino,52,2022-12-13,53,53,53,0,661,665,664,1,5,1,1,0,139,139,138,138
Merced,52,2022-12-13,321,321,321,0,3238,3253,3252,1,13,0,0,2,888,888,888,888
Modoc,52,2022-12-13,10,10,10,0,15,16,15,1,0,0,0,0,9,9,9,9
Mono,52,2022-12-13,7,7,7,0,117,118,117,1,0,0,0,0,8,8,8,8
Monterey,52,2022-12-13,253,253,253,0,4235,4255,4254,1,20,3,3,4,782,782,779,779
Napa,52,2022-12-13,170,170,170,0,2049,2059,2058,1,9,1,1,0,161,161,160,160
Nevada,52,2022-12-13,96,96,96,0,972,978,977,1,5,0,0,2,136,136,136,136
Orange,52,2022-12-13,3423,3438,3438,0,30907,31043,31042,1,320,30,30,48,7724,7724,7694,7694
Placer,52,2022-12-13,316,316,316,0,3774,3792,3791,1,77,5,5,11,674,674,669,669
Plumas,52,2022-12-13,6,6,6,0,190,191,190,1,3,0,0,0,13,13,13,13
Riverside,52,2022-12-13,3246,3259,3259,0,24423,24531,24530,1,197,21,21,26,6718,6718,6697,6697
Sacramento,52,2022-12-13,1805,1813,1813,0,20089,20177,20176,1,190,8,8,28,3419,3419,3411,3411
San Benito,52,2022-12-13,118,118,118,0,1311,1317,1316,1,2,2,2,2,106,106,104,104
San Bernardino,52,2022-12-13,3543,3557,3557,0,26678,26796,26795,1,239,1,1,36,8109,8109,8108,8108
San Diego,52,2022-12-13,4850,4871,4871,0,39992,40170,40169,1,323,16,16,45,5656,5656,5640,5640
San Francisco,52,2022-12-13,1377,1383,1383,0,16746,16820,16819,1,101,11,11,15,1115,1115,1104,1104
San Joaquin,52,2022-12-13,934,939,939,0,12839,12896,12895,1,82,5,5,19,2372,2372,2367,2367
San Luis Obispo,52,2022-12-13,222,222,222,0,2530,2544,2543,1,12,1,1,0,538,538,537,537
San Mateo,52,2022-12-13,1114,1120,1120,0,12447,12503,12502,1,55,0,0,6,740,740,740,740
Santa Barbara,52,2022-12-13,486,487,487,0,5644,5669,5668,1,39,1,1,8,745,745,744,744
Santa Clara,52,2022-12-13,3242,3256,3256,0,34989,35144,35143,1,194,16,16,35,2612,2612,2596,2596
Santa Cruz,52,2022-12-13,541,542,542,0,12986,13045,13044,1,19,0,0,1,276,276,276,276
Shasta,52,2022-12-13,104,104,104,0,1176,1183,1182,1,23,0,0,5,596,596,596,596
Siskiyou,52,2022-12-13,19,19,19,0,257,258,257,1,1,0,0,1,95,95,95,95
Solano,52,2022-12-13,652,654,654,0,6127,6155,6154,1,46,2,2,6,468,468,466,466
Sonoma,52,2022-12-13,573,575,575,0,5540,5565,5564,1,40,2,2,6,541,541,539,539
Stanislaus,52,2022-12-13,557,558,558,0,6268,6297,6296,1,112,7,7,9,1810,1810,1803,1803
Sutter,52,2022-12-13,106,106,106,0,1147,1154,1153,1,0,0,0,0,233,233,233,233
Tehama,52,2022-12-13,73,73,73,0,757,761,760,1,2,0,0,1,219,219,219,219
Trinity,52,2022-12-13,5,5,5,0,42,43,42,1,0,0,0,0,22,22,22,22
Tulare,52,2022-12-13,421,421,421,0,5630,5656,5655,1,31,3,3,2,1552,1552,1549,1549
Tuolumne,52,2022-12-13,128,128,128,0,901,906,905,1,6,0,0,0,203,203,203,203
Ventura,52,2022-12-13,890,895,895,0,10704,10752,10751,1,69,4,4,10,1618,1618,1614,1614
Yolo,52,2022-12-13,200,200,200,0,2208,2220,2219,1,5,2,2,2,426,426,424,424
Yuba,52,2022-12-13,75,75,75,0,934,940,939,1,7,0,0,0,122,122,122,122
Alameda,53,2022-12-20,2286,2298,2298,0,26750,26881,26880,1,150,14,14,23,2131,2131,2117,2117
Amador,53,2022-12-20,49,49,49,0,869,874,873,1,3,1,1,0,96,96,95,95
Butte,53,2022-12-20,126,126,126,0,1406,1415,1414,1,37,3,3,2,479,479,476,476
Calaveras,53,2022-12-20,28,28,28,0,429,430,429,1,0,2,2,0,137,137,135,135
Colusa,53,2022-12-20,13,13,13,0,204,205,204,1,0,0,0,0,22,22,22,22
Contra Costa,53,2022-12-20,1697,1705,1705,0,17181,17264,17263,1,84,4,4,9,1508,1508,1504,1504
Del Norte,53,2022-12-20,36,36,36,0,543,544,543,1,2,0,0,0,56,56,56,56
El Dorado,53,2022-12-20,165,165,165,0,1490,1498,1497,1,8,0,0,2,239,239,239,239
Fresno,53,2022-12-20,1148,1154,1154,0,12317,12377,12376,1,214,9,9,21,2939,2939,2930,2930
Glenn,53,2022-12-20,17,17,17,0,202,203,202,1,1,0,0,0,53,53,53,53
Humboldt,53,2022-12-20,113,113,113,0,903,909,908,1,9,0,0,2,165,165,165,165
Imperial,53,2022-12-20,258,258,258,0,2571,2585,2584,1,18,2,2,1,972,972,970,970
Inyo,53,2022-12-20,12,12,12,0,290,291,290,1,1,0,0,0,62,62,62,62
Kern,53,2022-12-20,907,912,912,0,10561,10614,10613,1,68,4,4,9,2452,2452,2448,2448
Kings,53,2022-12-20,215,215,215,0,2752,2766,2765,1,8,4,4,0,477,477,473,473
Lake,53,2022-12-20,73,73,73,0,763,768,767,1,6,1,1,0,152,152,151,151
Lassen,53,2022-12-20,14,14,14,0,489,491,490,1,0,0,0,0,64,64,64,64
Los Angeles,53,2022-12-20,15094,15167,15167,0,193499,194445,194443,2,1110,129,129,149,34520,34520,34391,34391
Madera,53,2022-12-20,189,189,189,0,1769,1778,1777,1,10,0,0,1,375,375,375,375
Marin,53,2022-12-20,258,258,258,0,3236,3253,3252,1,20,0,0,0,317,317,317,317
Mariposa,53,2022-12-20,25,25,25,0,132,133,132,1,0,0,0,0,30,30,30,30
Mendocino,53,2022-12-20,70,70,70,0,755,759,758,1,6,0,0,0,139,139,139,139
Merced,53,2022-12-20,237,237,237,0,2627,2641,2640,1,21,3,3,2,891,891,888,888
Modoc,53,2022-12-20,2,2,2,0,17,18,17,1,0,0,0,0,9,9,9,9
Mono,53,2022-12-20,12,12,12,0,113,114,113,1,1,0,0,0,8,8,8,8
Monterey,53,2022-12-20,220,220,220,0,3755,3775,3774,1,18,2,2,0,784,784,782,782
Napa,53,2022-12-20,178,178,178,0,2090,2101,2100,1,6,0,0,1,161,161,161,161
Nevada,53,2022-12-20,63,63,63,0,820,825,824,1,6,0,0,1,136,136,136,136
Orange,53,2022-12-20,3359,3375,3375,0,30119,30267,30266,1,303,37,37,48,7761,7761,7724,7724
Placer,53,2022-12-20,380,380,380,0,3839,3859,3858,1,102,1,1,6,675,675,674,674
Plumas,53,2022-12-20,9,9,9,0,169,170,169,1,1,0,0,0,13,13,13,13
Riverside,53,2022-12-20,3178,3194,3194,0,22632,22743,22742,1,180,21,21,19,6739,6739,6718,6718
Sacramento,53,2022-12-20,1731,1739,1739,0,19112,19206,19205,1,226,14,14,28,3433,3433,3419,3419
San Benito,53,2022-12-20,96,96,96,0,1089,1095,1094,1,0,3,3,1,109,109,106,106
San Bernardino,53,2022-12-20,3195,3210,3210,0,24536,24656,24655,1,217,4,4,27,8113,8113,8109,8109
San Diego,53,2022-12-20,4927,4951,4951,0,38136,38323,38322,1,386,14,14,41,5670,5670,5656,5656
San Francisco,53,2022-12-20,1213,1220,1220,0,15414,15490,15489,1,95,11,11,17,1126,1126,1115,1115
San Joaquin,53,2022-12-20,875,880,880,0,12722,12784,12783,1,66,12,12,14,2384,2384,2372,2372
San Luis Obispo,53,2022-12-20,245,245,245,0,2426,2440,2439,1,15,1,1,1,539,539,538,538
San Mateo,53,2022-12-20,969,974,974,0,11532,11588,11587,1,60,0,0,5,740,740,740,740
Santa Barbara,53,2022-12-20,504,504,504,0,5062,5087,5086,1,44,4,4,5,749,749,745,745
Santa Clara,53,2022-12-20,2720,2733,2733,0,30974,31126,31125,1,179,14,14,35,2626,2626,2612,2612
Santa Cruz,53,2022-12-20,202,202,202,0,10227,10278,10277,1,18,0,0,2,276,276,276,276
Shasta,53,2022-12-20,108,108,108,0,1085,1091,1090,1,17,1,1,3,597,597,596,596
Siskiyou,53,2022-12-20,11,11,11,0,248,249,248,1,0,0,0,1,95,95,95,95
Solano,53,2022-12-20,664,666,666,0,6100,6132,6131,1,43,0,0,7,468,468,468,468
Sonoma,53,2022-12-20,456,456,456,0,5295,5322,5321,1,30,1,1,6,542,542,541,541
Stanislaus,53,2022-12-20,482,482,482,0,5858,5888,5887,1,99,4,4,11,1814,1814,1810,1810
Sutter,53,2022-12-20,92,92,92,0,1002,1008,1007,1,0,1,1,0,234,234,233,233
Tehama,53,2022-12-20,70,70,70,0,707,711,710,1,2,2,2,1,221,221,219,219
Trinity,53,2022-12-20,1,1,1,0,29,30,29,1,0,0,0,0,22,22,22,22
Tulare,53,2022-12-20,477,478,478,0,5205,5231,5230,1,41,6,6,2,1558,1558,1552,1552
Tuolumne,53,2022-12-20,82,82,82,0,846,852,851,1,2,1,1,1,204,204,203,203
Ventura,53,2022-12-20,978,983,983,0,10013,10064,10063,1,82,5,5,11,1623,1623,1618,1618
Yolo,53,2022-12-20,177,177,177,0,2020,2031,2030,1,6,4,4,0,430,430,426,426
Yuba,53,2022-12-20,81,81,81,0,887,893,892,1,8,0,0,0,122,122,122,122
Alameda,54,2022-12-27,1984,1996,1996,0,20675,20784,20783,1,156,8,8,22,2139,2139,2131,2131
Amador,54,2022-12-27,33,33,33,0,635,640,639,1,6,0,0,0,96,96,96,96
Butte,54,2022-12-27,104,104,104,0,1342,1350,1349,1,32,0,0,3,479,479,479,479
Calaveras,54,2022-12-27,28,28,28,0,375,376,375,1,1,0,0,0,137,137,137,137
Colusa,54,2022-12-27,12,12,12,0,156,157,156,1,0,0,0,0,22,22,22,22
Contra Costa,54,2022-12-27,1490,1497,1497,0,13722,13794,13793,1,94,10,10,12,1518,1518,1508,1508
Del Norte,54,2022-12-27,34,34,34,0,405,407,406,1,3,0,0,0,56,56,56,56
El Dorado,54,2022-12-27,152,152,152,0,1412,1419,1418,1,3,2,2,1,241,241,239,239
Fresno,54,2022-12-27,1135,1141,1141,0,11207,11266,11265,1,181,11,11,30,2950,2950,2939,2939
Glenn,54,2022-12-27,9,9,9,0,198,199,198,1,0,0,0,0,53,53,53,53
Humboldt,54,2022-12-27,78,78,78,0,658,662,661,1,4,2,2,1,167,167,165,165
Imperial,54,2022-12-27,237,237,237,0,2094,2107,2106,1,4,1,1,3,973,973,972,972
Inyo,54,2022-12-27,14,14,14,0,208,209,208,1,2,0,0,0,62,62,62,62
Kern,54,2022-12-27,749,753,753,0,8943,8992,8991,1,50,8,8,9,2460,2460,2452,2452
Kings,54,2022-12-27,202,202,202,0,2175,2187,2186,1,4,0,0,1,477,477,477,477
Lake,54,2022-12-27,51,51,51,0,580,584,583,1,3,0,0,2,152,152,152,152
Lassen,54,2022-12-27,24,24,24,0,447,449,448,1,0,0,0,0,64,64,64,64
Los Angeles,54,2022-12-27,13698,13770,13770,0,134468,135179,135177,2,1044,177,184,151,34697,34704,34520,34520
Madera,54,2022-12-27,174,174,174,0,1662,1672,1671,1,5,0,0,1,375,375,375,375
Marin,54,2022-12-27,234,234,234,0,2460,2474,2473,1,29,0,0,3,317,317,317,317
Mariposa,54,2022-12-27,19,19,19,0,95,96,95,1,0,0,0,0,30,30,30,30
Mendocino,54,2022-12-27,73,73,73,0,668,673,672,1,9,0,0,1,139,139,139,139
Merced,54,2022-12-27,213,213,213,0,1987,2000,1999,1,15,4,4,3,895,895,891,891
Modoc,54,2022-12-27,7,7,7,0,14,15,14,1,0,0,0,0,9,9,9,9
Mono,54,2022-12-27,13,13,13,0,84,85,84,1,0,0,0,0,8,8,8,8
Monterey,54,2022-12-27,211,211,211,0,2979,2994,2993,1,20,3,3,1,787,787,784,784
Napa,54,2022-12-27,138,138,138,0,1761,1770,1769,1,13,1,1,0,162,162,161,161
Nevada,54,2022-12-27,73,73,73,0,750,755,754,1,9,0,0,0,136,136,136,136
Orange,54,2022-12-27,3337,3355,3355,0,25178,25311,25310,1,289,31,31,43,7792,7792,7761,7761
Placer,54,2022-12-27,299,299,299,0,3096,3113,3112,1,92,2,2,11,677,677,675,675
Plumas,54,2022-12-27,10,10,10,0,126,127,126,1,0,0,0,0,13,13,13,13
Riverside,54,2022-12-27,3108,3126,3126,0,19452,19554,19553,1,204,9,9,19,6748,6748,6739,6739
Sacramento,54,2022-12-27,1447,1454,1454,0,14990,15070,15069,1,183,15,15,24,3448,3448,3433,3433
San Benito,54,2022-12-27,102,102,102,0,861,865,864,1,1,0,0,1,109,109,109,109
San Bernardino,54,2022-12-27,3043,3060,3060,0,20854,20964,20963,1,199,8,8,31,8121,8121,8113,8113
San Diego,54,2022-12-27,4711,4736,4736,0,28995,29150,29149,1,397,31,31,48,5701,5701,5670,5670
San Francisco,54,2022-12-27,1058,1064,1064,0,11760,11822,11821,1,96,18,18,14,1144,1144,1126,1126
San Joaquin,54,2022-12-27,776,781,781,0,10625,10681,10680,1,66,6,6,12,2390,2390,2384,2384
San Luis Obispo,54,2022-12-27,225,225,225,0,2020,2032,2031,1,20,3,3,0,542,542,539,539
San Mateo,54,2022-12-27,844,849,849,0,8790,8838,8837,1,50,0,0,6,740,740,740,740
Santa Barbara,54,2022-12-27,476,476,476,0,4102,4125,4124,1,41,0,0,5,749,749,749,749
Santa Clara,54,2022-12-27,2448,2461,2461,0,24355,24485,24484,1,177,10,10,37,2636,2636,2626,2626
Santa Cruz,54,2022-12-27,233,233,233,0,4099,4122,4121,1,28,0,0,1,276,276,276,276
Shasta,54,2022-12-27,106,106,106,0,1031,1038,1037,1,19,0,0,0,597,597,597,597
Siskiyou,54,2022-12-27,21,21,21,0,278,279,278,1,2,0,0,0,95,95,95,95
Solano,54,2022-12-27,641,645,645,0,5139,5167,5166,1,59,4,4,8,472,472,468,468
Sonoma,54,2022-12-27,466,467,467,0,4142,4166,4165,1,42,1,1,2,543,543,542,542
Stanislaus,54,2022-12-27,459,460,460,0,5116,5144,5143,1,97,10,10,8,1824,1824,1814,1814
Sutter,54,2022-12-27,120,120,120,0,955,962,961,1,0,0,0,0,234,234,234,234
Tehama,54,2022-12-27,42,42,42,0,613,618,617,1,7,3,3,1,224,224,221,221
Trinity,54,2022-12-27,3,3,3,0,45,46,45,1,0,0,0,0,22,22,22,22
Tulare,54,2022-12-27,463,464,464,0,4174,4197,4196,1,42,5,5,3,1563,1563,1558,1558
Tuolumne,54,2022-12-27,95,95,95,0,733,739,738,1,7,3,3,0,207,207,204,204
Ventura,54,2022-12-27,931,937,937,0,7649,7692,7691,1,72,17,17,12,1640,1640,1623,1623
Yolo,54,2022-12-27,135,135,135,0,1499,1508,1507,1,7,3,3,0,433,433,430,430
Yuba,54,2022-12-27,103,103,103,0,743,749,748,1,18,0,0,0,122,122,122,122
Alameda,55,2023-01-03,1846,1857,1857,0,20506,20633,20632,1,166,15,15,14,2154,2154,2139,2139
Amador,55,2023-01-03,32,32,32,0,688,694,693,1,3,1,1,0,97,97,96,96
Butte,55,2023-01-03,93,93,93,0,1301,1309,1308,1,35,3,3,3,482,482,479,479
Calaveras,55,2023-01-03,31,31,31,0,360,361,360,1,0,2,2,0,139,139,137,137
Colusa,55,2023-01-03,6,6,6,0,86,87,86,1,0,0,0,0,22,22,22,22
Contra Costa,55,2023-01-03,1318,1327,1327,0,14391,14480,14479,1,92,7,7,12,1525,1525,1518,1518
Del Norte,55,2023-01-03,31,31,31,0,396,398,397,1,3,0,0,2,56,56,56,56
El Dorado,55,2023-01-03,135,135,135,0,1403,1412,1411,1,7,0,0,2,241,241,241,241
Fresno,55,2023-01-03,1008,1014,1014,0,10917,10984,10983,1,180,13,13,30,2963,2963,2950,2950
Glenn,55,2023-01-03,13,13,13,0,184,186,185,1,0,0,0,0,53,53,53,53
Humboldt,55,2023-01-03,48,48,48,0,646,651,650,1,5,0,0,1,167,167,167,167
Imperial,55,2023-01-03,188,188,188,0,1982,1996,1995,1,11,1,1,3,974,974,973,973
Inyo,55,2023-01-03,15,15,15,0,235,237,236,1,1,0,0,0,62,62,62,62
Kern,55,2023-01-03,836,840,840,0,9878,9940,9939,1,69,3,3,8,2463,2463,2460,2460
Kings,55,2023-01-03,195,195,195,0,2125,2140,2139,1,6,2,2,1,479,479,477,477
Lake,55,2023-01-03,54,54,54,0,644,650,649,1,2,1,1,1,153,153,152,152
Lassen,55,2023-01-03,13,13,13,0,483,486,485,1,0,0,0,0,64,64,64,64
Los Angeles,55,2023-01-03,12759,12837,12837,0,145713,146610,146608,2,1109,141,147,153,34838,34851,34697,34704
Madera,55,2023-01-03,133,133,133,0,1569,1579,1578,1,8,0,0,0,375,375,375,375
Marin,55,2023-01-03,210,210,210,0,2446,2462,2461,1,19,0,0,4,317,317,317,317
Mariposa,55,2023-01-03,15,15,15,0,102,103,102,1,0,1,1,0,31,31,30,30
Mendocino,55,2023-01-03,51,51,51,0,654,659,658,1,8,1,1,3,140,140,139,139
Merced,55,2023-01-03,193,193,193,0,2062,2076,2075,1,11,2,2,2,897,897,895,895
Modoc,55,2023-01-03,10,10,10,0,14,15,14,1,0,0,0,0,9,9,9,9
Mono,55,2023-01-03,9,9,9,0,69,70,69,1,0,0,0,0,8,8,8,8
Monterey,55,2023-01-03,194,194,194,0,3036,3055,3054,1,25,0,0,0,787,787,787,787
Napa,55,2023-01-03,124,124,124,0,1586,1597,1596,1,7,0,0,1,162,162,162,162
Nevada,55,2023-01-03,46,46,46,0,717,723,722,1,11,0,0,0,136,136,136,136
Orange,55,2023-01-03,3125,3145,3145,0,25333,25489,25488,1,317,35,35,33,7827,7827,7792,7792
Placer,55,2023-01-03,289,289,289,0,3256,3275,3274,1,112,1,1,11,678,678,677,677
Plumas,55,2023-01-03,12,12,12,0,148,149,148,1,1,1,1,0,14,14,13,13
Riverside,55,2023-01-03,2895,2913,2913,0,20140,20263,20262,1,245,12,12,28,6760,6760,6748,6748
Sacramento,55,2023-01-03,1393,1402,1402,0,15259,15352,15351,1,209,22,22,24,3470,3470,3448,3448
San Benito,55,2023-01-03,51,51,51,0,764,769,768,1,0,0,0,1,109,109,109,109
San Bernardino,55,2023-01-03,2608,2624,2624,0,20370,20494,20493,1,180,3,3,31,8124,8124,8121,8121
San Diego,55,2023-01-03,4327,4352,4352,0,29943,30126,30125,1,399,21,21,40,5722,5722,5701,5701
San Francisco,55,2023-01-03,858,863,863,0,10712,10777,10776,1,80,10,10,17,1154,1154,1144,1144
San Joaquin,55,2023-01-03,712,716,716,0,10245,10308,10307,1,71,6,6,14,2396,2396,2390,2390
San Luis Obispo,55,2023-01-03,220,220,220,0,2060,2074,2073,1,12,6,6,0,548,548,542,542
San Mateo,55,2023-01-03,712,717,717,0,8438,8490,8489,1,50,0,0,7,740,740,740,740
Santa Barbara,55,2023-01-03,424,424,424,0,4177,4203,4202,1,42,1,1,8,750,750,749,749
Santa Clara,55,2023-01-03,2372,2387,2387,0,24559,24711,24710,1,205,15,15,32,2651,2651,2636,2636
Santa Cruz,55,2023-01-03,161,161,161,0,2992,3011,3010,1,32,0,0,0,276,276,276,276
Shasta,55,2023-01-03,83,83,83,0,874,880,879,1,14,0,0,1,597,597,597,597
Siskiyou,55,2023-01-03,14,14,14,0,266,267,266,1,2,0,0,0,95,95,95,95
Solano,55,2023-01-03,587,591,591,0,5285,5318,5317,1,63,1,1,10,473,473,472,472
Sonoma,55,2023-01-03,385,385,385,0,4373,4401,4400,1,60,0,0,1,543,543,543,543
Stanislaus,55,2023-01-03,447,448,448,0,5078,5110,5109,1,81,5,5,8,1829,1829,1824,1824
Sutter,55,2023-01-03,91,91,91,0,885,892,891,1,0,0,0,0,234,234,234,234
Tehama,55,2023-01-03,52,52,52,0,584,590,589,1,3,4,4,0,228,228,224,224
Trinity,55,2023-01-03,4,4,4,0,38,39,38,1,0,0,0,0,22,22,22,22
Tulare,55,2023-01-03,449,451,451,0,4712,4742,4741,1,59,1,1,5,1564,1564,1563,1563
Tuolumne,55,2023-01-03,61,61,61,0,648,653,652,1,4,0,0,0,207,207,207,207
Ventura,55,2023-01-03,818,823,823,0,7768,7816,7815,1,84,8,8,11,1648,1648,1640,1640
Yolo,55,2023-01-03,135,135,135,0,1623,1634,1633,1,3,2,2,1,435,435,433,433
Yuba,55,2023-01-03,77,77,77,0,720,726,725,1,18,0,0,1,122,122,122,122
Alameda,56,2023-01-10,1314,1325,1325,0,22327,22487,22486,1,125,12,12,11,2166,2166,2154,2154
Amador,56,2023-01-10,30,30,30,0,755,762,761,1,2,0,0,0,97,97,97,97
Butte,56,2023-01-10,73,73,73,0,1048,1057,1056,1,36,2,2,3,484,484,482,482
Calaveras,56,2023-01-10,17,17,17,0,314,315,314,1,1,0,0,1,139,139,139,139
Colusa,56,2023-01-10,9,9,9,0,91,92,91,1,0,0,0,0,22,22,22,22
Contra Costa,56,2023-01-10,937,944,944,0,14434,14537,14536,1,77,5,5,13,1530,1530,1525,1525
Del Norte,56,2023-01-10,13,13,13,0,379,382,381,1,3,0,0,2,56,56,56,56
El Dorado,56,2023-01-10,74,74,74,0,1333,1344,1343,1,4,0,0,0,241,241,241,241
Fresno,56,2023-01-10,733,739,739,0,10995,11073,11072,1,177,6,6,27,2969,2969,2963,2963
Glenn,56,2023-01-10,7,7,7,0,175,177,176,1,0,0,0,0,53,53,53,53
Humboldt,56,2023-01-10,51,51,51,0,628,634,633,1,6,0,0,5,167,167,167,167
Imperial,56,2023-01-10,145,145,145,0,2542,2562,2561,1,9,1,1,6,975,975,974,974
Inyo,56,2023-01-10,10,10,10,0,188,189,188,1,1,0,0,0,62,62,62,62
Kern,56,2023-01-10,538,542,542,0,10197,10269,10268,1,78,5,5,7,2468,2468,2463,2463
Kings,56,2023-01-10,163,163,163,0,2375,2393,2392,1,7,0,0,0,479,479,479,479
Lake,56,2023-01-10,36,36,36,0,587,593,592,1,3,1,1,0,154,154,153,153
Lassen,56,2023-01-10,17,17,17,0,514,517,516,1,0,0,0,0,64,64,64,64
Los Angeles,56,2023-01-10,9058,9121,9121,0,180777,182077,182075,2,989,138,145,139,34976,34996,34838,34851
Madera,56,2023-01-10,90,90,90,0,1566,1579,1578,1,4,0,0,1,375,375,375,375
Marin,56,2023-01-10,128,128,128,0,2425,2443,2442,1,20,0,0,5,317,317,317,317
Mariposa,56,2023-01-10,5,5,5,0,96,97,96,1,0,0,0,0,31,31,31,31
Mendocino,56,2023-01-10,38,38,38,0,601,607,606,1,10,2,2,0,142,142,140,140
Merced,56,2023-01-10,177,177,177,0,1958,1973,1972,1,12,1,1,2,898,898,897,897
Modoc,56,2023-01-10,4,4,4,0,11,12,11,1,0,0,0,0,9,9,9,9
Mono,56,2023-01-10,11,11,11,0,72,73,72,1,0,0,0,0,8,8,8,8
Monterey,56,2023-01-10,173,173,173,0,2985,3008,3007,1,17,4,4,3,791,791,787,787
Napa,56,2023-01-10,115,115,115,0,1876,1891,1890,1,15,0,0,1,162,162,162,162
Nevada,56,2023-01-10,40,40,40,0,708,715,714,1,7,0,0,0,136,136,136,136
Orange,56,2023-01-10,2184,2199,2199,0,26989,27183,27182,1,264,42,42,36,7869,7869,7827,7827
Placer,56,2023-01-10,246,246,246,0,3261,3287,3286,1,79,0,0,4,678,678,678,678
Plumas,56,2023-01-10,3,3,3,0,68,69,68,1,1,0,0,0,14,14,14,14
Riverside,56,2023-01-10,1755,1768,1768,0,20012,20157,20156,1,168,14,14,27,6774,6774,6760,6760
Sacramento,56,2023-01-10,923,930,930,0,14766,14873,14872,1,173,20,20,28,3490,3490,3470,3470
San Benito,56,2023-01-10,45,45,45,0,731,738,737,1,1,0,0,2,109,109,109,109
San Bernardino,56,2023-01-10,1554,1565,1565,0,19835,19977,19976,1,179,5,5,32,8129,8129,8124,8124
San Diego,56,2023-01-10,3258,3281,3281,0,33721,33965,33964,1,363,26,26,38,5748,5748,5722,5722
San Francisco,56,2023-01-10,694,700,700,0,11699,11782,11781,1,77,6,6,13,1160,1160,1154,1154
San Joaquin,56,2023-01-10,537,541,541,0,10342,10416,10415,1,65,11,11,9,2407,2407,2396,2396
San Luis Obispo,56,2023-01-10,143,143,143,0,1932,1945,1944,1,13,3,3,0,551,551,548,548
San Mateo,56,2023-01-10,532,537,537,0,8991,9055,9054,1,46,0,0,2,740,740,740,740
Santa Barbara,56,2023-01-10,321,321,321,0,4183,4212,4211,1,39,3,3,1,753,753,750,750
Santa Clara,56,2023-01-10,1713,1725,1725,0,28031,28234,28233,1,167,13,13,24,2664,2664,2651,2651
Santa Cruz,56,2023-01-10,158,158,158,0,4212,4243,4242,1,29,0,0,1,276,276,276,276
Shasta,56,2023-01-10,56,56,56,0,818,824,823,1,14,0,0,3,597,597,597,597
Siskiyou,56,2023-01-10,17,17,17,0,221,222,221,1,1,0,0,0,95,95,95,95
Solano,56,2023-01-10,373,374,374,0,4964,5001,5000,1,52,1,1,7,474,474,473,473
Sonoma,56,2023-01-10,257,257,257,0,4480,4512,4511,1,36,3,3,4,546,546,543,543
Stanislaus,56,2023-01-10,283,283,283,0,4777,4812,4811,1,84,4,4,8,1833,1833,1829,1829
Sutter,56,2023-01-10,59,59,59,0,809,817,816,1,0,0,0,0,234,234,234,234
Tehama,56,2023-01-10,26,26,26,0,466,472,471,1,1,2,2,0,230,230,228,228
Trinity,56,2023-01-10,2,2,2,0,29,30,29,1,0,0,0,0,22,22,22,22
Tulare,56,2023-01-10,299,299,299,0,4762,4798,4797,1,52,5,5,3,1569,1569,1564,1564
Tuolumne,56,2023-01-10,75,75,75,0,642,649,648,1,3,1,1,0,208,208,207,207
Ventura,56,2023-01-10,600,605,605,0,9170,9237,9236,1,72,6,6,12,1654,1654,1648,1648
Yolo,56,2023-01-10,94,94,94,0,1614,1626,1625,1,4,2,2,1,437,437,435,435
Yuba,56,2023-01-10,45,45,45,0,726,734,733,1,13,0,0,1,122,122,122,122
Alameda,57,2023-01-17,833,840,840,0,19380,19542,19541,1,96,5,5,16,2171,2171,2166,2166
Amador,57,2023-01-17,24,24,24,0,502,510,509,1,4,0,0,0,97,97,97,97
Butte,57,2023-01-17,62,62,62,0,1251,1263,1262,1,26,1,1,1,485,485,484,484
Calaveras,57,2023-01-17,10,10,10,0,312,314,313,1,2,0,0,1,139,139,139,139
Colusa,57,2023-01-17,6,6,6,0,84,85,84,1,1,0,0,0,22,22,22,22
Contra Costa,57,2023-01-17,589,596,596,0,12337,12440,12439,1,67,4,4,9,1534,1534,1530,1530
Del Norte,57,2023-01-17,11,11,11,0,290,292,291,1,3,2,2,0,58,58,56,56
El Dorado,57,2023-01-17,62,62,62,0,972,982,981,1,3,1,1,1,242,242,241,241
Fresno,57,2023-01-17,440,443,443,0,9831,9915,9914,1,162,7,7,12,2976,2976,2969,2969
Glenn,57,2023-01-17,3,3,3,0,161,163,162,1,0,0,0,0,53,53,53,53
Humboldt,57,2023-01-17,36,36,36,0,534,540,539,1,6,1,1,3,168,168,167,167
Imperial,57,2023-01-17,114,114,114,0,1939,1956,1955,1,8,2,2,6,977,977,975,975
Inyo,57,2023-01-17,10,10,10,0,202,204,203,1,0,1,1,0,63,63,62,62
Kern,57,2023-01-17,390,393,393,0,8381,8451,8450,1,57,3,3,11,2471,2471,2468,2468
Kings,57,2023-01-17,113,113,113,0,1866,1882,1881,1,1,2,2,1,481,481,479,479
Lake,57,2023-01-17,30,30,30,0,576,582,581,1,0,2,2,1,156,156,154,154
Lassen,57,2023-01-17,7,7,7,0,427,431,430,1,0,0,0,0,64,64,64,64
Los Angeles,57,2023-01-17,6125,6176,6176,0,156990,158304,158302,2,854,139,146,104,35115,35142,34976,34996
Madera,57,2023-01-17,61,61,61,0,1399,1411,1410,1,5,0,0,2,375,375,375,375
Marin,57,2023-01-17,122,122,122,0,2104,2123,2122,1,20,0,0,2,317,317,317,317
Mariposa,57,2023-01-17,13,13,13,0,99,100,99,1,0,0,0,0,31,31,31,31
Mendocino,57,2023-01-17,25,25,25,0,521,527,526,1,8,0,0,0,142,142,142,142
Merced,57,2023-01-17,121,121,121,0,1777,1792,1791,1,15,3,3,2,901,901,898,898
Modoc,57,2023-01-17,2,2,2,0,11,12,11,1,0,0,0,0,9,9,9,9
Mono,57,2023-01-17,5,5,5,0,71,72,71,1,0,0,0,0,8,8,8,8
Monterey,57,2023-01-17,109,109,109,0,2667,2691,2690,1,20,3,3,0,794,794,791,791
Napa,57,2023-01-17,71,71,71,0,1503,1517,1516,1,3,0,0,1,162,162,162,162
Nevada,57,2023-01-17,27,27,27,0,604,611,610,1,4,0,0,2,136,136,136,136
Orange,57,2023-01-17,1391,1403,1403,0,24535,24739,24738,1,238,38,38,34,7907,7907,7869,7869
Placer,57,2023-01-17,163,163,163,0,2587,2609,2608,1,62,0,0,7,678,678,678,678
Plumas,57,2023-01-17,2,2,2,0,83,84,83,1,1,0,0,0,14,14,14,14
Riverside,57,2023-01-17,1187,1199,1199,0,16824,16964,16963,1,151,14,14,29,6788,6788,6774,6774
Sacramento,57,2023-01-17,551,557,557,0,12284,12388,12387,1,152,13,13,25,3503,3503,3490,3490
San Benito,57,2023-01-17,30,30,30,0,491,496,495,1,1,1,1,0,110,110,109,109
San Bernardino,57,2023-01-17,1032,1041,1041,0,17663,17811,17810,1,149,2,2,28,8131,8131,8129,8129
San Diego,57,2023-01-17,2054,2072,2072,0,29642,29892,29891,1,306,14,14,34,5762,5762,5748,5748
San Francisco,57,2023-01-17,435,439,439,0,10685,10775,10774,1,71,1,1,13,1161,1161,1160,1160
San Joaquin,57,2023-01-17,335,337,337,0,8511,8583,8582,1,58,8,8,7,2415,2415,2407,2407
San Luis Obispo,57,2023-01-17,120,120,120,0,1910,1926,1925,1,9,2,2,3,553,553,551,551
San Mateo,57,2023-01-17,371,372,372,0,7949,8017,8016,1,36,0,0,2,740,740,740,740
Santa Barbara,57,2023-01-17,245,245,245,0,4124,4160,4159,1,36,2,2,2,755,755,753,753
Santa Clara,57,2023-01-17,1105,1114,1114,0,24624,24831,24830,1,135,12,12,21,2676,2676,2664,2664
Santa Cruz,57,2023-01-17,159,159,159,0,7346,7407,7406,1,26,0,0,0,276,276,276,276
Shasta,57,2023-01-17,40,40,40,0,740,747,746,1,16,2,2,1,599,599,597,597
Siskiyou,57,2023-01-17,6,6,6,0,206,207,206,1,1,0,0,0,95,95,95,95
Solano,57,2023-01-17,205,205,205,0,3763,3796,3795,1,48,0,0,5,474,474,474,474
Sonoma,57,2023-01-17,193,193,193,0,3939,3974,3973,1,29,5,5,3,551,551,546,546
Stanislaus,57,2023-01-17,195,195,195,0,4292,4329,4328,1,66,3,3,8,1836,1836,1833,1833
Sutter,57,2023-01-17,43,43,43,0,708,716,715,1,0,1,1,0,235,235,234,234
Tehama,57,2023-01-17,17,17,17,0,339,342,341,1,1,0,0,0,230,230,230,230
Trinity,57,2023-01-17,3,3,3,0,23,24,23,1,0,0,0,0,22,22,22,22
Tulare,57,2023-01-17,246,247,247,0,4179,4216,4215,1,47,3,3,3,1572,1572,1569,1569
Tuolumne,57,2023-01-17,43,43,43,0,538,544,543,1,0,2,2,0,210,210,208,208
Ventura,57,2023-01-17,398,401,401,0,8052,8119,8118,1,57,3,3,10,1657,1657,1654,1654
Yolo,57,2023-01-17,80,80,80,0,1258,1269,1268,1,2,3,3,0,440,440,437,437
Yuba,57,2023-01-17,32,32,32,0,608,614,613,1,3,0,0,2,122,122,122,122
Alameda,58,2023-01-24,730,737,737,0,19913,20107,20106,1,74,13,13,10,2184,2184,2171,2171
Amador,58,2023-01-24,31,31,31,0,692,700,699,1,1,1,1,0,98,98,97,97
Butte,58,2023-01-24,40,40,40,0,1062,1074,1073,1,14,1,1,3,486,486,485,485
Calaveras,58,2023-01-24,14,14,14,0,282,286,285,1,0,0,0,0,139,139,139,139
Colusa,58,2023-01-24,10,10,10,0,142,144,143,1,1,0,0,0,22,22,22,22
Contra Costa,58,2023-01-24,525,531,531,0,13077,13206,13205,1,44,8,8,10,1542,1542,1534,1534
Del Norte,58,2023-01-24,25,25,25,0,362,367,366,1,1,0,0,0,58,58,58,58
El Dorado,58,2023-01-24,46,46,46,0,1126,1137,1136,1,2,1,1,1,243,243,242,242
Fresno,58,2023-01-24,435,440,440,0,9914,10012,10011,1,116,6,6,21,2982,2982,2976,2976
Glenn,58,2023-01-24,2,2,2,0,156,158,157,1,0,0,0,0,53,53,53,53
Humboldt,58,2023-01-24,29,29,29,0,534,540,539,1,7,1,1,3,169,169,168,168
Imperial,58,2023-01-24,102,102,102,0,2270,2292,2291,1,14,1,1,1,978,978,977,977
Inyo,58,2023-01-24,6,6,6,0,160,162,161,1,0,0,0,0,63,63,63,63
Kern,58,2023-01-24,320,322,322,0,9299,9390,9389,1,35,5,5,7,2476,2476,2471,2471
Kings,58,2023-01-24,127,127,127,0,2102,2123,2122,1,4,1,1,0,482,482,481,481
Lake,58,2023-01-24,25,25,25,0,600,606,605,1,2,1,1,2,157,157,156,156
Lassen,58,2023-01-24,4,4,4,0,485,491,490,1,0,0,0,0,64,64,64,64
Los Angeles,58,2023-01-24,5474,5528,5528,0,160272,161844,161842,2,661,110,117,94,35225,35259,35115,35142
Madera,58,2023-01-24,52,52,52,0,1402,1418,1417,1,6,0,0,2,375,375,375,375
Marin,58,2023-01-24,105,105,105,0,2373,2397,2396,1,14,0,0,2,317,317,317,317
Mariposa,58,2023-01-24,8,8,8,0,106,107,106,1,0,0,0,0,31,31,31,31
Mendocino,58,2023-01-24,18,18,18,0,512,518,517,1,2,0,0,1,142,142,142,142
Merced,58,2023-01-24,120,120,120,0,1841,1859,1858,1,8,2,2,4,903,903,901,901
Modoc,58,2023-01-24,1,1,1,0,7,8,7,1,1,0,0,0,9,9,9,9
Mono,58,2023-01-24,5,5,5,0,72,73,72,1,0,0,0,0,8,8,8,8
Monterey,58,2023-01-24,107,107,107,0,2743,2770,2769,1,13,1,1,1,795,795,794,794
Napa,58,2023-01-24,69,69,69,0,1452,1468,1467,1,5,0,0,0,162,162,162,162
Nevada,58,2023-01-24,22,22,22,0,568,575,574,1,2,0,0,1,136,136,136,136
Orange,58,2023-01-24,1152,1164,1164,0,23354,23583,23582,1,160,24,24,29,7931,7931,7907,7907
Placer,58,2023-01-24,132,132,132,0,2743,2771,2770,1,49,1,1,6,679,679,678,678
Plumas,58,2023-01-24,7,7,7,0,82,83,82,1,1,0,0,0,14,14,14,14
Riverside,58,2023-01-24,988,997,997,0,16140,16298,16297,1,102,13,13,24,6801,6801,6788,6788
Sacramento,58,2023-01-24,614,620,620,0,13579,13713,13712,1,123,9,9,19,3512,3512,3503,3503
San Benito,58,2023-01-24,27,27,27,0,532,538,537,1,0,0,0,0,110,110,110,110
San Bernardino,58,2023-01-24,966,976,976,0,17884,18060,18059,1,130,2,2,62,8133,8133,8131,8131
San Diego,58,2023-01-24,1928,1947,1947,0,32208,32526,32525,1,254,8,8,39,5770,5770,5762,5762
San Francisco,58,2023-01-24,438,443,443,0,10869,10974,10973,1,54,6,6,4,1167,1167,1161,1161
San Joaquin,58,2023-01-24,249,250,250,0,8378,8460,8459,1,33,3,3,10,2418,2418,2415,2415
San Luis Obispo,58,2023-01-24,104,104,104,0,1866,1886,1885,1,6,4,4,0,557,557,553,553
San Mateo,58,2023-01-24,364,367,367,0,8431,8515,8514,1,21,0,0,2,740,740,740,740
Santa Barbara,58,2023-01-24,218,218,218,0,4268,4311,4310,1,28,2,2,4,757,757,755,755
Santa Clara,58,2023-01-24,996,1005,1005,0,23301,23529,23528,1,115,6,6,26,2682,2682,2676,2676
Santa Cruz,58,2023-01-24,108,108,108,0,9413,9507,9506,1,17,0,0,0,276,276,276,276
Shasta,58,2023-01-24,26,26,26,0,743,752,751,1,6,1,1,1,600,600,599,599
Siskiyou,58,2023-01-24,7,7,7,0,183,184,183,1,0,0,0,0,95,95,95,95
Solano,58,2023-01-24,231,231,231,0,4171,4213,4212,1,32,0,0,0,474,474,474,474
Sonoma,58,2023-01-24,184,184,184,0,4092,4133,4132,1,26,0,0,3,551,551,551,551
Stanislaus,58,2023-01-24,181,181,181,0,4144,4184,4183,1,52,2,2,6,1838,1838,1836,1836
Sutter,58,2023-01-24,38,38,38,0,731,739,738,1,0,0,0,0,235,235,235,235
Tehama,58,2023-01-24,15,15,15,0,342,345,344,1,1,0,0,0,230,230,230,230
Trinity,58,2023-01-24,4,4,4,0,28,29,28,1,0,1,1,0,23,23,22,22
Tulare,58,2023-01-24,221,221,221,0,4049,4090,4089,1,32,2,2,3,1574,1574,1572,1572
Tuolumne,58,2023-01-24,40,40,40,0,545,552,551,1,0,1,1,1,211,211,210,210
Ventura,58,2023-01-24,373,377,377,0,8242,8325,8324,1,55,7,7,4,1664,1664,1657,1657
Yolo,58,2023-01-24,82,82,82,0,1271,1284,1283,1,3,2,2,0,442,442,440,440
Yuba,58,2023-01-24,29,29,29,0,722,730,729,1,3,0,0,0,122,122,122,122
Alameda,59,2023-01-31,876,886,886,0,18564,18772,18771,1,81,1,1,6,2185,2185,2184,2184
Amador,59,2023-01-31,28,28,28,0,624,633,632,1,2,0,0,0,98,98,98,98
Butte,59,2023-01-31,51,51,51,0,1094,1108,1107,1,14,2,2,1,488,488,486,486
Calaveras,59,2023-01-31,17,17,17,0,313,318,317,1,0,1,1,0,140,140,139,139
Colusa,59,2023-01-31,7,7,7,0,172,175,174,1,0,0,0,0,22,22,22,22
Contra Costa,59,2023-01-31,672,679,679,0,12220,12358,12357,1,31,7,7,9,1549,1549,1542,1542
Del Norte,59,2023-01-31,37,37,37,0,413,418,417,1,2,1,1,0,59,59,58,58
El Dorado,59,2023-01-31,58,58,58,0,1206,1220,1219,1,3,1,1,0,244,244,243,243
Fresno,59,2023-01-31,443,448,448,0,9833,9944,9943,1,111,8,8,10,2990,2990,2982,2982
Glenn,59,2023-01-31,3,3,3,0,154,156,155,1,0,0,0,0,53,53,53,53
Humboldt,59,2023-01-31,34,34,34,0,552,560,559,1,5,0,0,1,169,169,169,169
Imperial,59,2023-01-31,91,91,91,0,2055,2079,2078,1,7,1,1,1,979,979,978,978
Inyo,59,2023-01-31,11,11,11,0,197,199,198,1,0,0,0,0,63,63,63,63
Kern,59,2023-01-31,301,304,304,0,8886,8986,8985,1,40,3,3,5,2479,2479,2476,2476
Kings,59,2023-01-31,130,130,130,0,2208,2233,2232,1,7,0,0,1,482,482,482,482
Lake,59,2023-01-31,21,21,21,0,511,518,517,1,5,2,2,0,159,159,157,157
Lassen,59,2023-01-31,3,3,3,0,518,525,524,1,0,0,0,0,64,64,64,64
Los Angeles,59,2023-01-31,5866,5930,5930,0,149126,150799,150797,2,667,101,108,80,35326,35367,35225,35259
Madera,59,2023-01-31,48,48,48,0,1482,1500,1499,1,8,0,0,0,375,375,375,375
Marin,59,2023-01-31,115,115,115,0,2205,2230,2229,1,18,0,0,2,317,317,317,317
Mariposa,59,2023-01-31,2,2,2,0,100,101,100,1,0,0,0,0,31,31,31,31
Mendocino,59,2023-01-31,30,30,30,0,511,517,516,1,2,0,0,2,142,142,142,142
Merced,59,2023-01-31,141,141,141,0,1854,1877,1876,1,11,0,0,2,903,903,903,903
Modoc,59,2023-01-31,1,1,1,0,9,10,9,1,0,0,0,0,9,9,9,9
Mono,59,2023-01-31,3,3,3,0,83,84,83,1,0,0,0,0,8,8,8,8
Monterey,59,2023-01-31,165,165,165,0,2841,2875,2874,1,12,3,3,0,798,798,795,795
Napa,59,2023-01-31,81,81,81,0,1358,1375,1374,1,6,0,0,0,162,162,162,162
Nevada,59,2023-01-31,25,25,25,0,586,594,593,1,2,0,0,0,136,136,136,136
Orange,59,2023-01-31,1193,1206,1206,0,22543,22796,22795,1,157,15,15,25,7946,7946,7931,7931
Placer,59,2023-01-31,182,182,182,0,2728,2760,2759,1,51,2,2,6,681,681,679,679
Plumas,59,2023-01-31,1,1,1,0,72,73,72,1,0,1,1,0,15,15,14,14
Riverside,59,2023-01-31,1099,1110,1110,0,15847,16025,16024,1,86,3,3,17,6804,6804,6801,6801
Sacramento,59,2023-01-31,675,682,682,0,13358,13508,13507,1,119,6,6,16,3518,3518,3512,3512
San Benito,59,2023-01-31,32,32,32,0,562,570,569,1,1,0,0,0,110,110,110,110
San Bernardino,59,2023-01-31,929,940,940,0,17565,17763,17762,1,132,0,0,19,8133,8133,8133,8133
San Diego,59,2023-01-31,1872,1892,1892,0,29807,30142,30141,1,235,10,10,29,5780,5780,5770,5770
San Francisco,59,2023-01-31,490,497,497,0,10762,10883,10882,1,50,2,2,4,1169,1169,1167,1167
San Joaquin,59,2023-01-31,311,315,315,0,7468,7552,7551,1,32,3,3,4,2421,2421,2418,2418
San Luis Obispo,59,2023-01-31,135,135,135,0,1907,1930,1929,1,12,5,5,0,562,562,557,557
San Mateo,59,2023-01-31,437,442,442,0,8691,8789,8788,1,29,0,0,1,740,740,740,740
Santa Barbara,59,2023-01-31,218,218,218,0,4310,4358,4357,1,22,2,2,2,759,759,757,757
Santa Clara,59,2023-01-31,1224,1238,1238,0,23618,23884,23883,1,124,6,6,22,2688,2688,2682,2682
Santa Cruz,59,2023-01-31,139,139,139,0,9432,9540,9539,1,11,0,0,0,276,276,276,276
Shasta,59,2023-01-31,17,17,17,0,618,626,625,1,7,0,0,0,600,600,600,600
Siskiyou,59,2023-01-31,7,7,7,0,192,193,192,1,0,0,0,0,95,95,95,95
Solano,59,2023-01-31,239,240,240,0,4076,4122,4121,1,37,0,0,2,474,474,474,474
Sonoma,59,2023-01-31,177,177,177,0,3534,3574,3573,1,22,2,2,1,553,553,551,551
Stanislaus,59,2023-01-31,235,235,235,0,4135,4183,4182,1,44,2,2,6,1840,1840,1838,1838
Sutter,59,2023-01-31,36,36,36,0,639,648,647,1,0,1,1,0,236,236,235,235
Tehama,59,2023-01-31,9,9,9,0,314,319,318,1,1,1,1,0,231,231,230,230
Trinity,59,2023-01-31,7,7,7,0,28,29,28,1,0,0,0,0,23,23,23,23
Tulare,59,2023-01-31,265,267,267,0,4033,4080,4079,1,23,3,3,1,1577,1577,1574,1574
Tuolumne,59,2023-01-31,43,43,43,0,557,565,564,1,3,0,0,0,211,211,211,211
Ventura,59,2023-01-31,342,346,346,0,7608,7694,7693,1,41,5,5,7,1669,1669,1664,1664
Yolo,59,2023-01-31,80,80,80,0,1287,1303,1302,1,3,1,1,0,443,443,442,442
Yuba,59,2023-01-31,28,28,28,0,627,635,634,1,3,0,0,1,122,122,122,122
Alameda,60,2023-02-07,1151,1166,1166,0,18213,18444,18443,1,85,4,4,8,2189,2189,2185,2185
Amador,60,2023-02-07,22,22,22,0,509,517,516,1,1,0,0,0,98,98,98,98
Butte,60,2023-02-07,99,99,99,0,1294,1311,1310,1,21,0,0,1,488,488,488,488
Calaveras,60,2023-02-07,15,15,15,0,333,339,338,1,0,0,0,0,140,140,140,140
Colusa,60,2023-02-07,6,6,6,0,183,186,185,1,0,0,0,0,22,22,22,22
Contra Costa,60,2023-02-07,709,718,718,0,11621,11768,11767,1,46,3,3,8,1552,1552,1549,1549
Del Norte,60,2023-02-07,51,51,51,0,348,354,353,1,0,0,0,0,59,59,59,59
El Dorado,60,2023-02-07,63,63,63,0,1063,1076,1075,1,2,0,0,0,244,244,244,244
Fresno,60,2023-02-07,515,522,522,0,8951,9065,9064,1,87,4,4,16,2994,2994,2990,2990
Glenn,60,2023-02-07,10,10,10,0,171,173,172,1,0,0,0,0,53,53,53,53
Humboldt,60,2023-02-07,55,55,55,0,581,590,589,1,5,1,1,1,170,170,169,169
Imperial,60,2023-02-07,136,136,136,0,2018,2045,2044,1,7,1,1,0,980,980,979,979
Inyo,60,2023-02-07,10,10,10,0,200,204,203,1,0,0,0,0,63,63,63,63
Kern,60,2023-02-07,323,327,327,0,8415,8522,8521,1,26,1,1,4,2480,2480,2479,2479
Kings,60,2023-02-07,119,119,119,0,1920,1945,1944,1,4,0,0,0,482,482,482,482
Lake,60,2023-02-07,28,28,28,0,595,604,603,1,4,1,1,0,160,160,159,159
Lassen,60,2023-02-07,6,6,6,0,362,368,367,1,0,0,0,0,64,64,64,64
Los Angeles,60,2023-02-07,5799,5873,5873,0,138663,140417,140415,2,697,84,91,76,35410,35458,35326,35367
Madera,60,2023-02-07,59,59,59,0,1233,1249,1248,1,5,1,1,0,376,376,375,375
Marin,60,2023-02-07,141,141,141,0,2009,2035,2034,1,9,0,0,2,317,317,317,317
Mariposa,60,2023-02-07,2,2,2,0,106,107,106,1,0,0,0,0,31,31,31,31
Mendocino,60,2023-02-07,32,32,32,0,527,534,533,1,7,1,1,1,143,143,142,142
Merced,60,2023-02-07,169,169,169,0,1874,1899,1898,1,13,0,0,0,903,903,903,903
Modoc,60,2023-02-07,1,1,1,0,5,6,5,1,0,0,0,0,9,9,9,9
Mono,60,2023-02-07,2,2,2,0,79,80,79,1,0,0,0,0,8,8,8,8
Monterey,60,2023-02-07,239,240,240,0,2876,2913,2912,1,22,2,2,2,800,800,798,798
Napa,60,2023-02-07,112,112,112,0,1388,1407,1406,1,4,0,0,2,162,162,162,162
Nevada,60,2023-02-07,30,30,30,0,572,580,579,1,5,0,0,0,136,136,136,136
Orange,60,2023-02-07,1321,1337,1337,0,22011,22290,22289,1,153,20,21,18,7966,7967,7946,7946
Placer,60,2023-02-07,153,153,153,0,2646,2681,2680,1,54,0,0,3,681,681,681,681
Plumas,60,2023-02-07,2,2,2,0,73,74,73,1,0,0,0,0,15,15,15,15
Riverside,60,2023-02-07,1101,1116,1116,0,15426,15621,15620,1,88,4,4,9,6808,6808,6804,6804
Sacramento,60,2023-02-07,743,752,752,0,13158,13324,13323,1,98,4,4,17,3522,3522,3518,3518
San Benito,60,2023-02-07,54,54,54,0,552,560,559,1,1,0,0,0,110,110,110,110
San Bernardino,60,2023-02-07,1075,1089,1089,0,17186,17405,17404,1,136,0,0,21,8133,8133,8133,8133
San Diego,60,2023-02-07,1925,1949,1949,0,30247,30632,30631,1,239,7,7,18,5787,5787,5780,5780
San Francisco,60,2023-02-07,563,570,570,0,10473,10605,10604,1,55,4,4,2,1173,1173,1169,1169
San Joaquin,60,2023-02-07,450,457,457,0,6764,6850,6849,1,47,0,0,3,2421,2421,2421,2421
San Luis Obispo,60,2023-02-07,153,153,153,0,1856,1880,1879,1,8,1,1,0,563,563,562,562
San Mateo,60,2023-02-07,536,543,543,0,8112,8216,8215,1,40,0,0,4,740,740,740,740
Santa Barbara,60,2023-02-07,239,241,241,0,4228,4282,4281,1,23,0,0,1,759,759,759,759
Santa Clara,60,2023-02-07,1302,1318,1318,0,22855,23145,23144,1,125,7,7,24,2695,2695,2688,2688
Santa Cruz,60,2023-02-07,233,235,235,0,10587,10723,10722,1,12,0,0,3,276,276,276,276
Shasta,60,2023-02-07,23,23,23,0,664,674,673,1,5,0,0,0,600,600,600,600
Siskiyou,60,2023-02-07,12,12,12,0,215,217,216,1,0,0,0,0,95,95,95,95
Solano,60,2023-02-07,296,301,301,0,3851,3902,3901,1,40,0,0,4,474,474,474,474
Sonoma,60,2023-02-07,259,261,261,0,3560,3606,3605,1,15,2,2,2,555,555,553,553
Stanislaus,60,2023-02-07,279,283,283,0,3925,3975,3974,1,43,2,2,6,1842,1842,1840,1840
Sutter,60,2023-02-07,52,52,52,0,676,686,685,1,0,0,0,0,236,236,236,236
Tehama,60,2023-02-07,16,16,16,0,342,348,347,1,1,0,0,0,231,231,231,231
Trinity,60,2023-02-07,1,1,1,0,19,20,19,1,0,0,0,0,23,23,23,23
Tulare,60,2023-02-07,269,273,273,0,4390,4446,4445,1,26,2,2,4,1579,1579,1577,1577
Tuolumne,60,2023-02-07,45,45,45,0,508,516,515,1,2,0,0,0,211,211,211,211
Ventura,60,2023-02-07,341,346,346,0,6848,6936,6935,1,41,2,2,5,1671,1671,1669,1669
Yolo,60,2023-02-07,89,89,89,0,1308,1325,1324,1,4,1,1,2,444,444,443,443
Yuba,60,2023-02-07,28,28,28,0,637,647,646,1,4,0,0,1,122,122,122,122
Alameda,61,2023-02-14,1079,1094,1094,0,17557,17809,17808,1,91,3,3,8,2192,2192,2189,2189
Amador,61,2023-02-14,23,23,23,0,503,511,510,1,0,0,0,0,98,98,98,98
Butte,61,2023-02-14,73,73,73,0,1203,1222,1221,1,21,1,1,2,489,489,488,488
Calaveras,61,2023-02-14,11,11,11,0,291,297,296,1,1,0,0,0,140,140,140,140
Colusa,61,2023-02-14,7,7,7,0,140,142,141,1,1,0,0,0,22,22,22,22
Contra Costa,61,2023-02-14,692,703,703,0,11379,11543,11542,1,41,1,1,7,1553,1553,1552,1552
Del Norte,61,2023-02-14,18,18,18,0,291,298,297,1,2,0,0,0,59,59,59,59
El Dorado,61,2023-02-14,63,63,63,0,1065,1081,1080,1,1,0,0,0,244,244,244,244
Fresno,61,2023-02-14,466,473,473,0,8574,8698,8697,1,110,3,3,4,2997,2997,2994,2994
Glenn,61,2023-02-14,10,10,10,0,172,174,173,1,8,0,0,0,53,53,53,53
Humboldt,61,2023-02-14,36,36,36,0,589,599,598,1,6,0,0,1,170,170,170,170
Imperial,61,2023-02-14,125,125,125,0,1771,1798,1797,1,7,0,0,0,980,980,980,980
Inyo,61,2023-02-14,6,6,6,0,205,209,208,1,0,0,0,0,63,63,63,63
Kern,61,2023-02-14,345,351,351,0,8143,8260,8259,1,40,1,1,5,2481,2481,2480,2480
Kings,61,2023-02-14,91,91,91,0,1863,1891,1890,1,4,1,1,0,483,483,482,482
Lake,61,2023-02-14,20,20,20,0,543,551,550,1,2,1,1,0,161,161,160,160
Lassen,61,2023-02-14,5,5,5,0,328,336,335,1,0,0,0,0,64,64,64,64
Los Angeles,61,2023-02-14,5884,5969,5969,0,129104,130968,130967,1,616,77,87,73,35487,35545,35410,35458
Madera,61,2023-02-14,60,60,60,0,1230,1248,1247,1,8,0,0,2,376,376,376,376
Marin,61,2023-02-14,135,135,135,0,1879,1908,1907,1,19,0,0,2,317,317,317,317
Mariposa,61,2023-02-14,5,5,5,0,108,109,108,1,0,0,0,0,31,31,31,31
Mendocino,61,2023-02-14,24,24,24,0,535,544,543,1,3,1,1,1,144,144,143,143
Merced,61,2023-02-14,166,167,167,0,1816,1843,1842,1,6,0,0,1,903,903,903,903
Modoc,61,2023-02-14,0,0,0,0,4,5,4,1,0,0,0,0,9,9,9,9
Mono,61,2023-02-14,1,1,1,0,67,68,67,1,0,0,0,0,8,8,8,8
Monterey,61,2023-02-14,204,205,205,0,2485,2523,2522,1,16,2,2,1,802,802,800,800
Napa,61,2023-02-14,96,96,96,0,1316,1337,1336,1,2,1,1,0,163,163,162,162
Nevada,61,2023-02-14,39,39,39,0,622,632,631,1,5,0,0,1,136,136,136,136
Orange,61,2023-02-14,1370,1390,1390,0,20347,20640,20639,1,154,13,13,26,7979,7980,7966,7967
Placer,61,2023-02-14,169,169,169,0,2636,2674,2673,1,41,0,0,5,681,681,681,681
Plumas,61,2023-02-14,3,3,3,0,83,84,83,1,0,0,0,0,15,15,15,15
Riverside,61,2023-02-14,1086,1102,1102,0,15795,16022,16021,1,96,6,6,12,6814,6814,6808,6808
Sacramento,61,2023-02-14,812,824,824,0,12913,13101,13100,1,115,6,6,19,3528,3528,3522,3522
San Benito,61,2023-02-14,39,39,39,0,555,564,563,1,2,0,0,0,110,110,110,110
San Bernardino,61,2023-02-14,995,1009,1009,0,16653,16895,16894,1,127,0,0,21,8133,8133,8133,8133
San Diego,61,2023-02-14,1937,1965,1965,0,28819,29235,29234,1,212,4,4,30,5791,5791,5787,5787
San Francisco,61,2023-02-14,610,618,618,0,10660,10813,10812,1,58,2,2,6,1175,1175,1173,1173
San Joaquin,61,2023-02-14,454,460,460,0,6990,7091,7090,1,41,1,1,4,2422,2422,2421,2421
San Luis Obispo,61,2023-02-14,135,135,135,0,1623,1648,1647,1,11,0,0,1,563,563,563,563
San Mateo,61,2023-02-14,512,520,520,0,8200,8321,8320,1,36,0,0,4,740,740,740,740
Santa Barbara,61,2023-02-14,194,195,195,0,3919,3977,3976,1,18,1,1,3,760,760,759,759
Santa Clara,61,2023-02-14,1368,1388,1388,0,22714,23042,23041,1,110,10,10,24,2705,2705,2695,2695
Santa Cruz,61,2023-02-14,211,212,212,0,9373,9509,9508,1,16,0,0,0,276,276,276,276
Shasta,61,2023-02-14,33,33,33,0,682,693,692,1,8,0,0,0,600,600,600,600
Siskiyou,61,2023-02-14,10,10,10,0,203,205,204,1,0,0,0,0,95,95,95,95
Solano,61,2023-02-14,253,258,258,0,3680,3734,3733,1,29,0,0,3,474,474,474,474
Sonoma,61,2023-02-14,233,236,236,0,3373,3422,3421,1,36,1,1,1,556,556,555,555
Stanislaus,61,2023-02-14,272,277,277,0,3699,3754,3753,1,50,0,0,8,1842,1842,1842,1842
Sutter,61,2023-02-14,48,48,48,0,596,604,603,1,0,1,1,0,237,237,236,236
Tehama,61,2023-02-14,14,14,14,0,280,286,285,1,1,2,2,0,233,233,231,231
Trinity,61,2023-02-14,1,1,1,0,28,29,28,1,0,0,0,0,23,23,23,23
Tulare,61,2023-02-14,242,246,246,0,4104,4165,4164,1,29,2,2,0,1581,1581,1579,1579
Tuolumne,61,2023-02-14,37,37,37,0,504,513,512,1,3,0,0,0,211,211,211,211
Ventura,61,2023-02-14,300,305,305,0,6606,6703,6702,1,37,2,2,7,1673,1673,1671,1671
Yolo,61,2023-02-14,69,69,69,0,1175,1193,1192,1,1,1,1,0,445,445,444,444
Yuba,61,2023-02-14,26,26,26,0,598,607,606,1,6,0,0,0,122,122,122,122
Alameda,62,2023-02-21,1070,1088,1088,0,16432,16707,16706,1,75,4,4,5,2196,2196,2192,2192
Amador,62,2023-02-21,24,24,24,0,524,533,532,1,1,0,0,1,98,98,98,98
Butte,62,2023-02-21,42,42,42,0,1047,1065,1064,1,9,2,2,1,491,491,489,489
Calaveras,62,2023-02-21,21,21,21,0,298,304,303,1,1,0,0,0,140,140,140,140
Colusa,62,2023-02-21,14,14,14,0,91,92,91,1,0,0,0,0,22,22,22,22
Contra Costa,62,2023-02-21,681,691,691,0,10728,10905,10904,1,52,5,5,10,1558,1558,1553,1553
Del Norte,62,2023-02-21,10,10,10,0,277,283,282,1,2,0,0,0,59,59,59,59
El Dorado,62,2023-02-21,47,47,47,0,1012,1029,1028,1,0,1,1,1,245,245,244,244
Fresno,62,2023-02-21,479,487,487,0,8564,8707,8706,1,95,5,6,19,3002,3003,2997,2997
Glenn,62,2023-02-21,6,6,6,0,150,152,151,1,5,0,0,0,53,53,53,53
Humboldt,62,2023-02-21,31,31,31,0,549,558,557,1,3,0,0,0,170,170,170,170
Imperial,62,2023-02-21,136,136,136,0,1830,1862,1861,1,10,0,0,0,980,980,980,980
Inyo,62,2023-02-21,6,6,6,0,137,139,138,1,0,0,0,0,63,63,63,63
Kern,62,2023-02-21,406,414,414,0,7792,7924,7923,1,38,4,4,5,2485,2485,2481,2481
Kings,62,2023-02-21,73,73,73,0,1682,1711,1710,1,6,1,1,0,484,484,483,483
Lake,62,2023-02-21,17,17,17,0,478,487,486,1,2,0,0,1,161,161,161,161
Lassen,62,2023-02-21,2,2,2,0,372,380,379,1,0,0,0,0,64,64,64,64
Los Angeles,62,2023-02-21,5771,5867,5867,0,123558,125620,125619,1,624,67,79,74,35554,35624,35487,35545
Madera,62,2023-02-21,70,70,70,0,1158,1178,1177,1,5,0,0,2,376,376,376,376
Marin,62,2023-02-21,157,157,157,0,1837,1867,1866,1,13,0,0,3,317,317,317,317
Mariposa,62,2023-02-21,7,7,7,0,121,122,121,1,0,0,0,0,31,31,31,31
Mendocino,62,2023-02-21,25,25,25,0,489,498,497,1,8,0,0,0,144,144,144,144
Merced,62,2023-02-21,115,115,115,0,1849,1881,1880,1,19,0,0,1,903,903,903,903
Modoc,62,2023-02-21,1,1,1,0,14,15,14,1,0,0,0,0,9,9,9,9
Mono,62,2023-02-21,4,4,4,0,57,58,57,1,0,0,0,0,8,8,8,8
Monterey,62,2023-02-21,171,173,173,0,2392,2432,2431,1,28,1,1,0,803,803,802,802
Napa,62,2023-02-21,72,72,72,0,1166,1188,1187,1,6,3,3,0,166,166,163,163
Nevada,62,2023-02-21,29,29,29,0,634,646,645,1,5,1,1,1,137,137,136,136
Orange,62,2023-02-21,1343,1365,1365,0,19465,19789,19788,1,162,14,15,20,7993,7995,7979,7980
Placer,62,2023-02-21,159,159,159,0,2319,2357,2356,1,44,1,1,4,682,682,681,681
Plumas,62,2023-02-21,10,10,10,0,85,86,85,1,1,0,0,0,15,15,15,15
Riverside,62,2023-02-21,988,1005,1005,0,15803,16065,16064,1,86,7,7,10,6821,6821,6814,6814
Sacramento,62,2023-02-21,764,777,777,0,11803,12000,11999,1,106,12,12,13,3540,3540,3528,3528
San Benito,62,2023-02-21,29,29,29,0,478,487,486,1,1,2,2,0,112,112,110,110
San Bernardino,62,2023-02-21,940,955,955,0,15604,15865,15864,1,119,0,0,20,8133,8133,8133,8133
San Diego,62,2023-02-21,1822,1853,1853,0,25698,26128,26127,1,257,7,7,20,5798,5798,5791,5791
San Francisco,62,2023-02-21,623,632,632,0,10310,10482,10481,1,83,1,1,6,1176,1176,1175,1175
San Joaquin,62,2023-02-21,418,425,425,0,7897,8029,8028,1,43,1,1,3,2423,2423,2422,2422
San Luis Obispo,62,2023-02-21,85,85,85,0,1542,1568,1567,1,12,0,0,0,563,563,563,563
San Mateo,62,2023-02-21,477,485,485,0,7350,7474,7473,1,47,0,0,1,740,740,740,740
Santa Barbara,62,2023-02-21,212,216,216,0,3600,3660,3659,1,18,0,0,3,760,760,760,760
Santa Clara,62,2023-02-21,1272,1292,1292,0,19763,20091,20090,1,108,12,13,32,2717,2718,2705,2705
Santa Cruz,62,2023-02-21,166,167,167,0,6240,6345,6344,1,20,0,0,2,276,276,276,276
Shasta,62,2023-02-21,18,18,18,0,703,716,715,1,3,0,0,0,600,600,600,600
Siskiyou,62,2023-02-21,12,12,12,0,196,201,200,1,0,0,0,0,95,95,95,95
Solano,62,2023-02-21,255,259,259,0,3481,3540,3539,1,26,0,0,1,474,474,474,474
Sonoma,62,2023-02-21,264,269,269,0,3297,3351,3350,1,28,1,1,3,557,557,556,556
Stanislaus,62,2023-02-21,268,273,273,0,3728,3791,3790,1,64,0,0,4,1842,1842,1842,1842
Sutter,62,2023-02-21,38,38,38,0,531,542,541,1,0,1,1,0,238,238,237,237
Tehama,62,2023-02-21,14,14,14,0,290,297,296,1,0,0,0,0,233,233,233,233
Trinity,62,2023-02-21,0,0,0,0,25,26,25,1,0,0,0,0,23,23,23,23
Tulare,62,2023-02-21,227,231,231,0,4068,4136,4135,1,21,0,0,2,1581,1581,1581,1581
Tuolumne,62,2023-02-21,29,29,29,0,499,508,507,1,0,0,0,0,211,211,211,211
Ventura,62,2023-02-21,302,308,308,0,5732,5829,5828,1,34,4,4,8,1677,1677,1673,1673
Yolo,62,2023-02-21,92,92,92,0,1343,1367,1366,1,2,1,1,1,446,446,445,445
Yuba,62,2023-02-21,26,26,26,0,525,535,534,1,3,0,0,1,122,122,122,122
Alameda,63,2023-02-28,1028,1048,1048,0,17636,17989,17988,1,76,4,5,14,2200,2201,2196,2196
Amador,63,2023-02-28,14,14,14,0,487,498,497,1,2,0,0,0,98,98,98,98
Butte,63,2023-02-28,53,53,53,0,812,829,828,1,10,1,1,1,492,492,491,491
Calaveras,63,2023-02-28,11,11,11,0,286,294,293,1,1,0,0,0,140,140,140,140
Colusa,63,2023-02-28,11,11,11,0,78,79,78,1,0,0,0,0,22,22,22,22
Contra Costa,63,2023-02-28,692,705,705,0,10666,10877,10876,1,57,3,3,8,1561,1561,1558,1558
Del Norte,63,2023-02-28,8,8,8,0,274,280,279,1,0,0,0,0,59,59,59,59
El Dorado,63,2023-02-28,60,60,60,0,1002,1022,1021,1,2,1,1,0,246,246,245,245
Fresno,63,2023-02-28,430,437,437,0,8556,8728,8727,1,99,3,3,6,3005,3006,3002,3003
Glenn,63,2023-02-28,3,3,3,0,143,146,145,1,1,0,0,0,53,53,53,53
Humboldt,63,2023-02-28,26,26,26,0,489,501,500,1,2,0,0,0,170,170,170,170
Imperial,63,2023-02-28,180,184,184,0,1774,1809,1808,1,11,0,0,1,980,980,980,980
Inyo,63,2023-02-28,3,3,3,0,177,181,180,1,0,0,0,0,63,63,63,63
Kern,63,2023-02-28,425,434,434,0,7936,8096,8095,1,38,2,2,9,2487,2487,2485,2485
Kings,63,2023-02-28,53,53,53,0,1642,1676,1675,1,4,0,0,0,484,484,484,484
Lake,63,2023-02-28,20,20,20,0,473,484,483,1,2,1,1,0,162,162,161,161
Lassen,63,2023-02-28,3,3,3,0,322,331,330,1,0,0,0,0,64,64,64,64
Los Angeles,63,2023-02-28,5145,5248,5248,0,128267,130820,130819,1,553,69,85,80,35623,35709,35554,35624
Madera,63,2023-02-28,50,50,50,0,1108,1130,1129,1,6,0,0,1,376,376,376,376
Marin,63,2023-02-28,153,156,156,0,1957,1998,1997,1,15,0,0,1,317,317,317,317
Mariposa,63,2023-02-28,4,4,4,0,85,86,85,1,0,0,0,0,31,31,31,31
Mendocino,63,2023-02-28,21,21,21,0,474,483,482,1,4,1,1,2,145,145,144,144
Merced,63,2023-02-28,131,132,132,0,1824,1862,1861,1,14,0,0,2,903,903,903,903
Modoc,63,2023-02-28,1,1,1,0,7,8,7,1,0,0,0,0,9,9,9,9
Mono,63,2023-02-28,3,3,3,0,60,61,60,1,0,0,0,0,8,8,8,8
Monterey,63,2023-02-28,165,167,167,0,2472,2522,2521,1,29,3,3,1,806,806,803,803
Napa,63,2023-02-28,68,68,68,0,1235,1260,1259,1,9,0,0,3,166,166,166,166
Nevada,63,2023-02-28,21,21,21,0,511,522,521,1,2,0,0,0,137,137,137,137
Orange,63,2023-02-28,1133,1155,1155,0,19270,19654,19653,1,158,19,23,22,8012,8018,7993,7995
Placer,63,2023-02-28,173,175,175,0,2607,2659,2658,1,39,0,0,7,682,682,682,682
Plumas,63,2023-02-28,1,1,1,0,72,73,72,1,0,0,0,0,15,15,15,15
Riverside,63,2023-02-28,894,912,912,0,14685,14977,14976,1,85,6,6,14,6827,6827,6821,6821
Sacramento,63,2023-02-28,918,936,936,0,12590,12844,12843,1,114,5,6,16,3545,3546,3540,3540
San Benito,63,2023-02-28,25,25,25,0,462,472,471,1,3,0,0,0,112,112,112,112
San Bernardino,63,2023-02-28,803,819,819,0,15889,16208,16207,1,112,0,0,22,8133,8133,8133,8133
San Diego,63,2023-02-28,1701,1735,1735,0,26975,27514,27513,1,242,6,7,22,5804,5805,5798,5798
San Francisco,63,2023-02-28,640,652,652,0,11406,11633,11632,1,75,6,6,8,1182,1182,1176,1176
San Joaquin,63,2023-02-28,395,403,403,0,7063,7205,7204,1,46,2,2,1,2425,2425,2423,2423
San Luis Obispo,63,2023-02-28,87,87,87,0,1535,1566,1565,1,12,3,3,0,566,566,563,563
San Mateo,63,2023-02-28,468,478,478,0,7393,7542,7541,1,34,0,0,5,740,740,740,740
Santa Barbara,63,2023-02-28,152,155,155,0,3554,3626,3625,1,22,3,3,4,763,763,760,760
Santa Clara,63,2023-02-28,1259,1284,1284,0,22046,22488,22487,1,120,6,6,31,2723,2724,2717,2718
Santa Cruz,63,2023-02-28,120,120,120,0,8475,8645,8644,1,15,0,0,1,276,276,276,276
Shasta,63,2023-02-28,37,37,37,0,676,691,690,1,8,0,0,1,600,600,600,600
Siskiyou,63,2023-02-28,11,11,11,0,232,239,238,1,0,0,0,0,95,95,95,95
Solano,63,2023-02-28,258,263,263,0,3416,3484,3483,1,27,0,0,8,474,474,474,474
Sonoma,63,2023-02-28,217,222,222,0,3299,3367,3366,1,34,1,1,4,558,558,557,557
Stanislaus,63,2023-02-28,243,248,248,0,3754,3830,3829,1,55,0,0,3,1842,1842,1842,1842
Sutter,63,2023-02-28,49,49,49,0,515,526,525,1,0,0,0,0,238,238,238,238
Tehama,63,2023-02-28,14,14,14,0,262,268,267,1,3,0,0,1,233,233,233,233
Trinity,63,2023-02-28,2,2,2,0,24,25,24,1,0,0,0,0,23,23,23,23
Tulare,63,2023-02-28,210,214,214,0,3729,3805,3804,1,25,3,3,2,1584,1584,1581,1581
Tuolumne,63,2023-02-28,50,50,50,0,417,427,426,1,0,0,0,1,211,211,211,211
Ventura,63,2023-02-28,257,263,263,0,5675,5790,5789,1,37,3,3,8,1680,1680,1677,1677
Yolo,63,2023-02-28,86,86,86,0,1363,1391,1390,1,2,1,1,1,447,447,446,446
Yuba,63,2023-02-28,45,45,45,0,508,518,517,1,1,0,0,0,122,122,122,122
Alameda,64,2023-03-07,908,930,930,0,16440,16858,16857,1,88,2,2,11,2202,2203,2200,2201
Amador,64,2023-03-07,16,16,16,0,451,463,462,1,0,0,0,1,98,98,98,98
Butte,64,2023-03-07,39,39,39,0,590,607,606,1,4,1,1,0,493,493,492,492
Calaveras,64,2023-03-07,24,24,24,0,276,284,283,1,0,2,3,0,142,143,140,140
Colusa,64,2023-03-07,13,13,13,0,153,157,156,1,0,0,0,0,22,22,22,22
Contra Costa,64,2023-03-07,678,696,696,0,10076,10332,10331,1,57,3,3,8,1564,1564,1561,1561
Del Norte,64,2023-03-07,4,4,4,0,250,258,257,1,0,1,2,0,60,61,59,59
El Dorado,64,2023-03-07,54,54,54,0,949,974,973,1,2,0,0,0,246,246,246,246
Fresno,64,2023-03-07,395,404,404,0,8231,8441,8440,1,74,4,6,17,3009,3012,3005,3006
Glenn,64,2023-03-07,4,4,4,0,161,164,163,1,0,0,0,0,53,53,53,53
Humboldt,64,2023-03-07,21,21,21,0,485,499,498,1,4,0,0,1,170,170,170,170
Imperial,64,2023-03-07,176,179,179,0,1768,1814,1813,1,1,0,0,7,980,980,980,980
Inyo,64,2023-03-07,2,2,2,0,144,149,148,1,1,0,0,0,63,63,63,63
Kern,64,2023-03-07,284,290,290,0,7675,7872,7871,1,38,1,2,5,2488,2489,2487,2487
Kings,64,2023-03-07,71,71,71,0,1524,1564,1563,1,1,0,0,0,484,484,484,484
Lake,64,2023-03-07,21,21,21,0,465,477,476,1,1,0,0,1,162,162,162,162
Lassen,64,2023-03-07,5,5,5,0,309,318,317,1,0,0,0,0,64,64,64,64
Los Angeles,64,2023-03-07,4273,4382,4382,0,123205,126342,126341,1,583,51,73,62,35674,35782,35623,35709
Madera,64,2023-03-07,81,81,81,0,1180,1209,1208,1,4,0,0,1,376,376,376,376
Marin,64,2023-03-07,125,126,126,0,1729,1773,1772,1,22,0,0,2,317,317,317,317
Mariposa,64,2023-03-07,1,1,1,0,71,72,71,1,0,0,0,0,31,31,31,31
Mendocino,64,2023-03-07,25,25,25,0,454,466,465,1,6,0,0,0,145,145,145,145
Merced,64,2023-03-07,138,141,141,0,1656,1699,1698,1,6,0,0,1,903,903,903,903
Modoc,64,2023-03-07,2,2,2,0,11,12,11,1,0,0,0,0,9,9,9,9
Mono,64,2023-03-07,5,5,5,0,57,58,57,1,0,0,0,0,8,8,8,8
Monterey,64,2023-03-07,136,140,140,0,2052,2106,2105,1,31,1,2,1,807,808,806,806
Napa,64,2023-03-07,53,53,53,0,1038,1066,1065,1,6,1,1,3,167,167,166,166
Nevada,64,2023-03-07,19,19,19,0,464,477,476,1,4,0,0,0,137,137,137,137
Orange,64,2023-03-07,915,939,939,0,18856,19339,19338,1,123,15,21,22,8027,8039,8012,8018
Placer,64,2023-03-07,175,181,181,0,2413,2475,2474,1,62,0,0,8,682,682,682,682
Plumas,64,2023-03-07,1,1,1,0,66,67,66,1,0,0,0,0,15,15,15,15
Riverside,64,2023-03-07,892,914,914,0,14264,14624,14623,1,85,4,5,9,6831,6832,6827,6827
Sacramento,64,2023-03-07,821,842,842,0,11576,11871,11870,1,120,4,5,6,3549,3551,3545,3546
San Benito,64,2023-03-07,14,14,14,0,443,455,454,1,1,0,0,0,112,112,112,112
San Bernardino,64,2023-03-07,748,766,766,0,14800,15177,15176,1,118,0,0,20,8133,8133,8133,8133
San Diego,64,2023-03-07,1375,1410,1410,0,24903,25540,25539,1,212,12,17,15,5816,5822,5804,5805
San Francisco,64,2023-03-07,601,616,616,0,10519,10786,10785,1,71,4,6,10,1186,1188,1182,1182
San Joaquin,64,2023-03-07,393,403,403,0,6852,7026,7025,1,49,1,2,6,2426,2427,2425,2425
San Luis Obispo,64,2023-03-07,85,86,86,0,1299,1332,1331,1,7,3,3,0,569,569,566,566
San Mateo,64,2023-03-07,405,415,415,0,7123,7305,7304,1,27,0,0,3,740,740,740,740
Santa Barbara,64,2023-03-07,151,155,155,0,3684,3780,3779,1,14,1,1,1,764,764,763,763
Santa Clara,64,2023-03-07,1062,1089,1089,0,20387,20907,20906,1,126,4,6,27,2727,2730,2723,2724
Santa Cruz,64,2023-03-07,132,135,135,0,4333,4444,4443,1,19,0,0,0,276,276,276,276
Shasta,64,2023-03-07,24,24,24,0,601,616,615,1,4,0,0,2,600,600,600,600
Siskiyou,64,2023-03-07,5,5,5,0,213,221,220,1,1,0,0,0,95,95,95,95
Solano,64,2023-03-07,262,268,268,0,3370,3457,3456,1,40,0,0,4,474,474,474,474
Sonoma,64,2023-03-07,208,214,214,0,3199,3281,3280,1,24,2,3,3,560,561,558,558
Stanislaus,64,2023-03-07,247,254,254,0,3457,3546,3545,1,60,0,0,10,1842,1842,1842,1842
Sutter,64,2023-03-07,26,26,26,0,569,584,583,1,0,0,0,0,238,238,238,238
Tehama,64,2023-03-07,12,12,12,0,240,247,246,1,5,0,0,0,233,233,233,233
Trinity,64,2023-03-07,0,0,0,0,17,18,17,1,0,0,0,0,23,23,23,23
Tulare,64,2023-03-07,210,217,217,0,3108,3188,3187,1,30,0,0,3,1584,1584,1584,1584
Tuolumne,64,2023-03-07,33,33,33,0,394,405,404,1,0,0,0,0,211,211,211,211
Ventura,64,2023-03-07,247,253,253,0,4866,4991,4990,1,40,1,1,4,1681,1681,1680,1680
Yolo,64,2023-03-07,59,59,59,0,1169,1199,1198,1,2,0,0,1,447,447,447,447
Yuba,64,2023-03-07,30,30,30,0,500,514,513,1,7,0,0,0,122,122,122,122
Alameda,65,2023-03-14,851,881,881,0,15190,15733,15732,1,69,1,2,17,2203,2205,2202,2203
Amador,65,2023-03-14,11,11,11,0,384,400,399,1,4,0,0,1,98,98,98,98
Butte,65,2023-03-14,33,33,33,0,525,544,543,1,7,0,0,2,493,493,493,493
Calaveras,65,2023-03-14,7,7,7,0,230,239,238,1,0,0,0,0,142,143,142,143
Colusa,65,2023-03-14,4,4,4,0,165,171,170,1,0,1,2,0,23,24,22,22
Contra Costa,65,2023-03-14,563,582,582,0,9824,10175,10174,1,39,1,2,5,1565,1566,1564,1564
Del Norte,65,2023-03-14,9,9,9,0,252,262,261,1,2,0,0,0,60,61,60,61
El Dorado,65,2023-03-14,50,51,51,0,907,940,939,1,0,0,0,0,246,246,246,246
Fresno,65,2023-03-14,374,389,389,0,7687,7966,7965,1,86,0,0,10,3009,3012,3009,3012
Glenn,65,2023-03-14,9,9,9,0,136,140,139,1,0,0,0,0,53,53,53,53
Humboldt,65,2023-03-14,29,29,29,0,506,526,525,1,2,0,0,1,170,170,170,170
Imperial,65,2023-03-14,202,209,209,0,1922,1992,1991,1,10,0,0,5,980,980,980,980
Inyo,65,2023-03-14,0,0,0,0,262,272,271,1,0,0,0,0,63,63,63,63
Kern,65,2023-03-14,327,337,337,0,7602,7877,7876,1,44,0,0,11,2488,2489,2488,2489
Kings,65,2023-03-14,60,61,61,0,1489,1545,1544,1,0,0,0,0,484,484,484,484
Lake,65,2023-03-14,11,11,11,0,412,428,427,1,1,0,0,0,162,162,162,162
Lassen,65,2023-03-14,5,5,5,0,335,348,347,1,0,0,0,0,64,64,64,64
Los Angeles,65,2023-03-14,3734,3866,3866,0,117709,121925,121924,1,432,47,92,55,35721,35874,35674,35782
Madera,65,2023-03-14,52,52,52,0,1131,1170,1169,1,6,0,0,0,376,376,376,376
Marin,65,2023-03-14,97,101,101,0,1704,1766,1765,1,23,0,0,1,317,317,317,317
Mariposa,65,2023-03-14,4,4,4,0,90,94,93,1,0,0,0,0,31,31,31,31
Mendocino,65,2023-03-14,17,17,17,0,452,470,469,1,6,0,0,0,145,145,145,145
Merced,65,2023-03-14,97,100,100,0,1480,1534,1533,1,11,0,0,2,903,903,903,903
Modoc,65,2023-03-14,0,0,0,0,11,12,11,1,0,0,0,0,9,9,9,9
Mono,65,2023-03-14,1,1,1,0,45,47,46,1,0,0,0,0,8,8,8,8
Monterey,65,2023-03-14,73,74,74,0,1765,1829,1828,1,24,0,0,0,807,808,807,808
Napa,65,2023-03-14,51,51,51,0,941,975,974,1,5,1,2,1,168,169,167,167
Nevada,65,2023-03-14,19,19,19,0,470,487,486,1,4,0,0,0,137,137,137,137
Orange,65,2023-03-14,861,892,892,0,17689,18323,18322,1,127,21,41,23,8048,8080,8027,8039
Placer,65,2023-03-14,155,162,162,0,2150,2228,2227,1,67,0,0,8,682,682,682,682
Plumas,65,2023-03-14,5,5,5,0,62,64,63,1,0,0,0,0,15,15,15,15
Riverside,65,2023-03-14,831,861,861,0,14447,14961,14960,1,85,2,4,10,6833,6836,6831,6832
Sacramento,65,2023-03-14,677,701,701,0,10389,10764,10763,1,104,4,8,15,3553,3559,3549,3551
San Benito,65,2023-03-14,14,14,14,0,412,429,428,1,0,0,0,0,112,112,112,112
San Bernardino,65,2023-03-14,668,691,691,0,14550,15074,15073,1,95,0,0,27,8133,8133,8133,8133
San Diego,65,2023-03-14,1304,1351,1351,0,23458,24303,24302,1,161,5,10,16,5821,5832,5816,5822
San Francisco,65,2023-03-14,538,558,558,0,9192,9519,9518,1,66,3,6,15,1189,1194,1186,1188
San Joaquin,65,2023-03-14,342,355,355,0,6602,6839,6838,1,45,1,2,5,2427,2429,2426,2427
San Luis Obispo,65,2023-03-14,77,78,78,0,1291,1337,1336,1,8,0,0,0,569,569,569,569
San Mateo,65,2023-03-14,376,390,390,0,6810,7056,7055,1,27,0,0,6,740,740,740,740
Santa Barbara,65,2023-03-14,142,149,149,0,3149,3262,3261,1,13,0,0,1,764,764,764,764
Santa Clara,65,2023-03-14,1025,1062,1062,0,20073,20790,20789,1,143,0,0,20,2727,2730,2727,2730
Santa Cruz,65,2023-03-14,112,116,116,0,3064,3175,3174,1,15,0,0,0,276,276,276,276
Shasta,65,2023-03-14,23,23,23,0,614,637,636,1,7,0,0,1,600,600,600,600
Siskiyou,65,2023-03-14,11,11,11,0,169,177,176,1,0,0,0,0,95,95,95,95
Solano,65,2023-03-14,208,215,215,0,2983,3092,3091,1,28,0,0,5,474,474,474,474
Sonoma,65,2023-03-14,193,200,200,0,2750,2849,2848,1,36,1,2,5,561,563,560,561
Stanislaus,65,2023-03-14,183,190,190,0,3416,3540,3539,1,49,0,0,4,1842,1842,1842,1842
Sutter,65,2023-03-14,31,31,31,0,531,551,550,1,0,0,0,0,238,238,238,238
Tehama,65,2023-03-14,15,15,15,0,228,238,237,1,0,0,0,1,233,233,233,233
Trinity,65,2023-03-14,0,0,0,0,22,23,22,1,0,0,0,0,23,23,23,23
Tulare,65,2023-03-14,146,153,153,0,3201,3316,3315,1,32,3,6,2,1587,1590,1584,1584
Tuolumne,65,2023-03-14,11,11,11,0,370,384,383,1,2,0,0,0,211,211,211,211
Ventura,65,2023-03-14,202,209,209,0,4309,4465,4464,1,28,1,2,2,1682,1683,1681,1681
Yolo,65,2023-03-14,65,65,65,0,1065,1103,1102,1,1,0,0,0,447,447,447,447
Yuba,65,2023-03-14,28,28,28,0,455,473,472,1,6,0,0,0,122,122,122,122
Alameda,66,2023-03-21,703,751,751,0,14446,15419,15418,1,66,1,5,11,2204,2210,2203,2205
Amador,66,2023-03-21,17,17,17,0,384,413,412,1,4,0,0,0,98,98,98,98
Butte,66,2023-03-21,36,36,36,0,519,554,553,1,7,1,4,2,494,497,493,493
Calaveras,66,2023-03-21,10,10,10,0,238,254,253,1,0,0,0,0,142,143,142,143
Colusa,66,2023-03-21,4,4,4,0,156,166,165,1,1,0,0,0,23,24,23,24
Contra Costa,66,2023-03-21,423,452,452,0,9369,10002,10001,1,28,0,0,8,1565,1566,1565,1566
Del Norte,66,2023-03-21,1,1,1,0,201,215,214,1,0,0,0,1,60,61,60,61
El Dorado,66,2023-03-21,33,34,34,0,794,849,848,1,1,0,0,0,246,246,246,246
Fresno,66,2023-03-21,351,375,375,0,7651,8179,8178,1,72,0,0,14,3009,3012,3009,3012
Glenn,66,2023-03-21,4,4,4,0,131,143,142,1,0,0,0,0,53,53,53,53
Humboldt,66,2023-03-21,22,22,22,0,494,530,529,1,2,0,0,2,170,170,170,170
Imperial,66,2023-03-21,143,154,154,0,1645,1761,1760,1,9,0,0,1,980,980,980,980
Inyo,66,2023-03-21,14,14,14,0,260,279,278,1,0,0,0,0,63,63,63,63
Kern,66,2023-03-21,187,200,200,0,7377,7879,7878,1,30,1,3,5,2489,2492,2488,2489
Kings,66,2023-03-21,34,36,36,0,1360,1456,1455,1,0,1,3,0,485,487,484,484
Lake,66,2023-03-21,11,11,11,0,388,415,414,1,1,0,0,0,162,162,162,162
Lassen,66,2023-03-21,5,5,5,0,306,328,327,1,0,0,0,0,64,64,64,64
Los Angeles,66,2023-03-21,3023,3220,3220,0,105112,112195,112194,1,395,29,122,40,35750,35996,35721,35874
Madera,66,2023-03-21,46,48,48,0,1111,1187,1186,1,4,0,0,0,376,376,376,376
Marin,66,2023-03-21,91,98,98,0,1503,1605,1604,1,22,0,0,2,317,317,317,317
Mariposa,66,2023-03-21,2,2,2,0,85,91,90,1,0,0,0,0,31,31,31,31
Mendocino,66,2023-03-21,9,9,9,0,421,450,449,1,3,0,0,0,145,145,145,145
Merced,66,2023-03-21,105,113,113,0,1411,1506,1505,1,9,0,0,2,903,903,903,903
Modoc,66,2023-03-21,1,1,1,0,10,11,10,1,0,0,0,0,9,9,9,9
Mono,66,2023-03-21,4,4,4,0,49,54,53,1,0,0,0,0,8,8,8,8
Monterey,66,2023-03-21,50,52,52,0,1416,1514,1513,1,21,0,0,0,807,808,807,808
Napa,66,2023-03-21,33,34,34,0,883,944,943,1,3,0,0,0,168,169,168,169
Nevada,66,2023-03-21,19,20,20,0,449,481,480,1,3,0,0,0,137,137,137,137
Orange,66,2023-03-21,712,760,760,0,15801,16870,16869,1,107,2,6,22,8050,8086,8048,8080
Placer,66,2023-03-21,119,127,127,0,2060,2200,2199,1,54,0,0,8,682,682,682,682
Plumas,66,2023-03-21,1,1,1,0,57,61,60,1,0,0,0,0,15,15,15,15
Riverside,66,2023-03-21,540,577,577,0,11421,12179,12178,1,57,0,0,7,6833,6836,6833,6836
Sacramento,66,2023-03-21,448,478,478,0,9602,10262,10261,1,94,2,12,16,3555,3571,3553,3559
San Benito,66,2023-03-21,40,42,42,0,631,678,677,1,0,0,0,1,112,112,112,112
San Bernardino,66,2023-03-21,494,527,527,0,13375,14279,14278,1,71,0,0,16,8133,8133,8133,8133
San Diego,66,2023-03-21,1010,1075,1075,0,21332,22764,22763,1,139,8,38,9,5829,5870,5821,5832
San Francisco,66,2023-03-21,376,402,402,0,8257,8808,8807,1,60,0,0,7,1189,1194,1189,1194
San Joaquin,66,2023-03-21,255,271,271,0,5585,5959,5958,1,43,0,0,5,2427,2429,2427,2429
San Luis Obispo,66,2023-03-21,47,50,50,0,1171,1252,1251,1,9,0,0,0,569,569,569,569
San Mateo,66,2023-03-21,270,287,287,0,6104,6521,6520,1,26,0,0,3,740,740,740,740
Santa Barbara,66,2023-03-21,105,111,111,0,3286,3509,3508,1,14,1,3,0,765,767,764,764
Santa Clara,66,2023-03-21,745,795,795,0,16831,17996,17995,1,133,0,0,22,2727,2730,2727,2730
Santa Cruz,66,2023-03-21,126,137,137,0,3016,3224,3223,1,14,0,0,1,276,276,276,276
Shasta,66,2023-03-21,19,19,19,0,520,558,557,1,1,0,0,3,600,600,600,600
Siskiyou,66,2023-03-21,2,2,2,0,146,158,157,1,0,0,0,0,95,95,95,95
Solano,66,2023-03-21,183,195,195,0,2851,3046,3045,1,26,0,0,5,474,474,474,474
Sonoma,66,2023-03-21,172,183,183,0,2724,2905,2904,1,32,0,0,1,561,563,561,563
Stanislaus,66,2023-03-21,200,212,212,0,3147,3360,3359,1,44,0,0,4,1842,1842,1842,1842
Sutter,66,2023-03-21,37,37,37,0,476,510,509,1,0,0,0,0,238,238,238,238
Tehama,66,2023-03-21,13,13,13,0,196,210,209,1,1,0,0,0,233,233,233,233
Trinity,66,2023-03-21,0,0,0,0,16,17,16,1,0,0,0,0,23,23,23,23
Tulare,66,2023-03-21,106,113,113,0,2578,2754,2753,1,25,0,0,1,1587,1590,1587,1590
Tuolumne,66,2023-03-21,14,14,14,0,354,380,379,1,0,0,0,0,211,211,211,211
Ventura,66,2023-03-21,177,188,188,0,4062,4337,4336,1,32,0,0,2,1682,1683,1682,1683
Yolo,66,2023-03-21,63,67,67,0,1106,1184,1183,1,3,0,0,1,447,447,447,447
Yuba,66,2023-03-21,18,18,18,0,466,498,497,1,4,0,0,0,122,122,122,122
Alameda,67,2023-03-27,397,644,644,0,9096,13743,13742,1,91,0,0,9,2204,2210,2204,2210
Amador,67,2023-03-27,6,9,9,0,206,283,282,1,3,0,0,1,98,98,98,98
Butte,67,2023-03-27,19,26,26,0,283,446,445,1,8,1,11,0,495,508,494,497
Calaveras,67,2023-03-27,7,13,13,0,170,262,261,1,0,0,0,0,142,143,142,143
Colusa,67,2023-03-27,2,2,2,0,89,118,117,1,0,0,0,0,23,24,23,24
Contra Costa,67,2023-03-27,238,363,363,0,5931,8919,8918,1,33,0,0,6,1565,1566,1565,1566
Del Norte,67,2023-03-27,3,3,3,0,135,210,209,1,0,0,0,1,60,61,60,61
El Dorado,67,2023-03-27,25,45,45,0,490,744,743,1,2,0,0,0,246,246,246,246
Fresno,67,2023-03-27,160,251,251,0,4722,7199,7198,1,59,0,0,5,3009,3012,3009,3012
Glenn,67,2023-03-27,2,2,2,0,44,66,65,1,0,0,0,0,53,53,53,53
Humboldt,67,2023-03-27,5,6,6,0,296,469,468,1,5,0,0,1,170,170,170,170
Imperial,67,2023-03-27,88,147,147,0,1066,1649,1648,1,10,0,0,1,980,980,980,980
Inyo,67,2023-03-27,6,10,10,0,185,254,253,1,0,0,0,0,63,63,63,63
Kern,67,2023-03-27,107,145,145,0,3538,4685,4684,1,29,0,0,3,2489,2492,2489,2492
Kings,67,2023-03-27,26,42,42,0,758,1179,1178,1,2,0,0,1,485,487,485,487
Lake,67,2023-03-27,8,9,9,0,244,389,388,1,2,0,0,0,162,162,162,162
Lassen,67,2023-03-27,5,5,5,0,157,220,219,1,0,0,0,0,64,64,64,64
Los Angeles,67,2023-03-27,1113,1458,1458,0,47939,58232,58231,1,348,4,40,46,35754,36036,35750,35996
Madera,67,2023-03-27,15,19,19,0,583,842,841,1,5,0,0,0,376,376,376,376
Marin,67,2023-03-27,49,75,75,0,887,1349,1348,1,18,0,0,1,317,317,317,317
Mariposa,67,2023-03-27,0,0,0,0,45,63,62,1,0,0,0,0,31,31,31,31
Mendocino,67,2023-03-27,12,24,24,0,303,481,480,1,1,0,0,1,145,145,145,145
Merced,67,2023-03-27,46,62,62,0,760,1135,1134,1,6,0,0,2,903,903,903,903
Modoc,67,2023-03-27,0,0,0,0,4,5,4,1,0,0,0,0,9,9,9,9
Mono,67,2023-03-27,1,2,2,0,37,66,65,1,0,0,0,0,8,8,8,8
Monterey,67,2023-03-27,23,35,35,0,1177,1769,1768,1,19,0,0,0,807,808,807,808
Napa,67,2023-03-27,30,55,55,0,510,895,894,1,3,0,0,1,168,169,168,169
Nevada,67,2023-03-27,10,16,16,0,227,319,318,1,3,0,0,0,137,137,137,137
Orange,67,2023-03-27,443,681,681,0,10448,15767,15766,1,112,0,0,19,8050,8086,8050,8086
Placer,67,2023-03-27,74,117,117,0,1335,2059,2058,1,43,0,0,6,682,682,682,682
Plumas,67,2023-03-27,1,4,4,0,41,78,77,1,0,0,0,0,15,15,15,15
Riverside,67,2023-03-27,303,420,420,0,6814,9459,9458,1,41,1,11,6,6834,6847,6833,6836
Sacramento,67,2023-03-27,289,464,464,0,5812,8916,8915,1,79,1,9,11,3556,3580,3555,3571
San Benito,67,2023-03-27,17,28,28,0,509,930,929,1,1,0,0,0,112,112,112,112
San Bernardino,67,2023-03-27,224,332,332,0,6964,9630,9629,1,67,0,0,12,8133,8133,8133,8133
San Diego,67,2023-03-27,569,814,814,0,12757,18788,18787,1,137,0,0,7,5829,5870,5829,5870
San Francisco,67,2023-03-27,254,409,409,0,5704,8526,8525,1,45,0,0,5,1189,1194,1189,1194
San Joaquin,67,2023-03-27,168,266,266,0,3639,5400,5399,1,23,0,0,11,2427,2429,2427,2429
San Luis Obispo,67,2023-03-27,23,38,38,0,741,1140,1139,1,4,0,0,0,569,569,569,569
San Mateo,67,2023-03-27,168,274,274,0,3688,5494,5493,1,29,0,0,1,740,740,740,740
Santa Barbara,67,2023-03-27,53,76,76,0,2302,3528,3527,1,9,0,0,2,765,767,765,767
Santa Clara,67,2023-03-27,435,706,706,0,9746,14333,14332,1,100,0,0,14,2727,2730,2727,2730
Santa Cruz,67,2023-03-27,70,93,93,0,1858,2383,2382,1,8,0,0,1,276,276,276,276
Shasta,67,2023-03-27,7,8,8,0,234,309,308,1,2,0,0,3,600,600,600,600
Siskiyou,67,2023-03-27,0,0,0,0,102,160,159,1,0,0,0,0,95,95,95,95
Solano,67,2023-03-27,119,210,210,0,1752,2947,2946,1,23,0,0,4,474,474,474,474
Sonoma,67,2023-03-27,108,196,196,0,1665,2665,2664,1,29,0,0,4,561,563,561,563
Stanislaus,67,2023-03-27,97,185,185,0,1726,2710,2709,1,39,0,0,6,1842,1842,1842,1842
Sutter,67,2023-03-27,29,58,58,0,308,520,519,1,0,0,0,0,238,238,238,238
Tehama,67,2023-03-27,3,3,3,0,101,139,138,1,2,0,0,0,233,233,233,233
Trinity,67,2023-03-27,0,0,0,0,17,35,34,1,0,0,0,0,23,23,23,23
Tulare,67,2023-03-27,71,121,121,0,1548,2200,2199,1,25,0,0,1,1587,1590,1587,1590
Tuolumne,67,2023-03-27,5,6,6,0,217,329,328,1,1,0,0,0,211,211,211,211
Ventura,67,2023-03-27,97,163,163,0,2826,4300,4299,1,25,0,0,2,1682,1683,1682,1683
Yolo,67,2023-03-27,36,56,56,0,605,887,886,1,6,0,0,1,447,447,447,447
Yuba,67,2023-03-27,9,11,11,0,293,483,482,1,1,0,0,1,122,122,122,122
California,1,2021-12-21,103228,103228,59365,43863,2141731,2141783,1236635,905148,2652,501,501,937,77429,77429,76928,76928
California,2,2021-12-28,304055,304059,194284,109775,2104153,2104220,1308051,796169,3727,487,487,1032,77916,77916,77429,77429
California,3,2022-01-04,617537,617548,420610,196938,3287252,3287373,2227560,1059813,6642,641,641,1390,78557,78557,77916,77916
California,4,2022-01-11,845503,845521,609145,236376,4649612,4649796,3381779,1268017,10414,1014,1014,1903,79571,79571,78557,78557
California,5,2022-01-18,646410,646423,486416,160007,4017987,4018159,3082889,935270,12775,1495,1495,2404,81066,81066,79571,79571
California,6,2022-01-25,467612,467621,368099,99522,3751323,3751508,3027588,723920,12670,1804,1804,2609,82870,82870,81066,81066
California,7,2022-02-01,242816,242821,198741,44080,3048114,3048309,2566530,481779,10560,1933,1933,2435,84803,84803,82870,82870
California,8,2022-02-08,134585,134586,114074,20512,2615968,2616152,2285412,330740,8051,1738,1738,1958,86541,86541,84803,84803
California,9,2022-02-15,78585,78585,68843,9742,2286355,2286528,2057165,229363,6143,1330,1330,1502,87871,87871,86541,86541
California,10,2022-02-22,44469,44469,40006,4463,1899222,1899387,1746106,153281,4433,978,978,1054,88849,88849,87871,87871
California,11,2022-03-01,30242,30242,27841,2401,1982594,1982816,1858952,123864,3249,665,665,740,89514,89514,88849,88849
California,12,2022-03-08,21649,21649,20288,1361,1799549,1799765,1710377,89388,2336,471,471,536,89985,89985,89514,89514
California,13,2022-03-15,16304,16304,15495,809,1714056,1714295,1647631,66664,1827,335,335,400,90320,90320,89985,89985
California,14,2022-03-22,15038,15038,14464,574,1608907,1609210,1560043,49167,1475,243,243,299,90563,90563,90320,90320
California,15,2022-03-29,15157,15157,14711,446,1485814,1486160,1449997,36163,1145,176,176,246,90739,90739,90563,90563
California,16,2022-04-05,18335,18335,17925,410,1472005,1472448,1445124,27324,936,143,143,202,90882,90882,90739,90739
California,17,2022-04-12,22264,22266,21869,397,1286061,1286579,1266999,19580,884,113,113,156,90995,90995,90882,90882
California,18,2022-04-19,28638,28643,28246,397,1226618,1227247,1212399,14848,819,108,108,153,91103,91103,90995,90995
California,19,2022-04-26,38910,38918,38493,425,1650819,1651792,1637415,14377,877,91,91,131,91194,91194,91103,91103
California,20,2022-05-03,51359,51374,50938,436,1708361,1709530,1697773,11757,967,88,88,142,91282,91282,91194,91194
California,21,2022-05-10,65415,65444,64998,446,1779403,1780749,1771092,9657,1098,95,95,148,91377,91377,91282,91282
California,22,2022-05-17,84570,84623,84170,453,1847352,1848901,1840974,7927,1415,114,114,200,91491,91491,91377,91377
California,23,2022-05-24,99821,99899,99489,410,1873649,1875419,1869118,6301,1737,129,129,224,91620,91620,91491,91491
California,24,2022-05-31,96326,96406,96099,307,1599384,1601047,1596820,4227,2039,139,139,242,91759,91759,91620,91620
California,25,2022-06-07,115605,115711,115417,294,1791745,1793720,1790091,3629,2301,144,144,300,91903,91903,91759,91759
California,26,2022-06-14,103336,103433,103229,204,1306498,1308023,1305750,2273,2498,183,183,298,92086,92086,91903,91903
California,27,2022-06-21,103917,104019,103861,158,1031409,1032659,1031136,1523,2600,217,217,305,92303,92303,92086,92086
California,28,2022-06-28,117221,117342,117209,133,1024269,1025543,1024368,1175,3064,220,220,347,92523,92523,92303,92303
California,29,2022-07-05,114524,114647,114545,102,884081,885220,884424,796,3332,274,274,417,92797,92797,92523,92523
California,30,2022-07-12,136647,136807,136716,91,1032383,1033747,1033029,718,3888,313,313,490,93110,93110,92797,92797
California,31,2022-07-19,128509,128664,128596,68,990409,991771,991235,536,4247,301,301,543,93411,93411,93110,93110
California,32,2022-07-26,115119,115262,115218,44,934826,936181,935780,401,4300,364,364,543,93775,93775,93411,93411
California,33,2022-08-02,96187,96306,96275,31,864302,865606,865310,296,4062,347,347,543,94122,94122,93775,93775
California,34,2022-08-09,80498,80596,80579,17,817025,818307,818084,223,3609,339,339,491,94461,94461,94122,94122
California,35,2022-08-16,67784,67865,67854,11,790389,791675,791500,175,3317,298,298,462,94759,94759,94461,94461
California,36,2022-08-23,60041,60113,60108,5,780227,781535,781393,142,3065,270,270,416,95029,95029,94759,94759
California,37,2022-08-30,50033,50096,50094,2,769459,770779,770664,115,2732,231,231,363,95260,95260,95029,95029
California,38,2022-09-06,36922,36964,36964,0,662496,663667,663580,87,2602,242,242,381,95502,95502,95260,95260
California,39,2022-09-13,33609,33648,33648,0,711831,713130,713049,81,2360,216,216,329,95718,95718,95502,95502
California,40,2022-09-20,27133,27159,27159,0,683258,684568,684497,71,1909,177,177,275,95895,95895,95718,95718
California,41,2022-09-27,25268,25293,25293,0,633151,634431,634369,62,1756,171,171,243,96066,96066,95895,95895
California,42,2022-10-04,22924,22946,22946,0,572095,573311,573252,59,1667,147,147,229,96213,96213,96066,96066
California,43,2022-10-11,23183,23204,23204,0,626973,628366,628308,58,1541,147,147,218,96342,96342,96195,96195
California,44,2022-10-18,18762,18779,18779,0,519251,520470,520413,57,1389,121,121,212,96463,96463,96342,96342
California,45,2022-10-25,18747,18767,18767,0,518634,519914,519857,57,1339,125,125,198,96588,96588,96463,96463
California,46,2022-11-01,21892,21922,21922,0,524298,525658,525601,57,1434,106,106,200,96694,96694,96588,96588
California,47,2022-11-08,27286,27342,27342,0,545224,546739,546682,57,1630,131,131,225,96825,96825,96694,96694
California,48,2022-11-15,32495,32568,32568,0,561580,563267,563210,57,1829,127,127,266,96952,96952,96825,96825
California,49,2022-11-22,41999,42106,42106,0,563260,565067,565010,57,2332,150,150,346,97102,97102,96952,96952
California,50,2022-11-29,58881,59070,59070,0,548814,550789,550732,57,3354,211,211,384,97313,97313,97102,97102
California,51,2022-12-06,64329,64556,64556,0,650495,653120,653062,58,3858,261,261,463,97574,97574,97313,97313
California,52,2022-12-13,55692,55911,55911,0,618245,621015,620957,58,4024,344,344,531,97918,97918,97574,97574
California,53,2022-12-20,50787,51008,51008,0,555817,558571,558514,57,4029,339,339,515,98257,98257,97918,97918
California,54,2022-12-27,46891,47119,47119,0,423580,425859,425802,57,3902,406,413,530,98663,98670,98257,98257
California,55,2023-01-03,42968,43205,43205,0,435443,438152,438095,57,4124,347,353,524,99010,99023,98663,98670
California,56,2023-01-10,30258,30451,30451,0,484208,487728,487671,57,3599,344,351,482,99354,99374,99010,99023
California,57,2023-01-17,20102,20250,20250,0,424694,428291,428234,57,3066,305,312,412,99659,99686,99354,99374
California,58,2023-01-24,18174,18326,18326,0,435835,440146,440089,57,2330,246,253,406,99905,99939,99659,99686
California,59,2023-01-31,19682,19870,19870,0,415993,420708,420651,57,2279,201,208,283,100106,100147,99905,99939
California,60,2023-02-07,21464,21713,21713,0,399226,404324,404267,57,2310,159,167,268,100265,100314,100106,100147
California,61,2023-02-14,21117,21399,21399,0,380591,386128,386072,56,2247,144,154,282,100409,100468,100265,100314
California,62,2023-02-21,20340,20653,20653,0,357613,363608,363552,56,2295,158,173,278,100567,100641,100409,100468
California,63,2023-02-28,19030,19385,19385,0,368645,376039,375983,56,2206,152,175,311,100719,100816,100567,100641
California,64,2023-03-07,16706,17109,17109,0,345085,353906,353850,56,2180,118,165,275,100837,100981,100719,100816
California,65,2023-03-14,14933,15449,15449,0,327077,338839,338783,56,1920,92,181,277,100929,101162,100837,100981
California,66,2023-03-21,11673,12428,12428,0,295340,315359,315303,56,1670,46,196,222,100975,101358,100929,101162
California,67,2023-03-27,6075,9207,9207,0,163634,230106,230050,56,1498,7,71,196,100982,101429,100975,101358
