county,time,date,cases,est_cases,est_omicron_cases,est_other_cases,tests,est_tests,est_omicron_tests,est_other_tests,hospitalizations,deaths,est_deaths,icu,cum_deaths,cum_est_deaths,prev_cum_deaths,prev_cum_est_deaths
Alameda,1,2021-12-20,2978,2978,1417,1561,89768,89776,41921,47855,47,9,9,14,1549,1549,1540,1540
Amador,1,2021-12-20,49,49,18,31,1716,1716,602,1114,2,0,0,3,70,70,70,70
Butte,1,2021-12-20,193,193,101,92,4385,4385,2285,2100,24,5,5,1,359,359,354,354
Calaveras,1,2021-12-20,59,59,23,36,1520,1520,582,938,1,2,2,0,92,92,90,90
Colusa,1,2021-12-20,11,11,5,6,397,397,170,227,1,0,0,0,21,21,21,21
Contra Costa,1,2021-12-20,1685,1685,590,1095,43225,43230,14848,28382,27,4,4,7,1080,1080,1076,1076
Del Norte,1,2021-12-20,19,19,8,11,1378,1378,570,808,0,0,0,0,42,42,42,42
El Dorado,1,2021-12-20,238,238,93,145,4466,4466,1729,2737,4,4,4,3,178,178,174,174
Fresno,1,2021-12-20,1055,1055,379,676,25056,25056,8918,16138,131,19,19,45,2420,2420,2401,2401
Glenn,1,2021-12-20,20,20,8,12,462,462,185,277,0,0,0,0,41,41,41,41
Humboldt,1,2021-12-20,164,164,67,97,3772,3772,1529,2243,11,1,1,2,121,121,120,120
Imperial,1,2021-12-20,586,586,225,361,5535,5535,2109,3426,40,9,9,27,817,817,808,808
Inyo,1,2021-12-20,31,31,14,17,358,358,154,204,1,1,1,0,49,49,48,48
Kern,1,2021-12-20,927,927,401,526,26093,26093,11160,14933,84,24,24,27,2023,2023,1999,1999
Kings,1,2021-12-20,244,244,94,150,6912,6912,2638,4274,15,6,6,3,387,387,381,381
Lake,1,2021-12-20,37,37,13,24,1317,1317,464,853,0,0,0,0,116,116,116,116
Lassen,1,2021-12-20,11,11,5,6,2387,2387,1093,1294,0,0,0,0,54,54,54,54
Los Angeles,1,2021-12-20,31624,31625,22006,9619,985593,985676,676296,309380,574,107,107,174,27375,27375,27268,27268
Madera,1,2021-12-20,159,159,56,103,6014,6014,2122,3892,9,3,3,5,334,334,331,331
Marin,1,2021-12-20,566,566,210,356,11810,11810,4294,7516,5,1,1,1,256,256,255,255
Mariposa,1,2021-12-20,21,21,7,14,448,448,154,294,0,0,0,0,21,21,21,21
Mendocino,1,2021-12-20,91,91,27,64,2687,2687,789,1898,3,2,2,4,103,103,101,101
Merced,1,2021-12-20,323,323,138,185,5616,5616,2366,3250,11,6,6,12,693,693,687,687
Modoc,1,2021-12-20,5,5,2,3,67,67,30,37,2,0,0,0,6,6,6,6
Mono,1,2021-12-20,37,37,10,27,313,313,81,232,1,0,0,0,4,4,4,4
Monterey,1,2021-12-20,481,481,126,355,13259,13259,3421,9838,23,3,3,8,642,642,639,639
Napa,1,2021-12-20,229,229,106,123,5390,5390,2432,2958,2,1,1,2,108,108,107,107
Nevada,1,2021-12-20,161,161,58,103,2765,2765,999,1766,4,1,1,2,110,110,109,109
Orange,1,2021-12-20,4862,4862,2403,2459,99380,99388,48410,50978,132,34,34,56,6014,6014,5980,5980
Placer,1,2021-12-20,547,547,187,360,11155,11155,3769,7386,53,6,6,24,501,501,495,495
Plumas,1,2021-12-20,16,16,6,10,513,513,195,318,0,0,0,0,12,12,12,12
Riverside,1,2021-12-20,5595,5595,2346,3249,78334,78341,32452,45889,238,40,40,82,5578,5578,5538,5538
Sacramento,1,2021-12-20,2143,2143,855,1288,53571,53576,21168,32408,101,21,21,41,2490,2490,2469,2469
San Benito,1,2021-12-20,92,92,41,51,1928,1928,860,1068,2,3,3,2,81,81,78,78
San Bernardino,1,2021-12-20,5006,5006,2366,2640,79695,79701,37182,42519,299,66,66,112,6510,6510,6444,6444
San Diego,1,2021-12-20,8681,8681,5933,2748,149629,149642,101545,48097,249,29,29,94,4479,4479,4450,4450
San Francisco,1,2021-12-20,2984,2984,740,2244,57003,57008,13807,43201,28,3,3,10,693,693,690,690
San Joaquin,1,2021-12-20,952,952,359,593,25336,25336,9397,15939,48,13,13,27,1972,1972,1959,1959
San Luis Obispo,1,2021-12-20,425,425,187,238,9993,9993,4349,5644,11,3,3,6,371,371,368,368
San Mateo,1,2021-12-20,1558,1558,770,788,50631,50636,24532,26104,9,0,0,5,601,601,601,601
Santa Barbara,1,2021-12-20,788,788,326,462,15818,15818,6434,9384,18,8,8,12,570,570,562,562
Santa Clara,1,2021-12-20,2948,2948,1981,967,118952,118963,78841,40122,85,8,8,38,1978,1978,1970,1970
Santa Cruz,1,2021-12-20,404,404,182,222,19816,19816,8760,11056,11,2,2,5,230,230,228,228
Shasta,1,2021-12-20,163,163,65,98,6035,6035,2392,3643,28,8,8,8,448,448,440,440
Siskiyou,1,2021-12-20,20,20,9,11,449,449,207,242,2,2,2,2,63,63,61,61
Solano,1,2021-12-20,496,496,207,289,14752,14752,6069,8683,21,4,4,5,389,389,385,385
Sonoma,1,2021-12-20,751,751,319,432,20779,20779,8668,12111,22,1,1,6,420,420,419,419
Stanislaus,1,2021-12-20,670,670,210,460,13019,13019,4035,8984,90,13,13,22,1432,1432,1419,1419
Sutter,1,2021-12-20,123,123,51,72,2315,2315,947,1368,0,2,2,0,193,193,191,191
Tehama,1,2021-12-20,52,52,17,35,1324,1324,425,899,4,0,0,3,165,165,165,165
Trinity,1,2021-12-20,1,1,0,1,98,98,31,67,0,1,1,0,19,19,18,18
Tulare,1,2021-12-20,404,404,125,279,12352,12352,3799,8553,36,19,19,13,1308,1308,1289,1289
Tuolumne,1,2021-12-20,97,97,35,62,1940,1940,693,1247,7,0,0,0,150,150,150,150
Ventura,1,2021-12-20,2046,2046,1052,994,39239,39243,19904,19339,62,9,9,14,1216,1216,1207,1207
Yolo,1,2021-12-20,329,329,146,183,24705,24705,10823,13882,4,0,0,1,295,295,295,295
Yuba,1,2021-12-20,99,99,42,57,1873,1873,799,1074,3,0,0,4,102,102,102,102
Alameda,2,2021-12-27,7511,7511,4025,3486,87417,87427,46212,41215,89,12,12,19,1561,1561,1549,1549
Amador,2,2021-12-27,92,92,38,54,1445,1445,590,855,2,0,0,3,70,70,70,70
Butte,2,2021-12-27,540,540,318,222,4551,4551,2662,1889,37,3,3,3,362,362,359,359
Calaveras,2,2021-12-27,100,100,45,55,989,989,442,547,1,1,1,1,93,93,92,92
Colusa,2,2021-12-27,27,27,14,13,243,243,119,124,4,0,0,0,21,21,21,21
Contra Costa,2,2021-12-27,5132,5132,2102,3030,46335,46339,18597,27742,44,3,3,16,1083,1083,1080,1080
Del Norte,2,2021-12-27,25,25,12,13,1423,1423,679,744,0,0,0,1,42,42,42,42
El Dorado,2,2021-12-27,514,514,233,281,4085,4085,1816,2269,7,0,0,4,178,178,178,178
Fresno,2,2021-12-27,2204,2204,932,1272,23916,23917,9955,13962,122,16,16,41,2436,2436,2420,2420
Glenn,2,2021-12-27,53,53,24,29,451,451,207,244,0,1,1,0,42,42,41,41
Humboldt,2,2021-12-27,501,501,238,263,3456,3456,1617,1839,10,1,1,0,122,122,121,121
Imperial,2,2021-12-27,881,881,396,485,5910,5910,2617,3293,35,10,10,26,827,827,817,817
Inyo,2,2021-12-27,109,109,54,55,447,447,219,228,0,1,1,0,50,50,49,49
Kern,2,2021-12-27,1988,1988,996,992,22592,22593,11166,11427,79,18,18,36,2041,2041,2023,2023
Kings,2,2021-12-27,505,505,229,276,5481,5481,2433,3048,17,1,1,3,388,388,387,387
Lake,2,2021-12-27,67,67,28,39,1203,1203,495,708,0,1,1,0,117,117,116,116
Lassen,2,2021-12-27,21,21,11,10,2242,2242,1160,1082,0,0,0,0,54,54,54,54
Los Angeles,2,2021-12-27,96093,96102,71574,24528,717706,717779,530996,186783,862,115,115,207,27490,27490,27375,27375
Madera,2,2021-12-27,341,341,144,197,4210,4210,1748,2462,9,2,2,4,336,336,334,334
Marin,2,2021-12-27,1607,1607,688,919,16774,16774,7084,9690,3,0,0,1,256,256,256,256
Mariposa,2,2021-12-27,36,36,15,21,493,493,195,298,0,0,0,0,21,21,21,21
Mendocino,2,2021-12-27,152,152,55,97,2496,2496,862,1634,5,0,0,2,103,103,103,103
Merced,2,2021-12-27,653,653,322,331,5100,5100,2471,2629,11,7,7,10,700,700,693,693
Modoc,2,2021-12-27,3,3,1,2,38,38,19,19,1,0,0,0,6,6,6,6
Mono,2,2021-12-27,123,123,38,85,366,366,110,256,1,0,0,0,4,4,4,4
Monterey,2,2021-12-27,1008,1008,318,690,12882,12882,3971,8911,21,3,3,11,645,645,642,642
Napa,2,2021-12-27,809,809,422,387,6660,6660,3443,3217,6,0,0,1,108,108,108,108
Nevada,2,2021-12-27,236,236,100,136,1984,1984,815,1169,6,1,1,1,111,111,110,110
Orange,2,2021-12-27,18030,18031,10058,7973,130303,130316,71864,58452,256,31,31,66,6045,6045,6014,6014
Placer,2,2021-12-27,1230,1230,493,737,10769,10769,4261,6508,63,2,2,27,503,503,501,501
Plumas,2,2021-12-27,18,18,8,10,299,299,129,170,0,0,0,0,12,12,12,12
Riverside,2,2021-12-27,13686,13686,6601,7085,87498,87507,41716,45791,306,53,53,81,5631,5631,5578,5578
Sacramento,2,2021-12-27,5189,5189,2409,2780,52470,52475,24001,28474,135,22,22,44,2512,2512,2490,2490
San Benito,2,2021-12-27,317,317,163,154,2307,2307,1173,1134,1,3,3,3,84,84,81,81
San Bernardino,2,2021-12-27,14362,14363,7717,6646,87889,87899,46458,41441,341,69,69,141,6579,6579,6510,6510
San Diego,2,2021-12-27,27100,27101,19918,7183,177595,177612,129652,47960,315,34,34,96,4513,4513,4479,4479
San Francisco,2,2021-12-27,6856,6856,2009,4847,65930,65936,19045,46891,31,1,1,14,694,694,693,693
San Joaquin,2,2021-12-27,2358,2358,1040,1318,22776,22777,9885,12892,61,15,15,25,1987,1987,1972,1972
San Luis Obispo,2,2021-12-27,1153,1153,583,570,11182,11182,5563,5619,11,1,1,8,372,372,371,371
San Mateo,2,2021-12-27,5278,5278,2930,2348,55543,55549,30400,25149,19,2,2,5,603,603,601,601
Santa Barbara,2,2021-12-27,2142,2142,1022,1120,15278,15278,7172,8106,33,5,5,10,575,575,570,570
Santa Clara,2,2021-12-27,9044,9044,6545,2499,107058,107069,76814,30255,95,10,10,38,1988,1988,1978,1978
Santa Cruz,2,2021-12-27,946,946,489,457,12423,12423,6305,6118,11,0,0,2,230,230,230,230
Shasta,2,2021-12-27,261,261,122,139,4624,4624,2123,2501,32,5,5,12,453,453,448,448
Siskiyou,2,2021-12-27,21,21,11,10,360,360,190,170,0,0,0,0,63,63,63,63
Solano,2,2021-12-27,1298,1298,626,672,17049,17049,8088,8961,25,5,5,5,394,394,389,389
Sonoma,2,2021-12-27,1910,1910,932,978,21663,21664,10424,11240,19,1,1,5,421,421,420,420
Stanislaus,2,2021-12-27,1250,1250,468,782,11151,11151,4114,7037,94,17,17,18,1449,1449,1432,1432
Sutter,2,2021-12-27,225,225,108,117,2131,2131,1006,1125,0,2,2,0,195,195,193,193
Tehama,2,2021-12-27,103,103,40,63,1106,1106,419,687,6,2,2,3,167,167,165,165
Trinity,2,2021-12-27,4,4,2,2,101,101,37,64,0,0,0,0,19,19,19,19
Tulare,2,2021-12-27,815,815,301,514,11115,11115,4056,7059,36,10,10,9,1318,1318,1308,1308
Tuolumne,2,2021-12-27,170,170,72,98,1671,1671,692,979,5,0,0,1,150,150,150,150
Ventura,2,2021-12-27,5720,5720,3307,2413,39329,39334,22504,16830,66,8,8,19,1224,1224,1216,1216
Yolo,2,2021-12-27,816,816,416,400,22124,22126,11085,11041,7,1,1,4,296,296,295,295
Yuba,2,2021-12-27,164,164,81,83,1534,1534,749,785,8,1,1,4,103,103,102,102
Alameda,3,2022-01-03,17661,17662,10483,7179,117312,117325,69492,47833,156,5,5,31,1566,1566,1561,1561
Amador,3,2022-01-03,218,218,104,114,2179,2179,1029,1150,5,1,1,2,71,71,70,70
Butte,3,2022-01-03,1199,1199,776,423,6872,6872,4431,2441,32,0,0,4,362,362,362,362
Calaveras,3,2022-01-03,232,232,120,112,1305,1305,666,639,0,1,1,1,94,94,93,93
Colusa,3,2022-01-03,48,48,26,22,393,393,217,176,5,0,0,0,21,21,21,21
Contra Costa,3,2022-01-03,13509,13509,6284,7225,69123,69130,32072,37058,76,10,10,21,1093,1093,1083,1083
Del Norte,3,2022-01-03,86,86,47,39,2132,2132,1143,989,0,0,0,0,42,42,42,42
El Dorado,3,2022-01-03,1284,1284,657,627,6062,6062,3079,2983,7,4,4,6,182,182,178,178
Fresno,3,2022-01-03,6538,6538,3142,3396,38677,38681,18465,20216,175,14,14,44,2450,2450,2436,2436
Glenn,3,2022-01-03,76,76,39,37,610,610,318,292,0,1,1,0,43,43,42,42
Humboldt,3,2022-01-03,880,880,470,410,5295,5295,2810,2485,9,1,1,3,123,123,122,122
Imperial,3,2022-01-03,1877,1877,955,922,9147,9147,4618,4529,35,14,14,29,841,841,827,827
Inyo,3,2022-01-03,265,265,147,118,713,713,394,319,3,0,0,0,50,50,50,50
Kern,3,2022-01-03,5833,5833,3270,2563,35874,35878,19999,15879,100,16,16,32,2057,2057,2041,2041
Kings,3,2022-01-03,1094,1094,560,534,8511,8511,4310,4201,13,3,3,5,391,391,388,388
Lake,3,2022-01-03,220,220,106,114,1777,1777,847,930,1,0,0,1,117,117,117,117
Lassen,3,2022-01-03,61,61,35,26,3119,3119,1806,1313,2,0,0,0,54,54,54,54
Los Angeles,3,2022-01-03,204031,204057,160483,43574,1088038,1088168,856108,232060,1937,149,149,303,27639,27639,27490,27490
Madera,3,2022-01-03,829,829,397,432,6362,6362,3024,3338,17,3,3,6,339,339,336,336
Marin,3,2022-01-03,2363,2363,1148,1215,17674,17674,8532,9142,15,1,1,3,257,257,256,256
Mariposa,3,2022-01-03,103,103,48,55,657,657,304,353,0,0,0,0,21,21,21,21
Mendocino,3,2022-01-03,452,452,186,266,3572,3572,1454,2118,7,1,1,2,104,104,103,103
Merced,3,2022-01-03,1549,1549,851,698,8548,8548,4667,3881,3,9,9,4,709,709,700,700
Modoc,3,2022-01-03,15,15,8,7,59,59,33,26,0,0,0,0,6,6,6,6
Mono,3,2022-01-03,180,180,65,115,435,435,156,279,2,0,0,0,4,4,4,4
Monterey,3,2022-01-03,2462,2462,906,1556,20638,20639,7547,13092,30,4,4,10,649,649,645,645
Napa,3,2022-01-03,1855,1855,1075,780,11756,11756,6790,4966,9,1,1,3,109,109,108,108
Nevada,3,2022-01-03,646,646,313,333,3071,3071,1485,1586,7,1,1,3,112,112,111,111
Orange,3,2022-01-03,45456,45462,27779,17683,220201,220228,134363,85865,504,34,34,110,6079,6079,6045,6045
Placer,3,2022-01-03,2872,2872,1317,1555,15068,15068,6861,8207,113,15,15,24,518,518,503,503
Plumas,3,2022-01-03,54,54,27,27,496,496,248,248,1,0,0,0,12,12,12,12
Riverside,3,2022-01-03,32034,32038,17304,14734,138447,138465,74455,64010,564,54,54,94,5685,5685,5631,5631
Sacramento,3,2022-01-03,14120,14121,7374,6747,80492,80503,41836,38667,219,25,25,57,2537,2537,2512,2512
San Benito,3,2022-01-03,739,739,422,317,3466,3466,1977,1489,3,1,1,2,85,85,84,84
San Bernardino,3,2022-01-03,33822,33826,20008,13818,135048,135064,79609,55455,571,94,94,136,6673,6673,6579,6579
San Diego,3,2022-01-03,61076,61083,47452,13631,253654,253684,196975,56709,561,33,33,121,4546,4546,4513,4513
San Francisco,3,2022-01-03,11433,11433,3971,7462,85524,85535,29514,56021,78,5,5,22,699,699,694,694
San Joaquin,3,2022-01-03,6976,6976,3478,3498,36130,36134,17902,18232,80,13,13,27,2000,2000,1987,1987
San Luis Obispo,3,2022-01-03,2473,2473,1386,1087,15963,15964,8918,7046,24,5,5,7,377,377,372,372
San Mateo,3,2022-01-03,10623,10623,6504,4119,81979,81989,50101,31888,37,4,4,7,607,607,603,603
Santa Barbara,3,2022-01-03,5322,5322,2849,2473,28189,28192,15052,13140,53,5,5,7,580,580,575,575
Santa Clara,3,2022-01-03,23021,23022,17698,5324,170167,170187,130649,39538,186,10,10,58,1998,1998,1988,1988
Santa Cruz,3,2022-01-03,2405,2405,1385,1020,21662,21663,12485,9178,15,5,5,3,235,235,230,230
Shasta,3,2022-01-03,600,600,317,283,6172,6172,3227,2945,33,2,2,13,455,455,453,453
Siskiyou,3,2022-01-03,74,74,44,30,590,590,348,242,0,0,0,0,63,63,63,63
Solano,3,2022-01-03,4071,4071,2180,1891,26143,26147,13988,12159,54,2,2,9,396,396,394,394
Sonoma,3,2022-01-03,4537,4537,2478,2059,32186,32190,17530,14660,25,7,7,4,428,428,421,421
Stanislaus,3,2022-01-03,3332,3332,1435,1897,17983,17984,7688,10296,129,9,9,20,1458,1458,1449,1449
Sutter,3,2022-01-03,547,547,296,251,2980,2980,1594,1386,0,2,2,0,197,197,195,195
Tehama,3,2022-01-03,215,215,96,119,1466,1466,649,817,4,1,1,2,168,168,167,167
Trinity,3,2022-01-03,14,14,6,8,107,107,46,61,0,0,0,0,19,19,19,19
Tulare,3,2022-01-03,2132,2132,913,1219,16005,16006,6775,9231,57,5,5,7,1323,1323,1318,1318
Tuolumne,3,2022-01-03,383,383,186,197,2544,2544,1227,1317,7,3,3,0,153,153,150,150
Ventura,3,2022-01-03,12666,12666,7983,4683,59671,59678,37565,22113,136,11,11,28,1235,1235,1224,1224
Yolo,3,2022-01-03,2317,2317,1321,996,31705,31710,17937,13773,8,4,4,3,300,300,296,296
Yuba,3,2022-01-03,472,472,262,210,2331,2331,1284,1047,17,1,1,6,104,104,103,103
Alameda,4,2022-01-10,31198,31203,20215,10988,193890,193915,125758,68157,277,14,14,46,1580,1580,1566,1566
Amador,4,2022-01-10,391,391,209,182,2726,2726,1447,1279,4,0,0,4,71,71,71,71
Butte,4,2022-01-10,1998,1998,1394,604,10459,10459,7287,3172,55,2,2,4,364,364,362,362
Calaveras,4,2022-01-10,523,523,299,224,2607,2607,1479,1128,0,1,1,2,95,95,94,94
Colusa,4,2022-01-10,105,105,65,40,756,756,462,294,5,0,0,0,21,21,21,21
Contra Costa,4,2022-01-10,19713,19713,10325,9388,102242,102254,53544,48710,152,12,12,24,1105,1105,1093,1093
Del Norte,4,2022-01-10,178,178,106,72,3958,3958,2363,1595,2,0,0,0,42,42,42,42
El Dorado,4,2022-01-10,2216,2216,1261,955,9362,9362,5324,4038,14,6,6,2,188,188,182,182
Fresno,4,2022-01-10,14010,14010,7571,6439,60054,60061,32387,27674,301,14,14,47,2464,2464,2450,2450
Glenn,4,2022-01-10,219,219,127,92,938,938,544,394,2,0,0,0,43,43,43,43
Humboldt,4,2022-01-10,1400,1400,827,573,8355,8355,4924,3431,18,5,5,2,128,128,123,123
Imperial,4,2022-01-10,3622,3622,2047,1575,13841,13841,7804,6037,58,11,11,25,852,852,841,841
Inyo,4,2022-01-10,408,408,248,160,1356,1356,826,530,4,2,2,0,52,52,50,50
Kern,4,2022-01-10,11937,11937,7340,4597,57115,57121,35085,22036,181,26,26,35,2083,2083,2057,2057
Kings,4,2022-01-10,2413,2413,1381,1032,13013,13013,7401,5612,33,1,1,4,392,392,391,391
Lake,4,2022-01-10,499,499,268,231,2761,2761,1477,1284,0,3,3,1,120,120,117,117
Lassen,4,2022-01-10,194,194,124,70,3438,3438,2185,1253,1,0,0,0,54,54,54,54
Los Angeles,4,2022-01-10,328947,328990,270781,58209,1915111,1915360,1577006,338354,3253,270,270,513,27909,27909,27639,27639
Madera,4,2022-01-10,1910,1910,1027,883,10379,10379,5546,4833,19,1,1,6,340,340,339,339
Marin,4,2022-01-10,2940,2940,1602,1338,21011,21012,11438,9574,18,3,3,5,260,260,257,257
Mariposa,4,2022-01-10,199,199,105,94,1158,1158,607,551,0,1,1,0,22,22,21,21
Mendocino,4,2022-01-10,875,875,411,464,5538,5538,2581,2957,8,2,2,2,106,106,104,104
Merced,4,2022-01-10,3690,3690,2234,1456,14516,14516,8775,5741,33,10,10,11,719,719,709,709
Modoc,4,2022-01-10,13,13,8,5,109,109,67,42,0,0,0,0,6,6,6,6
Mono,4,2022-01-10,253,253,106,147,863,863,360,503,1,1,1,0,5,5,4,4
Monterey,4,2022-01-10,4978,4978,2116,2862,33233,33238,14054,19184,44,5,5,12,654,654,649,649
Napa,4,2022-01-10,2647,2647,1680,967,14353,14353,9103,5250,14,1,1,4,110,110,109,109
Nevada,4,2022-01-10,1185,1185,644,541,5232,5232,2839,2393,10,2,2,3,114,114,112,112
Orange,4,2022-01-10,60049,60056,39974,20082,317660,317701,211532,106169,854,100,100,159,6179,6179,6079,6079
Placer,4,2022-01-10,5235,5235,2712,2523,22555,22557,11667,10890,179,6,6,29,524,524,518,518
Plumas,4,2022-01-10,142,142,79,63,803,803,446,357,5,0,0,0,12,12,12,12
Riverside,4,2022-01-10,48252,48257,28850,19407,187755,187780,112229,75551,762,83,83,139,5768,5768,5685,5685
Sacramento,4,2022-01-10,27505,27510,15919,11591,121788,121804,70490,51314,375,37,37,89,2574,2574,2537,2537
San Benito,4,2022-01-10,1040,1040,655,385,4615,4615,2909,1706,3,1,1,2,86,86,85,85
San Bernardino,4,2022-01-10,50709,50715,32853,17862,192768,192792,124834,67958,784,113,113,187,6786,6786,6673,6673
San Diego,4,2022-01-10,82763,82775,67446,15329,330085,330128,269034,61094,895,65,65,166,4611,4611,4546,4546
San Francisco,4,2022-01-10,15091,15091,6033,9058,117287,117303,46962,70341,158,12,12,35,711,711,699,699
San Joaquin,4,2022-01-10,14515,14515,8088,6427,66840,66849,37188,29661,151,15,15,45,2015,2015,2000,2000
San Luis Obispo,4,2022-01-10,4336,4336,2675,1661,21621,21623,13358,8265,30,2,2,7,379,379,377,377
San Mateo,4,2022-01-10,15009,15009,9997,5012,113101,113115,75335,37780,95,5,5,16,612,612,607,607
Santa Barbara,4,2022-01-10,8537,8537,5053,3484,47382,47387,28054,19333,84,9,9,10,589,589,580,580
Santa Clara,4,2022-01-10,36488,36493,29450,7043,271158,271194,218804,52390,350,26,26,68,2024,2024,1998,1998
Santa Cruz,4,2022-01-10,4542,4542,2861,1681,42814,42819,26982,15837,25,2,2,2,237,237,235,235
Shasta,4,2022-01-10,1056,1056,617,439,8405,8405,4893,3512,37,7,7,12,462,462,455,455
Siskiyou,4,2022-01-10,120,120,77,43,919,919,591,328,3,1,1,1,64,64,63,63
Solano,4,2022-01-10,6917,6917,4122,2795,37125,37130,22134,14996,94,6,6,15,402,402,396,396
Sonoma,4,2022-01-10,8859,8859,5337,3522,47194,47199,28453,18746,72,9,9,8,437,437,428,428
Stanislaus,4,2022-01-10,6741,6741,3302,3439,29312,29317,14323,14994,173,13,13,19,1471,1471,1458,1458
Sutter,4,2022-01-10,1245,1245,743,502,5062,5062,3006,2056,0,2,2,0,199,199,197,197
Tehama,4,2022-01-10,512,512,257,255,2482,2482,1241,1241,13,1,1,1,169,169,168,168
Trinity,4,2022-01-10,38,38,19,19,275,275,135,140,0,0,0,0,19,19,19,19
Tulare,4,2022-01-10,5200,5200,2534,2666,24072,24075,11671,12404,66,9,9,8,1332,1332,1323,1323
Tuolumne,4,2022-01-10,804,804,435,369,4178,4178,2257,1921,13,1,1,1,154,154,153,153
Ventura,4,2022-01-10,17506,17506,11972,5534,88214,88226,60311,27915,227,23,23,34,1258,1258,1235,1235
Yolo,4,2022-01-10,3760,3760,2341,1419,48242,48247,30005,18242,6,4,4,1,304,304,300,300
Yuba,4,2022-01-10,1022,1022,624,398,4108,4108,2504,1604,41,0,0,7,104,104,104,104
Alameda,5,2022-01-17,24735,24740,17355,7385,170522,170548,119569,50979,366,33,33,62,1613,1613,1580,1580
Amador,5,2022-01-17,476,476,282,194,3557,3557,2081,1476,10,2,2,3,73,73,71,71
Butte,5,2022-01-17,2061,2061,1537,524,9328,9328,6950,2378,58,6,6,6,370,370,364,364
Calaveras,5,2022-01-17,564,564,353,211,2472,2472,1542,930,3,2,2,3,97,97,95,95
Colusa,5,2022-01-17,161,161,107,54,719,719,476,243,3,0,0,0,21,21,21,21
Contra Costa,5,2022-01-17,16219,16219,9470,6749,88034,88047,51325,36722,198,22,22,41,1127,1127,1105,1105
Del Norte,5,2022-01-17,200,200,131,69,3758,3758,2429,1329,2,0,0,1,42,42,42,42
El Dorado,5,2022-01-17,1963,1963,1227,736,8063,8063,5041,3022,9,4,4,2,192,192,188,188
Fresno,5,2022-01-17,17833,17833,10682,7151,66169,66181,39601,26580,386,27,27,61,2491,2491,2464,2464
Glenn,5,2022-01-17,307,307,194,113,1076,1076,683,393,3,2,2,0,45,45,43,43
Humboldt,5,2022-01-17,1141,1141,737,404,8322,8322,5364,2958,10,1,1,4,129,129,128,128
Imperial,5,2022-01-17,3409,3409,2120,1289,13241,13241,8231,5010,69,12,12,29,864,864,852,852
Inyo,5,2022-01-17,327,327,216,111,1040,1040,688,352,4,0,0,0,52,52,52,52
Kern,5,2022-01-17,11690,11690,7801,3889,51809,51815,34535,17280,242,29,29,44,2112,2112,2083,2083
Kings,5,2022-01-17,3194,3194,1995,1199,14866,14866,9258,5608,40,4,4,1,396,396,392,392
Lake,5,2022-01-17,583,583,348,235,3246,3246,1936,1310,2,1,1,2,121,121,120,120
Lassen,5,2022-01-17,283,283,195,88,3322,3322,2278,1044,0,0,0,0,54,54,54,54
Los Angeles,5,2022-01-17,218297,218330,186775,31555,1610377,1610616,1376903,233713,4034,504,504,680,28413,28413,27909,27909
Madera,5,2022-01-17,2398,2398,1430,968,10611,10611,6301,4310,32,5,5,10,345,345,340,340
Marin,5,2022-01-17,2420,2420,1461,959,17702,17703,10679,7024,38,4,4,6,264,264,260,260
Mariposa,5,2022-01-17,163,163,95,68,1115,1115,648,467,0,0,0,0,22,22,22,22
Mendocino,5,2022-01-17,921,921,486,435,5015,5015,2630,2385,18,3,3,2,109,109,106,106
Merced,5,2022-01-17,3967,3967,2616,1351,13639,13639,8989,4650,41,18,18,11,737,737,719,719
Modoc,5,2022-01-17,13,13,9,4,102,102,68,34,0,1,1,0,7,7,6,6
Mono,5,2022-01-17,198,198,94,104,809,809,386,423,2,0,0,0,5,5,5,5
Monterey,5,2022-01-17,5899,5899,2858,3041,28328,28333,13713,14620,69,6,6,14,660,660,654,654
Napa,5,2022-01-17,1927,1927,1327,600,11914,11914,8177,3737,21,2,2,5,112,112,110,110
Nevada,5,2022-01-17,1252,1252,752,500,5429,5429,3261,2168,19,1,1,1,115,115,114,114
Orange,5,2022-01-17,41302,41308,29630,11678,251481,251518,180246,71272,998,111,111,199,6290,6290,6179,6179
Placer,5,2022-01-17,4326,4326,2498,1828,19462,19465,11219,8246,178,14,14,36,538,538,524,524
Plumas,5,2022-01-17,194,194,119,75,852,852,524,328,3,0,0,0,12,12,12,12
Riverside,5,2022-01-17,41247,41253,26968,14285,168057,168082,109895,58187,920,97,97,158,5865,5865,5768,5768
Sacramento,5,2022-01-17,21452,21455,13654,7801,101462,101477,64502,36975,473,64,64,97,2638,2638,2574,2574
San Benito,5,2022-01-17,905,905,620,285,4273,4273,2922,1351,4,1,1,4,87,87,86,86
San Bernardino,5,2022-01-17,38508,38514,26941,11573,164355,164379,114984,49395,936,146,146,227,6932,6932,6786,6786
San Diego,5,2022-01-17,60731,60741,51560,9181,265927,265968,225789,40179,1067,101,101,193,4712,4712,4611,4611
San Francisco,5,2022-01-17,11257,11257,5199,6058,94011,94024,43311,50713,212,14,14,44,725,725,711,711
San Joaquin,5,2022-01-17,12724,12724,7806,4918,58121,58131,35671,22460,201,20,20,57,2035,2035,2015,2015
San Luis Obispo,5,2022-01-17,3935,3935,2647,1288,21023,21027,14129,6898,46,12,12,10,391,391,379,379
San Mateo,5,2022-01-17,12475,12475,8939,3536,95950,95964,68680,27284,92,10,10,30,622,622,612,612
Santa Barbara,5,2022-01-17,6850,6850,4444,2406,40485,40490,26233,14257,123,12,12,12,601,601,589,589
Santa Clara,5,2022-01-17,29555,29560,24871,4689,235954,235990,198436,37554,451,24,24,84,2048,2048,2024,2024
Santa Cruz,5,2022-01-17,4182,4182,2866,1316,42205,42210,28866,13344,23,3,3,3,240,240,237,237
Shasta,5,2022-01-17,1347,1347,863,484,9163,9163,5844,3319,55,7,7,14,469,469,462,462
Siskiyou,5,2022-01-17,158,158,110,48,927,927,640,287,3,1,1,2,65,65,64,64
Solano,5,2022-01-17,6436,6436,4201,2235,35200,35206,22975,12231,121,6,6,22,408,408,402,402
Sonoma,5,2022-01-17,7620,7620,5021,2599,42775,42780,28133,14647,73,7,7,15,444,444,437,437
Stanislaus,5,2022-01-17,7322,7322,4016,3306,29052,29057,15915,13142,206,10,10,31,1481,1481,1471,1471
Sutter,5,2022-01-17,1246,1246,810,436,4863,4863,3161,1702,0,4,4,0,203,203,199,199
Tehama,5,2022-01-17,614,614,343,271,2420,2420,1349,1071,15,5,5,2,174,174,169,169
Trinity,5,2022-01-17,41,41,23,18,255,255,140,115,0,1,1,0,20,20,19,19
Tulare,5,2022-01-17,7462,7462,4061,3401,27086,27091,14726,12365,97,16,16,16,1348,1348,1332,1332
Tuolumne,5,2022-01-17,885,885,531,354,3836,3836,2287,1549,10,8,8,1,162,162,154,154
Ventura,5,2022-01-17,11974,11974,8780,3194,66929,66940,49022,17918,300,41,41,56,1299,1299,1258,1258
Yolo,5,2022-01-17,2803,2803,1898,905,39497,39502,26708,12794,15,4,4,4,308,308,304,304
Yuba,5,2022-01-17,1064,1064,707,357,3747,3747,2489,1258,42,2,2,6,106,106,104,104
Alameda,6,2022-01-24,19784,19789,14856,4933,171810,171844,129184,42660,373,41,41,68,1654,1654,1613,1613
Amador,6,2022-01-24,544,544,352,192,4667,4667,3019,1648,8,0,0,5,73,73,73,73
Butte,6,2022-01-24,1904,1904,1501,403,9609,9610,7593,2017,82,10,10,9,380,380,370,370
Calaveras,6,2022-01-24,556,556,378,178,2506,2506,1705,801,6,2,2,2,99,99,97,97
Colusa,6,2022-01-24,177,177,127,50,951,951,680,271,6,0,0,0,21,21,21,21
Contra Costa,6,2022-01-24,13580,13581,8728,4853,85306,85323,54892,30431,217,25,25,64,1152,1152,1127,1127
Del Norte,6,2022-01-24,348,348,246,102,4326,4326,3042,1284,3,0,0,3,42,42,42,42
El Dorado,6,2022-01-24,1403,1403,956,447,7329,7329,5001,2328,17,2,2,6,194,194,192,192
Fresno,6,2022-01-24,17607,17612,11539,6073,68848,68862,45203,23659,491,43,43,83,2534,2534,2491,2491
Glenn,6,2022-01-24,249,249,172,77,971,971,670,301,0,0,0,0,45,45,45,45
Humboldt,6,2022-01-24,914,914,640,274,7713,7713,5408,2305,25,3,3,3,132,132,129,129
Imperial,6,2022-01-24,3613,3613,2452,1161,13189,13190,8970,4220,70,14,14,27,878,878,864,864
Inyo,6,2022-01-24,142,142,102,40,625,625,449,176,1,1,1,0,53,53,52,52
Kern,6,2022-01-24,10554,10554,7599,2955,53946,53958,38898,15060,267,47,47,51,2159,2159,2112,2112
Kings,6,2022-01-24,4300,4300,2921,1379,19064,19069,12980,6089,40,4,4,4,400,400,396,396
Lake,6,2022-01-24,746,746,488,258,3417,3417,2234,1183,6,2,2,3,123,123,121,121
Lassen,6,2022-01-24,418,418,307,111,3982,3982,2932,1050,6,0,0,0,54,54,54,54
Los Angeles,6,2022-01-24,164813,164845,145615,19230,1659193,1659521,1466965,192556,3769,611,611,785,29024,29024,28413,28413
Madera,6,2022-01-24,2710,2710,1767,943,12170,12171,7938,4233,49,7,7,10,352,352,345,345
Marin,6,2022-01-24,1856,1856,1227,629,17548,17553,11611,5942,38,4,4,10,268,268,264,264
Mariposa,6,2022-01-24,134,134,86,48,946,946,606,340,0,0,0,0,22,22,22,22
Mendocino,6,2022-01-24,917,917,538,379,4873,4873,2854,2019,23,2,2,3,111,111,109,109
Merced,6,2022-01-24,3185,3185,2273,912,12907,12909,9215,3694,55,9,9,12,746,746,737,737
Modoc,6,2022-01-24,14,14,10,4,114,114,82,32,2,0,0,0,7,7,7,7
Mono,6,2022-01-24,97,97,52,45,422,422,227,195,1,0,0,0,5,5,5,5
Monterey,6,2022-01-24,5082,5082,2771,2311,31796,31802,17337,14465,80,9,9,17,669,669,660,660
Napa,6,2022-01-24,1672,1672,1236,436,12465,12466,9206,3260,23,5,5,4,117,117,112,112
Nevada,6,2022-01-24,999,999,658,341,4807,4807,3171,1636,29,1,1,6,116,116,115,115
Orange,6,2022-01-24,26664,26669,20380,6289,230896,230942,176732,54210,923,177,177,191,6467,6467,6290,6290
Placer,6,2022-01-24,3658,3658,2328,1330,18642,18647,11869,6778,215,8,8,43,546,546,538,538
Plumas,6,2022-01-24,215,215,144,71,836,836,559,277,5,0,0,0,12,12,12,12
Riverside,6,2022-01-24,31903,31909,22577,9332,158778,158809,112485,46324,901,122,122,168,5987,5987,5865,5865
Sacramento,6,2022-01-24,17462,17466,12085,5381,98835,98854,68437,30417,542,63,63,105,2701,2701,2638,2638
San Benito,6,2022-01-24,777,777,570,207,3929,3929,2889,1040,7,1,1,3,88,88,87,87
San Bernardino,6,2022-01-24,28069,28074,21039,7035,153565,153595,115218,38377,975,170,170,223,7102,7102,6932,6932
San Diego,6,2022-01-24,51531,51541,45236,6305,252112,252162,221566,30596,1056,130,130,232,4842,4842,4712,4712
San Francisco,6,2022-01-24,8093,8093,4231,3862,88915,88932,46546,42386,232,19,19,37,744,744,725,725
San Joaquin,6,2022-01-24,11055,11056,7405,3651,59090,59103,39664,19439,241,34,34,71,2069,2069,2035,2035
San Luis Obispo,6,2022-01-24,3562,3562,2583,979,21516,21521,15606,5915,42,10,10,12,401,401,391,391
San Mateo,6,2022-01-24,8500,8500,6493,2007,95136,95155,72753,22402,139,19,19,28,641,641,622,622
Santa Barbara,6,2022-01-24,6483,6483,4558,1925,43826,43834,30828,13006,127,12,12,19,613,613,601,601
Santa Clara,6,2022-01-24,22781,22786,19872,2914,233308,233355,203498,29857,412,48,48,88,2096,2096,2048,2048
Santa Cruz,6,2022-01-24,5042,5042,3708,1334,45621,45630,33581,12049,31,1,1,2,241,241,240,240
Shasta,6,2022-01-24,1484,1484,1031,453,10135,10136,7033,3103,78,7,7,9,476,476,469,469
Siskiyou,6,2022-01-24,159,159,118,41,857,857,635,222,6,3,3,1,68,68,65,65
Solano,6,2022-01-24,5126,5126,3626,1500,32622,32627,23093,9534,143,14,14,26,422,422,408,408
Sonoma,6,2022-01-24,6917,6917,4924,1993,42473,42480,30250,12230,94,7,7,18,451,451,444,444
Stanislaus,6,2022-01-24,6369,6369,3872,2497,28262,28267,17211,11056,277,27,27,44,1508,1508,1481,1481
Sutter,6,2022-01-24,1048,1048,737,311,5002,5002,3521,1481,0,2,2,0,205,205,203,203
Tehama,6,2022-01-24,578,578,358,220,2702,2702,1674,1028,19,4,4,5,178,178,174,174
Trinity,6,2022-01-24,63,63,38,25,322,322,196,126,0,0,0,0,20,20,20,20
Tulare,6,2022-01-24,7662,7662,4622,3040,29528,29533,17857,11676,138,11,11,14,1359,1359,1348,1348
Tuolumne,6,2022-01-24,953,953,627,326,3825,3825,2509,1316,17,2,2,3,164,164,162,162
Ventura,6,2022-01-24,9408,9408,7328,2080,68517,68531,53436,15095,269,28,28,68,1327,1327,1299,1299
Yolo,6,2022-01-24,2296,2296,1674,622,40464,40471,29507,10964,18,12,12,5,320,320,308,308
Yuba,6,2022-01-24,910,910,653,257,3779,3779,2711,1068,54,3,3,10,109,109,106,106
Alameda,7,2022-01-31,11005,11006,8748,2258,137330,137364,109305,28059,336,50,50,75,1704,1704,1654,1654
Amador,7,2022-01-31,348,348,245,103,3226,3226,2273,953,15,1,1,4,74,74,73,73
Butte,7,2022-01-31,1168,1168,967,201,7609,7610,6306,1304,80,6,6,7,386,386,380,380
Calaveras,7,2022-01-31,263,263,193,70,1940,1940,1424,516,3,5,5,2,104,104,99,99
Colusa,7,2022-01-31,106,106,81,25,704,704,540,164,9,0,0,0,21,21,21,21
Contra Costa,7,2022-01-31,7311,7311,5097,2214,68621,68638,47929,20709,207,39,39,54,1191,1191,1152,1152
Del Norte,7,2022-01-31,315,315,237,78,3957,3957,2977,980,6,2,2,2,44,44,42,42
El Dorado,7,2022-01-31,743,743,545,198,6020,6020,4421,1599,13,4,4,5,198,198,194,194
Fresno,7,2022-01-31,10936,10938,7757,3181,54942,54956,39027,15929,503,39,39,98,2573,2573,2534,2534
Glenn,7,2022-01-31,189,189,140,49,759,759,563,196,2,2,2,0,47,47,45,45
Humboldt,7,2022-01-31,584,584,439,145,5790,5790,4348,1442,18,3,3,3,135,135,132,132
Imperial,7,2022-01-31,2192,2192,1598,594,11303,11305,8265,3040,71,17,17,28,895,895,878,878
Inyo,7,2022-01-31,55,55,42,13,467,467,357,110,5,3,3,0,56,56,53,53
Kern,7,2022-01-31,5647,5647,4338,1309,42263,42274,32511,9763,264,47,47,54,2206,2206,2159,2159
Kings,7,2022-01-31,2385,2385,1745,640,13681,13685,10020,3665,55,5,5,4,405,405,400,400
Lake,7,2022-01-31,478,478,338,140,3193,3193,2258,935,4,4,4,4,127,127,123,123
Lassen,7,2022-01-31,311,311,243,68,3624,3624,2838,786,7,1,1,0,55,55,54,54
Los Angeles,7,2022-01-31,74540,74558,67627,6931,1302823,1303146,1182813,120333,2991,640,640,719,29664,29664,29024,29024
Madera,7,2022-01-31,1740,1740,1230,510,9629,9631,6816,2815,50,6,6,7,358,358,352,352
Marin,7,2022-01-31,1063,1063,759,304,13816,13820,9891,3929,26,5,5,9,273,273,268,268
Mariposa,7,2022-01-31,101,101,70,31,840,840,584,256,0,2,2,0,24,24,22,22
Mendocino,7,2022-01-31,463,463,299,164,3486,3486,2252,1234,12,3,3,4,114,114,111,111
Merced,7,2022-01-31,2124,2124,1617,507,10465,10467,7977,2490,54,12,12,14,758,758,746,746
Modoc,7,2022-01-31,12,12,9,3,89,89,68,21,1,0,0,0,7,7,7,7
Mono,7,2022-01-31,41,41,25,16,339,339,203,136,0,0,0,0,5,5,5,5
Monterey,7,2022-01-31,3560,3560,2155,1405,26742,26748,16232,10516,82,9,9,13,678,678,669,669
Napa,7,2022-01-31,988,988,776,212,9376,9377,7355,2022,17,7,7,10,124,124,117,117
Nevada,7,2022-01-31,566,566,402,164,3912,3912,2788,1124,26,3,3,5,119,119,116,116
Orange,7,2022-01-31,11991,11993,9675,2318,177028,177071,142964,34107,708,169,169,164,6636,6636,6467,6467
Placer,7,2022-01-31,2261,2261,1563,698,15374,15379,10650,4729,152,19,19,42,565,565,546,546
Plumas,7,2022-01-31,137,137,98,39,753,753,542,211,1,0,0,0,12,12,12,12
Riverside,7,2022-01-31,15944,15949,12054,3895,121040,121070,91713,29357,740,111,111,171,6098,6098,5987,5987
Sacramento,7,2022-01-31,10135,10136,7521,2615,77583,77602,57664,19938,501,93,93,106,2794,2794,2701,2701
San Benito,7,2022-01-31,473,473,369,104,3322,3322,2595,727,5,2,2,3,90,90,88,88
San Bernardino,7,2022-01-31,13247,13251,10516,2735,116538,116567,92617,23950,744,185,185,207,7287,7287,7102,7102
San Diego,7,2022-01-31,24898,24903,22468,2435,181381,181426,163832,17594,944,105,105,214,4947,4947,4842,4842
San Francisco,7,2022-01-31,4042,4042,2357,1685,69163,69180,40410,28770,208,24,24,45,768,768,744,744
San Joaquin,7,2022-01-31,5700,5700,4124,1576,43671,43681,31666,12015,210,36,36,75,2105,2105,2069,2069
San Luis Obispo,7,2022-01-31,1979,1979,1528,451,16236,16241,12545,3696,40,12,12,10,413,413,401,401
San Mateo,7,2022-01-31,4316,4316,3479,837,75104,75123,60584,14539,131,10,10,19,651,651,641,641
Santa Barbara,7,2022-01-31,3634,3634,2733,901,35024,35031,26389,8642,103,23,23,13,636,636,613,613
Santa Clara,7,2022-01-31,13837,13842,12420,1422,207114,207165,185944,21221,427,54,54,93,2150,2150,2096,2096
Santa Cruz,7,2022-01-31,3438,3438,2679,759,51420,51432,40159,11273,35,5,5,6,246,246,241,241
Shasta,7,2022-01-31,900,900,670,230,8419,8420,6270,2150,59,13,13,11,489,489,476,476
Siskiyou,7,2022-01-31,119,119,94,25,691,691,545,146,8,2,2,2,70,70,68,68
Solano,7,2022-01-31,3812,3812,2885,927,28709,28715,21730,6985,126,6,6,30,428,428,422,422
Sonoma,7,2022-01-31,3570,3570,2712,858,32146,32153,24457,7696,84,12,12,15,463,463,451,451
Stanislaus,7,2022-01-31,3689,3689,2459,1230,22305,22310,14900,7410,261,33,33,53,1541,1541,1508,1508
Sutter,7,2022-01-31,619,619,466,153,3764,3764,2837,927,0,4,4,0,209,209,205,205
Tehama,7,2022-01-31,378,378,256,122,2022,2022,1368,654,17,3,3,5,181,181,178,178
Trinity,7,2022-01-31,43,43,29,14,227,227,151,76,0,0,0,0,20,20,20,20
Tulare,7,2022-01-31,4680,4680,3094,1586,22910,22915,15183,7732,150,22,22,21,1381,1381,1359,1359
Tuolumne,7,2022-01-31,708,708,501,207,3265,3265,2315,950,12,2,2,4,166,166,164,164
Ventura,7,2022-01-31,4600,4600,3767,833,52324,52337,42911,9426,253,39,39,48,1366,1366,1327,1327
Yolo,7,2022-01-31,1353,1353,1049,304,37506,37516,29112,8404,19,5,5,5,325,325,320,320
Yuba,7,2022-01-31,523,523,400,123,2930,2930,2243,687,78,2,2,11,111,111,109,109
Alameda,8,2022-02-07,5965,5965,4967,998,115669,115706,96401,19305,254,44,44,62,1748,1748,1704,1704
Amador,8,2022-02-07,205,205,154,51,2908,2908,2186,722,14,4,4,5,78,78,74,74
Butte,8,2022-02-07,780,780,671,109,6393,6394,5506,888,74,8,8,12,394,394,386,386
Calaveras,8,2022-02-07,182,182,142,40,1426,1426,1111,315,2,2,2,1,106,106,104,104
Colusa,8,2022-02-07,71,71,57,14,555,555,449,106,0,0,0,0,21,21,21,21
Contra Costa,8,2022-02-07,4131,4131,3089,1042,54147,54165,40515,13650,149,32,32,52,1223,1223,1191,1191
Del Norte,8,2022-02-07,285,285,228,57,4003,4003,3184,819,5,0,0,0,44,44,44,44
El Dorado,8,2022-02-07,428,428,334,94,5037,5037,3929,1108,20,1,1,5,199,199,198,198
Fresno,8,2022-02-07,6368,6368,4824,1544,42576,42590,32303,10287,450,49,49,87,2622,2622,2573,2573
Glenn,8,2022-02-07,113,113,88,25,620,620,488,132,4,3,3,0,50,50,47,47
Humboldt,8,2022-02-07,467,467,371,96,4875,4875,3874,1001,15,1,1,2,136,136,135,135
Imperial,8,2022-02-07,1094,1094,850,244,7941,7942,6175,1767,46,12,12,26,907,907,895,895
Inyo,8,2022-02-07,38,38,30,8,447,447,361,86,5,0,0,0,56,56,56,56
Kern,8,2022-02-07,3475,3475,2813,662,34658,34669,28098,6571,190,32,32,43,2238,2238,2206,2206
Kings,8,2022-02-07,1351,1351,1051,300,10246,10249,7977,2272,52,14,14,5,419,419,405,405
Lake,8,2022-02-07,351,351,265,86,2625,2625,1985,640,11,1,1,5,128,128,127,127
Lassen,8,2022-02-07,140,140,115,25,3023,3023,2487,536,5,2,2,0,57,57,55,55
Los Angeles,8,2022-02-07,37329,37341,34584,2757,1151460,1151824,1067247,84577,2155,638,638,547,30302,30302,29664,29664
Madera,8,2022-02-07,1060,1060,802,258,8081,8082,6119,1963,38,4,4,9,362,362,358,358
Marin,8,2022-02-07,656,656,500,156,11291,11295,8620,2675,29,8,8,6,281,281,273,273
Mariposa,8,2022-02-07,51,51,38,13,579,579,431,148,0,0,0,0,24,24,24,24
Mendocino,8,2022-02-07,327,327,229,98,2817,2817,1974,843,12,2,2,5,116,116,114,114
Merced,8,2022-02-07,1210,1210,974,236,8063,8064,6492,1572,53,13,13,12,771,771,758,758
Modoc,8,2022-02-07,25,25,20,5,219,219,179,40,3,0,0,0,7,7,7,7
Mono,8,2022-02-07,44,44,29,15,271,271,178,93,0,0,0,0,5,5,5,5
Monterey,8,2022-02-07,2222,2222,1475,747,22460,22466,14942,7524,68,11,11,14,689,689,678,678
Napa,8,2022-02-07,740,740,610,130,7766,7767,6397,1370,16,6,6,2,130,130,124,124
Nevada,8,2022-02-07,357,357,271,86,3187,3187,2429,758,24,3,3,1,122,122,119,119
Orange,8,2022-02-07,6397,6397,5393,1004,152283,152331,128477,23854,494,118,118,125,6754,6754,6636,6636
Placer,8,2022-02-07,1293,1293,959,334,11886,11891,8834,3057,148,22,22,34,587,587,565,565
Plumas,8,2022-02-07,79,79,60,19,521,521,399,122,1,1,1,0,13,13,12,12
Riverside,8,2022-02-07,8140,8141,6509,1632,93427,93457,74797,18660,548,107,107,116,6205,6205,6098,6098
Sacramento,8,2022-02-07,6071,6071,4780,1291,63990,64010,50445,13565,390,71,71,95,2865,2865,2794,2794
San Benito,8,2022-02-07,312,312,256,56,2660,2660,2184,476,3,0,0,4,90,90,90,90
San Bernardino,8,2022-02-07,7045,7045,5859,1186,90087,90115,75012,15103,528,140,140,156,7427,7427,7287,7287
San Diego,8,2022-02-07,13647,13652,12593,1059,151884,151933,140215,11718,773,116,116,169,5063,5063,4947,4947
San Francisco,8,2022-02-07,2409,2409,1553,856,55776,55794,35923,19871,171,25,25,40,793,793,768,768
San Joaquin,8,2022-02-07,3339,3339,2574,765,36540,36553,28228,8325,186,42,42,62,2147,2147,2105,2105
San Luis Obispo,8,2022-02-07,1203,1203,978,225,12341,12346,10046,2300,23,16,16,7,429,429,413,413
San Mateo,8,2022-02-07,2461,2461,2073,388,62131,62151,52369,9782,83,16,16,18,667,667,651,651
Santa Barbara,8,2022-02-07,2282,2282,1814,468,30723,30732,24440,6292,75,15,15,17,651,651,636,636
Santa Clara,8,2022-02-07,8036,8037,7379,658,175346,175402,161079,14323,377,31,31,74,2181,2181,2150,2150
Santa Cruz,8,2022-02-07,1900,1900,1560,340,38681,38691,31772,6919,28,4,4,5,250,250,246,246
Shasta,8,2022-02-07,673,673,531,142,6857,6858,5414,1444,64,15,15,10,504,504,489,489
Siskiyou,8,2022-02-07,91,91,75,16,720,720,595,125,10,2,2,0,72,72,70,70
Solano,8,2022-02-07,2238,2238,1784,454,24209,24216,19351,4865,91,5,5,28,433,433,428,428
Sonoma,8,2022-02-07,2083,2083,1674,409,27050,27057,21738,5319,57,7,7,11,470,470,463,463
Stanislaus,8,2022-02-07,2491,2491,1792,699,18735,18740,13503,5237,243,43,43,43,1584,1584,1541,1541
Sutter,8,2022-02-07,360,360,286,74,3305,3305,2631,674,0,5,5,0,214,214,209,209
Tehama,8,2022-02-07,282,282,205,77,1644,1644,1197,447,17,3,3,6,184,184,181,181
Trinity,8,2022-02-07,18,18,13,5,136,136,98,38,0,0,0,0,20,20,20,20
Tulare,8,2022-02-07,2694,2694,1926,768,17911,17917,12838,5079,130,26,26,21,1407,1407,1381,1381
Tuolumne,8,2022-02-07,348,348,263,85,2576,2576,1953,623,10,2,2,1,168,168,166,166
Ventura,8,2022-02-07,2695,2695,2301,394,42326,42340,36177,6163,207,40,40,45,1406,1406,1366,1366
Yolo,8,2022-02-07,863,863,705,158,30855,30867,25188,5679,12,11,11,6,336,336,325,325
Yuba,8,2022-02-07,333,333,269,64,2405,2405,1942,463,42,4,4,13,115,115,111,111
Alameda,9,2022-02-14,3408,3408,2946,462,98994,99036,85645,13391,190,40,40,48,1788,1788,1748,1748
Amador,9,2022-02-14,109,109,87,22,2345,2345,1866,479,8,3,3,3,81,81,78,78
Butte,9,2022-02-14,464,464,412,52,5317,5318,4721,597,64,10,10,9,404,404,394,394
Calaveras,9,2022-02-14,78,78,64,14,1161,1161,949,212,4,2,2,2,108,108,106,106
Colusa,9,2022-02-14,35,35,29,6,406,406,341,65,5,0,0,0,21,21,21,21
Contra Costa,9,2022-02-14,2402,2402,1902,500,44861,44880,35556,9324,123,23,23,31,1246,1246,1223,1223
Del Norte,9,2022-02-14,209,209,174,35,3338,3338,2775,563,6,0,0,3,44,44,44,44
El Dorado,9,2022-02-14,259,259,212,47,4432,4432,3631,801,21,4,4,3,203,203,199,199
Fresno,9,2022-02-14,3859,3859,3089,770,34929,34943,27984,6959,375,32,32,75,2654,2654,2622,2622
Glenn,9,2022-02-14,58,58,48,10,482,482,398,84,3,1,1,0,51,51,50,50
Humboldt,9,2022-02-14,331,331,275,56,4202,4202,3495,707,23,0,0,2,136,136,136,136
Imperial,9,2022-02-14,587,587,479,108,5962,5963,4872,1091,44,14,14,18,921,921,907,907
Inyo,9,2022-02-14,29,29,24,5,413,413,348,65,3,0,0,0,56,56,56,56
Kern,9,2022-02-14,2013,2013,1700,313,27232,27244,23021,4223,156,28,28,40,2266,2266,2238,2238
Kings,9,2022-02-14,772,772,631,141,8001,8004,6550,1454,43,8,8,5,427,427,419,419
Lake,9,2022-02-14,256,256,205,51,2307,2307,1842,465,6,2,2,5,130,130,128,128
Lassen,9,2022-02-14,154,154,132,22,2789,2789,2383,406,3,2,2,0,59,59,57,57
Los Angeles,9,2022-02-14,21425,21436,20183,1253,1052385,1052832,991464,61368,1572,490,490,423,30792,30792,30302,30302
Madera,9,2022-02-14,619,619,495,124,6463,6466,5168,1298,29,2,2,7,364,364,362,362
Marin,9,2022-02-14,383,383,309,74,10150,10155,8177,1978,23,5,5,4,286,286,281,281
Mariposa,9,2022-02-14,24,24,19,5,434,434,342,92,0,0,0,0,24,24,24,24
Mendocino,9,2022-02-14,207,207,155,52,2445,2445,1834,611,13,1,1,7,117,117,116,116
Merced,9,2022-02-14,747,747,629,118,6834,6836,5748,1088,37,13,13,8,784,784,771,771
Modoc,9,2022-02-14,16,16,13,3,124,124,104,20,0,0,0,0,7,7,7,7
Mono,9,2022-02-14,10,10,7,3,179,179,127,52,0,0,0,0,5,5,5,5
Monterey,9,2022-02-14,1227,1227,880,347,16949,16955,12158,4797,48,12,12,12,701,701,689,689
Napa,9,2022-02-14,399,399,342,57,6577,6579,5637,942,10,1,1,1,131,131,130,130
Nevada,9,2022-02-14,169,169,136,33,2568,2568,2066,502,19,1,1,5,123,123,122,122
Orange,9,2022-02-14,4000,4000,3495,505,132322,132377,115599,16778,354,115,115,77,6869,6869,6754,6754
Placer,9,2022-02-14,593,593,466,127,9966,9971,7847,2124,105,12,12,23,599,599,587,587
Plumas,9,2022-02-14,43,43,35,8,431,431,348,83,1,0,0,0,13,13,13,13
Riverside,9,2022-02-14,4605,4605,3853,752,74750,74782,62591,12191,400,85,85,86,6290,6290,6205,6205
Sacramento,9,2022-02-14,3420,3420,2826,594,53019,53041,43845,9196,349,59,59,66,2924,2924,2865,2865
San Benito,9,2022-02-14,158,158,135,23,2159,2159,1845,314,0,1,1,3,91,91,90,90
San Bernardino,9,2022-02-14,3698,3698,3194,504,72754,72784,62896,9888,338,117,117,128,7544,7544,7427,7427
San Diego,9,2022-02-14,8091,8095,7596,499,126079,126133,118418,7715,589,87,87,135,5150,5150,5063,5063
San Francisco,9,2022-02-14,1612,1612,1125,487,47599,47618,33274,14344,130,25,25,39,818,818,793,793
San Joaquin,9,2022-02-14,1983,1983,1610,373,30652,30665,24918,5747,123,37,37,53,2184,2184,2147,2147
San Luis Obispo,9,2022-02-14,798,798,677,121,10050,10055,8533,1522,24,9,9,7,438,438,429,429
San Mateo,9,2022-02-14,1345,1345,1174,171,55007,55029,48026,7003,63,16,16,11,683,683,667,667
Santa Barbara,9,2022-02-14,1056,1056,880,176,22481,22490,18760,3730,68,8,8,14,659,659,651,651
Santa Clara,9,2022-02-14,4637,4637,4336,301,155255,155321,145237,10084,296,27,27,59,2208,2208,2181,2181
Santa Cruz,9,2022-02-14,980,980,837,143,30369,30381,25930,4451,23,3,3,4,253,253,250,250
Shasta,9,2022-02-14,443,443,366,77,5851,5852,4842,1010,62,13,13,13,517,517,504,504
Siskiyou,9,2022-02-14,66,66,57,9,520,520,447,73,7,1,1,2,73,73,72,72
Solano,9,2022-02-14,1201,1201,1003,198,18982,18990,15877,3113,73,2,2,20,435,435,433,433
Sonoma,9,2022-02-14,1135,1135,953,182,21174,21183,17768,3415,55,8,8,7,478,478,470,470
Stanislaus,9,2022-02-14,1362,1362,1044,318,15076,15081,11572,3509,206,28,28,41,1612,1612,1584,1584
Sutter,9,2022-02-14,229,229,191,38,2862,2862,2386,476,0,3,3,0,217,217,214,214
Tehama,9,2022-02-14,180,180,139,41,1404,1404,1088,316,15,5,5,5,189,189,184,184
Trinity,9,2022-02-14,22,22,17,5,171,171,131,40,0,0,0,0,20,20,20,20
Tulare,9,2022-02-14,1477,1477,1126,351,15050,15055,11503,3552,116,25,25,19,1432,1432,1407,1407
Tuolumne,9,2022-02-14,193,193,154,39,2222,2222,1778,444,12,4,4,1,172,172,168,168
Ventura,9,2022-02-14,1512,1512,1334,178,35526,35541,31359,4182,141,36,36,26,1442,1442,1406,1406
Yolo,9,2022-02-14,478,478,406,72,26817,26829,22796,4033,10,7,7,3,343,343,336,336
Yuba,9,2022-02-14,220,220,185,35,2109,2109,1777,332,19,0,0,11,115,115,115,115
Alameda,10,2022-02-21,1929,1929,1719,210,77634,77674,69096,8578,138,27,27,26,1815,1815,1788,1788
Amador,10,2022-02-21,70,70,58,12,1921,1921,1598,323,7,3,3,3,84,84,81,81
Butte,10,2022-02-21,255,255,232,23,4426,4426,4027,399,63,12,12,4,416,416,404,404
Calaveras,10,2022-02-21,44,44,37,7,838,838,712,126,3,6,6,0,114,114,108,108
Colusa,10,2022-02-21,26,26,23,3,362,362,315,47,4,0,0,0,21,21,21,21
Contra Costa,10,2022-02-21,1304,1304,1081,223,34146,34165,28283,5882,66,17,17,30,1263,1263,1246,1246
Del Norte,10,2022-02-21,128,128,111,17,2704,2705,2330,375,8,0,0,1,44,44,44,44
El Dorado,10,2022-02-21,155,155,132,23,3612,3612,3078,534,8,1,1,5,204,204,203,203
Fresno,10,2022-02-21,2008,2008,1680,328,26906,26921,22521,4400,272,26,26,54,2680,2680,2654,2654
Glenn,10,2022-02-21,28,28,24,4,405,405,348,57,2,1,1,0,52,52,51,51
Humboldt,10,2022-02-21,193,193,166,27,3331,3331,2873,458,22,3,3,1,139,139,136,136
Imperial,10,2022-02-21,393,393,335,58,4756,4757,4048,709,31,6,6,10,927,927,921,921
Inyo,10,2022-02-21,10,10,9,1,326,326,284,42,1,0,0,0,56,56,56,56
Kern,10,2022-02-21,1284,1284,1123,161,24323,24336,21275,3061,95,23,23,25,2289,2289,2266,2266
Kings,10,2022-02-21,454,454,387,67,6543,6546,5579,967,32,4,4,5,431,431,427,427
Lake,10,2022-02-21,184,184,154,30,1935,1935,1614,321,7,2,2,1,132,132,130,130
Lassen,10,2022-02-21,111,111,98,13,2135,2135,1883,252,1,0,0,0,59,59,59,59
Los Angeles,10,2022-02-21,11804,11810,11263,547,832196,832627,793581,39046,997,322,322,279,31114,31114,30792,30792
Madera,10,2022-02-21,316,316,264,52,5176,5178,4317,861,27,2,2,7,366,366,364,364
Marin,10,2022-02-21,198,198,166,32,8845,8849,7429,1420,13,3,3,4,289,289,286,286
Mariposa,10,2022-02-21,23,23,19,4,372,372,307,65,0,1,1,0,25,25,24,24
Mendocino,10,2022-02-21,113,113,90,23,1942,1942,1539,403,9,2,2,3,119,119,117,117
Merced,10,2022-02-21,429,429,373,56,5162,5164,4493,671,26,10,10,7,794,794,784,784
Modoc,10,2022-02-21,9,9,8,1,65,65,57,8,2,0,0,0,7,7,7,7
Mono,10,2022-02-21,7,7,5,2,162,162,123,39,0,1,1,0,6,6,5,5
Monterey,10,2022-02-21,778,778,594,184,12977,12984,9899,3085,47,5,5,7,706,706,701,701
Napa,10,2022-02-21,229,229,202,27,4985,4987,4407,580,6,4,4,3,135,135,131,131
Nevada,10,2022-02-21,102,102,85,17,1985,1985,1665,320,16,2,2,5,125,125,123,123
Orange,10,2022-02-21,2461,2461,2211,250,110415,110471,99072,11399,256,79,79,69,6948,6948,6869,6869
Placer,10,2022-02-21,324,324,267,57,8678,8683,7161,1522,92,9,9,13,608,608,599,599
Plumas,10,2022-02-21,21,21,18,3,328,328,276,52,0,0,0,0,13,13,13,13
Riverside,10,2022-02-21,2434,2434,2111,323,61413,61445,53301,8144,262,53,53,61,6343,6343,6290,6290
Sacramento,10,2022-02-21,1958,1958,1680,278,42786,42807,36715,6092,249,33,33,47,2957,2957,2924,2924
San Benito,10,2022-02-21,105,105,92,13,1697,1697,1495,202,0,0,0,1,91,91,91,91
San Bernardino,10,2022-02-21,1902,1902,1694,208,60246,60277,53652,6625,251,82,82,78,7626,7626,7544,7544
San Diego,10,2022-02-21,4626,4626,4401,225,100588,100640,95737,4903,468,61,61,106,5211,5211,5150,5150
San Francisco,10,2022-02-21,975,975,730,245,40355,40375,30122,10253,98,11,11,24,829,829,818,818
San Joaquin,10,2022-02-21,1047,1047,886,161,23854,23868,20186,3682,91,25,25,31,2209,2209,2184,2184
San Luis Obispo,10,2022-02-21,440,440,385,55,7650,7655,6708,947,16,16,16,3,454,454,438,438
San Mateo,10,2022-02-21,694,694,623,71,42574,42595,38178,4417,47,8,8,8,691,691,683,683
Santa Barbara,10,2022-02-21,609,609,526,83,19195,19205,16586,2619,40,6,6,10,665,665,659,659
Santa Clara,10,2022-02-21,2509,2509,2380,129,120310,120374,114082,6292,224,25,25,53,2233,2233,2208,2208
Santa Cruz,10,2022-02-21,578,578,509,69,25013,25026,22026,3000,21,1,1,4,254,254,253,253
Shasta,10,2022-02-21,259,259,222,37,4976,4979,4278,701,46,9,9,10,526,526,517,517
Siskiyou,10,2022-02-21,47,47,42,5,450,450,398,52,6,4,4,1,77,77,73,73
Solano,10,2022-02-21,697,697,604,93,15115,15123,13104,2019,51,5,5,15,440,440,435,435
Sonoma,10,2022-02-21,628,628,546,82,16819,16827,14606,2221,36,2,2,8,480,480,478,478
Stanislaus,10,2022-02-21,730,730,589,141,11755,11760,9490,2270,168,29,29,30,1641,1641,1612,1612
Sutter,10,2022-02-21,121,121,105,16,2108,2108,1821,287,0,2,2,0,219,219,217,217
Tehama,10,2022-02-21,96,96,78,18,1219,1219,993,226,8,10,10,2,199,199,189,189
Trinity,10,2022-02-21,15,15,12,3,199,199,160,39,0,0,0,0,20,20,20,20
Tulare,10,2022-02-21,775,775,623,152,10925,10930,8788,2142,86,15,15,9,1447,1447,1432,1432
Tuolumne,10,2022-02-21,107,107,90,17,1784,1784,1491,293,2,6,6,2,178,178,172,172
Ventura,10,2022-02-21,886,886,802,84,27542,27557,24939,2618,107,22,22,22,1464,1464,1442,1442
Yolo,10,2022-02-21,282,282,248,34,20977,20988,18408,2580,7,6,6,3,349,349,343,343
Yuba,10,2022-02-21,134,134,117,17,1679,1679,1466,213,22,1,1,8,116,116,115,115
Alameda,11,2022-02-28,1475,1475,1348,127,78762,78808,71978,6830,113,17,17,23,1832,1832,1815,1815
Amador,11,2022-02-28,56,56,48,8,2077,2077,1796,281,7,0,0,2,84,84,84,84
Butte,11,2022-02-28,188,188,175,13,4475,4477,4158,319,45,6,6,4,422,422,416,416
Calaveras,11,2022-02-28,40,40,35,5,1254,1254,1105,149,0,3,3,0,117,117,114,114
Colusa,11,2022-02-28,10,10,9,1,406,406,364,42,5,0,0,0,21,21,21,21
Contra Costa,11,2022-02-28,934,934,805,129,35019,35039,30211,4828,56,15,15,19,1278,1278,1263,1263
Del Norte,11,2022-02-28,84,84,75,9,2876,2877,2558,319,5,3,3,2,47,47,44,44
El Dorado,11,2022-02-28,106,106,94,12,3686,3686,3252,434,5,2,2,3,206,206,204,204
Fresno,11,2022-02-28,1312,1312,1140,172,26365,26381,22920,3461,196,28,28,44,2708,2708,2680,2680
Glenn,11,2022-02-28,18,18,16,2,435,435,386,49,1,0,0,0,52,52,52,52
Humboldt,11,2022-02-28,157,157,140,17,2956,2956,2632,324,6,1,1,1,140,140,139,139
Imperial,11,2022-02-28,264,264,233,31,4783,4785,4212,573,13,6,6,10,933,933,927,927
Inyo,11,2022-02-28,10,10,9,1,379,379,341,38,0,0,0,0,56,56,56,56
Kern,11,2022-02-28,791,791,712,79,24602,24617,22163,2454,77,16,16,16,2305,2305,2289,2289
Kings,11,2022-02-28,246,246,216,30,6079,6083,5359,724,19,7,7,3,438,438,431,431
Lake,11,2022-02-28,110,110,95,15,1956,1956,1695,261,0,4,4,1,136,136,132,132
Lassen,11,2022-02-28,44,44,40,4,2097,2097,1899,198,1,2,2,0,61,61,59,59
Los Angeles,11,2022-02-28,8214,8219,7921,298,1057293,1057926,1019365,38561,753,222,222,174,31336,31336,31114,31114
Madera,11,2022-02-28,189,189,164,25,4623,4625,4014,611,20,2,2,6,368,368,366,366
Marin,11,2022-02-28,160,160,140,20,7664,7669,6685,984,13,3,3,3,292,292,289,289
Mariposa,11,2022-02-28,29,29,25,4,347,347,298,49,0,1,1,0,26,26,25,25
Mendocino,11,2022-02-28,84,84,70,14,1889,1889,1571,318,11,2,2,2,121,121,119,119
Merced,11,2022-02-28,285,285,256,29,5030,5032,4510,522,25,7,7,5,801,801,794,794
Modoc,11,2022-02-28,6,6,5,1,57,57,51,6,1,0,0,0,7,7,7,7
Mono,11,2022-02-28,5,5,4,1,169,169,136,33,0,0,0,0,6,6,6,6
Monterey,11,2022-02-28,355,355,286,69,14336,14343,11566,2777,28,9,9,5,715,715,706,706
Napa,11,2022-02-28,194,194,176,18,5593,5598,5083,515,8,3,3,2,138,138,135,135
Nevada,11,2022-02-28,70,70,61,9,2016,2016,1753,263,9,0,0,1,125,125,125,125
Orange,11,2022-02-28,1685,1685,1548,137,126369,126444,116175,10269,198,42,42,35,6990,6990,6948,6948
Placer,11,2022-02-28,250,250,215,35,8419,8424,7236,1188,65,4,4,13,612,612,608,608
Plumas,11,2022-02-28,23,23,20,3,370,370,323,47,0,0,0,0,13,13,13,13
Riverside,11,2022-02-28,1686,1686,1507,179,63262,63299,56599,6700,185,37,37,35,6380,6380,6343,6343
Sacramento,11,2022-02-28,1162,1162,1031,131,45696,45723,40538,5185,163,24,24,35,2981,2981,2957,2957
San Benito,11,2022-02-28,55,55,50,5,1809,1809,1638,171,0,0,0,1,91,91,91,91
San Bernardino,11,2022-02-28,1174,1174,1072,102,61093,61130,55807,5323,157,60,60,45,7686,7686,7626,7626
San Diego,11,2022-02-28,3035,3035,2919,116,100025,100086,96280,3806,341,37,37,83,5248,5248,5211,5211
San Francisco,11,2022-02-28,835,835,662,173,40065,40089,31761,8328,74,16,16,19,845,845,829,829
San Joaquin,11,2022-02-28,658,658,577,81,26100,26117,22891,3226,58,11,11,24,2220,2220,2209,2209
San Luis Obispo,11,2022-02-28,378,378,341,37,8504,8509,7676,833,9,5,5,2,459,459,454,454
San Mateo,11,2022-02-28,597,597,549,48,41439,41464,38109,3355,33,4,4,7,695,695,691,691
Santa Barbara,11,2022-02-28,369,369,329,40,21385,21399,19075,2324,36,5,5,10,670,670,665,665
Santa Clara,11,2022-02-28,1730,1730,1660,70,103090,103152,99030,4122,191,22,22,46,2255,2255,2233,2233
Santa Cruz,11,2022-02-28,459,459,416,43,27974,27991,25359,2632,20,2,2,4,256,256,254,254
Shasta,11,2022-02-28,167,167,148,19,4925,4928,4375,553,36,11,11,8,537,537,526,526
Siskiyou,11,2022-02-28,25,25,23,2,475,475,432,43,4,2,2,1,79,79,77,77
Solano,11,2022-02-28,476,476,425,51,15314,15323,13695,1628,47,3,3,17,443,443,440,440
Sonoma,11,2022-02-28,454,454,407,47,16950,16960,15194,1766,28,3,3,5,483,483,480,480
Stanislaus,11,2022-02-28,476,476,401,75,13361,13369,11282,2087,124,11,11,21,1652,1652,1641,1641
Sutter,11,2022-02-28,107,107,95,12,2333,2333,2079,254,0,2,2,0,221,221,219,219
Tehama,11,2022-02-28,60,60,51,9,1221,1221,1039,182,7,1,1,2,200,200,199,199
Trinity,11,2022-02-28,5,5,4,1,118,118,99,19,0,0,0,0,20,20,20,20
Tulare,11,2022-02-28,462,462,389,73,11876,11883,9996,1887,67,15,15,9,1462,1462,1447,1447
Tuolumne,11,2022-02-28,67,67,58,9,1486,1486,1291,195,6,3,3,1,181,181,178,178
Ventura,11,2022-02-28,548,548,507,41,29889,29908,27666,2242,75,10,10,11,1474,1474,1464,1464
Yolo,11,2022-02-28,207,207,187,20,26246,26262,23715,2547,4,5,5,6,354,354,349,349
Yuba,11,2022-02-28,75,75,67,8,1711,1711,1537,174,12,1,1,6,117,117,116,116
Alameda,12,2022-03-07,1094,1094,1019,75,72386,72437,67450,4987,77,12,12,16,1844,1844,1832,1832
Amador,12,2022-03-07,75,75,67,8,1428,1428,1274,154,6,2,2,1,86,86,84,84
Butte,12,2022-03-07,98,98,92,6,3638,3639,3435,204,33,4,4,3,426,426,422,422
Calaveras,12,2022-03-07,25,25,23,2,1048,1048,948,100,1,1,1,0,118,118,117,117
Colusa,12,2022-03-07,9,9,8,1,355,355,326,29,6,0,0,0,21,21,21,21
Contra Costa,12,2022-03-07,628,628,559,69,30970,30991,27564,3427,47,8,8,13,1286,1286,1278,1278
Del Norte,12,2022-03-07,50,50,46,4,1779,1779,1624,155,7,0,0,1,47,47,47,47
El Dorado,12,2022-03-07,77,77,70,7,3200,3201,2900,301,5,3,3,2,209,209,206,206
Fresno,12,2022-03-07,858,858,768,90,22259,22275,19942,2333,145,18,18,27,2726,2726,2708,2708
Glenn,12,2022-03-07,19,19,17,2,395,395,359,36,2,1,1,0,53,53,52,52
Humboldt,12,2022-03-07,81,81,74,7,3045,3045,2779,266,10,3,3,4,143,143,140,140
Imperial,12,2022-03-07,122,122,110,12,4481,4484,4056,428,16,5,5,10,938,938,933,933
Inyo,12,2022-03-07,10,10,9,1,269,269,247,22,0,0,0,0,56,56,56,56
Kern,12,2022-03-07,433,433,398,35,20833,20847,19197,1650,67,12,12,16,2317,2317,2305,2305
Kings,12,2022-03-07,201,201,182,19,4986,4990,4517,473,13,4,4,2,442,442,438,438
Lake,12,2022-03-07,64,64,57,7,1760,1760,1572,188,2,2,2,1,138,138,136,136
Lassen,12,2022-03-07,95,95,88,7,1889,1889,1748,141,0,1,1,0,62,62,61,61
Los Angeles,12,2022-03-07,5534,5538,5381,157,876053,876661,851721,24940,573,171,171,133,31507,31507,31336,31336
Madera,12,2022-03-07,133,133,119,14,3916,3918,3504,414,15,1,1,2,369,369,368,368
Marin,12,2022-03-07,154,154,138,16,7558,7563,6782,781,10,1,1,2,293,293,292,292
Mariposa,12,2022-03-07,11,11,10,1,296,296,263,33,0,1,1,0,27,27,26,26
Mendocino,12,2022-03-07,65,65,56,9,1643,1643,1418,225,6,0,0,2,121,121,121,121
Merced,12,2022-03-07,173,173,159,14,4537,4541,4166,375,17,7,7,5,808,808,801,801
Modoc,12,2022-03-07,0,0,0,0,54,54,50,4,0,0,0,0,7,7,7,7
Mono,12,2022-03-07,2,2,2,0,128,128,108,20,0,0,0,1,6,6,6,6
Monterey,12,2022-03-07,245,245,206,39,11053,11060,9330,1730,19,5,5,2,720,720,715,715
Napa,12,2022-03-07,199,199,185,14,4874,4878,4522,356,2,1,1,2,139,139,138,138
Nevada,12,2022-03-07,50,50,45,5,1750,1750,1568,182,0,1,1,0,126,126,125,125
Orange,12,2022-03-07,1252,1252,1172,80,107332,107406,100504,6902,138,29,29,28,7019,7019,6990,6990
Placer,12,2022-03-07,162,162,144,18,7796,7801,6919,882,54,3,3,11,615,615,612,612
Plumas,12,2022-03-07,7,7,6,1,266,266,239,27,0,0,0,0,13,13,13,13
Riverside,12,2022-03-07,982,982,899,83,53630,53667,49150,4517,125,26,26,30,6406,6406,6380,6380
Sacramento,12,2022-03-07,774,774,704,70,40206,40233,36610,3623,124,18,18,28,2999,2999,2981,2981
San Benito,12,2022-03-07,41,41,38,3,1525,1525,1411,114,0,2,2,1,93,93,91,91
San Bernardino,12,2022-03-07,792,792,737,55,53305,53342,49663,3679,95,43,43,38,7729,7729,7686,7686
San Diego,12,2022-03-07,2337,2337,2267,70,96661,96729,93843,2886,237,31,31,57,5279,5279,5248,5248
San Francisco,12,2022-03-07,699,699,581,118,37418,37445,31084,6361,62,5,5,11,850,850,845,845
San Joaquin,12,2022-03-07,438,438,395,43,21202,21218,19137,2081,33,9,9,19,2229,2229,2220,2220
San Luis Obispo,12,2022-03-07,245,245,226,19,7300,7305,6740,565,7,5,5,1,464,464,459,459
San Mateo,12,2022-03-07,529,529,495,34,40057,40085,37496,2589,30,2,2,3,697,697,695,695
Santa Barbara,12,2022-03-07,203,203,186,17,17714,17727,16198,1529,15,4,4,8,674,674,670,670
Santa Clara,12,2022-03-07,1466,1466,1420,46,112125,112202,108630,3572,128,13,13,38,2268,2268,2255,2255
Santa Cruz,12,2022-03-07,334,334,309,25,24974,24991,23131,1860,11,0,0,7,256,256,256,256
Shasta,12,2022-03-07,140,140,127,13,4940,4943,4500,443,24,8,8,3,545,545,537,537
Siskiyou,12,2022-03-07,12,12,11,1,399,399,370,29,2,1,1,0,80,80,79,79
Solano,12,2022-03-07,352,352,322,30,14071,14081,12888,1193,46,2,2,10,445,445,443,443
Sonoma,12,2022-03-07,320,320,293,27,14920,14930,13692,1238,26,3,3,6,486,486,483,483
Stanislaus,12,2022-03-07,276,276,241,35,10854,10861,9502,1359,94,10,10,13,1662,1662,1652,1652
Sutter,12,2022-03-07,79,79,72,7,1908,1908,1742,166,0,1,1,0,222,222,221,221
Tehama,12,2022-03-07,40,40,35,5,1115,1115,980,135,5,2,2,1,202,202,200,200
Trinity,12,2022-03-07,4,4,3,1,114,114,100,14,0,0,0,0,20,20,20,20
Tulare,12,2022-03-07,303,303,264,39,10283,10289,8980,1309,37,13,13,3,1475,1475,1462,1462
Tuolumne,12,2022-03-07,48,48,43,5,1253,1253,1122,131,2,0,0,1,181,181,181,181
Ventura,12,2022-03-07,417,417,392,25,26717,26735,25154,1581,45,4,4,11,1478,1478,1474,1474
Yolo,12,2022-03-07,160,160,148,12,22153,22170,20465,1705,3,2,2,2,356,356,354,354
Yuba,12,2022-03-07,59,59,54,5,1552,1552,1425,127,13,0,0,6,117,117,117,117
Alameda,13,2022-03-14,880,880,832,48,68948,68999,65245,3754,64,9,9,6,1853,1853,1844,1844
Amador,13,2022-03-14,32,32,29,3,1439,1439,1315,124,4,0,0,0,86,86,86,86
Butte,13,2022-03-14,82,82,78,4,3592,3594,3434,160,24,1,1,0,427,427,426,426
Calaveras,13,2022-03-14,17,17,16,1,990,990,914,76,1,1,1,1,119,119,118,118
Colusa,13,2022-03-14,4,4,4,0,257,257,240,17,4,0,0,0,21,21,21,21
Contra Costa,13,2022-03-14,565,565,515,50,29141,29163,26592,2571,19,5,5,9,1291,1291,1286,1286
Del Norte,13,2022-03-14,31,31,29,2,1415,1415,1317,98,1,2,2,1,49,49,47,47
El Dorado,13,2022-03-14,44,44,41,3,2980,2981,2758,223,4,1,1,0,210,210,209,209
Fresno,13,2022-03-14,521,521,477,44,21169,21185,19415,1770,120,10,10,20,2736,2736,2726,2726
Glenn,13,2022-03-14,11,11,10,1,342,342,318,24,1,0,0,0,53,53,53,53
Humboldt,13,2022-03-14,56,56,52,4,2651,2651,2466,185,3,1,1,2,144,144,143,143
Imperial,13,2022-03-14,75,75,69,6,4551,4555,4207,348,5,2,2,7,940,940,938,938
Inyo,13,2022-03-14,6,6,6,0,165,165,154,11,0,0,0,0,56,56,56,56
Kern,13,2022-03-14,301,301,282,19,20273,20290,19019,1271,42,14,14,12,2331,2331,2317,2317
Kings,13,2022-03-14,155,155,143,12,4695,4699,4345,354,17,1,1,2,443,443,442,442
Lake,13,2022-03-14,48,48,44,4,1570,1570,1436,134,1,1,1,0,139,139,138,138
Lassen,13,2022-03-14,5,5,5,0,1515,1515,1426,89,0,0,0,0,62,62,62,62
Los Angeles,13,2022-03-14,4055,4058,3968,90,845621,846262,827394,18868,412,116,116,91,31623,31623,31507,31507
Madera,13,2022-03-14,52,52,48,4,3575,3577,3274,303,12,0,0,2,369,369,369,369
Marin,13,2022-03-14,170,170,156,14,6532,6537,6001,536,7,1,1,0,294,294,293,293
Mariposa,13,2022-03-14,9,9,8,1,222,222,202,20,0,0,0,0,27,27,27,27
Mendocino,13,2022-03-14,34,34,30,4,1434,1434,1276,158,4,2,2,1,123,123,121,121
Merced,13,2022-03-14,134,134,125,9,4167,4170,3898,272,17,2,2,4,810,810,808,808
Modoc,13,2022-03-14,3,3,3,0,52,52,49,3,1,0,0,0,7,7,7,7
Mono,13,2022-03-14,2,2,2,0,118,118,103,15,0,0,0,0,6,6,6,6
Monterey,13,2022-03-14,155,155,135,20,10113,10120,8841,1279,14,4,4,2,724,724,720,720
Napa,13,2022-03-14,120,120,113,7,4104,4107,3870,237,6,1,1,3,140,140,139,139
Nevada,13,2022-03-14,50,50,46,4,1571,1571,1441,130,2,0,0,0,126,126,126,126
Orange,13,2022-03-14,821,821,779,42,101559,101636,96478,5158,109,31,31,31,7050,7050,7019,7019
Placer,13,2022-03-14,150,150,136,14,7318,7323,6661,662,45,3,3,5,618,618,615,615
Plumas,13,2022-03-14,4,4,4,0,317,317,291,26,0,0,0,0,13,13,13,13
Riverside,13,2022-03-14,737,737,688,49,52736,52776,49257,3519,87,15,15,16,6421,6421,6406,6406
Sacramento,13,2022-03-14,588,588,546,42,35138,35165,32640,2525,122,16,16,22,3015,3015,2999,2999
San Benito,13,2022-03-14,36,36,34,2,1461,1461,1374,87,0,0,0,1,93,93,93,93
San Bernardino,13,2022-03-14,566,566,535,31,51684,51724,48902,2822,68,26,26,32,7755,7755,7729,7729
San Diego,13,2022-03-14,1842,1842,1799,43,96065,96139,93883,2256,174,17,17,47,5296,5296,5279,5279
San Francisco,13,2022-03-14,608,608,525,83,34320,34347,29623,4724,28,7,7,7,857,857,850,850
San Joaquin,13,2022-03-14,269,269,248,21,18877,18892,17405,1487,28,7,7,11,2236,2236,2229,2229
San Luis Obispo,13,2022-03-14,162,162,152,10,6664,6669,6259,410,7,7,7,1,471,471,464,464
San Mateo,13,2022-03-14,441,441,419,22,35833,35860,34025,1835,27,0,0,3,697,697,697,697
Santa Barbara,13,2022-03-14,195,195,182,13,16859,16873,15713,1160,16,7,7,2,681,681,674,674
Santa Clara,13,2022-03-14,1176,1176,1147,29,99875,99950,97450,2500,108,12,12,28,2280,2280,2268,2268
Santa Cruz,13,2022-03-14,239,239,225,14,22176,22192,20884,1308,10,3,3,3,259,259,256,256
Shasta,13,2022-03-14,97,97,90,7,4838,4841,4494,347,16,5,5,2,550,550,545,545
Siskiyou,13,2022-03-14,9,9,8,1,370,370,349,21,0,3,3,0,83,83,80,80
Solano,13,2022-03-14,221,221,206,15,12303,12313,11484,829,34,1,1,6,446,446,445,445
Sonoma,13,2022-03-14,229,229,214,15,13399,13410,12524,886,14,1,1,4,487,487,486,486
Stanislaus,13,2022-03-14,216,216,194,22,9401,9407,8459,948,82,11,11,17,1673,1673,1662,1662
Sutter,13,2022-03-14,41,41,38,3,1815,1815,1689,126,0,0,0,0,222,222,222,222
Tehama,13,2022-03-14,17,17,15,2,981,981,886,95,2,3,3,0,205,205,202,202
Trinity,13,2022-03-14,3,3,3,0,96,96,86,10,0,0,0,0,20,20,20,20
Tulare,13,2022-03-14,172,172,154,18,9301,9307,8354,953,33,0,0,6,1475,1475,1475,1475
Tuolumne,13,2022-03-14,22,22,20,2,1246,1246,1142,104,1,0,0,0,181,181,181,181
Ventura,13,2022-03-14,326,326,311,15,24591,24610,23458,1152,37,6,6,7,1484,1484,1478,1478
Yolo,13,2022-03-14,118,118,111,7,21621,21638,20319,1319,1,3,3,2,359,359,356,356
Yuba,13,2022-03-14,35,35,33,2,1417,1417,1325,92,10,0,0,3,117,117,117,117
Alameda,14,2022-03-21,718,718,687,31,65826,65882,63047,2835,58,7,7,3,1860,1860,1853,1853
Amador,14,2022-03-21,29,29,27,2,1356,1356,1263,93,2,0,0,0,86,86,86,86
Butte,14,2022-03-21,81,81,78,3,3158,3159,3049,110,17,0,0,2,427,427,427,427
Calaveras,14,2022-03-21,8,8,8,0,657,657,618,39,0,0,0,0,119,119,119,119
Colusa,14,2022-03-21,3,3,3,0,231,231,219,12,2,0,0,0,21,21,21,21
Contra Costa,14,2022-03-21,466,466,434,32,26931,26954,25060,1894,27,7,7,9,1298,1298,1291,1291
Del Norte,14,2022-03-21,19,19,18,1,1192,1192,1127,65,0,0,0,0,49,49,49,49
El Dorado,14,2022-03-21,45,45,42,3,2813,2814,2648,166,1,2,2,0,212,212,210,210
Fresno,14,2022-03-21,348,348,325,23,19379,19395,18108,1287,97,11,11,12,2747,2747,2736,2736
Glenn,14,2022-03-21,7,7,7,0,366,366,345,21,1,0,0,0,53,53,53,53
Humboldt,14,2022-03-21,31,31,29,2,2456,2456,2322,134,5,1,1,2,145,145,144,144
Imperial,14,2022-03-21,59,59,55,4,3965,3969,3730,239,4,3,3,4,943,943,940,940
Inyo,14,2022-03-21,1,1,1,0,148,148,140,8,0,0,0,0,56,56,56,56
Kern,14,2022-03-21,206,206,196,10,19489,19505,18539,966,34,4,4,9,2335,2335,2331,2331
Kings,14,2022-03-21,79,79,74,5,4411,4415,4151,264,7,1,1,1,444,444,443,443
Lake,14,2022-03-21,18,18,17,1,1365,1365,1272,93,0,0,0,0,139,139,139,139
Lassen,14,2022-03-21,10,10,10,0,1388,1388,1323,65,0,0,0,0,62,62,62,62
Los Angeles,14,2022-03-21,4130,4135,4064,71,822835,823529,809145,14384,338,76,76,66,31699,31699,31623,31623
Madera,14,2022-03-21,40,40,37,3,3392,3395,3167,228,9,1,1,1,370,370,369,369
Marin,14,2022-03-21,133,133,124,9,6231,6236,5829,407,6,1,1,0,295,295,294,294
Mariposa,14,2022-03-21,7,7,6,1,236,236,219,17,0,0,0,0,27,27,27,27
Mendocino,14,2022-03-21,28,28,26,2,1508,1508,1376,132,4,0,0,1,123,123,123,123
Merced,14,2022-03-21,87,87,82,5,3771,3775,3580,195,13,5,5,1,815,815,810,810
Modoc,14,2022-03-21,2,2,2,0,60,60,57,3,0,0,0,0,7,7,7,7
Mono,14,2022-03-21,4,4,4,0,134,134,120,14,1,0,0,0,6,6,6,6
Monterey,14,2022-03-21,152,152,137,15,10087,10094,9069,1025,22,0,0,1,724,724,724,724
Napa,14,2022-03-21,54,54,52,2,3451,3454,3297,157,6,1,1,2,141,141,140,140
Nevada,14,2022-03-21,18,18,17,1,1528,1528,1428,100,2,0,0,0,126,126,126,126
Orange,14,2022-03-21,753,753,723,30,96133,96214,92358,3856,100,12,12,25,7062,7062,7050,7050
Placer,14,2022-03-21,111,111,103,8,6475,6480,6015,465,40,2,2,6,620,620,618,618
Plumas,14,2022-03-21,2,2,2,0,228,228,213,15,0,0,0,0,13,13,13,13
Riverside,14,2022-03-21,617,617,584,33,51895,51939,49180,2759,69,13,13,18,6434,6434,6421,6421
Sacramento,14,2022-03-21,461,461,435,26,32984,33011,31138,1873,89,13,13,13,3028,3028,3015,3015
San Benito,14,2022-03-21,19,19,18,1,1385,1385,1320,65,0,1,1,0,94,94,93,93
San Bernardino,14,2022-03-21,473,473,453,20,49316,49359,47226,2133,49,20,20,31,7775,7775,7755,7755
San Diego,14,2022-03-21,1372,1372,1347,25,84591,84663,83106,1557,146,14,14,39,5310,5310,5296,5296
San Francisco,14,2022-03-21,685,685,610,75,33568,33596,29881,3715,34,3,3,3,860,860,857,857
San Joaquin,14,2022-03-21,222,222,208,14,15680,15694,14721,973,23,6,6,6,2242,2242,2236,2236
San Luis Obispo,14,2022-03-21,107,107,102,5,6416,6421,6108,313,3,5,5,0,476,476,471,471
San Mateo,14,2022-03-21,367,367,352,15,34927,34956,33551,1405,30,1,1,1,698,698,697,697
Santa Barbara,14,2022-03-21,161,161,152,9,14298,14311,13521,790,17,5,5,4,686,686,681,681
Santa Clara,14,2022-03-21,1099,1099,1078,21,95230,95309,93442,1867,101,5,5,20,2285,2285,2280,2280
Santa Cruz,14,2022-03-21,184,184,175,9,20037,20053,19117,936,8,0,0,3,259,259,259,259
Shasta,14,2022-03-21,42,42,40,2,4136,4139,3905,234,10,6,6,2,556,556,550,550
Siskiyou,14,2022-03-21,9,9,9,0,370,370,353,17,1,0,0,0,83,83,83,83
Solano,14,2022-03-21,187,187,177,10,11754,11764,11139,625,17,1,1,5,447,447,446,446
Sonoma,14,2022-03-21,228,228,216,12,12377,12388,11736,652,15,2,2,2,489,489,487,487
Stanislaus,14,2022-03-21,142,142,131,11,8426,8432,7756,676,59,12,12,8,1685,1685,1673,1673
Sutter,14,2022-03-21,35,35,33,2,1479,1479,1399,80,0,1,1,0,223,223,222,222
Tehama,14,2022-03-21,10,10,9,1,926,926,854,72,2,0,0,0,205,205,205,205
Trinity,14,2022-03-21,0,0,0,0,111,111,102,9,0,0,0,0,20,20,20,20
Tulare,14,2022-03-21,111,111,102,9,8166,8172,7505,667,27,5,5,4,1480,1480,1475,1475
Tuolumne,14,2022-03-21,19,19,18,1,1131,1131,1055,76,2,0,0,0,181,181,181,181
Ventura,14,2022-03-21,289,289,278,11,23283,23303,22443,860,30,5,5,6,1489,1489,1484,1484
Yolo,14,2022-03-21,107,107,102,5,21433,21451,20412,1039,1,0,0,1,359,359,359,359
Yuba,14,2022-03-21,42,42,40,2,1318,1318,1251,67,8,0,0,2,117,117,117,117
Alameda,15,2022-03-28,927,927,896,31,59265,59323,57322,2001,35,4,4,5,1864,1864,1860,1860
Amador,15,2022-03-28,8,8,8,0,1376,1376,1301,75,3,0,0,0,86,86,86,86
Butte,15,2022-03-28,65,65,63,2,2853,2855,2777,78,11,0,0,1,427,427,427,427
Calaveras,15,2022-03-28,15,15,14,1,580,580,553,27,0,0,0,0,119,119,119,119
Colusa,15,2022-03-28,4,4,4,0,207,207,199,8,0,0,0,0,21,21,21,21
Contra Costa,15,2022-03-28,533,533,504,29,24906,24931,23548,1383,29,1,1,6,1299,1299,1298,1298
Del Norte,15,2022-03-28,16,16,15,1,1038,1038,993,45,1,0,0,0,49,49,49,49
El Dorado,15,2022-03-28,60,60,57,3,2810,2811,2680,131,0,0,0,0,212,212,212,212
Fresno,15,2022-03-28,274,274,260,14,17945,17961,17019,942,71,5,5,18,2752,2752,2747,2747
Glenn,15,2022-03-28,8,8,8,0,333,333,318,15,0,0,0,0,53,53,53,53
Humboldt,15,2022-03-28,27,27,26,1,2608,2609,2496,113,4,0,0,3,145,145,145,145
Imperial,15,2022-03-28,62,62,59,3,3535,3538,3370,168,4,1,1,3,944,944,943,943
Inyo,15,2022-03-28,4,4,4,0,186,186,178,8,1,0,0,0,56,56,56,56
Kern,15,2022-03-28,144,144,138,6,18179,18197,17487,710,17,4,4,8,2339,2339,2335,2335
Kings,15,2022-03-28,56,56,53,3,4275,4280,4078,202,6,2,2,0,446,446,444,444
Lake,15,2022-03-28,10,10,9,1,1068,1068,1010,58,0,0,0,0,139,139,139,139
Lassen,15,2022-03-28,4,4,4,0,1284,1284,1236,48,0,0,0,0,62,62,62,62
Los Angeles,15,2022-03-28,4472,4477,4416,61,703824,704489,694753,9736,264,52,52,57,31751,31751,31699,31699
Madera,15,2022-03-28,24,24,23,1,3451,3454,3271,183,4,0,0,2,370,370,370,370
Marin,15,2022-03-28,179,179,170,9,6000,6005,5697,308,3,0,0,0,295,295,295,295
Mariposa,15,2022-03-28,5,5,5,0,179,179,169,10,0,1,1,0,28,28,27,27
Mendocino,15,2022-03-28,31,31,29,2,1314,1314,1223,91,0,1,1,0,124,124,123,123
Merced,15,2022-03-28,65,65,62,3,3360,3362,3226,136,5,1,1,3,816,816,815,815
Modoc,15,2022-03-28,3,3,3,0,45,45,43,2,0,0,0,0,7,7,7,7
Mono,15,2022-03-28,1,1,1,0,134,134,123,11,0,0,0,0,6,6,6,6
Monterey,15,2022-03-28,148,148,136,12,8782,8790,8076,714,14,1,1,0,725,725,724,724
Napa,15,2022-03-28,67,67,65,2,3329,3332,3213,119,1,2,2,1,143,143,141,141
Nevada,15,2022-03-28,27,27,26,1,1431,1431,1357,74,1,1,1,0,127,127,126,126
Orange,15,2022-03-28,813,813,788,25,90211,90296,87457,2839,81,12,12,17,7074,7074,7062,7062
Placer,15,2022-03-28,107,107,101,6,6222,6229,5876,353,26,4,4,6,624,624,620,620
Plumas,15,2022-03-28,3,3,3,0,267,267,253,14,0,0,0,0,13,13,13,13
Riverside,15,2022-03-28,521,521,500,21,43926,43967,42134,1833,47,7,7,10,6441,6441,6434,6434
Sacramento,15,2022-03-28,457,457,437,20,32473,32504,31053,1451,68,6,6,19,3034,3034,3028,3028
San Benito,15,2022-03-28,14,14,13,1,1365,1365,1315,50,0,0,0,0,94,94,94,94
San Bernardino,15,2022-03-28,543,543,525,18,41305,41344,39946,1398,40,18,18,24,7793,7793,7775,7775
San Diego,15,2022-03-28,1325,1325,1306,19,72132,72200,71164,1036,114,9,9,26,5319,5319,5310,5310
San Francisco,15,2022-03-28,842,842,769,73,32804,32835,29938,2897,23,5,5,5,865,865,860,860
San Joaquin,15,2022-03-28,190,190,181,9,17500,17517,16661,856,20,4,4,4,2246,2246,2242,2242
San Luis Obispo,15,2022-03-28,96,96,92,4,5701,5706,5488,218,5,1,1,1,477,477,476,476
San Mateo,15,2022-03-28,582,582,564,18,33959,33992,32916,1076,26,3,3,3,701,701,698,698
Santa Barbara,15,2022-03-28,135,135,129,6,10222,10232,9800,432,15,1,1,4,687,687,686,686
Santa Clara,15,2022-03-28,1273,1273,1254,19,95188,95278,93825,1453,88,10,10,18,2295,2295,2285,2285
Santa Cruz,15,2022-03-28,145,145,140,5,19692,19711,18993,718,3,0,0,2,259,259,259,259
Shasta,15,2022-03-28,34,34,32,2,3879,3882,3709,173,7,2,2,3,558,558,556,556
Siskiyou,15,2022-03-28,5,5,5,0,292,292,282,10,0,0,0,0,83,83,83,83
Solano,15,2022-03-28,169,169,162,7,10934,10945,10488,457,18,0,0,6,447,447,447,447
Sonoma,15,2022-03-28,259,259,249,10,8553,8560,8213,347,13,0,0,1,489,489,489,489
Stanislaus,15,2022-03-28,116,116,109,7,8182,8189,7670,519,28,2,2,3,1687,1687,1685,1685
Sutter,15,2022-03-28,25,25,24,1,1490,1490,1426,64,0,1,1,0,224,224,223,223
Tehama,15,2022-03-28,13,13,12,1,798,798,749,49,3,1,1,0,206,206,205,205
Trinity,15,2022-03-28,0,0,0,0,79,79,74,5,0,0,0,0,20,20,20,20
Tulare,15,2022-03-28,80,80,75,5,7838,7844,7336,508,20,6,6,1,1486,1486,1480,1480
Tuolumne,15,2022-03-28,7,7,7,0,1083,1083,1026,57,3,1,1,0,182,182,181,181
Ventura,15,2022-03-28,334,334,324,10,21204,21223,20608,615,23,5,5,3,1494,1494,1489,1489
Yolo,15,2022-03-28,103,103,99,4,20514,20535,19771,764,3,2,2,0,361,361,359,359
Yuba,15,2022-03-28,26,26,25,1,1214,1214,1165,49,2,2,2,1,119,119,117,117
Alameda,16,2022-04-04,1058,1058,1031,27,56224,56282,54786,1496,40,3,3,3,1867,1867,1864,1864
Amador,16,2022-04-04,2,2,2,0,1107,1107,1060,47,1,0,0,0,86,86,86,86
Butte,16,2022-04-04,44,44,43,1,2582,2584,2528,56,8,2,2,1,429,429,427,427
Calaveras,16,2022-04-04,8,8,8,0,588,588,566,22,0,0,0,0,119,119,119,119
Colusa,16,2022-04-04,2,2,2,0,202,202,196,6,0,0,0,0,21,21,21,21
Contra Costa,16,2022-04-04,542,542,519,23,23556,23581,22545,1036,13,1,1,4,1300,1300,1299,1299
Del Norte,16,2022-04-04,8,8,8,0,1118,1118,1080,38,0,0,0,1,49,49,49,49
El Dorado,16,2022-04-04,49,49,47,2,2717,2720,2620,100,0,1,1,1,213,213,212,212
Fresno,16,2022-04-04,188,188,180,8,16847,16865,16169,696,62,4,4,12,2756,2756,2752,2752
Glenn,16,2022-04-04,3,3,3,0,287,287,277,10,0,0,0,0,53,53,53,53
Humboldt,16,2022-04-04,22,22,21,1,2385,2386,2304,82,5,0,0,2,145,145,145,145
Imperial,16,2022-04-04,38,38,37,1,3451,3455,3326,129,3,0,0,2,944,944,944,944
Inyo,16,2022-04-04,9,9,9,0,182,182,176,6,0,0,0,0,56,56,56,56
Kern,16,2022-04-04,152,152,147,5,16751,16767,16252,515,16,2,2,7,2341,2341,2339,2339
Kings,16,2022-04-04,47,47,45,2,4178,4183,4027,156,2,0,0,1,446,446,446,446
Lake,16,2022-04-04,14,14,13,1,973,973,931,42,0,0,0,0,139,139,139,139
Lassen,16,2022-04-04,5,5,5,0,1284,1284,1247,37,0,0,0,0,62,62,62,62
Los Angeles,16,2022-04-04,5459,5466,5409,57,803345,804183,795566,8617,255,47,47,42,31798,31798,31751,31751
Madera,16,2022-04-04,27,27,26,1,3190,3193,3060,133,3,0,0,1,370,370,370,370
Marin,16,2022-04-04,167,167,160,7,6343,6349,6091,258,3,0,0,1,295,295,295,295
Mariposa,16,2022-04-04,7,7,7,0,235,235,225,10,0,0,0,0,28,28,28,28
Mendocino,16,2022-04-04,25,25,24,1,1196,1196,1130,66,2,0,0,0,124,124,124,124
Merced,16,2022-04-04,58,58,56,2,3350,3354,3247,107,2,2,2,0,818,818,816,816
Modoc,16,2022-04-04,4,4,4,0,43,43,42,1,0,0,0,0,7,7,7,7
Mono,16,2022-04-04,1,1,1,0,142,142,133,9,0,0,0,0,6,6,6,6
Monterey,16,2022-04-04,128,128,120,8,7487,7494,7014,480,8,3,3,0,728,728,725,725
Napa,16,2022-04-04,75,75,73,2,3146,3149,3060,89,1,0,0,1,143,143,143,143
Nevada,16,2022-04-04,30,30,29,1,1447,1447,1388,59,1,1,1,0,128,128,127,127
Orange,16,2022-04-04,987,987,963,24,81525,81610,79576,2034,56,17,17,14,7091,7091,7074,7074
Placer,16,2022-04-04,129,129,123,6,6693,6700,6401,299,19,1,1,5,625,625,624,624
Plumas,16,2022-04-04,4,4,4,0,235,235,225,10,0,0,0,0,13,13,13,13
Riverside,16,2022-04-04,693,693,671,22,38907,38948,37674,1274,36,5,5,8,6446,6446,6441,6441
Sacramento,16,2022-04-04,430,430,415,15,32889,32923,31766,1157,50,8,8,11,3042,3042,3034,3034
San Benito,16,2022-04-04,13,13,13,0,1187,1187,1153,34,0,0,0,0,94,94,94,94
San Bernardino,16,2022-04-04,611,611,595,16,42052,42096,40977,1119,32,11,11,13,7804,7804,7793,7793
San Diego,16,2022-04-04,1547,1547,1530,17,66684,66755,66011,744,88,7,7,29,5326,5326,5319,5319
San Francisco,16,2022-04-04,1000,1000,931,69,28766,28796,26785,2011,20,1,1,3,866,866,865,865
San Joaquin,16,2022-04-04,229,229,220,9,15673,15689,15085,604,9,2,2,8,2248,2248,2246,2246
San Luis Obispo,16,2022-04-04,99,99,96,3,5382,5387,5225,162,2,1,1,1,478,478,477,477
San Mateo,16,2022-04-04,723,723,705,18,29369,29401,28674,727,14,2,2,1,703,703,701,701
Santa Barbara,16,2022-04-04,187,187,181,6,15277,15292,14775,517,7,2,2,1,689,689,687,687
Santa Clara,16,2022-04-04,1492,1492,1474,18,88302,88395,87335,1060,89,2,2,18,2297,2297,2295,2295
Santa Cruz,16,2022-04-04,210,210,204,6,16701,16719,16229,490,4,0,0,2,259,259,259,259
Shasta,16,2022-04-04,29,29,28,1,3320,3324,3207,117,4,1,1,2,559,559,558,558
Siskiyou,16,2022-04-04,2,2,2,0,294,294,286,8,0,0,0,0,83,83,83,83
Solano,16,2022-04-04,172,172,166,6,10226,10237,9900,337,21,1,1,4,448,448,447,447
Sonoma,16,2022-04-04,329,329,319,10,10654,10666,10322,344,9,1,1,1,490,490,489,489
Stanislaus,16,2022-04-04,113,113,107,6,7960,7968,7570,398,21,3,3,5,1690,1690,1687,1687
Sutter,16,2022-04-04,24,24,23,1,1324,1324,1280,44,0,0,0,0,224,224,224,224
Tehama,16,2022-04-04,6,6,6,0,765,765,728,37,0,1,1,0,207,207,206,206
Trinity,16,2022-04-04,1,1,1,0,87,87,83,4,0,0,0,0,20,20,20,20
Tulare,16,2022-04-04,48,48,46,2,7736,7743,7347,396,13,3,3,0,1489,1489,1486,1486
Tuolumne,16,2022-04-04,9,9,9,0,1034,1034,991,43,1,1,1,0,183,183,182,182
Ventura,16,2022-04-04,300,300,293,7,20330,20350,19886,464,19,5,5,5,1499,1499,1494,1494
Yolo,16,2022-04-04,104,104,101,3,26255,26283,25496,787,0,0,0,0,361,361,361,361
Yuba,16,2022-04-04,11,11,11,0,1071,1071,1037,34,4,0,0,1,119,119,119,119
Alameda,17,2022-04-11,1493,1493,1463,30,49840,49896,48866,1030,51,6,6,2,1873,1873,1867,1867
Amador,17,2022-04-11,9,9,9,0,1068,1068,1032,36,1,0,0,0,86,86,86,86
Butte,17,2022-04-11,33,33,32,1,2262,2263,2225,38,3,0,0,1,429,429,429,429
Calaveras,17,2022-04-11,14,14,14,0,649,649,630,19,0,0,0,0,119,119,119,119
Colusa,17,2022-04-11,6,6,6,0,203,203,198,5,0,0,0,0,21,21,21,21
Contra Costa,17,2022-04-11,712,712,688,24,20839,20863,20153,710,15,1,1,5,1301,1301,1300,1300
Del Norte,17,2022-04-11,9,9,9,0,1012,1012,985,27,0,0,0,0,49,49,49,49
El Dorado,17,2022-04-11,48,48,47,1,2508,2510,2437,73,1,0,0,0,213,213,213,213
Fresno,17,2022-04-11,194,194,188,6,15778,15795,15280,515,54,3,3,6,2759,2759,2756,2756
Glenn,17,2022-04-11,2,2,2,0,258,258,251,7,0,0,0,0,53,53,53,53
Humboldt,17,2022-04-11,46,46,45,1,2347,2349,2286,63,5,1,1,2,146,146,145,145
Imperial,17,2022-04-11,28,28,27,1,3448,3452,3351,101,2,1,1,1,945,945,944,944
Inyo,17,2022-04-11,4,4,4,0,188,188,183,5,0,0,0,0,56,56,56,56
Kern,17,2022-04-11,135,135,132,3,16366,16384,15986,398,20,2,2,6,2343,2343,2341,2341
Kings,17,2022-04-11,31,31,30,1,4161,4166,4044,122,3,0,0,0,446,446,446,446
Lake,17,2022-04-11,22,22,21,1,869,869,840,29,0,0,0,0,139,139,139,139
Lassen,17,2022-04-11,1,1,1,0,1292,1292,1263,29,1,0,0,0,62,62,62,62
Los Angeles,17,2022-04-11,6732,6740,6685,55,675654,676400,670688,5712,234,46,46,36,31844,31844,31798,31798
Madera,17,2022-04-11,29,29,28,1,3076,3081,2980,101,4,0,0,2,370,370,370,370
Marin,17,2022-04-11,214,214,207,7,5551,5557,5381,176,6,0,0,1,295,295,295,295
Mariposa,17,2022-04-11,7,7,7,0,246,246,237,9,0,0,0,0,28,28,28,28
Mendocino,17,2022-04-11,32,32,31,1,1158,1158,1108,50,0,0,0,0,124,124,124,124
Merced,17,2022-04-11,69,69,67,2,3221,3226,3145,81,6,2,2,0,820,820,818,818
Modoc,17,2022-04-11,0,0,0,0,40,40,39,1,0,0,0,0,7,7,7,7
Mono,17,2022-04-11,9,9,9,0,170,170,161,9,0,0,0,0,6,6,6,6
Monterey,17,2022-04-11,109,109,103,6,6890,6896,6546,350,9,2,2,0,730,730,728,728
Napa,17,2022-04-11,120,120,117,3,2801,2805,2743,62,1,0,0,0,143,143,143,143
Nevada,17,2022-04-11,45,45,44,1,1431,1431,1385,46,2,0,0,0,128,128,128,128
Orange,17,2022-04-11,1162,1162,1140,22,62009,62078,60898,1180,70,8,8,16,7099,7099,7091,7091
Placer,17,2022-04-11,126,126,122,4,5632,5637,5438,199,18,2,2,2,627,627,625,625
Plumas,17,2022-04-11,6,6,6,0,247,247,239,8,0,0,0,0,13,13,13,13
Riverside,17,2022-04-11,727,727,709,18,37775,37817,36846,971,35,5,5,9,6451,6451,6446,6446
Sacramento,17,2022-04-11,507,507,493,14,30136,30170,29336,834,47,11,11,5,3053,3053,3042,3042
San Benito,17,2022-04-11,17,17,17,0,1182,1182,1155,27,0,0,0,0,94,94,94,94
San Bernardino,17,2022-04-11,911,911,892,19,42011,42058,41182,876,33,5,5,7,7809,7809,7804,7804
San Diego,17,2022-04-11,1833,1833,1817,16,74105,74187,73538,649,91,4,4,22,5330,5330,5326,5326
San Francisco,17,2022-04-11,1179,1179,1114,65,29897,29928,28270,1658,19,6,6,4,872,872,866,866
San Joaquin,17,2022-04-11,223,223,216,7,15224,15241,14779,462,10,0,0,1,2248,2248,2248,2248
San Luis Obispo,17,2022-04-11,120,120,117,3,4908,4913,4797,116,2,1,1,0,479,479,478,478
San Mateo,17,2022-04-11,858,858,842,16,30381,30415,29823,592,8,2,2,1,705,705,703,703
Santa Barbara,17,2022-04-11,303,303,295,8,15120,15137,14735,402,6,2,2,1,691,691,689,689
Santa Clara,17,2022-04-11,1662,1662,1647,15,81519,81609,80849,760,61,4,4,13,2301,2301,2297,2297
Santa Cruz,17,2022-04-11,326,326,319,7,10999,11010,10769,241,7,1,1,0,260,260,259,259
Shasta,17,2022-04-11,18,18,18,0,3123,3127,3040,87,2,1,1,1,560,560,559,559
Siskiyou,17,2022-04-11,1,1,1,0,340,340,332,8,0,0,0,0,83,83,83,83
Solano,17,2022-04-11,249,249,243,6,9416,9427,9183,244,16,0,0,1,448,448,448,448
Sonoma,17,2022-04-11,416,416,406,10,10686,10698,10427,271,8,1,1,0,491,491,490,490
Stanislaus,17,2022-04-11,124,124,119,5,7639,7648,7346,302,22,1,1,1,1691,1691,1690,1690
Sutter,17,2022-04-11,20,20,19,1,1237,1237,1204,33,0,1,1,0,225,225,224,224
Tehama,17,2022-04-11,9,9,9,0,753,753,724,29,1,0,0,0,207,207,207,207
Trinity,17,2022-04-11,0,0,0,0,77,77,74,3,0,0,0,0,20,20,20,20
Tulare,17,2022-04-11,54,54,52,2,7835,7843,7526,317,11,3,3,0,1492,1492,1489,1489
Tuolumne,17,2022-04-11,22,22,21,1,1062,1062,1027,35,1,0,0,0,183,183,183,183
Ventura,17,2022-04-11,323,323,317,6,17587,17606,17292,314,16,2,2,2,1501,1501,1499,1499
Yolo,17,2022-04-11,130,130,127,3,18073,18093,17673,420,1,0,0,0,361,361,361,361
Yuba,17,2022-04-11,15,15,15,0,1019,1019,994,25,2,0,0,0,119,119,119,119
Alameda,18,2022-04-18,1784,1784,1755,29,54176,54240,53357,883,42,4,4,4,1877,1877,1873,1873
Amador,18,2022-04-18,12,12,12,0,1194,1194,1162,32,2,0,0,0,86,86,86,86
Butte,18,2022-04-18,47,47,46,1,2268,2270,2240,30,5,2,2,0,431,431,429,429
Calaveras,18,2022-04-18,16,16,16,0,576,576,563,13,0,1,1,0,120,120,119,119
Colusa,18,2022-04-18,3,3,3,0,157,157,154,3,0,0,0,0,21,21,21,21
Contra Costa,18,2022-04-18,1047,1047,1019,28,24749,24778,24108,670,26,1,1,5,1302,1302,1301,1301
Del Norte,18,2022-04-18,12,12,12,0,1010,1010,989,21,0,0,0,0,49,49,49,49
El Dorado,18,2022-04-18,69,69,67,2,2455,2457,2402,55,0,0,0,0,213,213,213,213
Fresno,18,2022-04-18,246,246,240,6,13938,13955,13602,353,42,4,4,5,2763,2763,2759,2759
Glenn,18,2022-04-18,4,4,4,0,278,278,272,6,0,0,0,0,53,53,53,53
Humboldt,18,2022-04-18,106,106,104,2,2052,2053,2010,43,4,1,1,2,147,147,146,146
Imperial,18,2022-04-18,49,49,48,1,3219,3224,3149,75,2,0,0,1,945,945,945,945
Inyo,18,2022-04-18,2,2,2,0,164,164,161,3,0,0,0,0,56,56,56,56
Kern,18,2022-04-18,151,151,148,3,13634,13650,13392,258,9,1,1,5,2344,2344,2343,2343
Kings,18,2022-04-18,44,44,43,1,3580,3585,3503,82,3,1,1,1,447,447,446,446
Lake,18,2022-04-18,16,16,16,0,782,782,762,20,2,1,1,1,140,140,139,139
Lassen,18,2022-04-18,1,1,1,0,1340,1340,1316,24,0,0,0,0,62,62,62,62
Los Angeles,18,2022-04-18,8312,8320,8267,53,469199,469753,466778,2975,200,35,35,26,31879,31879,31844,31844
Madera,18,2022-04-18,23,23,22,1,2521,2524,2459,65,2,0,0,2,370,370,370,370
Marin,18,2022-04-18,322,322,314,8,5987,5993,5843,150,6,0,0,0,295,295,295,295
Mariposa,18,2022-04-18,18,18,18,0,248,248,241,7,0,0,0,0,28,28,28,28
Mendocino,18,2022-04-18,53,53,51,2,1285,1285,1241,44,0,1,1,0,125,125,124,124
Merced,18,2022-04-18,65,65,64,1,3047,3052,2992,60,3,2,2,0,822,822,820,820
Modoc,18,2022-04-18,1,1,1,0,40,40,39,1,0,0,0,0,7,7,7,7
Mono,18,2022-04-18,9,9,9,0,122,122,117,5,0,0,0,0,6,6,6,6
Monterey,18,2022-04-18,157,157,151,6,6522,6528,6268,260,2,1,1,0,731,731,730,730
Napa,18,2022-04-18,164,164,161,3,2853,2857,2808,49,1,0,0,0,143,143,143,143
Nevada,18,2022-04-18,41,41,40,1,1260,1260,1228,32,1,0,0,0,128,128,128,128
Orange,18,2022-04-18,1443,1443,1422,21,79759,79853,78644,1209,50,5,5,10,7104,7104,7099,7099
Placer,18,2022-04-18,162,162,158,4,4800,4805,4673,132,30,0,0,3,627,627,627,627
Plumas,18,2022-04-18,6,6,6,0,225,225,219,6,0,0,0,0,13,13,13,13
Riverside,18,2022-04-18,935,935,916,19,36719,36763,36022,741,36,7,7,7,6458,6458,6451,6451
Sacramento,18,2022-04-18,714,714,699,15,27853,27885,27284,601,47,9,9,8,3062,3062,3053,3053
San Benito,18,2022-04-18,24,24,24,0,1170,1170,1149,21,0,0,0,0,94,94,94,94
San Bernardino,18,2022-04-18,1059,1059,1042,17,40084,40132,39478,654,35,7,7,8,7816,7816,7809,7809
San Diego,18,2022-04-18,2047,2048,2034,14,67089,67169,66710,459,78,9,9,17,5339,5339,5330,5330
San Francisco,18,2022-04-18,1437,1437,1375,62,30566,30601,29262,1339,27,2,2,2,874,874,872,872
San Joaquin,18,2022-04-18,248,248,242,6,14726,14744,14393,351,8,1,1,4,2249,2249,2248,2248
San Luis Obispo,18,2022-04-18,180,180,177,3,4959,4965,4873,92,2,2,2,0,481,481,479,479
San Mateo,18,2022-04-18,1151,1151,1134,17,30636,30671,30207,464,15,2,2,2,707,707,705,705
Santa Barbara,18,2022-04-18,299,299,293,6,14686,14703,14397,306,8,0,0,0,691,691,691,691
Santa Clara,18,2022-04-18,2237,2238,2222,16,71272,71355,70833,522,67,4,4,16,2305,2305,2301,2301
Santa Cruz,18,2022-04-18,437,437,429,8,12234,12247,12032,215,3,0,0,1,260,260,260,260
Shasta,18,2022-04-18,33,33,32,1,2849,2852,2790,62,2,1,1,2,561,561,560,560
Siskiyou,18,2022-04-18,8,8,8,0,318,318,312,6,0,0,0,0,83,83,83,83
Solano,18,2022-04-18,253,253,248,5,9319,9331,9142,189,6,1,1,1,449,449,448,448
Sonoma,18,2022-04-18,502,502,492,10,11183,11196,10973,223,16,1,1,4,492,492,491,491
Stanislaus,18,2022-04-18,161,161,156,5,7666,7674,7435,239,15,0,0,3,1691,1691,1691,1691
Sutter,18,2022-04-18,24,24,24,0,1173,1173,1149,24,0,0,0,0,225,225,225,225
Tehama,18,2022-04-18,7,7,7,0,685,685,664,21,1,0,0,0,207,207,207,207
Trinity,18,2022-04-18,1,1,1,0,72,72,70,2,0,0,0,0,20,20,20,20
Tulare,18,2022-04-18,77,77,75,2,6658,6665,6454,211,13,0,0,0,1492,1492,1492,1492
Tuolumne,18,2022-04-18,26,26,25,1,1025,1025,999,26,1,0,0,0,183,183,183,183
Ventura,18,2022-04-18,367,367,362,5,16412,16430,16202,228,8,3,3,0,1504,1504,1501,1501
Yolo,18,2022-04-18,217,217,213,4,17917,17938,17609,329,2,1,1,0,362,362,361,361
Yuba,18,2022-04-18,28,28,27,1,996,996,977,19,1,0,0,1,119,119,119,119
Alameda,19,2022-04-25,2541,2542,2510,32,60894,60969,60201,768,44,6,6,4,1883,1883,1877,1877
Amador,19,2022-04-25,26,26,25,1,1316,1316,1289,27,0,0,0,0,86,86,86,86
Butte,19,2022-04-25,66,66,65,1,2597,2600,2573,27,5,1,1,1,432,432,431,431
Calaveras,19,2022-04-25,34,34,33,1,687,687,675,12,0,0,0,0,120,120,120,120
Colusa,19,2022-04-25,3,3,3,0,199,199,196,3,0,0,0,0,21,21,21,21
Contra Costa,19,2022-04-25,1508,1508,1476,32,27262,27295,26720,575,25,3,3,3,1305,1305,1302,1302
Del Norte,19,2022-04-25,25,25,25,0,1104,1104,1086,18,0,0,0,0,49,49,49,49
El Dorado,19,2022-04-25,103,103,101,2,2648,2651,2604,47,1,0,0,0,213,213,213,213
Fresno,19,2022-04-25,334,334,327,7,15893,15912,15595,317,34,3,3,2,2766,2766,2763,2763
Glenn,19,2022-04-25,4,4,4,0,287,287,282,5,0,0,0,0,53,53,53,53
Humboldt,19,2022-04-25,168,168,165,3,2853,2858,2811,47,2,0,0,2,147,147,147,147
Imperial,19,2022-04-25,65,65,64,1,3512,3517,3454,63,4,0,0,1,945,945,945,945
Inyo,19,2022-04-25,7,7,7,0,194,194,191,3,0,0,0,0,56,56,56,56
Kern,19,2022-04-25,251,251,247,4,18299,18322,18051,271,14,2,2,4,2346,2346,2344,2344
Kings,19,2022-04-25,54,54,53,1,4515,4520,4439,81,3,0,0,1,447,447,447,447
Lake,19,2022-04-25,21,21,21,0,887,887,869,18,0,0,0,0,140,140,140,140
Lassen,19,2022-04-25,1,1,1,0,1556,1557,1535,22,0,0,0,0,62,62,62,62
Los Angeles,19,2022-04-25,11361,11374,11317,57,884893,885973,881483,4490,207,29,29,25,31908,31908,31879,31879
Madera,19,2022-04-25,44,44,43,1,2916,2920,2861,59,2,0,0,0,370,370,370,370
Marin,19,2022-04-25,328,328,322,6,6439,6446,6320,126,7,0,0,0,295,295,295,295
Mariposa,19,2022-04-25,9,9,9,0,205,205,201,4,0,0,0,0,28,28,28,28
Mendocino,19,2022-04-25,55,55,54,1,1254,1254,1220,34,0,1,1,0,126,126,125,125
Merced,19,2022-04-25,100,100,98,2,3030,3035,2989,46,5,0,0,0,822,822,822,822
Modoc,19,2022-04-25,1,1,1,0,41,41,40,1,0,0,0,0,7,7,7,7
Mono,19,2022-04-25,4,4,4,0,94,94,91,3,0,0,0,0,6,6,6,6
Monterey,19,2022-04-25,321,321,311,10,8006,8017,7767,250,5,1,1,0,732,732,731,731
Napa,19,2022-04-25,199,199,196,3,3375,3380,3334,46,2,0,0,0,143,143,143,143
Nevada,19,2022-04-25,52,52,51,1,1399,1399,1371,28,1,0,0,1,128,128,128,128
Orange,19,2022-04-25,1970,1971,1948,23,86611,86717,85693,1024,53,7,7,13,7111,7111,7104,7104
Placer,19,2022-04-25,237,237,232,5,6091,6098,5966,132,18,0,0,4,627,627,627,627
Plumas,19,2022-04-25,2,2,2,0,228,228,223,5,0,0,0,0,13,13,13,13
Riverside,19,2022-04-25,1303,1303,1283,20,40531,40581,39941,640,33,4,4,5,6462,6462,6458,6458
Sacramento,19,2022-04-25,1023,1023,1006,17,31868,31907,31367,540,44,4,4,4,3066,3066,3062,3062
San Benito,19,2022-04-25,34,34,34,0,1118,1118,1102,16,0,0,0,0,94,94,94,94
San Bernardino,19,2022-04-25,1292,1292,1276,16,42974,43027,42479,548,21,10,10,7,7826,7826,7816,7816
San Diego,19,2022-04-25,3012,3017,3001,16,74321,74413,74017,396,86,5,5,10,5344,5344,5339,5339
San Francisco,19,2022-04-25,1997,1998,1930,68,32530,32569,31451,1118,23,1,1,3,875,875,874,874
San Joaquin,19,2022-04-25,390,390,383,7,15469,15488,15199,289,12,0,0,1,2249,2249,2249,2249
San Luis Obispo,19,2022-04-25,209,209,206,3,5036,5042,4969,73,6,0,0,0,481,481,481,481
San Mateo,19,2022-04-25,1538,1538,1520,18,32869,32908,32519,389,14,1,1,3,708,708,707,707
Santa Barbara,19,2022-04-25,371,371,365,6,15227,15246,14998,248,7,2,2,1,693,693,691,691
Santa Clara,19,2022-04-25,3142,3147,3129,18,77133,77226,76792,434,73,4,4,9,2309,2309,2305,2305
Santa Cruz,19,2022-04-25,474,474,468,6,20467,20491,20209,282,4,1,1,0,261,261,260,260
Shasta,19,2022-04-25,48,48,47,1,3317,3321,3265,56,3,0,0,1,561,561,561,561
Siskiyou,19,2022-04-25,7,7,7,0,322,322,318,4,0,0,0,0,83,83,83,83
Solano,19,2022-04-25,475,475,468,7,10612,10625,10457,168,11,0,0,2,449,449,449,449
Sonoma,19,2022-04-25,672,672,662,10,12062,12077,11889,188,19,0,0,2,492,492,492,492
Stanislaus,19,2022-04-25,240,240,234,6,7896,7906,7714,192,25,3,3,0,1694,1694,1691,1691
Sutter,19,2022-04-25,39,39,38,1,1399,1399,1376,23,0,1,1,0,226,226,225,225
Tehama,19,2022-04-25,17,17,17,0,711,711,694,17,1,0,0,0,207,207,207,207
Trinity,19,2022-04-25,1,1,1,0,72,72,70,2,0,0,0,0,20,20,20,20
Tulare,19,2022-04-25,90,90,88,2,6912,6919,6747,172,11,1,1,0,1493,1493,1492,1492
Tuolumne,19,2022-04-25,43,43,42,1,1124,1124,1101,23,2,0,0,0,183,183,183,183
Ventura,19,2022-04-25,604,604,597,7,18900,18923,18718,205,10,1,1,3,1505,1505,1504,1504
Yolo,19,2022-04-25,272,272,268,4,19380,19403,19125,278,1,0,0,0,362,362,362,362
Yuba,19,2022-04-25,31,31,31,0,1106,1106,1089,17,0,0,0,0,119,119,119,119
Alameda,20,2022-05-02,3378,3384,3351,33,68025,68112,67435,677,42,2,2,5,1885,1885,1883,1883
Amador,20,2022-05-02,19,19,19,0,1335,1335,1313,22,0,0,0,0,86,86,86,86
Butte,20,2022-05-02,90,90,89,1,2385,2388,2369,19,4,2,2,0,434,434,432,432
Calaveras,20,2022-05-02,23,23,23,0,725,725,715,10,0,0,0,0,120,120,120,120
Colusa,20,2022-05-02,2,2,2,0,203,203,201,2,0,0,0,0,21,21,21,21
Contra Costa,20,2022-05-02,1880,1880,1849,31,29258,29294,28810,484,40,2,2,5,1307,1307,1305,1305
Del Norte,20,2022-05-02,40,40,39,1,1202,1202,1187,15,1,0,0,0,49,49,49,49
El Dorado,20,2022-05-02,139,139,137,2,2756,2761,2723,38,1,1,1,0,214,214,213,213
Fresno,20,2022-05-02,499,499,491,8,16710,16731,16470,261,42,3,3,4,2769,2769,2766,2766
Glenn,20,2022-05-02,4,4,4,0,252,252,249,3,0,0,0,0,53,53,53,53
Humboldt,20,2022-05-02,268,268,265,3,2941,2946,2908,38,6,0,0,2,147,147,147,147
Imperial,20,2022-05-02,123,123,121,2,3645,3650,3598,52,1,0,0,1,945,945,945,945
Inyo,20,2022-05-02,2,2,2,0,179,179,177,2,0,0,0,0,56,56,56,56
Kern,20,2022-05-02,292,292,289,3,17932,17954,17746,208,10,0,0,5,2346,2346,2346,2346
Kings,20,2022-05-02,58,58,57,1,4847,4852,4784,68,3,0,0,1,447,447,447,447
Lake,20,2022-05-02,29,29,29,0,1003,1003,987,16,1,0,0,0,140,140,140,140
Lassen,20,2022-05-02,8,8,8,0,1608,1609,1591,18,0,0,0,0,62,62,62,62
Los Angeles,20,2022-05-02,14799,14819,14761,58,917588,918741,915094,3647,214,23,23,22,31931,31931,31908,31908
Madera,20,2022-05-02,75,75,74,1,3307,3311,3259,52,5,0,0,0,370,370,370,370
Marin,20,2022-05-02,427,427,421,6,6543,6551,6451,100,10,0,0,0,295,295,295,295
Mariposa,20,2022-05-02,7,7,7,0,244,244,240,4,0,0,0,0,28,28,28,28
Mendocino,20,2022-05-02,60,60,59,1,1222,1222,1196,26,0,0,0,0,126,126,126,126
Merced,20,2022-05-02,129,129,127,2,3283,3288,3249,39,8,4,4,0,826,826,822,822
Modoc,20,2022-05-02,0,0,0,0,36,37,36,1,0,0,0,0,7,7,7,7
Mono,20,2022-05-02,6,6,6,0,106,106,103,3,0,0,0,0,6,6,6,6
Monterey,20,2022-05-02,354,354,345,9,8385,8396,8190,206,8,1,1,0,733,733,732,732
Napa,20,2022-05-02,228,228,226,2,3546,3551,3513,38,4,0,0,0,143,143,143,143
Nevada,20,2022-05-02,80,80,79,1,1535,1536,1512,24,2,0,0,0,128,128,128,128
Orange,20,2022-05-02,2636,2639,2615,24,87486,87595,86785,810,61,5,5,13,7116,7116,7111,7111
Placer,20,2022-05-02,302,302,297,5,6372,6379,6271,108,20,0,0,4,627,627,627,627
Plumas,20,2022-05-02,9,9,9,0,256,256,252,4,0,0,0,0,13,13,13,13
Riverside,20,2022-05-02,2046,2047,2022,25,42957,43011,42481,530,37,3,3,5,6465,6465,6462,6462
Sacramento,20,2022-05-02,1390,1390,1372,18,33655,33698,33253,445,43,5,5,9,3071,3071,3066,3066
San Benito,20,2022-05-02,50,50,49,1,1285,1285,1271,14,0,0,0,0,94,94,94,94
San Bernardino,20,2022-05-02,1489,1489,1474,15,43531,43586,43152,434,30,7,7,6,7833,7833,7826,7826
San Diego,20,2022-05-02,4123,4129,4112,17,72928,73021,72718,303,79,3,3,13,5347,5347,5344,5344
San Francisco,20,2022-05-02,2421,2422,2357,65,35538,35582,34622,960,39,3,3,13,878,878,875,875
San Joaquin,20,2022-05-02,545,545,537,8,15179,15199,14978,221,14,1,1,1,2250,2250,2249,2249
San Luis Obispo,20,2022-05-02,249,249,246,3,5109,5115,5057,58,5,2,2,0,483,483,481,481
San Mateo,20,2022-05-02,1819,1819,1802,17,35989,36034,35700,334,22,2,2,5,710,710,708,708
Santa Barbara,20,2022-05-02,439,439,434,5,15309,15329,15134,195,10,0,0,2,693,693,693,693
Santa Clara,20,2022-05-02,4356,4363,4344,19,96569,96691,96262,429,88,5,5,15,2314,2314,2309,2309
Santa Cruz,20,2022-05-02,678,678,671,7,22027,22055,21817,238,2,1,1,0,262,262,261,261
Shasta,20,2022-05-02,68,68,67,1,3450,3454,3408,46,7,0,0,1,561,561,561,561
Siskiyou,20,2022-05-02,9,9,9,0,329,329,326,3,0,0,0,0,83,83,83,83
Solano,20,2022-05-02,622,622,614,8,11759,11774,11628,146,20,0,0,2,449,449,449,449
Sonoma,20,2022-05-02,899,899,888,11,12793,12809,12654,155,16,1,1,4,493,493,492,492
Stanislaus,20,2022-05-02,269,269,264,5,8083,8092,7938,154,22,0,0,3,1694,1694,1694,1694
Sutter,20,2022-05-02,47,47,46,1,1263,1263,1247,16,0,1,1,0,227,227,226,226
Tehama,20,2022-05-02,17,17,17,0,700,700,687,13,0,0,0,0,207,207,207,207
Trinity,20,2022-05-02,1,1,1,0,84,84,82,2,0,0,0,0,20,20,20,20
Tulare,20,2022-05-02,162,162,159,3,7286,7294,7152,142,10,3,3,0,1496,1496,1493,1493
Tuolumne,20,2022-05-02,93,93,92,1,1297,1297,1277,20,5,0,0,0,183,183,183,183
Ventura,20,2022-05-02,743,743,737,6,19918,19943,19774,169,15,4,4,1,1509,1509,1505,1505
Yolo,20,2022-05-02,352,352,348,4,18791,18815,18604,211,1,1,1,0,363,363,362,362
Yuba,20,2022-05-02,46,46,45,1,1052,1052,1040,12,2,0,0,1,119,119,119,119
Alameda,21,2022-05-09,4156,4163,4131,32,71485,71577,71022,555,44,7,7,6,1892,1892,1885,1885
Amador,21,2022-05-09,25,25,25,0,1518,1518,1499,19,0,0,0,0,86,86,86,86
Butte,21,2022-05-09,115,115,114,1,2412,2414,2399,15,5,0,0,0,434,434,434,434
Calaveras,21,2022-05-09,33,33,33,0,689,689,681,8,1,0,0,0,120,120,120,120
Colusa,21,2022-05-09,3,3,3,0,215,215,213,2,0,0,0,0,21,21,21,21
Contra Costa,21,2022-05-09,2516,2519,2487,32,30521,30561,30166,395,48,4,4,12,1311,1311,1307,1307
Del Norte,21,2022-05-09,49,49,49,0,1356,1356,1343,13,0,0,0,0,49,49,49,49
El Dorado,21,2022-05-09,178,178,176,2,2890,2895,2864,31,3,0,0,1,214,214,214,214
Fresno,21,2022-05-09,744,744,735,9,17853,17876,17658,218,29,1,1,1,2770,2770,2769,2769
Glenn,21,2022-05-09,8,8,8,0,228,228,226,2,0,0,0,0,53,53,53,53
Humboldt,21,2022-05-09,273,273,270,3,3149,3154,3122,32,5,0,0,2,147,147,147,147
Imperial,21,2022-05-09,131,131,130,1,3826,3831,3789,42,0,0,0,1,945,945,945,945
Inyo,21,2022-05-09,26,26,26,0,236,236,234,2,0,0,0,0,56,56,56,56
Kern,21,2022-05-09,467,467,463,4,18696,18721,18552,169,18,2,2,2,2348,2348,2346,2346
Kings,21,2022-05-09,91,91,90,1,4936,4941,4887,54,1,0,0,1,447,447,447,447
Lake,21,2022-05-09,30,30,30,0,1029,1029,1016,13,1,0,0,0,140,140,140,140
Lassen,21,2022-05-09,6,6,6,0,1689,1690,1676,14,0,0,0,0,62,62,62,62
Los Angeles,21,2022-05-09,18416,18440,18384,56,926867,928073,925205,2868,225,29,29,27,31960,31960,31931,31931
Madera,21,2022-05-09,132,132,130,2,3725,3730,3684,46,3,0,0,0,370,370,370,370
Marin,21,2022-05-09,711,711,703,8,7776,7788,7695,93,12,0,0,0,295,295,295,295
Mariposa,21,2022-05-09,32,32,32,0,287,287,283,4,0,0,0,0,28,28,28,28
Mendocino,21,2022-05-09,92,92,91,1,1264,1264,1243,21,0,1,1,0,127,127,126,126
Merced,21,2022-05-09,198,198,196,2,3430,3435,3403,32,4,1,1,0,827,827,826,826
Modoc,21,2022-05-09,2,2,2,0,41,42,41,1,0,0,0,0,7,7,7,7
Mono,21,2022-05-09,9,9,9,0,113,113,111,2,0,0,0,0,6,6,6,6
Monterey,21,2022-05-09,439,439,431,8,9377,9391,9210,181,11,0,0,0,733,733,733,733
Napa,21,2022-05-09,232,232,230,2,3119,3124,3098,26,2,0,0,0,143,143,143,143
Nevada,21,2022-05-09,101,101,100,1,1655,1656,1636,20,5,0,0,0,128,128,128,128
Orange,21,2022-05-09,3510,3515,3490,25,91768,91887,91224,663,84,8,8,17,7124,7124,7116,7116
Placer,21,2022-05-09,537,537,530,7,6753,6761,6671,90,25,0,0,2,627,627,627,627
Plumas,21,2022-05-09,13,13,13,0,274,274,271,3,0,0,0,0,13,13,13,13
Riverside,21,2022-05-09,2401,2403,2380,23,45140,45199,44763,436,42,4,4,8,6469,6469,6465,6465
Sacramento,21,2022-05-09,2255,2256,2233,23,36120,36166,35792,374,62,4,4,10,3075,3075,3071,3071
San Benito,21,2022-05-09,74,74,73,1,1433,1433,1421,12,0,0,0,0,94,94,94,94
San Bernardino,21,2022-05-09,1932,1933,1918,15,46592,46653,46290,363,31,5,5,4,7838,7838,7833,7833
San Diego,21,2022-05-09,5217,5224,5207,17,87126,87240,86956,284,98,2,2,11,5349,5349,5347,5347
San Francisco,21,2022-05-09,3046,3051,2987,64,38186,38236,37427,809,52,6,6,9,884,884,878,878
San Joaquin,21,2022-05-09,773,773,764,9,16051,16072,15889,183,11,1,1,3,2251,2251,2250,2250
San Luis Obispo,21,2022-05-09,289,289,286,3,5221,5227,5181,46,0,0,0,0,483,483,483,483
San Mateo,21,2022-05-09,2313,2314,2298,16,37694,37743,37470,273,26,3,3,1,713,713,710,710
Santa Barbara,21,2022-05-09,638,638,632,6,15589,15609,15454,155,10,0,0,3,693,693,693,693
Santa Clara,21,2022-05-09,5623,5630,5611,19,106177,106315,105947,368,87,3,3,23,2317,2317,2314,2314
Santa Cruz,21,2022-05-09,729,729,723,6,23980,24011,23809,202,2,0,0,0,262,262,262,262
Shasta,21,2022-05-09,106,106,105,1,3301,3306,3272,34,7,0,0,0,561,561,561,561
Siskiyou,21,2022-05-09,16,16,16,0,285,285,283,2,0,0,0,0,83,83,83,83
Solano,21,2022-05-09,917,917,908,9,12289,12305,12185,120,20,0,0,1,449,449,449,449
Sonoma,21,2022-05-09,1179,1179,1168,11,13974,13993,13860,133,18,1,1,2,494,494,493,493
Stanislaus,21,2022-05-09,460,460,453,7,8942,8955,8821,134,27,0,0,2,1694,1694,1694,1694
Sutter,21,2022-05-09,61,61,60,1,1565,1565,1549,16,0,0,0,0,227,227,227,227
Tehama,21,2022-05-09,28,28,28,0,692,692,682,10,1,0,0,0,207,207,207,207
Trinity,21,2022-05-09,4,4,4,0,69,69,68,1,0,0,0,0,20,20,20,20
Tulare,21,2022-05-09,184,184,181,3,7633,7642,7526,116,11,1,1,1,1497,1497,1496,1496
Tuolumne,21,2022-05-09,71,71,70,1,1429,1430,1413,17,1,2,2,0,185,185,183,183
Ventura,21,2022-05-09,1151,1151,1143,8,20949,20976,20837,139,15,1,1,2,1510,1510,1509,1509
Yolo,21,2022-05-09,492,492,488,4,19654,19678,19505,173,1,0,0,1,363,363,363,363
Yuba,21,2022-05-09,77,77,76,1,1241,1241,1229,12,2,0,0,0,119,119,119,119
Alameda,22,2022-05-16,5006,5013,4983,30,75025,75125,74670,455,73,8,8,6,1900,1900,1892,1892
Amador,22,2022-05-16,54,54,53,1,1672,1672,1655,17,0,0,0,0,86,86,86,86
Butte,22,2022-05-16,206,206,205,1,2664,2668,2655,13,7,2,2,0,436,436,434,434
Calaveras,22,2022-05-16,43,43,43,0,765,765,758,7,0,1,1,1,121,121,120,120
Colusa,22,2022-05-16,7,7,7,0,217,217,215,2,0,0,0,0,21,21,21,21
Contra Costa,22,2022-05-16,3481,3487,3452,35,33510,33556,33217,339,50,5,5,7,1316,1316,1311,1311
Del Norte,22,2022-05-16,172,172,171,1,1859,1861,1846,15,0,0,0,0,49,49,49,49
El Dorado,22,2022-05-16,267,267,265,2,3039,3044,3018,26,5,0,0,1,214,214,214,214
Fresno,22,2022-05-16,1139,1139,1128,11,19033,19058,18877,181,46,2,2,6,2772,2772,2770,2770
Glenn,22,2022-05-16,15,15,15,0,259,259,257,2,0,0,0,0,53,53,53,53
Humboldt,22,2022-05-16,274,274,272,2,3253,3258,3232,26,9,1,1,2,148,148,147,147
Imperial,22,2022-05-16,207,207,205,2,4276,4281,4244,37,1,0,0,1,945,945,945,945
Inyo,22,2022-05-16,19,19,19,0,228,228,226,2,1,0,0,0,56,56,56,56
Kern,22,2022-05-16,686,686,681,5,19977,20004,19863,141,22,3,3,3,2351,2351,2348,2348
Kings,22,2022-05-16,221,221,219,2,5418,5423,5377,46,0,0,0,0,447,447,447,447
Lake,22,2022-05-16,74,74,73,1,1118,1118,1107,11,2,0,0,0,140,140,140,140
Lassen,22,2022-05-16,20,20,20,0,1704,1705,1694,11,1,0,0,0,62,62,62,62
Los Angeles,22,2022-05-16,21399,21427,21376,51,938053,939306,937042,2264,283,38,38,44,31998,31998,31960,31960
Madera,22,2022-05-16,199,199,197,2,3632,3637,3602,35,2,0,0,0,370,370,370,370
Marin,22,2022-05-16,815,815,807,8,8382,8394,8315,79,12,0,0,0,295,295,295,295
Mariposa,22,2022-05-16,23,23,23,0,340,340,336,4,0,0,0,0,28,28,28,28
Mendocino,22,2022-05-16,99,99,98,1,1326,1326,1309,17,0,1,1,1,128,128,127,127
Merced,22,2022-05-16,316,316,314,2,4013,4018,3989,29,8,1,1,1,828,828,827,827
Modoc,22,2022-05-16,4,4,4,0,43,44,43,1,0,0,0,0,7,7,7,7
Mono,22,2022-05-16,11,11,11,0,112,112,110,2,0,0,0,0,6,6,6,6
Monterey,22,2022-05-16,509,509,501,8,9600,9614,9469,145,6,1,1,0,734,734,733,733
Napa,22,2022-05-16,299,299,297,2,3736,3741,3717,24,3,0,0,0,143,143,143,143
Nevada,22,2022-05-16,146,146,145,1,1833,1835,1818,17,2,0,0,0,128,128,128,128
Orange,22,2022-05-16,4545,4552,4527,25,94622,94749,94216,533,74,7,7,15,7131,7131,7124,7124
Placer,22,2022-05-16,738,738,730,8,7776,7789,7708,81,43,2,2,3,629,629,627,627
Plumas,22,2022-05-16,48,48,48,0,242,242,240,2,1,0,0,0,13,13,13,13
Riverside,22,2022-05-16,3342,3349,3324,25,47983,48047,47686,361,65,1,1,6,6470,6470,6469,6469
Sacramento,22,2022-05-16,3138,3143,3118,25,39841,39894,39572,322,89,8,8,12,3083,3083,3075,3075
San Benito,22,2022-05-16,110,110,109,1,1529,1529,1519,10,1,0,0,0,94,94,94,94
San Bernardino,22,2022-05-16,2466,2467,2452,15,49167,49232,48933,299,44,8,8,5,7846,7846,7838,7838
San Diego,22,2022-05-16,6664,6672,6655,17,94782,94909,94669,240,91,6,6,25,5355,5355,5349,5349
San Francisco,22,2022-05-16,3415,3420,3364,56,39360,39413,38759,654,68,5,5,8,889,889,884,884
San Joaquin,22,2022-05-16,1195,1195,1184,11,19012,19037,18868,169,16,1,1,1,2252,2252,2251,2251
San Luis Obispo,22,2022-05-16,425,425,422,3,6056,6062,6020,42,3,0,0,0,483,483,483,483
San Mateo,22,2022-05-16,2776,2781,2766,15,39915,39968,39743,225,39,1,1,1,714,714,713,713
Santa Barbara,22,2022-05-16,912,912,905,7,17041,17064,16932,132,13,0,0,2,693,693,693,693
Santa Clara,22,2022-05-16,7202,7211,7192,19,113210,113360,113054,306,111,9,9,15,2326,2326,2317,2317
Santa Cruz,22,2022-05-16,808,808,803,5,20748,20776,20636,140,5,0,0,0,262,262,262,262
Shasta,22,2022-05-16,126,126,125,1,3812,3817,3786,31,6,0,0,1,561,561,561,561
Siskiyou,22,2022-05-16,19,19,19,0,372,372,370,2,0,0,0,0,83,83,83,83
Solano,22,2022-05-16,1269,1269,1260,9,14155,14173,14066,107,29,0,0,2,449,449,449,449
Sonoma,22,2022-05-16,1568,1568,1557,11,15543,15563,15448,115,28,0,0,4,494,494,494,494
Stanislaus,22,2022-05-16,742,742,733,9,9945,9959,9843,116,33,2,2,5,1696,1696,1694,1694
Sutter,22,2022-05-16,109,109,108,1,1828,1830,1816,14,0,0,0,0,227,227,227,227
Tehama,22,2022-05-16,38,38,38,0,840,840,831,9,0,1,1,1,208,208,207,207
Trinity,22,2022-05-16,5,5,5,0,69,69,68,1,0,0,0,0,20,20,20,20
Tulare,22,2022-05-16,399,399,394,5,8317,8327,8228,99,14,1,1,0,1498,1498,1497,1497
Tuolumne,22,2022-05-16,139,139,138,1,1448,1449,1435,14,1,1,1,0,186,186,185,185
Ventura,22,2022-05-16,1552,1552,1544,8,23859,23892,23768,124,34,2,2,2,1512,1512,1510,1510
Yolo,22,2022-05-16,688,688,683,5,22151,22180,22028,152,0,0,0,1,363,363,363,363
Yuba,22,2022-05-16,119,119,118,1,1335,1335,1325,10,4,0,0,0,119,119,119,119
Alameda,23,2022-05-23,5611,5619,5593,26,77861,77968,77600,368,76,4,4,4,1904,1904,1900,1900
Amador,23,2022-05-23,80,80,79,1,1441,1441,1430,11,0,0,0,0,86,86,86,86
Butte,23,2022-05-23,284,284,283,1,2768,2772,2761,11,5,1,1,1,437,437,436,436
Calaveras,23,2022-05-23,52,52,52,0,743,743,738,5,0,1,1,0,122,122,121,121
Colusa,23,2022-05-23,7,7,7,0,232,232,231,1,0,0,0,0,21,21,21,21
Contra Costa,23,2022-05-23,3831,3837,3807,30,35365,35413,35133,280,71,10,10,7,1326,1326,1316,1316
Del Norte,23,2022-05-23,64,64,64,0,1346,1346,1338,8,0,1,1,0,50,50,49,49
El Dorado,23,2022-05-23,362,362,360,2,3418,3423,3400,23,6,2,2,0,216,216,214,214
Fresno,23,2022-05-23,1638,1638,1626,12,21382,21411,21252,159,63,2,2,8,2774,2774,2772,2772
Glenn,23,2022-05-23,26,26,26,0,273,273,271,2,0,0,0,0,53,53,53,53
Humboldt,23,2022-05-23,245,245,244,1,2911,2916,2898,18,14,1,1,3,149,149,148,148
Imperial,23,2022-05-23,343,343,341,2,4746,4752,4720,32,2,0,0,1,945,945,945,945
Inyo,23,2022-05-23,27,27,27,0,221,221,220,1,0,0,0,0,56,56,56,56
Kern,23,2022-05-23,1005,1005,1000,5,21275,21305,21188,117,34,0,0,7,2351,2351,2351,2351
Kings,23,2022-05-23,250,250,248,2,5644,5651,5613,38,1,0,0,0,447,447,447,447
Lake,23,2022-05-23,96,96,95,1,1238,1238,1228,10,1,0,0,1,140,140,140,140
Lassen,23,2022-05-23,41,41,41,0,1763,1765,1756,9,0,0,0,0,62,62,62,62
Los Angeles,23,2022-05-23,27664,27701,27650,51,946288,947596,945816,1780,366,31,31,53,32029,32029,31998,31998
Madera,23,2022-05-23,215,215,213,2,3764,3769,3740,29,1,0,0,2,370,370,370,370
Marin,23,2022-05-23,798,798,792,6,8778,8790,8726,64,15,0,0,1,295,295,295,295
Mariposa,23,2022-05-23,32,32,32,0,340,340,337,3,0,0,0,0,28,28,28,28
Mendocino,23,2022-05-23,150,150,149,1,1659,1659,1642,17,3,1,1,1,129,129,128,128
Merced,23,2022-05-23,409,409,407,2,4203,4208,4184,24,4,0,0,0,828,828,828,828
Modoc,23,2022-05-23,2,2,2,0,40,41,40,1,0,0,0,0,7,7,7,7
Mono,23,2022-05-23,14,14,14,0,163,163,161,2,0,0,0,0,6,6,6,6
Monterey,23,2022-05-23,699,699,691,8,9612,9625,9512,113,17,1,1,1,735,735,734,734
Napa,23,2022-05-23,331,331,329,2,3937,3942,3922,20,5,0,0,0,143,143,143,143
Nevada,23,2022-05-23,150,150,149,1,1904,1906,1892,14,2,0,0,0,128,128,128,128
Orange,23,2022-05-23,5574,5582,5558,24,94582,94712,94296,416,111,11,11,20,7142,7142,7131,7131
Placer,23,2022-05-23,878,878,871,7,7834,7847,7783,64,49,2,2,4,631,631,629,629
Plumas,23,2022-05-23,46,46,46,0,279,279,277,2,0,0,0,0,13,13,13,13
Riverside,23,2022-05-23,4449,4456,4430,26,52421,52494,52186,308,73,6,6,10,6476,6476,6470,6470
Sacramento,23,2022-05-23,3893,3899,3875,24,41039,41097,40837,260,122,7,7,10,3090,3090,3083,3083
San Benito,23,2022-05-23,167,167,166,1,1667,1668,1659,9,0,0,0,0,94,94,94,94
San Bernardino,23,2022-05-23,3319,3324,3308,16,50641,50710,50470,240,53,3,3,10,7849,7849,7846,7846
San Diego,23,2022-05-23,8837,8849,8832,17,103273,103416,103211,205,138,4,4,20,5359,5359,5355,5355
San Francisco,23,2022-05-23,3604,3609,3562,47,41637,41696,41155,541,85,6,6,9,895,895,889,889
San Joaquin,23,2022-05-23,1547,1547,1536,11,20960,20989,20843,146,20,3,3,7,2255,2255,2252,2252
San Luis Obispo,23,2022-05-23,668,668,664,4,7270,7279,7240,39,10,3,3,0,486,486,483,483
San Mateo,23,2022-05-23,3156,3161,3147,14,40829,40886,40706,180,35,0,0,0,714,714,714,714
Santa Barbara,23,2022-05-23,1064,1064,1058,6,17776,17800,17692,108,20,0,0,3,693,693,693,693
Santa Clara,23,2022-05-23,7827,7838,7822,16,111310,111464,111229,235,126,7,7,18,2333,2333,2326,2326
Santa Cruz,23,2022-05-23,505,505,502,3,7816,7827,7787,40,16,0,0,0,262,262,262,262
Shasta,23,2022-05-23,196,196,195,1,3607,3612,3589,23,4,1,1,3,562,562,561,561
Siskiyou,23,2022-05-23,29,29,29,0,364,364,362,2,1,0,0,0,83,83,83,83
Solano,23,2022-05-23,1503,1503,1494,9,14887,14908,14820,88,24,1,1,3,450,450,449,449
Sonoma,23,2022-05-23,1487,1487,1478,9,16332,16355,16260,95,34,2,2,3,496,496,494,494
Stanislaus,23,2022-05-23,868,868,860,8,10691,10706,10608,98,37,2,2,3,1698,1698,1696,1696
Sutter,23,2022-05-23,140,140,139,1,1912,1913,1902,11,0,1,1,0,228,228,227,227
Tehama,23,2022-05-23,50,50,50,0,812,812,805,7,1,0,0,1,208,208,208,208
Trinity,23,2022-05-23,3,3,3,0,90,90,89,1,0,0,0,0,20,20,20,20
Tulare,23,2022-05-23,562,562,557,5,9068,9080,8996,84,26,0,0,0,1498,1498,1498,1498
Tuolumne,23,2022-05-23,136,136,135,1,1576,1577,1565,12,0,1,1,0,187,187,186,186
Ventura,23,2022-05-23,1917,1917,1909,8,24017,24050,23953,97,36,1,1,1,1513,1513,1512,1512
Yolo,23,2022-05-23,730,730,726,4,22654,22684,22562,122,1,1,1,1,364,364,363,363
Yuba,23,2022-05-23,151,151,150,1,1453,1453,1445,8,6,0,0,1,119,119,119,119
Alameda,24,2022-05-30,4913,4920,4902,18,60788,60876,60646,230,95,4,4,7,1908,1908,1904,1904
Amador,24,2022-05-30,88,88,87,1,1191,1191,1184,7,0,1,1,0,87,87,86,86
Butte,24,2022-05-30,275,275,274,1,2709,2713,2705,8,20,0,0,1,437,437,437,437
Calaveras,24,2022-05-30,54,54,54,0,617,617,614,3,0,0,0,0,122,122,122,122
Colusa,24,2022-05-30,13,13,13,0,170,170,169,1,0,0,0,0,21,21,21,21
Contra Costa,24,2022-05-30,3314,3319,3298,21,28983,29025,28842,183,65,7,7,9,1333,1333,1326,1326
Del Norte,24,2022-05-30,36,36,36,0,975,975,970,5,2,1,1,0,51,51,50,50
El Dorado,24,2022-05-30,334,334,332,2,2940,2944,2928,16,6,2,2,2,218,218,216,216
Fresno,24,2022-05-30,1672,1673,1663,10,19525,19553,19437,116,71,6,6,7,2780,2780,2774,2774
Glenn,24,2022-05-30,27,27,27,0,290,290,289,1,2,0,0,0,53,53,53,53
Humboldt,24,2022-05-30,181,181,180,1,2296,2300,2289,11,10,0,0,5,149,149,149,149
Imperial,24,2022-05-30,332,332,330,2,4148,4153,4131,22,2,1,1,2,946,946,945,945
Inyo,24,2022-05-30,18,18,18,0,151,151,150,1,0,0,0,0,56,56,56,56
Kern,24,2022-05-30,1078,1078,1073,5,17987,18014,17935,79,36,0,0,6,2351,2351,2351,2351
Kings,24,2022-05-30,290,290,288,2,4664,4670,4645,25,2,0,0,1,447,447,447,447
Lake,24,2022-05-30,89,89,88,1,994,994,988,6,1,0,0,0,140,140,140,140
Lassen,24,2022-05-30,50,50,50,0,1615,1616,1609,7,1,0,0,0,62,62,62,62
Los Angeles,24,2022-05-30,25982,26020,25982,38,746611,747694,746567,1127,425,47,47,54,32076,32076,32029,32029
Madera,24,2022-05-30,235,235,234,1,3313,3317,3297,20,4,0,0,1,370,370,370,370
Marin,24,2022-05-30,649,649,645,4,7145,7156,7114,42,16,3,3,1,298,298,295,295
Mariposa,24,2022-05-30,39,39,39,0,303,303,301,2,0,0,0,0,28,28,28,28
Mendocino,24,2022-05-30,137,137,136,1,1264,1265,1255,10,4,0,0,1,129,129,129,129
Merced,24,2022-05-30,366,366,364,2,3409,3413,3397,16,6,0,0,2,828,828,828,828
Modoc,24,2022-05-30,4,4,4,0,38,39,38,1,0,0,0,0,7,7,7,7
Mono,24,2022-05-30,6,6,6,0,81,81,80,1,0,0,0,0,6,6,6,6
Monterey,24,2022-05-30,527,527,522,5,7147,7158,7091,67,19,1,1,1,736,736,735,735
Napa,24,2022-05-30,312,312,311,1,3179,3183,3170,13,4,0,0,0,143,143,143,143
Nevada,24,2022-05-30,181,181,180,1,1595,1596,1587,9,3,2,2,1,130,130,128,128
Orange,24,2022-05-30,5593,5600,5581,19,81966,82085,81798,287,122,10,10,18,7152,7152,7142,7142
Placer,24,2022-05-30,749,749,744,5,6132,6142,6102,40,52,0,0,8,631,631,631,631
Plumas,24,2022-05-30,35,35,35,0,200,200,199,1,1,0,0,0,13,13,13,13
Riverside,24,2022-05-30,3862,3869,3851,18,43861,43925,43720,205,82,3,3,10,6479,6479,6476,6476
Sacramento,24,2022-05-30,3839,3845,3826,19,33075,33123,32956,167,130,9,9,20,3099,3099,3090,3090
San Benito,24,2022-05-30,153,153,152,1,1274,1274,1269,5,0,0,0,0,94,94,94,94
San Bernardino,24,2022-05-30,3332,3337,3325,12,42868,42929,42767,162,49,5,5,10,7854,7854,7849,7849
San Diego,24,2022-05-30,8411,8422,8409,13,85853,85979,85844,135,153,10,10,26,5369,5369,5359,5359
San Francisco,24,2022-05-30,3132,3137,3105,32,33427,33476,33132,344,88,11,11,14,906,906,895,895
San Joaquin,24,2022-05-30,1400,1400,1392,8,17012,17037,16943,94,25,2,2,9,2257,2257,2255,2255
San Luis Obispo,24,2022-05-30,651,651,648,3,5437,5446,5423,23,12,1,1,0,487,487,486,486
San Mateo,24,2022-05-30,2749,2753,2743,10,31174,31220,31110,110,33,3,3,2,717,717,714,714
Santa Barbara,24,2022-05-30,1030,1030,1025,5,14449,14469,14399,70,23,2,2,5,695,695,693,693
Santa Clara,24,2022-05-30,7028,7038,7026,12,85314,85437,85294,143,154,10,10,22,2343,2343,2333,2333
Santa Cruz,24,2022-05-30,526,526,524,2,6255,6264,6238,26,7,1,1,1,263,263,262,262
Shasta,24,2022-05-30,133,133,132,1,2838,2842,2828,14,4,3,3,4,565,565,562,562
Siskiyou,24,2022-05-30,53,53,53,0,340,340,339,1,3,0,0,0,83,83,83,83
Solano,24,2022-05-30,1170,1170,1164,6,11525,11541,11486,55,28,0,0,7,450,450,450,450
Sonoma,24,2022-05-30,1198,1198,1193,5,13239,13258,13197,61,38,2,2,5,498,498,496,496
Stanislaus,24,2022-05-30,801,801,795,6,8578,8590,8528,62,55,2,2,3,1700,1700,1698,1698
Sutter,24,2022-05-30,158,158,157,1,1701,1702,1694,8,0,0,0,0,228,228,228,228
Tehama,24,2022-05-30,62,62,62,0,757,757,752,5,2,0,0,0,208,208,208,208
Trinity,24,2022-05-30,8,8,8,0,96,96,95,1,0,0,0,0,20,20,20,20
Tulare,24,2022-05-30,594,594,590,4,7482,7494,7438,56,19,0,0,0,1498,1498,1498,1498
Tuolumne,24,2022-05-30,121,121,120,1,1306,1306,1298,8,3,0,0,0,187,187,187,187
Ventura,24,2022-05-30,1681,1681,1676,5,19544,19572,19509,63,30,1,1,4,1514,1514,1513,1513
Yolo,24,2022-05-30,611,611,608,3,17631,17656,17581,75,4,0,0,1,364,364,364,364
Yuba,24,2022-05-30,144,144,143,1,1276,1276,1270,6,7,0,0,2,119,119,119,119
Alameda,25,2022-06-06,6484,6495,6476,19,73219,73330,73118,212,112,5,5,12,1913,1913,1908,1908
Amador,25,2022-06-06,115,115,114,1,1724,1725,1717,8,1,0,0,1,87,87,87,87
Butte,25,2022-06-06,452,452,451,1,3617,3622,3614,8,24,1,1,1,438,438,437,437
Calaveras,25,2022-06-06,73,73,73,0,737,737,734,3,0,2,2,0,124,124,122,122
Colusa,25,2022-06-06,22,22,22,0,276,276,275,1,3,0,0,0,21,21,21,21
Contra Costa,25,2022-06-06,4237,4243,4223,20,35699,35753,35579,174,107,9,9,7,1342,1342,1333,1333
Del Norte,25,2022-06-06,63,63,63,0,1134,1134,1130,4,2,0,0,0,51,51,51,51
El Dorado,25,2022-06-06,414,414,412,2,3637,3642,3627,15,5,0,0,5,218,218,218,218
Fresno,25,2022-06-06,2448,2453,2442,11,22694,22729,22625,104,94,2,2,6,2782,2782,2780,2780
Glenn,25,2022-06-06,41,41,41,0,325,325,324,1,3,0,0,0,53,53,53,53
Humboldt,25,2022-06-06,261,261,260,1,3054,3059,3048,11,14,1,1,3,150,150,149,149
Imperial,25,2022-06-06,466,466,464,2,4874,4880,4860,20,2,0,0,0,946,946,946,946
Inyo,25,2022-06-06,20,20,20,0,213,213,212,1,1,0,0,0,56,56,56,56
Kern,25,2022-06-06,1607,1607,1602,5,22975,23010,22932,78,35,1,1,6,2352,2352,2351,2351
Kings,25,2022-06-06,398,398,396,2,5504,5512,5489,23,10,0,0,1,447,447,447,447
Lake,25,2022-06-06,136,136,135,1,1180,1180,1174,6,5,0,0,2,140,140,140,140
Lassen,25,2022-06-06,69,69,69,0,2398,2402,2394,8,2,0,0,0,62,62,62,62
Los Angeles,25,2022-06-06,35206,35259,35219,40,1041650,1043228,1042024,1204,496,39,39,61,32115,32115,32076,32076
Madera,25,2022-06-06,352,352,350,2,4126,4132,4113,19,7,0,0,1,370,370,370,370
Marin,25,2022-06-06,737,737,734,3,7640,7652,7618,34,10,2,2,5,300,300,298,298
Mariposa,25,2022-06-06,58,58,58,0,404,404,402,2,0,0,0,0,28,28,28,28
Mendocino,25,2022-06-06,209,209,208,1,1711,1712,1701,11,9,1,1,2,130,130,129,129
Merced,25,2022-06-06,531,531,529,2,4529,4536,4520,16,16,0,0,0,828,828,828,828
Modoc,25,2022-06-06,11,11,11,0,37,38,37,1,0,0,0,0,7,7,7,7
Mono,25,2022-06-06,15,15,15,0,120,120,119,1,0,0,0,0,6,6,6,6
Monterey,25,2022-06-06,1001,1001,994,7,10244,10259,10184,75,17,2,2,1,738,738,736,736
Napa,25,2022-06-06,543,543,541,2,4227,4232,4219,13,8,1,1,0,144,144,143,143
Nevada,25,2022-06-06,248,248,247,1,2150,2154,2144,10,5,0,0,0,130,130,130,130
Orange,25,2022-06-06,7562,7574,7554,20,73555,73666,73469,197,140,12,12,18,7164,7164,7152,7152
Placer,25,2022-06-06,869,869,865,4,7605,7617,7579,38,65,0,0,11,631,631,631,631
Plumas,25,2022-06-06,40,40,40,0,321,321,320,1,0,0,0,0,13,13,13,13
Riverside,25,2022-06-06,5352,5360,5341,19,55968,56053,55852,201,88,6,6,10,6485,6485,6479,6479
Sacramento,25,2022-06-06,4939,4946,4927,19,42457,42521,42356,165,149,14,14,20,3113,3113,3099,3099
San Benito,25,2022-06-06,272,272,271,1,2015,2018,2012,6,0,0,0,1,94,94,94,94
San Bernardino,25,2022-06-06,5119,5127,5112,15,55835,55920,55758,162,77,7,7,14,7861,7861,7854,7854
San Diego,25,2022-06-06,10785,10801,10788,13,100449,100602,100480,122,185,8,8,22,5377,5377,5369,5369
San Francisco,25,2022-06-06,3521,3528,3500,28,38261,38319,38014,305,77,0,0,11,906,906,906,906
San Joaquin,25,2022-06-06,2133,2136,2127,9,22158,22191,22097,94,40,4,4,9,2261,2261,2257,2257
San Luis Obispo,25,2022-06-06,900,900,897,3,7531,7544,7519,25,16,1,1,1,488,488,487,487
San Mateo,25,2022-06-06,3212,3217,3208,9,37065,37121,37020,101,36,2,2,4,719,719,717,717
Santa Barbara,25,2022-06-06,1246,1246,1241,5,15068,15091,15035,56,22,1,1,5,696,696,695,695
Santa Clara,25,2022-06-06,8502,8514,8503,11,102648,102804,102672,132,176,6,6,22,2349,2349,2343,2343
Santa Cruz,25,2022-06-06,896,896,893,3,9720,9735,9705,30,24,1,1,3,264,264,263,263
Shasta,25,2022-06-06,208,208,207,1,4424,4430,4413,17,10,2,2,2,567,567,565,565
Siskiyou,25,2022-06-06,39,39,39,0,431,431,430,1,1,0,0,0,83,83,83,83
Solano,25,2022-06-06,1729,1731,1725,6,15139,15162,15107,55,29,2,2,1,452,452,450,450
Sonoma,25,2022-06-06,1633,1633,1627,6,13993,14014,13965,49,38,1,1,1,499,499,498,498
Stanislaus,25,2022-06-06,1188,1188,1181,7,10910,10926,10865,61,60,1,1,2,1701,1701,1700,1700
Sutter,25,2022-06-06,206,206,205,1,1941,1943,1936,7,0,0,0,0,228,228,228,228
Tehama,25,2022-06-06,83,83,83,0,1051,1051,1045,6,2,0,0,0,208,208,208,208
Trinity,25,2022-06-06,7,7,7,0,110,110,109,1,0,0,0,0,20,20,20,20
Tulare,25,2022-06-06,860,860,855,5,10774,10790,10729,61,24,0,0,0,1498,1498,1498,1498
Tuolumne,25,2022-06-06,123,123,122,1,1723,1725,1717,8,4,0,0,1,187,187,187,187
Ventura,25,2022-06-06,1973,1975,1970,5,24764,24801,24740,61,43,3,3,3,1517,1517,1514,1514
Yolo,25,2022-06-06,829,829,826,3,21435,21467,21397,70,2,1,1,0,365,365,364,364
Yuba,25,2022-06-06,186,186,185,1,1556,1556,1551,5,9,0,0,1,119,119,119,119
Alameda,26,2022-06-13,5078,5085,5074,11,55930,56018,55892,126,106,5,5,18,1918,1918,1913,1913
Amador,26,2022-06-13,130,130,130,0,1413,1413,1408,5,1,0,0,0,87,87,87,87
Butte,26,2022-06-13,394,394,393,1,3459,3464,3458,6,31,4,4,0,442,442,438,438
Calaveras,26,2022-06-13,69,69,69,0,658,658,656,2,0,0,0,0,124,124,124,124
Colusa,26,2022-06-13,12,12,12,0,328,328,327,1,17,0,0,0,21,21,21,21
Contra Costa,26,2022-06-13,3411,3416,3403,13,27980,28024,27918,106,89,8,8,12,1350,1350,1342,1342
Del Norte,26,2022-06-13,79,79,79,0,658,658,656,2,4,0,0,0,51,51,51,51
El Dorado,26,2022-06-13,324,324,323,1,3197,3202,3192,10,7,3,3,1,221,221,218,218
Fresno,26,2022-06-13,2395,2400,2392,8,20695,20728,20655,73,103,4,4,13,2786,2786,2782,2782
Glenn,26,2022-06-13,32,32,32,0,329,329,328,1,2,0,0,0,53,53,53,53
Humboldt,26,2022-06-13,262,262,261,1,2325,2330,2323,7,11,0,0,3,150,150,150,150
Imperial,26,2022-06-13,444,444,443,1,4530,4536,4521,15,6,1,1,0,947,947,946,946
Inyo,26,2022-06-13,13,13,13,0,189,189,188,1,0,0,0,0,56,56,56,56
Kern,26,2022-06-13,1559,1559,1555,4,21421,21454,21398,56,38,1,1,5,2353,2353,2352,2352
Kings,26,2022-06-13,357,357,356,1,5156,5163,5147,16,4,1,1,0,448,448,447,447
Lake,26,2022-06-13,138,138,137,1,1227,1227,1223,4,1,0,0,0,140,140,140,140
Lassen,26,2022-06-13,77,77,77,0,1994,1997,1992,5,2,0,0,0,62,62,62,62
Los Angeles,26,2022-06-13,29981,30028,30001,27,660394,661426,660827,599,519,54,54,60,32169,32169,32115,32115
Madera,26,2022-06-13,381,381,380,1,4230,4237,4222,15,7,0,0,2,370,370,370,370
Marin,26,2022-06-13,685,685,683,2,7030,7042,7017,25,16,2,2,2,302,302,300,300
Mariposa,26,2022-06-13,45,45,45,0,372,372,371,1,0,0,0,0,28,28,28,28
Mendocino,26,2022-06-13,161,161,160,1,1567,1568,1560,8,9,0,0,1,130,130,130,130
Merced,26,2022-06-13,562,562,560,2,4169,4175,4164,11,13,0,0,2,828,828,828,828
Modoc,26,2022-06-13,7,7,7,0,34,35,34,1,1,1,1,0,8,8,7,7
Mono,26,2022-06-13,19,19,19,0,92,92,91,1,0,0,0,0,6,6,6,6
Monterey,26,2022-06-13,837,837,832,5,8655,8669,8620,49,25,3,3,1,741,741,738,738
Napa,26,2022-06-13,433,433,432,1,3935,3940,3931,9,2,1,1,1,145,145,144,144
Nevada,26,2022-06-13,186,186,185,1,1874,1876,1869,7,8,0,0,0,130,130,130,130
Orange,26,2022-06-13,6994,7006,6992,14,65110,65212,65076,136,175,14,14,19,7178,7178,7164,7164
Placer,26,2022-06-13,793,793,790,3,6801,6813,6787,26,79,2,2,7,633,633,631,631
Plumas,26,2022-06-13,34,34,34,0,271,271,270,1,0,0,0,0,13,13,13,13
Riverside,26,2022-06-13,5039,5046,5032,14,47838,47913,47779,134,105,3,3,11,6488,6488,6485,6485
Sacramento,26,2022-06-13,4173,4179,4166,13,37535,37595,37482,113,190,12,12,20,3125,3125,3113,3113
San Benito,26,2022-06-13,200,200,200,0,1780,1783,1779,4,1,0,0,1,94,94,94,94
San Bernardino,26,2022-06-13,4661,4668,4658,10,48695,48771,48661,110,96,6,6,15,7867,7867,7861,7861
San Diego,26,2022-06-13,9617,9631,9622,9,84893,85025,84945,80,192,9,9,27,5386,5386,5377,5377
San Francisco,26,2022-06-13,3040,3046,3027,19,31135,31185,30992,193,72,11,11,13,917,917,906,906
San Joaquin,26,2022-06-13,1917,1920,1914,6,19008,19037,18974,63,32,5,5,3,2266,2266,2261,2261
San Luis Obispo,26,2022-06-13,661,661,659,2,6049,6058,6043,15,21,0,0,0,488,488,488,488
San Mateo,26,2022-06-13,2633,2638,2633,5,29172,29218,29157,61,44,3,3,3,722,722,719,719
Santa Barbara,26,2022-06-13,931,931,928,3,9475,9490,9463,27,15,1,1,5,697,697,696,696
Santa Clara,26,2022-06-13,7036,7048,7041,7,76832,76952,76875,77,182,13,13,23,2362,2362,2349,2349
Santa Cruz,26,2022-06-13,842,842,840,2,9962,9978,9954,24,23,0,0,1,264,264,264,264
Shasta,26,2022-06-13,220,220,219,1,3390,3395,3385,10,8,1,1,0,568,568,567,567
Siskiyou,26,2022-06-13,50,50,50,0,372,372,371,1,1,0,0,0,83,83,83,83
Solano,26,2022-06-13,1676,1677,1672,5,12875,12896,12860,36,33,0,0,2,452,452,452,452
Sonoma,26,2022-06-13,1337,1337,1333,4,11649,11667,11635,32,36,3,3,6,502,502,499,499
Stanislaus,26,2022-06-13,1133,1133,1128,5,9453,9467,9426,41,63,1,1,7,1702,1702,1701,1701
Sutter,26,2022-06-13,193,193,192,1,1721,1723,1718,5,0,0,0,0,228,228,228,228
Tehama,26,2022-06-13,88,88,88,0,967,967,963,4,3,0,0,0,208,208,208,208
Trinity,26,2022-06-13,11,11,11,0,84,85,84,1,0,0,0,0,20,20,20,20
Tulare,26,2022-06-13,821,821,817,4,9450,9465,9423,42,26,2,2,1,1500,1500,1498,1498
Tuolumne,26,2022-06-13,148,148,147,1,1445,1446,1441,5,2,0,0,0,187,187,187,187
Ventura,26,2022-06-13,1934,1936,1932,4,20979,21011,20971,40,38,3,3,5,1520,1520,1517,1517
Yolo,26,2022-06-13,766,766,764,2,14392,14415,14378,37,4,1,1,0,366,366,365,365
Yuba,26,2022-06-13,188,188,187,1,1420,1420,1416,4,8,0,0,1,119,119,119,119
Alameda,27,2022-06-20,4963,4971,4962,9,48646,48725,48640,85,105,12,12,14,1930,1930,1918,1918
Amador,27,2022-06-20,104,104,104,0,1247,1247,1243,4,2,0,0,0,87,87,87,87
Butte,27,2022-06-20,413,413,412,1,3559,3564,3559,5,28,4,4,1,446,446,442,442
Calaveras,27,2022-06-20,82,82,82,0,624,624,622,2,0,0,0,0,124,124,124,124
Colusa,27,2022-06-20,16,16,16,0,176,177,176,1,15,1,1,0,22,22,21,21
Contra Costa,27,2022-06-20,3340,3346,3336,10,26008,26051,25974,77,81,7,7,8,1357,1357,1350,1350
Del Norte,27,2022-06-20,82,82,82,0,611,611,610,1,3,1,1,1,52,52,51,51
El Dorado,27,2022-06-20,351,351,350,1,3074,3079,3071,8,5,2,2,1,223,223,221,221
Fresno,27,2022-06-20,2467,2472,2465,7,19499,19531,19477,54,100,3,3,16,2789,2789,2786,2786
Glenn,27,2022-06-20,41,41,41,0,314,314,313,1,3,0,0,0,53,53,53,53
Humboldt,27,2022-06-20,272,272,271,1,2273,2278,2273,5,11,0,0,3,150,150,150,150
Imperial,27,2022-06-20,602,602,601,1,3692,3697,3688,9,5,0,0,0,947,947,947,947
Inyo,27,2022-06-20,18,18,18,0,187,188,187,1,0,0,0,0,56,56,56,56
Kern,27,2022-06-20,1648,1649,1646,3,20129,20162,20121,41,39,5,5,9,2358,2358,2353,2353
Kings,27,2022-06-20,413,413,412,1,4866,4874,4862,12,6,1,1,0,449,449,448,448
Lake,27,2022-06-20,120,120,120,0,1237,1237,1233,4,1,0,0,2,140,140,140,140
Lassen,27,2022-06-20,43,43,43,0,1223,1224,1222,2,1,0,0,0,62,62,62,62
Los Angeles,27,2022-06-20,27508,27552,27533,19,351448,352016,351771,245,596,57,57,68,32226,32226,32169,32169
Madera,27,2022-06-20,336,336,335,1,4163,4169,4157,12,4,0,0,1,370,370,370,370
Marin,27,2022-06-20,692,692,690,2,6321,6333,6316,17,21,0,0,1,302,302,302,302
Mariposa,27,2022-06-20,53,53,53,0,335,335,334,1,0,0,0,0,28,28,28,28
Mendocino,27,2022-06-20,179,179,178,1,1580,1581,1575,6,3,0,0,0,130,130,130,130
Merced,27,2022-06-20,541,541,540,1,3955,3961,3953,8,7,3,3,1,831,831,828,828
Modoc,27,2022-06-20,5,5,5,0,37,38,37,1,0,0,0,0,8,8,8,8
Mono,27,2022-06-20,6,6,6,0,82,83,82,1,1,1,1,0,7,7,6,6
Monterey,27,2022-06-20,893,893,889,4,8907,8921,8882,39,38,1,1,2,742,742,741,741
Napa,27,2022-06-20,364,364,363,1,3127,3132,3126,6,3,1,1,0,146,146,145,145
Nevada,27,2022-06-20,170,170,170,0,1619,1621,1617,4,6,1,1,0,131,131,130,130
Orange,27,2022-06-20,6967,6979,6968,11,60424,60521,60422,99,152,10,10,23,7188,7188,7178,7178
Placer,27,2022-06-20,671,671,669,2,6053,6065,6047,18,69,1,1,7,634,634,633,633
Plumas,27,2022-06-20,38,38,38,0,239,239,238,1,0,0,0,0,13,13,13,13
Riverside,27,2022-06-20,4955,4962,4951,11,43301,43371,43276,95,112,5,5,14,6493,6493,6488,6488
Sacramento,27,2022-06-20,3929,3936,3927,9,34808,34865,34783,82,171,12,12,21,3137,3137,3125,3125
San Benito,27,2022-06-20,172,172,172,0,1597,1599,1596,3,0,1,1,2,95,95,94,94
San Bernardino,27,2022-06-20,4516,4523,4515,8,46250,46325,46244,81,105,12,12,17,7879,7879,7867,7867
San Diego,27,2022-06-20,9692,9708,9701,7,77518,77643,77586,57,203,10,10,17,5396,5396,5386,5386
San Francisco,27,2022-06-20,3056,3063,3048,15,28301,28348,28210,138,72,12,12,14,929,929,917,917
San Joaquin,27,2022-06-20,1668,1669,1665,4,17896,17926,17880,46,38,6,6,6,2272,2272,2266,2266
San Luis Obispo,27,2022-06-20,596,596,595,1,5812,5822,5810,12,27,10,10,0,498,498,488,488
San Mateo,27,2022-06-20,2621,2626,2622,4,25938,25979,25936,43,42,2,2,1,724,724,722,722
Santa Barbara,27,2022-06-20,934,934,932,2,8260,8272,8254,18,33,2,2,6,699,699,697,697
Santa Clara,27,2022-06-20,6802,6814,6809,5,63478,63581,63532,49,170,8,8,21,2370,2370,2362,2362
Santa Cruz,27,2022-06-20,818,818,816,2,9130,9146,9129,17,19,1,1,2,265,265,264,264
Shasta,27,2022-06-20,240,240,239,1,3372,3377,3369,8,9,1,1,1,569,569,568,568
Siskiyou,27,2022-06-20,61,61,61,0,394,394,393,1,5,1,1,0,84,84,83,83
Solano,27,2022-06-20,1409,1409,1406,3,11441,11458,11433,25,41,0,0,5,452,452,452,452
Sonoma,27,2022-06-20,1400,1400,1397,3,10795,10813,10790,23,28,1,1,3,503,503,502,502
Stanislaus,27,2022-06-20,1040,1040,1036,4,8832,8846,8816,30,70,5,5,7,1707,1707,1702,1702
Sutter,27,2022-06-20,196,196,196,0,1858,1860,1856,4,0,0,0,0,228,228,228,228
Tehama,27,2022-06-20,97,97,97,0,889,889,886,3,3,0,0,0,208,208,208,208
Trinity,27,2022-06-20,10,10,10,0,106,107,106,1,0,0,0,0,20,20,20,20
Tulare,27,2022-06-20,885,885,882,3,8725,8740,8710,30,32,8,8,0,1508,1508,1500,1500
Tuolumne,27,2022-06-20,141,141,141,0,1554,1556,1552,4,3,0,0,1,187,187,187,187
Ventura,27,2022-06-20,1835,1836,1833,3,18669,18698,18670,28,50,1,1,7,1521,1521,1520,1520
Yolo,27,2022-06-20,678,678,677,1,10849,10867,10845,22,1,2,2,2,368,368,366,366
Yuba,27,2022-06-20,149,149,149,0,1339,1339,1336,3,13,0,0,5,119,119,119,119
Alameda,28,2022-06-27,5474,5482,5475,7,48325,48407,48341,66,124,8,8,16,1938,1938,1930,1930
Amador,28,2022-06-27,88,88,88,0,1149,1149,1146,3,3,0,0,1,87,87,87,87
Butte,28,2022-06-27,410,410,410,0,3468,3473,3469,4,30,2,2,0,448,448,446,446
Calaveras,28,2022-06-27,68,68,68,0,570,570,569,1,1,2,2,0,126,126,124,124
Colusa,28,2022-06-27,28,28,28,0,282,283,282,1,6,0,0,0,22,22,22,22
Contra Costa,28,2022-06-27,3524,3531,3523,8,25912,25956,25897,59,82,11,11,7,1368,1368,1357,1357
Del Norte,28,2022-06-27,140,140,140,0,669,669,668,1,5,1,1,2,53,53,52,52
El Dorado,28,2022-06-27,427,427,426,1,3357,3362,3356,6,5,0,0,1,223,223,223,223
Fresno,28,2022-06-27,2815,2820,2814,6,19935,19967,19924,43,136,2,2,17,2791,2791,2789,2789
Glenn,28,2022-06-27,28,28,28,0,296,296,295,1,1,0,0,0,53,53,53,53
Humboldt,28,2022-06-27,261,261,261,0,2189,2194,2190,4,10,1,1,2,151,151,150,150
Imperial,28,2022-06-27,703,703,702,1,4019,4025,4017,8,7,0,0,4,947,947,947,947
Inyo,28,2022-06-27,32,32,32,0,311,311,310,1,1,0,0,0,56,56,56,56
Kern,28,2022-06-27,1814,1816,1813,3,17277,17305,17277,28,52,7,7,8,2365,2365,2358,2358
Kings,28,2022-06-27,469,469,468,1,3931,3937,3929,8,9,0,0,0,449,449,449,449
Lake,28,2022-06-27,121,121,121,0,1139,1139,1136,3,2,0,0,0,140,140,140,140
Lassen,28,2022-06-27,51,51,51,0,848,848,847,1,1,0,0,0,62,62,62,62
Los Angeles,28,2022-06-27,32745,32799,32781,18,364322,364927,364730,197,679,73,73,68,32299,32299,32226,32226
Madera,28,2022-06-27,413,413,412,1,4286,4294,4285,9,8,0,0,0,370,370,370,370
Marin,28,2022-06-27,659,659,658,1,6236,6248,6235,13,20,1,1,2,303,303,302,302
Mariposa,28,2022-06-27,55,55,55,0,310,310,309,1,0,0,0,0,28,28,28,28
Mendocino,28,2022-06-27,153,153,153,0,1447,1448,1444,4,5,1,1,1,131,131,130,130
Merced,28,2022-06-27,614,614,613,1,4035,4041,4034,7,14,2,2,0,833,833,831,831
Modoc,28,2022-06-27,7,7,7,0,32,33,32,1,0,0,0,0,8,8,8,8
Mono,28,2022-06-27,25,25,25,0,110,111,110,1,1,0,0,0,7,7,7,7
Monterey,28,2022-06-27,933,933,930,3,8273,8286,8258,28,44,2,2,3,744,744,742,742
Napa,28,2022-06-27,391,391,390,1,3311,3316,3311,5,3,2,2,1,148,148,146,146
Nevada,28,2022-06-27,189,189,189,0,1619,1621,1618,3,4,0,0,3,131,131,131,131
Orange,28,2022-06-27,7531,7543,7534,9,59324,59422,59347,75,183,16,16,26,7204,7204,7188,7188
Placer,28,2022-06-27,807,807,805,2,6185,6197,6182,15,79,6,6,6,640,640,634,634
Plumas,28,2022-06-27,50,50,50,0,257,257,256,1,1,0,0,0,13,13,13,13
Riverside,28,2022-06-27,6185,6196,6186,10,44953,45028,44952,76,141,11,11,17,6504,6504,6493,6493
Sacramento,28,2022-06-27,4161,4168,4160,8,35275,35334,35269,65,173,10,10,25,3147,3147,3137,3137
San Benito,28,2022-06-27,221,221,221,0,1655,1658,1656,2,0,0,0,1,95,95,95,95
San Bernardino,28,2022-06-27,5720,5728,5720,8,48814,48895,48828,67,130,12,12,24,7891,7891,7879,7879
San Diego,28,2022-06-27,10870,10889,10883,6,80651,80785,80739,46,264,8,8,28,5404,5404,5396,5396
San Francisco,28,2022-06-27,3278,3284,3272,12,29264,29313,29203,110,92,5,5,23,934,934,929,929
San Joaquin,28,2022-06-27,1891,1894,1890,4,17963,17993,17957,36,46,2,2,5,2274,2274,2272,2272
San Luis Obispo,28,2022-06-27,645,645,644,1,5644,5654,5645,9,25,3,3,0,501,501,498,498
San Mateo,28,2022-06-27,2887,2893,2889,4,26904,26948,26914,34,36,1,1,2,725,725,724,724
Santa Barbara,28,2022-06-27,1146,1146,1144,2,9811,9827,9810,17,26,2,2,2,701,701,699,699
Santa Clara,28,2022-06-27,7534,7546,7541,5,61415,61516,61479,37,213,11,11,19,2381,2381,2370,2370
Santa Cruz,28,2022-06-27,861,861,860,1,9188,9204,9190,14,26,2,2,1,267,267,265,265
Shasta,28,2022-06-27,337,337,336,1,3308,3313,3307,6,21,0,0,4,569,569,569,569
Siskiyou,28,2022-06-27,63,63,63,0,355,355,354,1,2,1,1,0,85,85,84,84
Solano,28,2022-06-27,1594,1595,1592,3,12991,13013,12991,22,47,0,0,4,452,452,452,452
Sonoma,28,2022-06-27,1367,1367,1365,2,10095,10111,10094,17,33,2,2,3,505,505,503,503
Stanislaus,28,2022-06-27,1211,1211,1208,3,8582,8597,8574,23,96,2,2,6,1709,1709,1707,1707
Sutter,28,2022-06-27,197,197,197,0,1843,1845,1842,3,0,0,0,0,228,228,228,228
Tehama,28,2022-06-27,91,91,91,0,888,888,886,2,3,0,0,0,208,208,208,208
Trinity,28,2022-06-27,24,24,24,0,142,143,142,1,1,0,0,0,20,20,20,20
Tulare,28,2022-06-27,910,910,908,2,7883,7897,7876,21,35,0,0,2,1508,1508,1508,1508
Tuolumne,28,2022-06-27,172,172,172,0,1405,1406,1403,3,1,4,4,1,191,191,187,187
Ventura,28,2022-06-27,2090,2094,2092,2,18528,18558,18536,22,61,3,3,1,1524,1524,1521,1521
Yolo,28,2022-06-27,789,789,788,1,11410,11429,11411,18,8,0,0,1,368,368,368,368
Yuba,28,2022-06-27,171,171,171,0,1434,1435,1433,2,10,2,2,2,121,121,119,119
Alameda,29,2022-07-04,4829,4837,4832,5,38878,38944,38902,42,128,11,11,10,1949,1949,1938,1938
Amador,29,2022-07-04,66,66,66,0,1534,1536,1533,3,3,1,1,1,88,88,87,87
Butte,29,2022-07-04,284,284,284,0,2489,2493,2491,2,28,2,2,1,450,450,448,448
Calaveras,29,2022-07-04,81,81,81,0,486,486,485,1,0,2,2,0,128,128,126,126
Colusa,29,2022-07-04,21,21,21,0,150,151,150,1,4,0,0,0,22,22,22,22
Contra Costa,29,2022-07-04,3319,3326,3320,6,20925,20960,20922,38,76,10,10,12,1378,1378,1368,1368
Del Norte,29,2022-07-04,139,139,139,0,587,587,586,1,3,0,0,0,53,53,53,53
El Dorado,29,2022-07-04,307,307,307,0,2395,2399,2395,4,10,1,1,0,224,224,223,223
Fresno,29,2022-07-04,2462,2466,2462,4,15676,15703,15676,27,158,6,6,17,2797,2797,2791,2791
Glenn,29,2022-07-04,24,24,24,0,157,158,157,1,1,0,0,0,53,53,53,53
Humboldt,29,2022-07-04,188,188,188,0,1584,1587,1585,2,12,2,2,3,153,153,151,151
Imperial,29,2022-07-04,697,697,696,1,3234,3238,3233,5,8,1,1,3,948,948,947,947
Inyo,29,2022-07-04,41,41,41,0,292,293,292,1,1,0,0,0,56,56,56,56
Kern,29,2022-07-04,1757,1759,1757,2,14149,14173,14155,18,63,4,4,9,2369,2369,2365,2365
Kings,29,2022-07-04,438,438,437,1,3446,3450,3445,5,5,0,0,0,449,449,449,449
Lake,29,2022-07-04,107,107,107,0,790,790,789,1,3,2,2,0,142,142,140,140
Lassen,29,2022-07-04,31,31,31,0,640,640,639,1,2,0,0,0,62,62,62,62
Los Angeles,29,2022-07-04,32247,32302,32288,14,285888,286375,286252,123,801,88,88,85,32387,32387,32299,32299
Madera,29,2022-07-04,341,341,340,1,3179,3184,3178,6,9,0,0,1,370,370,370,370
Marin,29,2022-07-04,608,608,607,1,5162,5172,5163,9,25,1,1,2,304,304,303,303
Mariposa,29,2022-07-04,36,36,36,0,222,223,222,1,0,0,0,0,28,28,28,28
Mendocino,29,2022-07-04,164,164,164,0,1119,1119,1116,3,6,2,2,1,133,133,131,131
Merced,29,2022-07-04,597,597,596,1,2919,2923,2919,4,14,2,2,1,835,835,833,833
Modoc,29,2022-07-04,10,10,10,0,31,32,31,1,0,0,0,0,8,8,8,8
Mono,29,2022-07-04,22,22,22,0,81,82,81,1,1,0,0,0,7,7,7,7
Monterey,29,2022-07-04,842,842,840,2,6317,6328,6311,17,39,2,2,4,746,746,744,744
Napa,29,2022-07-04,340,340,340,0,2557,2561,2558,3,13,0,0,1,148,148,148,148
Nevada,29,2022-07-04,177,177,177,0,1268,1269,1267,2,5,0,0,1,131,131,131,131
Orange,29,2022-07-04,6955,6966,6959,7,50713,50800,50749,51,203,25,25,34,7229,7229,7204,7204
Placer,29,2022-07-04,806,806,805,1,5048,5058,5049,9,72,3,3,6,643,643,640,640
Plumas,29,2022-07-04,32,32,32,0,172,173,172,1,0,0,0,0,13,13,13,13
Riverside,29,2022-07-04,6386,6397,6388,9,38518,38583,38531,52,137,5,5,8,6509,6509,6504,6504
Sacramento,29,2022-07-04,3578,3584,3579,5,26532,26578,26539,39,163,19,19,22,3166,3166,3147,3147
San Benito,29,2022-07-04,210,210,210,0,1273,1275,1273,2,3,0,0,0,95,95,95,95
San Bernardino,29,2022-07-04,6061,6072,6065,7,41596,41666,41621,45,147,12,12,26,7903,7903,7891,7891
San Diego,29,2022-07-04,9601,9617,9613,4,65499,65611,65581,30,262,10,10,43,5414,5414,5404,5404
San Francisco,29,2022-07-04,2899,2904,2895,9,24214,24255,24183,72,100,11,11,18,945,945,934,934
San Joaquin,29,2022-07-04,1678,1681,1678,3,14664,14690,14667,23,41,5,5,4,2279,2279,2274,2274
San Luis Obispo,29,2022-07-04,616,616,615,1,4165,4172,4167,5,24,0,0,0,501,501,501,501
San Mateo,29,2022-07-04,2598,2603,2600,3,21586,21624,21602,22,39,1,1,3,726,726,725,725
Santa Barbara,29,2022-07-04,1057,1057,1056,1,7665,7678,7667,11,26,4,4,4,705,705,701,701
Santa Clara,29,2022-07-04,6797,6808,6805,3,50745,50830,50806,24,191,16,16,34,2397,2397,2381,2381
Santa Cruz,29,2022-07-04,732,732,731,1,7157,7169,7160,9,22,0,0,0,267,267,267,267
Shasta,29,2022-07-04,280,280,280,0,2396,2400,2396,4,15,5,5,3,574,574,569,569
Siskiyou,29,2022-07-04,34,34,34,0,326,327,326,1,1,0,0,1,85,85,85,85
Solano,29,2022-07-04,1336,1337,1335,2,9821,9839,9826,13,50,0,0,5,452,452,452,452
Sonoma,29,2022-07-04,1085,1085,1084,1,8092,8106,8095,11,35,2,2,1,507,507,505,505
Stanislaus,29,2022-07-04,1168,1168,1166,2,6989,7001,6986,15,84,7,7,16,1716,1716,1709,1709
Sutter,29,2022-07-04,230,230,230,0,1671,1673,1671,2,0,0,0,0,228,228,228,228
Tehama,29,2022-07-04,132,132,132,0,821,821,819,2,3,1,1,0,209,209,208,208
Trinity,29,2022-07-04,17,17,17,0,143,144,143,1,2,0,0,0,20,20,20,20
Tulare,29,2022-07-04,939,939,937,2,6098,6109,6096,13,40,4,4,1,1512,1512,1508,1508
Tuolumne,29,2022-07-04,165,165,165,0,938,939,937,2,8,0,0,1,191,191,191,191
Ventura,29,2022-07-04,1948,1952,1950,2,15408,15434,15420,14,66,2,2,8,1526,1526,1524,1524
Yolo,29,2022-07-04,535,535,534,1,7259,7270,7261,9,6,3,3,2,371,371,368,368
Yuba,29,2022-07-04,168,168,168,0,1078,1078,1077,1,9,0,0,1,121,121,121,121
Alameda,30,2022-07-11,5793,5803,5798,5,48335,48419,48379,40,119,8,8,16,1957,1957,1949,1949
Amador,30,2022-07-11,91,91,91,0,1504,1506,1504,2,2,0,0,0,88,88,88,88
Butte,30,2022-07-11,497,497,497,0,3299,3304,3302,2,27,1,1,4,451,451,450,450
Calaveras,30,2022-07-11,78,78,78,0,566,566,565,1,0,1,1,1,129,129,128,128
Colusa,30,2022-07-11,26,26,26,0,483,484,483,1,0,0,0,0,22,22,22,22
Contra Costa,30,2022-07-11,3678,3685,3680,5,26538,26585,26548,37,91,11,11,11,1389,1389,1378,1378
Del Norte,30,2022-07-11,174,174,174,0,677,677,676,1,5,0,0,1,53,53,53,53
El Dorado,30,2022-07-11,385,385,385,0,3153,3158,3154,4,12,1,1,3,225,225,224,224
Fresno,30,2022-07-11,3656,3662,3657,5,21578,21616,21588,28,161,7,7,14,2804,2804,2797,2797
Glenn,30,2022-07-11,45,45,45,0,382,383,382,1,0,0,0,0,53,53,53,53
Humboldt,30,2022-07-11,291,291,291,0,2189,2194,2192,2,11,1,1,2,154,154,153,153
Imperial,30,2022-07-11,1114,1114,1113,1,4746,4753,4747,6,14,1,1,1,949,949,948,948
Inyo,30,2022-07-11,38,38,38,0,389,390,389,1,0,1,1,0,57,57,56,56
Kern,30,2022-07-11,2452,2457,2455,2,16952,16981,16965,16,77,2,2,9,2371,2371,2369,2369
Kings,30,2022-07-11,730,730,729,1,4341,4348,4343,5,11,3,3,0,452,452,449,449
Lake,30,2022-07-11,126,126,126,0,1115,1115,1113,2,0,0,0,0,142,142,142,142
Lassen,30,2022-07-11,59,59,59,0,821,821,820,1,2,1,1,0,63,63,62,62
Los Angeles,30,2022-07-11,43299,43375,43361,14,381154,381821,381695,126,1038,89,89,115,32476,32476,32387,32387
Madera,30,2022-07-11,532,532,531,1,4126,4132,4127,5,15,0,0,3,370,370,370,370
Marin,30,2022-07-11,603,603,602,1,5927,5939,5931,8,17,1,1,1,305,305,304,304
Mariposa,30,2022-07-11,52,52,52,0,283,284,283,1,0,0,0,0,28,28,28,28
Mendocino,30,2022-07-11,190,190,190,0,1387,1388,1386,2,4,0,0,0,133,133,133,133
Merced,30,2022-07-11,762,762,761,1,4273,4280,4276,4,16,5,5,1,840,840,835,835
Modoc,30,2022-07-11,28,28,28,0,57,58,57,1,0,0,0,0,8,8,8,8
Mono,30,2022-07-11,11,11,11,0,105,106,105,1,0,0,0,0,7,7,7,7
Monterey,30,2022-07-11,1095,1095,1093,2,7948,7962,7945,17,47,5,5,3,751,751,746,746
Napa,30,2022-07-11,367,367,367,0,3660,3665,3662,3,13,1,1,1,149,149,148,148
Nevada,30,2022-07-11,221,221,221,0,1826,1829,1827,2,7,0,0,1,131,131,131,131
Orange,30,2022-07-11,9725,9743,9736,7,64153,64265,64215,50,257,20,20,30,7249,7249,7229,7229
Placer,30,2022-07-11,785,785,784,1,5963,5975,5966,9,76,2,2,8,645,645,643,643
Plumas,30,2022-07-11,71,71,71,0,282,283,282,1,0,0,0,0,13,13,13,13
Riverside,30,2022-07-11,9199,9216,9207,9,52063,52154,52100,54,225,17,17,12,6526,6526,6509,6509
Sacramento,30,2022-07-11,4200,4207,4202,5,35514,35576,35536,40,184,22,22,24,3188,3188,3166,3166
San Benito,30,2022-07-11,235,235,235,0,1666,1668,1666,2,1,0,0,0,95,95,95,95
San Bernardino,30,2022-07-11,8425,8439,8432,7,57669,57770,57722,48,188,14,14,20,7917,7917,7903,7903
San Diego,30,2022-07-11,13666,13690,13685,5,85548,85698,85668,30,332,10,10,41,5424,5424,5414,5414
San Francisco,30,2022-07-11,2992,2997,2990,7,27842,27891,27827,64,105,11,11,23,956,956,945,945
San Joaquin,30,2022-07-11,2141,2146,2143,3,19352,19386,19362,24,55,7,7,11,2286,2286,2279,2279
San Luis Obispo,30,2022-07-11,753,753,752,1,5271,5279,5274,5,22,3,3,1,504,504,501,501
San Mateo,30,2022-07-11,2776,2782,2780,2,25653,25697,25677,20,42,6,6,4,732,732,726,726
Santa Barbara,30,2022-07-11,1326,1326,1325,1,9703,9720,9710,10,46,5,5,9,710,710,705,705
Santa Clara,30,2022-07-11,7392,7405,7402,3,59971,60075,60053,22,211,12,12,38,2409,2409,2397,2397
Santa Cruz,30,2022-07-11,1028,1028,1027,1,9513,9531,9522,9,16,0,0,0,267,267,267,267
Shasta,30,2022-07-11,327,327,327,0,3565,3571,3567,4,21,2,2,6,576,576,574,574
Siskiyou,30,2022-07-11,29,29,29,0,361,362,361,1,1,1,1,1,86,86,85,85
Solano,30,2022-07-11,1618,1620,1618,2,11634,11654,11642,12,40,1,1,6,453,453,452,452
Sonoma,30,2022-07-11,1297,1298,1297,1,9941,9959,9949,10,50,0,0,7,507,507,507,507
Stanislaus,30,2022-07-11,1495,1496,1494,2,8687,8702,8688,14,103,7,7,11,1723,1723,1716,1716
Sutter,30,2022-07-11,287,287,287,0,1777,1779,1777,2,0,0,0,0,228,228,228,228
Tehama,30,2022-07-11,134,134,134,0,925,925,924,1,5,0,0,1,209,209,209,209
Trinity,30,2022-07-11,35,35,35,0,120,121,120,1,0,0,0,0,20,20,20,20
Tulare,30,2022-07-11,1380,1380,1378,2,9558,9575,9559,16,47,4,4,2,1516,1516,1512,1512
Tuolumne,30,2022-07-11,251,251,251,0,1303,1304,1302,2,6,0,0,0,191,191,191,191
Ventura,30,2022-07-11,2549,2554,2552,2,19713,19746,19732,14,89,9,9,6,1535,1535,1526,1526
Yolo,30,2022-07-11,502,502,502,0,5421,5431,5426,5,4,3,3,4,374,374,371,371
Yuba,30,2022-07-11,218,218,218,0,1404,1405,1404,1,9,0,0,1,121,121,121,121
Alameda,31,2022-07-18,4927,4936,4933,3,42948,43025,42997,28,149,9,9,25,1966,1966,1957,1957
Amador,31,2022-07-18,85,85,85,0,1348,1350,1349,1,6,0,0,1,88,88,88,88
Butte,31,2022-07-18,333,333,333,0,2794,2799,2798,1,25,1,1,3,452,452,451,451
Calaveras,31,2022-07-18,78,78,78,0,545,546,545,1,0,0,0,0,129,129,129,129
Colusa,31,2022-07-18,23,23,23,0,349,350,349,1,2,0,0,0,22,22,22,22
Contra Costa,31,2022-07-18,3055,3061,3058,3,22715,22757,22732,25,88,4,4,16,1393,1393,1389,1389
Del Norte,31,2022-07-18,167,167,167,0,705,705,704,1,7,0,0,0,53,53,53,53
El Dorado,31,2022-07-18,280,280,280,0,2639,2644,2642,2,11,1,1,1,226,226,225,225
Fresno,31,2022-07-18,3690,3697,3693,4,21120,21158,21136,22,199,9,9,15,2813,2813,2804,2804
Glenn,31,2022-07-18,34,34,34,0,263,264,263,1,0,0,0,0,53,53,53,53
Humboldt,31,2022-07-18,294,294,294,0,2025,2030,2028,2,10,0,0,4,154,154,154,154
Imperial,31,2022-07-18,1021,1021,1020,1,4434,4440,4436,4,18,2,2,3,951,951,949,949
Inyo,31,2022-07-18,30,30,30,0,331,332,331,1,0,0,0,0,57,57,57,57
Kern,31,2022-07-18,2291,2296,2294,2,16469,16499,16487,12,72,10,10,14,2381,2381,2371,2371
Kings,31,2022-07-18,706,706,705,1,4154,4160,4156,4,16,1,1,0,453,453,452,452
Lake,31,2022-07-18,132,132,132,0,993,993,992,1,3,0,0,0,142,142,142,142
Lassen,31,2022-07-18,78,78,78,0,1239,1241,1240,1,1,0,0,0,63,63,63,63
Los Angeles,31,2022-07-18,41808,41883,41872,11,352143,352777,352687,90,1162,112,112,137,32588,32588,32476,32476
Madera,31,2022-07-18,528,528,527,1,3632,3638,3634,4,5,0,0,3,370,370,370,370
Marin,31,2022-07-18,516,516,515,1,5500,5512,5506,6,12,1,1,5,306,306,305,305
Mariposa,31,2022-07-18,42,42,42,0,242,243,242,1,0,1,1,0,29,29,28,28
Mendocino,31,2022-07-18,185,185,185,0,1491,1493,1491,2,6,0,0,2,133,133,133,133
Merced,31,2022-07-18,751,751,750,1,3981,3987,3984,3,15,1,1,1,841,841,840,840
Modoc,31,2022-07-18,13,13,13,0,34,35,34,1,1,0,0,0,8,8,8,8
Mono,31,2022-07-18,10,10,10,0,85,86,85,1,1,0,0,0,7,7,7,7
Monterey,31,2022-07-18,984,984,982,2,7188,7201,7189,12,46,6,6,4,757,757,751,751
Napa,31,2022-07-18,318,318,318,0,2954,2959,2957,2,10,2,2,2,151,151,149,149
Nevada,31,2022-07-18,135,135,135,0,1331,1332,1331,1,8,0,0,3,131,131,131,131
Orange,31,2022-07-18,8787,8803,8798,5,59777,59885,59849,36,253,24,24,45,7273,7273,7249,7249
Placer,31,2022-07-18,684,684,683,1,5240,5251,5245,6,89,1,1,5,646,646,645,645
Plumas,31,2022-07-18,60,60,60,0,279,280,279,1,0,0,0,0,13,13,13,13
Riverside,31,2022-07-18,8244,8258,8251,7,48073,48160,48121,39,222,16,16,17,6542,6542,6526,6526
Sacramento,31,2022-07-18,3534,3541,3538,3,30404,30459,30433,26,180,12,12,26,3200,3200,3188,3188
San Benito,31,2022-07-18,198,198,198,0,1587,1589,1588,1,1,1,1,0,96,96,95,95
San Bernardino,31,2022-07-18,7966,7979,7974,5,53732,53830,53795,35,214,13,13,35,7930,7930,7917,7917
San Diego,31,2022-07-18,13080,13102,13098,4,79857,80001,79979,22,402,18,18,52,5442,5442,5424,5424
San Francisco,31,2022-07-18,2490,2495,2491,4,25514,25561,25515,46,111,10,10,24,966,966,956,956
San Joaquin,31,2022-07-18,2052,2057,2055,2,18030,18062,18045,17,66,2,2,11,2288,2288,2286,2286
San Luis Obispo,31,2022-07-18,560,560,560,0,4628,4636,4633,3,17,3,3,1,507,507,504,504
San Mateo,31,2022-07-18,2289,2294,2293,1,23091,23133,23119,14,33,0,0,4,732,732,732,732
Santa Barbara,31,2022-07-18,1297,1297,1296,1,9270,9287,9279,8,47,1,1,6,711,711,710,710
Santa Clara,31,2022-07-18,6192,6204,6202,2,54686,54784,54768,16,199,12,12,30,2421,2421,2409,2409
Santa Cruz,31,2022-07-18,874,874,873,1,7449,7460,7455,5,24,1,1,2,268,268,267,267
Shasta,31,2022-07-18,319,319,319,0,3209,3215,3212,3,40,3,3,3,579,579,576,576
Siskiyou,31,2022-07-18,34,34,34,0,345,346,345,1,3,0,0,0,86,86,86,86
Solano,31,2022-07-18,1237,1237,1236,1,9514,9532,9524,8,49,1,1,6,454,454,453,453
Sonoma,31,2022-07-18,1052,1052,1051,1,8745,8759,8752,7,44,0,0,5,507,507,507,507
Stanislaus,31,2022-07-18,1401,1401,1399,2,8395,8409,8398,11,109,5,5,9,1728,1728,1723,1723
Sutter,31,2022-07-18,251,251,251,0,1673,1675,1674,1,0,0,0,0,228,228,228,228
Tehama,31,2022-07-18,110,110,110,0,896,896,895,1,7,1,1,0,210,210,209,209
Trinity,31,2022-07-18,20,20,20,0,111,112,111,1,1,0,0,0,20,20,20,20
Tulare,31,2022-07-18,1183,1183,1181,2,8086,8102,8092,10,45,0,0,0,1516,1516,1516,1516
Tuolumne,31,2022-07-18,239,239,239,0,1142,1142,1141,1,7,4,4,0,195,195,191,191
Ventura,31,2022-07-18,2325,2330,2329,1,19561,19595,19584,11,92,4,4,7,1539,1539,1535,1535
Yolo,31,2022-07-18,430,430,430,0,4654,4663,4660,3,2,3,3,1,377,377,374,374
Yuba,31,2022-07-18,213,213,213,0,1292,1292,1291,1,18,0,0,0,121,121,121,121
Alameda,32,2022-07-25,4398,4406,4404,2,40440,40516,40496,20,143,12,12,19,1978,1978,1966,1966
Amador,32,2022-07-25,89,89,89,0,1206,1207,1206,1,3,0,0,1,88,88,88,88
Butte,32,2022-07-25,359,359,359,0,2945,2950,2949,1,30,1,1,2,453,453,452,452
Calaveras,32,2022-07-25,82,82,82,0,558,559,558,1,0,2,2,1,131,131,129,129
Colusa,32,2022-07-25,26,26,26,0,373,374,373,1,1,0,0,0,22,22,22,22
Contra Costa,32,2022-07-25,2821,2828,2826,2,21979,22020,22001,19,102,7,7,18,1400,1400,1393,1393
Del Norte,32,2022-07-25,66,66,66,0,534,535,534,1,6,0,0,0,53,53,53,53
El Dorado,32,2022-07-25,271,271,271,0,2485,2490,2488,2,9,1,1,0,227,227,226,226
Fresno,32,2022-07-25,3353,3359,3356,3,20398,20436,20420,16,195,6,6,29,2819,2819,2813,2813
Glenn,32,2022-07-25,31,31,31,0,271,272,271,1,0,0,0,0,53,53,53,53
Humboldt,32,2022-07-25,230,230,230,0,1923,1928,1927,1,13,2,2,4,156,156,154,154
Imperial,32,2022-07-25,872,872,871,1,4341,4349,4346,3,18,1,1,6,952,952,951,951
Inyo,32,2022-07-25,18,18,18,0,284,285,284,1,2,1,1,0,58,58,57,57
Kern,32,2022-07-25,1897,1902,1901,1,14987,15015,15006,9,82,3,3,12,2384,2384,2381,2381
Kings,32,2022-07-25,573,573,573,0,3888,3894,3891,3,15,1,1,0,454,454,453,453
Lake,32,2022-07-25,128,128,128,0,1041,1042,1041,1,5,1,1,2,143,143,142,142
Lassen,32,2022-07-25,53,53,53,0,1071,1072,1071,1,1,0,0,0,63,63,63,63
Los Angeles,32,2022-07-25,37110,37181,37174,7,334167,334796,334729,67,1152,120,120,134,32708,32708,32588,32588
Madera,32,2022-07-25,538,538,538,0,3828,3833,3830,3,11,1,1,5,371,371,370,370
Marin,32,2022-07-25,488,488,488,0,5411,5423,5419,4,26,2,2,2,308,308,306,306
Mariposa,32,2022-07-25,40,40,40,0,232,233,232,1,0,0,0,0,29,29,29,29
Mendocino,32,2022-07-25,196,196,196,0,1426,1428,1426,2,6,0,0,0,133,133,133,133
Merced,32,2022-07-25,730,730,730,0,3904,3910,3908,2,22,2,2,2,843,843,841,841
Modoc,32,2022-07-25,5,5,5,0,28,29,28,1,0,1,1,0,9,9,8,8
Mono,32,2022-07-25,15,15,15,0,84,85,84,1,0,0,0,0,7,7,7,7
Monterey,32,2022-07-25,932,932,931,1,7129,7143,7134,9,39,1,1,3,758,758,757,757
Napa,32,2022-07-25,296,296,296,0,2930,2935,2933,2,6,3,3,0,154,154,151,151
Nevada,32,2022-07-25,116,116,116,0,1316,1317,1316,1,3,1,1,0,132,132,131,131
Orange,32,2022-07-25,7991,8005,8001,4,58137,58247,58220,27,306,37,37,35,7310,7310,7273,7273
Placer,32,2022-07-25,605,605,604,1,5086,5096,5092,4,77,5,5,11,651,651,646,646
Plumas,32,2022-07-25,25,25,25,0,188,189,188,1,0,0,0,0,13,13,13,13
Riverside,32,2022-07-25,7502,7514,7509,5,45932,46019,45990,29,259,16,16,27,6558,6558,6542,6542
Sacramento,32,2022-07-25,3627,3634,3632,2,29833,29890,29870,20,207,18,18,32,3218,3218,3200,3200
San Benito,32,2022-07-25,198,198,198,0,1396,1398,1397,1,0,1,1,0,97,97,96,96
San Bernardino,32,2022-07-25,7087,7100,7096,4,52131,52230,52204,26,214,30,30,23,7960,7960,7930,7930
San Diego,32,2022-07-25,11898,11920,11917,3,76172,76315,76299,16,393,18,18,41,5460,5460,5442,5442
San Francisco,32,2022-07-25,2292,2297,2294,3,24269,24314,24280,34,126,9,9,24,975,975,966,966
San Joaquin,32,2022-07-25,1835,1839,1838,1,16573,16603,16591,12,73,5,5,9,2293,2293,2288,2288
San Luis Obispo,32,2022-07-25,538,538,538,0,4382,4391,4388,3,16,4,4,1,511,511,507,507
San Mateo,32,2022-07-25,2024,2029,2028,1,21674,21714,21704,10,57,1,1,7,733,733,732,732
Santa Barbara,32,2022-07-25,1177,1177,1176,1,8770,8786,8780,6,37,4,4,3,715,715,711,711
Santa Clara,32,2022-07-25,5774,5786,5785,1,50845,50940,50929,11,238,16,16,26,2437,2437,2421,2421
Santa Cruz,32,2022-07-25,832,832,832,0,7659,7672,7668,4,23,0,0,0,268,268,268,268
Shasta,32,2022-07-25,305,305,305,0,3079,3085,3083,2,38,2,2,6,581,581,579,579
Siskiyou,32,2022-07-25,36,36,36,0,333,334,333,1,1,0,0,0,86,86,86,86
Solano,32,2022-07-25,1197,1197,1196,1,9464,9482,9476,6,56,0,0,5,454,454,454,454
Sonoma,32,2022-07-25,1065,1065,1064,1,8650,8666,8661,5,48,2,2,4,509,509,507,507
Stanislaus,32,2022-07-25,1379,1380,1379,1,8157,8171,8163,8,104,8,8,11,1736,1736,1728,1728
Sutter,32,2022-07-25,222,222,222,0,1721,1724,1723,1,0,0,0,0,228,228,228,228
Tehama,32,2022-07-25,103,103,103,0,920,920,919,1,5,2,2,0,212,212,210,210
Trinity,32,2022-07-25,12,12,12,0,102,103,102,1,0,0,0,0,20,20,20,20
Tulare,32,2022-07-25,1140,1140,1139,1,8016,8032,8024,8,42,2,2,2,1518,1518,1516,1516
Tuolumne,32,2022-07-25,200,200,200,0,1150,1150,1149,1,5,1,1,0,196,196,195,195
Ventura,32,2022-07-25,2154,2159,2158,1,18388,18424,18416,8,76,5,5,8,1544,1544,1539,1539
Yolo,32,2022-07-25,411,411,411,0,4389,4398,4396,2,4,3,3,1,380,380,377,377
Yuba,32,2022-07-25,175,175,175,0,1282,1283,1282,1,15,0,0,0,121,121,121,121
Alameda,33,2022-08-01,3813,3820,3819,1,37198,37272,37257,15,176,7,7,21,1985,1985,1978,1978
Amador,33,2022-08-01,54,54,54,0,1133,1134,1133,1,3,1,1,0,89,89,88,88
Butte,33,2022-08-01,368,368,368,0,2843,2848,2847,1,33,2,2,3,455,455,453,453
Calaveras,33,2022-08-01,68,68,68,0,573,574,573,1,2,1,1,2,132,132,131,131
Colusa,33,2022-08-01,26,26,26,0,362,363,362,1,7,0,0,0,22,22,22,22
Contra Costa,33,2022-08-01,2618,2624,2622,2,21016,21058,21044,14,86,13,13,15,1413,1413,1400,1400
Del Norte,33,2022-08-01,52,52,52,0,476,477,476,1,4,0,0,2,53,53,53,53
El Dorado,33,2022-08-01,232,232,232,0,2456,2461,2460,1,4,3,3,2,230,230,227,227
Fresno,33,2022-08-01,2984,2989,2987,2,18320,18356,18345,11,231,9,9,16,2828,2828,2819,2819
Glenn,33,2022-08-01,28,28,28,0,251,252,251,1,0,0,0,0,53,53,53,53
Humboldt,33,2022-08-01,223,223,223,0,1880,1885,1884,1,12,0,0,3,156,156,156,156
Imperial,33,2022-08-01,635,635,635,0,3530,3535,3533,2,22,5,5,3,957,957,952,952
Inyo,33,2022-08-01,20,20,20,0,280,281,280,1,2,0,0,0,58,58,58,58
Kern,33,2022-08-01,1688,1691,1690,1,14820,14851,14844,7,81,6,6,17,2390,2390,2384,2384
Kings,33,2022-08-01,623,623,623,0,4044,4052,4050,2,6,0,0,1,454,454,454,454
Lake,33,2022-08-01,125,125,125,0,994,995,994,1,7,0,0,2,143,143,143,143
Lassen,33,2022-08-01,102,102,102,0,947,949,948,1,0,0,0,0,63,63,63,63
Los Angeles,33,2022-08-01,30578,30639,30634,5,308922,309534,309486,48,1105,129,129,137,32837,32837,32708,32708
Madera,33,2022-08-01,464,464,464,0,3483,3489,3487,2,10,0,0,7,371,371,371,371
Marin,33,2022-08-01,411,411,411,0,5129,5141,5138,3,32,1,1,4,309,309,308,308
Mariposa,33,2022-08-01,22,22,22,0,225,226,225,1,0,0,0,0,29,29,29,29
Mendocino,33,2022-08-01,175,175,175,0,1258,1259,1258,1,6,1,1,1,134,134,133,133
Merced,33,2022-08-01,640,640,640,0,3550,3556,3554,2,22,6,6,2,849,849,843,843
Modoc,33,2022-08-01,16,16,16,0,31,32,31,1,0,0,0,0,9,9,9,9
Mono,33,2022-08-01,9,9,9,0,67,68,67,1,0,0,0,0,7,7,7,7
Monterey,33,2022-08-01,928,928,927,1,6402,6414,6408,6,33,2,2,1,760,760,758,758
Napa,33,2022-08-01,282,282,282,0,2836,2841,2840,1,8,0,0,2,154,154,154,154
Nevada,33,2022-08-01,125,125,125,0,1404,1406,1405,1,12,0,0,0,132,132,132,132
Orange,33,2022-08-01,6469,6481,6479,2,52410,52514,52495,19,246,34,34,49,7344,7344,7310,7310
Placer,33,2022-08-01,588,588,588,0,4744,4753,4750,3,71,1,1,11,652,652,651,651
Plumas,33,2022-08-01,23,23,23,0,162,163,162,1,0,0,0,0,13,13,13,13
Riverside,33,2022-08-01,6116,6128,6125,3,42273,42356,42335,21,200,5,5,23,6563,6563,6558,6558
Sacramento,33,2022-08-01,3090,3096,3094,2,27842,27898,27883,15,179,18,18,26,3236,3236,3218,3218
San Benito,33,2022-08-01,177,177,177,0,839,840,839,1,2,1,1,0,98,98,97,97
San Bernardino,33,2022-08-01,6058,6070,6068,2,48910,49007,48988,19,184,26,26,23,7986,7986,7960,7960
San Diego,33,2022-08-01,9367,9385,9383,2,68638,68776,68765,11,396,15,15,46,5475,5475,5460,5460
San Francisco,33,2022-08-01,1813,1816,1814,2,21992,22037,22013,24,105,13,13,20,988,988,975,975
San Joaquin,33,2022-08-01,1733,1738,1737,1,16113,16145,16136,9,69,7,7,11,2300,2300,2293,2293
San Luis Obispo,33,2022-08-01,577,577,577,0,4141,4148,4146,2,14,3,3,0,514,514,511,511
San Mateo,33,2022-08-01,1774,1778,1777,1,20330,20370,20363,7,67,1,1,3,734,734,733,733
Santa Barbara,33,2022-08-01,1117,1117,1116,1,7779,7794,7790,4,40,1,1,3,716,716,715,715
Santa Clara,33,2022-08-01,4816,4826,4825,1,45429,45519,45511,8,230,19,19,36,2456,2456,2437,2437
Santa Cruz,33,2022-08-01,748,748,748,0,6872,6885,6882,3,20,1,1,3,269,269,268,268
Shasta,33,2022-08-01,243,243,243,0,2968,2974,2972,2,34,1,1,7,582,582,581,581
Siskiyou,33,2022-08-01,29,29,29,0,298,299,298,1,2,0,0,0,86,86,86,86
Solano,33,2022-08-01,1139,1139,1138,1,9123,9143,9139,4,53,0,0,4,454,454,454,454
Sonoma,33,2022-08-01,922,922,922,0,8182,8197,8193,4,46,3,3,3,512,512,509,509
Stanislaus,33,2022-08-01,1234,1234,1233,1,7718,7733,7727,6,115,6,6,8,1742,1742,1736,1736
Sutter,33,2022-08-01,232,232,232,0,1634,1637,1636,1,0,3,3,0,231,231,228,228
Tehama,33,2022-08-01,89,89,89,0,757,757,756,1,4,0,0,0,212,212,212,212
Trinity,33,2022-08-01,11,11,11,0,71,72,71,1,0,1,1,0,21,21,20,20
Tulare,33,2022-08-01,1033,1033,1032,1,7462,7478,7472,6,46,1,1,3,1519,1519,1518,1518
Tuolumne,33,2022-08-01,144,144,144,0,1111,1112,1111,1,4,0,0,1,196,196,196,196
Ventura,33,2022-08-01,1806,1811,1810,1,16967,17001,16995,6,75,10,10,10,1554,1554,1544,1544
Yolo,33,2022-08-01,331,331,331,0,4175,4184,4182,2,3,3,3,1,383,383,380,380
Yuba,33,2022-08-01,159,159,159,0,1216,1217,1216,1,10,0,0,3,121,121,121,121
Alameda,34,2022-08-08,3278,3285,3284,1,35238,35310,35299,11,133,13,13,20,1998,1998,1985,1985
Amador,34,2022-08-08,50,50,50,0,852,853,852,1,3,0,0,1,89,89,89,89
Butte,34,2022-08-08,334,334,334,0,2493,2498,2497,1,33,1,1,1,456,456,455,455
Calaveras,34,2022-08-08,57,57,57,0,559,560,559,1,1,1,1,0,133,133,132,132
Colusa,34,2022-08-08,15,15,15,0,362,363,362,1,0,0,0,0,22,22,22,22
Contra Costa,34,2022-08-08,2177,2183,2182,1,19793,19834,19824,10,102,4,4,14,1417,1417,1413,1413
Del Norte,34,2022-08-08,49,49,49,0,498,499,498,1,4,1,1,1,54,54,53,53
El Dorado,34,2022-08-08,192,192,192,0,2317,2322,2321,1,4,0,0,2,230,230,230,230
Fresno,34,2022-08-08,2415,2420,2419,1,17765,17802,17793,9,207,8,8,25,2836,2836,2828,2828
Glenn,34,2022-08-08,22,22,22,0,249,250,249,1,0,0,0,0,53,53,53,53
Humboldt,34,2022-08-08,208,208,208,0,1919,1924,1923,1,12,1,1,2,157,157,156,156
Imperial,34,2022-08-08,547,547,547,0,3277,3283,3282,1,16,2,2,2,959,959,957,957
Inyo,34,2022-08-08,8,8,8,0,276,277,276,1,1,0,0,1,58,58,58,58
Kern,34,2022-08-08,1314,1314,1314,0,13659,13688,13683,5,61,6,6,16,2396,2396,2390,2390
Kings,34,2022-08-08,468,468,468,0,3323,3329,3328,1,20,0,0,2,454,454,454,454
Lake,34,2022-08-08,106,106,106,0,893,894,893,1,4,0,0,1,143,143,143,143
Lassen,34,2022-08-08,132,132,132,0,1023,1025,1024,1,1,0,0,0,63,63,63,63
Los Angeles,34,2022-08-08,25728,25782,25779,3,291009,291614,291579,35,1030,127,127,121,32964,32964,32837,32837
Madera,34,2022-08-08,380,380,380,0,3175,3180,3178,2,16,0,0,3,371,371,371,371
Marin,34,2022-08-08,359,359,359,0,4482,4491,4489,2,26,2,2,2,311,311,309,309
Mariposa,34,2022-08-08,28,28,28,0,197,198,197,1,0,0,0,0,29,29,29,29
Mendocino,34,2022-08-08,132,132,132,0,1128,1129,1128,1,3,1,1,1,135,135,134,134
Merced,34,2022-08-08,538,538,538,0,3380,3386,3385,1,17,1,1,5,850,850,849,849
Modoc,34,2022-08-08,2,2,2,0,22,23,22,1,0,0,0,0,9,9,9,9
Mono,34,2022-08-08,10,10,10,0,85,86,85,1,0,0,0,0,7,7,7,7
Monterey,34,2022-08-08,739,739,738,1,5750,5762,5758,4,28,1,1,0,761,761,760,760
Napa,34,2022-08-08,252,252,252,0,2610,2615,2614,1,10,2,2,3,156,156,154,154
Nevada,34,2022-08-08,94,94,94,0,1290,1292,1291,1,4,0,0,0,132,132,132,132
Orange,34,2022-08-08,5268,5280,5279,1,48045,48145,48131,14,242,29,29,40,7373,7373,7344,7344
Placer,34,2022-08-08,512,512,512,0,4518,4527,4525,2,65,3,3,9,655,655,652,652
Plumas,34,2022-08-08,23,23,23,0,190,191,190,1,1,0,0,0,13,13,13,13
Riverside,34,2022-08-08,5498,5510,5508,2,40553,40636,40621,15,174,13,13,13,6576,6576,6563,6563
Sacramento,34,2022-08-08,2625,2631,2630,1,26964,27020,27009,11,156,16,16,20,3252,3252,3236,3236
San Benito,34,2022-08-08,184,184,184,0,872,873,872,1,1,0,0,0,98,98,98,98
San Bernardino,34,2022-08-08,5036,5047,5045,2,45831,45926,45912,14,204,20,20,15,8006,8006,7986,7986
San Diego,34,2022-08-08,7276,7291,7290,1,64411,64545,64537,8,337,10,10,30,5485,5485,5475,5475
San Francisco,34,2022-08-08,1492,1494,1493,1,20618,20661,20644,17,94,11,11,21,999,999,988,988
San Joaquin,34,2022-08-08,1519,1522,1521,1,15716,15749,15742,7,55,6,6,12,2306,2306,2300,2300
San Luis Obispo,34,2022-08-08,509,509,509,0,3610,3617,3616,1,14,0,0,2,514,514,514,514
San Mateo,34,2022-08-08,1517,1520,1520,0,18502,18542,18537,5,60,0,0,5,734,734,734,734
Santa Barbara,34,2022-08-08,961,961,961,0,7518,7533,7530,3,46,3,3,4,719,719,716,716
Santa Clara,34,2022-08-08,4137,4146,4145,1,40819,40903,40897,6,203,16,16,40,2472,2472,2456,2456
Santa Cruz,34,2022-08-08,618,618,618,0,6046,6059,6057,2,28,1,1,0,270,270,269,269
Shasta,34,2022-08-08,197,197,197,0,2831,2837,2836,1,33,1,1,3,583,583,582,582
Siskiyou,34,2022-08-08,27,27,27,0,291,292,291,1,0,1,1,0,87,87,86,86
Solano,34,2022-08-08,877,877,877,0,7948,7965,7962,3,54,0,0,9,454,454,454,454
Sonoma,34,2022-08-08,839,839,839,0,7721,7736,7733,3,34,4,4,3,516,516,512,512
Stanislaus,34,2022-08-08,1033,1033,1032,1,7170,7184,7180,4,90,7,7,11,1749,1749,1742,1742
Sutter,34,2022-08-08,223,223,223,0,1551,1554,1553,1,0,0,0,0,231,231,231,231
Tehama,34,2022-08-08,77,77,77,0,681,682,681,1,0,0,0,1,212,212,212,212
Trinity,34,2022-08-08,5,5,5,0,71,72,71,1,0,0,0,0,21,21,21,21
Tulare,34,2022-08-08,883,883,882,1,7320,7336,7332,4,46,4,4,3,1523,1523,1519,1519
Tuolumne,34,2022-08-08,118,118,118,0,1054,1054,1053,1,4,2,2,0,198,198,196,196
Ventura,34,2022-08-08,1503,1506,1506,0,15931,15964,15960,4,67,7,7,7,1561,1561,1554,1554
Yolo,34,2022-08-08,287,287,287,0,3881,3889,3888,1,4,1,1,3,384,384,383,383
Yuba,34,2022-08-08,136,136,136,0,1086,1087,1086,1,6,1,1,0,122,122,121,121
Alameda,35,2022-08-15,2561,2568,2567,1,33710,33783,33775,8,105,9,9,22,2007,2007,1998,1998
Amador,35,2022-08-15,47,47,47,0,848,849,848,1,2,0,0,0,89,89,89,89
Butte,35,2022-08-15,260,260,260,0,2244,2250,2249,1,19,0,0,2,456,456,456,456
Calaveras,35,2022-08-15,46,46,46,0,528,529,528,1,0,0,0,0,133,133,133,133
Colusa,35,2022-08-15,16,16,16,0,359,360,359,1,1,0,0,0,22,22,22,22
Contra Costa,35,2022-08-15,1777,1782,1781,1,18962,19003,18995,8,72,6,6,9,1423,1423,1417,1417
Del Norte,35,2022-08-15,52,52,52,0,499,500,499,1,2,0,0,1,54,54,54,54
El Dorado,35,2022-08-15,177,177,177,0,2304,2309,2308,1,5,0,0,3,230,230,230,230
Fresno,35,2022-08-15,1867,1872,1871,1,16171,16207,16201,6,170,7,7,17,2843,2843,2836,2836
Glenn,35,2022-08-15,15,15,15,0,225,226,225,1,3,0,0,0,53,53,53,53
Humboldt,35,2022-08-15,179,179,179,0,1587,1593,1592,1,16,0,0,2,157,157,157,157
Imperial,35,2022-08-15,366,366,366,0,3099,3104,3103,1,11,0,0,2,959,959,959,959
Inyo,35,2022-08-15,14,14,14,0,236,237,236,1,2,1,1,0,59,59,58,58
Kern,35,2022-08-15,1215,1216,1216,0,13478,13507,13503,4,59,7,7,16,2403,2403,2396,2396
Kings,35,2022-08-15,332,332,332,0,3235,3240,3239,1,9,0,0,1,454,454,454,454
Lake,35,2022-08-15,103,103,103,0,1028,1030,1029,1,3,1,1,2,144,144,143,143
Lassen,35,2022-08-15,59,59,59,0,897,900,899,1,0,0,0,0,63,63,63,63
Los Angeles,35,2022-08-15,20901,20948,20946,2,287482,288109,288082,27,905,110,110,117,33074,33074,32964,32964
Madera,35,2022-08-15,304,304,304,0,2954,2960,2959,1,12,0,0,3,371,371,371,371
Marin,35,2022-08-15,293,293,293,0,4107,4117,4115,2,15,0,0,0,311,311,311,311
Mariposa,35,2022-08-15,15,15,15,0,192,193,192,1,0,0,0,0,29,29,29,29
Mendocino,35,2022-08-15,104,104,104,0,996,996,995,1,7,0,0,3,135,135,135,135
Merced,35,2022-08-15,451,451,451,0,3407,3413,3412,1,12,2,2,1,852,852,850,850
Modoc,35,2022-08-15,4,4,4,0,23,24,23,1,0,0,0,0,9,9,9,9
Mono,35,2022-08-15,4,4,4,0,61,62,61,1,0,0,0,0,7,7,7,7
Monterey,35,2022-08-15,662,662,662,0,5803,5816,5813,3,30,0,0,1,761,761,761,761
Napa,35,2022-08-15,212,212,212,0,2280,2285,2284,1,13,0,0,0,156,156,156,156
Nevada,35,2022-08-15,98,98,98,0,1209,1211,1210,1,7,0,0,0,132,132,132,132
Orange,35,2022-08-15,4561,4572,4571,1,43027,43121,43111,10,270,31,31,44,7404,7404,7373,7373
Placer,35,2022-08-15,411,411,411,0,4469,4480,4478,2,61,1,1,11,656,656,655,655
Plumas,35,2022-08-15,17,17,17,0,184,185,184,1,0,0,0,0,13,13,13,13
Riverside,35,2022-08-15,4558,4569,4568,1,38026,38110,38099,11,143,16,16,22,6592,6592,6576,6576
Sacramento,35,2022-08-15,2349,2354,2353,1,25410,25464,25456,8,149,11,11,22,3263,3263,3252,3252
San Benito,35,2022-08-15,140,140,140,0,782,783,782,1,3,1,1,1,99,99,98,98
San Bernardino,35,2022-08-15,4685,4695,4694,1,44143,44239,44228,11,144,14,14,22,8020,8020,8006,8006
San Diego,35,2022-08-15,5499,5511,5510,1,59501,59631,59625,6,288,13,13,34,5498,5498,5485,5485
San Francisco,35,2022-08-15,1261,1262,1261,1,19570,19612,19599,13,103,15,15,11,1014,1014,999,999
San Joaquin,35,2022-08-15,1445,1447,1446,1,15214,15247,15242,5,64,8,8,8,2314,2314,2306,2306
San Luis Obispo,35,2022-08-15,325,325,325,0,3301,3307,3306,1,15,4,4,3,518,518,514,514
San Mateo,35,2022-08-15,1221,1221,1221,0,17367,17406,17402,4,56,1,1,5,735,735,734,734
Santa Barbara,35,2022-08-15,829,829,829,0,7118,7133,7131,2,44,1,1,4,720,720,719,719
Santa Clara,35,2022-08-15,3328,3335,3335,0,39700,39786,39782,4,200,8,8,24,2480,2480,2472,2472
Santa Cruz,35,2022-08-15,493,493,493,0,7538,7555,7553,2,23,3,3,1,273,273,270,270
Shasta,35,2022-08-15,193,193,193,0,2786,2792,2791,1,19,1,1,1,584,584,583,583
Siskiyou,35,2022-08-15,18,18,18,0,284,285,284,1,3,0,0,1,87,87,87,87
Solano,35,2022-08-15,659,659,659,0,7440,7456,7454,2,45,0,0,10,454,454,454,454
Sonoma,35,2022-08-15,629,629,629,0,7284,7299,7297,2,39,2,2,2,518,518,516,516
Stanislaus,35,2022-08-15,938,938,938,0,7655,7672,7668,4,99,9,9,11,1758,1758,1749,1749
Sutter,35,2022-08-15,197,197,197,0,1587,1591,1590,1,0,1,1,0,232,232,231,231
Tehama,35,2022-08-15,60,60,60,0,645,646,645,1,1,0,0,0,212,212,212,212
Trinity,35,2022-08-15,8,8,8,0,58,59,58,1,0,0,0,0,21,21,21,21
Tulare,35,2022-08-15,733,733,733,0,7326,7343,7340,3,32,3,3,1,1526,1526,1523,1523
Tuolumne,35,2022-08-15,110,110,110,0,991,992,991,1,1,0,0,0,198,198,198,198
Ventura,35,2022-08-15,1494,1497,1497,0,15260,15293,15290,3,70,6,6,7,1567,1567,1561,1561
Yolo,35,2022-08-15,264,264,264,0,3538,3546,3545,1,2,4,4,1,388,388,384,384
Yuba,35,2022-08-15,128,128,128,0,1080,1082,1081,1,9,0,0,0,122,122,122,122
Alameda,36,2022-08-22,2239,2244,2244,0,33139,33215,33209,6,117,8,8,21,2015,2015,2007,2007
Amador,36,2022-08-22,49,49,49,0,815,816,815,1,2,1,1,0,90,90,89,89
Butte,36,2022-08-22,222,222,222,0,2130,2136,2135,1,17,1,1,2,457,457,456,456
Calaveras,36,2022-08-22,43,43,43,0,572,573,572,1,1,0,0,0,133,133,133,133
Colusa,36,2022-08-22,16,16,16,0,394,395,394,1,0,0,0,0,22,22,22,22
Contra Costa,36,2022-08-22,1528,1532,1532,0,18832,18875,18869,6,56,5,5,9,1428,1428,1423,1423
Del Norte,36,2022-08-22,31,31,31,0,461,462,461,1,3,1,1,0,55,55,54,54
El Dorado,36,2022-08-22,152,152,152,0,2219,2224,2223,1,4,1,1,0,231,231,230,230
Fresno,36,2022-08-22,1591,1596,1596,0,15782,15819,15814,5,162,6,6,14,2849,2849,2843,2843
Glenn,36,2022-08-22,23,23,23,0,227,228,227,1,1,0,0,0,53,53,53,53
Humboldt,36,2022-08-22,151,151,151,0,1677,1683,1682,1,6,1,1,3,158,158,157,157
Imperial,36,2022-08-22,291,291,291,0,2844,2850,2849,1,15,0,0,0,959,959,959,959
Inyo,36,2022-08-22,8,8,8,0,213,214,213,1,0,0,0,0,59,59,59,59
Kern,36,2022-08-22,980,980,980,0,13744,13776,13773,3,69,6,6,10,2409,2409,2403,2403
Kings,36,2022-08-22,369,369,369,0,3636,3644,3643,1,10,1,1,0,455,455,454,454
Lake,36,2022-08-22,104,104,104,0,884,886,885,1,5,0,0,0,144,144,144,144
Lassen,36,2022-08-22,36,36,36,0,833,835,834,1,0,0,0,0,63,63,63,63
Los Angeles,36,2022-08-22,18441,18484,18483,1,274622,275250,275230,20,811,118,118,104,33192,33192,33074,33074
Madera,36,2022-08-22,299,299,299,0,2612,2617,2616,1,14,2,2,4,373,373,371,371
Marin,36,2022-08-22,249,249,249,0,3961,3971,3970,1,17,0,0,3,311,311,311,311
Mariposa,36,2022-08-22,14,14,14,0,172,173,172,1,0,0,0,0,29,29,29,29
Mendocino,36,2022-08-22,121,121,121,0,1145,1148,1147,1,3,0,0,2,135,135,135,135
Merced,36,2022-08-22,446,446,446,0,3636,3644,3643,1,12,4,4,1,856,856,852,852
Modoc,36,2022-08-22,6,6,6,0,27,28,27,1,0,0,0,0,9,9,9,9
Mono,36,2022-08-22,4,4,4,0,63,64,63,1,0,0,0,0,7,7,7,7
Monterey,36,2022-08-22,546,546,546,0,5905,5919,5916,3,27,1,1,2,762,762,761,761
Napa,36,2022-08-22,128,128,128,0,1999,2005,2004,1,5,2,2,1,158,158,156,156
Nevada,36,2022-08-22,84,84,84,0,1180,1182,1181,1,6,0,0,0,132,132,132,132
Orange,36,2022-08-22,3786,3796,3795,1,40764,40856,40849,7,224,21,21,35,7425,7425,7404,7404
Placer,36,2022-08-22,383,383,383,0,4302,4313,4312,1,61,1,1,14,657,657,656,656
Plumas,36,2022-08-22,20,20,20,0,175,176,175,1,1,0,0,0,13,13,13,13
Riverside,36,2022-08-22,4380,4390,4389,1,37505,37591,37582,9,142,13,13,19,6605,6605,6592,6592
Sacramento,36,2022-08-22,2076,2081,2080,1,24954,25012,25006,6,144,14,14,25,3277,3277,3263,3263
San Benito,36,2022-08-22,102,102,102,0,698,699,698,1,1,1,1,1,100,100,99,99
San Bernardino,36,2022-08-22,4614,4625,4624,1,44240,44339,44331,8,160,18,18,22,8038,8038,8020,8020
San Diego,36,2022-08-22,4784,4795,4795,0,57538,57669,57665,4,287,6,6,28,5504,5504,5498,5498
San Francisco,36,2022-08-22,1094,1094,1093,1,18859,18902,18892,10,81,16,16,12,1030,1030,1014,1014
San Joaquin,36,2022-08-22,1195,1196,1196,0,15723,15759,15755,4,56,1,1,8,2315,2315,2314,2314
San Luis Obispo,36,2022-08-22,258,258,258,0,3089,3095,3094,1,16,1,1,0,519,519,518,518
San Mateo,36,2022-08-22,1013,1013,1013,0,17202,17242,17239,3,42,0,0,2,735,735,735,735
Santa Barbara,36,2022-08-22,736,736,736,0,7435,7452,7450,2,37,1,1,2,721,721,720,720
Santa Clara,36,2022-08-22,3013,3020,3020,0,40156,40247,40244,3,173,10,10,27,2490,2490,2480,2480
Santa Cruz,36,2022-08-22,502,502,502,0,11958,11984,11982,2,13,0,0,0,273,273,273,273
Shasta,36,2022-08-22,172,172,172,0,2757,2763,2762,1,10,2,2,2,586,586,584,584
Siskiyou,36,2022-08-22,25,25,25,0,249,250,249,1,4,1,1,2,88,88,87,87
Solano,36,2022-08-22,526,526,526,0,7194,7211,7209,2,35,0,0,12,454,454,454,454
Sonoma,36,2022-08-22,605,605,605,0,7370,7387,7385,2,42,2,2,1,520,520,518,518
Stanislaus,36,2022-08-22,892,892,892,0,7647,7664,7661,3,79,7,7,16,1765,1765,1758,1758
Sutter,36,2022-08-22,189,189,189,0,1657,1662,1661,1,0,0,0,0,232,232,232,232
Tehama,36,2022-08-22,53,53,53,0,629,630,629,1,1,0,0,0,212,212,212,212
Trinity,36,2022-08-22,10,10,10,0,63,64,63,1,0,0,0,0,21,21,21,21
Tulare,36,2022-08-22,727,727,727,0,6780,6796,6794,2,33,4,4,1,1530,1530,1526,1526
Tuolumne,36,2022-08-22,106,106,106,0,1018,1020,1019,1,0,1,1,0,199,199,198,198
Ventura,36,2022-08-22,1318,1321,1321,0,14997,15032,15030,2,59,4,4,9,1571,1571,1567,1567
Yolo,36,2022-08-22,200,200,200,0,3483,3492,3491,1,10,1,1,1,389,389,388,388
Yuba,36,2022-08-22,126,126,126,0,1106,1108,1107,1,13,0,0,3,122,122,122,122
Alameda,37,2022-08-29,1965,1970,1970,0,34182,34264,34259,5,99,11,11,20,2026,2026,2015,2015
Amador,37,2022-08-29,46,46,46,0,804,806,805,1,2,1,1,0,91,91,90,90
Butte,37,2022-08-29,236,236,236,0,2170,2176,2175,1,18,0,0,3,457,457,457,457
Calaveras,37,2022-08-29,59,59,59,0,591,592,591,1,1,0,0,0,133,133,133,133
Colusa,37,2022-08-29,10,10,10,0,329,330,329,1,3,0,0,0,22,22,22,22
Contra Costa,37,2022-08-29,1351,1353,1353,0,18787,18832,18827,5,44,5,5,7,1433,1433,1428,1428
Del Norte,37,2022-08-29,28,28,28,0,431,432,431,1,5,0,0,1,55,55,55,55
El Dorado,37,2022-08-29,144,144,144,0,1947,1953,1952,1,1,0,0,1,231,231,231,231
Fresno,37,2022-08-29,1417,1420,1420,0,15740,15778,15774,4,159,3,3,15,2852,2852,2849,2849
Glenn,37,2022-08-29,22,22,22,0,220,221,220,1,1,0,0,0,53,53,53,53
Humboldt,37,2022-08-29,124,124,124,0,1662,1668,1667,1,4,0,0,0,158,158,158,158
Imperial,37,2022-08-29,294,294,294,0,2935,2941,2940,1,14,1,1,2,960,960,959,959
Inyo,37,2022-08-29,8,8,8,0,175,176,175,1,0,0,0,0,59,59,59,59
Kern,37,2022-08-29,885,885,885,0,13225,13256,13254,2,50,0,0,8,2409,2409,2409,2409
Kings,37,2022-08-29,314,314,314,0,3490,3497,3496,1,8,0,0,0,455,455,455,455
Lake,37,2022-08-29,93,93,93,0,870,871,870,1,1,1,1,0,145,145,144,144
Lassen,37,2022-08-29,28,28,28,0,771,773,772,1,0,0,0,0,63,63,63,63
Los Angeles,37,2022-08-29,15519,15556,15555,1,271321,271974,271958,16,753,86,86,83,33278,33278,33192,33192
Madera,37,2022-08-29,301,301,301,0,3019,3027,3026,1,13,0,0,3,373,373,373,373
Marin,37,2022-08-29,215,215,215,0,3840,3850,3849,1,16,2,2,2,313,313,311,311
Mariposa,37,2022-08-29,25,25,25,0,186,187,186,1,0,0,0,0,29,29,29,29
Mendocino,37,2022-08-29,87,87,87,0,969,970,969,1,2,0,0,1,135,135,135,135
Merced,37,2022-08-29,392,392,392,0,3397,3405,3404,1,11,3,3,0,859,859,856,856
Modoc,37,2022-08-29,1,1,1,0,30,31,30,1,0,0,0,0,9,9,9,9
Mono,37,2022-08-29,2,2,2,0,45,46,45,1,0,0,0,0,7,7,7,7
Monterey,37,2022-08-29,396,396,396,0,5353,5367,5365,2,33,2,2,5,764,764,762,762
Napa,37,2022-08-29,128,128,128,0,2157,2163,2162,1,10,0,0,1,158,158,158,158
Nevada,37,2022-08-29,116,116,116,0,1206,1208,1207,1,6,0,0,0,132,132,132,132
Orange,37,2022-08-29,2936,2943,2943,0,39168,39262,39257,5,195,18,18,25,7443,7443,7425,7425
Placer,37,2022-08-29,369,369,369,0,4210,4221,4220,1,55,1,1,12,658,658,657,657
Plumas,37,2022-08-29,18,18,18,0,159,160,159,1,1,0,0,0,13,13,13,13
Riverside,37,2022-08-29,3647,3656,3655,1,36826,36914,36907,7,124,9,9,11,6614,6614,6605,6605
Sacramento,37,2022-08-29,1855,1860,1860,0,24692,24751,24746,5,137,10,10,20,3287,3287,3277,3277
San Benito,37,2022-08-29,120,120,120,0,779,780,779,1,1,0,0,0,100,100,100,100
San Bernardino,37,2022-08-29,3618,3626,3625,1,42069,42169,42163,6,156,14,14,18,8052,8052,8038,8038
San Diego,37,2022-08-29,3933,3942,3942,0,56590,56726,56723,3,222,12,12,25,5516,5516,5504,5504
San Francisco,37,2022-08-29,870,870,870,0,19138,19184,19176,8,57,7,7,12,1037,1037,1030,1030
San Joaquin,37,2022-08-29,1003,1004,1004,0,14293,14327,14324,3,27,5,5,11,2320,2320,2315,2315
San Luis Obispo,37,2022-08-29,326,326,326,0,3216,3223,3222,1,17,3,3,0,522,522,519,519
San Mateo,37,2022-08-29,849,849,849,0,16779,16819,16817,2,26,0,0,5,735,735,735,735
Santa Barbara,37,2022-08-29,638,638,638,0,7623,7641,7640,1,24,1,1,3,722,722,721,721
Santa Clara,37,2022-08-29,2307,2314,2314,0,39522,39617,39614,3,135,5,5,24,2495,2495,2490,2490
Santa Cruz,37,2022-08-29,384,384,384,0,12670,12700,12698,2,16,0,0,1,273,273,273,273
Shasta,37,2022-08-29,129,129,129,0,2576,2582,2581,1,19,1,1,1,587,587,586,586
Siskiyou,37,2022-08-29,24,24,24,0,249,250,249,1,0,1,1,0,89,89,88,88
Solano,37,2022-08-29,546,546,546,0,7265,7283,7282,1,33,1,1,8,455,455,454,454
Sonoma,37,2022-08-29,486,486,486,0,7102,7121,7120,1,37,1,1,4,521,521,520,520
Stanislaus,37,2022-08-29,848,848,848,0,8082,8101,8099,2,79,7,7,6,1772,1772,1765,1765
Sutter,37,2022-08-29,170,170,170,0,1638,1644,1643,1,0,0,0,0,232,232,232,232
Tehama,37,2022-08-29,66,66,66,0,737,738,737,1,4,0,0,1,212,212,212,212
Trinity,37,2022-08-29,9,9,9,0,56,57,56,1,0,0,0,0,21,21,21,21
Tulare,37,2022-08-29,679,679,679,0,7369,7388,7386,2,42,0,0,1,1530,1530,1530,1530
Tuolumne,37,2022-08-29,91,91,91,0,856,857,856,1,1,0,0,0,199,199,199,199
Ventura,37,2022-08-29,1020,1020,1020,0,14598,14633,14631,2,71,6,6,7,1577,1577,1571,1571
Yolo,37,2022-08-29,204,204,204,0,3710,3719,3718,1,5,0,0,3,389,389,389,389
Yuba,37,2022-08-29,135,135,135,0,1176,1179,1178,1,14,0,0,1,122,122,122,122
Alameda,38,2022-09-05,1432,1436,1436,0,28119,28189,28186,3,89,4,4,16,2030,2030,2026,2026
Amador,38,2022-09-05,44,44,44,0,748,750,749,1,3,0,0,2,91,91,91,91
Butte,38,2022-09-05,193,193,193,0,2122,2128,2127,1,14,2,2,2,459,459,457,457
Calaveras,38,2022-09-05,22,22,22,0,451,452,451,1,0,0,0,0,133,133,133,133
Colusa,38,2022-09-05,8,8,8,0,197,198,197,1,2,0,0,0,22,22,22,22
Contra Costa,38,2022-09-05,956,956,956,0,15423,15462,15459,3,62,5,5,9,1438,1438,1433,1433
Del Norte,38,2022-09-05,8,8,8,0,347,348,347,1,1,0,0,1,55,55,55,55
El Dorado,38,2022-09-05,91,91,91,0,1523,1528,1527,1,3,1,1,3,232,232,231,231
Fresno,38,2022-09-05,1084,1086,1086,0,13051,13082,13080,2,162,10,10,16,2862,2862,2852,2852
Glenn,38,2022-09-05,11,11,11,0,188,189,188,1,1,0,0,0,53,53,53,53
Humboldt,38,2022-09-05,110,110,110,0,1294,1299,1298,1,9,1,1,2,159,159,158,158
Imperial,38,2022-09-05,235,235,235,0,2521,2528,2527,1,8,1,1,2,961,961,960,960
Inyo,38,2022-09-05,12,12,12,0,139,140,139,1,0,0,0,1,59,59,59,59
Kern,38,2022-09-05,719,719,719,0,11238,11267,11265,2,50,5,5,8,2414,2414,2409,2409
Kings,38,2022-09-05,229,229,229,0,2869,2878,2877,1,8,0,0,0,455,455,455,455
Lake,38,2022-09-05,62,62,62,0,655,656,655,1,1,3,3,1,148,148,145,145
Lassen,38,2022-09-05,19,19,19,0,633,635,634,1,0,0,0,0,63,63,63,63
Los Angeles,38,2022-09-05,10669,10696,10696,0,221984,222544,222534,10,695,95,95,91,33373,33373,33278,33278
Madera,38,2022-09-05,205,205,205,0,2505,2510,2509,1,12,0,0,4,373,373,373,373
Marin,38,2022-09-05,190,190,190,0,3551,3561,3560,1,12,0,0,1,313,313,313,313
Mariposa,38,2022-09-05,16,16,16,0,166,167,166,1,0,0,0,0,29,29,29,29
Mendocino,38,2022-09-05,57,57,57,0,828,829,828,1,2,1,1,1,136,136,135,135
Merced,38,2022-09-05,250,250,250,0,2624,2631,2630,1,12,2,2,1,861,861,859,859
Modoc,38,2022-09-05,3,3,3,0,17,18,17,1,0,0,0,0,9,9,9,9
Mono,38,2022-09-05,4,4,4,0,52,53,52,1,1,0,0,0,7,7,7,7
Monterey,38,2022-09-05,245,245,245,0,4348,4360,4359,1,24,4,4,0,768,768,764,764
Napa,38,2022-09-05,101,101,101,0,1720,1725,1724,1,6,1,1,2,159,159,158,158
Nevada,38,2022-09-05,81,81,81,0,899,900,899,1,3,0,0,0,132,132,132,132
Orange,38,2022-09-05,2163,2168,2168,0,32127,32207,32204,3,169,13,13,34,7456,7456,7443,7443
Placer,38,2022-09-05,238,238,238,0,3468,3476,3475,1,36,0,0,4,658,658,658,658
Plumas,38,2022-09-05,9,9,9,0,129,130,129,1,0,0,0,0,13,13,13,13
Riverside,38,2022-09-05,2401,2407,2407,0,28558,28629,28625,4,99,7,7,14,6621,6621,6614,6614
Sacramento,38,2022-09-05,1242,1245,1245,0,19658,19707,19704,3,139,12,12,22,3299,3299,3287,3287
San Benito,38,2022-09-05,65,65,65,0,638,639,638,1,0,0,0,2,100,100,100,100
San Bernardino,38,2022-09-05,2331,2335,2335,0,34202,34288,34284,4,122,14,14,19,8066,8066,8052,8052
San Diego,38,2022-09-05,2799,2807,2807,0,48217,48339,48337,2,212,14,14,25,5530,5530,5516,5516
San Francisco,38,2022-09-05,677,677,677,0,15724,15764,15759,5,52,9,9,9,1046,1046,1037,1037
San Joaquin,38,2022-09-05,831,831,831,0,11950,11980,11978,2,43,4,4,10,2324,2324,2320,2320
San Luis Obispo,38,2022-09-05,176,176,176,0,2675,2681,2680,1,7,2,2,1,524,524,522,522
San Mateo,38,2022-09-05,612,612,612,0,13543,13577,13576,1,23,1,1,2,736,736,735,735
Santa Barbara,38,2022-09-05,484,484,484,0,6632,6649,6648,1,39,4,4,3,726,726,722,722
Santa Clara,38,2022-09-05,1891,1897,1897,0,33018,33102,33100,2,127,9,9,20,2504,2504,2495,2495
Santa Cruz,38,2022-09-05,282,282,282,0,10210,10236,10235,1,16,0,0,0,273,273,273,273
Shasta,38,2022-09-05,103,103,103,0,2022,2026,2025,1,15,0,0,0,587,587,587,587
Siskiyou,38,2022-09-05,30,30,30,0,216,217,216,1,0,0,0,0,89,89,89,89
Solano,38,2022-09-05,367,367,367,0,5942,5956,5955,1,34,1,1,11,456,456,455,455
Sonoma,38,2022-09-05,369,369,369,0,5999,6014,6013,1,40,0,0,2,521,521,521,521
Stanislaus,38,2022-09-05,547,547,547,0,6346,6363,6362,1,69,5,5,4,1777,1777,1772,1772
Sutter,38,2022-09-05,116,116,116,0,1482,1487,1486,1,0,0,0,0,232,232,232,232
Tehama,38,2022-09-05,50,50,50,0,581,582,581,1,2,1,1,0,213,213,212,212
Trinity,38,2022-09-05,4,4,4,0,51,52,51,1,0,0,0,0,21,21,21,21
Tulare,38,2022-09-05,427,427,427,0,5163,5177,5176,1,37,2,2,1,1532,1532,1530,1530
Tuolumne,38,2022-09-05,68,68,68,0,737,738,737,1,1,0,0,0,199,199,199,199
Ventura,38,2022-09-05,864,864,864,0,12305,12336,12335,1,48,8,8,1,1585,1585,1577,1577
Yolo,38,2022-09-05,139,139,139,0,2899,2908,2907,1,1,3,3,2,392,392,389,389
Yuba,38,2022-09-05,88,88,88,0,975,978,977,1,14,0,0,1,122,122,122,122
Alameda,39,2022-09-12,1612,1617,1617,0,32013,32099,32096,3,94,5,5,16,2035,2035,2030,2030
Amador,39,2022-09-12,32,32,32,0,873,875,874,1,3,0,0,2,91,91,91,91
Butte,39,2022-09-12,196,196,196,0,2466,2473,2472,1,15,3,3,2,462,462,459,459
Calaveras,39,2022-09-12,14,14,14,0,500,501,500,1,1,0,0,0,133,133,133,133
Colusa,39,2022-09-12,17,17,17,0,414,415,414,1,0,0,0,0,22,22,22,22
Contra Costa,39,2022-09-12,977,977,977,0,17326,17371,17368,3,59,6,6,12,1444,1444,1438,1438
Del Norte,39,2022-09-12,34,34,34,0,595,596,595,1,1,0,0,1,55,55,55,55
El Dorado,39,2022-09-12,104,104,104,0,1898,1904,1903,1,3,0,0,1,232,232,232,232
Fresno,39,2022-09-12,902,903,903,0,14674,14714,14712,2,155,6,6,15,2868,2868,2862,2862
Glenn,39,2022-09-12,15,15,15,0,208,209,208,1,0,0,0,0,53,53,53,53
Humboldt,39,2022-09-12,112,112,112,0,1652,1658,1657,1,6,0,0,5,159,159,159,159
Imperial,39,2022-09-12,257,257,257,0,3287,3297,3296,1,10,0,0,2,961,961,961,961
Inyo,39,2022-09-12,15,15,15,0,194,195,194,1,0,1,1,0,60,60,59,59
Kern,39,2022-09-12,637,637,637,0,12820,12855,12854,1,45,7,7,13,2421,2421,2414,2414
Kings,39,2022-09-12,228,228,228,0,3171,3181,3180,1,6,1,1,0,456,456,455,455
Lake,39,2022-09-12,48,48,48,0,882,885,884,1,3,0,0,1,148,148,148,148
Lassen,39,2022-09-12,19,19,19,0,917,921,920,1,0,0,0,0,63,63,63,63
Los Angeles,39,2022-09-12,10972,11002,11002,0,282427,283193,283183,10,652,85,85,83,33458,33458,33373,33373
Madera,39,2022-09-12,242,242,242,0,2923,2932,2931,1,8,0,0,3,373,373,373,373
Marin,39,2022-09-12,173,173,173,0,3907,3918,3917,1,12,2,2,2,315,315,313,313
Mariposa,39,2022-09-12,16,16,16,0,192,193,192,1,0,0,0,0,29,29,29,29
Mendocino,39,2022-09-12,58,58,58,0,952,954,953,1,2,0,0,1,136,136,136,136
Merced,39,2022-09-12,237,237,237,0,3290,3299,3298,1,6,2,2,1,863,863,861,861
Modoc,39,2022-09-12,2,2,2,0,22,23,22,1,0,0,0,0,9,9,9,9
Mono,39,2022-09-12,7,7,7,0,76,77,76,1,0,0,0,0,7,7,7,7
Monterey,39,2022-09-12,229,229,229,0,5091,5105,5104,1,22,1,1,1,769,769,768,768
Napa,39,2022-09-12,118,118,118,0,2248,2254,2253,1,10,0,0,1,159,159,159,159
Nevada,39,2022-09-12,61,61,61,0,1179,1183,1182,1,2,0,0,0,132,132,132,132
Orange,39,2022-09-12,2080,2086,2086,0,36677,36776,36773,3,159,27,27,22,7483,7483,7456,7456
Placer,39,2022-09-12,237,237,237,0,4073,4085,4084,1,38,0,0,5,658,658,658,658
Plumas,39,2022-09-12,22,22,22,0,194,195,194,1,1,0,0,0,13,13,13,13
Riverside,39,2022-09-12,2241,2248,2248,0,32983,33072,33068,4,124,5,5,12,6626,6626,6621,6621
Sacramento,39,2022-09-12,1277,1280,1280,0,23397,23461,23458,3,119,16,16,15,3315,3315,3299,3299
San Benito,39,2022-09-12,92,92,92,0,715,716,715,1,1,0,0,1,100,100,100,100
San Bernardino,39,2022-09-12,1924,1929,1929,0,38555,38659,38656,3,92,13,13,26,8079,8079,8066,8066
San Diego,39,2022-09-12,3036,3045,3045,0,55706,55858,55856,2,194,7,7,24,5537,5537,5530,5530
San Francisco,39,2022-09-12,814,814,814,0,17414,17462,17458,4,58,8,8,15,1054,1054,1046,1046
San Joaquin,39,2022-09-12,644,644,644,0,14267,14306,14304,2,35,5,5,9,2329,2329,2324,2324
San Luis Obispo,39,2022-09-12,187,187,187,0,3219,3228,3227,1,10,0,0,1,524,524,524,524
San Mateo,39,2022-09-12,658,658,658,0,14178,14216,14215,1,20,1,1,2,737,737,736,736
Santa Barbara,39,2022-09-12,329,329,329,0,7232,7250,7249,1,27,1,1,2,727,727,726,726
Santa Clara,39,2022-09-12,1879,1886,1886,0,37991,38095,38094,1,144,8,8,28,2512,2512,2504,2504
Santa Cruz,39,2022-09-12,271,271,271,0,13336,13371,13370,1,15,0,0,0,273,273,273,273
Shasta,39,2022-09-12,180,180,180,0,2589,2596,2595,1,26,1,1,2,588,588,587,587
Siskiyou,39,2022-09-12,27,27,27,0,289,290,289,1,1,0,0,0,89,89,89,89
Solano,39,2022-09-12,416,416,416,0,6723,6742,6741,1,32,0,0,4,456,456,456,456
Sonoma,39,2022-09-12,395,395,395,0,7019,7038,7037,1,39,3,3,1,524,524,521,521
Stanislaus,39,2022-09-12,449,449,449,0,7740,7760,7759,1,73,1,1,4,1778,1778,1777,1777
Sutter,39,2022-09-12,119,119,119,0,1531,1537,1536,1,0,0,0,0,232,232,232,232
Tehama,39,2022-09-12,48,48,48,0,699,700,699,1,2,0,0,0,213,213,213,213
Trinity,39,2022-09-12,2,2,2,0,74,75,74,1,0,0,0,0,21,21,21,21
Tulare,39,2022-09-12,367,367,367,0,6886,6905,6904,1,39,4,4,0,1536,1536,1532,1532
Tuolumne,39,2022-09-12,60,60,60,0,809,810,809,1,2,0,0,1,199,199,199,199
Ventura,39,2022-09-12,842,842,842,0,14803,14843,14842,1,49,1,1,7,1586,1586,1585,1585
Yolo,39,2022-09-12,143,143,143,0,3447,3457,3456,1,1,2,2,3,394,394,392,392
Yuba,39,2022-09-12,92,92,92,0,1162,1166,1165,1,6,0,0,0,122,122,122,122
Alameda,40,2022-09-19,1228,1233,1233,0,29125,29212,29210,2,80,4,4,7,2039,2039,2035,2035
Amador,40,2022-09-19,33,33,33,0,759,761,760,1,1,3,3,1,94,94,91,91
Butte,40,2022-09-19,121,121,121,0,2118,2125,2124,1,18,0,0,1,462,462,462,462
Calaveras,40,2022-09-19,28,28,28,0,476,477,476,1,0,0,0,0,133,133,133,133
Colusa,40,2022-09-19,13,13,13,0,289,290,289,1,3,0,0,0,22,22,22,22
Contra Costa,40,2022-09-19,828,828,828,0,16769,16819,16817,2,52,8,8,8,1452,1452,1444,1444
Del Norte,40,2022-09-19,22,22,22,0,478,479,478,1,2,0,0,0,55,55,55,55
El Dorado,40,2022-09-19,79,79,79,0,1616,1622,1621,1,3,0,0,0,232,232,232,232
Fresno,40,2022-09-19,601,601,601,0,13300,13340,13339,1,110,7,7,14,2875,2875,2868,2868
Glenn,40,2022-09-19,14,14,14,0,201,202,201,1,2,0,0,0,53,53,53,53
Humboldt,40,2022-09-19,104,104,104,0,1456,1462,1461,1,8,0,0,3,159,159,159,159
Imperial,40,2022-09-19,150,150,150,0,2865,2875,2874,1,11,0,0,2,961,961,961,961
Inyo,40,2022-09-19,8,8,8,0,169,170,169,1,0,0,0,0,60,60,60,60
Kern,40,2022-09-19,440,440,440,0,11537,11571,11570,1,34,2,2,6,2423,2423,2421,2421
Kings,40,2022-09-19,136,136,136,0,2642,2651,2650,1,7,2,2,0,458,458,456,456
Lake,40,2022-09-19,37,37,37,0,903,905,904,1,0,0,0,0,148,148,148,148
Lassen,40,2022-09-19,7,7,7,0,704,707,706,1,0,0,0,0,63,63,63,63
Los Angeles,40,2022-09-19,8523,8548,8548,0,254635,255379,255372,7,564,65,65,69,33523,33523,33458,33458
Madera,40,2022-09-19,109,109,109,0,2691,2700,2699,1,9,1,1,2,374,374,373,373
Marin,40,2022-09-19,137,137,137,0,3697,3709,3708,1,6,0,0,0,315,315,315,315
Mariposa,40,2022-09-19,12,12,12,0,170,171,170,1,0,1,1,0,30,30,29,29
Mendocino,40,2022-09-19,43,43,43,0,928,930,929,1,0,0,0,1,136,136,136,136
Merced,40,2022-09-19,170,170,170,0,2892,2901,2900,1,8,3,3,1,866,866,863,863
Modoc,40,2022-09-19,2,2,2,0,17,18,17,1,0,0,0,0,9,9,9,9
Mono,40,2022-09-19,4,4,4,0,63,64,63,1,0,0,0,0,7,7,7,7
Monterey,40,2022-09-19,162,162,162,0,4249,4262,4261,1,14,1,1,2,770,770,769,769
Napa,40,2022-09-19,99,99,99,0,1771,1777,1776,1,4,0,0,0,159,159,159,159
Nevada,40,2022-09-19,66,66,66,0,1110,1114,1113,1,2,0,0,0,132,132,132,132
Orange,40,2022-09-19,1712,1718,1718,0,33954,34052,34050,2,129,16,16,19,7499,7499,7483,7483
Placer,40,2022-09-19,222,222,222,0,3829,3842,3841,1,51,1,1,4,659,659,658,658
Plumas,40,2022-09-19,22,22,22,0,183,184,183,1,1,0,0,0,13,13,13,13
Riverside,40,2022-09-19,1413,1418,1418,0,29082,29167,29165,2,68,4,4,19,6630,6630,6626,6626
Sacramento,40,2022-09-19,1016,1018,1018,0,21289,21352,21350,2,102,7,7,17,3322,3322,3315,3315
San Benito,40,2022-09-19,54,54,54,0,607,608,607,1,0,0,0,0,100,100,100,100
San Bernardino,40,2022-09-19,1462,1467,1467,0,32525,32619,32617,2,83,7,7,19,8086,8086,8079,8079
San Diego,40,2022-09-19,2563,2570,2570,0,55905,56069,56067,2,175,9,9,19,5546,5546,5537,5537
San Francisco,40,2022-09-19,688,688,688,0,16822,16872,16869,3,43,9,9,11,1063,1063,1054,1054
San Joaquin,40,2022-09-19,457,457,457,0,12853,12889,12888,1,35,5,5,2,2334,2334,2329,2329
San Luis Obispo,40,2022-09-19,154,154,154,0,2763,2771,2770,1,8,0,0,0,524,524,524,524
San Mateo,40,2022-09-19,585,585,585,0,13587,13626,13625,1,20,0,0,2,737,737,737,737
Santa Barbara,40,2022-09-19,268,268,268,0,6790,6809,6808,1,34,2,2,0,729,729,727,727
Santa Clara,40,2022-09-19,1414,1419,1419,0,36972,37081,37080,1,137,7,7,21,2519,2519,2512,2512
Santa Cruz,40,2022-09-19,148,148,148,0,12309,12344,12343,1,5,0,0,1,273,273,273,273
Shasta,40,2022-09-19,100,100,100,0,2112,2119,2118,1,21,0,0,3,588,588,588,588
Siskiyou,40,2022-09-19,21,21,21,0,233,234,233,1,2,1,1,0,90,90,89,89
Solano,40,2022-09-19,272,272,272,0,6110,6128,6127,1,24,1,1,5,457,457,456,456
Sonoma,40,2022-09-19,316,316,316,0,6358,6377,6376,1,27,3,3,1,527,527,524,524
Stanislaus,40,2022-09-19,336,336,336,0,6289,6307,6306,1,57,4,4,4,1782,1782,1778,1778
Sutter,40,2022-09-19,75,75,75,0,1388,1394,1393,1,0,0,0,0,232,232,232,232
Tehama,40,2022-09-19,35,35,35,0,599,600,599,1,2,1,1,0,214,214,213,213
Trinity,40,2022-09-19,3,3,3,0,53,54,53,1,0,0,0,0,21,21,21,21
Tulare,40,2022-09-19,234,234,234,0,5725,5743,5742,1,32,1,1,0,1537,1537,1536,1536
Tuolumne,40,2022-09-19,59,59,59,0,717,718,717,1,0,0,0,0,199,199,199,199
Ventura,40,2022-09-19,615,615,615,0,13372,13412,13411,1,42,2,2,6,1588,1588,1586,1586
Yolo,40,2022-09-19,83,83,83,0,3729,3741,3740,1,2,3,3,2,397,397,394,394
Yuba,40,2022-09-19,60,60,60,0,1029,1034,1033,1,3,0,0,0,122,122,122,122
Alameda,41,2022-09-26,1129,1133,1133,0,27667,27753,27752,1,77,2,2,4,2041,2041,2039,2039
Amador,41,2022-09-26,27,27,27,0,721,723,722,1,1,0,0,1,94,94,94,94
Butte,41,2022-09-26,90,90,90,0,1792,1798,1797,1,23,0,0,1,462,462,462,462
Calaveras,41,2022-09-26,20,20,20,0,388,389,388,1,2,1,1,0,134,134,133,133
Colusa,41,2022-09-26,7,7,7,0,299,300,299,1,1,0,0,0,22,22,22,22
Contra Costa,41,2022-09-26,780,780,780,0,16340,16392,16391,1,48,5,5,7,1457,1457,1452,1452
Del Norte,41,2022-09-26,22,22,22,0,469,470,469,1,2,0,0,0,55,55,55,55
El Dorado,41,2022-09-26,86,86,86,0,1580,1586,1585,1,5,0,0,0,232,232,232,232
Fresno,41,2022-09-26,516,516,516,0,12119,12157,12156,1,84,3,3,13,2878,2878,2875,2875
Glenn,41,2022-09-26,7,7,7,0,176,177,176,1,2,0,0,0,53,53,53,53
Humboldt,41,2022-09-26,98,98,98,0,1311,1317,1316,1,10,2,2,0,161,161,159,159
Imperial,41,2022-09-26,115,115,115,0,2628,2637,2636,1,4,1,1,1,962,962,961,961
Inyo,41,2022-09-26,5,5,5,0,165,166,165,1,0,0,0,0,60,60,60,60
Kern,41,2022-09-26,344,344,344,0,10734,10767,10766,1,32,3,3,7,2426,2426,2423,2423
Kings,41,2022-09-26,107,107,107,0,2620,2631,2630,1,2,0,0,0,458,458,458,458
Lake,41,2022-09-26,26,26,26,0,815,817,816,1,0,0,0,0,148,148,148,148
Lassen,41,2022-09-26,13,13,13,0,533,535,534,1,0,0,0,0,63,63,63,63
Los Angeles,41,2022-09-26,7693,7717,7717,0,239291,240043,240038,5,443,62,62,53,33585,33585,33523,33523
Madera,41,2022-09-26,84,84,84,0,2231,2239,2238,1,8,0,0,2,374,374,374,374
Marin,41,2022-09-26,173,173,173,0,3657,3671,3670,1,10,0,0,0,315,315,315,315
Mariposa,41,2022-09-26,4,4,4,0,155,156,155,1,0,0,0,0,30,30,30,30
Mendocino,41,2022-09-26,41,41,41,0,850,853,852,1,1,0,0,0,136,136,136,136
Merced,41,2022-09-26,127,127,127,0,2839,2848,2847,1,10,1,1,0,867,867,866,866
Modoc,41,2022-09-26,0,0,0,0,13,14,13,1,0,0,0,0,9,9,9,9
Mono,41,2022-09-26,1,1,1,0,60,61,60,1,0,0,0,0,7,7,7,7
Monterey,41,2022-09-26,135,135,135,0,4028,4042,4041,1,14,0,0,2,770,770,770,770
Napa,41,2022-09-26,86,86,86,0,1955,1961,1960,1,5,0,0,1,159,159,159,159
Nevada,41,2022-09-26,49,49,49,0,1077,1082,1081,1,1,0,0,0,132,132,132,132
Orange,41,2022-09-26,1669,1676,1676,0,31077,31174,31172,2,117,19,19,23,7518,7518,7499,7499
Placer,41,2022-09-26,209,209,209,0,3591,3604,3603,1,42,1,1,4,660,660,659,659
Plumas,41,2022-09-26,21,21,21,0,151,152,151,1,1,0,0,0,13,13,13,13
Riverside,41,2022-09-26,1275,1280,1280,0,25772,25852,25850,2,55,8,8,15,6638,6638,6630,6630
Sacramento,41,2022-09-26,918,920,920,0,19149,19208,19207,1,106,11,11,20,3333,3333,3322,3322
San Benito,41,2022-09-26,50,50,50,0,578,579,578,1,0,1,1,2,101,101,100,100
San Bernardino,41,2022-09-26,1211,1214,1214,0,27809,27897,27896,1,75,5,5,12,8091,8091,8086,8086
San Diego,41,2022-09-26,2481,2488,2488,0,50929,51087,51086,1,201,7,7,15,5553,5553,5546,5546
San Francisco,41,2022-09-26,685,685,685,0,16149,16201,16199,2,45,2,2,9,1065,1065,1063,1063
San Joaquin,41,2022-09-26,408,408,408,0,11067,11101,11100,1,35,1,1,3,2335,2335,2334,2334
San Luis Obispo,41,2022-09-26,131,131,131,0,2519,2526,2525,1,7,1,1,0,525,525,524,524
San Mateo,41,2022-09-26,593,593,593,0,13030,13072,13071,1,25,0,0,1,737,737,737,737
Santa Barbara,41,2022-09-26,260,260,260,0,6379,6399,6398,1,22,2,2,0,731,731,729,729
Santa Clara,41,2022-09-26,1363,1370,1370,0,35797,35909,35908,1,113,10,10,17,2529,2529,2519,2519
Santa Cruz,41,2022-09-26,224,224,224,0,12496,12535,12534,1,13,0,0,0,273,273,273,273
Shasta,41,2022-09-26,74,74,74,0,1739,1745,1744,1,14,0,0,3,588,588,588,588
Siskiyou,41,2022-09-26,18,18,18,0,183,184,183,1,1,2,2,0,92,92,90,90
Solano,41,2022-09-26,310,310,310,0,5718,5737,5736,1,23,1,1,2,458,458,457,457
Sonoma,41,2022-09-26,292,292,292,0,6331,6351,6350,1,31,1,1,2,528,528,527,527
Stanislaus,41,2022-09-26,266,266,266,0,5811,5828,5827,1,46,2,2,3,1784,1784,1782,1782
Sutter,41,2022-09-26,69,69,69,0,1146,1151,1150,1,0,0,0,0,232,232,232,232
Tehama,41,2022-09-26,36,36,36,0,550,551,550,1,1,2,2,0,216,216,214,214
Trinity,41,2022-09-26,3,3,3,0,44,45,44,1,0,0,0,0,21,21,21,21
Tulare,41,2022-09-26,168,168,168,0,5090,5106,5105,1,18,3,3,2,1540,1540,1537,1537
Tuolumne,41,2022-09-26,44,44,44,0,689,691,690,1,1,0,0,0,199,199,199,199
Ventura,41,2022-09-26,550,550,550,0,11569,11606,11605,1,33,4,4,1,1592,1592,1588,1588
Yolo,41,2022-09-26,129,129,129,0,3976,3989,3988,1,2,3,3,3,400,400,397,397
Yuba,41,2022-09-26,41,41,41,0,933,937,936,1,6,0,0,1,122,122,122,122
Alameda,42,2022-10-03,1120,1125,1125,0,26140,26231,26230,1,54,3,3,5,2044,2044,2041,2041
Amador,42,2022-10-03,14,14,14,0,690,692,691,1,0,0,0,1,94,94,94,94
Butte,42,2022-10-03,67,67,67,0,1751,1757,1756,1,11,2,2,2,464,464,462,462
Calaveras,42,2022-10-03,19,19,19,0,334,335,334,1,1,0,0,0,134,134,134,134
Colusa,42,2022-10-03,7,7,7,0,188,189,188,1,0,0,0,0,22,22,22,22
Contra Costa,42,2022-10-03,746,746,746,0,15771,15826,15825,1,34,3,3,6,1460,1460,1457,1457
Del Norte,42,2022-10-03,12,12,12,0,382,383,382,1,1,0,0,1,55,55,55,55
El Dorado,42,2022-10-03,80,80,80,0,1449,1455,1454,1,3,0,0,1,232,232,232,232
Fresno,42,2022-10-03,462,462,462,0,11208,11247,11246,1,77,2,2,11,2880,2880,2878,2878
Glenn,42,2022-10-03,7,7,7,0,155,156,155,1,0,0,0,0,53,53,53,53
Humboldt,42,2022-10-03,79,79,79,0,1157,1163,1162,1,6,0,0,1,161,161,161,161
Imperial,42,2022-10-03,140,140,140,0,2564,2574,2573,1,6,0,0,0,962,962,962,962
Inyo,42,2022-10-03,5,5,5,0,159,160,159,1,0,0,0,1,60,60,60,60
Kern,42,2022-10-03,285,285,285,0,9961,9997,9996,1,24,4,4,5,2430,2430,2426,2426
Kings,42,2022-10-03,87,87,87,0,2414,2422,2421,1,2,0,0,0,458,458,458,458
Lake,42,2022-10-03,35,35,35,0,759,762,761,1,3,1,1,0,149,149,148,148
Lassen,42,2022-10-03,7,7,7,0,530,532,531,1,2,0,0,0,63,63,63,63
Los Angeles,42,2022-10-03,6998,7023,7023,0,220014,220776,220772,4,439,50,50,69,33635,33635,33585,33585
Madera,42,2022-10-03,65,65,65,0,1563,1570,1569,1,6,0,0,2,374,374,374,374
Marin,42,2022-10-03,191,191,191,0,3470,3484,3483,1,6,0,0,2,315,315,315,315
Mariposa,42,2022-10-03,5,5,5,0,131,132,131,1,0,0,0,0,30,30,30,30
Mendocino,42,2022-10-03,50,50,50,0,778,781,780,1,4,0,0,0,136,136,136,136
Merced,42,2022-10-03,109,109,109,0,2593,2604,2603,1,5,3,3,1,870,870,867,867
Modoc,42,2022-10-03,2,2,2,0,14,15,14,1,0,0,0,0,9,9,9,9
Mono,42,2022-10-03,4,4,4,0,69,70,69,1,0,0,0,0,7,7,7,7
Monterey,42,2022-10-03,111,111,111,0,3759,3773,3772,1,11,1,1,1,771,771,770,770
Napa,42,2022-10-03,88,88,88,0,1697,1703,1702,1,4,0,0,2,159,159,159,159
Nevada,42,2022-10-03,51,51,51,0,954,959,958,1,1,0,0,4,132,132,132,132
Orange,42,2022-10-03,1525,1531,1531,0,27903,28001,28000,1,131,22,22,16,7540,7540,7518,7518
Placer,42,2022-10-03,207,207,207,0,3336,3349,3348,1,41,2,2,3,662,662,660,660
Plumas,42,2022-10-03,12,12,12,0,107,108,107,1,1,0,0,0,13,13,13,13
Riverside,42,2022-10-03,1138,1143,1143,0,22049,22126,22125,1,59,7,7,12,6645,6645,6638,6638
Sacramento,42,2022-10-03,900,902,902,0,18056,18119,18118,1,88,12,12,19,3345,3345,3333,3333
San Benito,42,2022-10-03,34,34,34,0,516,517,516,1,0,0,0,0,101,101,101,101
San Bernardino,42,2022-10-03,1215,1220,1220,0,24831,24917,24916,1,77,4,4,7,8095,8095,8091,8091
San Diego,42,2022-10-03,2085,2091,2091,0,46607,46771,46770,1,162,9,9,18,5562,5562,5553,5553
San Francisco,42,2022-10-03,642,642,642,0,15332,15386,15384,2,44,3,3,9,1068,1068,1065,1065
San Joaquin,42,2022-10-03,343,343,343,0,9925,9960,9959,1,25,4,4,3,2339,2339,2335,2335
San Luis Obispo,42,2022-10-03,150,150,150,0,2382,2391,2390,1,2,1,1,1,526,526,525,525
San Mateo,42,2022-10-03,549,549,549,0,12299,12344,12343,1,22,0,0,2,737,737,737,737
Santa Barbara,42,2022-10-03,253,253,253,0,6288,6310,6309,1,15,0,0,2,731,731,731,731
Santa Clara,42,2022-10-03,1410,1417,1417,0,32124,32235,32234,1,109,6,6,20,2535,2535,2529,2529
Santa Cruz,42,2022-10-03,227,227,227,0,11220,11258,11257,1,10,0,0,1,273,273,273,273
Shasta,42,2022-10-03,55,55,55,0,1441,1447,1446,1,10,0,0,2,588,588,588,588
Siskiyou,42,2022-10-03,10,10,10,0,204,205,204,1,0,0,0,0,92,92,92,92
Solano,42,2022-10-03,249,249,249,0,5353,5373,5372,1,17,0,0,2,458,458,458,458
Sonoma,42,2022-10-03,323,323,323,0,5930,5951,5950,1,17,0,0,3,528,528,528,528
Stanislaus,42,2022-10-03,203,203,203,0,5352,5372,5371,1,49,1,1,6,1785,1785,1784,1784
Sutter,42,2022-10-03,57,57,57,0,1108,1112,1111,1,0,0,0,0,232,232,232,232
Tehama,42,2022-10-03,20,20,20,0,526,527,526,1,1,0,0,0,216,216,216,216
Trinity,42,2022-10-03,1,1,1,0,43,44,43,1,0,0,0,0,21,21,21,21
Tulare,42,2022-10-03,162,162,162,0,5046,5066,5065,1,19,3,3,1,1543,1543,1540,1540
Tuolumne,42,2022-10-03,26,26,26,0,622,623,622,1,0,0,0,0,199,199,199,199
Ventura,42,2022-10-03,476,476,476,0,10424,10462,10461,1,41,2,2,2,1594,1594,1592,1592
Yolo,42,2022-10-03,122,122,122,0,2983,2993,2992,1,3,2,2,2,402,402,400,400
Yuba,42,2022-10-03,35,35,35,0,801,804,803,1,4,0,0,1,122,122,122,122
Alameda,43,2022-10-10,1131,1137,1137,0,27783,27893,27892,1,45,2,2,7,2046,2046,2044,2044
Amador,43,2022-10-10,15,15,15,0,801,805,804,1,0,0,0,2,94,94,94,94
Butte,43,2022-10-10,65,65,65,0,1750,1759,1758,1,12,3,3,1,466,466,463,463
Calaveras,43,2022-10-10,15,15,15,0,373,374,373,1,0,1,1,0,135,135,134,134
Colusa,43,2022-10-10,1,1,1,0,120,121,120,1,1,0,0,0,22,22,22,22
Contra Costa,43,2022-10-10,778,778,778,0,16845,16912,16911,1,31,7,7,6,1465,1465,1458,1458
Del Norte,43,2022-10-10,10,10,10,0,492,493,492,1,1,0,0,1,55,55,55,55
El Dorado,43,2022-10-10,82,82,82,0,1748,1755,1754,1,7,0,0,4,232,232,232,232
Fresno,43,2022-10-10,483,483,483,0,12470,12519,12518,1,60,3,3,9,2883,2883,2880,2880
Glenn,43,2022-10-10,10,10,10,0,226,227,226,1,1,0,0,0,53,53,53,53
Humboldt,43,2022-10-10,98,98,98,0,1418,1425,1424,1,7,1,1,0,162,162,161,161
Imperial,43,2022-10-10,203,203,203,0,2959,2974,2973,1,7,0,0,0,962,962,962,962
Inyo,43,2022-10-10,4,4,4,0,123,124,123,1,0,0,0,0,60,60,60,60
Kern,43,2022-10-10,325,325,325,0,11655,11702,11701,1,24,2,2,2,2432,2432,2430,2430
Kings,43,2022-10-10,102,102,102,0,2750,2763,2762,1,1,1,1,0,459,459,458,458
Lake,43,2022-10-10,33,33,33,0,920,924,923,1,1,0,0,0,149,149,149,149
Lassen,43,2022-10-10,3,3,3,0,573,574,573,1,0,0,0,0,63,63,63,63
Los Angeles,43,2022-10-10,6721,6746,6746,0,226512,227413,227410,3,436,70,70,51,33697,33697,33627,33627
Madera,43,2022-10-10,68,68,68,0,1717,1726,1725,1,7,1,1,2,375,375,374,374
Marin,43,2022-10-10,207,207,207,0,3773,3790,3789,1,9,0,0,0,315,315,315,315
Mariposa,43,2022-10-10,8,8,8,0,128,129,128,1,0,0,0,0,30,30,30,30
Mendocino,43,2022-10-10,32,32,32,0,973,979,978,1,1,0,0,2,136,136,136,136
Merced,43,2022-10-10,111,111,111,0,2766,2779,2778,1,8,1,1,3,871,871,870,870
Modoc,43,2022-10-10,5,5,5,0,12,13,12,1,0,0,0,0,9,9,9,9
Mono,43,2022-10-10,1,1,1,0,55,56,55,1,0,0,0,0,7,7,7,7
Monterey,43,2022-10-10,108,108,108,0,4344,4363,4362,1,9,0,0,1,771,771,771,771
Napa,43,2022-10-10,78,78,78,0,1765,1773,1772,1,3,0,0,2,159,159,159,159
Nevada,43,2022-10-10,42,42,42,0,979,984,983,1,1,0,0,1,132,132,132,132
Orange,43,2022-10-10,1478,1484,1484,0,29612,29729,29728,1,129,14,14,19,7552,7552,7538,7538
Placer,43,2022-10-10,187,187,187,0,3819,3835,3834,1,24,0,0,7,662,662,662,662
Plumas,43,2022-10-10,20,20,20,0,106,107,106,1,0,0,0,0,13,13,13,13
Riverside,43,2022-10-10,1177,1183,1183,0,23895,23990,23989,1,56,5,5,4,6650,6650,6645,6645
Sacramento,43,2022-10-10,942,945,945,0,20305,20387,20386,1,81,5,5,16,3350,3350,3345,3345
San Benito,43,2022-10-10,34,34,34,0,549,550,549,1,3,0,0,0,101,101,101,101
San Bernardino,43,2022-10-10,1094,1100,1100,0,27124,27232,27231,1,66,0,0,13,8095,8095,8095,8095
San Diego,43,2022-10-10,1991,1999,1999,0,51325,51530,51529,1,130,7,7,21,5567,5567,5560,5560
San Francisco,43,2022-10-10,686,686,686,0,16055,16117,16116,1,37,2,2,9,1070,1070,1068,1068
San Joaquin,43,2022-10-10,432,432,432,0,11576,11623,11622,1,17,2,2,8,2341,2341,2339,2339
San Luis Obispo,43,2022-10-10,88,88,88,0,2566,2579,2578,1,2,2,2,0,528,528,526,526
San Mateo,43,2022-10-10,647,647,647,0,13627,13682,13681,1,19,0,0,0,737,737,737,737
Santa Barbara,43,2022-10-10,242,242,242,0,7841,7874,7873,1,20,1,1,1,732,732,731,731
Santa Clara,43,2022-10-10,1422,1429,1429,0,34009,34146,34145,1,107,3,3,18,2538,2538,2535,2535
Santa Cruz,43,2022-10-10,338,338,338,0,12266,12315,12314,1,9,0,0,1,273,273,273,273
Shasta,43,2022-10-10,99,99,99,0,1292,1299,1298,1,13,3,3,1,591,591,588,588
Siskiyou,43,2022-10-10,9,9,9,0,244,245,244,1,0,1,1,0,93,93,92,92
Solano,43,2022-10-10,331,331,331,0,6264,6291,6290,1,23,0,0,4,458,458,458,458
Sonoma,43,2022-10-10,288,288,288,0,6769,6798,6797,1,15,1,1,3,529,529,528,528
Stanislaus,43,2022-10-10,209,209,209,0,5925,5950,5949,1,51,7,7,7,1790,1790,1783,1783
Sutter,43,2022-10-10,57,57,57,0,1126,1132,1131,1,0,0,0,0,232,232,232,232
Tehama,43,2022-10-10,21,21,21,0,566,567,566,1,1,0,0,0,216,216,216,216
Trinity,43,2022-10-10,1,1,1,0,53,54,53,1,0,0,0,0,21,21,21,21
Tulare,43,2022-10-10,170,170,170,0,4979,5001,5000,1,16,1,1,1,1544,1544,1543,1543
Tuolumne,43,2022-10-10,36,36,36,0,661,662,661,1,1,1,1,0,200,200,199,199
Ventura,43,2022-10-10,430,430,430,0,10969,11014,11013,1,41,4,4,1,1597,1597,1593,1593
Yolo,43,2022-10-10,126,126,126,0,3085,3099,3098,1,4,2,2,0,404,404,402,402
Yuba,43,2022-10-10,24,24,24,0,924,929,928,1,0,0,0,0,122,122,122,122
Alameda,44,2022-10-17,915,920,920,0,24485,24592,24591,1,60,5,5,8,2051,2051,2046,2046
Amador,44,2022-10-17,15,15,15,0,591,594,593,1,1,0,0,0,94,94,94,94
Butte,44,2022-10-17,76,76,76,0,1424,1431,1430,1,13,0,0,0,466,466,466,466
Calaveras,44,2022-10-17,19,19,19,0,305,306,305,1,0,0,0,0,135,135,135,135
Colusa,44,2022-10-17,4,4,4,0,80,81,80,1,0,0,0,0,22,22,22,22
Contra Costa,44,2022-10-17,668,669,669,0,14535,14600,14599,1,30,4,4,6,1469,1469,1465,1465
Del Norte,44,2022-10-17,11,11,11,0,379,380,379,1,1,0,0,0,55,55,55,55
El Dorado,44,2022-10-17,89,89,89,0,1380,1386,1385,1,2,0,0,1,232,232,232,232
Fresno,44,2022-10-17,347,347,347,0,10197,10244,10243,1,62,2,2,11,2885,2885,2883,2883
Glenn,44,2022-10-17,6,6,6,0,141,142,141,1,1,0,0,0,53,53,53,53
Humboldt,44,2022-10-17,70,70,70,0,1146,1152,1151,1,1,0,0,0,162,162,162,162
Imperial,44,2022-10-17,117,117,117,0,2320,2331,2330,1,5,0,0,0,962,962,962,962
Inyo,44,2022-10-17,6,6,6,0,122,123,122,1,1,0,0,0,60,60,60,60
Kern,44,2022-10-17,230,230,230,0,9626,9670,9669,1,32,0,0,1,2432,2432,2432,2432
Kings,44,2022-10-17,71,71,71,0,2320,2331,2330,1,2,0,0,0,459,459,459,459
Lake,44,2022-10-17,25,25,25,0,774,779,778,1,1,0,0,0,149,149,149,149
Lassen,44,2022-10-17,7,7,7,0,513,515,514,1,1,0,0,0,63,63,63,63
Los Angeles,44,2022-10-17,5074,5095,5095,0,188188,189010,189008,2,350,41,41,53,33738,33738,33697,33697
Madera,44,2022-10-17,59,59,59,0,1465,1473,1472,1,3,0,0,2,375,375,375,375
Marin,44,2022-10-17,132,132,132,0,3090,3104,3103,1,8,0,0,1,315,315,315,315
Mariposa,44,2022-10-17,6,6,6,0,119,120,119,1,0,0,0,0,30,30,30,30
Mendocino,44,2022-10-17,48,48,48,0,742,746,745,1,2,0,0,0,136,136,136,136
Merced,44,2022-10-17,129,129,129,0,2333,2345,2344,1,15,0,0,2,871,871,871,871
Modoc,44,2022-10-17,1,1,1,0,7,8,7,1,0,0,0,0,9,9,9,9
Mono,44,2022-10-17,6,6,6,0,41,42,41,1,1,0,0,0,7,7,7,7
Monterey,44,2022-10-17,125,125,125,0,3537,3554,3553,1,12,1,1,1,772,772,771,771
Napa,44,2022-10-17,60,60,60,0,1415,1423,1422,1,2,0,0,1,159,159,159,159
Nevada,44,2022-10-17,49,49,49,0,777,780,779,1,0,0,0,5,132,132,132,132
Orange,44,2022-10-17,1084,1089,1089,0,24716,24823,24822,1,91,21,21,18,7573,7573,7552,7552
Placer,44,2022-10-17,147,147,147,0,2919,2934,2933,1,32,0,0,3,662,662,662,662
Plumas,44,2022-10-17,11,11,11,0,98,99,98,1,0,0,0,0,13,13,13,13
Riverside,44,2022-10-17,885,890,890,0,20668,20759,20758,1,66,2,2,2,6652,6652,6650,6650
Sacramento,44,2022-10-17,853,857,857,0,16067,16139,16138,1,84,9,9,14,3359,3359,3350,3350
San Benito,44,2022-10-17,28,28,28,0,433,434,433,1,0,1,1,0,102,102,101,101
San Bernardino,44,2022-10-17,818,822,822,0,23216,23317,23316,1,63,1,1,9,8096,8096,8095,8095
San Diego,44,2022-10-17,1647,1655,1655,0,43406,43595,43594,1,117,8,8,24,5575,5575,5567,5567
San Francisco,44,2022-10-17,563,564,564,0,14422,14485,14484,1,34,3,3,13,1073,1073,1070,1070
San Joaquin,44,2022-10-17,353,353,353,0,9074,9114,9113,1,8,2,2,8,2343,2343,2341,2341
San Luis Obispo,44,2022-10-17,109,109,109,0,2130,2141,2140,1,4,1,1,0,529,529,528,528
San Mateo,44,2022-10-17,540,540,540,0,11235,11285,11284,1,21,0,0,1,737,737,737,737
Santa Barbara,44,2022-10-17,182,182,182,0,5624,5650,5649,1,18,0,0,2,732,732,732,732
Santa Clara,44,2022-10-17,1142,1148,1148,0,28409,28533,28532,1,93,4,4,16,2542,2542,2538,2538
Santa Cruz,44,2022-10-17,283,283,283,0,10280,10326,10325,1,7,1,1,0,274,274,273,273
Shasta,44,2022-10-17,82,82,82,0,1105,1112,1111,1,12,0,0,2,591,591,591,591
Siskiyou,44,2022-10-17,12,12,12,0,181,182,181,1,2,1,1,0,94,94,93,93
Solano,44,2022-10-17,263,263,263,0,4836,4859,4858,1,25,1,1,3,459,459,458,458
Sonoma,44,2022-10-17,244,244,244,0,5369,5394,5393,1,20,1,1,1,530,530,529,529
Stanislaus,44,2022-10-17,223,223,223,0,5293,5317,5316,1,45,1,1,5,1791,1791,1790,1790
Sutter,44,2022-10-17,40,40,40,0,909,912,911,1,0,0,0,0,232,232,232,232
Tehama,44,2022-10-17,21,21,21,0,396,397,396,1,0,0,0,0,216,216,216,216
Trinity,44,2022-10-17,0,0,0,0,34,35,34,1,0,0,0,0,21,21,21,21
Tulare,44,2022-10-17,137,137,137,0,4268,4287,4286,1,11,1,1,1,1545,1545,1544,1544
Tuolumne,44,2022-10-17,35,35,35,0,620,622,621,1,2,0,0,0,200,200,200,200
Ventura,44,2022-10-17,375,375,375,0,9332,9374,9373,1,32,3,3,1,1600,1600,1597,1597
Yolo,44,2022-10-17,103,103,103,0,2203,2214,2213,1,3,2,2,3,406,406,404,404
Yuba,44,2022-10-17,44,44,44,0,767,772,771,1,1,0,0,0,122,122,122,122
Alameda,45,2022-10-24,922,927,927,0,23193,23307,23306,1,46,6,6,10,2057,2057,2051,2051
Amador,45,2022-10-24,18,18,18,0,635,638,637,1,2,0,0,0,94,94,94,94
Butte,45,2022-10-24,68,68,68,0,1406,1415,1414,1,10,1,1,1,467,467,466,466
Calaveras,45,2022-10-24,20,20,20,0,322,323,322,1,0,0,0,0,135,135,135,135
Colusa,45,2022-10-24,3,3,3,0,95,96,95,1,0,0,0,0,22,22,22,22
Contra Costa,45,2022-10-24,623,625,625,0,13907,13975,13974,1,37,5,5,5,1474,1474,1469,1469
Del Norte,45,2022-10-24,6,6,6,0,361,362,361,1,0,0,0,1,55,55,55,55
El Dorado,45,2022-10-24,91,91,91,0,1519,1526,1525,1,1,0,0,0,232,232,232,232
Fresno,45,2022-10-24,377,377,377,0,9742,9790,9789,1,63,0,0,6,2885,2885,2885,2885
Glenn,45,2022-10-24,9,9,9,0,148,149,148,1,0,0,0,0,53,53,53,53
Humboldt,45,2022-10-24,69,69,69,0,1148,1154,1153,1,7,0,0,2,162,162,162,162
Imperial,45,2022-10-24,96,96,96,0,2344,2358,2357,1,8,1,1,0,963,963,962,962
Inyo,45,2022-10-24,8,8,8,0,272,275,274,1,0,0,0,0,60,60,60,60
Kern,45,2022-10-24,269,269,269,0,9630,9678,9677,1,24,2,2,2,2434,2434,2432,2432
Kings,45,2022-10-24,89,89,89,0,2338,2351,2350,1,8,0,0,0,459,459,459,459
Lake,45,2022-10-24,22,22,22,0,643,647,646,1,1,1,1,1,150,150,149,149
Lassen,45,2022-10-24,16,16,16,0,484,486,485,1,1,0,0,0,63,63,63,63
Los Angeles,45,2022-10-24,5312,5339,5339,0,185803,186709,186707,2,332,54,54,43,33792,33792,33738,33738
Madera,45,2022-10-24,61,61,61,0,1388,1396,1395,1,4,0,0,2,375,375,375,375
Marin,45,2022-10-24,138,138,138,0,3078,3094,3093,1,12,1,1,2,316,316,315,315
Mariposa,45,2022-10-24,12,12,12,0,120,121,120,1,0,0,0,0,30,30,30,30
Mendocino,45,2022-10-24,42,42,42,0,770,776,775,1,2,0,0,0,136,136,136,136
Merced,45,2022-10-24,88,88,88,0,2404,2417,2416,1,7,3,3,3,874,874,871,871
Modoc,45,2022-10-24,1,1,1,0,13,14,13,1,0,0,0,0,9,9,9,9
Mono,45,2022-10-24,3,3,3,0,63,64,63,1,0,1,1,0,8,8,7,7
Monterey,45,2022-10-24,130,130,130,0,3707,3726,3725,1,18,0,0,0,772,772,772,772
Napa,45,2022-10-24,51,51,51,0,1467,1475,1474,1,3,0,0,0,159,159,159,159
Nevada,45,2022-10-24,38,38,38,0,784,789,788,1,6,0,0,0,132,132,132,132
Orange,45,2022-10-24,1127,1133,1133,0,25605,25730,25729,1,84,10,10,14,7583,7583,7573,7573
Placer,45,2022-10-24,191,191,191,0,3026,3041,3040,1,39,0,0,6,662,662,662,662
Plumas,45,2022-10-24,12,12,12,0,91,92,91,1,0,0,0,0,13,13,13,13
Riverside,45,2022-10-24,919,924,924,0,20045,20144,20143,1,53,0,0,6,6652,6652,6652,6652
Sacramento,45,2022-10-24,801,806,806,0,15198,15272,15271,1,84,5,5,19,3364,3364,3359,3359
San Benito,45,2022-10-24,41,41,41,0,549,551,550,1,0,0,0,1,102,102,102,102
San Bernardino,45,2022-10-24,778,783,783,0,21408,21513,21512,1,39,3,3,10,8099,8099,8096,8096
San Diego,45,2022-10-24,1683,1691,1691,0,41857,42061,42060,1,83,5,5,18,5580,5580,5575,5575
San Francisco,45,2022-10-24,500,501,501,0,13870,13938,13937,1,35,1,1,5,1074,1074,1073,1073
San Joaquin,45,2022-10-24,272,272,272,0,8493,8537,8536,1,13,2,2,3,2345,2345,2343,2343
San Luis Obispo,45,2022-10-24,89,89,89,0,2053,2064,2063,1,2,0,0,0,529,529,529,529
San Mateo,45,2022-10-24,464,464,464,0,11066,11120,11119,1,19,0,0,2,737,737,737,737
Santa Barbara,45,2022-10-24,164,164,164,0,5728,5757,5756,1,19,2,2,4,734,734,732,732
Santa Clara,45,2022-10-24,1184,1191,1191,0,29129,29272,29271,1,92,2,2,9,2544,2544,2542,2542
Santa Cruz,45,2022-10-24,238,238,238,0,10199,10249,10248,1,14,1,1,0,275,275,274,274
Shasta,45,2022-10-24,73,73,73,0,983,989,988,1,5,0,0,2,591,591,591,591
Siskiyou,45,2022-10-24,12,12,12,0,171,172,171,1,0,0,0,0,94,94,94,94
Solano,45,2022-10-24,237,237,237,0,5016,5040,5039,1,20,0,0,1,459,459,459,459
Sonoma,45,2022-10-24,246,246,246,0,5436,5463,5462,1,23,0,0,1,530,530,530,530
Stanislaus,45,2022-10-24,199,199,199,0,4851,4875,4874,1,40,3,3,3,1794,1794,1791,1791
Sutter,45,2022-10-24,27,27,27,0,881,886,885,1,0,0,0,0,232,232,232,232
Tehama,45,2022-10-24,36,36,36,0,405,406,405,1,1,0,0,0,216,216,216,216
Trinity,45,2022-10-24,1,1,1,0,35,36,35,1,0,0,0,0,21,21,21,21
Tulare,45,2022-10-24,110,110,110,0,4341,4364,4363,1,16,1,1,1,1546,1546,1545,1545
Tuolumne,45,2022-10-24,33,33,33,0,625,629,628,1,1,1,1,0,201,201,200,200
Ventura,45,2022-10-24,293,293,293,0,9021,9066,9065,1,40,3,3,6,1603,1603,1600,1600
Yolo,45,2022-10-24,90,90,90,0,2041,2051,2050,1,5,1,1,0,407,407,406,406
Yuba,45,2022-10-24,52,52,52,0,799,803,802,1,5,0,0,1,122,122,122,122
Alameda,46,2022-10-31,1024,1030,1030,0,22808,22928,22927,1,57,5,5,4,2062,2062,2057,2057
Amador,46,2022-10-31,18,18,18,0,577,580,579,1,2,1,1,0,95,95,94,94
Butte,46,2022-10-31,82,82,82,0,1457,1466,1465,1,11,0,0,3,467,467,467,467
Calaveras,46,2022-10-31,13,13,13,0,256,257,256,1,0,0,0,0,135,135,135,135
Colusa,46,2022-10-31,11,11,11,0,95,96,95,1,0,0,0,0,22,22,22,22
Contra Costa,46,2022-10-31,749,753,753,0,13875,13949,13948,1,37,6,6,7,1480,1480,1474,1474
Del Norte,46,2022-10-31,16,16,16,0,357,358,357,1,1,0,0,0,55,55,55,55
El Dorado,46,2022-10-31,101,101,101,0,1404,1412,1411,1,2,0,0,0,232,232,232,232
Fresno,46,2022-10-31,423,423,423,0,10493,10549,10548,1,57,4,4,8,2889,2889,2885,2885
Glenn,46,2022-10-31,16,16,16,0,156,157,156,1,1,0,0,0,53,53,53,53
Humboldt,46,2022-10-31,44,44,44,0,1019,1025,1024,1,6,0,0,2,162,162,162,162
Imperial,46,2022-10-31,126,126,126,0,2786,2801,2800,1,7,0,0,0,963,963,963,963
Inyo,46,2022-10-31,7,7,7,0,242,244,243,1,0,0,0,0,60,60,60,60
Kern,46,2022-10-31,330,330,330,0,9783,9836,9835,1,20,2,2,2,2436,2436,2434,2434
Kings,46,2022-10-31,117,117,117,0,2460,2474,2473,1,3,0,0,1,459,459,459,459
Lake,46,2022-10-31,30,30,30,0,752,758,757,1,1,0,0,1,150,150,150,150
Lassen,46,2022-10-31,19,19,19,0,522,525,524,1,1,0,0,0,63,63,63,63
Los Angeles,46,2022-10-31,6197,6230,6230,0,190943,191949,191947,2,344,37,37,44,33829,33829,33792,33792
Madera,46,2022-10-31,54,54,54,0,1433,1442,1441,1,3,0,0,2,375,375,375,375
Marin,46,2022-10-31,137,137,137,0,3505,3525,3524,1,10,1,1,1,317,317,316,316
Mariposa,46,2022-10-31,8,8,8,0,126,127,126,1,0,0,0,0,30,30,30,30
Mendocino,46,2022-10-31,23,23,23,0,709,714,713,1,1,0,0,2,136,136,136,136
Merced,46,2022-10-31,113,113,113,0,2134,2147,2146,1,5,1,1,0,875,875,874,874
Modoc,46,2022-10-31,1,1,1,0,13,14,13,1,0,0,0,0,9,9,9,9
Mono,46,2022-10-31,1,1,1,0,85,86,85,1,1,0,0,0,8,8,8,8
Monterey,46,2022-10-31,150,150,150,0,3683,3704,3703,1,18,2,2,0,774,774,772,772
Napa,46,2022-10-31,53,53,53,0,1505,1513,1512,1,2,0,0,0,159,159,159,159
Nevada,46,2022-10-31,37,37,37,0,774,779,778,1,6,0,0,0,132,132,132,132
Orange,46,2022-10-31,1150,1157,1157,0,26723,26863,26862,1,91,14,14,14,7597,7597,7583,7583
Placer,46,2022-10-31,148,148,148,0,2746,2762,2761,1,40,0,0,5,662,662,662,662
Plumas,46,2022-10-31,5,5,5,0,87,88,87,1,0,0,0,0,13,13,13,13
Riverside,46,2022-10-31,1029,1036,1036,0,19434,19536,19535,1,64,5,5,5,6657,6657,6652,6652
Sacramento,46,2022-10-31,730,735,735,0,14042,14115,14114,1,80,8,8,16,3372,3372,3364,3364
San Benito,46,2022-10-31,33,33,33,0,501,502,501,1,1,0,0,1,102,102,102,102
San Bernardino,46,2022-10-31,1030,1037,1037,0,22276,22393,22392,1,64,2,2,11,8101,8101,8099,8099
San Diego,46,2022-10-31,1772,1780,1780,0,42542,42766,42765,1,109,5,5,13,5585,5585,5580,5580
San Francisco,46,2022-10-31,611,613,613,0,14581,14658,14657,1,45,3,3,3,1077,1077,1074,1074
San Joaquin,46,2022-10-31,330,330,330,0,8591,8637,8636,1,21,6,6,3,2351,2351,2345,2345
San Luis Obispo,46,2022-10-31,81,81,81,0,2009,2021,2020,1,1,1,1,0,530,530,529,529
San Mateo,46,2022-10-31,509,509,509,0,11503,11565,11564,1,30,0,0,2,737,737,737,737
Santa Barbara,46,2022-10-31,181,181,181,0,6033,6065,6064,1,20,1,1,6,735,735,734,734
Santa Clara,46,2022-10-31,1257,1264,1264,0,30676,30839,30838,1,85,3,3,16,2547,2547,2544,2544
Santa Cruz,46,2022-10-31,188,188,188,0,9951,10004,10003,1,7,0,0,0,275,275,275,275
Shasta,46,2022-10-31,64,64,64,0,829,835,834,1,6,2,2,1,593,593,591,591
Siskiyou,46,2022-10-31,17,17,17,0,216,217,216,1,1,1,1,0,95,95,94,94
Solano,46,2022-10-31,309,309,309,0,5245,5276,5275,1,16,0,0,4,459,459,459,459
Sonoma,46,2022-10-31,204,204,204,0,5595,5626,5625,1,24,0,0,3,530,530,530,530
Stanislaus,46,2022-10-31,235,235,235,0,4828,4856,4855,1,49,1,1,8,1795,1795,1794,1794
Sutter,46,2022-10-31,55,55,55,0,901,908,907,1,0,0,0,0,232,232,232,232
Tehama,46,2022-10-31,26,26,26,0,395,396,395,1,1,0,0,0,216,216,216,216
Trinity,46,2022-10-31,19,19,19,0,73,74,73,1,5,0,0,0,21,21,21,21
Tulare,46,2022-10-31,154,154,154,0,3675,3695,3694,1,12,0,0,0,1546,1546,1546,1546
Tuolumne,46,2022-10-31,27,27,27,0,518,520,519,1,3,0,0,0,201,201,201,201
Ventura,46,2022-10-31,375,375,375,0,9516,9567,9566,1,24,2,2,2,1605,1605,1603,1603
Yolo,46,2022-10-31,82,82,82,0,1823,1834,1833,1,3,0,0,1,407,407,407,407
Yuba,46,2022-10-31,46,46,46,0,775,781,780,1,3,0,0,0,122,122,122,122
Alameda,47,2022-11-07,1301,1309,1309,0,24295,24442,24441,1,58,7,7,11,2069,2069,2062,2062
Amador,47,2022-11-07,32,32,32,0,685,688,687,1,3,0,0,0,95,95,95,95
Butte,47,2022-11-07,118,118,118,0,1369,1378,1377,1,11,0,0,2,467,467,467,467
Calaveras,47,2022-11-07,16,16,16,0,333,335,334,1,0,0,0,0,135,135,135,135
Colusa,47,2022-11-07,2,2,2,0,102,103,102,1,0,0,0,0,22,22,22,22
Contra Costa,47,2022-11-07,867,874,874,0,15557,15652,15651,1,43,3,3,4,1483,1483,1480,1480
Del Norte,47,2022-11-07,4,4,4,0,375,378,377,1,0,0,0,0,55,55,55,55
El Dorado,47,2022-11-07,109,109,109,0,1598,1608,1607,1,7,2,2,0,234,234,232,232
Fresno,47,2022-11-07,593,596,596,0,10701,10767,10766,1,61,3,3,9,2892,2892,2889,2889
Glenn,47,2022-11-07,29,29,29,0,131,132,131,1,0,0,0,0,53,53,53,53
Humboldt,47,2022-11-07,79,79,79,0,984,991,990,1,9,0,0,2,162,162,162,162
Imperial,47,2022-11-07,209,209,209,0,3708,3731,3730,1,7,0,0,0,963,963,963,963
Inyo,47,2022-11-07,19,19,19,0,264,265,264,1,0,0,0,0,60,60,60,60
Kern,47,2022-11-07,454,456,456,0,10639,10705,10704,1,29,1,1,5,2437,2437,2436,2436
Kings,47,2022-11-07,149,149,149,0,2457,2473,2472,1,7,1,1,0,460,460,459,459
Lake,47,2022-11-07,50,50,50,0,795,801,800,1,3,0,0,1,150,150,150,150
Lassen,47,2022-11-07,10,10,10,0,451,454,453,1,0,0,0,0,63,63,63,63
Los Angeles,47,2022-11-07,8066,8115,8115,0,190389,191543,191541,2,387,54,54,53,33883,33883,33829,33829
Madera,47,2022-11-07,78,78,78,0,1612,1622,1621,1,3,0,0,4,375,375,375,375
Marin,47,2022-11-07,149,149,149,0,3364,3387,3386,1,9,0,0,0,317,317,317,317
Mariposa,47,2022-11-07,14,14,14,0,121,122,121,1,0,0,0,0,30,30,30,30
Mendocino,47,2022-11-07,37,37,37,0,819,825,824,1,4,1,1,0,137,137,136,136
Merced,47,2022-11-07,142,142,142,0,2582,2599,2598,1,9,4,4,0,879,879,875,875
Modoc,47,2022-11-07,2,2,2,0,6,7,6,1,0,0,0,0,9,9,9,9
Mono,47,2022-11-07,3,3,3,0,96,97,96,1,0,0,0,0,8,8,8,8
Monterey,47,2022-11-07,219,219,219,0,3917,3942,3941,1,18,1,1,0,775,775,774,774
Napa,47,2022-11-07,77,77,77,0,1756,1768,1767,1,6,0,0,0,159,159,159,159
Nevada,47,2022-11-07,60,60,60,0,743,748,747,1,3,0,0,1,132,132,132,132
Orange,47,2022-11-07,1245,1253,1253,0,28497,28668,28667,1,94,11,11,20,7608,7608,7597,7597
Placer,47,2022-11-07,229,229,229,0,3331,3352,3351,1,53,2,2,7,664,664,662,662
Plumas,47,2022-11-07,5,5,5,0,69,70,69,1,0,0,0,0,13,13,13,13
Riverside,47,2022-11-07,1492,1500,1500,0,21544,21673,21672,1,71,2,2,5,6659,6659,6657,6657
Sacramento,47,2022-11-07,1083,1090,1090,0,15898,15996,15995,1,90,7,7,9,3379,3379,3372,3372
San Benito,47,2022-11-07,43,43,43,0,517,520,519,1,1,0,0,0,102,102,102,102
San Bernardino,47,2022-11-07,1428,1436,1436,0,23824,23970,23969,1,76,2,2,17,8103,8103,8101,8101
San Diego,47,2022-11-07,2156,2169,2169,0,45385,45661,45660,1,117,7,7,24,5592,5592,5585,5585
San Francisco,47,2022-11-07,715,721,721,0,14867,14959,14958,1,42,2,2,8,1079,1079,1077,1077
San Joaquin,47,2022-11-07,485,486,486,0,8807,8862,8861,1,24,2,2,3,2353,2353,2351,2351
San Luis Obispo,47,2022-11-07,130,130,130,0,2268,2283,2282,1,4,0,0,2,530,530,530,530
San Mateo,47,2022-11-07,563,566,566,0,12245,12320,12319,1,27,0,0,3,737,737,737,737
Santa Barbara,47,2022-11-07,225,225,225,0,6670,6711,6710,1,18,1,1,2,736,736,735,735
Santa Clara,47,2022-11-07,1631,1639,1639,0,31228,31419,31418,1,76,7,7,19,2554,2554,2547,2547
Santa Cruz,47,2022-11-07,282,282,282,0,11327,11398,11397,1,8,0,0,0,275,275,275,275
Shasta,47,2022-11-07,95,95,95,0,1052,1059,1058,1,11,1,1,3,594,594,593,593
Siskiyou,47,2022-11-07,15,15,15,0,295,296,295,1,1,0,0,0,95,95,95,95
Solano,47,2022-11-07,383,384,384,0,5506,5541,5540,1,22,2,2,3,461,461,459,459
Sonoma,47,2022-11-07,250,250,250,0,5927,5966,5965,1,11,2,2,2,532,532,530,530
Stanislaus,47,2022-11-07,301,301,301,0,4928,4960,4959,1,42,2,2,9,1797,1797,1795,1795
Sutter,47,2022-11-07,87,87,87,0,957,965,964,1,0,0,0,0,232,232,232,232
Tehama,47,2022-11-07,47,47,47,0,471,474,473,1,2,0,0,0,216,216,216,216
Trinity,47,2022-11-07,2,2,2,0,34,35,34,1,0,0,0,0,21,21,21,21
Tulare,47,2022-11-07,161,161,161,0,4365,4392,4391,1,14,0,0,0,1546,1546,1546,1546
Tuolumne,47,2022-11-07,82,82,82,0,681,686,685,1,2,0,0,0,201,201,201,201
Ventura,47,2022-11-07,446,447,447,0,10345,10410,10409,1,36,2,2,1,1607,1607,1605,1605
Yolo,47,2022-11-07,173,173,173,0,2234,2249,2248,1,3,2,2,0,409,409,407,407
Yuba,47,2022-11-07,46,46,46,0,902,908,907,1,3,0,0,2,122,122,122,122
Alameda,48,2022-11-14,1461,1471,1471,0,24013,24185,24184,1,77,3,3,9,2072,2072,2069,2069
Amador,48,2022-11-14,20,20,20,0,656,661,660,1,2,0,0,0,95,95,95,95
Butte,48,2022-11-14,119,119,119,0,1378,1389,1388,1,20,0,0,1,467,467,467,467
Calaveras,48,2022-11-14,30,30,30,0,341,343,342,1,0,0,0,0,135,135,135,135
Colusa,48,2022-11-14,11,11,11,0,100,101,100,1,1,0,0,0,22,22,22,22
Contra Costa,48,2022-11-14,941,948,948,0,15611,15724,15723,1,56,1,1,5,1484,1484,1483,1483
Del Norte,48,2022-11-14,17,17,17,0,395,399,398,1,1,0,0,0,55,55,55,55
El Dorado,48,2022-11-14,143,143,143,0,1589,1602,1601,1,7,0,0,1,234,234,234,234
Fresno,48,2022-11-14,765,771,771,0,11263,11343,11342,1,72,8,8,13,2900,2900,2892,2892
Glenn,48,2022-11-14,20,20,20,0,160,162,161,1,0,0,0,0,53,53,53,53
Humboldt,48,2022-11-14,81,81,81,0,1030,1038,1037,1,6,0,0,0,162,162,162,162
Imperial,48,2022-11-14,251,251,251,0,3220,3243,3242,1,4,0,0,1,963,963,963,963
Inyo,48,2022-11-14,11,11,11,0,542,546,545,1,0,0,0,0,60,60,60,60
Kern,48,2022-11-14,444,446,446,0,10599,10676,10675,1,26,1,1,6,2438,2438,2437,2437
Kings,48,2022-11-14,201,201,201,0,2624,2644,2643,1,6,1,1,0,461,461,460,460
Lake,48,2022-11-14,54,54,54,0,802,810,809,1,2,0,0,1,150,150,150,150
Lassen,48,2022-11-14,35,35,35,0,544,548,547,1,0,1,1,0,64,64,63,63
Los Angeles,48,2022-11-14,9369,9436,9436,0,195233,196628,196626,2,477,46,46,75,33929,33929,33883,33883
Madera,48,2022-11-14,95,95,95,0,1712,1724,1723,1,4,0,0,3,375,375,375,375
Marin,48,2022-11-14,175,175,175,0,3568,3595,3594,1,8,0,0,2,317,317,317,317
Mariposa,48,2022-11-14,18,18,18,0,137,138,137,1,0,0,0,0,30,30,30,30
Mendocino,48,2022-11-14,39,39,39,0,908,917,916,1,3,0,0,1,137,137,137,137
Merced,48,2022-11-14,185,185,185,0,2625,2645,2644,1,6,0,0,0,879,879,879,879
Modoc,48,2022-11-14,3,3,3,0,11,12,11,1,0,0,0,0,9,9,9,9
Mono,48,2022-11-14,10,10,10,0,122,123,122,1,0,0,0,0,8,8,8,8
Monterey,48,2022-11-14,200,200,200,0,4137,4167,4166,1,20,1,1,1,776,776,775,775
Napa,48,2022-11-14,105,105,105,0,1918,1933,1932,1,5,0,0,0,159,159,159,159
Nevada,48,2022-11-14,65,65,65,0,796,804,803,1,3,0,0,2,132,132,132,132
Orange,48,2022-11-14,1560,1572,1572,0,26714,26906,26905,1,118,8,8,21,7616,7616,7608,7608
Placer,48,2022-11-14,310,311,311,0,3835,3864,3863,1,54,1,1,5,665,665,664,664
Plumas,48,2022-11-14,4,4,4,0,79,80,79,1,0,0,0,0,13,13,13,13
Riverside,48,2022-11-14,1641,1653,1653,0,22349,22509,22508,1,95,4,4,10,6663,6663,6659,6659
Sacramento,48,2022-11-14,1179,1187,1187,0,16846,16967,16966,1,82,6,6,18,3385,3385,3379,3379
San Benito,48,2022-11-14,42,42,42,0,521,525,524,1,1,0,0,0,102,102,102,102
San Bernardino,48,2022-11-14,1781,1795,1795,0,23971,24142,24141,1,83,0,0,14,8103,8103,8103,8103
San Diego,48,2022-11-14,2453,2470,2470,0,43492,43804,43803,1,124,5,5,21,5597,5597,5592,5592
San Francisco,48,2022-11-14,708,714,714,0,13675,13772,13771,1,52,7,7,5,1086,1086,1079,1079
San Joaquin,48,2022-11-14,605,610,610,0,9497,9565,9564,1,20,0,0,5,2353,2353,2353,2353
San Luis Obispo,48,2022-11-14,120,120,120,0,2198,2216,2215,1,6,0,0,1,530,530,530,530
San Mateo,48,2022-11-14,637,642,642,0,11293,11375,11374,1,27,0,0,2,737,737,737,737
Santa Barbara,48,2022-11-14,192,192,192,0,5891,5932,5931,1,15,1,1,2,737,737,736,736
Santa Clara,48,2022-11-14,1733,1747,1747,0,30425,30643,30642,1,117,3,3,14,2557,2557,2554,2554
Santa Cruz,48,2022-11-14,250,250,250,0,9596,9665,9664,1,11,1,1,0,276,276,275,275
Shasta,48,2022-11-14,101,101,101,0,1070,1079,1078,1,10,1,1,2,595,595,594,594
Siskiyou,48,2022-11-14,27,27,27,0,396,398,397,1,2,0,0,0,95,95,95,95
Solano,48,2022-11-14,437,440,440,0,5408,5448,5447,1,26,0,0,3,461,461,461,461
Sonoma,48,2022-11-14,266,266,266,0,6033,6078,6077,1,23,1,1,0,533,533,532,532
Stanislaus,48,2022-11-14,328,328,328,0,5221,5260,5259,1,48,0,0,10,1797,1797,1797,1797
Sutter,48,2022-11-14,95,95,95,0,1182,1192,1191,1,0,0,0,0,232,232,232,232
Tehama,48,2022-11-14,49,49,49,0,574,580,579,1,1,0,0,0,216,216,216,216
Trinity,48,2022-11-14,11,11,11,0,52,53,52,1,0,1,1,0,22,22,21,21
Tulare,48,2022-11-14,307,308,308,0,4282,4315,4314,1,16,0,0,1,1546,1546,1546,1546
Tuolumne,48,2022-11-14,77,77,77,0,695,701,700,1,2,0,0,0,201,201,201,201
Ventura,48,2022-11-14,572,577,577,0,10613,10691,10690,1,28,1,1,4,1608,1608,1607,1607
Yolo,48,2022-11-14,152,152,152,0,2156,2172,2171,1,2,6,6,0,415,415,409,409
Yuba,48,2022-11-14,60,60,60,0,987,995,994,1,6,0,0,1,122,122,122,122
Alameda,49,2022-11-21,1704,1719,1719,0,25161,25371,25370,1,82,8,8,16,2080,2080,2072,2072
Amador,49,2022-11-21,28,28,28,0,833,842,841,1,2,0,0,0,95,95,95,95
Butte,49,2022-11-21,144,144,144,0,1327,1339,1338,1,21,0,0,1,467,467,467,467
Calaveras,49,2022-11-21,40,40,40,0,421,426,425,1,2,0,0,0,135,135,135,135
Colusa,49,2022-11-21,9,9,9,0,110,111,110,1,0,0,0,0,22,22,22,22
Contra Costa,49,2022-11-21,997,1005,1005,0,16048,16182,16181,1,52,3,3,8,1487,1487,1484,1484
Del Norte,49,2022-11-21,16,16,16,0,452,456,455,1,4,0,0,0,55,55,55,55
El Dorado,49,2022-11-21,185,185,185,0,1826,1841,1840,1,10,0,0,1,234,234,234,234
Fresno,49,2022-11-21,1066,1074,1074,0,12139,12240,12239,1,114,4,4,9,2904,2904,2900,2900
Glenn,49,2022-11-21,21,21,21,0,214,216,215,1,0,0,0,0,53,53,53,53
Humboldt,49,2022-11-21,105,105,105,0,1078,1088,1087,1,4,1,1,1,163,163,162,162
Imperial,49,2022-11-21,280,281,281,0,3123,3148,3147,1,3,1,1,1,964,964,963,963
Inyo,49,2022-11-21,29,29,29,0,402,406,405,1,0,1,1,0,61,61,60,60
Kern,49,2022-11-21,482,487,487,0,10087,10171,10170,1,54,3,3,10,2441,2441,2438,2438
Kings,49,2022-11-21,297,298,298,0,2777,2802,2801,1,4,2,2,1,463,463,461,461
Lake,49,2022-11-21,55,55,55,0,927,935,934,1,0,0,0,1,150,150,150,150
Lassen,49,2022-11-21,34,34,34,0,540,545,544,1,0,0,0,0,64,64,64,64
Los Angeles,49,2022-11-21,13120,13230,13230,0,195651,197273,197271,2,648,69,73,93,33998,34002,33929,33929
Madera,49,2022-11-21,168,168,168,0,1860,1877,1876,1,11,0,0,1,375,375,375,375
Marin,49,2022-11-21,179,179,179,0,3350,3380,3379,1,8,0,0,0,317,317,317,317
Mariposa,49,2022-11-21,19,19,19,0,170,171,170,1,0,0,0,0,30,30,30,30
Mendocino,49,2022-11-21,38,38,38,0,889,898,897,1,4,0,0,1,137,137,137,137
Merced,49,2022-11-21,269,270,270,0,2921,2947,2946,1,9,2,2,4,881,881,879,879
Modoc,49,2022-11-21,8,8,8,0,13,14,13,1,0,0,0,0,9,9,9,9
Mono,49,2022-11-21,3,3,3,0,107,108,107,1,0,0,0,0,8,8,8,8
Monterey,49,2022-11-21,227,227,227,0,4423,4459,4458,1,17,1,1,0,777,777,776,776
Napa,49,2022-11-21,144,144,144,0,2037,2054,2053,1,4,0,0,1,159,159,159,159
Nevada,49,2022-11-21,93,93,93,0,931,940,939,1,2,0,0,2,132,132,132,132
Orange,49,2022-11-21,2159,2178,2178,0,27994,28226,28225,1,170,13,13,32,7629,7629,7616,7616
Placer,49,2022-11-21,359,360,360,0,4057,4091,4090,1,53,0,0,6,665,665,665,665
Plumas,49,2022-11-21,7,7,7,0,104,105,104,1,1,0,0,0,13,13,13,13
Riverside,49,2022-11-21,2142,2162,2162,0,24325,24527,24526,1,110,7,7,9,6670,6670,6663,6663
Sacramento,49,2022-11-21,1522,1535,1535,0,18915,19073,19072,1,105,3,3,18,3388,3388,3385,3385
San Benito,49,2022-11-21,64,64,64,0,560,567,566,1,2,0,0,0,102,102,102,102
San Bernardino,49,2022-11-21,2332,2352,2352,0,26570,26790,26789,1,89,1,1,19,8104,8104,8103,8103
San Diego,49,2022-11-21,3173,3200,3200,0,43755,44117,44116,1,198,3,3,26,5600,5600,5597,5597
San Francisco,49,2022-11-21,938,946,946,0,15058,15185,15184,1,54,5,5,7,1091,1091,1086,1086
San Joaquin,49,2022-11-21,765,772,772,0,11065,11159,11158,1,36,1,1,5,2354,2354,2353,2353
San Luis Obispo,49,2022-11-21,170,170,170,0,2350,2370,2369,1,4,1,1,0,531,531,530,530
San Mateo,49,2022-11-21,736,743,743,0,12298,12401,12400,1,36,0,0,1,737,737,737,737
Santa Barbara,49,2022-11-21,321,322,322,0,6105,6156,6155,1,15,3,3,3,740,740,737,737
Santa Clara,49,2022-11-21,2161,2180,2180,0,34182,34466,34465,1,119,9,9,23,2566,2566,2557,2557
Santa Cruz,49,2022-11-21,286,287,287,0,9511,9592,9591,1,12,0,0,2,276,276,276,276
Shasta,49,2022-11-21,91,91,91,0,1050,1060,1059,1,14,0,0,1,595,595,595,595
Siskiyou,49,2022-11-21,24,24,24,0,342,344,343,1,1,0,0,0,95,95,95,95
Solano,49,2022-11-21,488,493,493,0,5657,5704,5703,1,32,1,1,5,462,462,461,461
Sonoma,49,2022-11-21,323,324,324,0,5776,5826,5825,1,22,0,0,4,533,533,533,533
Stanislaus,49,2022-11-21,446,451,451,0,5969,6020,6019,1,51,0,0,10,1797,1797,1797,1797
Sutter,49,2022-11-21,92,92,92,0,1139,1149,1148,1,0,0,0,0,232,232,232,232
Tehama,49,2022-11-21,72,72,72,0,673,679,678,1,3,0,0,2,216,216,216,216
Trinity,49,2022-11-21,5,5,5,0,51,52,51,1,0,0,0,0,22,22,22,22
Tulare,49,2022-11-21,431,435,435,0,5502,5550,5549,1,23,0,0,1,1546,1546,1546,1546
Tuolumne,49,2022-11-21,97,97,97,0,765,773,772,1,3,0,0,0,201,201,201,201
Ventura,49,2022-11-21,728,735,735,0,10617,10706,10705,1,43,1,1,2,1609,1609,1608,1608
Yolo,49,2022-11-21,132,132,132,0,2235,2256,2255,1,7,4,4,2,419,419,415,415
Yuba,49,2022-11-21,70,70,70,0,1027,1035,1034,1,10,0,0,1,122,122,122,122
Alameda,50,2022-11-28,2217,2239,2239,0,21955,22171,22170,1,103,5,5,13,2085,2085,2080,2080
Amador,50,2022-11-28,32,32,32,0,756,765,764,1,5,1,1,1,96,96,95,95
Butte,50,2022-11-28,203,203,203,0,1476,1492,1491,1,41,0,0,1,467,467,467,467
Calaveras,50,2022-11-28,32,32,32,0,401,405,404,1,3,0,0,0,135,135,135,135
Colusa,50,2022-11-28,14,14,14,0,184,186,185,1,0,0,0,0,22,22,22,22
Contra Costa,50,2022-11-28,1434,1449,1449,0,15018,15165,15164,1,67,4,4,8,1491,1491,1487,1487
Del Norte,50,2022-11-28,28,28,28,0,426,431,430,1,1,1,1,0,56,56,55,55
El Dorado,50,2022-11-28,186,186,186,0,1548,1564,1563,1,13,1,1,1,235,235,234,234
Fresno,50,2022-11-28,1312,1327,1327,0,11701,11817,11816,1,136,5,5,19,2909,2909,2904,2904
Glenn,50,2022-11-28,17,17,17,0,194,196,195,1,3,0,0,0,53,53,53,53
Humboldt,50,2022-11-28,105,105,105,0,983,994,993,1,10,0,0,0,163,163,163,163
Imperial,50,2022-11-28,378,380,380,0,2790,2819,2818,1,6,1,1,1,965,965,964,964
Inyo,50,2022-11-28,34,34,34,0,376,380,379,1,2,0,0,0,61,61,61,61
Kern,50,2022-11-28,583,590,590,0,9354,9446,9445,1,60,4,4,6,2445,2445,2441,2441
Kings,50,2022-11-28,244,245,245,0,2544,2570,2569,1,10,0,0,0,463,463,463,463
Lake,50,2022-11-28,49,49,49,0,846,856,855,1,1,0,0,0,150,150,150,150
Lassen,50,2022-11-28,27,27,27,0,493,498,497,1,0,0,0,0,64,64,64,64
Los Angeles,50,2022-11-28,18807,18992,18992,0,176208,177947,177945,2,918,84,89,122,34082,34091,33998,34002
Madera,50,2022-11-28,162,163,163,0,1626,1644,1643,1,13,0,0,2,375,375,375,375
Marin,50,2022-11-28,298,299,299,0,3068,3099,3098,1,19,0,0,1,317,317,317,317
Mariposa,50,2022-11-28,23,23,23,0,136,137,136,1,0,0,0,0,30,30,30,30
Mendocino,50,2022-11-28,49,49,49,0,726,734,733,1,5,0,0,2,137,137,137,137
Merced,50,2022-11-28,350,352,352,0,2534,2561,2560,1,18,5,5,2,886,886,881,881
Modoc,50,2022-11-28,5,5,5,0,9,10,9,1,0,0,0,0,9,9,9,9
Mono,50,2022-11-28,4,4,4,0,94,95,94,1,0,0,0,0,8,8,8,8
Monterey,50,2022-11-28,281,282,282,0,3875,3914,3913,1,26,1,1,0,778,778,777,777
Napa,50,2022-11-28,141,141,141,0,1884,1903,1902,1,6,0,0,3,159,159,159,159
Nevada,50,2022-11-28,117,117,117,0,1006,1016,1015,1,9,0,0,0,132,132,132,132
Orange,50,2022-11-28,3095,3125,3125,0,25925,26179,26178,1,221,17,17,34,7646,7646,7629,7629
Placer,50,2022-11-28,388,392,392,0,3776,3815,3814,1,69,2,2,5,667,667,665,665
Plumas,50,2022-11-28,6,6,6,0,143,144,143,1,0,0,0,0,13,13,13,13
Riverside,50,2022-11-28,3190,3223,3223,0,23037,23263,23262,1,188,12,12,22,6682,6682,6670,6670
Sacramento,50,2022-11-28,1789,1807,1807,0,17952,18128,18127,1,126,7,7,14,3395,3395,3388,3388
San Benito,50,2022-11-28,130,130,130,0,562,568,567,1,1,0,0,0,102,102,102,102
San Bernardino,50,2022-11-28,3296,3329,3329,0,25629,25880,25879,1,146,1,1,20,8105,8105,8104,8104
San Diego,50,2022-11-28,4080,4121,4121,0,31659,31972,31971,1,259,7,7,27,5607,5607,5600,5600
San Francisco,50,2022-11-28,1159,1171,1171,0,12712,12838,12837,1,67,6,6,8,1097,1097,1091,1091
San Joaquin,50,2022-11-28,990,1000,1000,0,10923,11031,11030,1,50,3,3,11,2357,2357,2354,2354
San Luis Obispo,50,2022-11-28,179,180,180,0,2246,2269,2268,1,9,3,3,1,534,534,531,531
San Mateo,50,2022-11-28,1083,1093,1093,0,10972,11081,11080,1,42,1,1,3,738,738,737,737
Santa Barbara,50,2022-11-28,466,470,470,0,5201,5254,5253,1,27,2,2,5,742,742,740,740
Santa Clara,50,2022-11-28,2903,2932,2932,0,27978,28254,28253,1,159,8,8,22,2574,2574,2566,2566
Santa Cruz,50,2022-11-28,371,373,373,0,6655,6723,6722,1,20,0,0,2,276,276,276,276
Shasta,50,2022-11-28,97,97,97,0,1009,1021,1020,1,16,1,1,3,596,596,595,595
Siskiyou,50,2022-11-28,27,27,27,0,277,279,278,1,2,0,0,0,95,95,95,95
Solano,50,2022-11-28,588,593,593,0,5172,5223,5222,1,34,2,2,7,464,464,462,462
Sonoma,50,2022-11-28,453,459,459,0,5000,5050,5049,1,48,2,2,3,535,535,533,533
Stanislaus,50,2022-11-28,522,528,528,0,5357,5410,5409,1,77,3,3,4,1800,1800,1797,1797
Sutter,50,2022-11-28,82,82,82,0,1119,1131,1130,1,0,0,0,0,232,232,232,232
Tehama,50,2022-11-28,70,70,70,0,632,640,639,1,6,0,0,3,216,216,216,216
Trinity,50,2022-11-28,3,3,3,0,59,60,59,1,0,0,0,0,22,22,22,22
Tulare,50,2022-11-28,510,517,517,0,4928,4977,4976,1,34,0,0,0,1546,1546,1546,1546
Tuolumne,50,2022-11-28,72,72,72,0,676,684,683,1,4,0,0,0,201,201,201,201
Ventura,50,2022-11-28,962,970,970,0,10304,10406,10405,1,58,2,2,2,1611,1611,1609,1609
Yolo,50,2022-11-28,171,171,171,0,2027,2047,2046,1,3,4,4,1,423,423,419,419
Yuba,50,2022-11-28,92,92,92,0,925,935,934,1,12,0,0,0,122,122,122,122
Alameda,51,2022-12-05,2760,2792,2792,0,28744,29064,29063,1,126,7,7,13,2092,2092,2085,2085
Amador,51,2022-12-05,41,41,41,0,811,822,821,1,3,0,0,2,96,96,96,96
Butte,51,2022-12-05,238,239,239,0,1869,1890,1889,1,38,7,7,5,474,474,467,467
Calaveras,51,2022-12-05,47,47,47,0,483,491,490,1,0,1,1,0,136,136,135,135
Colusa,51,2022-12-05,12,12,12,0,206,208,207,1,4,0,0,0,22,22,22,22
Contra Costa,51,2022-12-05,1729,1749,1749,0,18643,18853,18852,1,78,0,0,11,1491,1491,1491,1491
Del Norte,51,2022-12-05,30,30,30,0,490,498,497,1,2,0,0,0,56,56,56,56
El Dorado,51,2022-12-05,181,181,181,0,1575,1594,1593,1,14,1,1,0,236,236,235,235
Fresno,51,2022-12-05,1523,1540,1540,0,14266,14425,14424,1,177,6,6,17,2915,2915,2909,2909
Glenn,51,2022-12-05,24,24,24,0,232,234,233,1,2,0,0,0,53,53,53,53
Humboldt,51,2022-12-05,121,121,121,0,988,1000,999,1,17,1,1,2,164,164,163,163
Imperial,51,2022-12-05,587,593,593,0,3394,3432,3431,1,18,2,2,5,967,967,965,965
Inyo,51,2022-12-05,26,26,26,0,332,337,336,1,1,1,1,0,62,62,61,61
Kern,51,2022-12-05,795,805,805,0,10504,10621,10620,1,55,1,1,10,2446,2446,2445,2445
Kings,51,2022-12-05,295,298,298,0,3022,3056,3055,1,8,0,0,0,463,463,463,463
Lake,51,2022-12-05,64,64,64,0,828,839,838,1,2,0,0,0,150,150,150,150
Lassen,51,2022-12-05,14,14,14,0,444,450,449,1,0,0,0,0,64,64,64,64
Los Angeles,51,2022-12-05,22322,22571,22571,0,231686,234273,234270,3,1119,108,116,151,34190,34207,34082,34091
Madera,51,2022-12-05,205,205,205,0,1979,2002,2001,1,12,0,0,3,375,375,375,375
Marin,51,2022-12-05,310,311,311,0,3480,3521,3520,1,14,0,0,2,317,317,317,317
Mariposa,51,2022-12-05,19,19,19,0,172,173,172,1,0,0,0,0,30,30,30,30
Mendocino,51,2022-12-05,47,47,47,0,793,803,802,1,6,1,1,2,138,138,137,137
Merced,51,2022-12-05,341,346,346,0,3135,3171,3170,1,23,2,2,2,888,888,886,886
Modoc,51,2022-12-05,12,12,12,0,12,13,12,1,0,0,0,0,9,9,9,9
Mono,51,2022-12-05,9,9,9,0,91,92,91,1,0,0,0,0,8,8,8,8
Monterey,51,2022-12-05,271,273,273,0,4345,4395,4394,1,34,1,1,0,779,779,778,778
Napa,51,2022-12-05,160,160,160,0,2334,2361,2360,1,7,0,0,0,159,159,159,159
Nevada,51,2022-12-05,114,114,114,0,1090,1103,1102,1,8,0,0,2,132,132,132,132
Orange,51,2022-12-05,4176,4222,4222,0,33269,33641,33640,1,301,20,20,48,7666,7666,7646,7646
Placer,51,2022-12-05,391,397,397,0,4031,4079,4078,1,72,1,1,4,668,668,667,667
Plumas,51,2022-12-05,22,22,22,0,184,186,185,1,1,0,0,0,13,13,13,13
Riverside,51,2022-12-05,3955,3998,3998,0,26866,27166,27165,1,186,12,12,25,6694,6694,6682,6682
Sacramento,51,2022-12-05,2127,2150,2150,0,21063,21298,21297,1,128,8,8,28,3403,3403,3395,3395
San Benito,51,2022-12-05,219,219,219,0,808,819,818,1,6,1,1,3,103,103,102,102
San Bernardino,51,2022-12-05,4015,4059,4059,0,27994,28309,28308,1,167,0,0,34,8105,8105,8105,8105
San Diego,51,2022-12-05,5674,5737,5737,0,44246,44740,44739,1,302,12,12,30,5619,5619,5607,5607
San Francisco,51,2022-12-05,1483,1501,1501,0,15908,16086,16085,1,77,7,7,7,1104,1104,1097,1097
San Joaquin,51,2022-12-05,1115,1127,1127,0,12387,12526,12525,1,70,8,8,16,2365,2365,2357,2357
San Luis Obispo,51,2022-12-05,206,206,206,0,2655,2686,2685,1,15,3,3,1,537,537,534,534
San Mateo,51,2022-12-05,1225,1238,1238,0,13345,13496,13495,1,56,0,0,1,738,738,738,738
Santa Barbara,51,2022-12-05,521,527,527,0,6752,6828,6827,1,38,1,1,9,743,743,742,742
Santa Clara,51,2022-12-05,3459,3499,3499,0,34710,35098,35097,1,207,11,11,26,2585,2585,2574,2574
Santa Cruz,51,2022-12-05,471,477,477,0,11779,11913,11912,1,22,0,0,3,276,276,276,276
Shasta,51,2022-12-05,132,132,132,0,1105,1119,1118,1,23,0,0,5,596,596,596,596
Siskiyou,51,2022-12-05,22,22,22,0,306,309,308,1,2,0,0,0,95,95,95,95
Solano,51,2022-12-05,627,634,634,0,6489,6563,6562,1,33,1,1,7,465,465,464,464
Sonoma,51,2022-12-05,499,506,506,0,5876,5942,5941,1,35,4,4,1,539,539,535,535
Stanislaus,51,2022-12-05,641,648,648,0,6712,6788,6787,1,76,1,1,7,1801,1801,1800,1800
Sutter,51,2022-12-05,96,96,96,0,1169,1183,1182,1,0,1,1,0,233,233,232,232
Tehama,51,2022-12-05,93,93,93,0,817,828,827,1,9,2,2,0,218,218,216,216
Trinity,51,2022-12-05,3,3,3,0,38,39,38,1,0,0,0,0,22,22,22,22
Tulare,51,2022-12-05,524,531,531,0,5940,6007,6006,1,35,0,0,1,1546,1546,1546,1546
Tuolumne,51,2022-12-05,107,107,107,0,852,862,861,1,2,0,0,0,201,201,201,201
Ventura,51,2022-12-05,1099,1111,1111,0,11824,11957,11956,1,71,2,2,6,1613,1613,1611,1611
Yolo,51,2022-12-05,213,214,214,0,2593,2622,2621,1,2,1,1,3,424,424,423,423
Yuba,51,2022-12-05,82,82,82,0,1021,1034,1033,1,11,0,0,1,122,122,122,122
Alameda,52,2022-12-12,2606,2639,2639,0,28661,29022,29021,1,147,10,10,20,2102,2102,2092,2092
Amador,52,2022-12-12,32,32,32,0,786,796,795,1,3,0,0,0,96,96,96,96
Butte,52,2022-12-12,183,183,183,0,1810,1834,1833,1,39,2,2,2,476,476,474,474
Calaveras,52,2022-12-12,41,41,41,0,452,459,458,1,1,0,0,0,136,136,136,136
Colusa,52,2022-12-12,12,12,12,0,272,276,275,1,1,0,0,0,22,22,22,22
Contra Costa,52,2022-12-12,1691,1713,1713,0,17626,17848,17847,1,78,9,9,4,1500,1500,1491,1491
Del Norte,52,2022-12-12,27,27,27,0,469,477,476,1,3,0,0,0,56,56,56,56
El Dorado,52,2022-12-12,146,146,146,0,1404,1422,1421,1,8,1,1,3,237,237,236,236
Fresno,52,2022-12-12,1473,1491,1491,0,13774,13946,13945,1,186,12,12,18,2927,2927,2915,2915
Glenn,52,2022-12-12,17,17,17,0,229,231,230,1,6,0,0,0,53,53,53,53
Humboldt,52,2022-12-12,97,97,97,0,911,924,923,1,13,1,1,2,165,165,164,164
Imperial,52,2022-12-12,451,456,456,0,2938,2977,2976,1,27,3,3,3,970,970,967,967
Inyo,52,2022-12-12,22,22,22,0,303,308,307,1,1,0,0,0,62,62,62,62
Kern,52,2022-12-12,943,954,954,0,10807,10944,10943,1,55,1,1,4,2447,2447,2446,2446
Kings,52,2022-12-12,256,259,259,0,2827,2864,2863,1,8,2,2,0,465,465,463,463
Lake,52,2022-12-12,56,56,56,0,761,773,772,1,3,0,0,1,150,150,150,150
Lassen,52,2022-12-12,15,15,15,0,423,430,429,1,0,0,0,0,64,64,64,64
Los Angeles,52,2022-12-12,17420,17640,17640,0,213960,216655,216653,2,1113,155,171,154,34345,34378,34190,34207
Madera,52,2022-12-12,212,215,215,0,2167,2196,2195,1,15,0,0,2,375,375,375,375
Marin,52,2022-12-12,314,319,319,0,3576,3622,3621,1,24,0,0,2,317,317,317,317
Mariposa,52,2022-12-12,18,18,18,0,121,122,121,1,0,0,0,0,30,30,30,30
Mendocino,52,2022-12-12,53,53,53,0,654,664,663,1,7,1,1,0,139,139,138,138
Merced,52,2022-12-12,280,284,284,0,3162,3203,3202,1,14,0,0,2,888,888,888,888
Modoc,52,2022-12-12,5,5,5,0,10,11,10,1,0,0,0,0,9,9,9,9
Mono,52,2022-12-12,9,9,9,0,121,122,121,1,0,0,0,0,8,8,8,8
Monterey,52,2022-12-12,263,265,265,0,4222,4276,4275,1,25,3,3,2,782,782,779,779
Napa,52,2022-12-12,163,164,164,0,2169,2197,2196,1,9,1,1,0,160,160,159,159
Nevada,52,2022-12-12,90,90,90,0,922,936,935,1,5,0,0,2,132,132,132,132
Orange,52,2022-12-12,3408,3452,3452,0,30168,30548,30547,1,300,32,35,48,7698,7701,7666,7666
Placer,52,2022-12-12,330,336,336,0,3856,3905,3904,1,73,5,5,6,673,673,668,668
Plumas,52,2022-12-12,7,7,7,0,186,189,188,1,2,0,0,0,13,13,13,13
Riverside,52,2022-12-12,3298,3339,3339,0,24178,24482,24481,1,204,18,19,25,6712,6713,6694,6694
Sacramento,52,2022-12-12,1809,1833,1833,0,19876,20125,20124,1,173,7,7,31,3410,3410,3403,3403
San Benito,52,2022-12-12,124,124,124,0,645,655,654,1,2,2,2,2,105,105,103,103
San Bernardino,52,2022-12-12,3539,3584,3584,0,26439,26772,26771,1,226,3,3,36,8108,8108,8105,8105
San Diego,52,2022-12-12,4721,4781,4781,0,39962,40464,40463,1,331,14,14,45,5633,5633,5619,5619
San Francisco,52,2022-12-12,1414,1433,1433,0,16567,16776,16775,1,103,5,5,12,1109,1109,1104,1104
San Joaquin,52,2022-12-12,997,1010,1010,0,12283,12438,12437,1,68,5,5,19,2370,2370,2365,2365
San Luis Obispo,52,2022-12-12,230,232,232,0,2646,2679,2678,1,10,1,1,0,538,538,537,537
San Mateo,52,2022-12-12,1146,1160,1160,0,12207,12362,12361,1,59,0,0,3,738,738,738,738
Santa Barbara,52,2022-12-12,512,519,519,0,5749,5823,5822,1,36,2,2,6,745,745,743,743
Santa Clara,52,2022-12-12,3219,3259,3259,0,33783,34210,34209,1,198,16,17,30,2601,2602,2585,2585
Santa Cruz,52,2022-12-12,576,582,582,0,12398,12556,12555,1,29,0,0,1,276,276,276,276
Shasta,52,2022-12-12,104,104,104,0,1147,1162,1161,1,22,0,0,5,596,596,596,596
Siskiyou,52,2022-12-12,15,15,15,0,237,239,238,1,2,0,0,0,95,95,95,95
Solano,52,2022-12-12,628,635,635,0,6117,6195,6194,1,42,2,2,7,467,467,465,465
Sonoma,52,2022-12-12,564,572,572,0,5561,5631,5630,1,41,1,1,7,540,540,539,539
Stanislaus,52,2022-12-12,594,601,601,0,6287,6367,6366,1,104,7,7,12,1808,1808,1801,1801
Sutter,52,2022-12-12,114,114,114,0,1146,1161,1160,1,0,0,0,0,233,233,233,233
Tehama,52,2022-12-12,80,80,80,0,738,748,747,1,6,1,1,0,219,219,218,218
Trinity,52,2022-12-12,3,3,3,0,45,46,45,1,0,0,0,0,22,22,22,22
Tulare,52,2022-12-12,437,444,444,0,5849,5923,5922,1,27,2,2,2,1548,1548,1546,1546
Tuolumne,52,2022-12-12,131,132,132,0,933,945,944,1,5,0,0,0,201,201,201,201
Ventura,52,2022-12-12,912,924,924,0,10305,10436,10435,1,72,4,4,7,1617,1617,1613,1613
Yolo,52,2022-12-12,212,214,214,0,2290,2321,2320,1,5,2,2,2,426,426,424,424
Yuba,52,2022-12-12,75,75,75,0,931,944,943,1,13,0,0,0,122,122,122,122
Alameda,53,2022-12-19,2266,2298,2298,0,26065,26438,26437,1,144,9,9,19,2111,2111,2102,2102
Amador,53,2022-12-19,42,42,42,0,805,817,816,1,6,0,0,0,96,96,96,96
Butte,53,2022-12-19,129,129,129,0,1503,1526,1525,1,34,3,3,2,479,479,476,476
Calaveras,53,2022-12-19,29,29,29,0,438,446,445,1,1,1,1,0,137,137,136,136
Colusa,53,2022-12-19,12,12,12,0,213,216,215,1,1,0,0,0,22,22,22,22
Contra Costa,53,2022-12-19,1651,1676,1676,0,16487,16723,16722,1,95,6,6,7,1506,1506,1500,1500
Del Norte,53,2022-12-19,31,31,31,0,490,498,497,1,3,0,0,0,56,56,56,56
El Dorado,53,2022-12-19,161,161,161,0,1625,1650,1649,1,9,1,1,2,238,238,237,237
Fresno,53,2022-12-19,1167,1184,1184,0,12738,12922,12921,1,212,7,7,22,2934,2934,2927,2927
Glenn,53,2022-12-19,21,21,21,0,203,205,204,1,6,0,0,0,53,53,53,53
Humboldt,53,2022-12-19,101,101,101,0,876,890,889,1,9,0,0,1,165,165,165,165
Imperial,53,2022-12-19,259,263,263,0,2543,2580,2579,1,16,1,1,0,971,971,970,970
Inyo,53,2022-12-19,12,12,12,0,324,329,328,1,1,0,0,0,62,62,62,62
Kern,53,2022-12-19,919,932,932,0,10598,10751,10750,1,60,3,3,5,2450,2450,2447,2447
Kings,53,2022-12-19,229,233,233,0,2702,2742,2741,1,6,3,3,1,468,468,465,465
Lake,53,2022-12-19,70,70,70,0,791,803,802,1,4,0,0,0,150,150,150,150
Lassen,53,2022-12-19,8,8,8,0,466,474,473,1,0,0,0,0,64,64,64,64
Los Angeles,53,2022-12-19,15144,15360,15360,0,191609,194350,194348,2,1096,127,143,155,34472,34521,34345,34378
Madera,53,2022-12-19,183,183,183,0,1882,1910,1909,1,10,0,0,1,375,375,375,375
Marin,53,2022-12-19,268,274,274,0,3193,3240,3239,1,17,0,0,0,317,317,317,317
Mariposa,53,2022-12-19,25,25,25,0,133,134,133,1,0,0,0,0,30,30,30,30
Mendocino,53,2022-12-19,66,66,66,0,752,764,763,1,4,0,0,0,139,139,139,139
Merced,53,2022-12-19,239,243,243,0,2684,2723,2722,1,15,2,2,2,890,890,888,888
Modoc,53,2022-12-19,8,8,8,0,20,21,20,1,0,0,0,0,9,9,9,9
Mono,53,2022-12-19,11,11,11,0,120,121,120,1,1,0,0,0,8,8,8,8
Monterey,53,2022-12-19,231,233,233,0,3810,3866,3865,1,13,1,1,1,783,783,782,782
Napa,53,2022-12-19,181,182,182,0,2085,2116,2115,1,8,0,0,0,160,160,160,160
Nevada,53,2022-12-19,71,71,71,0,849,862,861,1,5,0,0,2,132,132,132,132
Orange,53,2022-12-19,3212,3258,3258,0,28927,29343,29342,1,296,29,32,51,7727,7733,7698,7701
Placer,53,2022-12-19,361,366,366,0,3808,3864,3863,1,90,2,2,10,675,675,673,673
Plumas,53,2022-12-19,7,7,7,0,187,190,189,1,0,0,0,0,13,13,13,13
Riverside,53,2022-12-19,3095,3140,3140,0,22346,22666,22665,1,177,20,21,22,6732,6734,6712,6713
Sacramento,53,2022-12-19,1719,1744,1744,0,19377,19656,19655,1,210,12,13,22,3422,3423,3410,3410
San Benito,53,2022-12-19,104,104,104,0,500,507,506,1,0,4,4,1,109,109,105,105
San Bernardino,53,2022-12-19,3147,3192,3192,0,24523,24875,24874,1,200,4,4,38,8112,8112,8108,8108
San Diego,53,2022-12-19,4691,4757,4757,0,38608,39161,39160,1,381,16,16,45,5649,5649,5633,5633
San Francisco,53,2022-12-19,1213,1232,1232,0,15545,15767,15766,1,106,9,9,17,1118,1118,1109,1109
San Joaquin,53,2022-12-19,846,858,858,0,12538,12719,12718,1,58,10,10,19,2380,2380,2370,2370
San Luis Obispo,53,2022-12-19,242,245,245,0,2418,2454,2453,1,17,1,1,0,539,539,538,538
San Mateo,53,2022-12-19,914,927,927,0,11629,11796,11795,1,62,0,0,5,738,738,738,738
Santa Barbara,53,2022-12-19,466,474,474,0,5234,5310,5309,1,35,4,4,5,749,749,745,745
Santa Clara,53,2022-12-19,2785,2825,2825,0,31181,31630,31629,1,205,14,14,30,2615,2616,2601,2602
Santa Cruz,53,2022-12-19,259,261,261,0,10456,10607,10606,1,31,0,0,1,276,276,276,276
Shasta,53,2022-12-19,108,108,108,0,1117,1133,1132,1,24,1,1,4,597,597,596,596
Siskiyou,53,2022-12-19,15,15,15,0,258,264,263,1,2,0,0,0,95,95,95,95
Solano,53,2022-12-19,633,642,642,0,6066,6155,6154,1,41,1,1,6,468,468,467,467
Sonoma,53,2022-12-19,476,483,483,0,5392,5471,5470,1,38,1,1,4,541,541,540,540
Stanislaus,53,2022-12-19,472,479,479,0,5914,6000,5999,1,94,1,1,12,1809,1809,1808,1808
Sutter,53,2022-12-19,81,81,81,0,1053,1068,1067,1,0,1,1,0,234,234,233,233
Tehama,53,2022-12-19,67,67,67,0,659,670,669,1,6,0,0,0,219,219,219,219
Trinity,53,2022-12-19,2,2,2,0,31,32,31,1,0,0,0,0,22,22,22,22
Tulare,53,2022-12-19,466,474,474,0,5234,5310,5309,1,53,5,5,1,1553,1553,1548,1548
Tuolumne,53,2022-12-19,88,88,88,0,839,852,851,1,2,1,1,1,202,202,201,201
Ventura,53,2022-12-19,933,946,946,0,9669,9809,9808,1,81,4,4,9,1621,1621,1617,1617
Yolo,53,2022-12-19,168,168,168,0,1906,1933,1932,1,5,4,4,0,430,430,426,426
Yuba,53,2022-12-19,81,81,81,0,852,865,864,1,7,0,0,0,122,122,122,122
Alameda,54,2022-12-26,1925,1955,1955,0,20071,20399,20398,1,150,10,10,17,2121,2121,2111,2111
Amador,54,2022-12-26,43,43,43,0,758,772,771,1,5,1,1,0,97,97,96,96
Butte,54,2022-12-26,96,96,96,0,1293,1316,1315,1,33,0,0,1,479,479,479,479
Calaveras,54,2022-12-26,24,24,24,0,365,372,371,1,0,1,1,0,138,138,137,137
Colusa,54,2022-12-26,14,14,14,0,150,152,151,1,0,0,0,0,22,22,22,22
Contra Costa,54,2022-12-26,1403,1426,1426,0,13263,13480,13479,1,89,7,7,11,1513,1513,1506,1506
Del Norte,54,2022-12-26,32,32,32,0,395,404,403,1,3,0,0,0,56,56,56,56
El Dorado,54,2022-12-26,148,148,148,0,1316,1340,1339,1,7,1,1,0,239,239,238,238
Fresno,54,2022-12-26,1069,1086,1086,0,10613,10788,10787,1,186,10,10,33,2944,2944,2934,2934
Glenn,54,2022-12-26,12,12,12,0,193,197,196,1,0,0,0,0,53,53,53,53
Humboldt,54,2022-12-26,73,73,73,0,599,609,608,1,5,2,2,2,167,167,165,165
Imperial,54,2022-12-26,235,239,239,0,2161,2198,2197,1,67,2,2,0,973,973,971,971
Inyo,54,2022-12-26,13,13,13,0,158,160,159,1,1,0,0,0,62,62,62,62
Kern,54,2022-12-26,692,704,704,0,8698,8842,8841,1,51,8,9,8,2458,2459,2450,2450
Kings,54,2022-12-26,200,204,204,0,2256,2294,2293,1,5,0,0,2,468,468,468,468
Lake,54,2022-12-26,58,58,58,0,600,611,610,1,3,0,0,1,150,150,150,150
Lassen,54,2022-12-26,27,27,27,0,485,494,493,1,0,0,0,0,64,64,64,64
Los Angeles,54,2022-12-26,13365,13585,13585,0,127884,129978,129977,1,1032,157,184,164,34629,34705,34472,34521
Madera,54,2022-12-26,165,168,168,0,1561,1588,1587,1,6,0,0,1,375,375,375,375
Marin,54,2022-12-26,212,215,215,0,2544,2587,2586,1,29,0,0,2,317,317,317,317
Mariposa,54,2022-12-26,22,22,22,0,105,106,105,1,0,0,0,0,30,30,30,30
Mendocino,54,2022-12-26,74,74,74,0,646,658,657,1,10,0,0,0,139,139,139,139
Merced,54,2022-12-26,202,206,206,0,1930,1963,1962,1,17,5,5,3,895,895,890,890
Modoc,54,2022-12-26,4,4,4,0,11,12,11,1,0,0,0,0,9,9,9,9
Mono,54,2022-12-26,10,10,10,0,82,83,82,1,0,0,0,0,8,8,8,8
Monterey,54,2022-12-26,182,183,183,0,2938,2988,2987,1,21,4,4,0,787,787,783,783
Napa,54,2022-12-26,142,142,142,0,1717,1747,1746,1,12,0,0,0,160,160,160,160
Nevada,54,2022-12-26,64,64,64,0,747,759,758,1,9,0,0,1,132,132,132,132
Orange,54,2022-12-26,3135,3187,3187,0,23703,24091,24090,1,274,34,41,31,7761,7774,7727,7733
Placer,54,2022-12-26,290,295,295,0,3035,3085,3084,1,87,2,2,12,677,677,675,675
Plumas,54,2022-12-26,10,10,10,0,123,124,123,1,0,0,0,0,13,13,13,13
Riverside,54,2022-12-26,2862,2910,2910,0,18092,18390,18389,1,194,8,8,18,6740,6742,6732,6734
Sacramento,54,2022-12-26,1370,1392,1392,0,14451,14688,14687,1,179,13,14,25,3435,3437,3422,3423
San Benito,54,2022-12-26,105,105,105,0,400,408,407,1,1,0,0,1,109,109,109,109
San Bernardino,54,2022-12-26,2838,2885,2885,0,19768,20092,20091,1,210,7,7,26,8119,8119,8112,8112
San Diego,54,2022-12-26,4462,4535,4535,0,28046,28505,28504,1,395,24,28,45,5673,5677,5649,5649
San Francisco,54,2022-12-26,1005,1021,1021,0,11723,11915,11914,1,90,20,23,15,1138,1141,1118,1118
San Joaquin,54,2022-12-26,750,762,762,0,10056,10221,10220,1,60,6,6,10,2386,2386,2380,2380
San Luis Obispo,54,2022-12-26,211,215,215,0,1967,1999,1998,1,20,3,3,0,542,542,539,539
San Mateo,54,2022-12-26,815,828,828,0,8768,8912,8911,1,55,0,0,6,738,738,738,738
Santa Barbara,54,2022-12-26,486,494,494,0,4086,4153,4152,1,40,0,0,4,749,749,749,749
Santa Clara,54,2022-12-26,2271,2308,2308,0,23288,23671,23670,1,179,9,10,35,2624,2626,2615,2616
Santa Cruz,54,2022-12-26,222,224,224,0,4600,4676,4675,1,25,0,0,2,276,276,276,276
Shasta,54,2022-12-26,99,99,99,0,914,930,929,1,18,0,0,1,597,597,597,597
Siskiyou,54,2022-12-26,17,17,17,0,266,273,272,1,1,0,0,0,95,95,95,95
Solano,54,2022-12-26,647,657,657,0,5230,5317,5316,1,59,2,2,7,470,470,468,468
Sonoma,54,2022-12-26,449,456,456,0,4237,4308,4307,1,39,0,0,4,541,541,541,541
Stanislaus,54,2022-12-26,449,456,456,0,4878,4959,4958,1,96,9,9,5,1818,1818,1809,1809
Sutter,54,2022-12-26,127,127,127,0,926,942,941,1,0,0,0,0,234,234,234,234
Tehama,54,2022-12-26,47,47,47,0,570,581,580,1,2,1,1,0,220,220,219,219
Trinity,54,2022-12-26,3,3,3,0,39,40,39,1,0,0,0,0,22,22,22,22
Tulare,54,2022-12-26,440,447,447,0,3868,3933,3932,1,41,6,6,3,1559,1559,1553,1553
Tuolumne,54,2022-12-26,92,92,92,0,757,771,770,1,6,0,0,2,202,202,202,202
Ventura,54,2022-12-26,884,898,898,0,7714,7842,7841,1,71,16,19,11,1637,1640,1621,1621
Yolo,54,2022-12-26,137,137,137,0,1600,1626,1625,1,9,2,2,1,432,432,430,430
Yuba,54,2022-12-26,99,99,99,0,753,766,765,1,14,0,0,0,122,122,122,122
Alameda,55,2023-01-02,1780,1813,1813,0,19516,19898,19897,1,175,12,14,19,2133,2135,2121,2121
Amador,55,2023-01-02,32,32,32,0,673,686,685,1,3,1,1,0,98,98,97,97
Butte,55,2023-01-02,95,95,95,0,1326,1351,1350,1,35,3,4,2,482,483,479,479
Calaveras,55,2023-01-02,33,33,33,0,360,369,368,1,0,2,2,0,140,140,138,138
Colusa,55,2023-01-02,5,5,5,0,94,95,94,1,0,0,0,0,22,22,22,22
Contra Costa,55,2023-01-02,1316,1341,1341,0,13548,13813,13812,1,89,4,4,13,1517,1517,1513,1513
Del Norte,55,2023-01-02,32,32,32,0,385,393,392,1,3,0,0,2,56,56,56,56
El Dorado,55,2023-01-02,145,148,148,0,1398,1426,1425,1,7,0,0,2,239,239,239,239
Fresno,55,2023-01-02,1045,1065,1065,0,11149,11368,11367,1,195,13,16,28,2957,2960,2944,2944
Glenn,55,2023-01-02,12,12,12,0,188,192,191,1,0,0,0,0,53,53,53,53
Humboldt,55,2023-01-02,43,43,43,0,590,603,602,1,2,0,0,2,167,167,167,167
Imperial,55,2023-01-02,208,211,211,0,2017,2057,2056,1,11,0,0,1,973,973,973,973
Inyo,55,2023-01-02,16,16,16,0,226,230,229,1,1,0,0,0,62,62,62,62
Kern,55,2023-01-02,876,892,892,0,9524,9709,9708,1,66,1,1,8,2459,2460,2458,2459
Kings,55,2023-01-02,187,192,192,0,2148,2191,2190,1,4,2,2,1,470,470,468,468
Lake,55,2023-01-02,46,46,46,0,602,615,614,1,3,0,0,0,150,150,150,150
Lassen,55,2023-01-02,14,14,14,0,490,500,499,1,0,0,0,0,64,64,64,64
Los Angeles,55,2023-01-02,13223,13484,13484,0,129776,132321,132319,2,1091,134,168,154,34763,34873,34629,34705
Madera,55,2023-01-02,150,152,152,0,1648,1681,1680,1,7,0,0,0,375,375,375,375
Marin,55,2023-01-02,221,226,226,0,2389,2437,2436,1,24,0,0,2,317,317,317,317
Mariposa,55,2023-01-02,14,14,14,0,94,95,94,1,0,0,0,0,30,30,30,30
Mendocino,55,2023-01-02,57,57,57,0,686,700,699,1,6,1,1,3,140,140,139,139
Merced,55,2023-01-02,169,172,172,0,1960,2000,1999,1,8,2,2,4,897,897,895,895
Modoc,55,2023-01-02,9,9,9,0,13,14,13,1,0,0,0,0,9,9,9,9
Mono,55,2023-01-02,10,10,10,0,66,67,66,1,0,0,0,0,8,8,8,8
Monterey,55,2023-01-02,207,212,212,0,3026,3086,3085,1,27,0,0,0,787,787,787,787
Napa,55,2023-01-02,123,124,124,0,1676,1710,1709,1,8,1,1,1,161,161,160,160
Nevada,55,2023-01-02,53,53,53,0,718,733,732,1,8,0,0,2,132,132,132,132
Orange,55,2023-01-02,3155,3216,3216,0,24026,24497,24496,1,312,23,28,28,7784,7802,7761,7774
Placer,55,2023-01-02,302,309,309,0,3230,3295,3294,1,108,1,1,8,678,678,677,677
Plumas,55,2023-01-02,12,12,12,0,145,148,147,1,1,1,1,0,14,14,13,13
Riverside,55,2023-01-02,3020,3081,3081,0,19299,19677,19676,1,223,6,6,31,6746,6748,6740,6742
Sacramento,55,2023-01-02,1516,1546,1546,0,15173,15469,15468,1,201,17,21,26,3452,3458,3435,3437
San Benito,55,2023-01-02,55,55,55,0,413,421,420,1,1,0,0,1,109,109,109,109
San Bernardino,55,2023-01-02,2792,2847,2847,0,20375,20773,20772,1,183,3,4,31,8122,8123,8119,8119
San Diego,55,2023-01-02,4584,4673,4673,0,28794,29359,29358,1,401,18,22,43,5691,5699,5673,5677
San Francisco,55,2023-01-02,871,889,889,0,10092,10290,10289,1,77,9,11,15,1147,1152,1138,1141
San Joaquin,55,2023-01-02,746,760,760,0,10384,10588,10587,1,62,4,4,12,2390,2390,2386,2386
San Luis Obispo,55,2023-01-02,200,204,204,0,1985,2024,2023,1,17,6,6,0,548,548,542,542
San Mateo,55,2023-01-02,714,728,728,0,7868,8022,8021,1,50,0,0,9,738,738,738,738
Santa Barbara,55,2023-01-02,428,437,437,0,4023,4105,4104,1,47,1,1,5,750,750,749,749
Santa Clara,55,2023-01-02,2390,2437,2437,0,22692,23138,23137,1,200,13,17,32,2637,2643,2624,2626
Santa Cruz,55,2023-01-02,168,171,171,0,2882,2938,2937,1,27,0,0,0,276,276,276,276
Shasta,55,2023-01-02,101,101,101,0,916,934,933,1,20,0,0,1,597,597,597,597
Siskiyou,55,2023-01-02,15,15,15,0,268,276,275,1,1,0,0,0,95,95,95,95
Solano,55,2023-01-02,634,647,647,0,5285,5389,5388,1,60,3,3,11,473,473,470,470
Sonoma,55,2023-01-02,420,428,428,0,4254,4338,4337,1,56,0,0,2,541,541,541,541
Stanislaus,55,2023-01-02,470,479,479,0,5001,5101,5100,1,88,3,3,8,1821,1821,1818,1818
Sutter,55,2023-01-02,95,95,95,0,885,902,901,1,0,0,0,0,234,234,234,234
Tehama,55,2023-01-02,50,50,50,0,539,551,550,1,2,1,1,0,221,221,220,220
Trinity,55,2023-01-02,2,2,2,0,38,39,38,1,0,0,0,0,22,22,22,22
Tulare,55,2023-01-02,465,476,476,0,4521,4608,4607,1,52,1,1,6,1560,1560,1559,1559
Tuolumne,55,2023-01-02,61,61,61,0,660,673,672,1,5,0,0,0,202,202,202,202
Ventura,55,2023-01-02,888,905,905,0,7294,7438,7437,1,87,10,11,13,1647,1651,1637,1640
Yolo,55,2023-01-02,136,136,136,0,1512,1542,1541,1,4,2,2,1,434,434,432,432
Yuba,55,2023-01-02,80,80,80,0,731,746,745,1,19,0,0,1,122,122,122,122
Alameda,56,2023-01-09,1425,1460,1460,0,22886,23462,23461,1,149,12,18,11,2145,2153,2133,2135
Amador,56,2023-01-09,28,28,28,0,705,723,722,1,2,0,0,0,98,98,98,98
Butte,56,2023-01-09,84,84,84,0,1194,1224,1223,1,39,1,1,3,483,484,482,483
Calaveras,56,2023-01-09,18,18,18,0,339,349,348,1,0,0,0,1,140,140,140,140
Colusa,56,2023-01-09,8,8,8,0,87,88,87,1,0,0,0,0,22,22,22,22
Contra Costa,56,2023-01-09,1006,1031,1031,0,15008,15384,15383,1,85,1,1,11,1518,1518,1517,1517
Del Norte,56,2023-01-09,16,16,16,0,341,351,350,1,5,0,0,2,56,56,56,56
El Dorado,56,2023-01-09,82,82,82,0,1431,1469,1468,1,4,0,0,0,239,239,239,239
Fresno,56,2023-01-09,776,796,796,0,11292,11575,11574,1,171,7,10,23,2964,2970,2957,2960
Glenn,56,2023-01-09,8,8,8,0,184,189,188,1,0,0,0,0,53,53,53,53
Humboldt,56,2023-01-09,45,45,45,0,661,680,679,1,7,0,0,4,167,167,167,167
Imperial,56,2023-01-09,151,155,155,0,2427,2488,2487,1,12,1,1,2,974,974,973,973
Inyo,56,2023-01-09,9,9,9,0,205,210,209,1,0,0,0,0,62,62,62,62
Kern,56,2023-01-09,567,581,581,0,10277,10537,10536,1,73,2,3,8,2461,2463,2459,2460
Kings,56,2023-01-09,184,189,189,0,2296,2355,2354,1,9,0,0,0,470,470,470,470
Lake,56,2023-01-09,40,40,40,0,619,636,635,1,3,0,0,0,150,150,150,150
Lassen,56,2023-01-09,18,18,18,0,503,517,516,1,2,0,0,0,64,64,64,64
Los Angeles,56,2023-01-09,10018,10267,10267,0,178831,183329,183327,2,965,116,164,136,34879,35037,34763,34873
Madera,56,2023-01-09,92,93,93,0,1636,1679,1678,1,8,0,0,1,375,375,375,375
Marin,56,2023-01-09,142,145,145,0,2548,2612,2611,1,18,0,0,3,317,317,317,317
Mariposa,56,2023-01-09,8,8,8,0,98,101,100,1,0,0,0,0,30,30,30,30
Mendocino,56,2023-01-09,34,34,34,0,640,657,656,1,10,2,2,3,142,142,140,140
Merced,56,2023-01-09,156,160,160,0,1963,2013,2012,1,11,1,2,1,898,899,897,897
Modoc,56,2023-01-09,8,8,8,0,14,15,14,1,0,0,0,0,9,9,9,9
Mono,56,2023-01-09,12,12,12,0,78,79,78,1,0,0,0,0,8,8,8,8
Monterey,56,2023-01-09,156,160,160,0,3110,3189,3188,1,20,2,2,3,789,789,787,787
Napa,56,2023-01-09,130,134,134,0,1873,1921,1920,1,9,0,0,3,161,161,161,161
Nevada,56,2023-01-09,34,34,34,0,725,745,744,1,6,0,0,0,132,132,132,132
Orange,56,2023-01-09,2379,2439,2439,0,26769,27439,27438,1,267,12,17,34,7796,7819,7784,7802
Placer,56,2023-01-09,250,257,257,0,3368,3454,3453,1,89,0,0,6,678,678,678,678
Plumas,56,2023-01-09,5,5,5,0,87,89,88,1,1,0,0,0,14,14,14,14
Riverside,56,2023-01-09,1973,2023,2023,0,20346,20854,20853,1,186,7,9,26,6753,6757,6746,6748
Sacramento,56,2023-01-09,988,1013,1013,0,15245,15626,15625,1,178,11,15,28,3463,3473,3452,3458
San Benito,56,2023-01-09,45,45,45,0,813,834,833,1,1,0,0,2,109,109,109,109
San Bernardino,56,2023-01-09,1688,1730,1730,0,20177,20683,20682,1,179,6,8,36,8128,8131,8122,8123
San Diego,56,2023-01-09,3549,3637,3637,0,33977,34832,34831,1,397,16,23,40,5707,5722,5691,5699
San Francisco,56,2023-01-09,777,797,797,0,12686,13006,13005,1,75,5,6,17,1152,1158,1147,1152
San Joaquin,56,2023-01-09,577,591,591,0,10916,11193,11192,1,51,4,5,12,2394,2395,2390,2390
San Luis Obispo,56,2023-01-09,172,176,176,0,2138,2192,2191,1,12,1,1,0,549,549,548,548
San Mateo,56,2023-01-09,588,603,603,0,9517,9758,9757,1,47,0,0,5,738,738,738,738
Santa Barbara,56,2023-01-09,355,363,363,0,4440,4553,4552,1,39,3,4,1,753,754,750,750
Santa Clara,56,2023-01-09,1928,1975,1975,0,27632,28330,28329,1,182,9,12,28,2646,2655,2637,2643
Santa Cruz,56,2023-01-09,151,156,156,0,3635,3727,3726,1,27,0,0,1,276,276,276,276
Shasta,56,2023-01-09,54,54,54,0,818,839,838,1,17,0,0,2,597,597,597,597
Siskiyou,56,2023-01-09,20,20,20,0,221,229,228,1,0,0,0,0,95,95,95,95
Solano,56,2023-01-09,391,401,401,0,5116,5246,5245,1,54,1,1,6,474,474,473,473
Sonoma,56,2023-01-09,281,288,288,0,4743,4863,4862,1,31,2,2,4,543,543,541,541
Stanislaus,56,2023-01-09,292,299,299,0,5130,5260,5259,1,87,2,2,8,1823,1823,1821,1821
Sutter,56,2023-01-09,60,60,60,0,867,890,889,1,0,0,0,0,234,234,234,234
Tehama,56,2023-01-09,22,22,22,0,407,419,418,1,1,0,0,0,221,221,221,221
Trinity,56,2023-01-09,2,2,2,0,30,31,30,1,0,0,0,0,22,22,22,22
Tulare,56,2023-01-09,326,333,333,0,4995,5122,5121,1,53,1,2,2,1561,1562,1560,1560
Tuolumne,56,2023-01-09,70,70,70,0,651,667,666,1,2,0,0,0,202,202,202,202
Ventura,56,2023-01-09,621,636,636,0,8900,9123,9122,1,65,4,5,12,1651,1656,1647,1651
Yolo,56,2023-01-09,105,107,107,0,1571,1611,1610,1,2,0,0,1,434,434,434,434
Yuba,56,2023-01-09,49,49,49,0,734,753,752,1,21,0,0,1,122,122,122,122
Alameda,57,2023-01-16,844,873,873,0,18717,19359,19358,1,105,4,8,11,2149,2161,2145,2153
Amador,57,2023-01-16,20,20,20,0,584,604,603,1,4,0,0,0,98,98,98,98
Butte,57,2023-01-16,54,54,54,0,1155,1197,1196,1,21,3,7,0,486,491,483,484
Calaveras,57,2023-01-16,10,10,10,0,305,317,316,1,2,0,0,1,140,140,140,140
Colusa,57,2023-01-16,7,7,7,0,86,89,88,1,1,0,0,0,22,22,22,22
Contra Costa,57,2023-01-16,589,608,608,0,11759,12162,12161,1,61,0,0,11,1518,1518,1518,1518
Del Norte,57,2023-01-16,6,6,6,0,281,291,290,1,3,1,2,1,57,58,56,56
El Dorado,57,2023-01-16,57,57,57,0,972,1007,1006,1,2,0,0,1,239,239,239,239
Fresno,57,2023-01-16,447,463,463,0,9632,9971,9970,1,162,2,4,13,2966,2974,2964,2970
Glenn,57,2023-01-16,3,3,3,0,162,168,167,1,0,0,0,0,53,53,53,53
Humboldt,57,2023-01-16,28,28,28,0,476,494,493,1,9,1,3,2,168,170,167,167
Imperial,57,2023-01-16,126,132,132,0,2018,2089,2088,1,10,0,0,2,974,974,974,974
Inyo,57,2023-01-16,11,11,11,0,199,208,207,1,0,0,0,0,62,62,62,62
Kern,57,2023-01-16,366,379,379,0,8169,8453,8452,1,55,3,6,13,2464,2469,2461,2463
Kings,57,2023-01-16,125,130,130,0,1963,2031,2030,1,5,0,0,0,470,470,470,470
Lake,57,2023-01-16,19,19,19,0,575,597,596,1,2,0,0,1,150,150,150,150
Lassen,57,2023-01-16,7,7,7,0,441,457,456,1,0,0,0,0,64,64,64,64
Los Angeles,57,2023-01-16,5987,6197,6197,0,144907,149894,149892,2,855,75,146,113,34954,35183,34879,35037
Madera,57,2023-01-16,62,63,63,0,1339,1388,1387,1,4,0,0,2,375,375,375,375
Marin,57,2023-01-16,123,127,127,0,2126,2201,2200,1,20,0,0,1,317,317,317,317
Mariposa,57,2023-01-16,4,4,4,0,94,97,96,1,0,0,0,0,30,30,30,30
Mendocino,57,2023-01-16,23,23,23,0,498,516,515,1,6,0,0,0,142,142,142,142
Merced,57,2023-01-16,113,118,118,0,1642,1701,1700,1,12,3,7,5,901,906,898,899
Modoc,57,2023-01-16,2,2,2,0,9,10,9,1,0,0,0,0,9,9,9,9
Mono,57,2023-01-16,6,6,6,0,68,70,69,1,0,0,0,0,8,8,8,8
Monterey,57,2023-01-16,108,113,113,0,2593,2685,2684,1,20,1,2,2,790,791,789,789
Napa,57,2023-01-16,61,61,61,0,1506,1560,1559,1,5,0,0,0,161,161,161,161
Nevada,57,2023-01-16,24,24,24,0,561,581,580,1,4,0,0,0,132,132,132,132
Orange,57,2023-01-16,1425,1474,1474,0,23139,23940,23939,1,245,10,19,32,7806,7838,7796,7819
Placer,57,2023-01-16,163,169,169,0,2626,2720,2719,1,68,0,0,6,678,678,678,678
Plumas,57,2023-01-16,1,1,1,0,70,73,72,1,1,0,0,0,14,14,14,14
Riverside,57,2023-01-16,1212,1253,1253,0,16615,17191,17190,1,169,0,0,36,6753,6757,6753,6757
Sacramento,57,2023-01-16,568,587,587,0,12343,12772,12771,1,149,9,16,23,3472,3489,3463,3473
San Benito,57,2023-01-16,25,25,25,0,465,482,481,1,0,0,0,0,109,109,109,109
San Bernardino,57,2023-01-16,946,979,979,0,16430,17003,17002,1,148,2,4,35,8130,8135,8128,8131
San Diego,57,2023-01-16,2054,2126,2126,0,27770,28729,28728,1,327,10,19,39,5717,5741,5707,5722
San Francisco,57,2023-01-16,433,449,449,0,9976,10322,10321,1,75,0,0,12,1152,1158,1152,1158
San Joaquin,57,2023-01-16,353,365,365,0,8737,9044,9043,1,42,0,0,11,2394,2395,2394,2395
San Luis Obispo,57,2023-01-16,96,100,100,0,1772,1835,1834,1,12,0,0,3,549,549,549,549
San Mateo,57,2023-01-16,376,389,389,0,7572,7834,7833,1,37,0,0,3,738,738,738,738
Santa Barbara,57,2023-01-16,231,240,240,0,3896,4033,4032,1,34,1,2,0,754,756,753,754
Santa Clara,57,2023-01-16,1089,1126,1126,0,23350,24144,24143,1,106,8,17,16,2654,2672,2646,2655
Santa Cruz,57,2023-01-16,164,170,170,0,5867,6066,6065,1,23,0,0,1,276,276,276,276
Shasta,57,2023-01-16,40,40,40,0,670,693,692,1,13,2,5,2,599,602,597,597
Siskiyou,57,2023-01-16,6,6,6,0,208,216,215,1,0,0,0,0,95,95,95,95
Solano,57,2023-01-16,221,228,228,0,3703,3832,3831,1,49,0,0,6,474,474,474,474
Sonoma,57,2023-01-16,179,185,185,0,3694,3823,3822,1,26,1,2,2,544,545,543,543
Stanislaus,57,2023-01-16,200,207,207,0,4197,4345,4344,1,72,0,0,3,1823,1823,1823,1823
Sutter,57,2023-01-16,47,47,47,0,713,738,737,1,0,0,0,0,234,234,234,234
Tehama,57,2023-01-16,14,14,14,0,319,330,329,1,1,0,0,0,221,221,221,221
Trinity,57,2023-01-16,3,3,3,0,23,24,23,1,0,0,0,0,22,22,22,22
Tulare,57,2023-01-16,261,270,270,0,4051,4196,4195,1,45,0,0,2,1561,1562,1561,1562
Tuolumne,57,2023-01-16,42,42,42,0,545,566,565,1,1,0,0,0,202,202,202,202
Ventura,57,2023-01-16,393,405,405,0,7421,7678,7677,1,53,3,7,12,1654,1663,1651,1656
Yolo,57,2023-01-16,71,72,72,0,1246,1291,1290,1,2,1,2,0,435,436,434,434
Yuba,57,2023-01-16,37,37,37,0,595,617,616,1,9,0,0,2,122,122,122,122
Alameda,58,2023-01-23,718,765,765,0,20839,22175,22174,1,100,3,11,9,2152,2172,2149,2161
Amador,58,2023-01-23,32,33,33,0,589,628,627,1,1,0,0,0,98,98,98,98
Butte,58,2023-01-23,43,45,45,0,1079,1149,1148,1,13,0,0,0,486,491,486,491
Calaveras,58,2023-01-23,13,13,13,0,277,295,294,1,0,0,0,0,140,140,140,140
Colusa,58,2023-01-23,10,10,10,0,142,156,155,1,0,0,0,0,22,22,22,22
Contra Costa,58,2023-01-23,495,529,529,0,13076,13917,13916,1,61,0,0,6,1518,1518,1518,1518
Del Norte,58,2023-01-23,16,16,16,0,328,351,350,1,1,0,0,0,57,58,57,58
El Dorado,58,2023-01-23,36,37,37,0,1075,1149,1148,1,2,0,0,0,239,239,239,239
Fresno,58,2023-01-23,422,451,451,0,10033,10692,10691,1,117,0,0,19,2966,2974,2966,2974
Glenn,58,2023-01-23,3,3,3,0,153,168,167,1,0,0,0,0,53,53,53,53
Humboldt,58,2023-01-23,26,26,26,0,516,551,550,1,9,1,5,4,169,175,168,170
Imperial,58,2023-01-23,78,83,83,0,2250,2395,2394,1,10,0,0,1,974,974,974,974
Inyo,58,2023-01-23,4,4,4,0,164,175,174,1,0,1,3,0,63,65,62,62
Kern,58,2023-01-23,293,313,313,0,9093,9682,9681,1,34,1,3,8,2465,2472,2464,2469
Kings,58,2023-01-23,105,112,112,0,1974,2101,2100,1,6,0,0,0,470,470,470,470
Lake,58,2023-01-23,26,26,26,0,578,618,617,1,2,0,0,2,150,150,150,150
Lassen,58,2023-01-23,5,5,5,0,463,494,493,1,0,0,0,0,64,64,64,64
Los Angeles,58,2023-01-23,5181,5519,5519,0,161415,171736,171734,2,665,47,214,96,35001,35397,34954,35183
Madera,58,2023-01-23,45,47,47,0,1428,1521,1520,1,6,0,0,2,375,375,375,375
Marin,58,2023-01-23,107,114,114,0,2341,2493,2492,1,18,0,0,3,317,317,317,317
Mariposa,58,2023-01-23,5,5,5,0,98,107,106,1,0,0,0,0,30,30,30,30
Mendocino,58,2023-01-23,18,19,19,0,544,580,579,1,4,0,0,0,142,142,142,142
Merced,58,2023-01-23,110,119,119,0,1813,1936,1935,1,9,2,9,3,903,915,901,906
Modoc,58,2023-01-23,1,1,1,0,11,12,11,1,1,0,0,0,9,9,9,9
Mono,58,2023-01-23,5,5,5,0,71,77,76,1,0,0,0,0,8,8,8,8
Monterey,58,2023-01-23,89,96,96,0,2748,2932,2931,1,15,0,0,2,790,791,790,791
Napa,58,2023-01-23,76,82,82,0,1505,1604,1603,1,4,0,0,1,161,161,161,161
Nevada,58,2023-01-23,17,17,17,0,588,627,626,1,3,0,0,2,132,132,132,132
Orange,58,2023-01-23,1140,1214,1214,0,23098,24583,24582,1,177,0,0,27,7806,7838,7806,7838
Placer,58,2023-01-23,138,146,146,0,2711,2892,2891,1,42,1,3,7,679,681,678,678
Plumas,58,2023-01-23,5,5,5,0,90,98,97,1,1,0,0,0,14,14,14,14
Riverside,58,2023-01-23,971,1034,1034,0,15740,16757,16756,1,111,0,0,22,6753,6757,6753,6757
Sacramento,58,2023-01-23,582,621,621,0,13619,14520,14519,1,134,5,20,21,3477,3509,3472,3489
San Benito,58,2023-01-23,23,24,24,0,561,601,600,1,0,0,0,0,109,109,109,109
San Bernardino,58,2023-01-23,980,1044,1044,0,18336,19514,19513,1,127,1,3,33,8131,8138,8130,8135
San Diego,58,2023-01-23,1975,2104,2104,0,31390,33445,33444,1,236,7,34,37,5724,5775,5717,5741
San Francisco,58,2023-01-23,441,472,472,0,11204,11928,11927,1,58,0,0,5,1152,1158,1152,1158
San Joaquin,58,2023-01-23,238,253,253,0,8377,8934,8933,1,29,0,0,8,2394,2395,2394,2395
San Luis Obispo,58,2023-01-23,98,105,105,0,1927,2052,2051,1,8,0,0,2,549,549,549,549
San Mateo,58,2023-01-23,336,359,359,0,8623,9188,9187,1,21,0,0,0,738,738,738,738
Santa Barbara,58,2023-01-23,192,205,205,0,4174,4446,4445,1,28,2,10,4,756,766,754,756
Santa Clara,58,2023-01-23,1001,1067,1067,0,24211,25757,25756,1,119,1,4,23,2655,2676,2654,2672
Santa Cruz,58,2023-01-23,115,124,124,0,9395,10027,10026,1,16,1,6,0,277,282,276,276
Shasta,58,2023-01-23,24,24,24,0,744,792,791,1,6,0,0,1,599,602,599,602
Siskiyou,58,2023-01-23,6,6,6,0,176,189,188,1,0,0,0,0,95,95,95,95
Solano,58,2023-01-23,223,238,238,0,4197,4468,4467,1,33,0,0,2,474,474,474,474
Sonoma,58,2023-01-23,194,207,207,0,4271,4550,4549,1,26,0,0,4,544,545,544,545
Stanislaus,58,2023-01-23,182,195,195,0,4222,4496,4495,1,57,0,0,6,1823,1823,1823,1823
Sutter,58,2023-01-23,36,37,37,0,778,827,826,1,0,0,0,0,234,234,234,234
Tehama,58,2023-01-23,13,13,13,0,290,311,310,1,1,0,0,0,221,221,221,221
Trinity,58,2023-01-23,3,3,3,0,28,29,28,1,0,0,0,0,22,22,22,22
Tulare,58,2023-01-23,209,223,223,0,4047,4317,4316,1,27,0,0,5,1561,1562,1561,1562
Tuolumne,58,2023-01-23,36,37,37,0,484,515,514,1,0,0,0,1,202,202,202,202
Ventura,58,2023-01-23,346,369,369,0,7973,8485,8484,1,57,2,10,3,1656,1673,1654,1663
Yolo,58,2023-01-23,80,87,87,0,1353,1442,1441,1,2,0,0,0,435,436,435,436
Yuba,58,2023-01-23,27,27,27,0,724,773,772,1,3,0,0,0,122,122,122,122
Alameda,59,2023-01-30,686,2319,2319,0,13382,18788,18787,1,85,1,9,4,2153,2181,2152,2172
Amador,59,2023-01-30,19,40,40,0,455,628,627,1,3,0,0,0,98,98,98,98
Butte,59,2023-01-30,42,119,119,0,819,1196,1195,1,13,0,0,2,486,491,486,491
Calaveras,59,2023-01-30,11,44,44,0,231,334,333,1,0,0,0,0,140,140,140,140
Colusa,59,2023-01-30,3,3,3,0,98,128,127,1,0,0,0,0,22,22,22,22
Contra Costa,59,2023-01-30,506,1563,1563,0,9187,13013,13012,1,38,0,0,6,1518,1518,1518,1518
Del Norte,59,2023-01-30,15,59,59,0,248,347,346,1,1,0,0,0,57,58,57,58
El Dorado,59,2023-01-30,42,131,131,0,863,1272,1271,1,4,0,0,0,239,239,239,239
Fresno,59,2023-01-30,348,845,845,0,6568,9222,9221,1,117,0,0,10,2966,2974,2966,2974
Glenn,59,2023-01-30,1,4,4,0,66,93,92,1,0,0,0,0,53,53,53,53
Humboldt,59,2023-01-30,14,35,35,0,377,562,561,1,6,0,0,1,169,175,169,175
Imperial,59,2023-01-30,71,242,242,0,1472,1984,1983,1,7,0,0,0,974,974,974,974
Inyo,59,2023-01-30,8,23,23,0,98,153,152,1,1,0,0,0,63,65,63,65
Kern,59,2023-01-30,230,495,495,0,5512,7325,7324,1,36,0,0,8,2465,2472,2465,2472
Kings,59,2023-01-30,113,323,323,0,1566,2106,2105,1,7,0,0,1,470,470,470,470
Lake,59,2023-01-30,22,60,60,0,422,596,595,1,5,0,0,1,150,150,150,150
Lassen,59,2023-01-30,4,4,4,0,336,424,423,1,0,0,0,0,64,64,64,64
Los Angeles,59,2023-01-30,3296,5508,5508,0,86312,109557,109556,1,633,35,552,72,35036,35949,35001,35397
Madera,59,2023-01-30,24,37,37,0,978,1306,1305,1,7,0,0,0,375,375,375,375
Marin,59,2023-01-30,79,276,276,0,1615,2254,2253,1,19,0,0,1,317,317,317,317
Mariposa,59,2023-01-30,2,2,2,0,72,98,97,1,0,0,0,0,30,30,30,30
Mendocino,59,2023-01-30,18,78,78,0,385,541,540,1,2,0,0,1,142,142,142,142
Merced,59,2023-01-30,83,212,212,0,1023,1451,1450,1,11,0,0,3,903,915,903,915
Modoc,59,2023-01-30,0,0,0,0,6,12,11,1,1,0,0,0,9,9,9,9
Mono,59,2023-01-30,1,1,1,0,46,66,65,1,0,0,0,0,8,8,8,8
Monterey,59,2023-01-30,96,337,337,0,2035,2897,2896,1,8,0,0,1,790,791,790,791
Napa,59,2023-01-30,59,210,210,0,970,1344,1343,1,4,0,0,0,161,161,161,161
Nevada,59,2023-01-30,16,26,26,0,339,457,456,1,2,0,0,1,132,132,132,132
Orange,59,2023-01-30,966,2234,2234,0,14639,20372,20371,1,136,0,0,25,7806,7838,7806,7838
Placer,59,2023-01-30,131,349,349,0,1902,2857,2856,1,49,0,0,3,679,681,679,681
Plumas,59,2023-01-30,2,2,2,0,55,79,78,1,0,0,0,0,14,14,14,14
Riverside,59,2023-01-30,663,1370,1370,0,9892,13406,13405,1,84,1,11,17,6754,6768,6753,6757
Sacramento,59,2023-01-30,543,1633,1633,0,9145,12974,12973,1,117,2,18,13,3479,3527,3477,3509
San Benito,59,2023-01-30,24,102,102,0,412,625,624,1,0,0,0,0,109,109,109,109
San Bernardino,59,2023-01-30,599,1286,1286,0,9883,13627,13626,1,140,0,0,19,8131,8138,8131,8138
San Diego,59,2023-01-30,1501,3350,3350,0,20863,28213,28212,1,202,4,49,32,5728,5824,5724,5775
San Francisco,59,2023-01-30,357,1018,1018,0,7659,10698,10697,1,51,0,0,4,1152,1158,1152,1158
San Joaquin,59,2023-01-30,243,824,824,0,5188,7229,7228,1,22,0,0,5,2394,2395,2394,2395
San Luis Obispo,59,2023-01-30,88,258,258,0,1167,1627,1626,1,13,0,0,0,549,549,549,549
San Mateo,59,2023-01-30,319,858,858,0,5923,8080,8079,1,25,0,0,3,738,738,738,738
Santa Barbara,59,2023-01-30,165,505,505,0,2987,4353,4352,1,25,1,11,2,757,777,756,766
Santa Clara,59,2023-01-30,898,2467,2467,0,15975,22134,22133,1,132,0,0,14,2655,2676,2655,2676
Santa Cruz,59,2023-01-30,69,187,187,0,6067,7712,7711,1,12,0,0,0,277,282,277,282
Shasta,59,2023-01-30,10,13,13,0,348,456,455,1,7,0,0,0,599,602,599,602
Siskiyou,59,2023-01-30,0,0,0,0,130,201,200,1,0,0,0,0,95,95,95,95
Solano,59,2023-01-30,214,781,781,0,3044,4250,4249,1,40,0,0,1,474,474,474,474
Sonoma,59,2023-01-30,126,365,365,0,2754,4054,4053,1,23,0,0,1,544,545,544,545
Stanislaus,59,2023-01-30,178,540,540,0,3116,4543,4542,1,43,0,0,3,1823,1823,1823,1823
Sutter,59,2023-01-30,32,155,155,0,460,666,665,1,0,0,0,0,234,234,234,234
Tehama,59,2023-01-30,8,23,23,0,124,162,161,1,1,0,0,0,221,221,221,221
Trinity,59,2023-01-30,6,89,89,0,19,32,31,1,0,0,0,0,22,22,22,22
Tulare,59,2023-01-30,177,559,559,0,2586,3404,3403,1,28,0,0,3,1561,1562,1561,1562
Tuolumne,59,2023-01-30,34,88,88,0,422,585,584,1,3,0,0,0,202,202,202,202
Ventura,59,2023-01-30,267,709,709,0,5169,7236,7235,1,46,1,14,8,1657,1687,1656,1673
Yolo,59,2023-01-30,63,150,150,0,870,1236,1235,1,2,0,0,0,435,436,435,436
Yuba,59,2023-01-30,29,88,88,0,512,779,778,1,3,0,0,1,122,122,122,122
California,1,2021-12-20,84256,84257,47167,37090,2163343,2163503,1234434,929069,2585,503,503,932,77351,77351,76848,76848
California,2,2021-12-27,241797,241809,151843,89966,1954173,1954348,1192625,761723,3348,496,496,1030,77847,77847,77351,77351
California,3,2022-01-03,549352,549402,369172,180230,2956280,2956613,1966599,990014,6125,589,589,1280,78436,78436,77847,77847
California,4,2022-01-10,866654,866742,619546,247196,4666194,4666772,3354021,1312751,10002,945,945,1813,79381,79381,78436,78436
California,5,2022-01-17,661216,661290,492779,168511,3983953,3984524,3022538,961986,12343,1430,1430,2311,80811,80811,79381,79381
California,6,2022-01-24,527086,527165,412414,114751,3988993,3989763,3193936,795827,12648,1776,1776,2600,82587,82587,80811,80811
California,7,2022-01-31,270260,270303,219688,50615,3154915,3155675,2636637,519038,10873,1906,1906,2494,84493,84493,82587,82587
California,8,2022-02-07,149248,149267,125745,23522,2670348,2671173,2318882,352291,8405,1777,1777,2007,86270,86270,84493,84493
California,9,2022-02-14,85786,85801,74791,11010,2322936,2323892,2080593,243299,6407,1427,1427,1564,87697,87697,86270,86270
California,10,2022-02-21,48044,48050,43029,5021,1850820,1851759,1692920,158839,4557,1003,1003,1098,88700,88700,87697,87697
California,11,2022-02-28,32661,32666,29956,2710,2098729,2099967,1962958,137009,3357,695,695,772,89395,89395,88700,88700
California,12,2022-03-07,22976,22980,21472,1508,1818373,1819616,1725045,94571,2435,500,500,581,89895,89895,89395,89395
California,13,2022-03-14,16957,16960,16082,878,1725463,1726755,1656364,70391,1844,358,358,419,90253,90253,89895,89895
California,14,2022-03-21,14637,14642,14059,583,1646437,1647804,1595055,52749,1537,252,252,313,90505,90505,90253,90253
California,15,2022-03-28,15456,15461,14983,478,1463324,1464689,1427052,37637,1150,178,178,264,90683,90683,90505,90505
California,16,2022-04-04,17674,17681,17266,415,1525054,1526628,1497070,29558,943,141,141,211,90824,90824,90683,90683
California,17,2022-04-11,21494,21502,21109,393,1343318,1344786,1323919,20867,905,124,124,148,90948,90948,90824,90824
California,18,2022-04-18,26857,26867,26477,390,1131707,1133018,1118108,14910,823,110,110,141,91058,91058,90948,90948
California,19,2022-04-25,37218,37244,36816,428,1622641,1624606,1609736,14870,838,91,91,112,91149,91149,91058,91058
California,20,2022-05-02,48899,48943,48508,435,1701796,1703921,1691676,12245,950,85,85,143,91234,91234,91149,91149
California,21,2022-05-09,63311,63374,62929,445,1770509,1772797,1762751,10046,1050,86,86,153,91320,91320,91234,91234
California,22,2022-05-16,80268,80356,79905,451,1840045,1842486,1834228,8258,1345,118,118,182,91438,91438,91320,91320
California,23,2022-05-23,97732,97842,97423,419,1870112,1872677,1866076,6601,1714,117,117,217,91555,91555,91438,91438
California,24,2022-05-30,90426,90532,90223,309,1498738,1500893,1496637,4256,1918,150,150,272,91705,91705,91555,91555
California,25,2022-06-06,120629,120786,120468,318,1939005,1941925,1937825,4100,2305,138,138,276,91843,91843,91705,91705
California,26,2022-06-13,105207,105346,105129,217,1406594,1408780,1406296,2484,2471,178,178,291,92021,92021,91843,91843
California,27,2022-06-20,101298,101437,101275,162,1026767,1028419,1026826,1593,2552,211,211,310,92232,92232,92021,92021
California,28,2022-06-27,115440,115605,115467,138,1043825,1045547,1044295,1252,3006,218,218,339,92450,92450,92232,92232
California,29,2022-07-04,108218,108378,108276,102,836742,838159,837353,806,3167,272,272,393,92722,92722,92450,92450
California,30,2022-07-11,141229,141451,141352,99,1082386,1084266,1083475,791,3824,295,295,453,93017,93017,92722,92722
California,31,2022-07-18,129635,129841,129768,73,992892,994672,994107,565,4148,295,295,528,93312,93312,93017,93017
California,32,2022-07-25,117537,117734,117686,48,947877,949652,949228,424,4310,358,358,516,93670,93670,93312,93312
California,33,2022-08-01,99147,99316,99283,33,874586,876318,876006,312,4119,359,359,535,94029,94029,93670,93670
California,34,2022-08-08,83014,83162,83143,19,819373,821066,820835,231,3754,327,327,474,94356,94356,94029,94029
California,35,2022-08-15,68687,68814,68802,12,789208,790928,790746,182,3363,296,296,448,94652,94652,94356,94356
California,36,2022-08-22,61076,61191,61185,6,773272,775047,774901,146,3087,283,283,418,94935,94935,94652,94652
California,37,2022-08-29,51486,51579,51576,3,763000,764840,764719,121,2752,217,217,351,95152,95152,94935,94935
California,38,2022-09-05,36429,36494,36494,0,625679,627265,627177,88,2525,244,244,350,95396,95396,95152,95152
California,39,2022-09-12,36165,36238,36238,0,749905,751949,751865,84,2422,222,222,346,95618,95618,95396,95396
California,40,2022-09-19,27563,27623,27623,0,684814,686839,686768,71,2041,180,180,272,95798,95798,95618,95618
California,41,2022-09-26,25283,25342,25342,0,636785,638802,638739,63,1818,166,166,230,95964,95964,95798,95798
California,42,2022-10-03,23275,23336,23336,0,583462,585519,585459,60,1647,147,147,247,96111,96111,95964,95964
California,43,2022-10-10,23318,23385,23385,0,623562,626086,626028,58,1537,153,153,228,96246,96246,96093,96093
California,44,2022-10-17,18589,18649,18649,0,520062,522373,522316,57,1397,116,116,218,96362,96362,96246,96246
California,45,2022-10-24,18454,18525,18525,0,510706,513232,513175,57,1324,115,115,190,96477,96477,96362,96362
California,46,2022-10-31,20567,20653,20653,0,520036,522814,522757,57,1401,113,113,191,96590,96590,96477,96477
California,47,2022-11-07,26688,26821,26821,0,544023,547366,547309,57,1525,131,131,231,96721,96721,96590,96590
California,48,2022-11-14,30565,30760,30760,0,545085,549027,548970,57,1775,108,108,260,96829,96829,96721,96721
California,49,2022-11-21,39894,40208,40208,0,567469,572219,572162,57,2268,147,151,330,96976,96980,96829,96829
California,50,2022-11-28,53906,54417,54417,0,505066,510077,510020,57,3153,195,200,379,97171,97180,96976,96980
California,51,2022-12-05,65494,66201,66201,0,636687,643845,643787,58,3715,235,243,493,97406,97423,97171,97180
California,52,2022-12-12,56094,56786,56786,0,598066,605637,605580,57,3944,330,351,527,97736,97774,97406,97423
California,53,2022-12-19,50185,50882,50882,0,552271,560224,560167,57,3997,308,329,523,98044,98103,97736,97774
California,54,2022-12-26,44828,45533,45533,0,407397,414115,414059,56,3906,370,417,510,98414,98520,98044,98103
California,55,2023-01-02,44491,45343,45343,0,409571,417621,417564,57,4077,298,359,528,98712,98879,98414,98520
California,56,2023-01-09,32973,33774,33774,0,487900,500200,500143,57,3672,229,316,487,98941,99195,98712,98879
California,57,2023-01-16,19882,20554,20554,0,400850,414734,414677,57,3075,140,278,425,99081,99473,98941,99195
California,58,2023-01-23,17593,18738,18738,0,437934,466257,466200,57,2400,75,335,369,99156,99808,99081,99473
California,59,2023-01-30,13521,32999,32999,0,266792,359744,359688,56,2214,45,664,266,99201,100472,99156,99808
