county,time,date,cases,est_cases,est_omicron_cases,est_other_cases,tests,est_tests,est_omicron_tests,est_other_tests,hospitalizations,deaths,est_deaths,icu,cum_deaths,cum_est_deaths,prev_cum_deaths,prev_cum_est_deaths
Alameda,1,2021-12-20,2982,2982,1419,1563,89767,89767,41917,47850,47,9,9,14,1549,1549,1540,1540
Amador,1,2021-12-20,49,49,18,31,1716,1716,602,1114,2,0,0,3,70,70,70,70
Butte,1,2021-12-20,193,193,101,92,4385,4385,2285,2100,24,5,5,1,359,359,354,354
Calaveras,1,2021-12-20,59,59,23,36,1520,1520,582,938,1,2,2,0,92,92,90,90
Colusa,1,2021-12-20,11,11,5,6,397,397,170,227,1,0,0,0,21,21,21,21
Contra Costa,1,2021-12-20,1685,1685,590,1095,43224,43224,14846,28378,27,4,4,7,1080,1080,1076,1076
Del Norte,1,2021-12-20,19,19,8,11,1378,1378,570,808,0,0,0,0,42,42,42,42
El Dorado,1,2021-12-20,238,238,93,145,4466,4466,1729,2737,4,4,4,3,179,179,175,175
Fresno,1,2021-12-20,1057,1057,380,677,24956,24956,8882,16074,131,19,19,45,2419,2419,2400,2400
Glenn,1,2021-12-20,20,20,8,12,462,462,185,277,0,0,0,0,41,41,41,41
Humboldt,1,2021-12-20,164,164,67,97,3772,3772,1529,2243,11,1,1,2,121,121,120,120
Imperial,1,2021-12-20,584,584,225,359,5526,5526,2105,3421,40,9,9,27,817,817,808,808
Inyo,1,2021-12-20,31,31,14,17,358,358,154,204,1,1,1,0,49,49,48,48
Kern,1,2021-12-20,927,927,401,526,26093,26093,11160,14933,84,24,24,27,2023,2023,1999,1999
Kings,1,2021-12-20,244,244,94,150,6912,6912,2638,4274,15,6,6,3,389,389,383,383
Lake,1,2021-12-20,37,37,13,24,1317,1317,464,853,0,0,0,0,116,116,116,116
Lassen,1,2021-12-20,11,11,5,6,2387,2387,1093,1294,0,0,0,0,54,54,54,54
Los Angeles,1,2021-12-20,31634,31634,22012,9622,985583,985603,676246,309357,574,107,107,174,27373,27373,27266,27266
Madera,1,2021-12-20,159,159,56,103,6014,6014,2122,3892,9,3,3,5,334,334,331,331
Marin,1,2021-12-20,566,566,210,356,11810,11810,4294,7516,5,1,1,1,256,256,255,255
Mariposa,1,2021-12-20,21,21,7,14,448,448,154,294,0,0,0,0,21,21,21,21
Mendocino,1,2021-12-20,91,91,27,64,2687,2687,789,1898,3,2,2,4,103,103,101,101
Merced,1,2021-12-20,323,323,138,185,5616,5616,2366,3250,11,6,6,12,693,693,687,687
Modoc,1,2021-12-20,5,5,2,3,67,67,30,37,2,0,0,0,6,6,6,6
Mono,1,2021-12-20,37,37,10,27,313,313,81,232,1,0,0,0,4,4,4,4
Monterey,1,2021-12-20,481,481,126,355,13259,13259,3421,9838,23,3,3,8,642,642,639,639
Napa,1,2021-12-20,229,229,106,123,5390,5390,2432,2958,2,1,1,2,108,108,107,107
Nevada,1,2021-12-20,161,161,58,103,2764,2764,999,1765,4,1,1,2,110,110,109,109
Orange,1,2021-12-20,4865,4865,2404,2461,99380,99380,48406,50974,132,34,34,56,6021,6021,5987,5987
Placer,1,2021-12-20,555,555,190,365,11155,11155,3769,7386,53,6,6,24,501,501,495,495
Plumas,1,2021-12-20,16,16,6,10,513,513,195,318,0,0,0,0,12,12,12,12
Riverside,1,2021-12-20,5610,5610,2352,3258,78332,78332,32448,45884,238,40,40,82,5579,5579,5539,5539
Sacramento,1,2021-12-20,2147,2147,857,1290,53572,53572,21166,32406,101,21,21,41,2490,2490,2469,2469
San Benito,1,2021-12-20,91,91,41,50,1928,1928,860,1068,2,3,3,2,81,81,78,78
San Bernardino,1,2021-12-20,5012,5012,2369,2643,79700,79700,37182,42518,299,66,66,112,6511,6511,6445,6445
San Diego,1,2021-12-20,8682,8682,5934,2748,149629,149630,101537,48093,249,29,29,94,4479,4479,4450,4450
San Francisco,1,2021-12-20,2989,2989,741,2248,57003,57003,13806,43197,28,3,3,10,693,693,690,690
San Joaquin,1,2021-12-20,952,952,359,593,25321,25321,9391,15930,48,13,13,27,1972,1972,1959,1959
San Luis Obispo,1,2021-12-20,426,426,187,239,9993,9993,4349,5644,11,3,3,6,371,371,368,368
San Mateo,1,2021-12-20,1560,1560,771,789,50631,50631,24529,26102,9,0,0,5,601,601,601,601
Santa Barbara,1,2021-12-20,789,789,326,463,15818,15818,6434,9384,18,8,8,12,570,570,562,562
Santa Clara,1,2021-12-20,2948,2948,1981,967,118952,118952,78834,40118,85,8,8,38,1978,1978,1970,1970
Santa Cruz,1,2021-12-20,404,404,182,222,19816,19816,8760,11056,11,2,2,5,230,230,228,228
Shasta,1,2021-12-20,163,163,65,98,6035,6035,2392,3643,28,8,8,8,448,448,440,440
Siskiyou,1,2021-12-20,20,20,9,11,449,449,207,242,2,2,2,2,63,63,61,61
Solano,1,2021-12-20,496,496,207,289,14746,14746,6067,8679,21,4,4,5,389,389,385,385
Sonoma,1,2021-12-20,754,754,320,434,20779,20779,8668,12111,22,1,1,6,420,420,419,419
Stanislaus,1,2021-12-20,670,670,210,460,13019,13019,4035,8984,90,13,13,22,1432,1432,1419,1419
Sutter,1,2021-12-20,123,123,51,72,2315,2315,947,1368,0,2,2,0,193,193,191,191
Tehama,1,2021-12-20,52,52,17,35,1324,1324,425,899,4,0,0,3,165,165,165,165
Trinity,1,2021-12-20,1,1,0,1,98,98,31,67,0,1,1,0,19,19,18,18
Tulare,1,2021-12-20,404,404,125,279,12352,12352,3799,8553,36,19,19,13,1307,1307,1288,1288
Tuolumne,1,2021-12-20,97,97,35,62,1940,1940,693,1247,7,0,0,0,150,150,150,150
Ventura,1,2021-12-20,2046,2046,1052,994,39239,39239,19902,19337,62,9,9,14,1216,1216,1207,1207
Yolo,1,2021-12-20,329,329,146,183,24698,24698,10820,13878,4,0,0,1,295,295,295,295
Yuba,1,2021-12-20,100,100,43,57,1874,1874,799,1075,3,0,0,4,102,102,102,102
Alameda,2,2021-12-27,7511,7511,4025,3486,87414,87415,46205,41210,89,12,12,19,1561,1561,1549,1549
Amador,2,2021-12-27,92,92,38,54,1445,1445,590,855,2,0,0,3,70,70,70,70
Butte,2,2021-12-27,540,540,318,222,4551,4551,2662,1889,37,3,3,3,362,362,359,359
Calaveras,2,2021-12-27,100,100,45,55,989,989,442,547,1,1,1,1,93,93,92,92
Colusa,2,2021-12-27,27,27,14,13,243,243,119,124,4,0,0,0,21,21,21,21
Contra Costa,2,2021-12-27,5141,5141,2106,3035,46333,46333,18594,27739,44,3,3,16,1083,1083,1080,1080
Del Norte,2,2021-12-27,25,25,12,13,1423,1423,679,744,0,0,0,1,42,42,42,42
El Dorado,2,2021-12-27,511,511,231,280,4083,4083,1815,2268,7,0,0,4,179,179,179,179
Fresno,2,2021-12-27,2210,2210,935,1275,23816,23816,9913,13903,122,16,16,41,2435,2435,2419,2419
Glenn,2,2021-12-27,53,53,24,29,451,451,207,244,0,1,1,0,42,42,41,41
Humboldt,2,2021-12-27,501,501,238,263,3456,3456,1617,1839,10,1,1,0,122,122,121,121
Imperial,2,2021-12-27,881,881,396,485,5897,5897,2611,3286,35,10,10,26,827,827,817,817
Inyo,2,2021-12-27,109,109,54,55,447,447,219,228,0,1,1,0,50,50,49,49
Kern,2,2021-12-27,1988,1988,996,992,22592,22592,11165,11427,79,18,18,36,2041,2041,2023,2023
Kings,2,2021-12-27,506,506,229,277,5481,5481,2433,3048,17,1,1,3,390,390,389,389
Lake,2,2021-12-27,67,67,28,39,1203,1203,495,708,0,1,1,0,117,117,116,116
Lassen,2,2021-12-27,21,21,11,10,2242,2242,1160,1082,0,0,0,0,54,54,54,54
Los Angeles,2,2021-12-27,96141,96142,71604,24538,717704,717724,530955,186769,862,115,115,207,27488,27488,27373,27373
Madera,2,2021-12-27,341,341,144,197,4209,4209,1747,2462,9,2,2,4,336,336,334,334
Marin,2,2021-12-27,1607,1607,688,919,16774,16774,7084,9690,3,0,0,1,256,256,256,256
Mariposa,2,2021-12-27,36,36,15,21,493,493,195,298,0,0,0,0,21,21,21,21
Mendocino,2,2021-12-27,152,152,55,97,2496,2496,862,1634,5,0,0,2,103,103,103,103
Merced,2,2021-12-27,653,653,322,331,5100,5100,2471,2629,11,7,7,10,700,700,693,693
Modoc,2,2021-12-27,3,3,1,2,38,38,19,19,1,0,0,0,6,6,6,6
Mono,2,2021-12-27,123,123,38,85,366,366,110,256,1,0,0,0,4,4,4,4
Monterey,2,2021-12-27,1009,1009,318,691,12882,12882,3971,8911,21,3,3,11,645,645,642,642
Napa,2,2021-12-27,809,809,422,387,6660,6660,3443,3217,6,0,0,1,108,108,108,108
Nevada,2,2021-12-27,236,236,100,136,1984,1984,815,1169,6,1,1,1,111,111,110,110
Orange,2,2021-12-27,18034,18034,10059,7975,130306,130310,71861,58449,256,31,31,66,6052,6052,6021,6021
Placer,2,2021-12-27,1251,1251,502,749,10769,10769,4261,6508,63,2,2,27,503,503,501,501
Plumas,2,2021-12-27,18,18,8,10,299,299,129,170,0,0,0,0,12,12,12,12
Riverside,2,2021-12-27,13684,13684,6601,7083,87498,87499,41713,45786,306,53,53,81,5632,5632,5579,5579
Sacramento,2,2021-12-27,5199,5199,2414,2785,52471,52471,23999,28472,135,22,22,44,2512,2512,2490,2490
San Benito,2,2021-12-27,318,318,163,155,2307,2307,1173,1134,1,3,3,3,84,84,81,81
San Bernardino,2,2021-12-27,14398,14398,7736,6662,87891,87892,46455,41437,341,69,69,141,6580,6580,6511,6511
San Diego,2,2021-12-27,27116,27116,19928,7188,177595,177600,129643,47957,315,34,34,96,4513,4513,4479,4479
San Francisco,2,2021-12-27,6858,6858,2010,4848,65931,65931,19043,46888,31,1,1,14,694,694,693,693
San Joaquin,2,2021-12-27,2353,2353,1038,1315,22767,22767,9880,12887,61,15,15,25,1987,1987,1972,1972
San Luis Obispo,2,2021-12-27,1153,1153,583,570,11182,11182,5563,5619,11,1,1,8,372,372,371,371
San Mateo,2,2021-12-27,5283,5283,2933,2350,55543,55543,30396,25147,19,2,2,5,603,603,601,601
Santa Barbara,2,2021-12-27,2142,2142,1022,1120,15278,15278,7172,8106,33,5,5,10,575,575,570,570
Santa Clara,2,2021-12-27,9052,9052,6551,2501,107055,107056,76805,30251,95,10,10,38,1988,1988,1978,1978
Santa Cruz,2,2021-12-27,946,946,489,457,12423,12423,6305,6118,11,0,0,2,230,230,230,230
Shasta,2,2021-12-27,263,263,123,140,4624,4624,2123,2501,32,5,5,12,453,453,448,448
Siskiyou,2,2021-12-27,21,21,11,10,360,360,190,170,0,0,0,0,63,63,63,63
Solano,2,2021-12-27,1301,1301,627,674,17043,17043,8085,8958,25,5,5,5,394,394,389,389
Sonoma,2,2021-12-27,1912,1912,933,979,21662,21662,10423,11239,19,1,1,5,421,421,420,420
Stanislaus,2,2021-12-27,1249,1249,468,781,11151,11151,4114,7037,94,17,17,18,1449,1449,1432,1432
Sutter,2,2021-12-27,226,226,108,118,2131,2131,1006,1125,0,2,2,0,195,195,193,193
Tehama,2,2021-12-27,103,103,40,63,1106,1106,419,687,6,2,2,3,167,167,165,165
Trinity,2,2021-12-27,4,4,2,2,101,101,37,64,0,0,0,0,19,19,19,19
Tulare,2,2021-12-27,815,815,301,514,11116,11116,4057,7059,36,10,10,9,1317,1317,1307,1307
Tuolumne,2,2021-12-27,171,171,72,99,1672,1672,692,980,5,0,0,1,150,150,150,150
Ventura,2,2021-12-27,5721,5721,3307,2414,39329,39329,22501,16828,66,8,8,19,1224,1224,1216,1216
Yolo,2,2021-12-27,818,818,417,401,22120,22120,11082,11038,7,1,1,4,296,296,295,295
Yuba,2,2021-12-27,164,164,81,83,1534,1534,749,785,8,1,1,4,103,103,102,102
Alameda,3,2022-01-03,17656,17656,10480,7176,117281,117285,69468,47817,156,5,5,31,1566,1566,1561,1561
Amador,3,2022-01-03,218,218,104,114,2179,2179,1029,1150,5,1,1,2,71,71,70,70
Butte,3,2022-01-03,1202,1202,778,424,6871,6871,4430,2441,32,0,0,4,362,362,362,362
Calaveras,3,2022-01-03,232,232,120,112,1305,1305,666,639,0,1,1,1,94,94,93,93
Colusa,3,2022-01-03,48,48,26,22,393,393,217,176,5,0,0,0,21,21,21,21
Contra Costa,3,2022-01-03,13520,13520,6289,7231,69127,69128,32071,37057,76,10,10,21,1093,1093,1083,1083
Del Norte,3,2022-01-03,86,86,47,39,2132,2132,1143,989,0,0,0,0,42,42,42,42
El Dorado,3,2022-01-03,1290,1290,660,630,6062,6062,3079,2983,7,4,4,6,183,183,179,179
Fresno,3,2022-01-03,6605,6605,3175,3430,38535,38535,18395,20140,175,14,14,44,2449,2449,2435,2435
Glenn,3,2022-01-03,78,78,40,38,610,610,318,292,0,1,1,0,43,43,42,42
Humboldt,3,2022-01-03,881,881,471,410,5295,5295,2810,2485,9,1,1,3,123,123,122,122
Imperial,3,2022-01-03,1878,1878,956,922,9136,9136,4613,4523,35,14,14,29,841,841,827,827
Inyo,3,2022-01-03,265,265,147,118,713,713,394,319,3,0,0,0,50,50,50,50
Kern,3,2022-01-03,5836,5836,3271,2565,35876,35876,19998,15878,100,16,16,32,2057,2057,2041,2041
Kings,3,2022-01-03,1096,1096,561,535,8511,8511,4310,4201,13,3,3,5,393,393,390,390
Lake,3,2022-01-03,220,220,106,114,1777,1777,847,930,1,0,0,1,117,117,117,117
Lassen,3,2022-01-03,61,61,35,26,3119,3119,1806,1313,2,0,0,0,54,54,54,54
Los Angeles,3,2022-01-03,204159,204166,160569,43597,1088044,1088081,856039,232042,1937,149,149,303,27637,27637,27488,27488
Madera,3,2022-01-03,831,831,398,433,6362,6362,3024,3338,17,3,3,6,339,339,336,336
Marin,3,2022-01-03,2363,2363,1148,1215,17674,17674,8532,9142,15,1,1,3,257,257,256,256
Mariposa,3,2022-01-03,103,103,48,55,657,657,304,353,0,0,0,0,21,21,21,21
Mendocino,3,2022-01-03,453,453,187,266,3572,3572,1454,2118,7,1,1,2,104,104,103,103
Merced,3,2022-01-03,1603,1603,882,721,8548,8548,4667,3881,3,9,9,4,709,709,700,700
Modoc,3,2022-01-03,15,15,8,7,59,59,33,26,0,0,0,0,6,6,6,6
Mono,3,2022-01-03,180,180,65,115,435,435,156,279,2,0,0,0,4,4,4,4
Monterey,3,2022-01-03,2465,2465,908,1557,20639,20639,7547,13092,30,4,4,10,649,649,645,645
Napa,3,2022-01-03,1856,1856,1076,780,11756,11756,6790,4966,9,1,1,3,109,109,108,108
Nevada,3,2022-01-03,647,647,314,333,3071,3071,1485,1586,7,1,1,3,112,112,111,111
Orange,3,2022-01-03,45473,45473,27786,17687,220203,220210,134352,85858,504,34,34,110,6086,6086,6052,6052
Placer,3,2022-01-03,2917,2917,1338,1579,15071,15071,6863,8208,113,15,15,24,518,518,503,503
Plumas,3,2022-01-03,55,55,28,27,496,496,248,248,1,0,0,0,12,12,12,12
Riverside,3,2022-01-03,32053,32053,17313,14740,138453,138457,74451,64006,564,54,54,94,5686,5686,5632,5632
Sacramento,3,2022-01-03,14148,14148,7388,6760,80499,80500,41835,38665,219,25,25,57,2537,2537,2512,2512
San Benito,3,2022-01-03,739,739,422,317,3464,3464,1976,1488,3,1,1,2,85,85,84,84
San Bernardino,3,2022-01-03,33862,33862,20029,13833,135046,135050,79600,55450,571,94,94,136,6674,6674,6580,6580
San Diego,3,2022-01-03,61103,61104,47468,13636,253655,253662,196958,56704,561,35,35,121,4548,4548,4513,4513
San Francisco,3,2022-01-03,11439,11439,3973,7466,85531,85533,29514,56019,78,5,5,22,699,699,694,694
San Joaquin,3,2022-01-03,6977,6977,3479,3498,36106,36106,17888,18218,80,13,13,27,2000,2000,1987,1987
San Luis Obispo,3,2022-01-03,2473,2473,1386,1087,15963,15963,8917,7046,24,5,5,7,377,377,372,372
San Mateo,3,2022-01-03,10628,10628,6507,4121,81980,81981,50096,31885,37,4,4,7,607,607,603,603
Santa Barbara,3,2022-01-03,5327,5327,2851,2476,28193,28193,15053,13140,53,5,5,7,580,580,575,575
Santa Clara,3,2022-01-03,23031,23031,17705,5326,170172,170179,130643,39536,186,10,10,58,1998,1998,1988,1988
Santa Cruz,3,2022-01-03,2410,2410,1388,1022,21662,21662,12485,9177,15,5,5,3,235,235,230,230
Shasta,3,2022-01-03,601,601,318,283,6174,6174,3228,2946,33,2,2,13,455,455,453,453
Siskiyou,3,2022-01-03,74,74,44,30,590,590,348,242,0,0,0,0,63,63,63,63
Solano,3,2022-01-03,4072,4072,2181,1891,26132,26132,13980,12152,54,3,3,9,397,397,394,394
Sonoma,3,2022-01-03,4541,4541,2480,2061,32186,32186,17528,14658,25,7,7,4,428,428,421,421
Stanislaus,3,2022-01-03,3333,3333,1436,1897,17985,17985,7689,10296,129,9,9,20,1458,1458,1449,1449
Sutter,3,2022-01-03,547,547,296,251,2980,2980,1594,1386,0,2,2,0,197,197,195,195
Tehama,3,2022-01-03,216,216,97,119,1474,1474,652,822,4,1,1,2,168,168,167,167
Trinity,3,2022-01-03,14,14,6,8,107,107,46,61,0,0,0,0,19,19,19,19
Tulare,3,2022-01-03,2143,2143,917,1226,16001,16001,6773,9228,57,5,5,7,1322,1322,1317,1317
Tuolumne,3,2022-01-03,383,383,186,197,2544,2544,1227,1317,7,3,3,0,153,153,150,150
Ventura,3,2022-01-03,12671,12671,7986,4685,59673,59674,37562,22112,136,11,11,28,1235,1235,1224,1224
Yolo,3,2022-01-03,2321,2321,1323,998,31706,31706,17935,13771,8,4,4,3,300,300,296,296
Yuba,3,2022-01-03,473,473,262,211,2331,2331,1284,1047,17,1,1,6,104,104,103,103
Alameda,4,2022-01-10,31210,31210,20220,10990,193863,193869,125729,68140,277,14,14,46,1580,1580,1566,1566
Amador,4,2022-01-10,391,391,209,182,2726,2726,1447,1279,4,0,0,4,71,71,71,71
Butte,4,2022-01-10,2000,2000,1395,605,10455,10455,7284,3171,55,2,2,4,364,364,362,362
Calaveras,4,2022-01-10,523,523,299,224,2607,2607,1479,1128,0,1,1,2,95,95,94,94
Colusa,4,2022-01-10,105,105,65,40,756,756,462,294,5,0,0,0,21,21,21,21
Contra Costa,4,2022-01-10,19745,19745,10341,9404,102253,102258,53546,48712,152,12,12,24,1105,1105,1093,1093
Del Norte,4,2022-01-10,177,177,106,71,3958,3958,2363,1595,2,0,0,0,42,42,42,42
El Dorado,4,2022-01-10,2214,2214,1260,954,9363,9363,5325,4038,14,6,6,2,189,189,183,183
Fresno,4,2022-01-10,14412,14412,7788,6624,59851,59851,32273,27578,301,14,14,47,2463,2463,2449,2449
Glenn,4,2022-01-10,219,219,127,92,938,938,544,394,2,0,0,0,43,43,43,43
Humboldt,4,2022-01-10,1401,1401,827,574,8355,8355,4924,3431,18,5,5,2,128,128,123,123
Imperial,4,2022-01-10,3622,3622,2047,1575,13829,13829,7797,6032,58,11,11,25,852,852,841,841
Inyo,4,2022-01-10,408,408,248,160,1356,1356,826,530,4,2,2,0,52,52,50,50
Kern,4,2022-01-10,11945,11945,7345,4600,57114,57115,35082,22033,181,26,26,35,2083,2083,2057,2057
Kings,4,2022-01-10,2412,2412,1380,1032,13012,13012,7401,5611,33,1,1,4,394,394,393,393
Lake,4,2022-01-10,499,499,268,231,2761,2761,1477,1284,0,3,3,1,120,120,117,117
Lassen,4,2022-01-10,196,196,126,70,3438,3438,2185,1253,1,0,0,0,54,54,54,54
Los Angeles,4,2022-01-10,329105,329117,270886,58231,1915111,1915185,1576862,338323,3253,270,270,513,27907,27907,27637,27637
Madera,4,2022-01-10,1915,1915,1030,885,10380,10380,5547,4833,19,1,1,6,340,340,339,339
Marin,4,2022-01-10,2941,2941,1602,1339,21011,21011,11437,9574,18,3,3,5,260,260,257,257
Mariposa,4,2022-01-10,199,199,105,94,1158,1158,607,551,0,1,1,0,22,22,21,21
Mendocino,4,2022-01-10,874,874,410,464,5538,5538,2581,2957,8,2,2,2,106,106,104,104
Merced,4,2022-01-10,3831,3831,2319,1512,14514,14514,8774,5740,33,10,10,11,719,719,709,709
Modoc,4,2022-01-10,13,13,8,5,109,109,67,42,0,0,0,0,6,6,6,6
Mono,4,2022-01-10,253,253,106,147,863,863,360,503,1,1,1,0,5,5,4,4
Monterey,4,2022-01-10,4982,4982,2118,2864,33232,33232,14051,19181,44,5,5,12,654,654,649,649
Napa,4,2022-01-10,2646,2646,1679,967,14352,14352,9103,5249,14,1,1,4,110,110,109,109
Nevada,4,2022-01-10,1189,1189,646,543,5233,5233,2839,2394,10,2,2,3,114,114,112,112
Orange,4,2022-01-10,60091,60091,39997,20094,317671,317683,211520,106163,854,100,100,159,6186,6186,6086,6086
Placer,4,2022-01-10,5196,5196,2692,2504,22555,22555,11665,10890,179,6,6,29,524,524,518,518
Plumas,4,2022-01-10,141,141,79,62,803,803,446,357,5,0,0,0,12,12,12,12
Riverside,4,2022-01-10,48268,48268,28857,19411,187761,187767,112221,75546,762,83,83,139,5769,5769,5686,5686
Sacramento,4,2022-01-10,27529,27529,15929,11600,121783,121788,70481,51307,375,37,37,89,2574,2574,2537,2537
San Benito,4,2022-01-10,1038,1038,654,384,4616,4616,2910,1706,3,1,1,2,86,86,85,85
San Bernardino,4,2022-01-10,50606,50606,32783,17823,192763,192769,124819,67950,784,113,113,187,6787,6787,6674,6674
San Diego,4,2022-01-10,82764,82768,67440,15328,330085,330097,269009,61088,895,66,66,166,4614,4614,4548,4548
San Francisco,4,2022-01-10,15095,15095,6034,9061,117288,117293,46958,70335,158,12,12,35,711,711,699,699
San Joaquin,4,2022-01-10,14515,14515,8088,6427,66806,66807,37164,29643,151,15,15,45,2015,2015,2000,2000
San Luis Obispo,4,2022-01-10,4337,4337,2676,1661,21621,21621,13356,8265,30,2,2,7,379,379,377,377
San Mateo,4,2022-01-10,15023,15023,10006,5017,113103,113108,75331,37777,95,5,5,16,612,612,607,607
Santa Barbara,4,2022-01-10,8537,8537,5053,3484,47382,47382,28051,19331,84,9,9,10,589,589,580,580
Santa Clara,4,2022-01-10,36504,36504,29459,7045,271164,271176,218790,52386,350,26,26,68,2024,2024,1998,1998
Santa Cruz,4,2022-01-10,4543,4543,2861,1682,42815,42815,26980,15835,25,2,2,2,237,237,235,235
Shasta,4,2022-01-10,1060,1060,619,441,8406,8406,4894,3512,37,7,7,12,462,462,455,455
Siskiyou,4,2022-01-10,120,120,77,43,919,919,591,328,3,1,1,1,64,64,63,63
Solano,4,2022-01-10,6923,6923,4125,2798,37116,37116,22126,14990,94,6,6,15,403,403,397,397
Sonoma,4,2022-01-10,8869,8869,5343,3526,47195,47195,28451,18744,72,9,9,8,437,437,428,428
Stanislaus,4,2022-01-10,6741,6741,3302,3439,29317,29317,14323,14994,173,13,13,19,1471,1471,1458,1458
Sutter,4,2022-01-10,1245,1245,743,502,5062,5062,3006,2056,0,2,2,0,199,199,197,197
Tehama,4,2022-01-10,513,513,257,256,2482,2482,1241,1241,13,1,1,1,169,169,168,168
Trinity,4,2022-01-10,38,38,19,19,275,275,135,140,0,0,0,0,19,19,19,19
Tulare,4,2022-01-10,5208,5208,2538,2670,24078,24078,11672,12406,66,9,9,8,1331,1331,1322,1322
Tuolumne,4,2022-01-10,806,806,436,370,4178,4178,2257,1921,13,1,1,1,154,154,153,153
Ventura,4,2022-01-10,17512,17512,11976,5536,88215,88220,60306,27914,227,23,23,34,1258,1258,1235,1235
Yolo,4,2022-01-10,3760,3760,2341,1419,48232,48232,29996,18236,6,4,4,1,304,304,300,300
Yuba,4,2022-01-10,1022,1022,624,398,4108,4108,2504,1604,41,0,0,7,104,104,104,104
Alameda,5,2022-01-17,24710,24710,17334,7376,170497,170504,119538,50966,366,33,33,62,1613,1613,1580,1580
Amador,5,2022-01-17,476,476,282,194,3557,3557,2081,1476,10,2,2,3,73,73,71,71
Butte,5,2022-01-17,2061,2061,1537,524,9327,9327,6949,2378,58,6,6,6,370,370,364,364
Calaveras,5,2022-01-17,564,564,353,211,2472,2472,1542,930,3,2,2,3,97,97,95,95
Colusa,5,2022-01-17,161,161,107,54,719,719,476,243,3,0,0,0,21,21,21,21
Contra Costa,5,2022-01-17,16224,16224,9473,6751,88038,88042,51322,36720,198,22,22,41,1127,1127,1105,1105
Del Norte,5,2022-01-17,200,200,131,69,3758,3758,2429,1329,2,0,0,1,42,42,42,42
El Dorado,5,2022-01-17,1967,1967,1229,738,8062,8062,5041,3021,9,4,4,2,193,193,189,189
Fresno,5,2022-01-17,18268,18268,10941,7327,65974,65977,39479,26498,386,27,27,61,2490,2490,2463,2463
Glenn,5,2022-01-17,306,306,194,112,1076,1076,683,393,3,2,2,0,45,45,43,43
Humboldt,5,2022-01-17,1144,1144,739,405,8323,8323,5365,2958,10,1,1,4,129,129,128,128
Imperial,5,2022-01-17,3414,3414,2123,1291,13220,13220,8218,5002,69,12,12,29,864,864,852,852
Inyo,5,2022-01-17,327,327,216,111,1040,1040,688,352,4,0,0,0,52,52,52,52
Kern,5,2022-01-17,11693,11693,7803,3890,51810,51811,34532,17279,242,29,29,44,2112,2112,2083,2083
Kings,5,2022-01-17,3200,3200,1999,1201,14866,14866,9258,5608,40,4,4,1,398,398,394,394
Lake,5,2022-01-17,583,583,348,235,3245,3245,1935,1310,2,1,1,2,121,121,120,120
Lassen,5,2022-01-17,284,284,196,88,3322,3322,2278,1044,0,0,0,0,54,54,54,54
Los Angeles,5,2022-01-17,218485,218496,186917,31579,1610421,1610492,1376797,233695,4034,504,504,680,28411,28411,27907,27907
Madera,5,2022-01-17,2400,2400,1431,969,10611,10611,6301,4310,32,5,5,10,345,345,340,340
Marin,5,2022-01-17,2421,2421,1461,960,17702,17702,10678,7024,38,4,4,6,264,264,260,260
Mariposa,5,2022-01-17,163,163,95,68,1115,1115,648,467,0,0,0,0,22,22,22,22
Mendocino,5,2022-01-17,922,922,487,435,5015,5015,2630,2385,18,3,3,2,109,109,106,106
Merced,5,2022-01-17,3970,3970,2618,1352,13639,13639,8989,4650,41,18,18,11,737,737,719,719
Modoc,5,2022-01-17,13,13,9,4,102,102,68,34,0,1,1,0,7,7,6,6
Mono,5,2022-01-17,198,198,94,104,809,809,386,423,2,0,0,0,5,5,5,5
Monterey,5,2022-01-17,5903,5903,2860,3043,28328,28328,13710,14618,69,6,6,14,660,660,654,654
Napa,5,2022-01-17,1932,1932,1330,602,11917,11917,8179,3738,21,2,2,5,112,112,110,110
Nevada,5,2022-01-17,1253,1253,753,500,5429,5429,3261,2168,19,1,1,1,115,115,114,114
Orange,5,2022-01-17,41335,41335,29650,11685,251496,251507,180238,71269,998,111,111,199,6297,6297,6186,6186
Placer,5,2022-01-17,4318,4318,2494,1824,19460,19460,11216,8244,178,14,14,36,538,538,524,524
Plumas,5,2022-01-17,194,194,119,75,852,852,524,328,3,0,0,0,12,12,12,12
Riverside,5,2022-01-17,41253,41253,26968,14285,168056,168062,109882,58180,920,97,97,158,5866,5866,5769,5769
Sacramento,5,2022-01-17,21463,21463,13659,7804,101464,101469,64497,36972,473,64,64,97,2638,2638,2574,2574
San Benito,5,2022-01-17,903,903,618,285,4273,4273,2922,1351,4,1,1,4,87,87,86,86
San Bernardino,5,2022-01-17,38503,38503,26933,11570,164352,164358,114970,49388,936,146,146,227,6933,6933,6787,6787
San Diego,5,2022-01-17,60680,60682,51510,9172,265928,265939,225764,40175,1067,103,103,193,4717,4717,4614,4614
San Francisco,5,2022-01-17,11265,11265,5203,6062,94012,94017,43307,50710,212,14,14,44,725,725,711,711
San Joaquin,5,2022-01-17,12719,12719,7803,4916,58085,58086,35643,22443,201,20,20,57,2035,2035,2015,2015
San Luis Obispo,5,2022-01-17,3934,3934,2647,1287,21024,21024,14127,6897,46,12,12,10,391,391,379,379
San Mateo,5,2022-01-17,12487,12487,8948,3539,95951,95955,68674,27281,92,10,10,30,622,622,612,612
Santa Barbara,5,2022-01-17,6854,6854,4446,2408,40486,40486,26230,14256,123,12,12,12,601,601,589,589
Santa Clara,5,2022-01-17,29562,29562,24873,4689,235961,235972,198421,37551,451,24,24,84,2048,2048,2024,2024
Santa Cruz,5,2022-01-17,4186,4186,2869,1317,42205,42205,28863,13342,23,3,3,3,240,240,237,237
Shasta,5,2022-01-17,1347,1347,863,484,9163,9163,5844,3319,55,7,7,14,469,469,462,462
Siskiyou,5,2022-01-17,158,158,110,48,927,927,640,287,3,1,1,2,65,65,64,64
Solano,5,2022-01-17,6434,6434,4199,2235,35197,35197,22969,12228,121,6,6,22,409,409,403,403
Sonoma,5,2022-01-17,7629,7629,5027,2602,42778,42778,28132,14646,73,7,7,15,444,444,437,437
Stanislaus,5,2022-01-17,7327,7327,4018,3309,29058,29058,15916,13142,206,10,10,31,1481,1481,1471,1471
Sutter,5,2022-01-17,1248,1248,812,436,4863,4863,3161,1702,0,4,4,0,203,203,199,199
Tehama,5,2022-01-17,616,616,344,272,2420,2420,1349,1071,15,5,5,2,174,174,169,169
Trinity,5,2022-01-17,41,41,23,18,255,255,140,115,0,1,1,0,20,20,19,19
Tulare,5,2022-01-17,7477,7477,4070,3407,27091,27091,14726,12365,97,16,16,16,1347,1347,1331,1331
Tuolumne,5,2022-01-17,886,886,532,354,3836,3836,2287,1549,10,8,8,1,162,162,154,154
Ventura,5,2022-01-17,11975,11975,8781,3194,66930,66933,49017,17916,300,41,41,56,1299,1299,1258,1258
Yolo,5,2022-01-17,2805,2805,1899,906,39494,39494,26703,12791,15,4,4,4,308,308,304,304
Yuba,5,2022-01-17,1064,1064,707,357,3747,3747,2489,1258,42,2,2,6,106,106,104,104
Alameda,6,2022-01-24,19741,19741,14820,4921,171782,171788,129141,42647,373,41,41,68,1654,1654,1613,1613
Amador,6,2022-01-24,544,544,352,192,4667,4667,3019,1648,8,0,0,5,73,73,73,73
Butte,6,2022-01-24,1904,1904,1501,403,9606,9606,7589,2017,82,10,10,9,380,380,370,370
Calaveras,6,2022-01-24,556,556,378,178,2506,2506,1705,801,6,2,2,2,99,99,97,97
Colusa,6,2022-01-24,177,177,127,50,951,951,680,271,6,0,0,0,21,21,21,21
Contra Costa,6,2022-01-24,13595,13595,8737,4858,85313,85318,54889,30429,217,25,25,64,1152,1152,1127,1127
Del Norte,6,2022-01-24,348,348,246,102,4326,4326,3042,1284,3,0,0,3,42,42,42,42
El Dorado,6,2022-01-24,1400,1400,954,446,7329,7329,5001,2328,17,2,2,6,195,195,193,193
Fresno,6,2022-01-24,17727,17727,11615,6112,68661,68665,45073,23592,491,43,43,83,2533,2533,2490,2490
Glenn,6,2022-01-24,250,250,172,78,971,971,670,301,0,0,0,0,45,45,45,45
Humboldt,6,2022-01-24,915,915,641,274,7714,7714,5409,2305,25,3,3,3,132,132,129,129
Imperial,6,2022-01-24,3619,3619,2456,1163,13168,13168,8955,4213,70,14,14,27,878,878,864,864
Inyo,6,2022-01-24,142,142,102,40,625,625,449,176,1,1,1,0,53,53,52,52
Kern,6,2022-01-24,10554,10554,7599,2955,53946,53947,38890,15057,267,47,47,51,2159,2159,2112,2112
Kings,6,2022-01-24,4306,4306,2925,1381,19064,19064,12977,6087,40,4,4,4,402,402,398,398
Lake,6,2022-01-24,746,746,488,258,3417,3417,2234,1183,6,2,2,3,123,123,121,121
Lassen,6,2022-01-24,418,418,307,111,3982,3982,2932,1050,6,0,0,0,54,54,54,54
Los Angeles,6,2022-01-24,164908,164915,145677,19238,1659204,1659277,1466749,192528,3769,611,611,785,29022,29022,28411,28411
Madera,6,2022-01-24,2715,2715,1771,944,12170,12170,7938,4232,49,7,7,10,352,352,345,345
Marin,6,2022-01-24,1857,1857,1227,630,17548,17548,11608,5940,38,4,4,10,268,268,264,264
Mariposa,6,2022-01-24,133,133,85,48,945,945,605,340,0,0,0,0,22,22,22,22
Mendocino,6,2022-01-24,917,917,538,379,4873,4873,2854,2019,23,2,2,3,111,111,109,109
Merced,6,2022-01-24,3235,3235,2308,927,12907,12907,9214,3693,55,9,9,12,746,746,737,737
Modoc,6,2022-01-24,14,14,10,4,114,114,82,32,2,0,0,0,7,7,7,7
Mono,6,2022-01-24,97,97,52,45,422,422,227,195,1,0,0,0,5,5,5,5
Monterey,6,2022-01-24,5088,5088,2775,2313,31797,31797,17335,14462,80,9,9,17,669,669,660,660
Napa,6,2022-01-24,1672,1672,1236,436,12465,12465,9206,3259,23,5,5,4,117,117,112,112
Nevada,6,2022-01-24,1001,1001,659,342,4806,4806,3170,1636,29,1,1,6,116,116,115,115
Orange,6,2022-01-24,26687,26687,20394,6293,230903,230914,176711,54203,923,177,177,191,6474,6474,6297,6297
Placer,6,2022-01-24,3660,3660,2330,1330,18644,18644,11867,6777,215,8,8,43,546,546,538,538
Plumas,6,2022-01-24,215,215,144,71,836,836,559,277,5,0,0,0,12,12,12,12
Riverside,6,2022-01-24,31911,31911,22578,9333,158777,158783,112466,46317,901,122,122,168,5988,5988,5866,5866
Sacramento,6,2022-01-24,17474,17474,12091,5383,98837,98842,68429,30413,542,64,64,105,2702,2702,2638,2638
San Benito,6,2022-01-24,776,776,570,206,3929,3929,2889,1040,7,1,1,3,88,88,87,87
San Bernardino,6,2022-01-24,28078,28078,21042,7036,153568,153574,115203,38371,975,170,170,223,7103,7103,6933,6933
San Diego,6,2022-01-24,51462,51463,45168,6295,252113,252125,221533,30592,1056,131,131,232,4848,4848,4717,4717
San Francisco,6,2022-01-24,8097,8097,4233,3864,88914,88919,46540,42379,232,19,19,37,744,744,725,725
San Joaquin,6,2022-01-24,11055,11055,7404,3651,59068,59070,39642,19428,241,34,34,71,2069,2069,2035,2035
San Luis Obispo,6,2022-01-24,3561,3561,2582,979,21516,21516,15603,5913,42,10,10,12,401,401,391,391
San Mateo,6,2022-01-24,8510,8510,6501,2009,95138,95143,72744,22399,139,19,19,28,641,641,622,622
Santa Barbara,6,2022-01-24,6484,6484,4559,1925,43826,43826,30822,13004,127,12,12,19,613,613,601,601
Santa Clara,6,2022-01-24,22785,22785,19871,2914,233308,233319,203466,29853,412,48,48,88,2096,2096,2048,2048
Santa Cruz,6,2022-01-24,5045,5045,3710,1335,45621,45621,33575,12046,31,1,1,2,241,241,240,240
Shasta,6,2022-01-24,1486,1486,1032,454,10135,10135,7033,3102,78,7,7,9,476,476,469,469
Siskiyou,6,2022-01-24,159,159,118,41,857,857,635,222,6,3,3,1,68,68,65,65
Solano,6,2022-01-24,5127,5127,3627,1500,32612,32612,23082,9530,143,14,14,26,423,423,409,409
Sonoma,6,2022-01-24,6926,6926,4931,1995,42474,42474,30246,12228,94,7,7,18,451,451,444,444
Stanislaus,6,2022-01-24,6376,6376,3877,2499,28268,28268,17211,11057,277,27,27,44,1508,1508,1481,1481
Sutter,6,2022-01-24,1047,1047,737,310,5002,5002,3521,1481,0,2,2,0,205,205,203,203
Tehama,6,2022-01-24,577,577,357,220,2702,2702,1674,1028,19,4,4,5,178,178,174,174
Trinity,6,2022-01-24,63,63,38,25,322,322,196,126,0,0,0,0,20,20,20,20
Tulare,6,2022-01-24,7676,7676,4631,3045,29520,29520,17849,11671,138,11,11,14,1358,1358,1347,1347
Tuolumne,6,2022-01-24,954,954,628,326,3827,3827,2510,1317,17,2,2,3,164,164,162,162
Ventura,6,2022-01-24,9412,9412,7331,2081,68520,68523,53430,15093,269,28,28,68,1327,1327,1299,1299
Yolo,6,2022-01-24,2300,2300,1677,623,40465,40465,29503,10962,18,12,12,5,320,320,308,308
Yuba,6,2022-01-24,911,911,653,258,3777,3777,2709,1068,54,3,3,10,109,109,106,106
Alameda,7,2022-01-31,11000,11000,8743,2257,137317,137322,109271,28051,336,50,50,75,1704,1704,1654,1654
Amador,7,2022-01-31,350,350,246,104,3226,3226,2273,953,15,1,1,4,74,74,73,73
Butte,7,2022-01-31,1169,1169,968,201,7608,7608,6305,1303,80,6,6,7,386,386,380,380
Calaveras,7,2022-01-31,263,263,193,70,1940,1940,1424,516,3,5,5,2,104,104,99,99
Colusa,7,2022-01-31,106,106,81,25,704,704,540,164,9,0,0,0,21,21,21,21
Contra Costa,7,2022-01-31,7314,7314,5099,2215,68624,68629,47922,20707,207,39,39,54,1191,1191,1152,1152
Del Norte,7,2022-01-31,315,315,237,78,3957,3957,2977,980,6,2,2,2,44,44,42,42
El Dorado,7,2022-01-31,741,741,544,197,6019,6019,4420,1599,13,4,4,5,199,199,195,195
Fresno,7,2022-01-31,10971,10971,7780,3191,54816,54818,38929,15889,503,39,39,98,2572,2572,2533,2533
Glenn,7,2022-01-31,190,190,140,50,759,759,563,196,2,2,2,0,47,47,45,45
Humboldt,7,2022-01-31,583,583,438,145,5790,5790,4348,1442,18,3,3,3,135,135,132,132
Imperial,7,2022-01-31,2196,2196,1601,595,11279,11279,8246,3033,71,17,17,28,895,895,878,878
Inyo,7,2022-01-31,55,55,42,13,467,467,357,110,5,3,3,0,56,56,53,53
Kern,7,2022-01-31,5650,5650,4340,1310,42263,42263,32503,9760,264,47,47,54,2206,2206,2159,2159
Kings,7,2022-01-31,2391,2391,1749,642,13681,13681,10017,3664,55,5,5,4,407,407,402,402
Lake,7,2022-01-31,478,478,338,140,3193,3193,2258,935,4,4,4,4,127,127,123,123
Lassen,7,2022-01-31,311,311,243,68,3624,3624,2838,786,7,1,1,0,55,55,54,54
Los Angeles,7,2022-01-31,74572,74577,67644,6933,1302832,1302895,1182585,120310,2991,640,640,719,29662,29662,29022,29022
Madera,7,2022-01-31,1744,1744,1233,511,9631,9631,6816,2815,50,6,6,7,358,358,352,352
Marin,7,2022-01-31,1063,1063,759,304,13816,13816,9888,3928,26,5,5,9,273,273,268,268
Mariposa,7,2022-01-31,101,101,70,31,840,840,584,256,0,2,2,0,24,24,22,22
Mendocino,7,2022-01-31,464,464,299,165,3486,3486,2252,1234,12,3,3,4,114,114,111,111
Merced,7,2022-01-31,2126,2126,1618,508,10466,10466,7976,2490,54,12,12,14,758,758,746,746
Modoc,7,2022-01-31,12,12,9,3,89,89,68,21,1,0,0,0,7,7,7,7
Mono,7,2022-01-31,41,41,25,16,339,339,203,136,0,0,0,0,5,5,5,5
Monterey,7,2022-01-31,3558,3558,2154,1404,26742,26742,16229,10513,82,9,9,13,678,678,669,669
Napa,7,2022-01-31,989,989,776,213,9376,9376,7355,2021,17,7,7,10,124,124,117,117
Nevada,7,2022-01-31,568,568,404,164,3912,3912,2788,1124,26,3,3,5,119,119,116,116
Orange,7,2022-01-31,11999,11999,9680,2319,177030,177037,142936,34101,708,170,170,164,6644,6644,6474,6474
Placer,7,2022-01-31,2256,2256,1560,696,15375,15375,10647,4728,152,19,19,42,565,565,546,546
Plumas,7,2022-01-31,137,137,98,39,753,753,542,211,1,0,0,0,12,12,12,12
Riverside,7,2022-01-31,15945,15945,12051,3894,121042,121047,91695,29352,740,111,111,171,6099,6099,5988,5988
Sacramento,7,2022-01-31,10141,10141,7524,2617,77585,77590,57655,19935,501,93,93,106,2795,2795,2702,2702
San Benito,7,2022-01-31,474,474,370,104,3323,3323,2596,727,5,2,2,3,90,90,88,88
San Bernardino,7,2022-01-31,13253,13253,10517,2736,116538,116543,92598,23945,744,185,185,207,7288,7288,7103,7103
San Diego,7,2022-01-31,24845,24845,22416,2429,181384,181393,163802,17591,944,105,105,214,4953,4953,4848,4848
San Francisco,7,2022-01-31,4046,4046,2359,1687,69165,69170,40404,28766,208,24,24,45,768,768,744,744
San Joaquin,7,2022-01-31,5702,5702,4125,1577,43647,43648,31643,12005,210,36,36,75,2105,2105,2069,2069
San Luis Obispo,7,2022-01-31,1981,1981,1530,451,16234,16234,12540,3694,40,12,12,10,413,413,401,401
San Mateo,7,2022-01-31,4328,4328,3489,839,75105,75110,60573,14537,131,10,10,19,651,651,641,641
Santa Barbara,7,2022-01-31,3634,3634,2733,901,35026,35026,26385,8641,103,23,23,13,636,636,613,613
Santa Clara,7,2022-01-31,13837,13837,12416,1421,207114,207125,185908,21217,427,54,54,93,2150,2150,2096,2096
Santa Cruz,7,2022-01-31,3441,3441,2682,759,51420,51421,40151,11270,35,5,5,6,246,246,241,241
Shasta,7,2022-01-31,900,900,670,230,8419,8419,6269,2150,59,13,13,11,489,489,476,476
Siskiyou,7,2022-01-31,119,119,94,25,691,691,545,146,8,2,2,2,70,70,68,68
Solano,7,2022-01-31,3812,3812,2885,927,28697,28697,21716,6981,126,6,6,30,429,429,423,423
Sonoma,7,2022-01-31,3569,3569,2711,858,32147,32147,24452,7695,84,12,12,15,463,463,451,451
Stanislaus,7,2022-01-31,3687,3687,2458,1229,22306,22306,14897,7409,261,33,33,53,1541,1541,1508,1508
Sutter,7,2022-01-31,619,619,466,153,3764,3764,2837,927,0,4,4,0,209,209,205,205
Tehama,7,2022-01-31,377,377,256,121,2022,2022,1368,654,17,3,3,5,181,181,178,178
Trinity,7,2022-01-31,43,43,29,14,227,227,151,76,0,0,0,0,20,20,20,20
Tulare,7,2022-01-31,4685,4685,3097,1588,22901,22901,15174,7727,150,22,22,21,1380,1380,1358,1358
Tuolumne,7,2022-01-31,710,710,502,208,3265,3265,2315,950,12,2,2,4,166,166,164,164
Ventura,7,2022-01-31,4599,4599,3766,833,52327,52328,42904,9424,253,39,39,48,1366,1366,1327,1327
Yolo,7,2022-01-31,1353,1353,1049,304,37503,37503,29102,8401,19,5,5,5,325,325,320,320
Yuba,7,2022-01-31,524,524,401,123,2931,2931,2243,688,78,2,2,11,111,111,109,109
Alameda,8,2022-02-07,5968,5968,4969,999,115664,115669,96370,19299,254,44,44,62,1748,1748,1704,1704
Amador,8,2022-02-07,204,204,153,51,2909,2909,2187,722,14,4,4,5,78,78,74,74
Butte,8,2022-02-07,784,784,674,110,6392,6392,5504,888,74,8,8,12,394,394,386,386
Calaveras,8,2022-02-07,183,183,142,41,1427,1427,1112,315,2,2,2,1,106,106,104,104
Colusa,8,2022-02-07,71,71,57,14,555,555,449,106,0,0,0,0,21,21,21,21
Contra Costa,8,2022-02-07,4136,4136,3093,1043,54149,54153,40506,13647,149,32,32,52,1223,1223,1191,1191
Del Norte,8,2022-02-07,286,286,228,58,4003,4003,3184,819,5,0,0,0,44,44,44,44
El Dorado,8,2022-02-07,427,427,333,94,5034,5034,3927,1107,20,1,1,5,200,200,199,199
Fresno,8,2022-02-07,6382,6382,4835,1547,42464,42464,32207,10257,450,49,49,87,2621,2621,2572,2572
Glenn,8,2022-02-07,113,113,88,25,620,620,488,132,4,3,3,0,50,50,47,47
Humboldt,8,2022-02-07,467,467,371,96,4875,4875,3874,1001,15,1,1,2,136,136,135,135
Imperial,8,2022-02-07,1095,1095,851,244,7927,7927,6163,1764,46,12,12,26,907,907,895,895
Inyo,8,2022-02-07,38,38,30,8,447,447,361,86,5,0,0,0,56,56,56,56
Kern,8,2022-02-07,3472,3472,2811,661,34656,34656,28087,6569,190,32,32,43,2238,2238,2206,2206
Kings,8,2022-02-07,1353,1353,1052,301,10247,10247,7976,2271,52,14,14,5,421,421,407,407
Lake,8,2022-02-07,351,351,265,86,2624,2624,1985,639,11,1,1,5,128,128,127,127
Lassen,8,2022-02-07,140,140,115,25,3023,3023,2487,536,5,2,2,0,57,57,55,55
Los Angeles,8,2022-02-07,37352,37352,34595,2757,1151459,1151522,1066967,84555,2155,638,638,547,30300,30300,29662,29662
Madera,8,2022-02-07,1060,1060,802,258,8081,8081,6118,1963,38,4,4,9,362,362,358,358
Marin,8,2022-02-07,655,655,500,155,11291,11291,8617,2674,29,8,8,6,281,281,273,273
Mariposa,8,2022-02-07,51,51,38,13,579,579,431,148,0,0,0,0,24,24,24,24
Mendocino,8,2022-02-07,327,327,229,98,2817,2817,1974,843,12,2,2,5,116,116,114,114
Merced,8,2022-02-07,1210,1210,974,236,8063,8063,6492,1571,53,13,13,12,771,771,758,758
Modoc,8,2022-02-07,25,25,20,5,219,219,179,40,3,0,0,0,7,7,7,7
Mono,8,2022-02-07,44,44,29,15,271,271,178,93,0,0,0,0,5,5,5,5
Monterey,8,2022-02-07,2221,2221,1474,747,22461,22461,14939,7522,68,11,11,14,689,689,678,678
Napa,8,2022-02-07,742,742,611,131,7766,7766,6396,1370,16,6,6,2,130,130,124,124
Nevada,8,2022-02-07,357,357,271,86,3187,3187,2429,758,24,3,3,1,122,122,119,119
Orange,8,2022-02-07,6394,6394,5391,1003,152286,152294,128446,23848,494,118,118,125,6762,6762,6644,6644
Placer,8,2022-02-07,1294,1294,960,334,11887,11887,8831,3056,148,22,22,34,587,587,565,565
Plumas,8,2022-02-07,79,79,60,19,521,521,399,122,1,1,1,0,13,13,12,12
Riverside,8,2022-02-07,8144,8144,6512,1632,93427,93432,74777,18655,548,107,107,116,6206,6206,6099,6099
Sacramento,8,2022-02-07,6076,6076,4784,1292,63990,63994,50432,13562,390,72,72,95,2867,2867,2795,2795
San Benito,8,2022-02-07,311,311,255,56,2660,2660,2184,476,3,0,0,4,90,90,90,90
San Bernardino,8,2022-02-07,7050,7050,5864,1186,90091,90096,74997,15099,528,140,140,156,7428,7428,7288,7288
San Diego,8,2022-02-07,13634,13634,12577,1057,151885,151893,140178,11715,773,116,116,169,5069,5069,4953,4953
San Francisco,8,2022-02-07,2408,2408,1552,856,55776,55779,35913,19866,171,25,25,40,793,793,768,768
San Joaquin,8,2022-02-07,3348,3348,2581,767,36517,36518,28201,8317,186,42,42,62,2147,2147,2105,2105
San Luis Obispo,8,2022-02-07,1204,1204,979,225,12341,12341,10042,2299,23,16,16,7,429,429,413,413
San Mateo,8,2022-02-07,2463,2463,2075,388,62131,62135,52356,9779,83,16,16,18,667,667,651,651
Santa Barbara,8,2022-02-07,2282,2282,1814,468,30723,30723,24432,6291,75,15,15,17,651,651,636,636
Santa Clara,8,2022-02-07,8032,8032,7375,657,175342,175352,161033,14319,377,31,31,74,2181,2181,2150,2150
Santa Cruz,8,2022-02-07,1900,1900,1560,340,38681,38682,31764,6918,28,4,4,5,250,250,246,246
Shasta,8,2022-02-07,677,677,534,143,6857,6857,5413,1444,64,15,15,10,504,504,489,489
Siskiyou,8,2022-02-07,91,91,75,16,720,720,595,125,10,2,2,0,72,72,70,70
Solano,8,2022-02-07,2238,2238,1784,454,24201,24201,19339,4862,91,5,5,28,434,434,429,429
Sonoma,8,2022-02-07,2086,2086,1676,410,27053,27053,21735,5318,57,7,7,11,470,470,463,463
Stanislaus,8,2022-02-07,2491,2491,1792,699,18738,18738,13501,5237,243,43,43,43,1584,1584,1541,1541
Sutter,8,2022-02-07,360,360,286,74,3305,3305,2631,674,0,5,5,0,214,214,209,209
Tehama,8,2022-02-07,282,282,205,77,1644,1644,1197,447,17,3,3,6,184,184,181,181
Trinity,8,2022-02-07,18,18,13,5,136,136,98,38,0,0,0,0,20,20,20,20
Tulare,8,2022-02-07,2705,2705,1934,771,17908,17908,12832,5076,130,27,27,21,1407,1407,1380,1380
Tuolumne,8,2022-02-07,348,348,263,85,2576,2576,1953,623,10,2,2,1,168,168,166,166
Ventura,8,2022-02-07,2696,2696,2301,395,42327,42328,36166,6162,207,40,40,45,1406,1406,1366,1366
Yolo,8,2022-02-07,864,864,706,158,30854,30854,25178,5676,12,11,11,6,336,336,325,325
Yuba,8,2022-02-07,333,333,269,64,2406,2406,1942,464,42,4,4,13,115,115,111,111
Alameda,9,2022-02-14,3403,3403,2942,461,98989,98994,85609,13385,190,40,40,48,1788,1788,1748,1748
Amador,9,2022-02-14,109,109,87,22,2345,2345,1866,479,8,3,3,3,81,81,78,78
Butte,9,2022-02-14,464,464,412,52,5317,5317,4721,596,64,10,10,9,404,404,394,394
Calaveras,9,2022-02-14,79,79,64,15,1162,1162,950,212,4,2,2,2,108,108,106,106
Colusa,9,2022-02-14,35,35,29,6,406,406,341,65,5,0,0,0,21,21,21,21
Contra Costa,9,2022-02-14,2406,2406,1905,501,44861,44865,35544,9321,123,23,23,31,1246,1246,1223,1223
Del Norte,9,2022-02-14,210,210,175,35,3338,3338,2775,563,6,0,0,3,44,44,44,44
El Dorado,9,2022-02-14,260,260,213,47,4433,4433,3631,802,21,4,4,3,204,204,200,200
Fresno,9,2022-02-14,3866,3866,3095,771,34831,34832,27895,6937,375,34,34,75,2655,2655,2621,2621
Glenn,9,2022-02-14,58,58,48,10,482,482,398,84,3,1,1,0,51,51,50,50
Humboldt,9,2022-02-14,331,331,275,56,4202,4202,3495,707,23,0,0,2,136,136,136,136
Imperial,9,2022-02-14,588,588,480,108,5949,5949,4860,1089,44,14,14,18,921,921,907,907
Inyo,9,2022-02-14,29,29,24,5,413,413,348,65,3,0,0,0,56,56,56,56
Kern,9,2022-02-14,2014,2014,1701,313,27232,27232,23011,4221,156,28,28,40,2266,2266,2238,2238
Kings,9,2022-02-14,774,774,633,141,8001,8001,6548,1453,43,8,8,5,429,429,421,421
Lake,9,2022-02-14,256,256,205,51,2307,2307,1842,465,6,2,2,5,130,130,128,128
Lassen,9,2022-02-14,155,155,133,22,2789,2789,2383,406,3,2,2,0,59,59,57,57
Los Angeles,9,2022-02-14,21441,21441,20188,1253,1052388,1052463,991116,61347,1572,490,490,423,30790,30790,30300,30300
Madera,9,2022-02-14,620,620,496,124,6462,6462,5165,1297,29,2,2,7,364,364,362,362
Marin,9,2022-02-14,383,383,309,74,10149,10149,8172,1977,23,5,5,4,286,286,281,281
Mariposa,9,2022-02-14,24,24,19,5,433,433,342,91,0,0,0,0,24,24,24,24
Mendocino,9,2022-02-14,207,207,155,52,2445,2445,1834,611,13,1,1,7,117,117,116,116
Merced,9,2022-02-14,745,745,627,118,6832,6832,5744,1088,37,13,13,8,784,784,771,771
Modoc,9,2022-02-14,17,17,14,3,124,124,104,20,0,0,0,0,7,7,7,7
Mono,9,2022-02-14,10,10,7,3,179,179,127,52,0,0,0,0,5,5,5,5
Monterey,9,2022-02-14,1229,1229,881,348,16949,16949,12154,4795,48,12,12,12,701,701,689,689
Napa,9,2022-02-14,400,400,343,57,6577,6577,5635,942,10,1,1,1,131,131,130,130
Nevada,9,2022-02-14,169,169,136,33,2568,2568,2066,502,19,3,3,5,125,125,122,122
Orange,9,2022-02-14,3999,3999,3494,505,132322,132331,115559,16772,354,115,115,77,6877,6877,6762,6762
Placer,9,2022-02-14,595,595,468,127,9967,9967,7844,2123,105,12,12,23,599,599,587,587
Plumas,9,2022-02-14,43,43,35,8,431,431,348,83,1,0,0,0,13,13,13,13
Riverside,9,2022-02-14,4611,4611,3858,753,74753,74758,62570,12188,400,85,85,86,6291,6291,6206,6206
Sacramento,9,2022-02-14,3418,3418,2824,594,53018,53023,43830,9193,349,59,59,66,2926,2926,2867,2867
San Benito,9,2022-02-14,158,158,135,23,2159,2159,1845,314,0,1,1,3,91,91,90,90
San Bernardino,9,2022-02-14,3704,3704,3199,505,72754,72759,62874,9885,338,117,117,128,7545,7545,7428,7428
San Diego,9,2022-02-14,8075,8075,7578,497,126079,126087,118375,7712,589,89,89,135,5158,5158,5069,5069
San Francisco,9,2022-02-14,1610,1610,1124,486,47602,47607,33266,14341,130,25,25,39,818,818,793,793
San Joaquin,9,2022-02-14,1987,1987,1614,373,30637,30637,24895,5742,123,37,37,53,2184,2184,2147,2147
San Luis Obispo,9,2022-02-14,798,798,677,121,10051,10051,8530,1521,24,9,9,7,438,438,429,429
San Mateo,9,2022-02-14,1345,1345,1174,171,55007,55012,48011,7001,63,16,16,11,683,683,667,667
Santa Barbara,9,2022-02-14,1056,1056,880,176,22481,22481,18752,3729,68,8,8,14,659,659,651,651
Santa Clara,9,2022-02-14,4636,4636,4335,301,155253,155263,145183,10080,296,27,27,59,2208,2208,2181,2181
Santa Cruz,9,2022-02-14,981,981,838,143,30369,30370,25921,4449,23,3,3,4,253,253,250,250
Shasta,9,2022-02-14,443,443,366,77,5851,5851,4841,1010,62,13,13,13,517,517,504,504
Siskiyou,9,2022-02-14,66,66,57,9,520,520,447,73,7,1,1,2,73,73,72,72
Solano,9,2022-02-14,1201,1201,1003,198,18977,18977,15866,3111,73,2,2,20,436,436,434,434
Sonoma,9,2022-02-14,1135,1135,953,182,21176,21176,17763,3413,55,8,8,7,478,478,470,470
Stanislaus,9,2022-02-14,1364,1364,1046,318,15080,15080,11571,3509,206,28,28,41,1612,1612,1584,1584
Sutter,9,2022-02-14,230,230,192,38,2862,2862,2386,476,0,3,3,0,217,217,214,214
Tehama,9,2022-02-14,180,180,139,41,1404,1404,1088,316,15,5,5,5,189,189,184,184
Trinity,9,2022-02-14,22,22,17,5,171,171,131,40,0,0,0,0,20,20,20,20
Tulare,9,2022-02-14,1479,1479,1127,352,15049,15049,11498,3551,116,27,27,19,1434,1434,1407,1407
Tuolumne,9,2022-02-14,192,192,154,38,2221,2221,1778,443,12,4,4,1,172,172,168,168
Ventura,9,2022-02-14,1511,1511,1333,178,35526,35527,31347,4180,141,36,36,26,1442,1442,1406,1406
Yolo,9,2022-02-14,479,479,407,72,26819,26819,22787,4032,10,7,7,3,343,343,336,336
Yuba,9,2022-02-14,220,220,185,35,2109,2109,1777,332,19,0,0,11,115,115,115,115
Alameda,10,2022-02-21,1927,1927,1717,210,77636,77641,69066,8575,138,28,28,26,1816,1816,1788,1788
Amador,10,2022-02-21,70,70,58,12,1921,1921,1598,323,7,3,3,3,84,84,81,81
Butte,10,2022-02-21,255,255,232,23,4424,4424,4025,399,63,12,12,4,416,416,404,404
Calaveras,10,2022-02-21,44,44,37,7,838,838,712,126,3,6,6,0,114,114,108,108
Colusa,10,2022-02-21,26,26,23,3,362,362,315,47,4,0,0,0,21,21,21,21
Contra Costa,10,2022-02-21,1305,1305,1081,224,34147,34150,28271,5879,66,17,17,30,1263,1263,1246,1246
Del Norte,10,2022-02-21,129,129,111,18,2704,2704,2329,375,8,0,0,1,44,44,44,44
El Dorado,10,2022-02-21,155,155,132,23,3612,3612,3078,534,8,1,1,5,205,205,204,204
Fresno,10,2022-02-21,2011,2011,1683,328,26828,26828,22443,4385,272,26,26,54,2681,2681,2655,2655
Glenn,10,2022-02-21,28,28,24,4,405,405,348,57,2,1,1,0,52,52,51,51
Humboldt,10,2022-02-21,193,193,166,27,3331,3331,2873,458,22,3,3,1,139,139,136,136
Imperial,10,2022-02-21,394,394,335,59,4745,4745,4037,708,31,6,6,10,927,927,921,921
Inyo,10,2022-02-21,10,10,9,1,326,326,284,42,1,0,0,0,56,56,56,56
Kern,10,2022-02-21,1285,1285,1123,162,24322,24322,21263,3059,95,23,23,25,2289,2289,2266,2266
Kings,10,2022-02-21,454,454,387,67,6543,6543,5576,967,32,4,4,5,433,433,429,429
Lake,10,2022-02-21,185,185,155,30,1935,1935,1614,321,7,2,2,1,132,132,130,130
Lassen,10,2022-02-21,111,111,98,13,2135,2135,1883,252,1,0,0,0,59,59,59,59
Los Angeles,10,2022-02-21,11810,11810,11263,547,832204,832268,793239,39029,997,322,322,279,31112,31112,30790,30790
Madera,10,2022-02-21,317,317,265,52,5176,5176,4315,861,27,2,2,7,366,366,364,364
Marin,10,2022-02-21,199,199,167,32,8845,8845,7425,1420,13,3,3,4,289,289,286,286
Mariposa,10,2022-02-21,23,23,19,4,372,372,307,65,0,1,1,0,25,25,24,24
Mendocino,10,2022-02-21,113,113,90,23,1942,1942,1539,403,9,2,2,3,119,119,117,117
Merced,10,2022-02-21,427,427,372,55,5160,5160,4489,671,26,10,10,7,794,794,784,784
Modoc,10,2022-02-21,9,9,8,1,65,65,57,8,2,0,0,0,7,7,7,7
Mono,10,2022-02-21,7,7,5,2,162,162,123,39,0,1,1,0,6,6,5,5
Monterey,10,2022-02-21,780,780,596,184,12977,12977,9894,3083,47,5,5,7,706,706,701,701
Napa,10,2022-02-21,229,229,202,27,4985,4985,4405,580,6,4,4,3,135,135,131,131
Nevada,10,2022-02-21,102,102,85,17,1985,1985,1665,320,16,2,2,5,127,127,125,125
Orange,10,2022-02-21,2463,2463,2213,250,110415,110423,99029,11394,256,79,79,69,6956,6956,6877,6877
Placer,10,2022-02-21,328,328,271,57,8679,8679,7157,1522,92,9,9,13,608,608,599,599
Plumas,10,2022-02-21,21,21,18,3,328,328,276,52,0,0,0,0,13,13,13,13
Riverside,10,2022-02-21,2437,2437,2113,324,61414,61419,53279,8140,262,53,53,61,6344,6344,6291,6291
Sacramento,10,2022-02-21,1960,1960,1682,278,42786,42790,36700,6090,249,33,33,47,2959,2959,2926,2926
San Benito,10,2022-02-21,104,104,92,12,1696,1696,1494,202,0,0,0,1,91,91,91,91
San Bernardino,10,2022-02-21,1901,1901,1693,208,60251,60256,53633,6623,251,82,82,78,7627,7627,7545,7545
San Diego,10,2022-02-21,4623,4623,4398,225,100589,100596,95695,4901,468,61,61,106,5219,5219,5158,5158
San Francisco,10,2022-02-21,975,975,730,245,40355,40359,30110,10249,98,11,11,24,829,829,818,818
San Joaquin,10,2022-02-21,1049,1049,888,161,23840,23840,20163,3677,91,25,25,31,2209,2209,2184,2184
San Luis Obispo,10,2022-02-21,441,441,386,55,7650,7650,6704,946,16,16,16,3,454,454,438,438
San Mateo,10,2022-02-21,695,695,624,71,42575,42579,38164,4415,47,8,8,8,691,691,683,683
Santa Barbara,10,2022-02-21,611,611,528,83,19195,19195,16577,2618,40,6,6,10,665,665,659,659
Santa Clara,10,2022-02-21,2515,2515,2385,130,120311,120319,114030,6289,224,25,25,53,2233,2233,2208,2208
Santa Cruz,10,2022-02-21,578,578,509,69,25013,25015,22016,2999,21,1,1,4,254,254,253,253
Shasta,10,2022-02-21,263,263,225,38,4976,4976,4276,700,46,9,9,10,526,526,517,517
Siskiyou,10,2022-02-21,47,47,42,5,450,450,398,52,6,4,4,1,77,77,73,73
Solano,10,2022-02-21,697,697,604,93,15110,15110,13093,2017,51,5,5,15,441,441,436,436
Sonoma,10,2022-02-21,628,628,546,82,16821,16821,14601,2220,36,2,2,8,480,480,478,478
Stanislaus,10,2022-02-21,732,732,590,142,11759,11759,9489,2270,168,29,29,30,1641,1641,1612,1612
Sutter,10,2022-02-21,121,121,105,16,2108,2108,1821,287,0,2,2,0,219,219,217,217
Tehama,10,2022-02-21,96,96,78,18,1219,1219,993,226,8,10,10,2,199,199,189,189
Trinity,10,2022-02-21,15,15,12,3,199,199,160,39,0,0,0,0,20,20,20,20
Tulare,10,2022-02-21,774,774,622,152,10925,10925,8784,2141,86,15,15,9,1449,1449,1434,1434
Tuolumne,10,2022-02-21,107,107,90,17,1784,1784,1491,293,2,6,6,2,178,178,172,172
Ventura,10,2022-02-21,886,886,802,84,27543,27543,24926,2617,107,22,22,22,1464,1464,1442,1442
Yolo,10,2022-02-21,282,282,248,34,20977,20977,18398,2579,7,6,6,3,349,349,343,343
Yuba,10,2022-02-21,134,134,117,17,1679,1679,1466,213,22,1,1,8,116,116,115,115
Alameda,11,2022-02-28,1475,1475,1348,127,78764,78769,71942,6827,113,17,17,23,1833,1833,1816,1816
Amador,11,2022-02-28,56,56,48,8,2077,2077,1796,281,7,0,0,2,84,84,84,84
Butte,11,2022-02-28,188,188,175,13,4475,4475,4156,319,45,6,6,4,422,422,416,416
Calaveras,11,2022-02-28,40,40,35,5,1254,1254,1105,149,0,3,3,0,117,117,114,114
Colusa,11,2022-02-28,10,10,9,1,406,406,364,42,5,0,0,0,21,21,21,21
Contra Costa,11,2022-02-28,935,935,806,129,35020,35023,30197,4826,56,15,15,19,1278,1278,1263,1263
Del Norte,11,2022-02-28,84,84,75,9,2876,2876,2557,319,5,3,3,2,47,47,44,44
El Dorado,11,2022-02-28,105,105,93,12,3686,3686,3252,434,5,2,2,3,207,207,205,205
Fresno,11,2022-02-28,1308,1308,1136,172,26284,26285,22836,3449,196,28,28,44,2709,2709,2681,2681
Glenn,11,2022-02-28,18,18,16,2,435,435,386,49,1,0,0,0,52,52,52,52
Humboldt,11,2022-02-28,157,157,140,17,2957,2957,2633,324,6,1,1,1,140,140,139,139
Imperial,11,2022-02-28,264,264,233,31,4769,4769,4198,571,13,6,6,10,933,933,927,927
Inyo,11,2022-02-28,10,10,9,1,379,379,341,38,0,0,0,0,56,56,56,56
Kern,11,2022-02-28,792,792,713,79,24603,24603,22150,2453,77,16,16,16,2305,2305,2289,2289
Kings,11,2022-02-28,246,246,216,30,6079,6079,5356,723,19,7,7,3,440,440,433,433
Lake,11,2022-02-28,110,110,95,15,1956,1956,1695,261,0,4,4,1,136,136,132,132
Lassen,11,2022-02-28,44,44,40,4,2097,2097,1899,198,1,2,2,0,61,61,59,59
Los Angeles,11,2022-02-28,8218,8218,7920,298,1057290,1057378,1018837,38541,753,222,222,174,31334,31334,31112,31112
Madera,11,2022-02-28,189,189,164,25,4623,4623,4012,611,20,2,2,6,368,368,366,366
Marin,11,2022-02-28,160,160,140,20,7664,7664,6681,983,13,3,3,3,292,292,289,289
Mariposa,11,2022-02-28,29,29,25,4,347,347,298,49,0,1,1,0,26,26,25,25
Mendocino,11,2022-02-28,84,84,70,14,1889,1889,1571,318,11,2,2,2,121,121,119,119
Merced,11,2022-02-28,283,283,254,29,5030,5030,4509,521,25,7,7,5,801,801,794,794
Modoc,11,2022-02-28,6,6,5,1,57,57,51,6,1,0,0,0,7,7,7,7
Mono,11,2022-02-28,5,5,4,1,169,169,136,33,0,0,0,0,6,6,6,6
Monterey,11,2022-02-28,355,355,286,69,14337,14337,11561,2776,28,9,9,5,715,715,706,706
Napa,11,2022-02-28,194,194,176,18,5594,5594,5080,514,8,3,3,2,138,138,135,135
Nevada,11,2022-02-28,71,71,62,9,2016,2016,1753,263,9,0,0,1,127,127,127,127
Orange,11,2022-02-28,1689,1689,1552,137,126368,126378,116114,10264,198,42,42,35,6998,6998,6956,6956
Placer,11,2022-02-28,248,248,213,35,8421,8421,7233,1188,65,4,4,13,612,612,608,608
Plumas,11,2022-02-28,23,23,20,3,370,370,323,47,0,0,0,0,13,13,13,13
Riverside,11,2022-02-28,1687,1687,1508,179,63264,63269,56572,6697,185,37,37,35,6381,6381,6344,6344
Sacramento,11,2022-02-28,1163,1163,1032,131,45697,45702,40520,5182,163,24,24,35,2983,2983,2959,2959
San Benito,11,2022-02-28,55,55,50,5,1809,1809,1638,171,0,0,0,1,91,91,91,91
San Bernardino,11,2022-02-28,1175,1175,1073,102,61095,61100,55780,5320,157,60,60,45,7687,7687,7627,7627
San Diego,11,2022-02-28,3034,3034,2918,116,100026,100035,96231,3804,341,37,37,83,5256,5256,5219,5219
San Francisco,11,2022-02-28,836,836,662,174,40065,40070,31745,8325,74,16,16,19,845,845,829,829
San Joaquin,11,2022-02-28,657,657,576,81,26083,26085,22863,3222,58,11,11,24,2220,2220,2209,2209
San Luis Obispo,11,2022-02-28,378,378,341,37,8504,8504,7672,832,9,5,5,2,459,459,454,454
San Mateo,11,2022-02-28,597,597,549,48,41439,41443,38089,3354,33,4,4,7,695,695,691,691
Santa Barbara,11,2022-02-28,369,369,329,40,21385,21385,19063,2322,36,5,5,10,670,670,665,665
Santa Clara,11,2022-02-28,1730,1730,1660,70,103090,103098,98978,4120,191,22,22,46,2255,2255,2233,2233
Santa Cruz,11,2022-02-28,460,460,416,44,27974,27977,25347,2630,20,2,2,4,256,256,254,254
Shasta,11,2022-02-28,167,167,148,19,4926,4926,4373,553,36,11,11,8,537,537,526,526
Siskiyou,11,2022-02-28,25,25,23,2,475,475,432,43,4,2,2,1,79,79,77,77
Solano,11,2022-02-28,476,476,425,51,15304,15304,13678,1626,47,3,3,17,444,444,441,441
Sonoma,11,2022-02-28,454,454,407,47,16949,16949,15184,1765,28,3,3,5,483,483,480,480
Stanislaus,11,2022-02-28,470,470,396,74,13361,13361,11275,2086,124,11,11,21,1652,1652,1641,1641
Sutter,11,2022-02-28,106,106,95,11,2333,2333,2079,254,0,2,2,0,221,221,219,219
Tehama,11,2022-02-28,60,60,51,9,1221,1221,1039,182,7,1,1,2,200,200,199,199
Trinity,11,2022-02-28,5,5,4,1,118,118,99,19,0,0,0,0,20,20,20,20
Tulare,11,2022-02-28,462,462,389,73,11875,11875,9989,1886,67,15,15,9,1464,1464,1449,1449
Tuolumne,11,2022-02-28,69,69,60,9,1486,1486,1291,195,6,3,3,1,181,181,178,178
Ventura,11,2022-02-28,548,548,507,41,29889,29891,27650,2241,75,10,10,11,1474,1474,1464,1464
Yolo,11,2022-02-28,207,207,187,20,26250,26250,23704,2546,4,5,5,6,354,354,349,349
Yuba,11,2022-02-28,75,75,67,8,1711,1711,1537,174,12,1,1,6,117,117,116,116
Alameda,12,2022-03-07,1094,1094,1019,75,72592,72598,67600,4998,77,12,12,16,1845,1845,1833,1833
Amador,12,2022-03-07,75,75,67,8,1428,1428,1274,154,6,2,2,1,86,86,84,84
Butte,12,2022-03-07,98,98,92,6,3638,3638,3434,204,33,4,4,3,426,426,422,422
Calaveras,12,2022-03-07,25,25,23,2,1048,1048,948,100,1,1,1,0,118,118,117,117
Colusa,12,2022-03-07,9,9,8,1,355,355,326,29,6,0,0,0,21,21,21,21
Contra Costa,12,2022-03-07,627,627,558,69,30970,30974,27549,3425,47,8,8,13,1286,1286,1278,1278
Del Norte,12,2022-03-07,50,50,46,4,1779,1779,1624,155,7,0,0,1,47,47,47,47
El Dorado,12,2022-03-07,77,77,70,7,3200,3200,2899,301,5,3,3,2,210,210,207,207
Fresno,12,2022-03-07,859,859,769,90,22195,22195,19871,2324,145,18,18,27,2727,2727,2709,2709
Glenn,12,2022-03-07,19,19,17,2,395,395,359,36,2,1,1,0,53,53,52,52
Humboldt,12,2022-03-07,81,81,74,7,3045,3045,2779,266,10,3,3,4,143,143,140,140
Imperial,12,2022-03-07,122,122,110,12,4468,4468,4042,426,16,5,5,10,938,938,933,933
Inyo,12,2022-03-07,10,10,9,1,269,269,247,22,0,0,0,0,56,56,56,56
Kern,12,2022-03-07,433,433,398,35,20833,20834,19185,1649,67,12,12,16,2317,2317,2305,2305
Kings,12,2022-03-07,201,201,182,19,4986,4986,4514,472,13,4,4,2,444,444,440,440
Lake,12,2022-03-07,64,64,57,7,1760,1760,1572,188,2,2,2,1,138,138,136,136
Lassen,12,2022-03-07,96,96,89,7,1889,1889,1748,141,0,1,1,0,62,62,61,61
Los Angeles,12,2022-03-07,5537,5537,5380,157,876055,876144,851219,24925,573,171,171,133,31505,31505,31334,31334
Madera,12,2022-03-07,133,133,119,14,3916,3916,3502,414,15,1,1,2,369,369,368,368
Marin,12,2022-03-07,154,154,138,16,7559,7559,6778,781,10,1,1,2,293,293,292,292
Mariposa,12,2022-03-07,11,11,10,1,296,296,263,33,0,1,1,0,27,27,26,26
Mendocino,12,2022-03-07,65,65,56,9,1643,1643,1418,225,6,0,0,2,121,121,121,121
Merced,12,2022-03-07,173,173,159,14,4536,4536,4161,375,17,7,7,5,808,808,801,801
Modoc,12,2022-03-07,0,0,0,0,54,54,50,4,0,0,0,0,7,7,7,7
Mono,12,2022-03-07,2,2,2,0,128,128,108,20,0,0,0,1,6,6,6,6
Monterey,12,2022-03-07,244,244,206,38,11053,11053,9324,1729,19,5,5,2,720,720,715,715
Napa,12,2022-03-07,199,199,185,14,4874,4874,4518,356,2,1,1,2,139,139,138,138
Nevada,12,2022-03-07,50,50,45,5,1751,1751,1569,182,0,2,2,0,129,129,127,127
Orange,12,2022-03-07,1254,1254,1174,80,107456,107466,100561,6905,138,29,29,28,7027,7027,6998,6998
Placer,12,2022-03-07,164,164,145,19,7797,7797,6916,881,54,3,3,11,615,615,612,612
Plumas,12,2022-03-07,7,7,6,1,266,266,239,27,0,0,0,0,13,13,13,13
Riverside,12,2022-03-07,981,981,899,82,53631,53636,49122,4514,125,26,26,30,6407,6407,6381,6381
Sacramento,12,2022-03-07,773,773,704,69,40204,40209,36588,3621,124,18,18,28,3001,3001,2983,2983
San Benito,12,2022-03-07,41,41,38,3,1525,1525,1411,114,0,2,2,1,93,93,91,91
San Bernardino,12,2022-03-07,792,792,737,55,54193,54198,50461,3737,95,43,43,38,7730,7730,7687,7687
San Diego,12,2022-03-07,2338,2338,2268,70,96665,96675,93791,2884,237,31,31,57,5287,5287,5256,5256
San Francisco,12,2022-03-07,700,700,582,118,37419,37424,31066,6358,62,5,5,11,850,850,845,845
San Joaquin,12,2022-03-07,439,439,396,43,21194,21195,19117,2078,33,9,9,19,2229,2229,2220,2220
San Luis Obispo,12,2022-03-07,245,245,226,19,7300,7300,6735,565,7,5,5,1,464,464,459,459
San Mateo,12,2022-03-07,529,529,495,34,40058,40063,37475,2588,30,2,2,3,697,697,695,695
Santa Barbara,12,2022-03-07,203,203,186,17,17714,17714,16186,1528,15,4,4,8,674,674,670,670
Santa Clara,12,2022-03-07,1467,1467,1421,46,112126,112136,108566,3570,128,13,13,38,2268,2268,2255,2255
Santa Cruz,12,2022-03-07,335,335,310,25,24974,24977,23118,1859,11,0,0,7,256,256,256,256
Shasta,12,2022-03-07,140,140,127,13,4940,4940,4498,442,24,8,8,3,545,545,537,537
Siskiyou,12,2022-03-07,12,12,11,1,399,399,370,29,2,1,1,0,80,80,79,79
Solano,12,2022-03-07,352,352,322,30,14064,14064,12873,1191,46,2,2,10,446,446,444,444
Sonoma,12,2022-03-07,321,321,294,27,14921,14921,13684,1237,26,3,3,6,486,486,483,483
Stanislaus,12,2022-03-07,276,276,241,35,10858,10858,9500,1358,94,10,10,13,1662,1662,1652,1652
Sutter,12,2022-03-07,81,81,74,7,1908,1908,1742,166,0,1,1,0,222,222,221,221
Tehama,12,2022-03-07,40,40,35,5,1115,1115,980,135,5,2,2,1,202,202,200,200
Trinity,12,2022-03-07,4,4,3,1,114,114,100,14,0,0,0,0,20,20,20,20
Tulare,12,2022-03-07,302,302,263,39,10282,10282,8974,1308,37,13,13,3,1477,1477,1464,1464
Tuolumne,12,2022-03-07,48,48,43,5,1253,1253,1122,131,2,0,0,1,181,181,181,181
Ventura,12,2022-03-07,417,417,392,25,26717,26718,25138,1580,45,4,4,11,1478,1478,1474,1474
Yolo,12,2022-03-07,160,160,148,12,22153,22153,20449,1704,3,2,2,2,356,356,354,354
Yuba,12,2022-03-07,59,59,54,5,1552,1552,1425,127,13,0,0,6,117,117,117,117
Alameda,13,2022-03-14,877,877,829,48,68949,68956,65205,3751,64,9,9,6,1854,1854,1845,1845
Amador,13,2022-03-14,32,32,29,3,1439,1439,1315,124,4,0,0,0,86,86,86,86
Butte,13,2022-03-14,82,82,78,4,3592,3592,3432,160,24,1,1,0,427,427,426,426
Calaveras,13,2022-03-14,17,17,16,1,990,990,914,76,1,1,1,1,119,119,118,118
Colusa,13,2022-03-14,4,4,4,0,257,257,240,17,4,0,0,0,21,21,21,21
Contra Costa,13,2022-03-14,567,567,517,50,29141,29146,26577,2569,19,5,5,9,1291,1291,1286,1286
Del Norte,13,2022-03-14,31,31,29,2,1415,1415,1317,98,1,2,2,1,49,49,47,47
El Dorado,13,2022-03-14,44,44,41,3,2980,2980,2757,223,4,1,1,0,211,211,210,210
Fresno,13,2022-03-14,526,526,482,44,21102,21103,19340,1763,120,10,10,20,2737,2737,2727,2727
Glenn,13,2022-03-14,11,11,10,1,342,342,318,24,1,0,0,0,53,53,53,53
Humboldt,13,2022-03-14,56,56,52,4,2651,2651,2466,185,3,1,1,2,144,144,143,143
Imperial,13,2022-03-14,74,74,68,6,4541,4541,4194,347,5,2,2,7,940,940,938,938
Inyo,13,2022-03-14,6,6,6,0,165,165,154,11,0,0,0,0,56,56,56,56
Kern,13,2022-03-14,301,301,282,19,20273,20274,19004,1270,42,14,14,12,2331,2331,2317,2317
Kings,13,2022-03-14,156,156,144,12,4695,4695,4341,354,17,1,1,2,445,445,444,444
Lake,13,2022-03-14,48,48,44,4,1570,1570,1436,134,1,1,1,0,139,139,138,138
Lassen,13,2022-03-14,5,5,5,0,1515,1515,1426,89,0,0,0,0,62,62,62,62
Los Angeles,13,2022-03-14,4060,4060,3970,90,845627,845728,826872,18856,412,115,115,91,31620,31620,31505,31505
Madera,13,2022-03-14,52,52,48,4,3575,3575,3272,303,12,0,0,2,369,369,369,369
Marin,13,2022-03-14,170,170,156,14,6532,6532,5997,535,7,1,1,0,294,294,293,293
Mariposa,13,2022-03-14,9,9,8,1,222,222,202,20,0,0,0,0,27,27,27,27
Mendocino,13,2022-03-14,35,35,31,4,1434,1434,1276,158,4,2,2,1,123,123,121,121
Merced,13,2022-03-14,134,134,125,9,4167,4167,3895,272,17,2,2,4,810,810,808,808
Modoc,13,2022-03-14,3,3,3,0,52,52,49,3,1,0,0,0,7,7,7,7
Mono,13,2022-03-14,2,2,2,0,118,118,103,15,0,0,0,0,6,6,6,6
Monterey,13,2022-03-14,156,156,136,20,10113,10113,8834,1279,14,4,4,2,724,724,720,720
Napa,13,2022-03-14,119,119,112,7,4104,4104,3867,237,6,1,1,3,140,140,139,139
Nevada,13,2022-03-14,50,50,46,4,1571,1571,1441,130,2,0,0,0,129,129,129,129
Orange,13,2022-03-14,823,823,781,42,101559,101571,96416,5155,109,31,31,31,7058,7058,7027,7027
Placer,13,2022-03-14,148,148,135,13,7319,7319,6658,661,45,3,3,5,618,618,615,615
Plumas,13,2022-03-14,4,4,4,0,317,317,291,26,0,0,0,0,13,13,13,13
Riverside,13,2022-03-14,739,739,690,49,52736,52742,49225,3517,87,15,15,16,6422,6422,6407,6407
Sacramento,13,2022-03-14,588,588,546,42,35140,35145,32621,2524,122,16,16,22,3017,3017,3001,3001
San Benito,13,2022-03-14,36,36,34,2,1462,1462,1375,87,0,0,0,1,93,93,93,93
San Bernardino,13,2022-03-14,569,569,538,31,51687,51692,48872,2820,68,26,26,32,7756,7756,7730,7730
San Diego,13,2022-03-14,1843,1843,1800,43,96065,96078,93823,2255,174,17,17,47,5304,5304,5287,5287
San Francisco,13,2022-03-14,608,608,525,83,34320,34325,29604,4721,28,7,7,7,857,857,850,850
San Joaquin,13,2022-03-14,268,268,247,21,18873,18873,17388,1485,28,7,7,11,2236,2236,2229,2229
San Luis Obispo,13,2022-03-14,162,162,152,10,6664,6664,6254,410,7,7,7,1,471,471,464,464
San Mateo,13,2022-03-14,441,441,419,22,35834,35839,34005,1834,27,0,0,3,697,697,697,697
Santa Barbara,13,2022-03-14,196,196,183,13,16859,16859,15700,1159,16,7,7,2,681,681,674,674
Santa Clara,13,2022-03-14,1177,1177,1148,29,99875,99886,97388,2498,108,13,13,28,2281,2281,2268,2268
Santa Cruz,13,2022-03-14,239,239,225,14,22176,22180,20872,1308,10,3,3,3,259,259,256,256
Shasta,13,2022-03-14,97,97,90,7,4838,4838,4492,346,16,5,5,2,550,550,545,545
Siskiyou,13,2022-03-14,9,9,8,1,370,370,349,21,0,3,3,0,83,83,80,80
Solano,13,2022-03-14,221,221,206,15,12299,12299,11471,828,34,1,1,6,447,447,446,446
Sonoma,13,2022-03-14,228,228,213,15,13398,13398,12513,885,14,1,1,4,487,487,486,486
Stanislaus,13,2022-03-14,216,216,194,22,9401,9401,8454,947,82,11,11,17,1673,1673,1662,1662
Sutter,13,2022-03-14,41,41,38,3,1815,1815,1689,126,0,0,0,0,222,222,222,222
Tehama,13,2022-03-14,17,17,15,2,981,981,886,95,2,3,3,0,205,205,202,202
Trinity,13,2022-03-14,3,3,3,0,96,96,86,10,0,0,0,0,20,20,20,20
Tulare,13,2022-03-14,174,174,156,18,9301,9301,8348,953,33,0,0,6,1477,1477,1477,1477
Tuolumne,13,2022-03-14,22,22,20,2,1246,1246,1142,104,1,0,0,0,181,181,181,181
Ventura,13,2022-03-14,326,326,311,15,24591,24594,23443,1151,37,6,6,7,1484,1484,1478,1478
Yolo,13,2022-03-14,118,118,111,7,21619,21619,20301,1318,1,3,3,2,359,359,356,356
Yuba,13,2022-03-14,35,35,33,2,1417,1417,1325,92,10,0,0,3,117,117,117,117
Alameda,14,2022-03-21,722,722,691,31,65827,65836,63003,2833,58,7,7,3,1861,1861,1854,1854
Amador,14,2022-03-21,29,29,27,2,1356,1356,1263,93,2,0,0,0,86,86,86,86
Butte,14,2022-03-21,81,81,78,3,3158,3158,3048,110,17,0,0,2,427,427,427,427
Calaveras,14,2022-03-21,8,8,8,0,657,657,618,39,0,0,0,0,119,119,119,119
Colusa,14,2022-03-21,3,3,3,0,231,231,219,12,2,0,0,0,21,21,21,21
Contra Costa,14,2022-03-21,466,466,434,32,26931,26935,25042,1893,27,7,7,9,1298,1298,1291,1291
Del Norte,14,2022-03-21,19,19,18,1,1192,1192,1127,65,0,0,0,0,49,49,49,49
El Dorado,14,2022-03-21,46,46,43,3,2813,2813,2647,166,1,2,2,0,213,213,211,211
Fresno,14,2022-03-21,346,346,323,23,19318,19320,18038,1282,97,11,11,12,2748,2748,2737,2737
Glenn,14,2022-03-21,7,7,7,0,366,366,345,21,1,0,0,0,53,53,53,53
Humboldt,14,2022-03-21,31,31,29,2,2456,2456,2322,134,5,1,1,2,145,145,144,144
Imperial,14,2022-03-21,58,58,54,4,3955,3955,3717,238,4,3,3,4,943,943,940,940
Inyo,14,2022-03-21,1,1,1,0,148,148,140,8,0,0,0,0,56,56,56,56
Kern,14,2022-03-21,206,206,196,10,19490,19492,18527,965,34,4,4,9,2335,2335,2331,2331
Kings,14,2022-03-21,79,79,74,5,4411,4411,4147,264,7,1,1,1,446,446,445,445
Lake,14,2022-03-21,18,18,17,1,1365,1365,1272,93,0,0,0,0,139,139,139,139
Lassen,14,2022-03-21,10,10,10,0,1388,1388,1323,65,0,0,0,0,62,62,62,62
Los Angeles,14,2022-03-21,4131,4131,4060,71,822844,822953,808579,14374,338,76,76,66,31696,31696,31620,31620
Madera,14,2022-03-21,40,40,37,3,3392,3392,3164,228,9,1,1,1,370,370,369,369
Marin,14,2022-03-21,133,133,124,9,6231,6231,5825,406,6,1,1,0,295,295,294,294
Mariposa,14,2022-03-21,7,7,6,1,236,236,219,17,0,0,0,0,27,27,27,27
Mendocino,14,2022-03-21,28,28,26,2,1508,1508,1376,132,4,0,0,1,123,123,123,123
Merced,14,2022-03-21,87,87,82,5,3771,3771,3576,195,13,5,5,1,815,815,810,810
Modoc,14,2022-03-21,2,2,2,0,60,60,57,3,0,0,0,0,7,7,7,7
Mono,14,2022-03-21,4,4,4,0,134,134,120,14,1,0,0,0,6,6,6,6
Monterey,14,2022-03-21,152,152,137,15,10087,10087,9063,1024,22,0,0,1,724,724,724,724
Napa,14,2022-03-21,54,54,52,2,3451,3451,3294,157,6,1,1,2,141,141,140,140
Nevada,14,2022-03-21,18,18,17,1,1528,1528,1428,100,2,0,0,0,129,129,129,129
Orange,14,2022-03-21,756,756,726,30,96133,96144,92291,3853,100,12,12,25,7070,7070,7058,7058
Placer,14,2022-03-21,112,112,104,8,6475,6475,6010,465,40,2,2,6,620,620,618,618
Plumas,14,2022-03-21,2,2,2,0,228,228,213,15,0,0,0,0,13,13,13,13
Riverside,14,2022-03-21,616,616,583,33,51895,51900,49143,2757,69,13,13,18,6435,6435,6422,6422
Sacramento,14,2022-03-21,462,462,436,26,32986,32991,31120,1871,89,13,13,13,3030,3030,3017,3017
San Benito,14,2022-03-21,19,19,18,1,1385,1385,1320,65,0,1,1,0,94,94,93,93
San Bernardino,14,2022-03-21,473,473,453,20,49316,49321,47190,2131,49,20,20,31,7776,7776,7756,7756
San Diego,14,2022-03-21,1371,1371,1346,25,84591,84603,83047,1556,146,15,15,39,5319,5319,5304,5304
San Francisco,14,2022-03-21,687,687,612,75,33568,33573,29860,3713,34,3,3,3,860,860,857,857
San Joaquin,14,2022-03-21,220,220,206,14,15669,15669,14698,971,23,6,6,6,2242,2242,2236,2236
San Luis Obispo,14,2022-03-21,107,107,102,5,6416,6416,6103,313,3,5,5,0,476,476,471,471
San Mateo,14,2022-03-21,369,369,354,15,34927,34932,33528,1404,30,1,1,1,698,698,697,697
Santa Barbara,14,2022-03-21,160,160,151,9,14296,14296,13507,789,17,5,5,4,686,686,681,681
Santa Clara,14,2022-03-21,1099,1099,1078,21,95231,95242,93376,1866,101,5,5,20,2286,2286,2281,2281
Santa Cruz,14,2022-03-21,184,184,175,9,20037,20040,19105,935,8,0,0,3,259,259,259,259
Shasta,14,2022-03-21,41,41,39,2,4136,4136,3902,234,10,6,6,2,556,556,550,550
Siskiyou,14,2022-03-21,9,9,9,0,370,370,353,17,1,0,0,0,83,83,83,83
Solano,14,2022-03-21,187,187,177,10,11748,11748,11123,625,17,1,1,5,448,448,447,447
Sonoma,14,2022-03-21,231,231,219,12,12380,12380,11728,652,15,2,2,2,489,489,487,487
Stanislaus,14,2022-03-21,142,142,131,11,8428,8428,7752,676,59,12,12,8,1685,1685,1673,1673
Sutter,14,2022-03-21,34,34,32,2,1478,1478,1398,80,0,1,1,0,223,223,222,222
Tehama,14,2022-03-21,10,10,9,1,926,926,854,72,2,0,0,0,205,205,205,205
Trinity,14,2022-03-21,0,0,0,0,111,111,102,9,0,0,0,0,20,20,20,20
Tulare,14,2022-03-21,108,108,99,9,8165,8165,7499,666,27,5,5,4,1482,1482,1477,1477
Tuolumne,14,2022-03-21,19,19,18,1,1131,1131,1055,76,2,0,0,0,181,181,181,181
Ventura,14,2022-03-21,289,289,278,11,23283,23286,22426,860,30,5,5,6,1489,1489,1484,1484
Yolo,14,2022-03-21,107,107,102,5,21431,21434,20395,1039,1,0,0,1,359,359,359,359
Yuba,14,2022-03-21,42,42,40,2,1318,1318,1251,67,8,0,0,2,117,117,117,117
Alameda,15,2022-03-28,925,925,894,31,59262,59270,57271,1999,35,4,4,5,1865,1865,1861,1861
Amador,15,2022-03-28,8,8,8,0,1376,1376,1301,75,3,0,0,0,86,86,86,86
Butte,15,2022-03-28,64,64,62,2,2853,2853,2775,78,11,0,0,1,427,427,427,427
Calaveras,15,2022-03-28,15,15,14,1,580,580,553,27,0,0,0,0,119,119,119,119
Colusa,15,2022-03-28,4,4,4,0,207,207,199,8,0,0,0,0,21,21,21,21
Contra Costa,15,2022-03-28,534,534,505,29,24907,24912,23530,1382,29,1,1,6,1299,1299,1298,1298
Del Norte,15,2022-03-28,16,16,15,1,1038,1038,993,45,1,0,0,0,49,49,49,49
El Dorado,15,2022-03-28,60,60,57,3,2810,2810,2679,131,0,0,0,0,213,213,213,213
Fresno,15,2022-03-28,275,275,261,14,17888,17890,16951,939,71,5,5,18,2753,2753,2748,2748
Glenn,15,2022-03-28,8,8,8,0,333,333,318,15,0,0,0,0,53,53,53,53
Humboldt,15,2022-03-28,27,27,26,1,2608,2608,2495,113,4,0,0,3,145,145,145,145
Imperial,15,2022-03-28,63,63,60,3,3532,3532,3364,168,4,1,1,3,944,944,943,943
Inyo,15,2022-03-28,4,4,4,0,186,186,178,8,1,0,0,0,56,56,56,56
Kern,15,2022-03-28,144,144,138,6,18179,18181,17471,710,17,4,4,8,2339,2339,2335,2335
Kings,15,2022-03-28,57,57,54,3,4275,4275,4073,202,6,2,2,0,448,448,446,446
Lake,15,2022-03-28,10,10,9,1,1068,1068,1010,58,0,0,0,0,139,139,139,139
Lassen,15,2022-03-28,4,4,4,0,1284,1284,1236,48,0,0,0,0,62,62,62,62
Los Angeles,15,2022-03-28,4473,4473,4412,61,703828,703932,694204,9728,264,53,53,57,31749,31749,31696,31696
Madera,15,2022-03-28,24,24,23,1,3451,3451,3268,183,4,0,0,2,370,370,370,370
Marin,15,2022-03-28,180,180,171,9,6000,6000,5692,308,3,0,0,0,295,295,295,295
Mariposa,15,2022-03-28,5,5,5,0,179,179,169,10,0,1,1,0,28,28,27,27
Mendocino,15,2022-03-28,31,31,29,2,1314,1314,1223,91,0,1,1,0,124,124,123,123
Merced,15,2022-03-28,64,64,61,3,3359,3359,3223,136,5,1,1,3,816,816,815,815
Modoc,15,2022-03-28,3,3,3,0,45,45,43,2,0,0,0,0,7,7,7,7
Mono,15,2022-03-28,1,1,1,0,134,134,123,11,0,0,0,0,6,6,6,6
Monterey,15,2022-03-28,148,148,136,12,8782,8782,8069,713,14,1,1,0,725,725,724,724
Napa,15,2022-03-28,68,68,66,2,3329,3329,3210,119,1,2,2,1,143,143,141,141
Nevada,15,2022-03-28,27,27,26,1,1431,1431,1357,74,1,1,1,0,130,130,129,129
Orange,15,2022-03-28,809,809,784,25,90210,90223,87386,2837,81,12,12,17,7082,7082,7070,7070
Placer,15,2022-03-28,107,107,101,6,6222,6222,5870,352,26,4,4,6,624,624,620,620
Plumas,15,2022-03-28,3,3,3,0,267,267,253,14,0,0,0,0,13,13,13,13
Riverside,15,2022-03-28,522,522,500,22,43927,43933,42102,1831,47,7,7,10,6442,6442,6435,6435
Sacramento,15,2022-03-28,456,456,436,20,32473,32478,31028,1450,68,6,6,19,3036,3036,3030,3030
San Benito,15,2022-03-28,14,14,13,1,1365,1365,1315,50,0,0,0,0,94,94,94,94
San Bernardino,15,2022-03-28,545,545,527,18,41309,41314,39917,1397,40,18,18,24,7794,7794,7776,7776
San Diego,15,2022-03-28,1327,1327,1308,19,72132,72144,71109,1035,114,9,9,26,5328,5328,5319,5319
San Francisco,15,2022-03-28,844,844,770,74,32805,32810,29915,2895,23,5,5,5,865,865,860,860
San Joaquin,15,2022-03-28,189,189,180,9,17487,17489,16635,854,20,4,4,4,2246,2246,2242,2242
San Luis Obispo,15,2022-03-28,96,96,92,4,5701,5701,5484,217,5,1,1,1,477,477,476,476
San Mateo,15,2022-03-28,582,582,564,18,33959,33964,32889,1075,26,3,3,3,701,701,698,698
Santa Barbara,15,2022-03-28,135,135,129,6,10222,10222,9791,431,15,1,1,4,687,687,686,686
Santa Clara,15,2022-03-28,1276,1276,1257,19,95191,95206,93754,1452,88,10,10,18,2296,2296,2286,2286
Santa Cruz,15,2022-03-28,145,145,140,5,19692,19696,18979,717,3,0,0,2,259,259,259,259
Shasta,15,2022-03-28,34,34,32,2,3879,3879,3706,173,7,2,2,3,558,558,556,556
Siskiyou,15,2022-03-28,5,5,5,0,292,292,282,10,0,0,0,0,83,83,83,83
Solano,15,2022-03-28,169,169,162,7,10930,10930,10474,456,18,0,0,6,448,448,448,448
Sonoma,15,2022-03-28,260,260,250,10,8553,8553,8206,347,13,0,0,1,489,489,489,489
Stanislaus,15,2022-03-28,119,119,111,8,8184,8184,7665,519,28,2,2,3,1687,1687,1685,1685
Sutter,15,2022-03-28,25,25,24,1,1490,1490,1426,64,0,1,1,0,224,224,223,223
Tehama,15,2022-03-28,13,13,12,1,798,798,749,49,3,1,1,0,206,206,205,205
Trinity,15,2022-03-28,0,0,0,0,79,79,74,5,0,0,0,0,20,20,20,20
Tulare,15,2022-03-28,81,81,76,5,7838,7838,7331,507,20,6,6,1,1488,1488,1482,1482
Tuolumne,15,2022-03-28,7,7,7,0,1083,1083,1026,57,3,1,1,0,182,182,181,181
Ventura,15,2022-03-28,335,335,325,10,21204,21207,20593,614,23,6,6,3,1495,1495,1489,1489
Yolo,15,2022-03-28,103,103,99,4,20513,20516,19753,763,3,2,2,0,361,361,359,359
Yuba,15,2022-03-28,26,26,25,1,1214,1214,1165,49,2,2,2,1,119,119,117,117
Alameda,16,2022-04-04,1055,1055,1028,27,56224,56235,54740,1495,40,3,3,3,1868,1868,1865,1865
Amador,16,2022-04-04,2,2,2,0,1107,1107,1060,47,1,0,0,0,86,86,86,86
Butte,16,2022-04-04,44,44,43,1,2582,2582,2526,56,8,2,2,1,429,429,427,427
Calaveras,16,2022-04-04,8,8,8,0,589,589,567,22,0,0,0,0,119,119,119,119
Colusa,16,2022-04-04,2,2,2,0,202,202,196,6,0,0,0,0,21,21,21,21
Contra Costa,16,2022-04-04,544,544,520,24,23558,23563,22527,1036,13,1,1,4,1300,1300,1299,1299
Del Norte,16,2022-04-04,8,8,8,0,1118,1118,1080,38,0,0,0,1,49,49,49,49
El Dorado,16,2022-04-04,50,50,48,2,2717,2717,2617,100,0,1,1,1,214,214,213,213
Fresno,16,2022-04-04,188,188,180,8,16783,16786,16093,693,62,4,4,12,2757,2757,2753,2753
Glenn,16,2022-04-04,3,3,3,0,287,287,277,10,0,0,0,0,53,53,53,53
Humboldt,16,2022-04-04,23,23,22,1,2385,2385,2303,82,5,0,0,2,145,145,145,145
Imperial,16,2022-04-04,39,39,37,2,3441,3441,3312,129,3,0,0,2,944,944,944,944
Inyo,16,2022-04-04,9,9,9,0,182,182,176,6,0,0,0,0,56,56,56,56
Kern,16,2022-04-04,152,152,147,5,16751,16754,16239,515,16,2,2,7,2341,2341,2339,2339
Kings,16,2022-04-04,47,47,45,2,4178,4178,4022,156,2,0,0,1,448,448,448,448
Lake,16,2022-04-04,14,14,13,1,973,973,931,42,0,0,0,0,139,139,139,139
Lassen,16,2022-04-04,5,5,5,0,1284,1284,1247,37,0,0,0,0,62,62,62,62
Los Angeles,16,2022-04-04,5461,5461,5404,57,803346,803505,794895,8610,255,47,47,42,31796,31796,31749,31749
Madera,16,2022-04-04,27,27,26,1,3190,3190,3057,133,3,0,0,1,370,370,370,370
Marin,16,2022-04-04,167,167,160,7,6346,6346,6088,258,3,0,0,1,295,295,295,295
Mariposa,16,2022-04-04,7,7,7,0,235,235,225,10,0,0,0,0,28,28,28,28
Mendocino,16,2022-04-04,25,25,24,1,1196,1196,1130,66,2,0,0,0,124,124,124,124
Merced,16,2022-04-04,58,58,56,2,3350,3350,3243,107,2,2,2,0,818,818,816,816
Modoc,16,2022-04-04,4,4,4,0,43,43,42,1,0,0,0,0,7,7,7,7
Mono,16,2022-04-04,1,1,1,0,142,142,133,9,0,0,0,0,6,6,6,6
Monterey,16,2022-04-04,128,128,120,8,7487,7487,7007,480,8,3,3,0,728,728,725,725
Napa,16,2022-04-04,75,75,73,2,3146,3146,3058,88,1,0,0,1,143,143,143,143
Nevada,16,2022-04-04,30,30,29,1,1447,1447,1388,59,1,1,1,0,131,131,130,130
Orange,16,2022-04-04,989,989,965,24,81527,81543,79511,2032,56,17,17,14,7099,7099,7082,7082
Placer,16,2022-04-04,129,129,123,6,6693,6693,6394,299,19,1,1,5,625,625,624,624
Plumas,16,2022-04-04,4,4,4,0,235,235,225,10,0,0,0,0,13,13,13,13
Riverside,16,2022-04-04,692,692,670,22,38907,38914,37641,1273,36,5,5,8,6447,6447,6442,6442
Sacramento,16,2022-04-04,430,430,415,15,32890,32896,31740,1156,50,8,8,11,3044,3044,3036,3036
San Benito,16,2022-04-04,13,13,13,0,1187,1187,1153,34,0,0,0,0,94,94,94,94
San Bernardino,16,2022-04-04,613,613,597,16,42055,42062,40944,1118,32,11,11,13,7805,7805,7794,7794
San Diego,16,2022-04-04,1544,1544,1527,17,66684,66698,65954,744,88,7,7,29,5335,5335,5328,5328
San Francisco,16,2022-04-04,1001,1001,932,69,28766,28771,26761,2010,20,1,1,3,866,866,865,865
San Joaquin,16,2022-04-04,228,228,219,9,15696,15698,15094,604,9,2,2,8,2248,2248,2246,2246
San Luis Obispo,16,2022-04-04,99,99,96,3,5382,5382,5220,162,2,1,1,1,478,478,477,477
San Mateo,16,2022-04-04,725,725,707,18,29369,29374,28648,726,14,2,2,1,703,703,701,701
Santa Barbara,16,2022-04-04,187,187,181,6,15277,15280,14763,517,7,2,2,1,689,689,687,687
Santa Clara,16,2022-04-04,1492,1492,1474,18,88302,88321,87262,1059,89,2,2,18,2298,2298,2296,2296
Santa Cruz,16,2022-04-04,210,210,204,6,16701,16704,16214,490,4,0,0,2,259,259,259,259
Shasta,16,2022-04-04,29,29,28,1,3320,3320,3203,117,4,1,1,2,559,559,558,558
Siskiyou,16,2022-04-04,2,2,2,0,294,294,286,8,0,0,0,0,83,83,83,83
Solano,16,2022-04-04,173,173,167,6,10220,10221,9885,336,21,1,1,4,449,449,448,448
Sonoma,16,2022-04-04,330,330,320,10,10654,10654,10310,344,9,1,1,1,490,490,489,489
Stanislaus,16,2022-04-04,113,113,107,6,7960,7960,7562,398,21,3,3,5,1690,1690,1687,1687
Sutter,16,2022-04-04,24,24,23,1,1324,1324,1280,44,0,0,0,0,224,224,224,224
Tehama,16,2022-04-04,6,6,6,0,765,765,728,37,0,1,1,0,207,207,206,206
Trinity,16,2022-04-04,1,1,1,0,87,87,83,4,0,0,0,0,20,20,20,20
Tulare,16,2022-04-04,48,48,46,2,7740,7740,7344,396,13,3,3,0,1491,1491,1488,1488
Tuolumne,16,2022-04-04,10,10,10,0,1034,1034,991,43,1,1,1,0,183,183,182,182
Ventura,16,2022-04-04,298,298,291,7,20329,20334,19870,464,19,5,5,5,1500,1500,1495,1495
Yolo,16,2022-04-04,104,104,101,3,26253,26258,25471,787,0,0,0,0,361,361,361,361
Yuba,16,2022-04-04,11,11,11,0,1071,1071,1037,34,4,0,0,1,119,119,119,119
Alameda,17,2022-04-11,1493,1493,1463,30,49841,49854,48825,1029,51,6,6,2,1874,1874,1868,1868
Amador,17,2022-04-11,9,9,9,0,1068,1068,1032,36,1,0,0,0,86,86,86,86
Butte,17,2022-04-11,33,33,32,1,2262,2262,2224,38,3,0,0,1,429,429,429,429
Calaveras,17,2022-04-11,14,14,14,0,649,649,630,19,0,0,0,0,119,119,119,119
Colusa,17,2022-04-11,6,6,6,0,203,203,198,5,0,0,0,0,21,21,21,21
Contra Costa,17,2022-04-11,713,713,689,24,20839,20844,20134,710,15,1,1,5,1301,1301,1300,1300
Del Norte,17,2022-04-11,9,9,9,0,1012,1012,985,27,0,0,0,0,49,49,49,49
El Dorado,17,2022-04-11,48,48,47,1,2508,2508,2436,72,1,0,0,0,214,214,214,214
Fresno,17,2022-04-11,196,196,190,6,15712,15717,15205,512,54,3,3,6,2760,2760,2757,2757
Glenn,17,2022-04-11,2,2,2,0,258,258,251,7,0,0,0,0,53,53,53,53
Humboldt,17,2022-04-11,46,46,45,1,2347,2347,2284,63,5,1,1,2,146,146,145,145
Imperial,17,2022-04-11,28,28,27,1,3442,3442,3341,101,2,1,1,1,945,945,944,944
Inyo,17,2022-04-11,4,4,4,0,188,188,183,5,0,0,0,0,56,56,56,56
Kern,17,2022-04-11,135,135,132,3,16366,16371,15973,398,20,2,2,6,2343,2343,2341,2341
Kings,17,2022-04-11,31,31,30,1,4161,4161,4039,122,3,0,0,0,448,448,448,448
Lake,17,2022-04-11,22,22,21,1,869,869,840,29,0,0,0,0,139,139,139,139
Lassen,17,2022-04-11,1,1,1,0,1292,1292,1263,29,1,0,0,0,62,62,62,62
Los Angeles,17,2022-04-11,6736,6736,6681,55,675656,675821,670114,5707,234,46,46,36,31842,31842,31796,31796
Madera,17,2022-04-11,29,29,28,1,3076,3076,2975,101,4,0,0,2,370,370,370,370
Marin,17,2022-04-11,214,214,207,7,5555,5555,5379,176,6,0,0,1,295,295,295,295
Mariposa,17,2022-04-11,7,7,7,0,246,246,237,9,0,0,0,0,28,28,28,28
Mendocino,17,2022-04-11,32,32,31,1,1158,1158,1108,50,0,0,0,0,124,124,124,124
Merced,17,2022-04-11,68,68,66,2,3222,3222,3141,81,6,2,2,0,820,820,818,818
Modoc,17,2022-04-11,0,0,0,0,40,40,39,1,0,0,0,0,7,7,7,7
Mono,17,2022-04-11,9,9,9,0,170,170,161,9,0,0,0,0,6,6,6,6
Monterey,17,2022-04-11,109,109,103,6,6890,6890,6540,350,9,2,2,0,730,730,728,728
Napa,17,2022-04-11,120,120,117,3,2802,2802,2740,62,1,0,0,0,143,143,143,143
Nevada,17,2022-04-11,45,45,44,1,1431,1431,1385,46,2,0,0,0,131,131,131,131
Orange,17,2022-04-11,1165,1165,1143,22,62009,62024,60845,1179,70,9,9,16,7108,7108,7099,7099
Placer,17,2022-04-11,126,126,122,4,5632,5632,5433,199,18,2,2,2,627,627,625,625
Plumas,17,2022-04-11,7,7,7,0,247,247,239,8,0,0,0,0,13,13,13,13
Riverside,17,2022-04-11,728,728,710,18,37776,37786,36816,970,35,5,5,9,6452,6452,6447,6447
Sacramento,17,2022-04-11,508,508,494,14,30138,30145,29312,833,47,11,11,5,3055,3055,3044,3044
San Benito,17,2022-04-11,16,16,16,0,1182,1182,1155,27,0,0,0,0,94,94,94,94
San Bernardino,17,2022-04-11,916,916,897,19,42013,42025,41149,876,33,5,5,7,7810,7810,7805,7805
San Diego,17,2022-04-11,1833,1833,1817,16,74105,74123,73475,648,91,4,4,22,5339,5339,5335,5335
San Francisco,17,2022-04-11,1182,1182,1117,65,29897,29903,28247,1656,19,6,6,4,872,872,866,866
San Joaquin,17,2022-04-11,221,221,214,7,15222,15225,14764,461,10,0,0,1,2248,2248,2248,2248
San Luis Obispo,17,2022-04-11,120,120,117,3,4908,4908,4792,116,2,1,1,0,479,479,478,478
San Mateo,17,2022-04-11,858,858,842,16,30381,30388,29797,591,8,2,2,1,705,705,703,703
Santa Barbara,17,2022-04-11,303,303,295,8,15120,15125,14723,402,6,2,2,1,691,691,689,689
Santa Clara,17,2022-04-11,1662,1662,1647,15,81519,81540,80780,760,61,4,4,13,2302,2302,2298,2298
Santa Cruz,17,2022-04-11,328,328,321,7,10999,11000,10759,241,7,1,1,0,260,260,259,259
Shasta,17,2022-04-11,18,18,18,0,3123,3123,3036,87,2,1,1,1,560,560,559,559
Siskiyou,17,2022-04-11,1,1,1,0,340,340,332,8,0,0,0,0,83,83,83,83
Solano,17,2022-04-11,249,249,243,6,9417,9418,9175,243,16,0,0,1,449,449,449,449
Sonoma,17,2022-04-11,416,416,406,10,10686,10688,10417,271,8,1,1,0,491,491,490,490
Stanislaus,17,2022-04-11,124,124,119,5,7639,7640,7339,301,22,1,1,1,1691,1691,1690,1690
Sutter,17,2022-04-11,20,20,19,1,1237,1237,1204,33,0,1,1,0,225,225,224,224
Tehama,17,2022-04-11,9,9,9,0,753,753,724,29,1,0,0,0,207,207,207,207
Trinity,17,2022-04-11,0,0,0,0,77,77,74,3,0,0,0,0,20,20,20,20
Tulare,17,2022-04-11,58,58,56,2,7839,7840,7523,317,11,3,3,0,1494,1494,1491,1491
Tuolumne,17,2022-04-11,22,22,21,1,1062,1062,1027,35,1,0,0,0,183,183,183,183
Ventura,17,2022-04-11,323,323,317,6,17587,17592,17279,313,16,2,2,2,1502,1502,1500,1500
Yolo,17,2022-04-11,130,130,127,3,18074,18079,17659,420,1,0,0,0,361,361,361,361
Yuba,17,2022-04-11,15,15,15,0,1019,1019,994,25,2,0,0,0,119,119,119,119
Alameda,18,2022-04-18,1781,1781,1752,29,54179,54196,53314,882,42,4,4,4,1878,1878,1874,1874
Amador,18,2022-04-18,12,12,12,0,1194,1194,1162,32,2,0,0,0,86,86,86,86
Butte,18,2022-04-18,47,47,46,1,2267,2267,2237,30,5,2,2,0,431,431,429,429
Calaveras,18,2022-04-18,16,16,16,0,579,579,566,13,0,1,1,0,120,120,119,119
Colusa,18,2022-04-18,3,3,3,0,157,157,154,3,0,0,0,0,21,21,21,21
Contra Costa,18,2022-04-18,1049,1049,1021,28,24753,24761,24092,669,26,1,1,5,1302,1302,1301,1301
Del Norte,18,2022-04-18,13,13,13,0,1010,1010,989,21,0,0,0,0,49,49,49,49
El Dorado,18,2022-04-18,66,66,65,1,2455,2455,2400,55,0,0,0,0,214,214,214,214
Fresno,18,2022-04-18,247,247,241,6,13859,13864,13513,351,42,4,4,5,2764,2764,2760,2760
Glenn,18,2022-04-18,4,4,4,0,278,278,272,6,0,0,0,0,53,53,53,53
Humboldt,18,2022-04-18,107,107,105,2,2052,2052,2009,43,4,1,1,2,147,147,146,146
Imperial,18,2022-04-18,49,49,48,1,3211,3211,3137,74,2,0,0,1,945,945,945,945
Inyo,18,2022-04-18,2,2,2,0,164,164,161,3,0,0,0,0,56,56,56,56
Kern,18,2022-04-18,150,150,147,3,13634,13639,13382,257,9,1,1,5,2344,2344,2343,2343
Kings,18,2022-04-18,44,44,43,1,3580,3580,3498,82,3,1,1,1,449,449,448,448
Lake,18,2022-04-18,16,16,16,0,782,782,762,20,2,1,1,1,140,140,139,139
Lassen,18,2022-04-18,1,1,1,0,1340,1340,1316,24,0,0,0,0,62,62,62,62
Los Angeles,18,2022-04-18,8318,8319,8266,53,469196,469351,466379,2972,200,35,35,26,31877,31877,31842,31842
Madera,18,2022-04-18,23,23,22,1,2521,2521,2456,65,2,0,0,2,370,370,370,370
Marin,18,2022-04-18,322,322,314,8,5992,5992,5842,150,6,0,0,0,295,295,295,295
Mariposa,18,2022-04-18,18,18,18,0,248,248,241,7,0,0,0,0,28,28,28,28
Mendocino,18,2022-04-18,53,53,51,2,1285,1285,1241,44,0,1,1,0,125,125,124,124
Merced,18,2022-04-18,65,65,64,1,3047,3047,2987,60,3,2,2,0,822,822,820,820
Modoc,18,2022-04-18,1,1,1,0,40,40,39,1,0,0,0,0,7,7,7,7
Mono,18,2022-04-18,9,9,9,0,122,122,117,5,0,0,0,0,6,6,6,6
Monterey,18,2022-04-18,157,157,151,6,6522,6523,6264,259,2,1,1,0,731,731,730,730
Napa,18,2022-04-18,164,164,161,3,2860,2860,2811,49,1,0,0,0,143,143,143,143
Nevada,18,2022-04-18,41,41,40,1,1260,1260,1228,32,1,0,0,0,131,131,131,131
Orange,18,2022-04-18,1446,1446,1425,21,79767,79792,78584,1208,50,6,6,10,7114,7114,7108,7108
Placer,18,2022-04-18,161,161,157,4,4800,4800,4668,132,30,0,0,3,627,627,627,627
Plumas,18,2022-04-18,6,6,6,0,225,225,219,6,0,0,0,0,13,13,13,13
Riverside,18,2022-04-18,938,938,919,19,36721,36733,35993,740,36,7,7,7,6459,6459,6452,6452
Sacramento,18,2022-04-18,715,715,700,15,27855,27863,27262,601,47,9,9,8,3064,3064,3055,3055
San Benito,18,2022-04-18,24,24,24,0,1170,1170,1149,21,0,0,0,0,94,94,94,94
San Bernardino,18,2022-04-18,1058,1058,1041,17,40085,40098,39444,654,35,7,7,8,7817,7817,7810,7810
San Diego,18,2022-04-18,2047,2047,2033,14,67090,67113,66654,459,78,9,9,17,5348,5348,5339,5339
San Francisco,18,2022-04-18,1440,1440,1378,62,30566,30577,29240,1337,27,2,2,2,874,874,872,872
San Joaquin,18,2022-04-18,248,248,242,6,14729,14734,14384,350,8,1,1,4,2249,2249,2248,2248
San Luis Obispo,18,2022-04-18,180,180,177,3,4959,4959,4868,91,2,2,2,0,481,481,479,479
San Mateo,18,2022-04-18,1153,1153,1136,17,30636,30647,30183,464,15,2,2,2,707,707,705,705
Santa Barbara,18,2022-04-18,299,299,293,6,14686,14691,14385,306,8,0,0,0,691,691,691,691
Santa Clara,18,2022-04-18,2238,2238,2222,16,71271,71294,70773,521,67,4,4,16,2306,2306,2302,2302
Santa Cruz,18,2022-04-18,438,438,430,8,12234,12237,12022,215,3,0,0,1,260,260,260,260
Shasta,18,2022-04-18,32,32,31,1,2849,2849,2787,62,2,1,1,2,561,561,560,560
Siskiyou,18,2022-04-18,8,8,8,0,318,318,312,6,0,0,0,0,83,83,83,83
Solano,18,2022-04-18,254,254,249,5,9327,9329,9140,189,6,1,1,1,450,450,449,449
Sonoma,18,2022-04-18,502,502,492,10,11184,11189,10966,223,16,1,1,4,492,492,491,491
Stanislaus,18,2022-04-18,162,162,157,5,7666,7668,7429,239,15,0,0,3,1691,1691,1691,1691
Sutter,18,2022-04-18,24,24,24,0,1173,1173,1149,24,0,0,0,0,225,225,225,225
Tehama,18,2022-04-18,7,7,7,0,685,685,664,21,1,0,0,0,207,207,207,207
Trinity,18,2022-04-18,1,1,1,0,72,72,70,2,0,0,0,0,20,20,20,20
Tulare,18,2022-04-18,77,77,75,2,6658,6659,6449,210,13,0,0,0,1494,1494,1494,1494
Tuolumne,18,2022-04-18,26,26,25,1,1025,1025,999,26,1,0,0,0,183,183,183,183
Ventura,18,2022-04-18,367,367,362,5,16412,16418,16191,227,8,3,3,0,1505,1505,1502,1502
Yolo,18,2022-04-18,217,217,213,4,17914,17919,17590,329,2,1,1,0,362,362,361,361
Yuba,18,2022-04-18,28,28,27,1,996,996,977,19,1,0,0,1,119,119,119,119
Alameda,19,2022-04-25,2539,2539,2507,32,60890,60915,60147,768,44,6,6,4,1884,1884,1878,1878
Amador,19,2022-04-25,26,26,25,1,1316,1316,1289,27,0,0,0,0,86,86,86,86
Butte,19,2022-04-25,66,66,65,1,2596,2596,2569,27,5,1,1,1,432,432,431,431
Calaveras,19,2022-04-25,34,34,33,1,688,688,676,12,0,0,0,0,120,120,120,120
Colusa,19,2022-04-25,3,3,3,0,199,199,196,3,0,0,0,0,21,21,21,21
Contra Costa,19,2022-04-25,1508,1508,1476,32,27265,27278,26704,574,25,3,3,3,1305,1305,1302,1302
Del Norte,19,2022-04-25,25,25,25,0,1104,1104,1086,18,0,0,0,0,49,49,49,49
El Dorado,19,2022-04-25,103,103,101,2,2648,2648,2601,47,1,0,0,0,214,214,214,214
Fresno,19,2022-04-25,335,335,328,7,15799,15807,15492,315,34,3,3,2,2767,2767,2764,2764
Glenn,19,2022-04-25,4,4,4,0,287,287,282,5,0,0,0,0,53,53,53,53
Humboldt,19,2022-04-25,168,168,165,3,2853,2853,2806,47,2,0,0,2,147,147,147,147
Imperial,19,2022-04-25,65,65,64,1,3508,3508,3445,63,4,0,0,1,945,945,945,945
Inyo,19,2022-04-25,7,7,7,0,194,194,191,3,0,0,0,0,56,56,56,56
Kern,19,2022-04-25,251,251,247,4,18299,18306,18035,271,14,2,2,4,2346,2346,2344,2344
Kings,19,2022-04-25,54,54,53,1,4515,4515,4434,81,3,0,0,1,449,449,449,449
Lake,19,2022-04-25,21,21,21,0,887,887,869,18,0,0,0,0,140,140,140,140
Lassen,19,2022-04-25,1,1,1,0,1556,1556,1534,22,0,0,0,0,62,62,62,62
Los Angeles,19,2022-04-25,11370,11375,11318,57,884895,885271,880784,4487,207,29,29,25,31906,31906,31877,31877
Madera,19,2022-04-25,44,44,43,1,2916,2916,2857,59,2,0,0,0,370,370,370,370
Marin,19,2022-04-25,329,329,323,6,6440,6441,6315,126,7,0,0,0,295,295,295,295
Mariposa,19,2022-04-25,9,9,9,0,205,205,201,4,0,0,0,0,28,28,28,28
Mendocino,19,2022-04-25,55,55,54,1,1254,1254,1220,34,0,1,1,0,126,126,125,125
Merced,19,2022-04-25,99,99,98,1,3030,3030,2984,46,5,0,0,0,822,822,822,822
Modoc,19,2022-04-25,1,1,1,0,41,41,40,1,0,0,0,0,7,7,7,7
Mono,19,2022-04-25,4,4,4,0,94,94,91,3,0,0,0,0,6,6,6,6
Monterey,19,2022-04-25,322,322,312,10,8006,8009,7759,250,5,1,1,0,732,732,731,731
Napa,19,2022-04-25,199,199,196,3,3376,3376,3330,46,2,0,0,0,143,143,143,143
Nevada,19,2022-04-25,52,52,51,1,1399,1399,1371,28,1,0,0,1,131,131,131,131
Orange,19,2022-04-25,1970,1970,1947,23,86618,86654,85631,1023,53,7,7,13,7121,7121,7114,7114
Placer,19,2022-04-25,239,239,234,5,6091,6092,5960,132,18,0,0,4,627,627,627,627
Plumas,19,2022-04-25,2,2,2,0,228,228,223,5,0,0,0,0,13,13,13,13
Riverside,19,2022-04-25,1304,1304,1284,20,40532,40549,39910,639,33,4,4,5,6463,6463,6459,6459
Sacramento,19,2022-04-25,1023,1023,1006,17,31869,31882,31343,539,44,4,4,4,3068,3068,3064,3064
San Benito,19,2022-04-25,34,34,34,0,1118,1118,1102,16,0,0,0,0,94,94,94,94
San Bernardino,19,2022-04-25,1292,1292,1276,16,42976,42994,42446,548,21,10,10,7,7827,7827,7817,7817
San Diego,19,2022-04-25,3013,3013,2997,16,74324,74356,73960,396,86,5,5,10,5353,5353,5348,5348
San Francisco,19,2022-04-25,2001,2001,1933,68,32532,32545,31428,1117,23,1,1,3,875,875,874,874
San Joaquin,19,2022-04-25,387,387,380,7,15463,15469,15180,289,12,0,0,1,2249,2249,2249,2249
San Luis Obispo,19,2022-04-25,209,209,206,3,5036,5037,4964,73,6,0,0,0,481,481,481,481
San Mateo,19,2022-04-25,1538,1538,1520,18,32870,32885,32497,388,14,1,1,3,708,708,707,707
Santa Barbara,19,2022-04-25,371,371,365,6,15227,15233,14986,247,7,2,2,1,693,693,691,691
Santa Clara,19,2022-04-25,3142,3142,3124,18,77133,77166,76732,434,73,4,4,9,2310,2310,2306,2306
Santa Cruz,19,2022-04-25,474,474,468,6,20467,20477,20195,282,4,1,1,0,261,261,260,260
Shasta,19,2022-04-25,48,48,47,1,3317,3317,3261,56,3,0,0,1,561,561,561,561
Siskiyou,19,2022-04-25,7,7,7,0,322,322,318,4,0,0,0,0,83,83,83,83
Solano,19,2022-04-25,479,479,471,8,10651,10656,10488,168,11,0,0,2,450,450,450,450
Sonoma,19,2022-04-25,674,674,664,10,12065,12070,11882,188,19,0,0,2,492,492,492,492
Stanislaus,19,2022-04-25,241,241,235,6,7899,7901,7709,192,25,4,4,0,1695,1695,1691,1691
Sutter,19,2022-04-25,39,39,38,1,1399,1399,1376,23,0,1,1,0,226,226,225,225
Tehama,19,2022-04-25,17,17,17,0,711,711,694,17,1,0,0,0,207,207,207,207
Trinity,19,2022-04-25,1,1,1,0,72,72,70,2,0,0,0,0,20,20,20,20
Tulare,19,2022-04-25,90,90,88,2,6912,6914,6742,172,11,1,1,0,1495,1495,1494,1494
Tuolumne,19,2022-04-25,43,43,42,1,1124,1124,1101,23,2,0,0,0,183,183,183,183
Ventura,19,2022-04-25,604,604,597,7,18901,18908,18703,205,10,1,1,3,1506,1506,1505,1505
Yolo,19,2022-04-25,272,272,268,4,19381,19389,19111,278,1,0,0,0,362,362,362,362
Yuba,19,2022-04-25,31,31,31,0,1106,1106,1089,17,0,0,0,0,119,119,119,119
Alameda,20,2022-05-02,3377,3377,3344,33,68019,68055,67378,677,42,2,2,5,1886,1886,1884,1884
Amador,20,2022-05-02,19,19,19,0,1335,1335,1313,22,0,0,0,0,86,86,86,86
Butte,20,2022-05-02,91,91,90,1,2385,2385,2366,19,4,2,2,0,434,434,432,432
Calaveras,20,2022-05-02,23,23,23,0,727,727,717,10,0,0,0,0,120,120,120,120
Colusa,20,2022-05-02,2,2,2,0,203,203,201,2,0,0,0,0,21,21,21,21
Contra Costa,20,2022-05-02,1881,1881,1850,31,29263,29278,28795,483,40,2,2,5,1307,1307,1305,1305
Del Norte,20,2022-05-02,42,42,41,1,1202,1202,1187,15,1,0,0,0,49,49,49,49
El Dorado,20,2022-05-02,140,140,138,2,2756,2756,2718,38,1,1,1,0,215,215,214,214
Fresno,20,2022-05-02,503,503,495,8,16611,16620,16361,259,42,3,3,4,2770,2770,2767,2767
Glenn,20,2022-05-02,4,4,4,0,252,252,249,3,0,0,0,0,53,53,53,53
Humboldt,20,2022-05-02,269,269,266,3,2941,2941,2903,38,6,0,0,2,147,147,147,147
Imperial,20,2022-05-02,123,123,121,2,3637,3637,3586,51,1,0,0,1,945,945,945,945
Inyo,20,2022-05-02,2,2,2,0,179,179,177,2,0,0,0,0,56,56,56,56
Kern,20,2022-05-02,294,294,291,3,17931,17940,17732,208,10,0,0,5,2346,2346,2346,2346
Kings,20,2022-05-02,59,59,58,1,4847,4848,4780,68,3,0,0,1,449,449,449,449
Lake,20,2022-05-02,29,29,29,0,1003,1003,987,16,1,0,0,0,140,140,140,140
Lassen,20,2022-05-02,8,8,8,0,1608,1608,1590,18,0,0,0,0,62,62,62,62
Los Angeles,20,2022-05-02,14809,14817,14759,58,917593,918073,914429,3644,214,23,23,22,31929,31929,31906,31906
Madera,20,2022-05-02,76,76,75,1,3307,3307,3255,52,5,0,0,0,370,370,370,370
Marin,20,2022-05-02,427,427,421,6,6544,6548,6448,100,10,0,0,0,295,295,295,295
Mariposa,20,2022-05-02,7,7,7,0,244,244,240,4,0,0,0,0,28,28,28,28
Mendocino,20,2022-05-02,60,60,59,1,1222,1222,1196,26,0,0,0,0,126,126,126,126
Merced,20,2022-05-02,131,131,129,2,3283,3283,3244,39,8,4,4,0,826,826,822,822
Modoc,20,2022-05-02,0,0,0,0,36,37,36,1,0,0,0,0,7,7,7,7
Mono,20,2022-05-02,6,6,6,0,106,106,103,3,0,0,0,0,6,6,6,6
Monterey,20,2022-05-02,356,356,347,9,8386,8391,8185,206,8,1,1,0,733,733,732,732
Napa,20,2022-05-02,229,229,227,2,3548,3548,3510,38,4,0,0,0,143,143,143,143
Nevada,20,2022-05-02,80,80,79,1,1535,1535,1511,24,2,0,0,0,131,131,131,131
Orange,20,2022-05-02,2640,2640,2616,24,87495,87542,86733,809,61,5,5,13,7126,7126,7121,7121
Placer,20,2022-05-02,306,306,301,5,6373,6376,6268,108,20,0,0,4,627,627,627,627
Plumas,20,2022-05-02,9,9,9,0,256,256,252,4,0,0,0,0,13,13,13,13
Riverside,20,2022-05-02,2050,2050,2025,25,42957,42979,42449,530,37,3,3,5,6466,6466,6463,6463
Sacramento,20,2022-05-02,1393,1393,1375,18,33656,33675,33231,444,43,5,5,9,3073,3073,3068,3068
San Benito,20,2022-05-02,50,50,49,1,1285,1285,1271,14,0,0,0,0,94,94,94,94
San Bernardino,20,2022-05-02,1490,1490,1475,15,43535,43557,43123,434,30,7,7,6,7834,7834,7827,7827
San Diego,20,2022-05-02,4122,4122,4105,17,72930,72967,72665,302,79,3,3,13,5356,5356,5353,5353
San Francisco,20,2022-05-02,2423,2423,2358,65,35538,35556,34597,959,39,3,3,13,878,878,875,875
San Joaquin,20,2022-05-02,546,546,538,8,15207,15214,14992,222,14,1,1,1,2250,2250,2249,2249
San Luis Obispo,20,2022-05-02,249,249,246,3,5109,5110,5052,58,5,2,2,0,483,483,481,481
San Mateo,20,2022-05-02,1819,1819,1802,17,35990,36010,35676,334,22,2,2,5,710,710,708,708
Santa Barbara,20,2022-05-02,440,440,435,5,15309,15316,15121,195,10,0,0,2,693,693,693,693
Santa Clara,20,2022-05-02,4358,4359,4340,19,96570,96620,96191,429,88,5,5,15,2315,2315,2310,2310
Santa Cruz,20,2022-05-02,678,678,671,7,22027,22038,21800,238,2,1,1,0,262,262,261,261
Shasta,20,2022-05-02,68,68,67,1,3451,3452,3406,46,7,0,0,1,561,561,561,561
Siskiyou,20,2022-05-02,9,9,9,0,329,329,326,3,0,0,0,0,83,83,83,83
Solano,20,2022-05-02,624,624,616,8,11785,11790,11644,146,20,0,0,2,450,450,450,450
Sonoma,20,2022-05-02,898,898,887,11,12794,12800,12645,155,16,1,1,4,493,493,492,492
Stanislaus,20,2022-05-02,269,269,264,5,8083,8088,7934,154,22,0,0,3,1695,1695,1695,1695
Sutter,20,2022-05-02,47,47,46,1,1263,1263,1247,16,0,1,1,0,227,227,226,226
Tehama,20,2022-05-02,17,17,17,0,700,700,687,13,0,0,0,0,207,207,207,207
Trinity,20,2022-05-02,1,1,1,0,84,84,82,2,0,0,0,0,20,20,20,20
Tulare,20,2022-05-02,163,163,160,3,7286,7291,7149,142,10,3,3,0,1498,1498,1495,1495
Tuolumne,20,2022-05-02,94,94,93,1,1298,1298,1278,20,5,0,0,0,183,183,183,183
Ventura,20,2022-05-02,744,744,738,6,19920,19931,19762,169,15,4,4,1,1510,1510,1506,1506
Yolo,20,2022-05-02,352,352,348,4,18791,18802,18591,211,1,1,1,0,363,363,362,362
Yuba,20,2022-05-02,46,46,45,1,1052,1052,1040,12,2,0,0,1,119,119,119,119
Alameda,21,2022-05-09,4152,4153,4121,32,71485,71528,70974,554,44,7,7,6,1893,1893,1886,1886
Amador,21,2022-05-09,25,25,25,0,1518,1518,1499,19,0,0,0,0,86,86,86,86
Butte,21,2022-05-09,115,115,114,1,2412,2412,2397,15,5,0,0,0,434,434,434,434
Calaveras,21,2022-05-09,33,33,33,0,689,689,681,8,1,0,0,0,120,120,120,120
Colusa,21,2022-05-09,3,3,3,0,215,215,213,2,0,0,0,0,21,21,21,21
Contra Costa,21,2022-05-09,2516,2516,2484,32,30522,30540,30145,395,48,4,4,12,1311,1311,1307,1307
Del Norte,21,2022-05-09,49,49,49,0,1358,1358,1344,14,0,0,0,0,49,49,49,49
El Dorado,21,2022-05-09,179,179,177,2,2889,2889,2858,31,3,0,0,1,215,215,215,215
Fresno,21,2022-05-09,745,745,736,9,17757,17769,17552,217,29,1,1,1,2771,2771,2770,2770
Glenn,21,2022-05-09,8,8,8,0,228,228,226,2,0,0,0,0,53,53,53,53
Humboldt,21,2022-05-09,273,273,270,3,3149,3149,3117,32,5,0,0,2,147,147,147,147
Imperial,21,2022-05-09,131,131,130,1,3821,3822,3780,42,0,0,0,1,945,945,945,945
Inyo,21,2022-05-09,26,26,26,0,236,236,234,2,0,0,0,0,56,56,56,56
Kern,21,2022-05-09,467,467,463,4,18698,18710,18541,169,18,2,2,2,2348,2348,2346,2346
Kings,21,2022-05-09,91,91,90,1,4936,4940,4886,54,1,0,0,1,449,449,449,449
Lake,21,2022-05-09,30,30,30,0,1029,1029,1016,13,1,0,0,0,140,140,140,140
Lassen,21,2022-05-09,7,7,7,0,1689,1689,1675,14,0,0,0,0,62,62,62,62
Los Angeles,21,2022-05-09,18426,18438,18382,56,926870,927429,924563,2866,225,29,29,27,31958,31958,31929,31929
Madera,21,2022-05-09,132,132,130,2,3725,3726,3680,46,3,0,0,0,370,370,370,370
Marin,21,2022-05-09,711,711,703,8,7781,7786,7693,93,12,0,0,0,295,295,295,295
Mariposa,21,2022-05-09,32,32,32,0,287,287,283,4,0,0,0,0,28,28,28,28
Mendocino,21,2022-05-09,92,92,91,1,1264,1264,1243,21,0,1,1,0,127,127,126,126
Merced,21,2022-05-09,198,198,196,2,3432,3432,3400,32,4,1,1,0,827,827,826,826
Modoc,21,2022-05-09,2,2,2,0,41,42,41,1,0,0,0,0,7,7,7,7
Mono,21,2022-05-09,9,9,9,0,113,113,111,2,0,0,0,0,6,6,6,6
Monterey,21,2022-05-09,440,440,432,8,9377,9383,9202,181,11,0,0,0,733,733,733,733
Napa,21,2022-05-09,233,233,231,2,3121,3121,3095,26,2,0,0,0,143,143,143,143
Nevada,21,2022-05-09,102,102,101,1,1655,1655,1635,20,5,0,0,0,131,131,131,131
Orange,21,2022-05-09,3518,3518,3493,25,91790,91845,91182,663,84,8,8,17,7134,7134,7126,7126
Placer,21,2022-05-09,537,537,530,7,6752,6757,6667,90,25,0,0,2,627,627,627,627
Plumas,21,2022-05-09,13,13,13,0,274,274,271,3,0,0,0,0,13,13,13,13
Riverside,21,2022-05-09,2402,2402,2379,23,45141,45168,44732,436,42,4,4,8,6470,6470,6466,6466
Sacramento,21,2022-05-09,2256,2256,2233,23,36121,36142,35768,374,62,4,4,10,3077,3077,3073,3073
San Benito,21,2022-05-09,74,74,73,1,1433,1433,1421,12,0,0,0,0,94,94,94,94
San Bernardino,21,2022-05-09,1938,1938,1923,15,46593,46622,46259,363,31,5,5,4,7839,7839,7834,7834
San Diego,21,2022-05-09,5222,5223,5206,17,87126,87178,86895,283,98,2,2,11,5358,5358,5356,5356
San Francisco,21,2022-05-09,3050,3050,2986,64,38188,38211,37402,809,52,6,6,9,884,884,878,878
San Joaquin,21,2022-05-09,772,772,763,9,16049,16059,15876,183,11,1,1,3,2251,2251,2250,2250
San Luis Obispo,21,2022-05-09,290,290,287,3,5221,5225,5179,46,0,0,0,0,483,483,483,483
San Mateo,21,2022-05-09,2315,2315,2299,16,37695,37716,37443,273,26,3,3,1,713,713,710,710
Santa Barbara,21,2022-05-09,638,638,632,6,15589,15598,15443,155,10,0,0,3,693,693,693,693
Santa Clara,21,2022-05-09,5623,5625,5606,19,106179,106243,105875,368,87,3,3,23,2318,2318,2315,2315
Santa Cruz,21,2022-05-09,729,729,723,6,23980,23994,23792,202,2,0,0,0,262,262,262,262
Shasta,21,2022-05-09,107,107,106,1,3301,3302,3268,34,7,0,0,0,561,561,561,561
Siskiyou,21,2022-05-09,16,16,16,0,285,285,283,2,0,0,0,0,83,83,83,83
Solano,21,2022-05-09,920,920,911,9,12318,12325,12205,120,20,0,0,1,450,450,450,450
Sonoma,21,2022-05-09,1179,1179,1168,11,13977,13985,13852,133,18,1,1,2,494,494,493,493
Stanislaus,21,2022-05-09,460,460,453,7,8942,8947,8814,133,27,0,0,2,1695,1695,1695,1695
Sutter,21,2022-05-09,61,61,60,1,1565,1565,1549,16,0,0,0,0,227,227,227,227
Tehama,21,2022-05-09,28,28,28,0,692,692,682,10,1,0,0,0,207,207,207,207
Trinity,21,2022-05-09,4,4,4,0,69,69,68,1,0,0,0,0,20,20,20,20
Tulare,21,2022-05-09,183,183,180,3,7633,7638,7522,116,11,1,1,1,1499,1499,1498,1498
Tuolumne,21,2022-05-09,71,71,70,1,1429,1429,1412,17,1,2,2,0,185,185,183,183
Ventura,21,2022-05-09,1151,1151,1143,8,20949,20962,20823,139,15,1,1,2,1511,1511,1510,1510
Yolo,21,2022-05-09,493,493,489,4,19655,19667,19495,172,1,0,0,1,363,363,363,363
Yuba,21,2022-05-09,77,77,76,1,1241,1241,1229,12,2,0,0,0,119,119,119,119
Alameda,22,2022-05-16,4995,4999,4969,30,75028,75079,74624,455,73,8,8,6,1901,1901,1893,1893
Amador,22,2022-05-16,54,54,53,1,1672,1672,1655,17,0,0,0,0,86,86,86,86
Butte,22,2022-05-16,207,207,206,1,2664,2664,2651,13,7,2,2,0,436,436,434,434
Calaveras,22,2022-05-16,43,43,43,0,765,765,758,7,0,1,1,1,121,121,120,120
Colusa,22,2022-05-16,7,7,7,0,217,217,215,2,0,0,0,0,21,21,21,21
Contra Costa,22,2022-05-16,3488,3489,3454,35,33513,33536,33197,339,50,5,5,7,1316,1316,1311,1311
Del Norte,22,2022-05-16,175,175,174,1,1859,1859,1844,15,0,0,0,0,49,49,49,49
El Dorado,22,2022-05-16,266,266,264,2,3039,3039,3013,26,5,0,0,1,215,215,215,215
Fresno,22,2022-05-16,1140,1140,1129,11,18942,18955,18775,180,46,2,2,6,2773,2773,2771,2771
Glenn,22,2022-05-16,15,15,15,0,259,259,257,2,0,0,0,0,53,53,53,53
Humboldt,22,2022-05-16,274,274,272,2,3253,3253,3227,26,9,1,1,2,148,148,147,147
Imperial,22,2022-05-16,207,207,205,2,4266,4268,4231,37,1,0,0,1,945,945,945,945
Inyo,22,2022-05-16,19,19,19,0,228,228,226,2,1,0,0,0,56,56,56,56
Kern,22,2022-05-16,687,687,682,5,19978,19992,19851,141,22,3,3,3,2351,2351,2348,2348
Kings,22,2022-05-16,220,220,218,2,5418,5422,5376,46,0,1,1,0,450,450,449,449
Lake,22,2022-05-16,75,75,74,1,1118,1118,1107,11,2,0,0,0,140,140,140,140
Lassen,22,2022-05-16,21,21,21,0,1704,1704,1693,11,1,0,0,0,62,62,62,62
Los Angeles,22,2022-05-16,21417,21430,21379,51,938067,938720,936458,2262,283,39,39,44,31997,31997,31958,31958
Madera,22,2022-05-16,199,199,197,2,3632,3632,3597,35,2,0,0,0,370,370,370,370
Marin,22,2022-05-16,816,816,808,8,8391,8396,8317,79,12,0,0,0,295,295,295,295
Mariposa,22,2022-05-16,23,23,23,0,340,340,336,4,0,0,0,0,28,28,28,28
Mendocino,22,2022-05-16,99,99,98,1,1326,1326,1309,17,0,1,1,1,128,128,127,127
Merced,22,2022-05-16,314,314,312,2,4010,4011,3982,29,8,1,1,1,828,828,827,827
Modoc,22,2022-05-16,4,4,4,0,43,44,43,1,0,0,0,0,7,7,7,7
Mono,22,2022-05-16,11,11,11,0,112,112,110,2,0,0,0,0,6,6,6,6
Monterey,22,2022-05-16,509,509,501,8,9600,9606,9461,145,6,1,1,0,734,734,733,733
Napa,22,2022-05-16,299,299,297,2,3740,3741,3717,24,3,0,0,0,143,143,143,143
Nevada,22,2022-05-16,146,146,145,1,1834,1834,1817,17,2,0,0,0,131,131,131,131
Orange,22,2022-05-16,4557,4558,4533,25,94692,94758,94225,533,74,7,7,15,7141,7141,7134,7134
Placer,22,2022-05-16,742,742,734,8,7777,7782,7701,81,43,2,2,3,629,629,627,627
Plumas,22,2022-05-16,48,48,48,0,242,242,240,2,1,0,0,0,13,13,13,13
Riverside,22,2022-05-16,3345,3346,3321,25,47986,48019,47658,361,65,1,1,6,6471,6471,6470,6470
Sacramento,22,2022-05-16,3137,3138,3113,25,39840,39867,39545,322,89,8,8,12,3085,3085,3077,3077
San Benito,22,2022-05-16,110,110,109,1,1529,1529,1519,10,1,0,0,0,94,94,94,94
San Bernardino,22,2022-05-16,2473,2473,2458,15,49170,49204,48905,299,44,8,8,5,7847,7847,7839,7839
San Diego,22,2022-05-16,6666,6671,6654,17,94783,94847,94607,240,91,6,6,25,5364,5364,5358,5358
San Francisco,22,2022-05-16,3413,3414,3358,56,39358,39386,38733,653,68,5,5,8,889,889,884,884
San Joaquin,22,2022-05-16,1201,1201,1190,11,19000,19014,18845,169,16,1,1,1,2252,2252,2251,2251
San Luis Obispo,22,2022-05-16,426,426,423,3,6056,6061,6019,42,3,0,0,0,483,483,483,483
San Mateo,22,2022-05-16,2776,2776,2761,15,39916,39944,39719,225,39,1,1,1,714,714,713,713
Santa Barbara,22,2022-05-16,913,913,906,7,17042,17054,16922,132,13,0,0,2,693,693,693,693
Santa Clara,22,2022-05-16,7204,7211,7192,19,113213,113292,112986,306,111,9,9,15,2327,2327,2318,2318
Santa Cruz,22,2022-05-16,808,808,803,5,20748,20762,20622,140,5,0,0,0,262,262,262,262
Shasta,22,2022-05-16,126,126,125,1,3812,3815,3784,31,6,0,0,1,561,561,561,561
Siskiyou,22,2022-05-16,19,19,19,0,372,372,370,2,0,0,0,0,83,83,83,83
Solano,22,2022-05-16,1279,1279,1269,10,14198,14208,14101,107,29,0,0,2,450,450,450,450
Sonoma,22,2022-05-16,1573,1573,1562,11,15543,15554,15439,115,28,0,0,4,494,494,494,494
Stanislaus,22,2022-05-16,749,749,740,9,9951,9958,9842,116,33,2,2,5,1697,1697,1695,1695
Sutter,22,2022-05-16,109,109,108,1,1828,1828,1814,14,0,0,0,0,227,227,227,227
Tehama,22,2022-05-16,38,38,38,0,840,840,831,9,0,1,1,1,208,208,207,207
Trinity,22,2022-05-16,5,5,5,0,69,69,68,1,0,0,0,0,20,20,20,20
Tulare,22,2022-05-16,397,397,392,5,8312,8318,8219,99,14,1,1,0,1500,1500,1499,1499
Tuolumne,22,2022-05-16,139,139,138,1,1448,1448,1434,14,1,1,1,0,186,186,185,185
Ventura,22,2022-05-16,1552,1552,1544,8,23859,23876,23752,124,34,2,2,2,1513,1513,1511,1511
Yolo,22,2022-05-16,688,688,683,5,22153,22170,22018,152,0,0,0,1,363,363,363,363
Yuba,22,2022-05-16,119,119,118,1,1335,1335,1325,10,4,0,0,0,119,119,119,119
Alameda,23,2022-05-23,5602,5607,5581,26,77858,77917,77549,368,76,4,4,4,1905,1905,1901,1901
Amador,23,2022-05-23,80,80,79,1,1441,1441,1430,11,0,0,0,0,86,86,86,86
Butte,23,2022-05-23,284,284,283,1,2766,2767,2756,11,5,1,1,1,437,437,436,436
Calaveras,23,2022-05-23,52,52,52,0,744,744,739,5,0,1,1,0,122,122,121,121
Colusa,23,2022-05-23,7,7,7,0,232,232,231,1,0,0,0,0,21,21,21,21
Contra Costa,23,2022-05-23,3834,3835,3805,30,35371,35398,35118,280,71,10,10,7,1326,1326,1316,1316
Del Norte,23,2022-05-23,67,67,67,0,1346,1346,1338,8,0,1,1,0,50,50,49,49
El Dorado,23,2022-05-23,359,359,357,2,3419,3420,3397,23,6,2,2,0,217,217,215,215
Fresno,23,2022-05-23,1649,1649,1637,12,21269,21285,21127,158,63,2,2,8,2775,2775,2773,2773
Glenn,23,2022-05-23,26,26,26,0,273,273,271,2,0,0,0,0,53,53,53,53
Humboldt,23,2022-05-23,245,245,244,1,2911,2911,2893,18,14,1,1,3,149,149,148,148
Imperial,23,2022-05-23,343,343,341,2,4740,4744,4712,32,2,0,0,1,945,945,945,945
Inyo,23,2022-05-23,27,27,27,0,221,221,220,1,0,0,0,0,56,56,56,56
Kern,23,2022-05-23,1006,1006,1001,5,21275,21291,21174,117,34,0,0,7,2351,2351,2351,2351
Kings,23,2022-05-23,250,250,248,2,5644,5649,5611,38,1,0,0,0,450,450,450,450
Lake,23,2022-05-23,96,96,95,1,1238,1238,1228,10,1,0,0,1,140,140,140,140
Lassen,23,2022-05-23,41,41,41,0,1763,1763,1754,9,0,0,0,0,62,62,62,62
Los Angeles,23,2022-05-23,27747,27768,27716,52,946448,947167,945388,1779,366,31,31,53,32028,32028,31997,31997
Madera,23,2022-05-23,216,216,214,2,3765,3767,3738,29,1,0,0,2,370,370,370,370
Marin,23,2022-05-23,798,798,792,6,8785,8791,8727,64,15,0,0,1,295,295,295,295
Mariposa,23,2022-05-23,32,32,32,0,340,340,337,3,0,0,0,0,28,28,28,28
Mendocino,23,2022-05-23,150,150,149,1,1659,1659,1642,17,3,1,1,1,129,129,128,128
Merced,23,2022-05-23,409,409,407,2,4201,4205,4181,24,4,0,0,0,828,828,828,828
Modoc,23,2022-05-23,2,2,2,0,40,41,40,1,0,0,0,0,7,7,7,7
Mono,23,2022-05-23,14,14,14,0,163,163,161,2,0,0,0,0,6,6,6,6
Monterey,23,2022-05-23,701,701,693,8,9613,9619,9506,113,17,1,1,1,735,735,734,734
Napa,23,2022-05-23,332,332,330,2,3938,3943,3923,20,5,0,0,0,143,143,143,143
Nevada,23,2022-05-23,150,150,149,1,1904,1904,1890,14,2,0,0,0,131,131,131,131
Orange,23,2022-05-23,5625,5630,5606,24,94934,95006,94588,418,111,11,11,20,7152,7152,7141,7141
Placer,23,2022-05-23,887,887,880,7,7834,7839,7775,64,49,2,2,4,631,631,629,629
Plumas,23,2022-05-23,46,46,46,0,279,279,277,2,0,0,0,0,13,13,13,13
Riverside,23,2022-05-23,4456,4459,4433,26,52424,52464,52156,308,73,6,6,10,6477,6477,6471,6471
Sacramento,23,2022-05-23,3893,3894,3870,24,41040,41072,40812,260,122,7,7,10,3092,3092,3085,3085
San Benito,23,2022-05-23,168,168,167,1,1668,1668,1659,9,0,0,0,0,94,94,94,94
San Bernardino,23,2022-05-23,3324,3325,3309,16,50646,50685,50445,240,53,3,3,10,7850,7850,7847,7847
San Diego,23,2022-05-23,8841,8848,8831,17,103288,103367,103162,205,138,4,4,20,5368,5368,5364,5364
San Francisco,23,2022-05-23,3605,3607,3560,47,41636,41667,41127,540,85,6,6,9,895,895,889,889
San Joaquin,23,2022-05-23,1549,1549,1538,11,20954,20970,20824,146,20,3,3,7,2255,2255,2252,2252
San Luis Obispo,23,2022-05-23,669,669,665,4,7270,7275,7236,39,10,3,3,0,486,486,483,483
San Mateo,23,2022-05-23,3155,3155,3141,14,40829,40861,40681,180,35,0,0,0,714,714,714,714
Santa Barbara,23,2022-05-23,1064,1064,1058,6,17776,17790,17682,108,20,0,0,3,693,693,693,693
Santa Clara,23,2022-05-23,7829,7836,7820,16,111312,111396,111161,235,126,7,7,18,2334,2334,2327,2327
Santa Cruz,23,2022-05-23,505,505,502,3,7816,7821,7781,40,16,0,0,0,262,262,262,262
Shasta,23,2022-05-23,195,195,194,1,3606,3609,3586,23,4,1,1,3,562,562,561,561
Siskiyou,23,2022-05-23,29,29,29,0,364,364,362,2,1,0,0,0,83,83,83,83
Solano,23,2022-05-23,1513,1513,1504,9,14913,14925,14837,88,24,1,1,3,451,451,450,450
Sonoma,23,2022-05-23,1488,1488,1479,9,16335,16348,16253,95,34,2,2,3,496,496,494,494
Stanislaus,23,2022-05-23,873,873,865,8,10701,10709,10611,98,37,2,2,3,1699,1699,1697,1697
Sutter,23,2022-05-23,141,141,140,1,1912,1912,1901,11,0,1,1,0,228,228,227,227
Tehama,23,2022-05-23,50,50,50,0,812,812,805,7,1,0,0,1,208,208,208,208
Trinity,23,2022-05-23,3,3,3,0,90,90,89,1,0,0,0,0,20,20,20,20
Tulare,23,2022-05-23,558,558,553,5,9066,9072,8988,84,26,0,0,0,1500,1500,1500,1500
Tuolumne,23,2022-05-23,136,136,135,1,1576,1576,1564,12,0,1,1,0,187,187,186,186
Ventura,23,2022-05-23,1917,1917,1909,8,24020,24038,23941,97,36,1,1,1,1514,1514,1513,1513
Yolo,23,2022-05-23,731,731,727,4,22658,22675,22553,122,1,1,1,1,364,364,363,363
Yuba,23,2022-05-23,151,151,150,1,1453,1453,1445,8,6,0,0,1,119,119,119,119
Alameda,24,2022-05-30,4914,4918,4900,18,60793,60843,60614,229,95,4,4,7,1909,1909,1905,1905
Amador,24,2022-05-30,89,89,88,1,1191,1191,1184,7,0,1,1,0,87,87,86,86
Butte,24,2022-05-30,276,276,275,1,2708,2708,2700,8,20,0,0,1,437,437,437,437
Calaveras,24,2022-05-30,54,54,54,0,617,617,614,3,0,0,0,0,122,122,122,122
Colusa,24,2022-05-30,13,13,13,0,170,170,169,1,0,0,0,0,21,21,21,21
Contra Costa,24,2022-05-30,3320,3322,3301,21,28986,29011,28829,182,65,7,7,9,1333,1333,1326,1326
Del Norte,24,2022-05-30,36,36,36,0,975,975,970,5,2,1,1,0,51,51,50,50
El Dorado,24,2022-05-30,332,332,330,2,2940,2941,2925,16,6,2,2,2,219,219,217,217
Fresno,24,2022-05-30,1667,1667,1657,10,19451,19467,19352,115,71,6,6,7,2781,2781,2775,2775
Glenn,24,2022-05-30,27,27,27,0,290,290,289,1,2,0,0,0,53,53,53,53
Humboldt,24,2022-05-30,181,181,180,1,2296,2296,2285,11,10,0,0,5,149,149,149,149
Imperial,24,2022-05-30,332,332,330,2,4136,4140,4118,22,2,1,1,2,946,946,945,945
Inyo,24,2022-05-30,18,18,18,0,151,151,150,1,0,0,0,0,56,56,56,56
Kern,24,2022-05-30,1078,1078,1073,5,17986,18001,17922,79,36,0,0,6,2351,2351,2351,2351
Kings,24,2022-05-30,292,292,290,2,4664,4668,4643,25,2,0,0,1,450,450,450,450
Lake,24,2022-05-30,89,89,88,1,994,994,988,6,1,0,0,0,140,140,140,140
Lassen,24,2022-05-30,50,50,50,0,1615,1615,1608,7,1,0,0,0,62,62,62,62
Los Angeles,24,2022-05-30,26043,26065,26026,39,746779,747400,746273,1127,425,47,47,54,32075,32075,32028,32028
Madera,24,2022-05-30,235,235,234,1,3314,3317,3297,20,4,0,0,1,370,370,370,370
Marin,24,2022-05-30,650,650,646,4,7153,7157,7115,42,16,3,3,1,298,298,295,295
Mariposa,24,2022-05-30,39,39,39,0,303,303,301,2,0,0,0,0,28,28,28,28
Mendocino,24,2022-05-30,137,137,136,1,1264,1264,1254,10,4,0,0,1,129,129,129,129
Merced,24,2022-05-30,365,365,363,2,3406,3410,3395,15,6,0,0,2,828,828,828,828
Modoc,24,2022-05-30,4,4,4,0,38,39,38,1,0,0,0,0,7,7,7,7
Mono,24,2022-05-30,6,6,6,0,81,81,80,1,0,0,0,0,6,6,6,6
Monterey,24,2022-05-30,526,526,521,5,7149,7155,7088,67,19,1,1,1,736,736,735,735
Napa,24,2022-05-30,313,313,312,1,3181,3184,3171,13,4,0,0,0,143,143,143,143
Nevada,24,2022-05-30,181,181,180,1,1595,1595,1586,9,3,2,2,1,133,133,131,131
Orange,24,2022-05-30,5638,5643,5624,19,82275,82344,82056,288,122,12,12,18,7164,7164,7152,7152
Placer,24,2022-05-30,738,738,733,5,6134,6139,6099,40,52,0,0,8,631,631,631,631
Plumas,24,2022-05-30,35,35,35,0,200,200,199,1,1,0,0,0,13,13,13,13
Riverside,24,2022-05-30,3865,3869,3851,18,43871,43909,43704,205,82,3,3,10,6480,6480,6477,6477
Sacramento,24,2022-05-30,3840,3844,3825,19,33074,33102,32936,166,130,9,9,20,3101,3101,3092,3092
San Benito,24,2022-05-30,154,154,153,1,1276,1276,1271,5,0,0,0,0,94,94,94,94
San Bernardino,24,2022-05-30,3335,3337,3325,12,42869,42903,42742,161,49,5,5,10,7855,7855,7850,7850
San Diego,24,2022-05-30,8414,8421,8408,13,85859,85931,85796,135,153,10,10,26,5378,5378,5368,5368
San Francisco,24,2022-05-30,3133,3133,3101,32,33425,33454,33110,344,88,11,11,14,906,906,895,895
San Joaquin,24,2022-05-30,1399,1399,1391,8,17011,17026,16932,94,25,2,2,9,2257,2257,2255,2255
San Luis Obispo,24,2022-05-30,653,653,650,3,5437,5441,5418,23,12,1,1,0,487,487,486,486
San Mateo,24,2022-05-30,2753,2753,2743,10,31176,31203,31093,110,33,3,3,2,717,717,714,714
Santa Barbara,24,2022-05-30,1032,1032,1027,5,14449,14462,14392,70,23,2,2,5,695,695,693,693
Santa Clara,24,2022-05-30,7030,7037,7025,12,85314,85385,85242,143,154,10,10,22,2344,2344,2334,2334
Santa Cruz,24,2022-05-30,526,526,524,2,6255,6260,6234,26,7,1,1,1,263,263,262,262
Shasta,24,2022-05-30,133,133,132,1,2838,2840,2826,14,4,3,3,4,565,565,562,562
Siskiyou,24,2022-05-30,53,53,53,0,340,340,339,1,3,0,0,0,83,83,83,83
Solano,24,2022-05-30,1185,1185,1179,6,11556,11566,11511,55,28,0,0,7,451,451,451,451
Sonoma,24,2022-05-30,1201,1201,1196,5,13239,13250,13189,61,38,2,2,5,498,498,496,496
Stanislaus,24,2022-05-30,801,801,795,6,8585,8593,8531,62,55,2,2,3,1701,1701,1699,1699
Sutter,24,2022-05-30,158,158,157,1,1701,1701,1693,8,0,0,0,0,228,228,228,228
Tehama,24,2022-05-30,62,62,62,0,757,757,752,5,2,0,0,0,208,208,208,208
Trinity,24,2022-05-30,8,8,8,0,96,96,95,1,0,0,0,0,20,20,20,20
Tulare,24,2022-05-30,597,597,593,4,7482,7488,7432,56,19,0,0,0,1500,1500,1500,1500
Tuolumne,24,2022-05-30,122,122,121,1,1306,1306,1298,8,3,0,0,0,187,187,187,187
Ventura,24,2022-05-30,1681,1681,1676,5,19545,19561,19498,63,30,1,1,4,1515,1515,1514,1514
Yolo,24,2022-05-30,610,610,607,3,17634,17648,17573,75,4,0,0,1,364,364,364,364
Yuba,24,2022-05-30,144,144,143,1,1276,1276,1270,6,7,0,0,2,119,119,119,119
Alameda,25,2022-06-06,6489,6495,6476,19,73232,73301,73089,212,112,5,5,12,1914,1914,1909,1909
Amador,25,2022-06-06,114,114,113,1,1723,1723,1715,8,1,0,0,1,87,87,87,87
Butte,25,2022-06-06,453,453,452,1,3617,3621,3613,8,24,1,1,1,438,438,437,437
Calaveras,25,2022-06-06,73,73,73,0,737,737,734,3,0,2,2,0,124,124,122,122
Colusa,25,2022-06-06,22,22,22,0,275,275,274,1,3,0,0,0,21,21,21,21
Contra Costa,25,2022-06-06,4237,4242,4222,20,35702,35735,35562,173,107,9,9,7,1342,1342,1333,1333
Del Norte,25,2022-06-06,64,64,64,0,1134,1134,1130,4,2,0,0,0,51,51,51,51
El Dorado,25,2022-06-06,413,413,411,2,3637,3641,3626,15,5,0,0,5,219,219,219,219
Fresno,25,2022-06-06,2451,2451,2440,11,22602,22623,22520,103,94,2,2,6,2783,2783,2781,2781
Glenn,25,2022-06-06,41,41,41,0,325,325,324,1,3,0,0,0,53,53,53,53
Humboldt,25,2022-06-06,261,261,260,1,3054,3057,3046,11,14,1,1,3,150,150,149,149
Imperial,25,2022-06-06,466,466,464,2,4860,4865,4845,20,2,0,0,0,946,946,946,946
Inyo,25,2022-06-06,20,20,20,0,213,213,212,1,1,0,0,0,56,56,56,56
Kern,25,2022-06-06,1611,1611,1606,5,22975,22997,22920,77,35,1,1,6,2352,2352,2351,2351
Kings,25,2022-06-06,397,397,395,2,5504,5509,5486,23,10,0,0,1,450,450,450,450
Lake,25,2022-06-06,136,136,135,1,1180,1180,1174,6,5,0,0,2,140,140,140,140
Lassen,25,2022-06-06,71,71,71,0,2398,2400,2392,8,2,0,0,0,62,62,62,62
Los Angeles,25,2022-06-06,35101,35135,35095,40,1041692,1042678,1041475,1203,496,39,39,61,32114,32114,32075,32075
Madera,25,2022-06-06,354,354,352,2,4126,4131,4112,19,7,0,0,1,370,370,370,370
Marin,25,2022-06-06,739,739,736,3,7650,7656,7622,34,10,2,2,5,300,300,298,298
Mariposa,25,2022-06-06,57,57,57,0,403,403,401,2,0,0,0,0,28,28,28,28
Mendocino,25,2022-06-06,209,209,208,1,1711,1711,1700,11,9,1,1,2,130,130,129,129
Merced,25,2022-06-06,532,532,530,2,4530,4535,4519,16,16,0,0,0,828,828,828,828
Modoc,25,2022-06-06,11,11,11,0,37,38,37,1,0,0,0,0,7,7,7,7
Mono,25,2022-06-06,15,15,15,0,120,120,119,1,0,0,0,0,6,6,6,6
Monterey,25,2022-06-06,1002,1002,995,7,10243,10252,10177,75,17,2,2,1,738,738,736,736
Napa,25,2022-06-06,543,543,541,2,4232,4237,4224,13,8,1,1,0,144,144,143,143
Nevada,25,2022-06-06,246,246,245,1,2149,2149,2139,10,5,0,0,0,133,133,133,133
Orange,25,2022-06-06,7580,7587,7567,20,73767,73837,73639,198,140,12,12,18,7176,7176,7164,7164
Placer,25,2022-06-06,868,868,864,4,7605,7612,7574,38,65,0,0,11,631,631,631,631
Plumas,25,2022-06-06,40,40,40,0,321,321,320,1,0,0,0,0,13,13,13,13
Riverside,25,2022-06-06,5356,5363,5344,19,55974,56029,55828,201,88,6,6,10,6486,6486,6480,6480
Sacramento,25,2022-06-06,4951,4956,4937,19,42466,42507,42342,165,149,14,14,20,3115,3115,3101,3101
San Benito,25,2022-06-06,273,273,272,1,2016,2016,2010,6,0,0,0,1,94,94,94,94
San Bernardino,25,2022-06-06,5130,5135,5120,15,55840,55892,55730,162,77,7,7,14,7862,7862,7855,7855
San Diego,25,2022-06-06,10777,10788,10775,13,100457,100553,100431,122,185,8,8,22,5386,5386,5378,5378
San Francisco,25,2022-06-06,3521,3524,3496,28,38260,38296,37991,305,77,0,0,11,906,906,906,906
San Joaquin,25,2022-06-06,2133,2133,2124,9,22156,22176,22082,94,40,4,4,9,2261,2261,2257,2257
San Luis Obispo,25,2022-06-06,901,901,898,3,7531,7537,7512,25,16,1,1,1,488,488,487,487
San Mateo,25,2022-06-06,3214,3217,3208,9,37066,37101,37001,100,36,2,2,4,719,719,717,717
Santa Barbara,25,2022-06-06,1246,1246,1241,5,15068,15081,15025,56,22,1,1,5,696,696,695,695
Santa Clara,25,2022-06-06,8504,8511,8500,11,102648,102746,102614,132,176,6,6,22,2350,2350,2344,2344
Santa Cruz,25,2022-06-06,896,896,893,3,9720,9729,9699,30,24,1,1,3,264,264,263,263
Shasta,25,2022-06-06,210,210,209,1,4423,4427,4410,17,10,2,2,2,567,567,565,565
Siskiyou,25,2022-06-06,41,41,41,0,431,431,430,1,1,0,0,0,83,83,83,83
Solano,25,2022-06-06,1748,1748,1742,6,15180,15194,15139,55,29,2,2,1,453,453,451,451
Sonoma,25,2022-06-06,1636,1636,1630,6,13997,14011,13962,49,38,1,1,1,499,499,498,498
Stanislaus,25,2022-06-06,1183,1183,1176,7,10914,10925,10864,61,60,1,1,2,1702,1702,1701,1701
Sutter,25,2022-06-06,206,206,205,1,1941,1941,1934,7,0,0,0,0,228,228,228,228
Tehama,25,2022-06-06,83,83,83,0,1051,1051,1045,6,2,0,0,0,208,208,208,208
Trinity,25,2022-06-06,7,7,7,0,110,110,109,1,0,0,0,0,20,20,20,20
Tulare,25,2022-06-06,857,857,852,5,10773,10782,10721,61,24,0,0,0,1500,1500,1500,1500
Tuolumne,25,2022-06-06,124,124,123,1,1723,1723,1715,8,4,0,0,1,187,187,187,187
Ventura,25,2022-06-06,1973,1973,1968,5,24765,24787,24726,61,43,3,3,3,1518,1518,1515,1515
Yolo,25,2022-06-06,827,827,824,3,21438,21458,21388,70,2,1,1,0,365,365,364,364
Yuba,25,2022-06-06,187,187,186,1,1556,1556,1551,5,9,0,0,1,119,119,119,119
Alameda,26,2022-06-13,5079,5085,5074,11,55924,55982,55856,126,106,7,7,18,1921,1921,1914,1914
Amador,26,2022-06-13,129,129,129,0,1413,1413,1408,5,1,0,0,0,87,87,87,87
Butte,26,2022-06-13,394,394,393,1,3459,3462,3456,6,31,4,4,0,442,442,438,438
Calaveras,26,2022-06-13,69,69,69,0,658,658,656,2,0,0,0,0,124,124,124,124
Colusa,26,2022-06-13,12,12,12,0,328,328,327,1,17,0,0,0,21,21,21,21
Contra Costa,26,2022-06-13,3415,3420,3407,13,27986,28015,27909,106,89,8,8,12,1350,1350,1342,1342
Del Norte,26,2022-06-13,79,79,79,0,658,658,656,2,4,0,0,0,51,51,51,51
El Dorado,26,2022-06-13,324,324,323,1,3197,3202,3192,10,7,3,3,1,222,222,219,219
Fresno,26,2022-06-13,2398,2399,2391,8,20607,20629,20556,73,103,4,4,13,2787,2787,2783,2783
Glenn,26,2022-06-13,32,32,32,0,329,329,328,1,2,0,0,0,53,53,53,53
Humboldt,26,2022-06-13,262,262,261,1,2325,2325,2318,7,11,0,0,3,150,150,150,150
Imperial,26,2022-06-13,446,446,445,1,4521,4526,4512,14,6,1,1,0,947,947,946,946
Inyo,26,2022-06-13,13,13,13,0,189,189,188,1,0,0,0,0,56,56,56,56
Kern,26,2022-06-13,1565,1565,1561,4,21421,21442,21386,56,38,1,1,5,2353,2353,2352,2352
Kings,26,2022-06-13,357,357,356,1,5156,5161,5145,16,4,1,1,0,451,451,450,450
Lake,26,2022-06-13,138,138,137,1,1227,1227,1223,4,1,0,0,0,140,140,140,140
Lassen,26,2022-06-13,77,77,77,0,1994,1995,1990,5,2,0,0,0,62,62,62,62
Los Angeles,26,2022-06-13,29990,30022,29995,27,660484,661170,660571,599,519,54,54,60,32168,32168,32114,32114
Madera,26,2022-06-13,381,381,380,1,4231,4235,4220,15,7,0,0,2,370,370,370,370
Marin,26,2022-06-13,686,686,684,2,7039,7046,7021,25,16,2,2,2,302,302,300,300
Mariposa,26,2022-06-13,45,45,45,0,372,372,371,1,0,0,0,0,28,28,28,28
Mendocino,26,2022-06-13,162,162,161,1,1567,1567,1559,8,9,0,0,1,130,130,130,130
Merced,26,2022-06-13,561,561,559,2,4169,4174,4163,11,13,0,0,2,828,828,828,828
Modoc,26,2022-06-13,7,7,7,0,34,35,34,1,1,1,1,0,8,8,7,7
Mono,26,2022-06-13,19,19,19,0,92,92,91,1,0,0,0,0,6,6,6,6
Monterey,26,2022-06-13,841,841,836,5,8659,8668,8619,49,25,3,3,1,741,741,738,738
Napa,26,2022-06-13,434,434,433,1,3940,3945,3936,9,2,1,1,1,145,145,144,144
Nevada,26,2022-06-13,186,186,185,1,1874,1875,1868,7,8,0,0,0,133,133,133,133
Orange,26,2022-06-13,7005,7012,6998,14,65234,65301,65165,136,175,15,15,19,7191,7191,7176,7176
Placer,26,2022-06-13,790,790,787,3,6801,6807,6781,26,79,2,2,7,633,633,631,631
Plumas,26,2022-06-13,34,34,34,0,271,271,270,1,0,0,0,0,13,13,13,13
Riverside,26,2022-06-13,5046,5053,5039,14,47851,47901,47767,134,105,3,3,11,6489,6489,6486,6486
Sacramento,26,2022-06-13,4179,4184,4171,13,37540,37580,37467,113,190,12,12,20,3127,3127,3115,3115
San Benito,26,2022-06-13,200,200,200,0,1780,1780,1776,4,1,0,0,1,94,94,94,94
San Bernardino,26,2022-06-13,4674,4679,4669,10,48699,48750,48640,110,96,6,6,15,7868,7868,7862,7862
San Diego,26,2022-06-13,9615,9626,9617,9,84902,84990,84910,80,192,9,9,27,5395,5395,5386,5386
San Francisco,26,2022-06-13,3033,3036,3017,19,31123,31155,30962,193,72,11,11,13,917,917,906,906
San Joaquin,26,2022-06-13,1920,1920,1914,6,19008,19027,18964,63,32,5,5,3,2266,2266,2261,2261
San Luis Obispo,26,2022-06-13,661,661,659,2,6049,6054,6039,15,21,0,0,0,488,488,488,488
San Mateo,26,2022-06-13,2635,2636,2631,5,29175,29205,29144,61,44,3,3,3,722,722,719,719
Santa Barbara,26,2022-06-13,931,931,928,3,9475,9486,9459,27,15,1,1,5,697,697,696,696
Santa Clara,26,2022-06-13,7044,7051,7044,7,76835,76917,76840,77,182,13,13,23,2363,2363,2350,2350
Santa Cruz,26,2022-06-13,842,842,840,2,9962,9973,9949,24,23,0,0,1,264,264,264,264
Shasta,26,2022-06-13,220,220,219,1,3390,3394,3384,10,8,1,1,0,568,568,567,567
Siskiyou,26,2022-06-13,50,50,50,0,372,372,371,1,1,0,0,0,83,83,83,83
Solano,26,2022-06-13,1689,1689,1684,5,12899,12913,12877,36,33,0,0,2,453,453,453,453
Sonoma,26,2022-06-13,1336,1336,1332,4,11651,11663,11631,32,36,3,3,6,502,502,499,499
Stanislaus,26,2022-06-13,1132,1132,1127,5,9453,9463,9422,41,63,1,1,7,1703,1703,1702,1702
Sutter,26,2022-06-13,193,193,192,1,1721,1721,1716,5,0,0,0,0,228,228,228,228
Tehama,26,2022-06-13,88,88,88,0,967,967,963,4,3,0,0,0,208,208,208,208
Trinity,26,2022-06-13,11,11,11,0,84,85,84,1,0,0,0,0,20,20,20,20
Tulare,26,2022-06-13,826,826,822,4,9451,9460,9418,42,26,2,2,1,1502,1502,1500,1500
Tuolumne,26,2022-06-13,148,148,147,1,1445,1445,1440,5,2,0,0,0,187,187,187,187
Ventura,26,2022-06-13,1935,1935,1931,4,20980,21002,20962,40,38,3,3,5,1521,1521,1518,1518
Yolo,26,2022-06-13,767,767,765,2,14394,14410,14373,37,4,1,1,0,366,366,365,365
Yuba,26,2022-06-13,188,188,187,1,1419,1419,1415,4,8,0,0,1,119,119,119,119
Alameda,27,2022-06-20,4955,4962,4953,9,48647,48700,48615,85,105,12,12,14,1933,1933,1921,1921
Amador,27,2022-06-20,104,104,104,0,1247,1247,1243,4,2,0,0,0,87,87,87,87
Butte,27,2022-06-20,413,413,412,1,3560,3565,3560,5,28,4,4,1,446,446,442,442
Calaveras,27,2022-06-20,82,82,82,0,624,624,622,2,0,0,0,0,124,124,124,124
Colusa,27,2022-06-20,16,16,16,0,176,177,176,1,15,1,1,0,22,22,21,21
Contra Costa,27,2022-06-20,3344,3349,3339,10,26019,26048,25971,77,81,7,7,8,1357,1357,1350,1350
Del Norte,27,2022-06-20,82,82,82,0,611,611,610,1,3,1,1,1,52,52,51,51
El Dorado,27,2022-06-20,351,351,350,1,3074,3079,3071,8,5,2,2,1,224,224,222,222
Fresno,27,2022-06-20,2471,2472,2465,7,19408,19429,19375,54,100,2,2,16,2789,2789,2787,2787
Glenn,27,2022-06-20,41,41,41,0,314,314,313,1,3,0,0,0,53,53,53,53
Humboldt,27,2022-06-20,273,273,272,1,2273,2273,2268,5,11,0,0,3,150,150,150,150
Imperial,27,2022-06-20,602,602,601,1,3691,3696,3687,9,5,0,0,0,947,947,947,947
Inyo,27,2022-06-20,19,19,19,0,187,188,187,1,0,0,0,0,56,56,56,56
Kern,27,2022-06-20,1652,1652,1649,3,20136,20158,20117,41,39,5,5,9,2358,2358,2353,2353
Kings,27,2022-06-20,413,413,412,1,4866,4871,4859,12,6,1,1,0,452,452,451,451
Lake,27,2022-06-20,120,120,120,0,1237,1237,1233,4,1,0,0,2,140,140,140,140
Lassen,27,2022-06-20,43,43,43,0,1223,1224,1222,2,1,0,0,0,62,62,62,62
Los Angeles,27,2022-06-20,27529,27560,27541,19,351473,351862,351618,244,596,57,57,68,32225,32225,32168,32168
Madera,27,2022-06-20,340,340,339,1,4163,4167,4155,12,4,0,0,1,370,370,370,370
Marin,27,2022-06-20,693,693,691,2,6328,6334,6317,17,21,0,0,1,302,302,302,302
Mariposa,27,2022-06-20,53,53,53,0,335,335,334,1,0,0,0,0,28,28,28,28
Mendocino,27,2022-06-20,180,180,179,1,1580,1580,1574,6,3,0,0,0,130,130,130,130
Merced,27,2022-06-20,541,541,540,1,3955,3960,3952,8,7,3,3,1,831,831,828,828
Modoc,27,2022-06-20,5,5,5,0,37,38,37,1,0,0,0,0,8,8,8,8
Mono,27,2022-06-20,6,6,6,0,82,83,82,1,1,1,1,0,7,7,6,6
Monterey,27,2022-06-20,894,894,890,4,8905,8916,8877,39,38,1,1,2,742,742,741,741
Napa,27,2022-06-20,365,365,364,1,3129,3134,3128,6,3,1,1,0,146,146,145,145
Nevada,27,2022-06-20,170,170,170,0,1619,1619,1615,4,6,1,1,0,134,134,133,133
Orange,27,2022-06-20,7020,7027,7016,11,60449,60515,60417,98,152,10,10,23,7201,7201,7191,7191
Placer,27,2022-06-20,674,674,672,2,6053,6059,6041,18,69,1,1,7,634,634,633,633
Plumas,27,2022-06-20,38,38,38,0,239,239,238,1,0,0,0,0,13,13,13,13
Riverside,27,2022-06-20,4960,4967,4956,11,43308,43356,43261,95,112,5,5,14,6494,6494,6489,6489
Sacramento,27,2022-06-20,3928,3933,3924,9,34811,34849,34767,82,171,12,12,21,3139,3139,3127,3127
San Benito,27,2022-06-20,173,173,173,0,1598,1598,1595,3,0,1,1,2,95,95,94,94
San Bernardino,27,2022-06-20,4532,4537,4529,8,46252,46304,46223,81,105,12,12,17,7880,7880,7868,7868
San Diego,27,2022-06-20,9698,9710,9703,7,77520,77605,77548,57,203,9,9,17,5404,5404,5395,5395
San Francisco,27,2022-06-20,3059,3062,3047,15,28295,28328,28191,137,72,12,12,14,929,929,917,917
San Joaquin,27,2022-06-20,1670,1670,1666,4,17897,17916,17870,46,38,6,6,6,2272,2272,2266,2266
San Luis Obispo,27,2022-06-20,601,601,600,1,5812,5817,5805,12,27,10,10,0,498,498,488,488
San Mateo,27,2022-06-20,2623,2624,2620,4,25948,25976,25933,43,42,2,2,1,724,724,722,722
Santa Barbara,27,2022-06-20,934,934,932,2,8260,8270,8252,18,33,2,2,6,699,699,697,697
Santa Clara,27,2022-06-20,6809,6816,6811,5,63486,63556,63507,49,170,8,8,21,2371,2371,2363,2363
Santa Cruz,27,2022-06-20,818,818,816,2,9130,9141,9124,17,19,1,1,2,265,265,264,264
Shasta,27,2022-06-20,241,241,240,1,3372,3376,3368,8,9,1,1,1,569,569,568,568
Siskiyou,27,2022-06-20,61,61,61,0,394,394,393,1,5,1,1,0,84,84,83,83
Solano,27,2022-06-20,1420,1420,1417,3,11467,11479,11454,25,41,0,0,5,453,453,453,453
Sonoma,27,2022-06-20,1399,1399,1396,3,10797,10809,10786,23,28,1,1,3,503,503,502,502
Stanislaus,27,2022-06-20,1035,1035,1032,3,8832,8842,8812,30,70,5,5,7,1708,1708,1703,1703
Sutter,27,2022-06-20,197,197,197,0,1858,1859,1855,4,0,0,0,0,228,228,228,228
Tehama,27,2022-06-20,97,97,97,0,889,889,886,3,3,0,0,0,208,208,208,208
Trinity,27,2022-06-20,10,10,10,0,106,107,106,1,0,0,0,0,20,20,20,20
Tulare,27,2022-06-20,892,892,889,3,8726,8734,8704,30,32,8,8,0,1510,1510,1502,1502
Tuolumne,27,2022-06-20,141,141,141,0,1554,1554,1550,4,3,0,0,1,187,187,187,187
Ventura,27,2022-06-20,1835,1835,1832,3,18669,18690,18662,28,50,1,1,7,1522,1522,1521,1521
Yolo,27,2022-06-20,680,680,679,1,10850,10862,10840,22,1,2,2,2,368,368,366,366
Yuba,27,2022-06-20,149,149,149,0,1339,1339,1336,3,13,0,0,5,119,119,119,119
Alameda,28,2022-06-27,5475,5482,5475,7,48325,48381,48315,66,124,8,8,16,1941,1941,1933,1933
Amador,28,2022-06-27,88,88,88,0,1149,1149,1146,3,3,0,0,1,87,87,87,87
Butte,28,2022-06-27,410,410,410,0,3468,3472,3468,4,30,2,2,0,448,448,446,446
Calaveras,28,2022-06-27,69,69,69,0,571,571,570,1,1,2,2,0,126,126,124,124
Colusa,28,2022-06-27,28,28,28,0,282,283,282,1,6,0,0,0,22,22,22,22
Contra Costa,28,2022-06-27,3527,3532,3524,8,25914,25944,25885,59,82,11,11,7,1368,1368,1357,1357
Del Norte,28,2022-06-27,140,140,140,0,669,669,668,1,5,1,1,2,53,53,52,52
El Dorado,28,2022-06-27,427,427,426,1,3357,3362,3356,6,5,0,0,1,224,224,224,224
Fresno,28,2022-06-27,2827,2830,2824,6,19885,19908,19865,43,136,2,2,17,2791,2791,2789,2789
Glenn,28,2022-06-27,28,28,28,0,296,296,295,1,1,0,0,0,53,53,53,53
Humboldt,28,2022-06-27,261,261,261,0,2189,2190,2186,4,10,1,1,2,151,151,150,150
Imperial,28,2022-06-27,705,705,704,1,4018,4023,4015,8,7,0,0,4,947,947,947,947
Inyo,28,2022-06-27,32,32,32,0,311,311,310,1,1,0,0,0,56,56,56,56
Kern,28,2022-06-27,1819,1819,1816,3,17406,17426,17398,28,52,7,7,8,2365,2365,2358,2358
Kings,28,2022-06-27,470,470,469,1,3931,3936,3928,8,9,0,0,0,452,452,452,452
Lake,28,2022-06-27,122,122,122,0,1139,1139,1136,3,2,0,0,0,140,140,140,140
Lassen,28,2022-06-27,51,51,51,0,848,848,847,1,1,0,0,0,62,62,62,62
Los Angeles,28,2022-06-27,32761,32801,32783,18,364326,364753,364556,197,679,73,73,68,32298,32298,32225,32225
Madera,28,2022-06-27,414,414,413,1,4286,4290,4281,9,8,0,0,0,370,370,370,370
Marin,28,2022-06-27,660,660,659,1,6243,6249,6236,13,20,1,1,2,303,303,302,302
Mariposa,28,2022-06-27,55,55,55,0,310,310,309,1,0,0,0,0,28,28,28,28
Mendocino,28,2022-06-27,153,153,153,0,1447,1447,1443,4,5,1,1,1,131,131,130,130
Merced,28,2022-06-27,614,614,613,1,4036,4041,4034,7,14,2,2,0,833,833,831,831
Modoc,28,2022-06-27,7,7,7,0,32,33,32,1,0,0,0,0,8,8,8,8
Mono,28,2022-06-27,25,25,25,0,110,111,110,1,1,0,0,0,7,7,7,7
Monterey,28,2022-06-27,935,935,932,3,8274,8286,8258,28,44,2,2,3,744,744,742,742
Napa,28,2022-06-27,391,391,390,1,3313,3318,3313,5,3,2,2,1,148,148,146,146
Nevada,28,2022-06-27,189,189,189,0,1619,1619,1616,3,4,0,0,3,134,134,134,134
Orange,28,2022-06-27,7551,7559,7550,9,59338,59409,59334,75,183,16,16,26,7217,7217,7201,7201
Placer,28,2022-06-27,808,808,806,2,6185,6192,6177,15,79,6,6,6,640,640,634,634
Plumas,28,2022-06-27,50,50,50,0,257,257,256,1,1,0,0,0,13,13,13,13
Riverside,28,2022-06-27,6195,6202,6192,10,44963,45015,44939,76,141,11,11,17,6505,6505,6494,6494
Sacramento,28,2022-06-27,4164,4169,4161,8,35282,35324,35259,65,173,10,10,25,3149,3149,3139,3139
San Benito,28,2022-06-27,221,221,221,0,1655,1655,1653,2,0,0,0,1,95,95,95,95
San Bernardino,28,2022-06-27,5722,5729,5721,8,48817,48875,48808,67,130,12,12,24,7892,7892,7880,7880
San Diego,28,2022-06-27,10872,10885,10879,6,80651,80747,80701,46,264,9,9,28,5413,5413,5404,5404
San Francisco,28,2022-06-27,3269,3274,3262,12,29256,29292,29182,110,92,5,5,23,934,934,929,929
San Joaquin,28,2022-06-27,1893,1893,1889,4,17962,17982,17946,36,46,2,2,5,2274,2274,2272,2272
San Luis Obispo,28,2022-06-27,645,645,644,1,5644,5650,5641,9,25,3,3,0,501,501,498,498
San Mateo,28,2022-06-27,2890,2893,2889,4,26919,26950,26916,34,36,2,2,2,726,726,724,724
Santa Barbara,28,2022-06-27,1148,1148,1146,2,9812,9824,9807,17,26,2,2,2,701,701,699,699
Santa Clara,28,2022-06-27,7542,7550,7545,5,61416,61487,61450,37,213,11,11,19,2382,2382,2371,2371
Santa Cruz,28,2022-06-27,861,861,860,1,9188,9200,9186,14,26,2,2,1,267,267,265,265
Shasta,28,2022-06-27,339,339,338,1,3308,3312,3306,6,21,0,0,4,569,569,569,569
Siskiyou,28,2022-06-27,63,63,63,0,355,355,354,1,2,1,1,0,85,85,84,84
Solano,28,2022-06-27,1614,1614,1611,3,13043,13059,13037,22,47,0,0,4,453,453,453,453
Sonoma,28,2022-06-27,1368,1368,1366,2,10098,10110,10093,17,33,2,2,3,505,505,503,503
Stanislaus,28,2022-06-27,1212,1212,1209,3,8583,8593,8570,23,96,2,2,6,1710,1710,1708,1708
Sutter,28,2022-06-27,197,197,197,0,1843,1844,1841,3,0,0,0,0,228,228,228,228
Tehama,28,2022-06-27,93,93,93,0,888,888,886,2,3,0,0,0,208,208,208,208
Trinity,28,2022-06-27,24,24,24,0,142,143,142,1,1,0,0,0,20,20,20,20
Tulare,28,2022-06-27,909,909,907,2,7882,7890,7869,21,35,0,0,2,1510,1510,1510,1510
Tuolumne,28,2022-06-27,172,172,172,0,1405,1405,1402,3,1,4,4,1,191,191,187,187
Ventura,28,2022-06-27,2090,2090,2088,2,18528,18550,18528,22,61,3,3,1,1525,1525,1522,1522
Yolo,28,2022-06-27,794,794,793,1,11410,11423,11405,18,8,0,0,1,368,368,368,368
Yuba,28,2022-06-27,172,172,172,0,1435,1435,1433,2,10,2,2,2,121,121,119,119
Alameda,29,2022-07-04,4832,4838,4833,5,38876,38923,38881,42,128,11,11,10,1952,1952,1941,1941
Amador,29,2022-07-04,66,66,66,0,1534,1535,1532,3,3,0,0,1,87,87,87,87
Butte,29,2022-07-04,284,284,284,0,2489,2492,2490,2,28,2,2,1,450,450,448,448
Calaveras,29,2022-07-04,81,81,81,0,486,486,485,1,0,2,2,0,128,128,126,126
Colusa,29,2022-07-04,21,21,21,0,150,151,150,1,4,0,0,0,22,22,22,22
Contra Costa,29,2022-07-04,3321,3325,3319,6,20929,20954,20916,38,76,10,10,12,1378,1378,1368,1368
Del Norte,29,2022-07-04,140,140,140,0,587,587,586,1,3,0,0,0,53,53,53,53
El Dorado,29,2022-07-04,307,307,307,0,2395,2398,2394,4,10,1,1,0,225,225,224,224
Fresno,29,2022-07-04,2469,2471,2467,4,15666,15684,15657,27,158,6,6,17,2797,2797,2791,2791
Glenn,29,2022-07-04,24,24,24,0,157,158,157,1,1,0,0,0,53,53,53,53
Humboldt,29,2022-07-04,188,188,188,0,1584,1584,1582,2,12,2,2,3,153,153,151,151
Imperial,29,2022-07-04,698,698,697,1,3234,3238,3233,5,8,1,1,3,948,948,947,947
Inyo,29,2022-07-04,42,42,42,0,292,293,292,1,1,0,0,0,56,56,56,56
Kern,29,2022-07-04,1794,1794,1792,2,14291,14307,14289,18,63,4,4,9,2369,2369,2365,2365
Kings,29,2022-07-04,436,436,435,1,3446,3450,3445,5,5,0,0,0,452,452,452,452
Lake,29,2022-07-04,107,107,107,0,790,790,789,1,3,2,2,0,142,142,140,140
Lassen,29,2022-07-04,31,31,31,0,640,640,639,1,2,0,0,0,62,62,62,62
Los Angeles,29,2022-07-04,32265,32303,32289,14,285968,286317,286194,123,801,88,88,85,32386,32386,32298,32298
Madera,29,2022-07-04,341,341,340,1,3179,3182,3176,6,9,0,0,1,370,370,370,370
Marin,29,2022-07-04,608,608,607,1,5170,5176,5167,9,25,1,1,2,304,304,303,303
Mariposa,29,2022-07-04,36,36,36,0,222,223,222,1,0,0,0,0,28,28,28,28
Mendocino,29,2022-07-04,164,164,164,0,1119,1119,1116,3,6,2,2,1,133,133,131,131
Merced,29,2022-07-04,596,596,595,1,2920,2924,2920,4,14,2,2,1,835,835,833,833
Modoc,29,2022-07-04,10,10,10,0,31,32,31,1,0,0,0,0,8,8,8,8
Mono,29,2022-07-04,22,22,22,0,81,82,81,1,1,0,0,0,7,7,7,7
Monterey,29,2022-07-04,843,843,841,2,6318,6327,6310,17,39,2,2,4,746,746,744,744
Napa,29,2022-07-04,340,340,340,0,2557,2561,2558,3,13,0,0,1,148,148,148,148
Nevada,29,2022-07-04,177,177,177,0,1268,1268,1266,2,5,0,0,1,134,134,134,134
Orange,29,2022-07-04,6980,6989,6982,7,50727,50790,50739,51,203,25,25,34,7242,7242,7217,7217
Placer,29,2022-07-04,808,808,807,1,5049,5055,5046,9,72,3,3,6,643,643,640,640
Plumas,29,2022-07-04,32,32,32,0,172,173,172,1,0,0,0,0,13,13,13,13
Riverside,29,2022-07-04,6396,6403,6394,9,38526,38572,38520,52,137,5,5,8,6510,6510,6505,6505
Sacramento,29,2022-07-04,3578,3582,3577,5,26532,26564,26525,39,163,19,19,22,3168,3168,3149,3149
San Benito,29,2022-07-04,211,211,211,0,1274,1274,1272,2,3,0,0,0,95,95,95,95
San Bernardino,29,2022-07-04,6065,6072,6065,7,41597,41649,41604,45,147,12,12,26,7904,7904,7892,7892
San Diego,29,2022-07-04,9598,9609,9605,4,65499,65579,65549,30,262,10,10,43,5423,5423,5413,5413
San Francisco,29,2022-07-04,2891,2895,2886,9,24201,24231,24159,72,100,11,11,18,945,945,934,934
San Joaquin,29,2022-07-04,1682,1682,1679,3,14672,14690,14667,23,41,5,5,4,2279,2279,2274,2274
San Luis Obispo,29,2022-07-04,616,616,615,1,4165,4169,4164,5,24,0,0,0,501,501,501,501
San Mateo,29,2022-07-04,2600,2603,2600,3,21595,21621,21599,22,39,1,1,3,727,727,726,726
Santa Barbara,29,2022-07-04,1057,1057,1056,1,7665,7676,7665,11,26,4,4,4,705,705,701,701
Santa Clara,29,2022-07-04,6804,6812,6809,3,50745,50808,50784,24,191,16,16,34,2398,2398,2382,2382
Santa Cruz,29,2022-07-04,733,733,732,1,7158,7166,7157,9,22,0,0,0,267,267,267,267
Shasta,29,2022-07-04,280,280,280,0,2396,2399,2395,4,15,5,5,3,574,574,569,569
Siskiyou,29,2022-07-04,34,34,34,0,326,327,326,1,1,0,0,1,85,85,85,85
Solano,29,2022-07-04,1345,1345,1343,2,9841,9854,9841,13,50,0,0,5,453,453,453,453
Sonoma,29,2022-07-04,1088,1088,1087,1,8092,8103,8092,11,35,2,2,1,507,507,505,505
Stanislaus,29,2022-07-04,1165,1165,1163,2,6990,7000,6985,15,84,7,7,16,1717,1717,1710,1710
Sutter,29,2022-07-04,230,230,230,0,1671,1672,1670,2,0,0,0,0,228,228,228,228
Tehama,29,2022-07-04,132,132,132,0,821,821,819,2,3,1,1,0,209,209,208,208
Trinity,29,2022-07-04,17,17,17,0,143,144,143,1,2,0,0,0,20,20,20,20
Tulare,29,2022-07-04,945,945,943,2,6100,6107,6094,13,40,4,4,1,1514,1514,1510,1510
Tuolumne,29,2022-07-04,165,165,165,0,938,938,936,2,8,0,0,1,191,191,191,191
Ventura,29,2022-07-04,1948,1948,1946,2,15409,15427,15413,14,66,2,2,8,1527,1527,1525,1525
Yolo,29,2022-07-04,535,535,534,1,7260,7268,7259,9,6,3,3,2,371,371,368,368
Yuba,29,2022-07-04,168,168,168,0,1078,1078,1077,1,9,0,0,1,121,121,121,121
Alameda,30,2022-07-11,5794,5801,5796,5,48339,48400,48360,40,119,8,8,16,1960,1960,1952,1952
Amador,30,2022-07-11,92,92,92,0,1504,1505,1503,2,2,0,0,0,87,87,87,87
Butte,30,2022-07-11,497,497,497,0,3298,3303,3301,2,27,1,1,4,451,451,450,450
Calaveras,30,2022-07-11,78,78,78,0,566,566,565,1,0,1,1,1,129,129,128,128
Colusa,30,2022-07-11,26,26,26,0,483,484,483,1,0,0,0,0,22,22,22,22
Contra Costa,30,2022-07-11,3682,3687,3682,5,26539,26572,26535,37,91,11,11,11,1389,1389,1378,1378
Del Norte,30,2022-07-11,174,174,174,0,677,677,676,1,5,0,0,1,53,53,53,53
El Dorado,30,2022-07-11,384,384,384,0,3153,3158,3154,4,12,1,1,3,226,226,225,225
Fresno,30,2022-07-11,3664,3669,3664,5,21552,21578,21550,28,161,7,7,14,2804,2804,2797,2797
Glenn,30,2022-07-11,45,45,45,0,382,383,382,1,0,0,0,0,53,53,53,53
Humboldt,30,2022-07-11,291,291,291,0,2189,2191,2189,2,11,1,1,2,154,154,153,153
Imperial,30,2022-07-11,1118,1118,1117,1,4746,4751,4745,6,14,1,1,1,949,949,948,948
Inyo,30,2022-07-11,40,40,40,0,391,392,391,1,0,1,1,0,57,57,56,56
Kern,30,2022-07-11,2481,2484,2482,2,17066,17087,17070,17,77,2,2,9,2371,2371,2369,2369
Kings,30,2022-07-11,732,732,731,1,4341,4346,4341,5,11,4,4,0,456,456,452,452
Lake,30,2022-07-11,126,126,126,0,1115,1115,1113,2,0,0,0,0,142,142,142,142
Lassen,30,2022-07-11,59,59,59,0,821,821,820,1,2,1,1,0,63,63,62,62
Los Angeles,30,2022-07-11,43325,43378,43364,14,381183,381661,381536,125,1038,90,90,115,32476,32476,32386,32386
Madera,30,2022-07-11,532,532,531,1,4126,4131,4126,5,15,0,0,3,370,370,370,370
Marin,30,2022-07-11,603,603,602,1,5928,5934,5926,8,17,1,1,1,305,305,304,304
Mariposa,30,2022-07-11,52,52,52,0,283,284,283,1,0,0,0,0,28,28,28,28
Mendocino,30,2022-07-11,190,190,190,0,1387,1387,1385,2,4,0,0,0,133,133,133,133
Merced,30,2022-07-11,764,764,763,1,4273,4278,4274,4,16,5,5,1,840,840,835,835
Modoc,30,2022-07-11,28,28,28,0,57,58,57,1,0,0,0,0,8,8,8,8
Mono,30,2022-07-11,11,11,11,0,105,106,105,1,0,0,0,0,7,7,7,7
Monterey,30,2022-07-11,1096,1096,1094,2,7948,7959,7942,17,47,5,5,3,751,751,746,746
Napa,30,2022-07-11,367,367,367,0,3664,3669,3666,3,13,1,1,1,149,149,148,148
Nevada,30,2022-07-11,221,221,221,0,1826,1828,1826,2,7,0,0,1,134,134,134,134
Orange,30,2022-07-11,9750,9762,9755,7,64160,64240,64190,50,257,20,20,30,7262,7262,7242,7242
Placer,30,2022-07-11,784,784,783,1,5963,5970,5961,9,76,2,2,8,645,645,643,643
Plumas,30,2022-07-11,71,71,71,0,282,283,282,1,0,0,0,0,13,13,13,13
Riverside,30,2022-07-11,9209,9221,9212,9,52070,52135,52081,54,225,17,17,12,6527,6527,6510,6510
Sacramento,30,2022-07-11,4205,4211,4206,5,35516,35561,35521,40,184,22,22,24,3190,3190,3168,3168
San Benito,30,2022-07-11,235,235,235,0,1666,1667,1665,2,1,0,0,0,95,95,95,95
San Bernardino,30,2022-07-11,8441,8453,8446,7,57673,57745,57697,48,188,14,14,20,7918,7918,7904,7904
San Diego,30,2022-07-11,13665,13682,13677,5,85548,85656,85626,30,332,11,11,41,5434,5434,5423,5423
San Francisco,30,2022-07-11,2999,3003,2996,7,27843,27878,27814,64,105,11,11,23,956,956,945,945
San Joaquin,30,2022-07-11,2141,2141,2138,3,19354,19379,19355,24,55,7,7,11,2286,2286,2279,2279
San Luis Obispo,30,2022-07-11,754,754,753,1,5272,5277,5272,5,22,3,3,1,504,504,501,501
San Mateo,30,2022-07-11,2778,2782,2780,2,25663,25697,25677,20,42,6,6,4,733,733,727,727
Santa Barbara,30,2022-07-11,1326,1326,1325,1,9703,9716,9706,10,46,5,5,9,710,710,705,705
Santa Clara,30,2022-07-11,7403,7411,7408,3,59980,60055,60033,22,211,12,12,38,2410,2410,2398,2398
Santa Cruz,30,2022-07-11,1031,1031,1030,1,9513,9526,9517,9,16,0,0,0,267,267,267,267
Shasta,30,2022-07-11,328,328,328,0,3565,3569,3565,4,21,2,2,6,576,576,574,574
Siskiyou,30,2022-07-11,29,29,29,0,361,362,361,1,1,1,1,1,86,86,85,85
Solano,30,2022-07-11,1632,1632,1630,2,11657,11672,11660,12,40,1,1,6,454,454,453,453
Sonoma,30,2022-07-11,1300,1300,1299,1,9943,9956,9946,10,50,0,0,7,507,507,507,507
Stanislaus,30,2022-07-11,1494,1494,1492,2,8687,8699,8685,14,103,7,7,11,1724,1724,1717,1717
Sutter,30,2022-07-11,287,287,287,0,1777,1778,1776,2,0,0,0,0,228,228,228,228
Tehama,30,2022-07-11,134,134,134,0,925,925,924,1,5,0,0,1,209,209,209,209
Trinity,30,2022-07-11,35,35,35,0,120,121,120,1,0,0,0,0,20,20,20,20
Tulare,30,2022-07-11,1385,1385,1383,2,9557,9569,9553,16,47,4,4,2,1518,1518,1514,1514
Tuolumne,30,2022-07-11,254,254,254,0,1303,1303,1301,2,6,0,0,0,191,191,191,191
Ventura,30,2022-07-11,2549,2551,2549,2,19713,19740,19726,14,89,9,9,6,1536,1536,1527,1527
Yolo,30,2022-07-11,502,502,502,0,5419,5425,5420,5,4,3,3,4,374,374,371,371
Yuba,30,2022-07-11,218,218,218,0,1402,1402,1401,1,9,0,0,1,121,121,121,121
Alameda,31,2022-07-18,4951,4958,4955,3,42944,43000,42972,28,149,10,10,25,1970,1970,1960,1960
Amador,31,2022-07-18,85,85,85,0,1348,1349,1348,1,6,0,0,1,87,87,87,87
Butte,31,2022-07-18,334,334,334,0,2794,2798,2797,1,25,1,1,3,452,452,451,451
Calaveras,31,2022-07-18,78,78,78,0,545,546,545,1,0,0,0,0,129,129,129,129
Colusa,31,2022-07-18,23,23,23,0,349,350,349,1,2,0,0,0,22,22,22,22
Contra Costa,31,2022-07-18,3059,3064,3061,3,22716,22745,22720,25,88,4,4,16,1393,1393,1389,1389
Del Norte,31,2022-07-18,168,168,168,0,705,705,704,1,7,0,0,0,53,53,53,53
El Dorado,31,2022-07-18,279,279,279,0,2638,2641,2639,2,11,1,1,1,227,227,226,226
Fresno,31,2022-07-18,3702,3708,3704,4,21099,21127,21105,22,199,9,9,15,2813,2813,2804,2804
Glenn,31,2022-07-18,34,34,34,0,263,264,263,1,0,0,0,0,53,53,53,53
Humboldt,31,2022-07-18,295,295,295,0,2026,2027,2025,2,10,0,0,4,154,154,154,154
Imperial,31,2022-07-18,1022,1022,1021,1,4434,4439,4435,4,18,2,2,3,951,951,949,949
Inyo,31,2022-07-18,30,30,30,0,332,333,332,1,0,0,0,0,57,57,57,57
Kern,31,2022-07-18,2318,2320,2318,2,16584,16605,16593,12,72,10,10,14,2381,2381,2371,2371
Kings,31,2022-07-18,708,708,707,1,4154,4159,4155,4,16,1,1,0,457,457,456,456
Lake,31,2022-07-18,132,132,132,0,993,993,992,1,3,0,0,0,142,142,142,142
Lassen,31,2022-07-18,78,78,78,0,1239,1240,1239,1,1,0,0,0,63,63,63,63
Los Angeles,31,2022-07-18,41846,41902,41891,11,352156,352614,352524,90,1162,112,112,137,32588,32588,32476,32476
Madera,31,2022-07-18,529,529,528,1,3632,3637,3633,4,5,0,0,3,370,370,370,370
Marin,31,2022-07-18,516,516,515,1,5504,5510,5504,6,12,1,1,5,306,306,305,305
Mariposa,31,2022-07-18,42,42,42,0,242,243,242,1,0,1,1,0,29,29,28,28
Mendocino,31,2022-07-18,185,185,185,0,1491,1491,1489,2,6,0,0,2,133,133,133,133
Merced,31,2022-07-18,753,753,752,1,3981,3986,3983,3,15,1,1,1,841,841,840,840
Modoc,31,2022-07-18,13,13,13,0,34,35,34,1,1,0,0,0,8,8,8,8
Mono,31,2022-07-18,10,10,10,0,85,86,85,1,1,0,0,0,7,7,7,7
Monterey,31,2022-07-18,985,985,983,2,7188,7198,7186,12,46,6,6,4,757,757,751,751
Napa,31,2022-07-18,318,318,318,0,2954,2958,2956,2,10,2,2,2,151,151,149,149
Nevada,31,2022-07-18,135,135,135,0,1331,1332,1331,1,8,0,0,3,134,134,134,134
Orange,31,2022-07-18,8792,8804,8799,5,59781,59858,59822,36,253,24,24,45,7286,7286,7262,7262
Placer,31,2022-07-18,684,684,683,1,5240,5246,5240,6,89,1,1,5,646,646,645,645
Plumas,31,2022-07-18,60,60,60,0,279,280,279,1,0,0,0,0,13,13,13,13
Riverside,31,2022-07-18,8244,8256,8249,7,48075,48137,48098,39,222,16,16,17,6543,6543,6527,6527
Sacramento,31,2022-07-18,3540,3545,3542,3,30409,30448,30422,26,180,12,12,26,3202,3202,3190,3190
San Benito,31,2022-07-18,199,199,199,0,1588,1588,1587,1,1,1,1,0,96,96,95,95
San Bernardino,31,2022-07-18,7998,8010,8005,5,53738,53808,53773,35,214,13,13,35,7931,7931,7918,7918
San Diego,31,2022-07-18,13080,13096,13092,4,79857,79961,79939,22,402,18,18,52,5452,5452,5434,5434
San Francisco,31,2022-07-18,2491,2495,2491,4,25515,25549,25504,45,111,10,10,24,966,966,956,956
San Joaquin,31,2022-07-18,2053,2053,2051,2,18028,18052,18035,17,66,2,2,11,2288,2288,2286,2286
San Luis Obispo,31,2022-07-18,559,559,559,0,4627,4632,4629,3,17,3,3,1,507,507,504,504
San Mateo,31,2022-07-18,2290,2292,2291,1,23097,23127,23113,14,33,0,0,4,733,733,733,733
Santa Barbara,31,2022-07-18,1298,1298,1297,1,9271,9283,9275,8,47,1,1,6,711,711,710,710
Santa Clara,31,2022-07-18,6194,6201,6199,2,54686,54758,54742,16,199,12,12,30,2422,2422,2410,2410
Santa Cruz,31,2022-07-18,874,874,873,1,7449,7459,7454,5,24,1,1,2,268,268,267,267
Shasta,31,2022-07-18,320,320,320,0,3209,3213,3210,3,40,3,3,3,579,579,576,576
Siskiyou,31,2022-07-18,34,34,34,0,345,346,345,1,3,0,0,0,86,86,86,86
Solano,31,2022-07-18,1246,1246,1245,1,9541,9554,9546,8,49,1,1,6,455,455,454,454
Sonoma,31,2022-07-18,1053,1053,1052,1,8748,8760,8753,7,44,0,0,5,507,507,507,507
Stanislaus,31,2022-07-18,1395,1395,1393,2,8397,8409,8398,11,109,5,5,9,1729,1729,1724,1724
Sutter,31,2022-07-18,253,253,253,0,1673,1674,1673,1,0,0,0,0,228,228,228,228
Tehama,31,2022-07-18,110,110,110,0,896,896,895,1,7,1,1,0,210,210,209,209
Trinity,31,2022-07-18,20,20,20,0,111,112,111,1,1,0,0,0,20,20,20,20
Tulare,31,2022-07-18,1185,1185,1183,2,8085,8094,8084,10,45,0,0,0,1518,1518,1518,1518
Tuolumne,31,2022-07-18,239,239,239,0,1142,1142,1141,1,7,4,4,0,195,195,191,191
Ventura,31,2022-07-18,2324,2326,2325,1,19560,19586,19575,11,92,4,4,7,1540,1540,1536,1536
Yolo,31,2022-07-18,430,430,430,0,4653,4658,4655,3,2,3,3,1,377,377,374,374
Yuba,31,2022-07-18,213,213,213,0,1292,1292,1291,1,18,0,0,0,121,121,121,121
Alameda,32,2022-07-25,4401,4408,4406,2,40429,40483,40463,20,143,12,12,19,1982,1982,1970,1970
Amador,32,2022-07-25,90,90,90,0,1206,1206,1205,1,3,0,0,1,87,87,87,87
Butte,32,2022-07-25,359,359,359,0,2945,2949,2948,1,30,1,1,2,453,453,452,452
Calaveras,32,2022-07-25,82,82,82,0,558,559,558,1,0,2,2,1,131,131,129,129
Colusa,32,2022-07-25,26,26,26,0,373,374,373,1,1,0,0,0,22,22,22,22
Contra Costa,32,2022-07-25,2823,2828,2826,2,21980,22010,21991,19,102,7,7,18,1400,1400,1393,1393
Del Norte,32,2022-07-25,67,67,67,0,534,535,534,1,6,0,0,0,53,53,53,53
El Dorado,32,2022-07-25,270,270,270,0,2485,2488,2486,2,9,1,1,0,228,228,227,227
Fresno,32,2022-07-25,3359,3364,3361,3,20377,20403,20387,16,195,6,6,29,2819,2819,2813,2813
Glenn,32,2022-07-25,31,31,31,0,271,272,271,1,0,0,0,0,53,53,53,53
Humboldt,32,2022-07-25,230,230,230,0,1923,1923,1922,1,13,2,2,4,156,156,154,154
Imperial,32,2022-07-25,873,873,872,1,4338,4343,4340,3,18,1,1,6,952,952,951,951
Inyo,32,2022-07-25,18,18,18,0,284,285,284,1,2,1,1,0,58,58,57,57
Kern,32,2022-07-25,1930,1931,1930,1,15241,15261,15252,9,82,3,3,12,2384,2384,2381,2381
Kings,32,2022-07-25,571,571,571,0,3887,3892,3889,3,15,1,1,0,458,458,457,457
Lake,32,2022-07-25,128,128,128,0,1041,1041,1040,1,5,1,1,2,143,143,142,142
Lassen,32,2022-07-25,53,53,53,0,1071,1072,1071,1,1,0,0,0,63,63,63,63
Los Angeles,32,2022-07-25,37131,37181,37174,7,334157,334603,334536,67,1152,121,121,134,32709,32709,32588,32588
Madera,32,2022-07-25,539,539,539,0,3829,3834,3831,3,11,1,1,5,371,371,370,370
Marin,32,2022-07-25,489,489,489,0,5418,5424,5420,4,26,2,2,2,308,308,306,306
Mariposa,32,2022-07-25,40,40,40,0,232,233,232,1,0,0,0,0,29,29,29,29
Mendocino,32,2022-07-25,196,196,196,0,1426,1426,1424,2,6,0,0,0,133,133,133,133
Merced,32,2022-07-25,732,732,732,0,3917,3922,3920,2,22,2,2,2,843,843,841,841
Modoc,32,2022-07-25,5,5,5,0,28,29,28,1,0,1,1,0,9,9,8,8
Mono,32,2022-07-25,15,15,15,0,85,86,85,1,0,0,0,0,7,7,7,7
Monterey,32,2022-07-25,933,933,932,1,7142,7152,7143,9,39,1,1,3,758,758,757,757
Napa,32,2022-07-25,297,297,297,0,2934,2939,2937,2,6,3,3,0,154,154,151,151
Nevada,32,2022-07-25,116,116,116,0,1316,1316,1315,1,3,1,1,0,135,135,134,134
Orange,32,2022-07-25,8024,8036,8032,4,58148,58224,58197,27,306,37,37,35,7323,7323,7286,7286
Placer,32,2022-07-25,606,606,605,1,5086,5093,5089,4,77,5,5,11,651,651,646,646
Plumas,32,2022-07-25,25,25,25,0,188,189,188,1,0,0,0,0,13,13,13,13
Riverside,32,2022-07-25,7518,7528,7523,5,45936,45997,45968,29,259,16,16,27,6559,6559,6543,6543
Sacramento,32,2022-07-25,3633,3638,3636,2,29836,29876,29856,20,207,18,18,32,3220,3220,3202,3202
San Benito,32,2022-07-25,201,201,201,0,1836,1837,1836,1,0,1,1,0,97,97,96,96
San Bernardino,32,2022-07-25,7099,7108,7104,4,52148,52217,52191,26,214,30,30,23,7961,7961,7931,7931
San Diego,32,2022-07-25,11895,11910,11907,3,76176,76279,76263,16,393,19,19,41,5471,5471,5452,5452
San Francisco,32,2022-07-25,2300,2302,2299,3,24271,24303,24269,34,126,9,9,24,975,975,966,966
San Joaquin,32,2022-07-25,1838,1838,1837,1,16572,16593,16581,12,73,5,5,9,2293,2293,2288,2288
San Luis Obispo,32,2022-07-25,539,539,539,0,4382,4387,4384,3,16,4,4,1,511,511,507,507
San Mateo,32,2022-07-25,2030,2030,2029,1,21689,21716,21706,10,57,1,1,7,734,734,733,733
Santa Barbara,32,2022-07-25,1178,1178,1177,1,8770,8782,8776,6,37,4,4,3,715,715,711,711
Santa Clara,32,2022-07-25,5773,5780,5779,1,50881,50950,50939,11,238,16,16,26,2438,2438,2422,2422
Santa Cruz,32,2022-07-25,832,832,832,0,7665,7676,7672,4,23,0,0,0,268,268,268,268
Shasta,32,2022-07-25,305,305,305,0,3079,3083,3081,2,38,2,2,6,581,581,579,579
Siskiyou,32,2022-07-25,36,36,36,0,333,334,333,1,1,0,0,0,86,86,86,86
Solano,32,2022-07-25,1203,1203,1202,1,9480,9492,9486,6,56,0,0,5,455,455,455,455
Sonoma,32,2022-07-25,1066,1066,1065,1,8654,8666,8661,5,48,2,2,4,509,509,507,507
Stanislaus,32,2022-07-25,1377,1377,1376,1,8160,8171,8163,8,104,8,8,11,1737,1737,1729,1729
Sutter,32,2022-07-25,222,222,222,0,1723,1724,1723,1,0,0,0,0,228,228,228,228
Tehama,32,2022-07-25,103,103,103,0,920,920,919,1,5,2,2,0,212,212,210,210
Trinity,32,2022-07-25,12,12,12,0,102,103,102,1,0,0,0,0,20,20,20,20
Tulare,32,2022-07-25,1144,1144,1143,1,8015,8025,8017,8,42,2,2,2,1520,1520,1518,1518
Tuolumne,32,2022-07-25,200,200,200,0,1150,1150,1149,1,5,1,1,0,196,196,195,195
Ventura,32,2022-07-25,2153,2155,2154,1,18389,18414,18406,8,76,5,5,8,1545,1545,1540,1540
Yolo,32,2022-07-25,414,414,414,0,4392,4397,4395,2,4,3,3,1,380,380,377,377
Yuba,32,2022-07-25,175,175,175,0,1282,1282,1281,1,15,0,0,0,121,121,121,121
Alameda,33,2022-08-01,3817,3823,3822,1,37186,37237,37222,15,176,8,8,21,1990,1990,1982,1982
Amador,33,2022-08-01,53,53,53,0,1133,1133,1132,1,3,1,1,0,88,88,87,87
Butte,33,2022-08-01,368,368,368,0,2841,2845,2844,1,33,2,2,3,455,455,453,453
Calaveras,33,2022-08-01,68,68,68,0,573,574,573,1,2,1,1,2,132,132,131,131
Colusa,33,2022-08-01,26,26,26,0,362,363,362,1,7,0,0,0,22,22,22,22
Contra Costa,33,2022-08-01,2625,2629,2627,2,21021,21050,21036,14,86,13,13,15,1413,1413,1400,1400
Del Norte,33,2022-08-01,53,53,53,0,476,477,476,1,4,0,0,2,53,53,53,53
El Dorado,33,2022-08-01,232,232,232,0,2456,2461,2460,1,4,3,3,2,231,231,228,228
Fresno,33,2022-08-01,2998,3003,3001,2,18294,18320,18309,11,231,10,10,16,2829,2829,2819,2819
Glenn,33,2022-08-01,28,28,28,0,251,252,251,1,0,0,0,0,53,53,53,53
Humboldt,33,2022-08-01,224,224,224,0,1880,1881,1880,1,12,0,0,3,156,156,156,156
Imperial,33,2022-08-01,636,636,636,0,3526,3531,3529,2,22,5,5,3,957,957,952,952
Inyo,33,2022-08-01,20,20,20,0,280,281,280,1,2,0,0,0,58,58,58,58
Kern,33,2022-08-01,1729,1729,1728,1,15102,15123,15116,7,81,6,6,17,2390,2390,2384,2384
Kings,33,2022-08-01,624,624,624,0,4044,4049,4047,2,6,0,0,1,458,458,458,458
Lake,33,2022-08-01,125,125,125,0,994,994,993,1,7,0,0,2,143,143,143,143
Lassen,33,2022-08-01,103,103,103,0,947,949,948,1,0,0,0,0,63,63,63,63
Los Angeles,33,2022-08-01,30590,30632,30627,5,308937,309364,309316,48,1105,129,129,137,32838,32838,32709,32709
Madera,33,2022-08-01,463,463,463,0,3481,3486,3484,2,10,0,0,7,371,371,371,371
Marin,33,2022-08-01,411,411,411,0,5134,5140,5137,3,32,1,1,4,309,309,308,308
Mariposa,33,2022-08-01,22,22,22,0,225,226,225,1,0,0,0,0,29,29,29,29
Mendocino,33,2022-08-01,175,175,175,0,1258,1258,1257,1,6,1,1,1,134,134,133,133
Merced,33,2022-08-01,644,644,644,0,3568,3573,3571,2,22,6,6,2,849,849,843,843
Modoc,33,2022-08-01,16,16,16,0,31,32,31,1,0,0,0,0,9,9,9,9
Mono,33,2022-08-01,9,9,9,0,67,68,67,1,0,0,0,0,7,7,7,7
Monterey,33,2022-08-01,930,930,929,1,6430,6440,6434,6,33,2,2,1,760,760,758,758
Napa,33,2022-08-01,282,282,282,0,2838,2843,2842,1,8,0,0,2,154,154,154,154
Nevada,33,2022-08-01,125,125,125,0,1404,1405,1404,1,12,0,0,0,135,135,135,135
Orange,33,2022-08-01,6502,6511,6509,2,52424,52496,52477,19,246,34,34,49,7357,7357,7323,7323
Placer,33,2022-08-01,588,588,588,0,4744,4750,4747,3,71,1,1,11,652,652,651,651
Plumas,33,2022-08-01,23,23,23,0,162,163,162,1,0,0,0,0,13,13,13,13
Riverside,33,2022-08-01,6127,6135,6132,3,42288,42347,42326,21,200,5,5,23,6564,6564,6559,6559
Sacramento,33,2022-08-01,3095,3100,3098,2,27844,27883,27868,15,179,18,18,26,3238,3238,3220,3220
San Benito,33,2022-08-01,177,177,177,0,1561,1562,1561,1,2,1,1,0,98,98,97,97
San Bernardino,33,2022-08-01,6070,6079,6077,2,48923,48990,48971,19,184,26,26,23,7987,7987,7961,7961
San Diego,33,2022-08-01,9365,9377,9375,2,68641,68736,68725,11,396,16,16,46,5487,5487,5471,5471
San Francisco,33,2022-08-01,1815,1816,1814,2,21992,22023,21999,24,105,13,13,20,988,988,975,975
San Joaquin,33,2022-08-01,1734,1735,1734,1,16113,16135,16126,9,69,7,7,11,2300,2300,2293,2293
San Luis Obispo,33,2022-08-01,578,578,578,0,4141,4146,4144,2,14,3,3,0,514,514,511,511
San Mateo,33,2022-08-01,1774,1775,1774,1,20333,20361,20354,7,67,1,1,3,735,735,734,734
Santa Barbara,33,2022-08-01,1119,1119,1118,1,7779,7791,7787,4,40,1,1,3,716,716,715,715
Santa Clara,33,2022-08-01,4826,4833,4832,1,45489,45553,45545,8,230,19,19,36,2457,2457,2438,2438
Santa Cruz,33,2022-08-01,748,748,748,0,6877,6886,6883,3,20,1,1,3,269,269,268,268
Shasta,33,2022-08-01,245,245,245,0,2968,2972,2970,2,34,1,1,7,582,582,581,581
Siskiyou,33,2022-08-01,29,29,29,0,298,299,298,1,2,0,0,0,86,86,86,86
Solano,33,2022-08-01,1145,1145,1144,1,9145,9158,9153,5,53,0,0,4,455,455,455,455
Sonoma,33,2022-08-01,921,921,921,0,8185,8197,8193,4,46,3,3,3,512,512,509,509
Stanislaus,33,2022-08-01,1233,1233,1232,1,7720,7731,7725,6,115,6,6,8,1743,1743,1737,1737
Sutter,33,2022-08-01,232,232,232,0,1634,1635,1634,1,0,3,3,0,231,231,228,228
Tehama,33,2022-08-01,89,89,89,0,757,757,756,1,4,0,0,0,212,212,212,212
Trinity,33,2022-08-01,11,11,11,0,71,72,71,1,0,1,1,0,21,21,20,20
Tulare,33,2022-08-01,1035,1035,1034,1,7462,7471,7465,6,46,1,1,3,1521,1521,1520,1520
Tuolumne,33,2022-08-01,144,144,144,0,1111,1111,1110,1,4,0,0,1,196,196,196,196
Ventura,33,2022-08-01,1808,1808,1807,1,16969,16993,16987,6,75,10,10,10,1555,1555,1545,1545
Yolo,33,2022-08-01,333,333,333,0,4179,4184,4182,2,3,3,3,1,383,383,380,380
Yuba,33,2022-08-01,159,159,159,0,1215,1215,1214,1,10,0,0,3,121,121,121,121
Alameda,34,2022-08-08,3314,3319,3318,1,35421,35473,35462,11,133,15,15,20,2005,2005,1990,1990
Amador,34,2022-08-08,50,50,50,0,852,853,852,1,3,0,0,1,88,88,88,88
Butte,34,2022-08-08,334,334,334,0,2494,2498,2497,1,33,1,1,1,456,456,455,455
Calaveras,34,2022-08-08,57,57,57,0,559,560,559,1,1,1,1,0,133,133,132,132
Colusa,34,2022-08-08,15,15,15,0,362,363,362,1,0,0,0,0,22,22,22,22
Contra Costa,34,2022-08-08,2182,2185,2184,1,19805,19834,19824,10,102,4,4,14,1417,1417,1413,1413
Del Norte,34,2022-08-08,49,49,49,0,498,499,498,1,4,1,1,1,54,54,53,53
El Dorado,34,2022-08-08,191,191,191,0,2317,2321,2320,1,4,0,0,2,231,231,231,231
Fresno,34,2022-08-08,2424,2428,2427,1,17742,17768,17759,9,207,9,9,25,2838,2838,2829,2829
Glenn,34,2022-08-08,22,22,22,0,249,250,249,1,0,0,0,0,53,53,53,53
Humboldt,34,2022-08-08,208,208,208,0,1920,1922,1921,1,12,1,1,2,157,157,156,156
Imperial,34,2022-08-08,548,548,548,0,3279,3284,3283,1,16,2,2,2,959,959,957,957
Inyo,34,2022-08-08,8,8,8,0,276,277,276,1,1,0,0,1,58,58,58,58
Kern,34,2022-08-08,1339,1339,1339,0,13982,14001,13996,5,61,6,6,16,2396,2396,2390,2390
Kings,34,2022-08-08,467,467,467,0,3326,3331,3330,1,20,1,1,2,459,459,458,458
Lake,34,2022-08-08,106,106,106,0,893,894,893,1,4,0,0,1,143,143,143,143
Lassen,34,2022-08-08,132,132,132,0,1023,1025,1024,1,1,0,0,0,63,63,63,63
Los Angeles,34,2022-08-08,25780,25817,25814,3,293366,293794,293759,35,1030,129,129,121,32967,32967,32838,32838
Madera,34,2022-08-08,380,380,380,0,3175,3180,3178,2,16,0,0,3,371,371,371,371
Marin,34,2022-08-08,361,361,361,0,4485,4491,4489,2,26,2,2,2,311,311,309,309
Mariposa,34,2022-08-08,28,28,28,0,197,198,197,1,0,0,0,0,29,29,29,29
Mendocino,34,2022-08-08,132,132,132,0,1128,1128,1127,1,3,1,1,1,135,135,134,134
Merced,34,2022-08-08,538,538,538,0,3396,3401,3400,1,17,1,1,5,850,850,849,849
Modoc,34,2022-08-08,2,2,2,0,22,23,22,1,0,0,0,0,9,9,9,9
Mono,34,2022-08-08,10,10,10,0,85,86,85,1,0,0,0,0,7,7,7,7
Monterey,34,2022-08-08,736,736,735,1,5773,5782,5778,4,28,1,1,0,761,761,760,760
Napa,34,2022-08-08,252,252,252,0,2614,2619,2618,1,10,2,2,3,156,156,154,154
Nevada,34,2022-08-08,94,94,94,0,1290,1290,1289,1,4,0,0,0,135,135,135,135
Orange,34,2022-08-08,5434,5441,5439,2,48983,49055,49041,14,242,29,29,40,7386,7386,7357,7357
Placer,34,2022-08-08,513,513,513,0,4519,4525,4523,2,65,3,3,9,655,655,652,652
Plumas,34,2022-08-08,23,23,23,0,190,191,190,1,1,0,0,0,13,13,13,13
Riverside,34,2022-08-08,5566,5573,5571,2,40848,40908,40892,16,174,13,13,13,6577,6577,6564,6564
Sacramento,34,2022-08-08,2623,2628,2627,1,26972,27012,27001,11,156,17,17,20,3255,3255,3238,3238
San Benito,34,2022-08-08,186,186,186,0,1433,1434,1433,1,1,0,0,0,98,98,98,98
San Bernardino,34,2022-08-08,5111,5118,5116,2,46296,46363,46349,14,204,20,20,15,8007,8007,7987,7987
San Diego,34,2022-08-08,7271,7282,7281,1,64799,64893,64885,8,337,11,11,30,5498,5498,5487,5487
San Francisco,34,2022-08-08,1495,1495,1494,1,20636,20666,20649,17,94,11,11,21,999,999,988,988
San Joaquin,34,2022-08-08,1522,1522,1521,1,15717,15739,15732,7,55,6,6,12,2306,2306,2300,2300
San Luis Obispo,34,2022-08-08,509,509,509,0,3613,3618,3617,1,14,0,0,2,514,514,514,514
San Mateo,34,2022-08-08,1528,1528,1528,0,18588,18616,18611,5,60,0,0,5,735,735,735,735
Santa Barbara,34,2022-08-08,964,964,964,0,7525,7537,7534,3,46,3,3,4,719,719,716,716
Santa Clara,34,2022-08-08,4184,4191,4190,1,41197,41259,41253,6,203,17,17,40,2474,2474,2457,2457
Santa Cruz,34,2022-08-08,619,619,619,0,6060,6067,6065,2,28,1,1,0,270,270,269,269
Shasta,34,2022-08-08,198,198,198,0,2833,2836,2835,1,33,1,1,3,583,583,582,582
Siskiyou,34,2022-08-08,27,27,27,0,291,292,291,1,0,1,1,0,87,87,86,86
Solano,34,2022-08-08,883,883,883,0,7967,7980,7977,3,54,0,0,9,455,455,455,455
Sonoma,34,2022-08-08,839,839,839,0,7726,7738,7735,3,34,4,4,3,516,516,512,512
Stanislaus,34,2022-08-08,1035,1035,1034,1,7175,7186,7182,4,90,7,7,11,1750,1750,1743,1743
Sutter,34,2022-08-08,223,223,223,0,1552,1553,1552,1,0,0,0,0,231,231,231,231
Tehama,34,2022-08-08,78,78,78,0,681,682,681,1,0,0,0,1,212,212,212,212
Trinity,34,2022-08-08,5,5,5,0,71,72,71,1,0,0,0,0,21,21,21,21
Tulare,34,2022-08-08,886,886,885,1,7321,7331,7327,4,46,4,4,3,1525,1525,1521,1521
Tuolumne,34,2022-08-08,118,118,118,0,1054,1054,1053,1,4,2,2,0,198,198,196,196
Ventura,34,2022-08-08,1503,1503,1503,0,15931,15955,15951,4,67,7,7,7,1562,1562,1555,1555
Yolo,34,2022-08-08,287,287,287,0,3881,3886,3885,1,4,1,1,3,384,384,383,383
Yuba,34,2022-08-08,136,136,136,0,1086,1087,1086,1,6,1,1,0,122,122,121,121
Alameda,35,2022-08-15,2590,2594,2593,1,33885,33937,33929,8,105,9,9,22,2014,2014,2005,2005
Amador,35,2022-08-15,47,47,47,0,848,849,848,1,2,0,0,0,88,88,88,88
Butte,35,2022-08-15,262,262,262,0,2245,2250,2249,1,19,0,0,2,456,456,456,456
Calaveras,35,2022-08-15,46,46,46,0,528,529,528,1,0,0,0,0,133,133,133,133
Colusa,35,2022-08-15,16,16,16,0,359,360,359,1,1,0,0,0,22,22,22,22
Contra Costa,35,2022-08-15,1777,1778,1777,1,18969,18997,18989,8,72,7,7,9,1424,1424,1417,1417
Del Norte,35,2022-08-15,53,53,53,0,499,500,499,1,2,0,0,1,54,54,54,54
El Dorado,35,2022-08-15,178,178,178,0,2304,2308,2307,1,5,0,0,3,231,231,231,231
Fresno,35,2022-08-15,1869,1870,1869,1,16162,16187,16181,6,170,7,7,17,2845,2845,2838,2838
Glenn,35,2022-08-15,15,15,15,0,225,226,225,1,3,0,0,0,53,53,53,53
Humboldt,35,2022-08-15,179,179,179,0,1587,1588,1587,1,16,0,0,2,157,157,157,157
Imperial,35,2022-08-15,365,365,365,0,3101,3106,3105,1,11,0,0,2,959,959,959,959
Inyo,35,2022-08-15,14,14,14,0,238,239,238,1,2,1,1,0,59,59,58,58
Kern,35,2022-08-15,1237,1237,1237,0,13701,13721,13717,4,59,7,7,16,2403,2403,2396,2396
Kings,35,2022-08-15,332,332,332,0,3235,3240,3239,1,9,0,0,1,459,459,459,459
Lake,35,2022-08-15,104,104,104,0,1028,1029,1028,1,3,1,1,2,144,144,143,143
Lassen,35,2022-08-15,59,59,59,0,898,899,898,1,0,0,0,0,63,63,63,63
Los Angeles,35,2022-08-15,20945,20977,20975,2,289514,289953,289926,27,905,110,110,117,33077,33077,32967,32967
Madera,35,2022-08-15,305,305,305,0,2954,2958,2957,1,12,0,0,3,371,371,371,371
Marin,35,2022-08-15,295,295,295,0,4113,4119,4117,2,15,0,0,0,311,311,311,311
Mariposa,35,2022-08-15,15,15,15,0,192,193,192,1,0,0,0,0,29,29,29,29
Mendocino,35,2022-08-15,104,104,104,0,996,996,995,1,7,0,0,3,135,135,135,135
Merced,35,2022-08-15,453,453,453,0,3427,3432,3431,1,12,2,2,1,852,852,850,850
Modoc,35,2022-08-15,4,4,4,0,23,24,23,1,0,0,0,0,9,9,9,9
Mono,35,2022-08-15,4,4,4,0,61,62,61,1,0,0,0,0,7,7,7,7
Monterey,35,2022-08-15,662,662,662,0,5824,5833,5830,3,30,0,0,1,761,761,761,761
Napa,35,2022-08-15,212,212,212,0,2280,2285,2284,1,13,0,0,0,156,156,156,156
Nevada,35,2022-08-15,98,98,98,0,1209,1211,1210,1,7,0,0,0,135,135,135,135
Orange,35,2022-08-15,4662,4669,4668,1,43732,43799,43789,10,270,31,31,44,7417,7417,7386,7386
Placer,35,2022-08-15,411,411,411,0,4469,4475,4473,2,61,1,1,11,656,656,655,655
Plumas,35,2022-08-15,17,17,17,0,184,185,184,1,0,0,0,0,13,13,13,13
Riverside,35,2022-08-15,4599,4606,4605,1,38259,38317,38306,11,143,16,16,22,6593,6593,6577,6577
Sacramento,35,2022-08-15,2359,2362,2361,1,25434,25472,25464,8,149,12,12,22,3267,3267,3255,3255
San Benito,35,2022-08-15,140,140,140,0,1336,1338,1337,1,3,1,1,1,99,99,98,98
San Bernardino,35,2022-08-15,4737,4744,4743,1,44504,44572,44561,11,144,14,14,22,8021,8021,8007,8007
San Diego,35,2022-08-15,5502,5510,5509,1,59786,59878,59872,6,288,14,14,34,5512,5512,5498,5498
San Francisco,35,2022-08-15,1267,1267,1266,1,19587,19617,19604,13,103,15,15,11,1014,1014,999,999
San Joaquin,35,2022-08-15,1443,1443,1442,1,15216,15239,15234,5,64,8,8,8,2314,2314,2306,2306
San Luis Obispo,35,2022-08-15,325,325,325,0,3302,3307,3306,1,15,4,4,3,518,518,514,514
San Mateo,35,2022-08-15,1235,1235,1235,0,17463,17490,17486,4,56,1,1,5,736,736,735,735
Santa Barbara,35,2022-08-15,831,831,831,0,7130,7142,7140,2,44,1,1,4,720,720,719,719
Santa Clara,35,2022-08-15,3402,3409,3409,0,40109,40169,40165,4,200,8,8,24,2482,2482,2474,2474
Santa Cruz,35,2022-08-15,493,493,493,0,7545,7557,7555,2,23,3,3,1,273,273,270,270
Shasta,35,2022-08-15,194,194,194,0,2788,2792,2791,1,19,1,1,1,584,584,583,583
Siskiyou,35,2022-08-15,19,19,19,0,284,285,284,1,3,0,0,1,87,87,87,87
Solano,35,2022-08-15,662,662,662,0,7459,7471,7469,2,45,0,0,10,455,455,455,455
Sonoma,35,2022-08-15,632,632,632,0,7288,7300,7298,2,39,2,2,2,518,518,516,516
Stanislaus,35,2022-08-15,940,940,940,0,7658,7671,7667,4,99,9,9,11,1759,1759,1750,1750
Sutter,35,2022-08-15,197,197,197,0,1587,1589,1588,1,0,1,1,0,232,232,231,231
Tehama,35,2022-08-15,60,60,60,0,645,646,645,1,1,0,0,0,212,212,212,212
Trinity,35,2022-08-15,8,8,8,0,58,59,58,1,0,0,0,0,21,21,21,21
Tulare,35,2022-08-15,734,734,734,0,7328,7338,7335,3,32,3,3,1,1528,1528,1525,1525
Tuolumne,35,2022-08-15,110,110,110,0,991,992,991,1,1,0,0,0,198,198,198,198
Ventura,35,2022-08-15,1494,1494,1494,0,15264,15287,15284,3,70,6,6,7,1568,1568,1562,1562
Yolo,35,2022-08-15,264,264,264,0,3540,3545,3544,1,2,4,4,1,388,388,384,384
Yuba,35,2022-08-15,128,128,128,0,1080,1081,1080,1,9,0,0,0,122,122,122,122
Alameda,36,2022-08-22,2257,2261,2261,0,33316,33369,33363,6,117,9,9,21,2023,2023,2014,2014
Amador,36,2022-08-22,49,49,49,0,817,818,817,1,2,1,1,0,89,89,88,88
Butte,36,2022-08-22,222,222,222,0,2131,2136,2135,1,17,1,1,2,457,457,456,456
Calaveras,36,2022-08-22,43,43,43,0,572,573,572,1,1,0,0,0,133,133,133,133
Colusa,36,2022-08-22,16,16,16,0,394,395,394,1,0,0,0,0,22,22,22,22
Contra Costa,36,2022-08-22,1530,1530,1530,0,18843,18872,18866,6,56,5,5,9,1429,1429,1424,1424
Del Norte,36,2022-08-22,32,32,32,0,462,463,462,1,3,1,1,0,55,55,54,54
El Dorado,36,2022-08-22,152,152,152,0,2220,2224,2223,1,4,1,1,0,232,232,231,231
Fresno,36,2022-08-22,1597,1597,1597,0,15769,15794,15789,5,162,6,6,14,2851,2851,2845,2845
Glenn,36,2022-08-22,23,23,23,0,227,228,227,1,1,0,0,0,53,53,53,53
Humboldt,36,2022-08-22,151,151,151,0,1679,1681,1680,1,6,1,1,3,158,158,157,157
Imperial,36,2022-08-22,292,292,292,0,2845,2850,2849,1,15,0,0,0,959,959,959,959
Inyo,36,2022-08-22,8,8,8,0,214,215,214,1,0,0,0,0,59,59,59,59
Kern,36,2022-08-22,999,999,999,0,13976,13996,13993,3,69,6,6,10,2409,2409,2403,2403
Kings,36,2022-08-22,369,369,369,0,3636,3641,3640,1,10,2,2,0,461,461,459,459
Lake,36,2022-08-22,104,104,104,0,884,885,884,1,5,0,0,0,144,144,144,144
Lassen,36,2022-08-22,37,37,37,0,834,835,834,1,0,0,0,0,63,63,63,63
Los Angeles,36,2022-08-22,18485,18514,18513,1,276757,277191,277171,20,811,121,121,104,33198,33198,33077,33077
Madera,36,2022-08-22,300,300,300,0,2613,2617,2616,1,14,2,2,4,373,373,371,371
Marin,36,2022-08-22,250,250,250,0,3967,3973,3972,1,17,0,0,3,311,311,311,311
Mariposa,36,2022-08-22,14,14,14,0,172,173,172,1,0,0,0,0,29,29,29,29
Mendocino,36,2022-08-22,121,121,121,0,1145,1146,1145,1,3,0,0,2,135,135,135,135
Merced,36,2022-08-22,447,447,447,0,3659,3664,3663,1,12,4,4,1,856,856,852,852
Modoc,36,2022-08-22,6,6,6,0,27,28,27,1,0,0,0,0,9,9,9,9
Mono,36,2022-08-22,4,4,4,0,63,64,63,1,0,0,0,0,7,7,7,7
Monterey,36,2022-08-22,549,549,549,0,5927,5936,5933,3,27,1,1,2,762,762,761,761
Napa,36,2022-08-22,127,127,127,0,2002,2007,2006,1,5,2,2,1,158,158,156,156
Nevada,36,2022-08-22,84,84,84,0,1180,1181,1180,1,6,0,0,0,135,135,135,135
Orange,36,2022-08-22,3893,3900,3899,1,41427,41493,41486,7,224,21,21,35,7438,7438,7417,7417
Placer,36,2022-08-22,384,384,384,0,4307,4313,4312,1,61,1,1,14,657,657,656,656
Plumas,36,2022-08-22,20,20,20,0,175,176,175,1,1,0,0,0,13,13,13,13
Riverside,36,2022-08-22,4420,4427,4426,1,37724,37782,37773,9,142,13,13,19,6606,6606,6593,6593
Sacramento,36,2022-08-22,2090,2094,2093,1,25029,25070,25064,6,144,15,15,25,3282,3282,3267,3267
San Benito,36,2022-08-22,102,102,102,0,1268,1270,1269,1,1,1,1,1,100,100,99,99
San Bernardino,36,2022-08-22,4697,4704,4703,1,44667,44738,44730,8,160,18,18,22,8039,8039,8021,8021
San Diego,36,2022-08-22,4782,4789,4789,0,57812,57902,57898,4,287,6,6,28,5518,5518,5512,5512
San Francisco,36,2022-08-22,1097,1097,1096,1,18874,18903,18893,10,81,16,16,12,1030,1030,1014,1014
San Joaquin,36,2022-08-22,1196,1196,1196,0,15725,15750,15746,4,56,1,1,8,2315,2315,2314,2314
San Luis Obispo,36,2022-08-22,259,259,259,0,3090,3095,3094,1,16,1,1,0,519,519,518,518
San Mateo,36,2022-08-22,1028,1028,1028,0,17319,17348,17345,3,42,0,0,2,736,736,736,736
Santa Barbara,36,2022-08-22,736,736,736,0,7443,7455,7453,2,37,1,1,2,721,721,720,720
Santa Clara,36,2022-08-22,3079,3084,3084,0,40559,40622,40619,3,173,10,10,27,2492,2492,2482,2482
Santa Cruz,36,2022-08-22,502,502,502,0,11965,11984,11982,2,13,0,0,0,273,273,273,273
Shasta,36,2022-08-22,174,174,174,0,2760,2764,2763,1,10,2,2,2,586,586,584,584
Siskiyou,36,2022-08-22,25,25,25,0,249,250,249,1,4,1,1,2,88,88,87,87
Solano,36,2022-08-22,534,534,534,0,7220,7233,7231,2,35,0,0,12,455,455,455,455
Sonoma,36,2022-08-22,605,605,605,0,7374,7386,7384,2,42,1,1,1,519,519,518,518
Stanislaus,36,2022-08-22,894,894,894,0,7650,7663,7660,3,79,7,7,16,1766,1766,1759,1759
Sutter,36,2022-08-22,189,189,189,0,1657,1659,1658,1,0,0,0,0,232,232,232,232
Tehama,36,2022-08-22,53,53,53,0,629,630,629,1,1,0,0,0,212,212,212,212
Trinity,36,2022-08-22,10,10,10,0,63,64,63,1,0,0,0,0,21,21,21,21
Tulare,36,2022-08-22,731,731,731,0,6786,6796,6794,2,33,4,4,1,1532,1532,1528,1528
Tuolumne,36,2022-08-22,106,106,106,0,1018,1019,1018,1,0,1,1,0,199,199,198,198
Ventura,36,2022-08-22,1319,1319,1319,0,15001,15025,15023,2,59,4,4,9,1572,1572,1568,1568
Yolo,36,2022-08-22,200,200,200,0,3492,3497,3496,1,10,1,1,1,389,389,388,388
Yuba,36,2022-08-22,127,127,127,0,1106,1107,1106,1,13,0,0,3,122,122,122,122
Alameda,37,2022-08-29,1990,1993,1993,0,34348,34403,34398,5,99,11,11,20,2034,2034,2023,2023
Amador,37,2022-08-29,46,46,46,0,804,805,804,1,2,1,1,0,90,90,89,89
Butte,37,2022-08-29,236,236,236,0,2173,2178,2177,1,18,0,0,3,457,457,457,457
Calaveras,37,2022-08-29,59,59,59,0,593,594,593,1,1,0,0,0,133,133,133,133
Colusa,37,2022-08-29,11,11,11,0,329,330,329,1,3,0,0,0,22,22,22,22
Contra Costa,37,2022-08-29,1358,1358,1358,0,18807,18838,18833,5,44,5,5,7,1434,1434,1429,1429
Del Norte,37,2022-08-29,28,28,28,0,432,433,432,1,5,0,0,1,55,55,55,55
El Dorado,37,2022-08-29,143,143,143,0,1947,1951,1950,1,1,0,0,1,232,232,232,232
Fresno,37,2022-08-29,1419,1419,1419,0,15724,15750,15746,4,159,3,3,15,2854,2854,2851,2851
Glenn,37,2022-08-29,22,22,22,0,220,221,220,1,1,0,0,0,53,53,53,53
Humboldt,37,2022-08-29,124,124,124,0,1664,1666,1665,1,4,0,0,0,158,158,158,158
Imperial,37,2022-08-29,294,294,294,0,2936,2941,2940,1,14,1,1,2,960,960,959,959
Inyo,37,2022-08-29,8,8,8,0,176,177,176,1,0,0,0,0,59,59,59,59
Kern,37,2022-08-29,906,906,906,0,13447,13468,13466,2,50,0,0,8,2409,2409,2409,2409
Kings,37,2022-08-29,314,314,314,0,3490,3495,3494,1,8,0,0,0,461,461,461,461
Lake,37,2022-08-29,93,93,93,0,870,871,870,1,1,1,1,0,145,145,144,144
Lassen,37,2022-08-29,28,28,28,0,772,773,772,1,0,0,0,0,63,63,63,63
Los Angeles,37,2022-08-29,15558,15583,15582,1,273726,274170,274154,16,753,87,87,83,33285,33285,33198,33198
Madera,37,2022-08-29,302,302,302,0,3019,3024,3023,1,13,0,0,3,373,373,373,373
Marin,37,2022-08-29,215,215,215,0,3848,3854,3853,1,16,2,2,2,313,313,311,311
Mariposa,37,2022-08-29,25,25,25,0,186,187,186,1,0,0,0,0,29,29,29,29
Mendocino,37,2022-08-29,87,87,87,0,969,970,969,1,2,0,0,1,135,135,135,135
Merced,37,2022-08-29,393,393,393,0,3418,3423,3422,1,11,3,3,0,859,859,856,856
Modoc,37,2022-08-29,1,1,1,0,30,31,30,1,0,0,0,0,9,9,9,9
Mono,37,2022-08-29,2,2,2,0,45,46,45,1,0,0,0,0,7,7,7,7
Monterey,37,2022-08-29,395,395,395,0,5383,5392,5390,2,33,2,2,5,764,764,762,762
Napa,37,2022-08-29,129,129,129,0,2161,2167,2166,1,10,0,0,1,158,158,158,158
Nevada,37,2022-08-29,116,116,116,0,1206,1208,1207,1,6,0,0,0,135,135,135,135
Orange,37,2022-08-29,3032,3037,3037,0,39953,40017,40012,5,195,18,18,25,7456,7456,7438,7438
Placer,37,2022-08-29,370,370,370,0,4217,4224,4223,1,55,1,1,12,658,658,657,657
Plumas,37,2022-08-29,17,17,17,0,159,160,159,1,1,0,0,0,13,13,13,13
Riverside,37,2022-08-29,3677,3684,3683,1,37023,37083,37076,7,124,9,9,11,6615,6615,6606,6606
Sacramento,37,2022-08-29,1880,1883,1883,0,24822,24863,24858,5,137,11,11,20,3293,3293,3282,3282
San Benito,37,2022-08-29,120,120,120,0,1410,1412,1411,1,1,0,0,0,100,100,100,100
San Bernardino,37,2022-08-29,3682,3689,3688,1,42583,42652,42646,6,156,14,14,18,8053,8053,8039,8039
San Diego,37,2022-08-29,3932,3939,3939,0,56917,57009,57006,3,222,12,12,25,5530,5530,5518,5518
San Francisco,37,2022-08-29,874,874,874,0,19157,19188,19180,8,57,7,7,12,1037,1037,1030,1030
San Joaquin,37,2022-08-29,1005,1005,1005,0,14298,14321,14318,3,27,5,5,11,2320,2320,2315,2315
San Luis Obispo,37,2022-08-29,326,326,326,0,3217,3222,3221,1,17,3,3,0,522,522,519,519
San Mateo,37,2022-08-29,872,872,872,0,16902,16929,16927,2,26,0,0,5,736,736,736,736
Santa Barbara,37,2022-08-29,638,638,638,0,7627,7639,7638,1,24,1,1,3,722,722,721,721
Santa Clara,37,2022-08-29,2357,2362,2362,0,40001,40066,40063,3,135,5,5,24,2497,2497,2492,2492
Santa Cruz,37,2022-08-29,385,385,385,0,12686,12706,12704,2,16,0,0,1,273,273,273,273
Shasta,37,2022-08-29,131,131,131,0,2578,2582,2581,1,19,1,1,1,587,587,586,586
Siskiyou,37,2022-08-29,24,24,24,0,249,250,249,1,0,1,1,0,89,89,88,88
Solano,37,2022-08-29,549,549,549,0,7289,7302,7301,1,33,1,1,8,456,456,455,455
Sonoma,37,2022-08-29,486,486,486,0,7108,7120,7119,1,37,1,1,4,520,520,519,519
Stanislaus,37,2022-08-29,849,849,849,0,8083,8096,8094,2,79,7,7,6,1773,1773,1766,1766
Sutter,37,2022-08-29,170,170,170,0,1638,1640,1639,1,0,0,0,0,232,232,232,232
Tehama,37,2022-08-29,67,67,67,0,738,739,738,1,4,0,0,1,212,212,212,212
Trinity,37,2022-08-29,9,9,9,0,56,57,56,1,0,0,0,0,21,21,21,21
Tulare,37,2022-08-29,683,683,683,0,7373,7383,7381,2,42,0,0,1,1532,1532,1532,1532
Tuolumne,37,2022-08-29,91,91,91,0,856,857,856,1,1,0,0,0,199,199,199,199
Ventura,37,2022-08-29,1021,1021,1021,0,14607,14631,14629,2,71,6,6,7,1578,1578,1572,1572
Yolo,37,2022-08-29,204,204,204,0,3717,3722,3721,1,5,0,0,3,389,389,389,389
Yuba,37,2022-08-29,135,135,135,0,1176,1177,1176,1,14,0,0,1,122,122,122,122
Alameda,38,2022-09-05,1461,1462,1462,0,28342,28389,28386,3,89,5,5,16,2039,2039,2034,2034
Amador,38,2022-09-05,44,44,44,0,748,749,748,1,3,0,0,2,90,90,90,90
Butte,38,2022-09-05,193,193,193,0,2125,2129,2128,1,14,2,2,2,459,459,457,457
Calaveras,38,2022-09-05,22,22,22,0,452,453,452,1,0,0,0,0,133,133,133,133
Colusa,38,2022-09-05,8,8,8,0,197,198,197,1,2,0,0,0,22,22,22,22
Contra Costa,38,2022-09-05,954,954,954,0,15434,15459,15456,3,62,5,5,9,1439,1439,1434,1434
Del Norte,38,2022-09-05,9,9,9,0,347,348,347,1,1,0,0,1,55,55,55,55
El Dorado,38,2022-09-05,91,91,91,0,1524,1527,1526,1,3,1,1,3,233,233,232,232
Fresno,38,2022-09-05,1085,1085,1085,0,13046,13068,13066,2,162,10,10,16,2864,2864,2854,2854
Glenn,38,2022-09-05,11,11,11,0,188,189,188,1,1,0,0,0,53,53,53,53
Humboldt,38,2022-09-05,110,110,110,0,1295,1296,1295,1,9,1,1,2,159,159,158,158
Imperial,38,2022-09-05,235,235,235,0,2522,2527,2526,1,8,1,1,2,961,961,960,960
Inyo,38,2022-09-05,12,12,12,0,139,140,139,1,0,0,0,1,59,59,59,59
Kern,38,2022-09-05,739,739,739,0,11391,11410,11408,2,50,5,5,8,2414,2414,2409,2409
Kings,38,2022-09-05,229,229,229,0,2869,2874,2873,1,8,0,0,0,461,461,461,461
Lake,38,2022-09-05,62,62,62,0,655,656,655,1,1,3,3,1,148,148,145,145
Lassen,38,2022-09-05,19,19,19,0,633,634,633,1,0,0,0,0,63,63,63,63
Los Angeles,38,2022-09-05,10704,10723,10723,0,224241,224612,224602,10,695,96,96,91,33381,33381,33285,33285
Madera,38,2022-09-05,206,206,206,0,2506,2511,2510,1,12,0,0,4,373,373,373,373
Marin,38,2022-09-05,191,191,191,0,3557,3563,3562,1,12,0,0,1,313,313,313,313
Mariposa,38,2022-09-05,16,16,16,0,166,167,166,1,0,0,0,0,29,29,29,29
Mendocino,38,2022-09-05,57,57,57,0,828,829,828,1,2,1,1,1,136,136,135,135
Merced,38,2022-09-05,251,251,251,0,2640,2645,2644,1,12,2,2,1,861,861,859,859
Modoc,38,2022-09-05,3,3,3,0,17,18,17,1,0,0,0,0,9,9,9,9
Mono,38,2022-09-05,4,4,4,0,52,53,52,1,1,0,0,0,7,7,7,7
Monterey,38,2022-09-05,245,245,245,0,4380,4386,4385,1,24,4,4,0,768,768,764,764
Napa,38,2022-09-05,102,102,102,0,1725,1730,1729,1,6,1,1,2,159,159,158,158
Nevada,38,2022-09-05,81,81,81,0,899,900,899,1,3,0,0,0,135,135,135,135
Orange,38,2022-09-05,2244,2248,2248,0,32843,32898,32894,4,169,13,13,34,7469,7469,7456,7456
Placer,38,2022-09-05,238,238,238,0,3479,3485,3484,1,36,0,0,4,658,658,658,658
Plumas,38,2022-09-05,9,9,9,0,130,131,130,1,0,0,0,0,13,13,13,13
Riverside,38,2022-09-05,2433,2437,2437,0,28763,28811,28807,4,99,7,7,14,6622,6622,6615,6615
Sacramento,38,2022-09-05,1273,1273,1273,0,19822,19855,19852,3,139,12,12,22,3305,3305,3293,3293
San Benito,38,2022-09-05,65,65,65,0,1087,1088,1087,1,0,0,0,2,100,100,100,100
San Bernardino,38,2022-09-05,2368,2372,2372,0,34557,34615,34611,4,122,14,14,19,8067,8067,8053,8053
San Diego,38,2022-09-05,2802,2806,2806,0,48504,48583,48581,2,212,15,15,25,5545,5545,5530,5530
San Francisco,38,2022-09-05,681,681,681,0,15741,15766,15761,5,52,9,9,9,1046,1046,1037,1037
San Joaquin,38,2022-09-05,831,831,831,0,11954,11975,11973,2,43,4,4,10,2324,2324,2320,2320
San Luis Obispo,38,2022-09-05,176,176,176,0,2677,2682,2681,1,7,2,2,1,524,524,522,522
San Mateo,38,2022-09-05,632,632,632,0,13669,13692,13691,1,23,1,1,2,737,737,736,736
Santa Barbara,38,2022-09-05,485,485,485,0,6633,6645,6644,1,39,4,4,3,726,726,722,722
Santa Clara,38,2022-09-05,1929,1932,1932,0,33400,33455,33453,2,127,10,10,20,2507,2507,2497,2497
Santa Cruz,38,2022-09-05,282,282,282,0,10222,10239,10238,1,16,0,0,0,273,273,273,273
Shasta,38,2022-09-05,104,104,104,0,2023,2027,2026,1,15,0,0,0,587,587,587,587
Siskiyou,38,2022-09-05,30,30,30,0,216,217,216,1,0,0,0,0,89,89,89,89
Solano,38,2022-09-05,368,368,368,0,5959,5970,5969,1,34,1,1,11,457,457,456,456
Sonoma,38,2022-09-05,369,369,369,0,6006,6016,6015,1,40,0,0,2,520,520,520,520
Stanislaus,38,2022-09-05,548,548,548,0,6350,6361,6360,1,69,5,5,4,1778,1778,1773,1773
Sutter,38,2022-09-05,118,118,118,0,1482,1484,1483,1,0,0,0,0,232,232,232,232
Tehama,38,2022-09-05,50,50,50,0,581,582,581,1,2,1,1,0,213,213,212,212
Trinity,38,2022-09-05,4,4,4,0,51,52,51,1,0,0,0,0,21,21,21,21
Tulare,38,2022-09-05,431,431,431,0,5164,5171,5170,1,37,2,2,1,1534,1534,1532,1532
Tuolumne,38,2022-09-05,68,68,68,0,737,738,737,1,1,0,0,0,199,199,199,199
Ventura,38,2022-09-05,864,864,864,0,12314,12334,12333,1,48,8,8,1,1586,1586,1578,1578
Yolo,38,2022-09-05,140,140,140,0,2909,2914,2913,1,1,3,3,2,392,392,389,389
Yuba,38,2022-09-05,88,88,88,0,977,978,977,1,14,0,0,1,122,122,122,122
Alameda,39,2022-09-12,1629,1629,1629,0,32242,32296,32293,3,94,5,5,16,2044,2044,2039,2039
Amador,39,2022-09-12,32,32,32,0,874,875,874,1,3,0,0,2,90,90,90,90
Butte,39,2022-09-12,196,196,196,0,2469,2474,2473,1,15,3,3,2,462,462,459,459
Calaveras,39,2022-09-12,14,14,14,0,501,502,501,1,1,0,0,0,133,133,133,133
Colusa,39,2022-09-12,17,17,17,0,414,415,414,1,0,0,0,0,22,22,22,22
Contra Costa,39,2022-09-12,979,979,979,0,17341,17370,17367,3,59,6,6,12,1445,1445,1439,1439
Del Norte,39,2022-09-12,34,34,34,0,595,596,595,1,1,0,0,1,55,55,55,55
El Dorado,39,2022-09-12,104,104,104,0,1904,1909,1908,1,3,0,0,1,233,233,233,233
Fresno,39,2022-09-12,907,907,907,0,14661,14687,14685,2,155,6,6,15,2870,2870,2864,2864
Glenn,39,2022-09-12,15,15,15,0,208,209,208,1,0,0,0,0,53,53,53,53
Humboldt,39,2022-09-12,113,113,113,0,1653,1657,1656,1,6,0,0,5,159,159,159,159
Imperial,39,2022-09-12,258,258,258,0,3287,3293,3292,1,10,0,0,2,961,961,961,961
Inyo,39,2022-09-12,15,15,15,0,194,195,194,1,0,1,1,0,60,60,59,59
Kern,39,2022-09-12,646,646,646,0,12995,13018,13017,1,45,7,7,13,2421,2421,2414,2414
Kings,39,2022-09-12,229,229,229,0,3172,3178,3177,1,6,1,1,0,462,462,461,461
Lake,39,2022-09-12,48,48,48,0,882,883,882,1,3,0,0,1,148,148,148,148
Lassen,39,2022-09-12,20,20,20,0,917,918,917,1,0,0,0,0,63,63,63,63
Los Angeles,39,2022-09-12,11021,11041,11041,0,284769,285255,285245,10,652,84,84,83,33465,33465,33381,33381
Madera,39,2022-09-12,242,242,242,0,2923,2929,2928,1,8,0,0,3,373,373,373,373
Marin,39,2022-09-12,174,174,174,0,3914,3919,3918,1,12,2,2,2,315,315,313,313
Mariposa,39,2022-09-12,16,16,16,0,192,193,192,1,0,0,0,0,29,29,29,29
Mendocino,39,2022-09-12,58,58,58,0,952,953,952,1,2,0,0,1,136,136,136,136
Merced,39,2022-09-12,237,237,237,0,3317,3323,3322,1,6,2,2,1,863,863,861,861
Modoc,39,2022-09-12,2,2,2,0,22,23,22,1,0,0,0,0,9,9,9,9
Mono,39,2022-09-12,7,7,7,0,77,78,77,1,0,0,0,0,7,7,7,7
Monterey,39,2022-09-12,229,229,229,0,5128,5137,5136,1,22,1,1,1,769,769,768,768
Napa,39,2022-09-12,119,119,119,0,2249,2254,2253,1,10,0,0,1,159,159,159,159
Nevada,39,2022-09-12,61,61,61,0,1179,1180,1179,1,2,1,1,0,136,136,135,135
Orange,39,2022-09-12,2152,2156,2156,0,37295,37358,37355,3,159,28,28,22,7497,7497,7469,7469
Placer,39,2022-09-12,240,240,240,0,4091,4097,4096,1,38,0,0,5,658,658,658,658
Plumas,39,2022-09-12,22,22,22,0,194,195,194,1,1,0,0,0,13,13,13,13
Riverside,39,2022-09-12,2264,2267,2267,0,33154,33211,33207,4,124,5,5,12,6627,6627,6622,6622
Sacramento,39,2022-09-12,1301,1301,1301,0,23559,23599,23596,3,119,15,15,15,3320,3320,3305,3305
San Benito,39,2022-09-12,96,96,96,0,1508,1511,1510,1,1,0,0,1,100,100,100,100
San Bernardino,39,2022-09-12,1951,1954,1954,0,38930,38998,38995,3,92,13,13,26,8080,8080,8067,8067
San Diego,39,2022-09-12,3033,3038,3038,0,56054,56149,56147,2,194,7,7,24,5552,5552,5545,5545
San Francisco,39,2022-09-12,815,815,815,0,17436,17466,17462,4,58,8,8,15,1054,1054,1046,1046
San Joaquin,39,2022-09-12,644,644,644,0,14281,14304,14302,2,35,6,6,9,2330,2330,2324,2324
San Luis Obispo,39,2022-09-12,187,187,187,0,3219,3225,3224,1,10,0,0,1,524,524,524,524
San Mateo,39,2022-09-12,671,671,671,0,14329,14353,14352,1,20,1,1,2,738,738,737,737
Santa Barbara,39,2022-09-12,329,329,329,0,7232,7244,7243,1,27,1,1,2,727,727,726,726
Santa Clara,39,2022-09-12,1924,1926,1926,0,38434,38499,38497,2,144,8,8,28,2515,2515,2507,2507
Santa Cruz,39,2022-09-12,272,272,272,0,13349,13372,13371,1,15,0,0,0,273,273,273,273
Shasta,39,2022-09-12,182,182,182,0,2592,2597,2596,1,26,1,1,2,588,588,587,587
Siskiyou,39,2022-09-12,27,27,27,0,289,290,289,1,1,0,0,0,89,89,89,89
Solano,39,2022-09-12,415,415,415,0,6740,6753,6752,1,32,0,0,4,457,457,457,457
Sonoma,39,2022-09-12,398,398,398,0,7021,7034,7033,1,39,3,3,1,523,523,520,520
Stanislaus,39,2022-09-12,447,447,447,0,7742,7756,7755,1,73,1,1,4,1779,1779,1778,1778
Sutter,39,2022-09-12,119,119,119,0,1531,1533,1532,1,0,0,0,0,232,232,232,232
Tehama,39,2022-09-12,48,48,48,0,699,700,699,1,2,0,0,0,213,213,213,213
Trinity,39,2022-09-12,2,2,2,0,74,75,74,1,0,0,0,0,21,21,21,21
Tulare,39,2022-09-12,369,369,369,0,6888,6900,6899,1,39,4,4,0,1538,1538,1534,1534
Tuolumne,39,2022-09-12,61,61,61,0,810,811,810,1,2,0,0,1,199,199,199,199
Ventura,39,2022-09-12,842,842,842,0,14808,14833,14832,1,49,1,1,7,1587,1587,1586,1586
Yolo,39,2022-09-12,143,143,143,0,3457,3464,3463,1,1,2,2,3,394,394,392,392
Yuba,39,2022-09-12,93,93,93,0,1164,1165,1164,1,6,0,0,0,122,122,122,122
Alameda,40,2022-09-19,1236,1236,1236,0,29337,29389,29387,2,80,4,4,7,2048,2048,2044,2044
Amador,40,2022-09-19,33,33,33,0,760,761,760,1,1,3,3,1,93,93,90,90
Butte,40,2022-09-19,121,121,121,0,2122,2126,2125,1,18,0,0,1,462,462,462,462
Calaveras,40,2022-09-19,28,28,28,0,477,478,477,1,0,0,0,0,133,133,133,133
Colusa,40,2022-09-19,13,13,13,0,289,290,289,1,3,0,0,0,22,22,22,22
Contra Costa,40,2022-09-19,826,826,826,0,16785,16814,16812,2,52,8,8,8,1453,1453,1445,1445
Del Norte,40,2022-09-19,22,22,22,0,479,480,479,1,2,0,0,0,55,55,55,55
El Dorado,40,2022-09-19,79,79,79,0,1617,1620,1619,1,3,0,0,0,233,233,233,233
Fresno,40,2022-09-19,605,605,605,0,13291,13314,13313,1,110,7,7,14,2877,2877,2870,2870
Glenn,40,2022-09-19,14,14,14,0,201,202,201,1,2,0,0,0,53,53,53,53
Humboldt,40,2022-09-19,105,105,105,0,1458,1459,1458,1,8,0,0,3,159,159,159,159
Imperial,40,2022-09-19,150,150,150,0,2869,2875,2874,1,11,0,0,2,961,961,961,961
Inyo,40,2022-09-19,8,8,8,0,169,170,169,1,0,0,0,0,60,60,60,60
Kern,40,2022-09-19,445,445,445,0,11650,11671,11670,1,34,2,2,6,2423,2423,2421,2421
Kings,40,2022-09-19,137,137,137,0,2642,2648,2647,1,7,2,2,0,464,464,462,462
Lake,40,2022-09-19,37,37,37,0,903,904,903,1,0,0,0,0,148,148,148,148
Lassen,40,2022-09-19,7,7,7,0,704,705,704,1,0,0,0,0,63,63,63,63
Los Angeles,40,2022-09-19,8552,8567,8567,0,256798,257248,257241,7,564,66,66,69,33531,33531,33465,33465
Madera,40,2022-09-19,109,109,109,0,2692,2698,2697,1,9,1,1,2,374,374,373,373
Marin,40,2022-09-19,137,137,137,0,3702,3709,3708,1,6,0,0,0,315,315,315,315
Mariposa,40,2022-09-19,12,12,12,0,170,171,170,1,0,1,1,0,30,30,29,29
Mendocino,40,2022-09-19,43,43,43,0,928,929,928,1,0,0,0,1,136,136,136,136
Merced,40,2022-09-19,170,170,170,0,2914,2920,2919,1,8,3,3,1,866,866,863,863
Modoc,40,2022-09-19,2,2,2,0,17,18,17,1,0,0,0,0,9,9,9,9
Mono,40,2022-09-19,4,4,4,0,63,64,63,1,0,0,0,0,7,7,7,7
Monterey,40,2022-09-19,162,162,162,0,4272,4280,4279,1,14,1,1,2,770,770,769,769
Napa,40,2022-09-19,101,101,101,0,1772,1776,1775,1,4,0,0,0,159,159,159,159
Nevada,40,2022-09-19,66,66,66,0,1111,1113,1112,1,2,0,0,0,136,136,136,136
Orange,40,2022-09-19,1788,1792,1792,0,34570,34631,34629,2,129,16,16,19,7513,7513,7497,7497
Placer,40,2022-09-19,223,223,223,0,3845,3853,3852,1,51,1,1,4,659,659,658,658
Plumas,40,2022-09-19,22,22,22,0,183,184,183,1,1,0,0,0,13,13,13,13
Riverside,40,2022-09-19,1427,1427,1427,0,29209,29260,29258,2,68,4,4,19,6631,6631,6627,6627
Sacramento,40,2022-09-19,1040,1040,1040,0,21423,21460,21458,2,102,8,8,17,3328,3328,3320,3320
San Benito,40,2022-09-19,54,54,54,0,1231,1233,1232,1,0,0,0,0,100,100,100,100
San Bernardino,40,2022-09-19,1486,1487,1487,0,32836,32893,32891,2,83,7,7,19,8087,8087,8080,8080
San Diego,40,2022-09-19,2563,2568,2568,0,56220,56318,56316,2,175,9,9,19,5561,5561,5552,5552
San Francisco,40,2022-09-19,695,695,695,0,16845,16875,16872,3,43,9,9,11,1063,1063,1054,1054
San Joaquin,40,2022-09-19,459,459,459,0,12860,12881,12880,1,35,5,5,2,2335,2335,2330,2330
San Luis Obispo,40,2022-09-19,155,155,155,0,2766,2772,2771,1,8,0,0,0,524,524,524,524
San Mateo,40,2022-09-19,607,607,607,0,13735,13760,13759,1,20,0,0,2,738,738,738,738
Santa Barbara,40,2022-09-19,269,269,269,0,6792,6805,6804,1,34,2,2,0,729,729,727,727
Santa Clara,40,2022-09-19,1450,1450,1450,0,37367,37433,37432,1,137,7,7,21,2522,2522,2515,2515
Santa Cruz,40,2022-09-19,148,148,148,0,12323,12345,12344,1,5,0,0,1,273,273,273,273
Shasta,40,2022-09-19,101,101,101,0,2113,2118,2117,1,21,0,0,3,588,588,588,588
Siskiyou,40,2022-09-19,21,21,21,0,233,234,233,1,2,1,1,0,90,90,89,89
Solano,40,2022-09-19,274,274,274,0,6124,6135,6134,1,24,1,1,5,458,458,457,457
Sonoma,40,2022-09-19,318,318,318,0,6359,6371,6370,1,27,3,3,1,526,526,523,523
Stanislaus,40,2022-09-19,333,333,333,0,6290,6301,6300,1,57,4,4,4,1783,1783,1779,1779
Sutter,40,2022-09-19,75,75,75,0,1388,1390,1389,1,0,0,0,0,232,232,232,232
Tehama,40,2022-09-19,35,35,35,0,599,600,599,1,2,1,1,0,214,214,213,213
Trinity,40,2022-09-19,3,3,3,0,53,54,53,1,0,0,0,0,21,21,21,21
Tulare,40,2022-09-19,234,234,234,0,5725,5733,5732,1,32,1,1,0,1539,1539,1538,1538
Tuolumne,40,2022-09-19,59,59,59,0,717,718,717,1,0,0,0,0,199,199,199,199
Ventura,40,2022-09-19,616,616,616,0,13383,13406,13405,1,42,2,2,6,1589,1589,1587,1587
Yolo,40,2022-09-19,83,83,83,0,3743,3750,3749,1,2,3,3,2,397,397,394,394
Yuba,40,2022-09-19,60,60,60,0,1029,1030,1029,1,3,0,0,0,122,122,122,122
Alameda,41,2022-09-26,1151,1151,1151,0,27842,27892,27891,1,77,2,2,4,2050,2050,2048,2048
Amador,41,2022-09-26,27,27,27,0,721,722,721,1,1,0,0,1,93,93,93,93
Butte,41,2022-09-26,90,90,90,0,1798,1803,1802,1,23,0,0,1,462,462,462,462
Calaveras,41,2022-09-26,20,20,20,0,390,391,390,1,2,1,1,0,134,134,133,133
Colusa,41,2022-09-26,7,7,7,0,299,300,299,1,1,0,0,0,22,22,22,22
Contra Costa,41,2022-09-26,775,775,775,0,16348,16377,16376,1,48,5,5,7,1458,1458,1453,1453
Del Norte,41,2022-09-26,22,22,22,0,469,470,469,1,2,0,0,0,55,55,55,55
El Dorado,41,2022-09-26,86,86,86,0,1580,1584,1583,1,5,0,0,0,233,233,233,233
Fresno,41,2022-09-26,516,516,516,0,12130,12153,12152,1,84,3,3,13,2880,2880,2877,2877
Glenn,41,2022-09-26,7,7,7,0,176,177,176,1,2,0,0,0,53,53,53,53
Humboldt,41,2022-09-26,98,98,98,0,1312,1313,1312,1,10,2,2,0,161,161,159,159
Imperial,41,2022-09-26,115,115,115,0,2630,2636,2635,1,4,1,1,1,962,962,961,961
Inyo,41,2022-09-26,5,5,5,0,165,166,165,1,0,0,0,0,60,60,60,60
Kern,41,2022-09-26,357,357,357,0,10879,10897,10896,1,32,3,3,7,2426,2426,2423,2423
Kings,41,2022-09-26,107,107,107,0,2621,2627,2626,1,2,0,0,0,464,464,464,464
Lake,41,2022-09-26,26,26,26,0,815,816,815,1,0,0,0,0,148,148,148,148
Lassen,41,2022-09-26,13,13,13,0,533,534,533,1,0,0,0,0,63,63,63,63
Los Angeles,41,2022-09-26,7725,7738,7738,0,241343,241777,241772,5,443,62,62,53,33593,33593,33531,33531
Madera,41,2022-09-26,84,84,84,0,2231,2236,2235,1,8,0,0,2,374,374,374,374
Marin,41,2022-09-26,173,173,173,0,3659,3665,3664,1,10,0,0,0,315,315,315,315
Mariposa,41,2022-09-26,4,4,4,0,155,156,155,1,0,0,0,0,30,30,30,30
Mendocino,41,2022-09-26,41,41,41,0,852,853,852,1,1,0,0,0,136,136,136,136
Merced,41,2022-09-26,127,127,127,0,2855,2861,2860,1,10,1,1,0,867,867,866,866
Modoc,41,2022-09-26,0,0,0,0,13,14,13,1,0,0,0,0,9,9,9,9
Mono,41,2022-09-26,1,1,1,0,60,61,60,1,0,0,0,0,7,7,7,7
Monterey,41,2022-09-26,135,135,135,0,4055,4063,4062,1,14,0,0,2,770,770,770,770
Napa,41,2022-09-26,85,85,85,0,1956,1962,1961,1,5,0,0,1,159,159,159,159
Nevada,41,2022-09-26,49,49,49,0,1077,1079,1078,1,1,0,0,0,136,136,136,136
Orange,41,2022-09-26,1720,1723,1723,0,31542,31598,31596,2,117,19,19,23,7532,7532,7513,7513
Placer,41,2022-09-26,209,209,209,0,3611,3619,3618,1,42,1,1,4,660,660,659,659
Plumas,41,2022-09-26,21,21,21,0,151,152,151,1,1,0,0,0,13,13,13,13
Riverside,41,2022-09-26,1289,1289,1289,0,25891,25939,25937,2,55,8,8,15,6639,6639,6631,6631
Sacramento,41,2022-09-26,930,930,930,0,19275,19309,19308,1,106,11,11,20,3339,3339,3328,3328
San Benito,41,2022-09-26,50,50,50,0,1160,1162,1161,1,0,1,1,2,101,101,100,100
San Bernardino,41,2022-09-26,1239,1239,1239,0,28101,28151,28149,2,75,5,5,12,8092,8092,8087,8087
San Diego,41,2022-09-26,2483,2488,2488,0,51204,51296,51295,1,201,7,7,15,5568,5568,5561,5561
San Francisco,41,2022-09-26,678,678,678,0,16224,16254,16252,2,45,2,2,9,1065,1065,1063,1063
San Joaquin,41,2022-09-26,408,408,408,0,11083,11102,11101,1,35,1,1,3,2336,2336,2335,2335
San Luis Obispo,41,2022-09-26,131,131,131,0,2521,2527,2526,1,7,1,1,0,525,525,524,524
San Mateo,41,2022-09-26,617,617,617,0,13188,13213,13212,1,25,0,0,1,738,738,738,738
Santa Barbara,41,2022-09-26,259,259,259,0,6381,6393,6392,1,22,2,2,0,731,731,729,729
Santa Clara,41,2022-09-26,1401,1401,1401,0,36176,36242,36241,1,113,10,10,17,2532,2532,2522,2522
Santa Cruz,41,2022-09-26,225,225,225,0,12507,12530,12529,1,13,0,0,0,273,273,273,273
Shasta,41,2022-09-26,75,75,75,0,1740,1744,1743,1,14,0,0,3,588,588,588,588
Siskiyou,41,2022-09-26,18,18,18,0,183,184,183,1,1,2,2,0,92,92,90,90
Solano,41,2022-09-26,309,309,309,0,5725,5737,5736,1,23,1,1,2,459,459,458,458
Sonoma,41,2022-09-26,291,291,291,0,6334,6346,6345,1,31,1,1,2,527,527,526,526
Stanislaus,41,2022-09-26,261,261,261,0,5814,5824,5823,1,46,2,2,3,1785,1785,1783,1783
Sutter,41,2022-09-26,69,69,69,0,1147,1149,1148,1,0,0,0,0,232,232,232,232
Tehama,41,2022-09-26,36,36,36,0,550,551,550,1,1,2,2,0,216,216,214,214
Trinity,41,2022-09-26,3,3,3,0,44,45,44,1,0,0,0,0,21,21,21,21
Tulare,41,2022-09-26,168,168,168,0,5091,5099,5098,1,18,3,3,2,1542,1542,1539,1539
Tuolumne,41,2022-09-26,44,44,44,0,689,690,689,1,1,0,0,0,199,199,199,199
Ventura,41,2022-09-26,557,557,557,0,11597,11617,11616,1,33,4,4,1,1593,1593,1589,1589
Yolo,41,2022-09-26,130,130,130,0,3989,3997,3996,1,2,3,3,3,400,400,397,397
Yuba,41,2022-09-26,41,41,41,0,933,934,933,1,6,0,0,1,122,122,122,122
Alameda,42,2022-10-03,1145,1145,1145,0,26322,26371,26370,1,54,3,3,5,2053,2053,2050,2050
Amador,42,2022-10-03,14,14,14,0,691,692,691,1,0,0,0,1,93,93,93,93
Butte,42,2022-10-03,67,67,67,0,1754,1758,1757,1,11,2,2,2,464,464,462,462
Calaveras,42,2022-10-03,19,19,19,0,337,338,337,1,1,0,0,0,134,134,134,134
Colusa,42,2022-10-03,7,7,7,0,188,189,188,1,0,0,0,0,22,22,22,22
Contra Costa,42,2022-10-03,741,741,741,0,15784,15814,15813,1,34,3,3,6,1461,1461,1458,1458
Del Norte,42,2022-10-03,12,12,12,0,382,383,382,1,1,0,0,1,55,55,55,55
El Dorado,42,2022-10-03,80,80,80,0,1450,1453,1452,1,3,0,0,1,233,233,233,233
Fresno,42,2022-10-03,465,465,465,0,11226,11248,11247,1,77,2,2,11,2882,2882,2880,2880
Glenn,42,2022-10-03,7,7,7,0,155,156,155,1,0,0,0,0,53,53,53,53
Humboldt,42,2022-10-03,78,78,78,0,1159,1160,1159,1,6,0,0,1,161,161,161,161
Imperial,42,2022-10-03,140,140,140,0,2563,2569,2568,1,6,0,0,0,962,962,962,962
Inyo,42,2022-10-03,5,5,5,0,159,160,159,1,0,0,0,1,60,60,60,60
Kern,42,2022-10-03,295,295,295,0,10110,10130,10129,1,24,4,4,5,2430,2430,2426,2426
Kings,42,2022-10-03,87,87,87,0,2416,2422,2421,1,2,0,0,0,464,464,464,464
Lake,42,2022-10-03,35,35,35,0,759,760,759,1,3,1,1,0,149,149,148,148
Lassen,42,2022-10-03,7,7,7,0,530,531,530,1,2,0,0,0,63,63,63,63
Los Angeles,42,2022-10-03,7020,7032,7032,0,221723,222139,222135,4,439,50,50,69,33643,33643,33593,33593
Madera,42,2022-10-03,65,65,65,0,1565,1568,1567,1,6,0,0,2,374,374,374,374
Marin,42,2022-10-03,191,191,191,0,3475,3482,3481,1,6,0,0,2,315,315,315,315
Mariposa,42,2022-10-03,5,5,5,0,131,132,131,1,0,0,0,0,30,30,30,30
Mendocino,42,2022-10-03,50,50,50,0,778,779,778,1,4,0,0,0,136,136,136,136
Merced,42,2022-10-03,109,109,109,0,2610,2616,2615,1,5,3,3,1,870,870,867,867
Modoc,42,2022-10-03,2,2,2,0,14,15,14,1,0,0,0,0,9,9,9,9
Mono,42,2022-10-03,4,4,4,0,69,70,69,1,0,0,0,0,7,7,7,7
Monterey,42,2022-10-03,111,111,111,0,3790,3798,3797,1,11,1,1,1,771,771,770,770
Napa,42,2022-10-03,88,88,88,0,1699,1704,1703,1,4,0,0,2,159,159,159,159
Nevada,42,2022-10-03,51,51,51,0,954,955,954,1,1,0,0,4,136,136,136,136
Orange,42,2022-10-03,1575,1578,1578,0,28364,28417,28416,1,131,22,22,16,7554,7554,7532,7532
Placer,42,2022-10-03,208,208,208,0,3349,3357,3356,1,41,2,2,3,662,662,660,660
Plumas,42,2022-10-03,12,12,12,0,107,108,107,1,1,0,0,0,13,13,13,13
Riverside,42,2022-10-03,1147,1147,1147,0,22158,22200,22199,1,59,7,7,12,6646,6646,6639,6639
Sacramento,42,2022-10-03,921,921,921,0,18203,18238,18237,1,88,12,12,19,3351,3351,3339,3339
San Benito,42,2022-10-03,34,34,34,0,1105,1107,1106,1,0,0,0,0,101,101,101,101
San Bernardino,42,2022-10-03,1243,1243,1243,0,25069,25115,25114,1,77,4,4,7,8096,8096,8092,8092
San Diego,42,2022-10-03,2085,2089,2089,0,46921,47010,47009,1,162,9,9,18,5577,5577,5568,5568
San Francisco,42,2022-10-03,655,655,655,0,15383,15413,15411,2,44,3,3,9,1068,1068,1065,1065
San Joaquin,42,2022-10-03,342,342,342,0,9930,9947,9946,1,25,4,4,3,2340,2340,2336,2336
San Luis Obispo,42,2022-10-03,150,150,150,0,2383,2389,2388,1,2,1,1,1,526,526,525,525
San Mateo,42,2022-10-03,560,560,560,0,12420,12445,12444,1,22,0,0,2,738,738,738,738
Santa Barbara,42,2022-10-03,253,253,253,0,6289,6302,6301,1,15,0,0,2,731,731,731,731
Santa Clara,42,2022-10-03,1436,1436,1436,0,32448,32509,32508,1,109,6,6,20,2538,2538,2532,2532
Santa Cruz,42,2022-10-03,227,227,227,0,11231,11252,11251,1,10,0,0,1,273,273,273,273
Shasta,42,2022-10-03,56,56,56,0,1444,1447,1446,1,10,0,0,2,588,588,588,588
Siskiyou,42,2022-10-03,10,10,10,0,204,205,204,1,0,0,0,0,92,92,92,92
Solano,42,2022-10-03,251,251,251,0,5361,5371,5370,1,17,0,0,2,459,459,459,459
Sonoma,42,2022-10-03,323,323,323,0,5934,5947,5946,1,17,0,0,3,527,527,527,527
Stanislaus,42,2022-10-03,200,200,200,0,5355,5366,5365,1,49,1,1,6,1786,1786,1785,1785
Sutter,42,2022-10-03,57,57,57,0,1109,1111,1110,1,0,0,0,0,232,232,232,232
Tehama,42,2022-10-03,20,20,20,0,526,527,526,1,1,0,0,0,216,216,216,216
Trinity,42,2022-10-03,1,1,1,0,43,44,43,1,0,0,0,0,21,21,21,21
Tulare,42,2022-10-03,162,162,162,0,5048,5058,5057,1,19,4,4,1,1546,1546,1542,1542
Tuolumne,42,2022-10-03,26,26,26,0,622,623,622,1,0,1,1,0,200,200,199,199
Ventura,42,2022-10-03,479,479,479,0,10440,10459,10458,1,41,2,2,2,1595,1595,1593,1593
Yolo,42,2022-10-03,122,122,122,0,2987,2994,2993,1,3,2,2,2,402,402,400,400
Yuba,42,2022-10-03,35,35,35,0,802,803,802,1,4,0,0,1,122,122,122,122
Alameda,43,2022-10-10,1160,1160,1160,0,28030,28085,28084,1,45,2,2,7,2055,2055,2053,2053
Amador,43,2022-10-10,15,15,15,0,801,802,801,1,0,0,0,2,93,93,93,93
Butte,43,2022-10-10,65,65,65,0,1754,1758,1757,1,12,3,3,1,466,466,463,463
Calaveras,43,2022-10-10,15,15,15,0,374,375,374,1,0,1,1,0,135,135,134,134
Colusa,43,2022-10-10,1,1,1,0,120,121,120,1,1,0,0,0,22,22,22,22
Contra Costa,43,2022-10-10,774,774,774,0,16874,16908,16907,1,31,7,7,6,1466,1466,1459,1459
Del Norte,43,2022-10-10,10,10,10,0,492,493,492,1,1,0,0,1,55,55,55,55
El Dorado,43,2022-10-10,81,81,81,0,1751,1754,1753,1,7,0,0,4,233,233,233,233
Fresno,43,2022-10-10,483,483,483,0,12481,12507,12506,1,60,3,3,9,2885,2885,2882,2882
Glenn,43,2022-10-10,10,10,10,0,226,227,226,1,1,0,0,0,53,53,53,53
Humboldt,43,2022-10-10,98,98,98,0,1420,1422,1421,1,7,1,1,0,162,162,161,161
Imperial,43,2022-10-10,203,203,203,0,2960,2967,2966,1,7,0,0,0,962,962,962,962
Inyo,43,2022-10-10,4,4,4,0,124,125,124,1,0,0,0,0,60,60,60,60
Kern,43,2022-10-10,338,338,338,0,11848,11871,11870,1,24,2,2,2,2432,2432,2430,2430
Kings,43,2022-10-10,102,102,102,0,2751,2758,2757,1,1,1,1,0,465,465,464,464
Lake,43,2022-10-10,33,33,33,0,920,921,920,1,1,0,0,0,149,149,149,149
Lassen,43,2022-10-10,3,3,3,0,573,574,573,1,0,0,0,0,63,63,63,63
Los Angeles,43,2022-10-10,6753,6767,6767,0,228391,228845,228842,3,436,70,70,51,33705,33705,33635,33635
Madera,43,2022-10-10,68,68,68,0,1718,1721,1720,1,7,1,1,2,375,375,374,374
Marin,43,2022-10-10,207,207,207,0,3779,3787,3786,1,9,0,0,0,315,315,315,315
Mariposa,43,2022-10-10,8,8,8,0,128,129,128,1,0,0,0,0,30,30,30,30
Mendocino,43,2022-10-10,32,32,32,0,975,976,975,1,1,0,0,2,136,136,136,136
Merced,43,2022-10-10,111,111,111,0,2789,2796,2795,1,8,1,1,3,871,871,870,870
Modoc,43,2022-10-10,5,5,5,0,12,13,12,1,0,0,0,0,9,9,9,9
Mono,43,2022-10-10,1,1,1,0,55,56,55,1,0,0,0,0,7,7,7,7
Monterey,43,2022-10-10,108,108,108,0,4375,4384,4383,1,9,0,0,1,771,771,771,771
Napa,43,2022-10-10,78,78,78,0,1766,1772,1771,1,3,0,0,2,159,159,159,159
Nevada,43,2022-10-10,42,42,42,0,981,982,981,1,1,0,0,1,136,136,136,136
Orange,43,2022-10-10,1525,1525,1525,0,30118,30178,30177,1,129,14,14,19,7566,7566,7552,7552
Placer,43,2022-10-10,186,186,186,0,3823,3831,3830,1,24,0,0,7,662,662,662,662
Plumas,43,2022-10-10,20,20,20,0,106,107,106,1,0,0,0,0,13,13,13,13
Riverside,43,2022-10-10,1195,1195,1195,0,24021,24069,24068,1,56,5,5,4,6651,6651,6646,6646
Sacramento,43,2022-10-10,957,957,957,0,20475,20516,20515,1,81,4,4,16,3355,3355,3351,3351
San Benito,43,2022-10-10,35,35,35,0,1268,1272,1271,1,3,0,0,0,101,101,101,101
San Bernardino,43,2022-10-10,1112,1112,1112,0,27423,27478,27477,1,66,0,0,13,8096,8096,8096,8096
San Diego,43,2022-10-10,1991,1995,1995,0,51613,51717,51716,1,130,7,7,21,5582,5582,5575,5575
San Francisco,43,2022-10-10,691,691,691,0,16134,16166,16165,1,37,2,2,9,1070,1070,1068,1068
San Joaquin,43,2022-10-10,431,431,431,0,11585,11609,11608,1,17,2,2,8,2342,2342,2340,2340
San Luis Obispo,43,2022-10-10,88,88,88,0,2568,2575,2574,1,2,2,2,0,528,528,526,526
San Mateo,43,2022-10-10,668,668,668,0,13746,13774,13773,1,19,0,0,0,738,738,738,738
Santa Barbara,43,2022-10-10,242,242,242,0,7844,7860,7859,1,20,1,1,1,732,732,731,731
Santa Clara,43,2022-10-10,1457,1457,1457,0,34357,34427,34426,1,107,4,4,18,2542,2542,2538,2538
Santa Cruz,43,2022-10-10,338,338,338,0,12283,12309,12308,1,9,0,0,1,273,273,273,273
Shasta,43,2022-10-10,99,99,99,0,1294,1295,1294,1,13,3,3,1,591,591,588,588
Siskiyou,43,2022-10-10,9,9,9,0,244,245,244,1,0,1,1,0,93,93,92,92
Solano,43,2022-10-10,333,333,333,0,6279,6293,6292,1,23,0,0,4,459,459,459,459
Sonoma,43,2022-10-10,286,286,286,0,6772,6787,6786,1,15,1,1,3,528,528,527,527
Stanislaus,43,2022-10-10,208,208,208,0,5928,5940,5939,1,51,7,7,7,1791,1791,1784,1784
Sutter,43,2022-10-10,58,58,58,0,1127,1128,1127,1,0,0,0,0,232,232,232,232
Tehama,43,2022-10-10,21,21,21,0,567,568,567,1,1,0,0,0,216,216,216,216
Trinity,43,2022-10-10,1,1,1,0,53,54,53,1,0,0,0,0,21,21,21,21
Tulare,43,2022-10-10,168,168,168,0,4979,4990,4989,1,16,1,1,1,1547,1547,1546,1546
Tuolumne,43,2022-10-10,36,36,36,0,660,661,660,1,1,1,1,0,201,201,200,200
Ventura,43,2022-10-10,438,438,438,0,10998,11020,11019,1,41,4,4,1,1598,1598,1594,1594
Yolo,43,2022-10-10,126,126,126,0,3099,3106,3105,1,4,2,2,0,404,404,402,402
Yuba,43,2022-10-10,23,23,23,0,924,925,924,1,0,0,0,0,122,122,122,122
Alameda,44,2022-10-17,942,942,942,0,24696,24747,24746,1,60,5,5,8,2060,2060,2055,2055
Amador,44,2022-10-17,15,15,15,0,592,593,592,1,1,0,0,0,93,93,93,93
Butte,44,2022-10-17,76,76,76,0,1426,1429,1428,1,13,0,0,0,466,466,466,466
Calaveras,44,2022-10-17,19,19,19,0,306,307,306,1,0,0,0,0,135,135,135,135
Colusa,44,2022-10-17,4,4,4,0,80,81,80,1,0,0,0,0,22,22,22,22
Contra Costa,44,2022-10-17,672,672,672,0,14549,14579,14578,1,30,4,4,6,1470,1470,1466,1466
Del Norte,44,2022-10-17,11,11,11,0,381,382,381,1,1,0,0,0,55,55,55,55
El Dorado,44,2022-10-17,89,89,89,0,1381,1385,1384,1,2,0,0,1,233,233,233,233
Fresno,44,2022-10-17,350,350,350,0,10209,10230,10229,1,62,2,2,11,2887,2887,2885,2885
Glenn,44,2022-10-17,6,6,6,0,141,142,141,1,1,0,0,0,53,53,53,53
Humboldt,44,2022-10-17,70,70,70,0,1147,1150,1149,1,1,0,0,0,162,162,162,162
Imperial,44,2022-10-17,117,117,117,0,2319,2325,2324,1,5,0,0,0,962,962,962,962
Inyo,44,2022-10-17,6,6,6,0,123,124,123,1,1,0,0,0,60,60,60,60
Kern,44,2022-10-17,238,238,238,0,9714,9734,9733,1,32,0,0,1,2432,2432,2432,2432
Kings,44,2022-10-17,70,70,70,0,2320,2326,2325,1,2,1,1,0,466,466,465,465
Lake,44,2022-10-17,25,25,25,0,774,775,774,1,1,0,0,0,149,149,149,149
Lassen,44,2022-10-17,7,7,7,0,513,514,513,1,1,0,0,0,63,63,63,63
Los Angeles,44,2022-10-17,5090,5102,5102,0,189693,190088,190086,2,350,42,42,53,33747,33747,33705,33705
Madera,44,2022-10-17,59,59,59,0,1467,1470,1469,1,3,0,0,2,375,375,375,375
Marin,44,2022-10-17,132,132,132,0,3095,3103,3102,1,8,0,0,1,315,315,315,315
Mariposa,44,2022-10-17,6,6,6,0,119,120,119,1,0,0,0,0,30,30,30,30
Mendocino,44,2022-10-17,48,48,48,0,743,744,743,1,2,0,0,0,136,136,136,136
Merced,44,2022-10-17,129,129,129,0,2344,2350,2349,1,15,0,0,2,871,871,871,871
Modoc,44,2022-10-17,1,1,1,0,7,8,7,1,0,0,0,0,9,9,9,9
Mono,44,2022-10-17,6,6,6,0,42,43,42,1,1,0,0,0,7,7,7,7
Monterey,44,2022-10-17,125,125,125,0,3552,3560,3559,1,12,1,1,1,772,772,771,771
Napa,44,2022-10-17,60,60,60,0,1416,1420,1419,1,2,0,0,1,159,159,159,159
Nevada,44,2022-10-17,49,49,49,0,780,781,780,1,0,0,0,5,136,136,136,136
Orange,44,2022-10-17,1137,1137,1137,0,25138,25190,25189,1,91,21,21,18,7587,7587,7566,7566
Placer,44,2022-10-17,149,149,149,0,2932,2939,2938,1,32,0,0,3,662,662,662,662
Plumas,44,2022-10-17,11,11,11,0,98,99,98,1,0,0,0,0,13,13,13,13
Riverside,44,2022-10-17,897,897,897,0,20799,20842,20841,1,66,2,2,2,6653,6653,6651,6651
Sacramento,44,2022-10-17,871,871,871,0,16203,16237,16236,1,84,11,11,14,3366,3366,3355,3355
San Benito,44,2022-10-17,28,28,28,0,881,883,882,1,0,1,1,0,102,102,101,101
San Bernardino,44,2022-10-17,835,835,835,0,23470,23518,23517,1,63,1,1,9,8097,8097,8096,8096
San Diego,44,2022-10-17,1648,1652,1652,0,43705,43796,43795,1,117,8,8,24,5590,5590,5582,5582
San Francisco,44,2022-10-17,568,568,568,0,14501,14532,14531,1,34,3,3,13,1073,1073,1070,1070
San Joaquin,44,2022-10-17,353,353,353,0,9076,9097,9096,1,8,2,2,8,2344,2344,2342,2342
San Luis Obispo,44,2022-10-17,109,109,109,0,2131,2137,2136,1,4,1,1,0,529,529,528,528
San Mateo,44,2022-10-17,552,552,552,0,11331,11355,11354,1,21,0,0,1,738,738,738,738
Santa Barbara,44,2022-10-17,182,182,182,0,5626,5639,5638,1,18,0,0,2,732,732,732,732
Santa Clara,44,2022-10-17,1170,1170,1170,0,28716,28778,28777,1,93,5,5,16,2547,2547,2542,2542
Santa Cruz,44,2022-10-17,284,284,284,0,10290,10311,10310,1,7,1,1,0,274,274,273,273
Shasta,44,2022-10-17,82,82,82,0,1105,1106,1105,1,12,0,0,2,591,591,591,591
Siskiyou,44,2022-10-17,12,12,12,0,181,182,181,1,2,1,1,0,94,94,93,93
Solano,44,2022-10-17,266,266,266,0,4852,4863,4862,1,25,1,1,3,460,460,459,459
Sonoma,44,2022-10-17,244,244,244,0,5370,5383,5382,1,20,1,1,1,529,529,528,528
Stanislaus,44,2022-10-17,222,222,222,0,5295,5308,5307,1,45,1,1,5,1792,1792,1791,1791
Sutter,44,2022-10-17,40,40,40,0,910,911,910,1,0,0,0,0,232,232,232,232
Tehama,44,2022-10-17,21,21,21,0,397,398,397,1,0,0,0,0,216,216,216,216
Trinity,44,2022-10-17,0,0,0,0,34,35,34,1,0,0,0,0,21,21,21,21
Tulare,44,2022-10-17,136,136,136,0,4270,4279,4278,1,11,1,1,1,1548,1548,1547,1547
Tuolumne,44,2022-10-17,35,35,35,0,620,621,620,1,2,0,0,0,201,201,201,201
Ventura,44,2022-10-17,376,376,376,0,9350,9370,9369,1,32,3,3,1,1601,1601,1598,1598
Yolo,44,2022-10-17,103,103,103,0,2212,2218,2217,1,3,2,2,3,406,406,404,404
Yuba,44,2022-10-17,44,44,44,0,767,768,767,1,1,0,0,0,122,122,122,122
Alameda,45,2022-10-24,952,952,952,0,23421,23472,23471,1,46,8,8,10,2068,2068,2060,2060
Amador,45,2022-10-24,18,18,18,0,635,636,635,1,2,0,0,0,93,93,93,93
Butte,45,2022-10-24,68,68,68,0,1405,1408,1407,1,10,1,1,1,467,467,466,466
Calaveras,45,2022-10-24,20,20,20,0,322,323,322,1,0,0,0,0,135,135,135,135
Colusa,45,2022-10-24,3,3,3,0,95,96,95,1,0,0,0,0,22,22,22,22
Contra Costa,45,2022-10-24,627,627,627,0,13919,13949,13948,1,37,5,5,5,1475,1475,1470,1470
Del Norte,45,2022-10-24,6,6,6,0,361,362,361,1,0,0,0,1,55,55,55,55
El Dorado,45,2022-10-24,91,91,91,0,1520,1525,1524,1,1,0,0,0,233,233,233,233
Fresno,45,2022-10-24,379,379,379,0,9763,9786,9785,1,63,0,0,6,2887,2887,2887,2887
Glenn,45,2022-10-24,9,9,9,0,148,149,148,1,0,0,0,0,53,53,53,53
Humboldt,45,2022-10-24,69,69,69,0,1150,1152,1151,1,7,0,0,2,162,162,162,162
Imperial,45,2022-10-24,96,96,96,0,2344,2350,2349,1,8,1,1,0,963,963,962,962
Inyo,45,2022-10-24,8,8,8,0,273,274,273,1,0,0,0,0,60,60,60,60
Kern,45,2022-10-24,279,279,279,0,9716,9737,9736,1,24,2,2,2,2434,2434,2432,2432
Kings,45,2022-10-24,88,88,88,0,2341,2347,2346,1,8,0,0,0,466,466,466,466
Lake,45,2022-10-24,22,22,22,0,643,644,643,1,1,1,1,1,150,150,149,149
Lassen,45,2022-10-24,16,16,16,0,484,485,484,1,1,0,0,0,63,63,63,63
Los Angeles,45,2022-10-24,5338,5350,5350,0,187323,187730,187728,2,332,54,54,43,33801,33801,33747,33747
Madera,45,2022-10-24,61,61,61,0,1388,1391,1390,1,4,0,0,2,375,375,375,375
Marin,45,2022-10-24,138,138,138,0,3081,3088,3087,1,12,1,1,2,316,316,315,315
Mariposa,45,2022-10-24,12,12,12,0,120,121,120,1,0,0,0,0,30,30,30,30
Mendocino,45,2022-10-24,42,42,42,0,771,772,771,1,2,0,0,0,136,136,136,136
Merced,45,2022-10-24,88,88,88,0,2410,2416,2415,1,7,3,3,3,874,874,871,871
Modoc,45,2022-10-24,1,1,1,0,13,14,13,1,0,0,0,0,9,9,9,9
Mono,45,2022-10-24,3,3,3,0,64,65,64,1,0,1,1,0,8,8,7,7
Monterey,45,2022-10-24,131,131,131,0,3719,3729,3728,1,18,0,0,0,772,772,772,772
Napa,45,2022-10-24,51,51,51,0,1467,1471,1470,1,3,0,0,0,159,159,159,159
Nevada,45,2022-10-24,38,38,38,0,784,786,785,1,6,0,0,0,136,136,136,136
Orange,45,2022-10-24,1162,1163,1163,0,26001,26057,26056,1,84,12,12,14,7599,7599,7587,7587
Placer,45,2022-10-24,192,192,192,0,3034,3042,3041,1,39,0,0,6,662,662,662,662
Plumas,45,2022-10-24,12,12,12,0,91,92,91,1,0,0,0,0,13,13,13,13
Riverside,45,2022-10-24,933,933,933,0,20176,20220,20219,1,53,0,0,6,6653,6653,6653,6653
Sacramento,45,2022-10-24,815,815,815,0,15314,15347,15346,1,84,5,5,19,3371,3371,3366,3366
San Benito,45,2022-10-24,41,41,41,0,845,846,845,1,0,0,0,1,102,102,102,102
San Bernardino,45,2022-10-24,806,806,806,0,21612,21659,21658,1,39,3,3,10,8100,8100,8097,8097
San Diego,45,2022-10-24,1684,1688,1688,0,42118,42210,42209,1,83,5,5,18,5595,5595,5590,5590
San Francisco,45,2022-10-24,511,511,511,0,13946,13976,13975,1,35,1,1,5,1074,1074,1073,1073
San Joaquin,45,2022-10-24,271,271,271,0,8498,8518,8517,1,13,2,2,3,2346,2346,2344,2344
San Luis Obispo,45,2022-10-24,89,89,89,0,2055,2061,2060,1,2,0,0,0,529,529,529,529
San Mateo,45,2022-10-24,474,474,474,0,11148,11174,11173,1,19,0,0,2,738,738,738,738
Santa Barbara,45,2022-10-24,164,164,164,0,5730,5744,5743,1,19,2,2,4,734,734,732,732
Santa Clara,45,2022-10-24,1211,1212,1212,0,29387,29451,29450,1,92,3,3,9,2550,2550,2547,2547
Santa Cruz,45,2022-10-24,240,240,240,0,10203,10225,10224,1,14,1,1,0,275,275,274,274
Shasta,45,2022-10-24,74,74,74,0,984,986,985,1,5,0,0,2,591,591,591,591
Siskiyou,45,2022-10-24,12,12,12,0,171,172,171,1,0,0,0,0,94,94,94,94
Solano,45,2022-10-24,239,239,239,0,5028,5041,5040,1,20,0,0,1,460,460,460,460
Sonoma,45,2022-10-24,246,246,246,0,5438,5452,5451,1,23,0,0,1,529,529,529,529
Stanislaus,45,2022-10-24,199,199,199,0,4851,4863,4862,1,40,3,3,3,1795,1795,1792,1792
Sutter,45,2022-10-24,28,28,28,0,881,882,881,1,0,0,0,0,232,232,232,232
Tehama,45,2022-10-24,36,36,36,0,406,407,406,1,1,0,0,0,216,216,216,216
Trinity,45,2022-10-24,1,1,1,0,35,36,35,1,0,0,0,0,21,21,21,21
Tulare,45,2022-10-24,110,110,110,0,4343,4353,4352,1,16,1,1,1,1549,1549,1548,1548
Tuolumne,45,2022-10-24,33,33,33,0,625,626,625,1,1,1,1,0,202,202,201,201
Ventura,45,2022-10-24,294,294,294,0,9024,9045,9044,1,40,3,3,6,1604,1604,1601,1601
Yolo,45,2022-10-24,91,91,91,0,2049,2054,2053,1,5,1,1,0,407,407,406,406
Yuba,45,2022-10-24,51,51,51,0,799,800,799,1,5,0,0,1,122,122,122,122
Alameda,46,2022-10-31,1054,1055,1055,0,23016,23069,23068,1,57,5,5,4,2073,2073,2068,2068
Amador,46,2022-10-31,18,18,18,0,578,579,578,1,2,1,1,0,94,94,93,93
Butte,46,2022-10-31,82,82,82,0,1458,1463,1462,1,11,0,0,3,467,467,467,467
Calaveras,46,2022-10-31,13,13,13,0,257,258,257,1,0,0,0,0,135,135,135,135
Colusa,46,2022-10-31,11,11,11,0,95,96,95,1,0,0,0,0,22,22,22,22
Contra Costa,46,2022-10-31,748,748,748,0,13901,13932,13931,1,37,6,6,7,1481,1481,1475,1475
Del Norte,46,2022-10-31,16,16,16,0,357,358,357,1,1,0,0,0,55,55,55,55
El Dorado,46,2022-10-31,100,100,100,0,1406,1410,1409,1,2,0,0,0,233,233,233,233
Fresno,46,2022-10-31,427,427,427,0,10499,10525,10524,1,57,4,4,8,2891,2891,2887,2887
Glenn,46,2022-10-31,16,16,16,0,156,157,156,1,1,0,0,0,53,53,53,53
Humboldt,46,2022-10-31,44,44,44,0,1021,1022,1021,1,6,0,0,2,162,162,162,162
Imperial,46,2022-10-31,126,126,126,0,2785,2791,2790,1,7,0,0,0,963,963,963,963
Inyo,46,2022-10-31,7,7,7,0,242,243,242,1,0,0,0,0,60,60,60,60
Kern,46,2022-10-31,341,341,341,0,9872,9896,9895,1,20,2,2,2,2436,2436,2434,2434
Kings,46,2022-10-31,118,118,118,0,2461,2467,2466,1,3,0,0,1,466,466,466,466
Lake,46,2022-10-31,30,30,30,0,752,753,752,1,1,0,0,1,150,150,150,150
Lassen,46,2022-10-31,19,19,19,0,522,523,522,1,1,0,0,0,63,63,63,63
Los Angeles,46,2022-10-31,6228,6241,6241,0,192565,193006,193004,2,344,37,37,44,33838,33838,33801,33801
Madera,46,2022-10-31,54,54,54,0,1433,1436,1435,1,3,0,0,2,375,375,375,375
Marin,46,2022-10-31,137,137,137,0,3508,3518,3517,1,10,1,1,1,317,317,316,316
Mariposa,46,2022-10-31,8,8,8,0,126,127,126,1,0,0,0,0,30,30,30,30
Mendocino,46,2022-10-31,23,23,23,0,709,710,709,1,1,0,0,2,136,136,136,136
Merced,46,2022-10-31,114,114,114,0,2139,2145,2144,1,5,1,1,0,875,875,874,874
Modoc,46,2022-10-31,1,1,1,0,13,14,13,1,0,0,0,0,9,9,9,9
Mono,46,2022-10-31,1,1,1,0,85,86,85,1,1,0,0,0,8,8,8,8
Monterey,46,2022-10-31,150,150,150,0,3693,3703,3702,1,18,2,2,0,774,774,772,772
Napa,46,2022-10-31,54,54,54,0,1505,1511,1510,1,2,0,0,0,159,159,159,159
Nevada,46,2022-10-31,37,37,37,0,775,776,775,1,6,0,0,0,136,136,136,136
Orange,46,2022-10-31,1189,1190,1190,0,27139,27201,27200,1,91,14,14,14,7613,7613,7599,7599
Placer,46,2022-10-31,151,151,151,0,2755,2762,2761,1,40,0,0,5,662,662,662,662
Plumas,46,2022-10-31,5,5,5,0,87,88,87,1,0,0,0,0,13,13,13,13
Riverside,46,2022-10-31,1050,1051,1051,0,19558,19603,19602,1,64,5,5,5,6658,6658,6653,6653
Sacramento,46,2022-10-31,754,754,754,0,14139,14171,14170,1,80,8,8,16,3379,3379,3371,3371
San Benito,46,2022-10-31,33,33,33,0,745,746,745,1,1,0,0,1,102,102,102,102
San Bernardino,46,2022-10-31,1048,1048,1048,0,22481,22533,22532,1,64,2,2,11,8102,8102,8100,8100
San Diego,46,2022-10-31,1772,1777,1777,0,42849,42946,42945,1,109,5,5,13,5600,5600,5595,5595
San Francisco,46,2022-10-31,620,620,620,0,14642,14674,14673,1,45,3,3,3,1077,1077,1074,1074
San Joaquin,46,2022-10-31,330,330,330,0,8598,8619,8618,1,21,6,6,3,2352,2352,2346,2346
San Luis Obispo,46,2022-10-31,81,81,81,0,2013,2019,2018,1,1,1,1,0,530,530,529,529
San Mateo,46,2022-10-31,521,521,521,0,11581,11609,11608,1,30,0,0,2,738,738,738,738
Santa Barbara,46,2022-10-31,181,181,181,0,6036,6052,6051,1,20,1,1,6,735,735,734,734
Santa Clara,46,2022-10-31,1288,1289,1289,0,30978,31049,31048,1,85,3,3,16,2553,2553,2550,2550
Santa Cruz,46,2022-10-31,188,188,188,0,9957,9982,9981,1,7,0,0,0,275,275,275,275
Shasta,46,2022-10-31,64,64,64,0,830,831,830,1,6,2,2,1,593,593,591,591
Siskiyou,46,2022-10-31,17,17,17,0,216,217,216,1,1,1,1,0,95,95,94,94
Solano,46,2022-10-31,312,312,312,0,5255,5269,5268,1,16,0,0,4,460,460,460,460
Sonoma,46,2022-10-31,205,205,205,0,5598,5611,5610,1,24,0,0,3,529,529,529,529
Stanislaus,46,2022-10-31,235,235,235,0,4830,4843,4842,1,49,1,1,8,1796,1796,1795,1795
Sutter,46,2022-10-31,55,55,55,0,902,903,902,1,0,0,0,0,232,232,232,232
Tehama,46,2022-10-31,26,26,26,0,395,396,395,1,1,0,0,0,216,216,216,216
Trinity,46,2022-10-31,18,18,18,0,73,74,73,1,5,0,0,0,21,21,21,21
Tulare,46,2022-10-31,153,153,153,0,3677,3685,3684,1,12,0,0,0,1549,1549,1549,1549
Tuolumne,46,2022-10-31,27,27,27,0,518,519,518,1,3,0,0,0,202,202,202,202
Ventura,46,2022-10-31,378,378,378,0,9550,9574,9573,1,24,2,2,2,1606,1606,1604,1604
Yolo,46,2022-10-31,82,82,82,0,1832,1837,1836,1,3,0,0,1,407,407,407,407
Yuba,46,2022-10-31,46,46,46,0,776,777,776,1,3,0,0,0,122,122,122,122
Alameda,47,2022-11-07,1333,1335,1335,0,24521,24579,24578,1,58,8,8,11,2081,2081,2073,2073
Amador,47,2022-11-07,32,32,32,0,685,687,686,1,3,0,0,0,94,94,94,94
Butte,47,2022-11-07,118,118,118,0,1370,1376,1375,1,11,0,0,2,467,467,467,467
Calaveras,47,2022-11-07,16,16,16,0,334,335,334,1,0,0,0,0,135,135,135,135
Colusa,47,2022-11-07,2,2,2,0,102,103,102,1,0,0,0,0,22,22,22,22
Contra Costa,47,2022-11-07,880,880,880,0,15675,15712,15711,1,43,3,3,4,1484,1484,1481,1481
Del Norte,47,2022-11-07,10,10,10,0,400,401,400,1,0,0,0,0,55,55,55,55
El Dorado,47,2022-11-07,108,108,108,0,1598,1604,1603,1,7,2,2,0,235,235,233,233
Fresno,47,2022-11-07,598,598,598,0,10694,10721,10720,1,61,3,3,9,2894,2894,2891,2891
Glenn,47,2022-11-07,29,29,29,0,131,132,131,1,0,0,0,0,53,53,53,53
Humboldt,47,2022-11-07,85,85,85,0,1025,1026,1025,1,9,0,0,2,162,162,162,162
Imperial,47,2022-11-07,209,209,209,0,3708,3719,3718,1,7,0,0,0,963,963,963,963
Inyo,47,2022-11-07,19,19,19,0,267,268,267,1,0,0,0,0,60,60,60,60
Kern,47,2022-11-07,478,478,478,0,10745,10771,10770,1,29,1,1,5,2437,2437,2436,2436
Kings,47,2022-11-07,148,148,148,0,2457,2463,2462,1,7,1,1,0,467,467,466,466
Lake,47,2022-11-07,51,51,51,0,795,796,795,1,3,0,0,1,150,150,150,150
Lassen,47,2022-11-07,10,10,10,0,451,452,451,1,0,0,0,0,63,63,63,63
Los Angeles,47,2022-11-07,8104,8124,8124,0,192278,192741,192739,2,387,55,55,53,33893,33893,33838,33838
Madera,47,2022-11-07,78,78,78,0,1612,1618,1617,1,3,0,0,4,375,375,375,375
Marin,47,2022-11-07,152,152,152,0,3368,3377,3376,1,9,0,0,0,317,317,317,317
Mariposa,47,2022-11-07,14,14,14,0,121,122,121,1,0,0,0,0,30,30,30,30
Mendocino,47,2022-11-07,37,37,37,0,819,820,819,1,4,1,1,0,137,137,136,136
Merced,47,2022-11-07,142,142,142,0,2592,2598,2597,1,9,4,4,0,879,879,875,875
Modoc,47,2022-11-07,2,2,2,0,6,7,6,1,0,0,0,0,9,9,9,9
Mono,47,2022-11-07,3,3,3,0,96,97,96,1,0,0,0,0,8,8,8,8
Monterey,47,2022-11-07,219,219,219,0,3932,3943,3942,1,18,1,1,0,775,775,774,774
Napa,47,2022-11-07,77,77,77,0,1757,1763,1762,1,6,0,0,0,159,159,159,159
Nevada,47,2022-11-07,60,60,60,0,744,746,745,1,3,0,0,1,136,136,136,136
Orange,47,2022-11-07,1286,1287,1287,0,28967,29037,29036,1,94,11,11,20,7624,7624,7613,7613
Placer,47,2022-11-07,231,231,231,0,3353,3362,3361,1,53,2,2,7,664,664,662,662
Plumas,47,2022-11-07,5,5,5,0,69,70,69,1,0,0,0,0,13,13,13,13
Riverside,47,2022-11-07,1508,1512,1512,0,21686,21737,21736,1,71,2,2,5,6660,6660,6658,6658
Sacramento,47,2022-11-07,1121,1122,1122,0,16054,16092,16091,1,90,7,7,9,3386,3386,3379,3379
San Benito,47,2022-11-07,43,43,43,0,924,925,924,1,1,0,0,0,102,102,102,102
San Bernardino,47,2022-11-07,1463,1465,1465,0,24051,24108,24107,1,76,2,2,17,8104,8104,8102,8102
San Diego,47,2022-11-07,2156,2162,2162,0,45659,45769,45768,1,117,8,8,24,5608,5608,5600,5600
San Francisco,47,2022-11-07,716,716,716,0,14906,14942,14941,1,42,2,2,8,1079,1079,1077,1077
San Joaquin,47,2022-11-07,482,482,482,0,8813,8836,8835,1,24,2,2,3,2354,2354,2352,2352
San Luis Obispo,47,2022-11-07,131,131,131,0,2272,2278,2277,1,4,0,0,2,530,530,530,530
San Mateo,47,2022-11-07,582,582,582,0,12353,12383,12382,1,27,0,0,3,738,738,738,738
Santa Barbara,47,2022-11-07,225,225,225,0,6672,6689,6688,1,18,1,1,2,736,736,735,735
Santa Clara,47,2022-11-07,1675,1680,1680,0,31524,31600,31599,1,76,7,7,19,2560,2560,2553,2553
Santa Cruz,47,2022-11-07,282,282,282,0,11333,11362,11361,1,8,0,0,0,275,275,275,275
Shasta,47,2022-11-07,96,96,96,0,1058,1060,1059,1,11,1,1,3,594,594,593,593
Siskiyou,47,2022-11-07,15,15,15,0,295,296,295,1,1,0,0,0,95,95,95,95
Solano,47,2022-11-07,384,384,384,0,5513,5527,5526,1,22,2,2,3,462,462,460,460
Sonoma,47,2022-11-07,250,250,250,0,5933,5947,5946,1,11,2,2,2,531,531,529,529
Stanislaus,47,2022-11-07,300,300,300,0,4931,4944,4943,1,42,2,2,9,1798,1798,1796,1796
Sutter,47,2022-11-07,86,86,86,0,958,960,959,1,0,0,0,0,232,232,232,232
Tehama,47,2022-11-07,47,47,47,0,472,473,472,1,2,0,0,0,216,216,216,216
Trinity,47,2022-11-07,2,2,2,0,34,35,34,1,0,0,0,0,21,21,21,21
Tulare,47,2022-11-07,160,160,160,0,4365,4375,4374,1,14,0,0,0,1549,1549,1549,1549
Tuolumne,47,2022-11-07,83,83,83,0,682,683,682,1,2,0,0,0,202,202,202,202
Ventura,47,2022-11-07,448,448,448,0,10372,10398,10397,1,36,2,2,1,1608,1608,1606,1606
Yolo,47,2022-11-07,173,173,173,0,2238,2245,2244,1,3,2,2,0,409,409,407,407
Yuba,47,2022-11-07,47,47,47,0,902,903,902,1,3,0,0,2,122,122,122,122
Alameda,48,2022-11-14,1506,1510,1510,0,24310,24372,24371,1,77,3,3,9,2084,2084,2081,2081
Amador,48,2022-11-14,20,20,20,0,656,657,656,1,2,0,0,0,94,94,94,94
Butte,48,2022-11-14,119,119,119,0,1380,1384,1383,1,20,0,0,1,467,467,467,467
Calaveras,48,2022-11-14,30,30,30,0,341,342,341,1,0,0,0,0,135,135,135,135
Colusa,48,2022-11-14,11,11,11,0,100,101,100,1,1,0,0,0,22,22,22,22
Contra Costa,48,2022-11-14,967,968,968,0,15961,16001,16000,1,56,1,1,5,1485,1485,1484,1484
Del Norte,48,2022-11-14,20,20,20,0,429,430,429,1,1,0,0,0,55,55,55,55
El Dorado,48,2022-11-14,143,143,143,0,1591,1597,1596,1,7,0,0,1,235,235,235,235
Fresno,48,2022-11-14,771,771,771,0,11251,11280,11279,1,72,8,8,13,2902,2902,2894,2894
Glenn,48,2022-11-14,20,20,20,0,160,161,160,1,0,0,0,0,53,53,53,53
Humboldt,48,2022-11-14,84,84,84,0,1105,1107,1106,1,6,0,0,0,162,162,162,162
Imperial,48,2022-11-14,251,251,251,0,3220,3229,3228,1,4,0,0,1,963,963,963,963
Inyo,48,2022-11-14,11,11,11,0,543,544,543,1,0,0,0,0,60,60,60,60
Kern,48,2022-11-14,470,470,470,0,10701,10728,10727,1,26,1,1,6,2438,2438,2437,2437
Kings,48,2022-11-14,201,201,201,0,2624,2632,2631,1,6,2,2,0,469,469,467,467
Lake,48,2022-11-14,54,54,54,0,803,805,804,1,2,0,0,1,150,150,150,150
Lassen,48,2022-11-14,35,35,35,0,544,545,544,1,0,1,1,0,64,64,63,63
Los Angeles,48,2022-11-14,9412,9436,9436,0,197228,197730,197728,2,477,49,49,75,33942,33942,33893,33893
Madera,48,2022-11-14,95,95,95,0,1713,1718,1717,1,4,0,0,3,375,375,375,375
Marin,48,2022-11-14,175,175,175,0,3569,3579,3578,1,8,0,0,2,317,317,317,317
Mariposa,48,2022-11-14,18,18,18,0,137,138,137,1,0,0,0,0,30,30,30,30
Mendocino,48,2022-11-14,39,39,39,0,908,910,909,1,3,0,0,1,137,137,137,137
Merced,48,2022-11-14,186,186,186,0,2639,2648,2647,1,6,0,0,0,879,879,879,879
Modoc,48,2022-11-14,3,3,3,0,11,12,11,1,0,0,0,0,9,9,9,9
Mono,48,2022-11-14,10,10,10,0,122,123,122,1,0,0,0,0,8,8,8,8
Monterey,48,2022-11-14,200,200,200,0,4157,4170,4169,1,20,1,1,1,776,776,775,775
Napa,48,2022-11-14,105,105,105,0,1919,1925,1924,1,5,0,0,0,159,159,159,159
Nevada,48,2022-11-14,65,65,65,0,797,799,798,1,3,0,0,2,136,136,136,136
Orange,48,2022-11-14,1618,1623,1623,0,27190,27259,27258,1,118,8,8,21,7632,7632,7624,7624
Placer,48,2022-11-14,320,320,320,0,3855,3865,3864,1,54,1,1,5,665,665,664,664
Plumas,48,2022-11-14,4,4,4,0,80,81,80,1,0,0,0,0,13,13,13,13
Riverside,48,2022-11-14,1662,1666,1666,0,22489,22546,22545,1,95,4,4,10,6664,6664,6660,6660
Sacramento,48,2022-11-14,1212,1213,1213,0,16983,17026,17025,1,82,6,6,18,3392,3392,3386,3386
San Benito,48,2022-11-14,42,42,42,0,979,982,981,1,1,0,0,0,102,102,102,102
San Bernardino,48,2022-11-14,1816,1822,1822,0,24221,24282,24281,1,83,0,0,14,8104,8104,8104,8104
San Diego,48,2022-11-14,2454,2462,2462,0,43801,43913,43912,1,124,7,7,21,5615,5615,5608,5608
San Francisco,48,2022-11-14,717,717,717,0,13761,13796,13795,1,52,7,7,5,1086,1086,1079,1079
San Joaquin,48,2022-11-14,609,609,609,0,9500,9525,9524,1,20,0,0,5,2354,2354,2354,2354
San Luis Obispo,48,2022-11-14,120,120,120,0,2200,2206,2205,1,6,0,0,1,530,530,530,530
San Mateo,48,2022-11-14,662,662,662,0,11419,11448,11447,1,27,0,0,2,738,738,738,738
Santa Barbara,48,2022-11-14,192,192,192,0,5891,5906,5905,1,15,1,1,2,737,737,736,736
Santa Clara,48,2022-11-14,1773,1779,1779,0,30788,30869,30868,1,117,3,3,14,2563,2563,2560,2560
Santa Cruz,48,2022-11-14,249,249,249,0,9607,9633,9632,1,11,1,1,0,276,276,275,275
Shasta,48,2022-11-14,104,104,104,0,1073,1075,1074,1,10,1,1,2,595,595,594,594
Siskiyou,48,2022-11-14,27,27,27,0,397,398,397,1,2,0,0,0,95,95,95,95
Solano,48,2022-11-14,438,438,438,0,5428,5443,5442,1,26,0,0,3,462,462,462,462
Sonoma,48,2022-11-14,268,268,268,0,6037,6053,6052,1,23,1,1,0,532,532,531,531
Stanislaus,48,2022-11-14,328,328,328,0,5223,5237,5236,1,48,0,0,10,1798,1798,1798,1798
Sutter,48,2022-11-14,95,95,95,0,1183,1186,1185,1,0,0,0,0,232,232,232,232
Tehama,48,2022-11-14,49,49,49,0,574,575,574,1,1,0,0,0,216,216,216,216
Trinity,48,2022-11-14,11,11,11,0,52,53,52,1,0,1,1,0,22,22,21,21
Tulare,48,2022-11-14,309,309,309,0,4283,4296,4295,1,16,0,0,1,1549,1549,1549,1549
Tuolumne,48,2022-11-14,77,77,77,0,695,696,695,1,2,0,0,0,202,202,202,202
Ventura,48,2022-11-14,572,572,572,0,10636,10664,10663,1,28,1,1,4,1609,1609,1608,1608
Yolo,48,2022-11-14,152,152,152,0,2166,2173,2172,1,2,6,6,0,415,415,409,409
Yuba,48,2022-11-14,60,60,60,0,987,988,987,1,6,0,0,1,122,122,122,122
Alameda,49,2022-11-21,1745,1752,1752,0,25494,25564,25563,1,82,9,9,16,2093,2093,2084,2084
Amador,49,2022-11-21,28,28,28,0,833,835,834,1,2,0,0,0,94,94,94,94
Butte,49,2022-11-21,143,143,143,0,1328,1333,1332,1,21,0,0,1,467,467,467,467
Calaveras,49,2022-11-21,40,40,40,0,421,422,421,1,2,0,0,0,135,135,135,135
Colusa,49,2022-11-21,9,9,9,0,110,111,110,1,0,0,0,0,22,22,22,22
Contra Costa,49,2022-11-21,1029,1030,1030,0,16521,16567,16566,1,52,3,3,8,1488,1488,1485,1485
Del Norte,49,2022-11-21,18,18,18,0,489,490,489,1,4,0,0,0,55,55,55,55
El Dorado,49,2022-11-21,186,186,186,0,1830,1836,1835,1,10,0,0,1,235,235,235,235
Fresno,49,2022-11-21,1068,1069,1069,0,12124,12157,12156,1,114,5,5,9,2907,2907,2902,2902
Glenn,49,2022-11-21,21,21,21,0,214,215,214,1,0,0,0,0,53,53,53,53
Humboldt,49,2022-11-21,123,123,123,0,1174,1177,1176,1,4,1,1,1,163,163,162,162
Imperial,49,2022-11-21,280,280,280,0,3122,3129,3128,1,3,1,1,1,964,964,963,963
Inyo,49,2022-11-21,29,29,29,0,405,406,405,1,0,1,1,0,61,61,60,60
Kern,49,2022-11-21,506,506,506,0,10332,10360,10359,1,54,3,3,10,2441,2441,2438,2438
Kings,49,2022-11-21,295,295,295,0,2780,2789,2788,1,4,2,2,1,471,471,469,469
Lake,49,2022-11-21,55,55,55,0,928,929,928,1,0,1,1,1,151,151,150,150
Lassen,49,2022-11-21,34,34,34,0,541,542,541,1,0,0,0,0,64,64,64,64
Los Angeles,49,2022-11-21,13209,13245,13245,0,200380,200923,200921,2,648,69,69,93,34011,34011,33942,33942
Madera,49,2022-11-21,168,168,168,0,1861,1869,1868,1,11,0,0,1,375,375,375,375
Marin,49,2022-11-21,179,179,179,0,3353,3363,3362,1,8,0,0,0,317,317,317,317
Mariposa,49,2022-11-21,19,19,19,0,170,171,170,1,0,0,0,0,30,30,30,30
Mendocino,49,2022-11-21,39,39,39,0,890,892,891,1,4,0,0,1,137,137,137,137
Merced,49,2022-11-21,269,269,269,0,2931,2941,2940,1,9,2,2,4,881,881,879,879
Modoc,49,2022-11-21,8,8,8,0,13,14,13,1,0,0,0,0,9,9,9,9
Mono,49,2022-11-21,3,3,3,0,107,108,107,1,0,0,0,0,8,8,8,8
Monterey,49,2022-11-21,227,227,227,0,4444,4457,4456,1,17,1,1,0,777,777,776,776
Napa,49,2022-11-21,145,145,145,0,2040,2046,2045,1,4,0,0,1,159,159,159,159
Nevada,49,2022-11-21,92,92,92,0,935,937,936,1,2,0,0,2,136,136,136,136
Orange,49,2022-11-21,2238,2245,2245,0,28652,28731,28730,1,170,14,14,32,7646,7646,7632,7632
Placer,49,2022-11-21,362,362,362,0,4079,4092,4091,1,53,0,0,6,665,665,665,665
Plumas,49,2022-11-21,7,7,7,0,104,105,104,1,1,0,0,0,13,13,13,13
Riverside,49,2022-11-21,2180,2187,2187,0,24557,24622,24621,1,110,7,7,9,6671,6671,6664,6664
Sacramento,49,2022-11-21,1544,1549,1549,0,19057,19110,19109,1,105,3,3,18,3395,3395,3392,3392
San Benito,49,2022-11-21,64,64,64,0,1156,1160,1159,1,2,0,0,0,102,102,102,102
San Bernardino,49,2022-11-21,2390,2398,2398,0,26894,26966,26965,1,89,1,1,19,8105,8105,8104,8104
San Diego,49,2022-11-21,3171,3180,3180,0,44092,44212,44211,1,198,3,3,26,5618,5618,5615,5615
San Francisco,49,2022-11-21,958,959,959,0,15161,15203,15202,1,54,5,5,7,1091,1091,1086,1086
San Joaquin,49,2022-11-21,764,764,764,0,11080,11111,11110,1,36,1,1,5,2355,2355,2354,2354
San Luis Obispo,49,2022-11-21,170,170,170,0,2352,2358,2357,1,4,1,1,0,531,531,530,530
San Mateo,49,2022-11-21,760,760,760,0,12399,12433,12432,1,36,0,0,1,738,738,738,738
Santa Barbara,49,2022-11-21,321,321,321,0,6109,6126,6125,1,15,3,3,3,740,740,737,737
Santa Clara,49,2022-11-21,2210,2217,2217,0,34650,34745,34744,1,119,10,10,23,2573,2573,2563,2563
Santa Cruz,49,2022-11-21,286,286,286,0,9527,9553,9552,1,12,0,0,2,276,276,276,276
Shasta,49,2022-11-21,93,93,93,0,1056,1059,1058,1,14,0,0,1,595,595,595,595
Siskiyou,49,2022-11-21,24,24,24,0,342,343,342,1,1,0,0,0,95,95,95,95
Solano,49,2022-11-21,491,491,491,0,5667,5683,5682,1,32,1,1,5,463,463,462,462
Sonoma,49,2022-11-21,326,326,326,0,5783,5801,5800,1,22,0,0,4,532,532,532,532
Stanislaus,49,2022-11-21,445,445,445,0,5970,5988,5987,1,51,0,0,10,1798,1798,1798,1798
Sutter,49,2022-11-21,91,91,91,0,1143,1146,1145,1,0,0,0,0,232,232,232,232
Tehama,49,2022-11-21,72,72,72,0,673,674,673,1,3,0,0,2,216,216,216,216
Trinity,49,2022-11-21,5,5,5,0,51,52,51,1,0,0,0,0,22,22,22,22
Tulare,49,2022-11-21,430,430,430,0,5506,5522,5521,1,23,0,0,1,1549,1549,1549,1549
Tuolumne,49,2022-11-21,97,97,97,0,766,767,766,1,3,1,1,0,203,203,202,202
Ventura,49,2022-11-21,728,728,728,0,10731,10762,10761,1,43,1,1,2,1610,1610,1609,1609
Yolo,49,2022-11-21,132,132,132,0,2247,2255,2254,1,7,4,4,2,419,419,415,415
Yuba,49,2022-11-21,70,70,70,0,1027,1028,1027,1,10,0,0,1,122,122,122,122
Alameda,50,2022-11-28,2272,2279,2279,0,22324,22390,22389,1,103,6,6,13,2099,2099,2093,2093
Amador,50,2022-11-28,32,32,32,0,757,759,758,1,5,1,1,1,95,95,94,94
Butte,50,2022-11-28,204,204,204,0,1476,1481,1480,1,41,0,0,1,467,467,467,467
Calaveras,50,2022-11-28,32,32,32,0,402,403,402,1,3,0,0,0,135,135,135,135
Colusa,50,2022-11-28,14,14,14,0,184,185,184,1,0,0,0,0,22,22,22,22
Contra Costa,50,2022-11-28,1472,1478,1478,0,15539,15585,15584,1,67,4,4,8,1492,1492,1488,1488
Del Norte,50,2022-11-28,33,33,33,0,458,459,458,1,1,1,1,0,56,56,55,55
El Dorado,50,2022-11-28,185,185,185,0,1549,1554,1553,1,13,1,1,1,236,236,235,235
Fresno,50,2022-11-28,1321,1326,1326,0,11686,11720,11719,1,136,6,6,19,2913,2913,2907,2907
Glenn,50,2022-11-28,17,17,17,0,194,195,194,1,3,0,0,0,53,53,53,53
Humboldt,50,2022-11-28,114,114,114,0,1045,1049,1048,1,10,0,0,0,163,163,163,163
Imperial,50,2022-11-28,379,379,379,0,2790,2800,2799,1,6,1,1,1,965,965,964,964
Inyo,50,2022-11-28,34,34,34,0,376,377,376,1,2,0,0,0,61,61,61,61
Kern,50,2022-11-28,600,600,600,0,9536,9564,9563,1,60,5,5,6,2446,2446,2441,2441
Kings,50,2022-11-28,245,245,245,0,2545,2554,2553,1,10,0,0,0,471,471,471,471
Lake,50,2022-11-28,49,49,49,0,848,851,850,1,1,0,0,0,151,151,151,151
Lassen,50,2022-11-28,27,27,27,0,493,494,493,1,0,0,0,0,64,64,64,64
Los Angeles,50,2022-11-28,18923,18978,18978,0,185012,185558,185556,2,918,89,89,122,34100,34100,34011,34011
Madera,50,2022-11-28,162,162,162,0,1627,1633,1632,1,13,0,0,2,375,375,375,375
Marin,50,2022-11-28,298,298,298,0,3071,3080,3079,1,19,0,0,1,317,317,317,317
Mariposa,50,2022-11-28,23,23,23,0,136,137,136,1,0,0,0,0,30,30,30,30
Mendocino,50,2022-11-28,49,49,49,0,726,727,726,1,5,0,0,2,137,137,137,137
Merced,50,2022-11-28,349,349,349,0,2551,2559,2558,1,18,5,5,2,886,886,881,881
Modoc,50,2022-11-28,5,5,5,0,10,11,10,1,0,0,0,0,9,9,9,9
Mono,50,2022-11-28,4,4,4,0,94,95,94,1,0,0,0,0,8,8,8,8
Monterey,50,2022-11-28,283,283,283,0,3892,3904,3903,1,26,1,1,0,778,778,777,777
Napa,50,2022-11-28,141,141,141,0,1884,1890,1889,1,6,0,0,3,159,159,159,159
Nevada,50,2022-11-28,118,118,118,0,1008,1011,1010,1,9,0,0,0,136,136,136,136
Orange,50,2022-11-28,3187,3195,3195,0,26613,26691,26690,1,221,17,17,34,7663,7663,7646,7646
Placer,50,2022-11-28,391,391,391,0,3786,3799,3798,1,69,3,3,5,668,668,665,665
Plumas,50,2022-11-28,6,6,6,0,143,144,143,1,0,0,0,0,13,13,13,13
Riverside,50,2022-11-28,3230,3239,3239,0,23434,23503,23502,1,188,12,12,22,6683,6683,6671,6671
Sacramento,50,2022-11-28,1811,1817,1817,0,18077,18130,18129,1,126,9,9,14,3404,3404,3395,3395
San Benito,50,2022-11-28,131,131,131,0,1223,1227,1226,1,1,0,0,0,102,102,102,102
San Bernardino,50,2022-11-28,3367,3376,3376,0,26017,26094,26093,1,146,1,1,20,8106,8106,8105,8105
San Diego,50,2022-11-28,4096,4108,4108,0,31919,32014,32013,1,259,7,7,27,5625,5625,5618,5618
San Francisco,50,2022-11-28,1169,1170,1170,0,12782,12818,12817,1,67,6,6,8,1097,1097,1091,1091
San Joaquin,50,2022-11-28,993,994,994,0,10948,10980,10979,1,50,3,3,11,2358,2358,2355,2355
San Luis Obispo,50,2022-11-28,179,179,179,0,2248,2256,2255,1,9,3,3,1,534,534,531,531
San Mateo,50,2022-11-28,1109,1111,1111,0,11096,11132,11131,1,42,1,1,3,739,739,738,738
Santa Barbara,50,2022-11-28,466,466,466,0,5212,5229,5228,1,27,2,2,5,742,742,740,740
Santa Clara,50,2022-11-28,2940,2949,2949,0,28322,28406,28405,1,159,9,9,22,2582,2582,2573,2573
Santa Cruz,50,2022-11-28,371,371,371,0,6667,6688,6687,1,20,0,0,2,276,276,276,276
Shasta,50,2022-11-28,97,97,97,0,1010,1013,1012,1,16,1,1,3,596,596,595,595
Siskiyou,50,2022-11-28,27,27,27,0,277,278,277,1,2,0,0,0,95,95,95,95
Solano,50,2022-11-28,590,590,590,0,5185,5202,5201,1,34,2,2,7,465,465,463,463
Sonoma,50,2022-11-28,456,456,456,0,5012,5027,5026,1,48,2,2,3,534,534,532,532
Stanislaus,50,2022-11-28,523,523,523,0,5363,5380,5379,1,77,3,3,4,1801,1801,1798,1798
Sutter,50,2022-11-28,82,82,82,0,1120,1124,1123,1,0,0,0,0,232,232,232,232
Tehama,50,2022-11-28,70,70,70,0,632,634,633,1,6,0,0,3,216,216,216,216
Trinity,50,2022-11-28,3,3,3,0,60,61,60,1,0,0,0,0,22,22,22,22
Tulare,50,2022-11-28,509,509,509,0,4932,4949,4948,1,34,0,0,0,1549,1549,1549,1549
Tuolumne,50,2022-11-28,72,72,72,0,676,678,677,1,4,0,0,0,203,203,203,203
Ventura,50,2022-11-28,966,967,967,0,10618,10651,10650,1,58,2,2,2,1612,1612,1610,1610
Yolo,50,2022-11-28,169,169,169,0,2033,2040,2039,1,3,4,4,1,423,423,419,419
Yuba,50,2022-11-28,92,92,92,0,927,929,928,1,12,0,0,0,122,122,122,122
Alameda,51,2022-12-05,2834,2842,2842,0,29278,29369,29368,1,126,7,7,13,2106,2106,2099,2099
Amador,51,2022-12-05,41,41,41,0,812,814,813,1,3,0,0,2,95,95,95,95
Butte,51,2022-12-05,239,239,239,0,1887,1893,1892,1,38,7,7,5,474,474,467,467
Calaveras,51,2022-12-05,45,45,45,0,485,486,485,1,0,0,0,0,135,135,135,135
Colusa,51,2022-12-05,13,13,13,0,206,207,206,1,4,0,0,0,22,22,22,22
Contra Costa,51,2022-12-05,1781,1788,1788,0,19307,19368,19367,1,78,0,0,11,1492,1492,1492,1492
Del Norte,51,2022-12-05,39,39,39,0,566,567,566,1,2,0,0,0,56,56,56,56
El Dorado,51,2022-12-05,182,182,182,0,1577,1583,1582,1,14,1,1,0,237,237,236,236
Fresno,51,2022-12-05,1538,1544,1544,0,14271,14316,14315,1,177,6,6,17,2919,2919,2913,2913
Glenn,51,2022-12-05,24,24,24,0,232,233,232,1,2,0,0,0,53,53,53,53
Humboldt,51,2022-12-05,134,134,134,0,1086,1091,1090,1,17,1,1,2,164,164,163,163
Imperial,51,2022-12-05,587,587,587,0,3397,3410,3409,1,18,2,2,5,967,967,965,965
Inyo,51,2022-12-05,26,26,26,0,333,334,333,1,1,1,1,0,62,62,61,61
Kern,51,2022-12-05,819,819,819,0,10831,10865,10864,1,55,1,1,10,2447,2447,2446,2446
Kings,51,2022-12-05,295,295,295,0,3048,3059,3058,1,8,0,0,0,471,471,471,471
Lake,51,2022-12-05,64,64,64,0,831,833,832,1,2,0,0,0,151,151,151,151
Lassen,51,2022-12-05,14,14,14,0,444,445,444,1,0,0,0,0,64,64,64,64
Los Angeles,51,2022-12-05,22429,22500,22500,0,244814,245585,245582,3,1119,110,110,151,34210,34210,34100,34100
Madera,51,2022-12-05,205,205,205,0,1983,1990,1989,1,12,0,0,3,375,375,375,375
Marin,51,2022-12-05,312,312,312,0,3508,3520,3519,1,14,0,0,2,317,317,317,317
Mariposa,51,2022-12-05,19,19,19,0,174,175,174,1,0,0,0,0,30,30,30,30
Mendocino,51,2022-12-05,47,47,47,0,797,798,797,1,6,1,1,2,138,138,137,137
Merced,51,2022-12-05,352,352,352,0,3211,3222,3221,1,23,2,2,2,888,888,886,886
Modoc,51,2022-12-05,12,12,12,0,13,14,13,1,0,0,0,0,9,9,9,9
Mono,51,2022-12-05,9,9,9,0,91,92,91,1,0,0,0,0,8,8,8,8
Monterey,51,2022-12-05,272,272,272,0,4387,4401,4400,1,34,1,1,0,779,779,778,778
Napa,51,2022-12-05,161,161,161,0,2342,2350,2349,1,7,0,0,0,159,159,159,159
Nevada,51,2022-12-05,115,115,115,0,1126,1131,1130,1,8,0,0,2,136,136,136,136
Orange,51,2022-12-05,4347,4360,4360,0,34723,34833,34832,1,301,22,22,48,7685,7685,7663,7663
Placer,51,2022-12-05,396,396,396,0,4059,4073,4072,1,72,1,1,4,669,669,668,668
Plumas,51,2022-12-05,22,22,22,0,184,185,184,1,1,0,0,0,13,13,13,13
Riverside,51,2022-12-05,4045,4057,4057,0,27541,27627,27626,1,186,13,13,25,6696,6696,6683,6683
Sacramento,51,2022-12-05,2147,2154,2154,0,21271,21338,21337,1,128,9,9,28,3413,3413,3404,3404
San Benito,51,2022-12-05,219,219,219,0,1483,1489,1488,1,6,1,1,3,103,103,102,102
San Bernardino,51,2022-12-05,4125,4138,4138,0,28674,28765,28764,1,167,0,0,34,8106,8106,8106,8106
San Diego,51,2022-12-05,5674,5693,5693,0,44779,44919,44918,1,302,13,13,30,5638,5638,5625,5625
San Francisco,51,2022-12-05,1493,1498,1498,0,16003,16053,16052,1,77,7,7,7,1104,1104,1097,1097
San Joaquin,51,2022-12-05,1122,1126,1126,0,12640,12680,12679,1,70,8,8,16,2366,2366,2358,2358
San Luis Obispo,51,2022-12-05,206,206,206,0,2662,2671,2670,1,15,3,3,1,537,537,534,534
San Mateo,51,2022-12-05,1253,1258,1258,0,13631,13676,13675,1,56,1,1,1,740,740,739,739
Santa Barbara,51,2022-12-05,521,521,521,0,6765,6788,6787,1,38,1,1,9,743,743,742,742
Santa Clara,51,2022-12-05,3529,3541,3541,0,35817,35930,35929,1,207,11,11,26,2593,2593,2582,2582
Santa Cruz,51,2022-12-05,471,471,471,0,12739,12780,12779,1,22,0,0,3,276,276,276,276
Shasta,51,2022-12-05,132,132,132,0,1108,1112,1111,1,23,0,0,5,596,596,596,596
Siskiyou,51,2022-12-05,22,22,22,0,309,310,309,1,2,0,0,0,95,95,95,95
Solano,51,2022-12-05,643,643,643,0,6616,6638,6637,1,33,1,1,7,466,466,465,465
Sonoma,51,2022-12-05,507,507,507,0,5883,5904,5903,1,35,5,5,1,539,539,534,534
Stanislaus,51,2022-12-05,640,640,640,0,6730,6752,6751,1,76,1,1,7,1802,1802,1801,1801
Sutter,51,2022-12-05,96,96,96,0,1173,1177,1176,1,0,1,1,0,233,233,232,232
Tehama,51,2022-12-05,93,93,93,0,817,819,818,1,9,2,2,0,218,218,216,216
Trinity,51,2022-12-05,3,3,3,0,39,40,39,1,0,0,0,0,22,22,22,22
Tulare,51,2022-12-05,524,524,524,0,5949,5969,5968,1,35,0,0,1,1549,1549,1549,1549
Tuolumne,51,2022-12-05,107,107,107,0,852,855,854,1,2,0,0,0,203,203,203,203
Ventura,51,2022-12-05,1102,1106,1106,0,12190,12230,12229,1,71,2,2,6,1614,1614,1612,1612
Yolo,51,2022-12-05,215,215,215,0,2653,2663,2662,1,2,1,1,3,424,424,423,423
Yuba,51,2022-12-05,82,82,82,0,1038,1042,1041,1,11,0,0,1,122,122,122,122
Alameda,52,2022-12-12,2687,2696,2696,0,29592,29695,29694,1,147,11,11,20,2117,2117,2106,2106
Amador,52,2022-12-12,32,32,32,0,790,793,792,1,3,0,0,0,95,95,95,95
Butte,52,2022-12-12,183,183,183,0,1836,1844,1843,1,39,2,2,2,476,476,474,474
Calaveras,52,2022-12-12,41,41,41,0,454,455,454,1,1,0,0,0,135,135,135,135
Colusa,52,2022-12-12,12,12,12,0,272,273,272,1,1,0,0,0,22,22,22,22
Contra Costa,52,2022-12-12,1736,1743,1743,0,18442,18506,18505,1,78,10,10,4,1502,1502,1492,1492
Del Norte,52,2022-12-12,34,34,34,0,534,535,534,1,3,0,0,0,56,56,56,56
El Dorado,52,2022-12-12,146,146,146,0,1410,1417,1416,1,8,1,1,3,238,238,237,237
Fresno,52,2022-12-12,1477,1483,1483,0,13830,13879,13878,1,186,12,12,18,2931,2931,2919,2919
Glenn,52,2022-12-12,17,17,17,0,230,231,230,1,6,0,0,0,53,53,53,53
Humboldt,52,2022-12-12,107,107,107,0,1014,1019,1018,1,13,1,1,2,165,165,164,164
Imperial,52,2022-12-12,455,455,455,0,2940,2953,2952,1,27,3,3,3,970,970,967,967
Inyo,52,2022-12-12,22,22,22,0,303,304,303,1,1,0,0,0,62,62,62,62
Kern,52,2022-12-12,955,957,957,0,11016,11055,11054,1,55,2,2,4,2449,2449,2447,2447
Kings,52,2022-12-12,256,256,256,0,2855,2866,2865,1,8,2,2,0,473,473,471,471
Lake,52,2022-12-12,56,56,56,0,761,762,761,1,3,0,0,1,151,151,151,151
Lassen,52,2022-12-12,15,15,15,0,423,424,423,1,0,0,0,0,64,64,64,64
Los Angeles,52,2022-12-12,17532,17593,17593,0,227425,228219,228216,3,1113,158,158,154,34368,34368,34210,34210
Madera,52,2022-12-12,212,212,212,0,2174,2184,2183,1,15,0,0,2,375,375,375,375
Marin,52,2022-12-12,315,315,315,0,3620,3634,3633,1,24,0,0,2,317,317,317,317
Mariposa,52,2022-12-12,18,18,18,0,122,123,122,1,0,0,0,0,30,30,30,30
Mendocino,52,2022-12-12,53,53,53,0,657,658,657,1,7,1,1,0,139,139,138,138
Merced,52,2022-12-12,318,318,318,0,3323,3336,3335,1,14,0,0,2,888,888,888,888
Modoc,52,2022-12-12,5,5,5,0,10,11,10,1,0,0,0,0,9,9,9,9
Mono,52,2022-12-12,9,9,9,0,122,123,122,1,0,0,0,0,8,8,8,8
Monterey,52,2022-12-12,265,265,265,0,4258,4272,4271,1,25,3,3,2,782,782,779,779
Napa,52,2022-12-12,162,162,162,0,2173,2181,2180,1,9,1,1,0,160,160,159,159
Nevada,52,2022-12-12,90,90,90,0,969,972,971,1,5,0,0,2,136,136,136,136
Orange,52,2022-12-12,3490,3502,3502,0,31459,31568,31567,1,300,35,35,48,7720,7720,7685,7685
Placer,52,2022-12-12,332,332,332,0,3892,3906,3905,1,73,5,5,6,674,674,669,669
Plumas,52,2022-12-12,7,7,7,0,186,187,186,1,2,0,0,0,13,13,13,13
Riverside,52,2022-12-12,3336,3348,3348,0,24677,24762,24761,1,204,19,19,25,6715,6715,6696,6696
Sacramento,52,2022-12-12,1821,1828,1828,0,20158,20228,20227,1,173,7,7,31,3420,3420,3413,3413
San Benito,52,2022-12-12,125,125,125,0,1330,1335,1334,1,2,2,2,2,105,105,103,103
San Bernardino,52,2022-12-12,3603,3615,3615,0,26972,27066,27065,1,226,4,4,36,8110,8110,8106,8106
San Diego,52,2022-12-12,4844,4861,4861,0,40541,40683,40682,1,331,15,15,45,5653,5653,5638,5638
San Francisco,52,2022-12-12,1427,1433,1433,0,16802,16861,16860,1,103,7,7,12,1111,1111,1104,1104
San Joaquin,52,2022-12-12,1000,1004,1004,0,12712,12757,12756,1,68,6,6,19,2372,2372,2366,2366
San Luis Obispo,52,2022-12-12,231,231,231,0,2650,2660,2659,1,10,1,1,0,538,538,537,537
San Mateo,52,2022-12-12,1168,1173,1173,0,12498,12543,12542,1,59,1,1,3,741,741,740,740
Santa Barbara,52,2022-12-12,512,512,512,0,5768,5789,5788,1,36,2,2,6,745,745,743,743
Santa Clara,52,2022-12-12,3260,3272,3272,0,35159,35282,35281,1,198,18,18,30,2611,2611,2593,2593
Santa Cruz,52,2022-12-12,578,578,578,0,12939,12986,12985,1,29,0,0,1,276,276,276,276
Shasta,52,2022-12-12,104,104,104,0,1154,1160,1159,1,22,0,0,5,596,596,596,596
Siskiyou,52,2022-12-12,15,15,15,0,245,246,245,1,2,0,0,0,95,95,95,95
Solano,52,2022-12-12,635,635,635,0,6178,6199,6198,1,42,2,2,7,468,468,466,466
Sonoma,52,2022-12-12,558,558,558,0,5592,5613,5612,1,41,2,2,7,541,541,539,539
Stanislaus,52,2022-12-12,593,593,593,0,6383,6406,6405,1,104,8,8,12,1810,1810,1802,1802
Sutter,52,2022-12-12,114,114,114,0,1156,1162,1161,1,0,0,0,0,233,233,233,233
Tehama,52,2022-12-12,80,80,80,0,774,777,776,1,6,1,1,0,219,219,218,218
Trinity,52,2022-12-12,3,3,3,0,45,46,45,1,0,0,0,0,22,22,22,22
Tulare,52,2022-12-12,439,439,439,0,5891,5912,5911,1,27,2,2,2,1551,1551,1549,1549
Tuolumne,52,2022-12-12,133,133,133,0,936,939,938,1,5,0,0,0,203,203,203,203
Ventura,52,2022-12-12,915,918,918,0,10660,10698,10697,1,72,4,4,7,1618,1618,1614,1614
Yolo,52,2022-12-12,210,210,210,0,2300,2308,2307,1,5,2,2,2,426,426,424,424
Yuba,52,2022-12-12,75,75,75,0,948,953,952,1,13,0,0,0,122,122,122,122
Alameda,53,2022-12-19,2349,2359,2359,0,27041,27149,27148,1,144,11,11,19,2128,2128,2117,2117
Amador,53,2022-12-19,42,42,42,0,807,810,809,1,6,0,0,0,95,95,95,95
Butte,53,2022-12-19,128,128,128,0,1639,1646,1645,1,34,3,3,2,479,479,476,476
Calaveras,53,2022-12-19,29,29,29,0,441,442,441,1,1,1,1,0,136,136,135,135
Colusa,53,2022-12-19,12,12,12,0,214,215,214,1,1,0,0,0,22,22,22,22
Contra Costa,53,2022-12-19,1716,1723,1723,0,17365,17435,17434,1,95,6,6,7,1508,1508,1502,1502
Del Norte,53,2022-12-19,39,39,39,0,553,554,553,1,3,0,0,0,56,56,56,56
El Dorado,53,2022-12-19,160,160,160,0,1632,1638,1637,1,9,1,1,2,239,239,238,238
Fresno,53,2022-12-19,1179,1185,1185,0,12865,12917,12916,1,212,7,7,22,2938,2938,2931,2931
Glenn,53,2022-12-19,21,21,21,0,205,206,205,1,6,0,0,0,53,53,53,53
Humboldt,53,2022-12-19,113,113,113,0,945,951,950,1,9,0,0,1,165,165,165,165
Imperial,53,2022-12-19,262,262,262,0,2547,2559,2558,1,16,1,1,0,971,971,970,970
Inyo,53,2022-12-19,12,12,12,0,324,325,324,1,1,0,0,0,62,62,62,62
Kern,53,2022-12-19,940,945,945,0,10704,10747,10746,1,60,3,3,5,2452,2452,2449,2449
Kings,53,2022-12-19,228,228,228,0,2770,2782,2781,1,6,4,4,1,477,477,473,473
Lake,53,2022-12-19,70,70,70,0,794,799,798,1,4,1,1,0,152,152,151,151
Lassen,53,2022-12-19,8,8,8,0,466,467,466,1,0,0,0,0,64,64,64,64
Los Angeles,53,2022-12-19,15277,15338,15338,0,204067,204873,204871,2,1096,130,130,155,34498,34498,34368,34368
Madera,53,2022-12-19,186,186,186,0,1891,1900,1899,1,10,0,0,1,375,375,375,375
Marin,53,2022-12-19,268,268,268,0,3234,3247,3246,1,17,0,0,0,317,317,317,317
Mariposa,53,2022-12-19,25,25,25,0,133,134,133,1,0,0,0,0,30,30,30,30
Mendocino,53,2022-12-19,66,66,66,0,755,759,758,1,4,0,0,0,139,139,139,139
Merced,53,2022-12-19,262,262,262,0,2773,2786,2785,1,15,2,2,2,890,890,888,888
Modoc,53,2022-12-19,8,8,8,0,21,22,21,1,0,0,0,0,9,9,9,9
Mono,53,2022-12-19,11,11,11,0,121,122,121,1,1,0,0,0,8,8,8,8
Monterey,53,2022-12-19,232,232,232,0,3880,3896,3895,1,13,1,1,1,783,783,782,782
Napa,53,2022-12-19,181,181,181,0,2094,2102,2101,1,8,0,0,0,160,160,160,160
Nevada,53,2022-12-19,72,72,72,0,883,887,886,1,5,0,0,2,136,136,136,136
Orange,53,2022-12-19,3299,3311,3311,0,30243,30363,30362,1,296,33,33,51,7753,7753,7720,7720
Placer,53,2022-12-19,363,363,363,0,3844,3859,3858,1,90,1,1,10,675,675,674,674
Plumas,53,2022-12-19,7,7,7,0,188,189,188,1,0,0,0,0,13,13,13,13
Riverside,53,2022-12-19,3164,3176,3176,0,22868,22959,22958,1,177,21,21,22,6736,6736,6715,6715
Sacramento,53,2022-12-19,1730,1736,1736,0,19755,19833,19832,1,210,15,15,22,3435,3435,3420,3420
San Benito,53,2022-12-19,105,105,105,0,1136,1142,1141,1,0,4,4,1,109,109,105,105
San Bernardino,53,2022-12-19,3215,3227,3227,0,25064,25162,25161,1,200,4,4,38,8114,8114,8110,8110
San Diego,53,2022-12-19,4850,4870,4870,0,39286,39442,39441,1,381,16,16,45,5669,5669,5653,5653
San Francisco,53,2022-12-19,1228,1233,1233,0,15730,15792,15791,1,106,11,11,17,1122,1122,1111,1111
San Joaquin,53,2022-12-19,851,854,854,0,12994,13045,13044,1,58,11,11,19,2383,2383,2372,2372
San Luis Obispo,53,2022-12-19,242,242,242,0,2423,2434,2433,1,17,1,1,0,539,539,538,538
San Mateo,53,2022-12-19,950,955,955,0,11890,11937,11936,1,62,1,1,5,742,742,741,741
Santa Barbara,53,2022-12-19,468,468,468,0,5251,5274,5273,1,35,4,4,5,749,749,745,745
Santa Clara,53,2022-12-19,2837,2849,2849,0,32490,32621,32620,1,205,14,14,30,2625,2625,2611,2611
Santa Cruz,53,2022-12-19,260,260,260,0,11208,11255,11254,1,31,0,0,1,276,276,276,276
Shasta,53,2022-12-19,109,109,109,0,1126,1132,1131,1,24,1,1,4,597,597,596,596
Siskiyou,53,2022-12-19,15,15,15,0,258,259,258,1,2,0,0,0,95,95,95,95
Solano,53,2022-12-19,639,640,640,0,6177,6202,6201,1,41,0,0,6,468,468,468,468
Sonoma,53,2022-12-19,478,478,478,0,5425,5447,5446,1,38,1,1,4,542,542,541,541
Stanislaus,53,2022-12-19,474,474,474,0,5998,6022,6021,1,94,1,1,12,1811,1811,1810,1810
Sutter,53,2022-12-19,81,81,81,0,1074,1079,1078,1,0,1,1,0,234,234,233,233
Tehama,53,2022-12-19,67,67,67,0,676,679,678,1,6,1,1,0,220,220,219,219
Trinity,53,2022-12-19,2,2,2,0,31,32,31,1,0,0,0,0,22,22,22,22
Tulare,53,2022-12-19,467,467,467,0,5382,5404,5403,1,53,5,5,1,1556,1556,1551,1551
Tuolumne,53,2022-12-19,88,88,88,0,841,846,845,1,2,1,1,1,204,204,203,203
Ventura,53,2022-12-19,937,942,942,0,9969,10009,10008,1,81,4,4,9,1622,1622,1618,1618
Yolo,53,2022-12-19,172,172,172,0,1968,1978,1977,1,5,4,4,0,430,430,426,426
Yuba,53,2022-12-19,81,81,81,0,900,906,905,1,7,0,0,0,122,122,122,122
Alameda,54,2022-12-26,1971,1978,1978,0,20709,20798,20797,1,150,11,11,17,2139,2139,2128,2128
Amador,54,2022-12-26,43,43,43,0,758,760,759,1,5,1,1,0,96,96,95,95
Butte,54,2022-12-26,95,95,95,0,1296,1302,1301,1,33,0,0,1,479,479,479,479
Calaveras,54,2022-12-26,24,24,24,0,366,367,366,1,0,1,1,0,137,137,136,136
Colusa,54,2022-12-26,14,14,14,0,150,151,150,1,0,0,0,0,22,22,22,22
Contra Costa,54,2022-12-26,1454,1460,1460,0,13769,13827,13826,1,89,10,10,11,1518,1518,1508,1508
Del Norte,54,2022-12-26,33,33,33,0,420,421,420,1,3,0,0,0,56,56,56,56
El Dorado,54,2022-12-26,152,152,152,0,1317,1323,1322,1,7,1,1,0,240,240,239,239
Fresno,54,2022-12-26,1086,1091,1091,0,10629,10677,10676,1,186,10,10,33,2948,2948,2938,2938
Glenn,54,2022-12-26,12,12,12,0,196,197,196,1,0,0,0,0,53,53,53,53
Humboldt,54,2022-12-26,82,82,82,0,631,634,633,1,5,2,2,2,167,167,165,165
Imperial,54,2022-12-26,234,234,234,0,2164,2175,2174,1,67,2,2,0,973,973,971,971
Inyo,54,2022-12-26,13,13,13,0,158,159,158,1,1,0,0,0,62,62,62,62
Kern,54,2022-12-26,702,705,705,0,8862,8900,8899,1,51,9,9,8,2461,2461,2452,2452
Kings,54,2022-12-26,200,200,200,0,2295,2307,2306,1,5,0,0,2,477,477,477,477
Lake,54,2022-12-26,58,58,58,0,601,603,602,1,3,0,0,1,152,152,152,152
Lassen,54,2022-12-26,27,27,27,0,485,487,486,1,0,0,0,0,64,64,64,64
Los Angeles,54,2022-12-26,13479,13538,13538,0,134561,135143,135141,2,1032,170,170,164,34668,34668,34498,34498
Madera,54,2022-12-26,166,166,166,0,1565,1573,1572,1,6,0,0,1,375,375,375,375
Marin,54,2022-12-26,214,214,214,0,2555,2568,2567,1,29,0,0,2,317,317,317,317
Mariposa,54,2022-12-26,22,22,22,0,105,106,105,1,0,0,0,0,30,30,30,30
Mendocino,54,2022-12-26,75,75,75,0,646,650,649,1,10,0,0,0,139,139,139,139
Merced,54,2022-12-26,212,212,212,0,1965,1976,1975,1,17,5,5,3,895,895,890,890
Modoc,54,2022-12-26,4,4,4,0,11,12,11,1,0,0,0,0,9,9,9,9
Mono,54,2022-12-26,10,10,10,0,83,84,83,1,0,0,0,0,8,8,8,8
Monterey,54,2022-12-26,192,192,192,0,2963,2976,2975,1,21,5,5,0,788,788,783,783
Napa,54,2022-12-26,142,142,142,0,1720,1727,1726,1,12,0,0,0,160,160,160,160
Nevada,54,2022-12-26,66,66,66,0,751,756,755,1,9,0,0,1,136,136,136,136
Orange,54,2022-12-26,3281,3296,3296,0,25029,25138,25137,1,274,38,38,31,7791,7791,7753,7753
Placer,54,2022-12-26,291,291,291,0,3048,3062,3061,1,87,2,2,12,677,677,675,675
Plumas,54,2022-12-26,10,10,10,0,123,124,123,1,0,0,0,0,13,13,13,13
Riverside,54,2022-12-26,2933,2945,2945,0,18669,18750,18749,1,194,12,12,18,6748,6748,6736,6736
Sacramento,54,2022-12-26,1389,1395,1395,0,14558,14622,14621,1,179,12,12,25,3447,3447,3435,3435
San Benito,54,2022-12-26,106,106,106,0,810,814,813,1,1,0,0,1,109,109,109,109
San Bernardino,54,2022-12-26,2956,2968,2968,0,20237,20326,20325,1,210,7,7,26,8121,8121,8114,8114
San Diego,54,2022-12-26,4603,4622,4622,0,28859,28984,28983,1,395,25,25,45,5694,5694,5669,5669
San Francisco,54,2022-12-26,1031,1036,1036,0,11830,11882,11881,1,90,20,20,15,1142,1142,1122,1122
San Joaquin,54,2022-12-26,750,754,754,0,10079,10123,10122,1,60,7,7,10,2390,2390,2383,2383
San Luis Obispo,54,2022-12-26,212,212,212,0,1973,1984,1983,1,20,3,3,0,542,542,539,539
San Mateo,54,2022-12-26,843,848,848,0,8983,9023,9022,1,55,0,0,6,742,742,742,742
Santa Barbara,54,2022-12-26,486,486,486,0,4097,4116,4115,1,40,0,0,4,749,749,749,749
Santa Clara,54,2022-12-26,2341,2353,2353,0,24200,24304,24303,1,179,9,9,35,2634,2634,2625,2625
Santa Cruz,54,2022-12-26,221,221,221,0,4641,4662,4661,1,25,0,0,2,276,276,276,276
Shasta,54,2022-12-26,100,100,100,0,923,929,928,1,18,0,0,1,597,597,597,597
Siskiyou,54,2022-12-26,17,17,17,0,266,267,266,1,1,0,0,0,95,95,95,95
Solano,54,2022-12-26,648,651,651,0,5238,5261,5260,1,59,2,2,7,470,470,468,468
Sonoma,54,2022-12-26,455,455,455,0,4249,4269,4268,1,39,1,1,4,543,543,542,542
Stanislaus,54,2022-12-26,451,451,451,0,4899,4922,4921,1,96,10,10,5,1821,1821,1811,1811
Sutter,54,2022-12-26,128,128,128,0,928,934,933,1,0,0,0,0,234,234,234,234
Tehama,54,2022-12-26,48,48,48,0,607,609,608,1,2,3,3,0,223,223,220,220
Trinity,54,2022-12-26,3,3,3,0,39,40,39,1,0,0,0,0,22,22,22,22
Tulare,54,2022-12-26,441,441,441,0,3938,3957,3956,1,41,7,7,3,1563,1563,1556,1556
Tuolumne,54,2022-12-26,93,93,93,0,758,762,761,1,6,2,2,2,206,206,204,204
Ventura,54,2022-12-26,888,892,892,0,7867,7902,7901,1,71,16,16,11,1638,1638,1622,1622
Yolo,54,2022-12-26,140,140,140,0,1613,1621,1620,1,9,2,2,1,432,432,430,430
Yuba,54,2022-12-26,99,99,99,0,754,758,757,1,14,0,0,0,122,122,122,122
Alameda,55,2023-01-02,1857,1867,1867,0,20045,20142,20141,1,175,14,14,19,2153,2153,2139,2139
Amador,55,2023-01-02,34,34,34,0,677,681,680,1,3,1,1,0,97,97,96,96
Butte,55,2023-01-02,99,99,99,0,1326,1334,1333,1,35,3,3,2,482,482,479,479
Calaveras,55,2023-01-02,33,33,33,0,361,362,361,1,0,2,2,0,139,139,137,137
Colusa,55,2023-01-02,5,5,5,0,94,95,94,1,0,0,0,0,22,22,22,22
Contra Costa,55,2023-01-02,1381,1388,1388,0,14060,14127,14126,1,89,5,5,13,1523,1523,1518,1518
Del Norte,55,2023-01-02,32,32,32,0,408,409,408,1,3,0,0,2,56,56,56,56
El Dorado,55,2023-01-02,147,147,147,0,1408,1416,1415,1,7,1,1,2,241,241,240,240
Fresno,55,2023-01-02,1065,1070,1070,0,11342,11397,11396,1,195,16,16,28,2964,2964,2948,2948
Glenn,55,2023-01-02,12,12,12,0,190,191,190,1,0,0,0,0,53,53,53,53
Humboldt,55,2023-01-02,48,48,48,0,618,622,621,1,2,0,0,2,167,167,167,167
Imperial,55,2023-01-02,205,205,205,0,2033,2044,2043,1,11,0,0,1,973,973,973,973
Inyo,55,2023-01-02,16,16,16,0,226,227,226,1,1,0,0,0,62,62,62,62
Kern,55,2023-01-02,892,896,896,0,9781,9829,9828,1,66,3,3,8,2464,2464,2461,2461
Kings,55,2023-01-02,186,186,186,0,2165,2177,2176,1,4,2,2,1,479,479,477,477
Lake,55,2023-01-02,47,47,47,0,604,606,605,1,3,1,1,0,153,153,152,152
Lassen,55,2023-01-02,13,13,13,0,490,493,492,1,0,0,0,0,64,64,64,64
Los Angeles,55,2023-01-02,13379,13444,13444,0,138201,138873,138871,2,1091,145,146,154,34813,34814,34668,34668
Madera,55,2023-01-02,153,153,153,0,1654,1664,1663,1,7,0,0,0,375,375,375,375
Marin,55,2023-01-02,225,225,225,0,2407,2420,2419,1,24,0,0,2,317,317,317,317
Mariposa,55,2023-01-02,15,15,15,0,94,95,94,1,0,0,0,0,30,30,30,30
Mendocino,55,2023-01-02,59,59,59,0,687,691,690,1,6,1,1,3,140,140,139,139
Merced,55,2023-01-02,194,194,194,0,2013,2025,2024,1,8,2,2,4,897,897,895,895
Modoc,55,2023-01-02,9,9,9,0,14,15,14,1,0,0,0,0,9,9,9,9
Mono,55,2023-01-02,10,10,10,0,66,67,66,1,0,0,0,0,8,8,8,8
Monterey,55,2023-01-02,216,216,216,0,3046,3061,3060,1,27,0,0,0,788,788,788,788
Napa,55,2023-01-02,124,124,124,0,1677,1686,1685,1,8,1,1,1,161,161,160,160
Nevada,55,2023-01-02,54,54,54,0,722,727,726,1,8,0,0,2,136,136,136,136
Orange,55,2023-01-02,3282,3298,3298,0,25264,25388,25387,1,312,37,37,28,7828,7828,7791,7791
Placer,55,2023-01-02,305,305,305,0,3244,3261,3260,1,108,1,1,8,678,678,677,677
Plumas,55,2023-01-02,12,12,12,0,145,146,145,1,1,1,1,0,14,14,13,13
Riverside,55,2023-01-02,3122,3137,3137,0,20084,20183,20182,1,223,9,9,31,6757,6757,6748,6748
Sacramento,55,2023-01-02,1520,1527,1527,0,15307,15382,15381,1,201,19,19,26,3466,3466,3447,3447
San Benito,55,2023-01-02,58,58,58,0,793,797,796,1,1,0,0,1,109,109,109,109
San Bernardino,55,2023-01-02,2872,2886,2886,0,20964,21066,21065,1,183,3,3,31,8124,8124,8121,8121
San Diego,55,2023-01-02,4633,4655,4655,0,29554,29698,29697,1,401,25,25,43,5719,5719,5694,5694
San Francisco,55,2023-01-02,884,889,889,0,10187,10237,10236,1,77,11,11,15,1153,1153,1142,1142
San Joaquin,55,2023-01-02,753,757,757,0,10414,10466,10465,1,62,6,6,12,2396,2396,2390,2390
San Luis Obispo,55,2023-01-02,210,210,210,0,1995,2006,2005,1,17,6,6,0,548,548,542,542
San Mateo,55,2023-01-02,741,744,744,0,8038,8077,8076,1,50,0,0,9,742,742,742,742
Santa Barbara,55,2023-01-02,433,433,433,0,4044,4065,4064,1,47,1,1,5,750,750,749,749
Santa Clara,55,2023-01-02,2446,2459,2459,0,23404,23518,23517,1,200,15,15,32,2649,2649,2634,2634
Santa Cruz,55,2023-01-02,171,171,171,0,3008,3024,3023,1,27,0,0,0,276,276,276,276
Shasta,55,2023-01-02,98,98,98,0,947,952,951,1,20,0,0,1,597,597,597,597
Siskiyou,55,2023-01-02,15,15,15,0,268,269,268,1,1,0,0,0,95,95,95,95
Solano,55,2023-01-02,639,642,642,0,5300,5326,5325,1,60,3,3,11,473,473,470,470
Sonoma,55,2023-01-02,423,423,423,0,4259,4280,4279,1,56,0,0,2,543,543,543,543
Stanislaus,55,2023-01-02,475,476,476,0,5020,5046,5045,1,88,6,6,8,1827,1827,1821,1821
Sutter,55,2023-01-02,97,97,97,0,889,895,894,1,0,0,0,0,234,234,234,234
Tehama,55,2023-01-02,54,54,54,0,621,624,623,1,2,5,5,0,228,228,223,223
Trinity,55,2023-01-02,4,4,4,0,41,42,41,1,0,0,0,0,22,22,22,22
Tulare,55,2023-01-02,469,470,470,0,4718,4742,4741,1,52,1,1,6,1564,1564,1563,1563
Tuolumne,55,2023-01-02,66,66,66,0,662,666,665,1,5,1,1,0,207,207,206,206
Ventura,55,2023-01-02,902,907,907,0,7466,7503,7502,1,87,10,10,13,1648,1648,1638,1638
Yolo,55,2023-01-02,135,135,135,0,1524,1532,1531,1,4,3,3,1,435,435,432,432
Yuba,55,2023-01-02,79,79,79,0,730,734,733,1,19,0,0,1,122,122,122,122
Alameda,56,2023-01-09,1494,1502,1502,0,23341,23464,23463,1,149,12,12,11,2165,2165,2153,2153
Amador,56,2023-01-09,28,28,28,0,706,710,709,1,2,0,0,0,97,97,97,97
Butte,56,2023-01-09,86,86,86,0,1201,1209,1208,1,39,2,2,3,484,484,482,482
Calaveras,56,2023-01-09,19,19,19,0,341,342,341,1,0,0,0,1,139,139,139,139
Colusa,56,2023-01-09,8,8,8,0,92,93,92,1,0,0,0,0,22,22,22,22
Contra Costa,56,2023-01-09,1057,1062,1062,0,15376,15457,15456,1,85,6,6,11,1529,1529,1523,1523
Del Norte,56,2023-01-09,17,17,17,0,367,368,367,1,5,0,0,2,56,56,56,56
El Dorado,56,2023-01-09,87,87,87,0,1453,1463,1462,1,4,0,0,0,241,241,241,241
Fresno,56,2023-01-09,805,810,810,0,11449,11509,11508,1,171,7,7,23,2971,2971,2964,2964
Glenn,56,2023-01-09,8,8,8,0,185,186,185,1,0,0,0,0,53,53,53,53
Humboldt,56,2023-01-09,57,57,57,0,708,713,712,1,7,0,0,4,167,167,167,167
Imperial,56,2023-01-09,161,161,161,0,2438,2453,2452,1,12,2,2,2,975,975,973,973
Inyo,56,2023-01-09,10,10,10,0,205,206,205,1,0,0,0,0,62,62,62,62
Kern,56,2023-01-09,621,625,625,0,10590,10649,10648,1,73,4,4,8,2468,2468,2464,2464
Kings,56,2023-01-09,184,184,184,0,2315,2328,2327,1,9,0,0,0,479,479,479,479
Lake,56,2023-01-09,44,44,44,0,622,627,626,1,3,1,1,0,154,154,153,153
Lassen,56,2023-01-09,19,19,19,0,506,509,508,1,2,0,0,0,64,64,64,64
Los Angeles,56,2023-01-09,10168,10222,10222,0,189788,190788,190786,2,965,142,146,136,34955,34960,34813,34814
Madera,56,2023-01-09,100,100,100,0,1645,1656,1655,1,8,0,0,1,375,375,375,375
Marin,56,2023-01-09,145,145,145,0,2559,2574,2573,1,18,0,0,3,317,317,317,317
Mariposa,56,2023-01-09,9,9,9,0,105,106,105,1,0,1,1,0,31,31,30,30
Mendocino,56,2023-01-09,40,40,40,0,645,649,648,1,10,2,2,3,142,142,140,140
Merced,56,2023-01-09,185,185,185,0,2151,2163,2162,1,11,1,1,1,898,898,897,897
Modoc,56,2023-01-09,8,8,8,0,14,15,14,1,0,0,0,0,9,9,9,9
Mono,56,2023-01-09,12,12,12,0,78,79,78,1,0,0,0,0,8,8,8,8
Monterey,56,2023-01-09,170,170,170,0,3126,3144,3143,1,20,4,4,3,792,792,788,788
Napa,56,2023-01-09,132,132,132,0,1878,1890,1889,1,9,0,0,3,161,161,161,161
Nevada,56,2023-01-09,42,42,42,0,760,765,764,1,6,0,0,0,136,136,136,136
Orange,56,2023-01-09,2448,2461,2461,0,28000,28146,28145,1,267,39,39,34,7867,7867,7828,7828
Placer,56,2023-01-09,260,260,260,0,3404,3423,3422,1,89,0,0,6,678,678,678,678
Plumas,56,2023-01-09,5,5,5,0,89,90,89,1,1,0,0,0,14,14,14,14
Riverside,56,2023-01-09,2003,2013,2013,0,21232,21344,21343,1,186,13,13,26,6770,6770,6757,6757
Sacramento,56,2023-01-09,1022,1028,1028,0,15633,15715,15714,1,178,16,16,28,3482,3482,3466,3466
San Benito,56,2023-01-09,51,51,51,0,817,821,820,1,1,0,0,2,109,109,109,109
San Bernardino,56,2023-01-09,1758,1767,1767,0,20708,20818,20817,1,179,6,6,36,8130,8130,8124,8124
San Diego,56,2023-01-09,3592,3610,3610,0,35103,35289,35288,1,397,25,25,40,5744,5744,5719,5719
San Francisco,56,2023-01-09,791,796,796,0,12768,12836,12835,1,75,7,7,17,1160,1160,1153,1153
San Joaquin,56,2023-01-09,591,593,593,0,10955,11014,11013,1,51,10,10,12,2406,2406,2396,2396
San Luis Obispo,56,2023-01-09,186,186,186,0,2148,2162,2161,1,12,3,3,0,551,551,548,548
San Mateo,56,2023-01-09,609,612,612,0,9703,9755,9754,1,47,0,0,5,742,742,742,742
Santa Barbara,56,2023-01-09,367,367,367,0,4500,4525,4524,1,39,3,3,1,753,753,750,750
Santa Clara,56,2023-01-09,1976,1987,1987,0,28593,28745,28744,1,182,12,12,28,2661,2661,2649,2649
Santa Cruz,56,2023-01-09,152,152,152,0,4064,4086,4085,1,27,0,0,1,276,276,276,276
Shasta,56,2023-01-09,60,60,60,0,890,896,895,1,17,0,0,2,597,597,597,597
Siskiyou,56,2023-01-09,20,20,20,0,233,234,233,1,0,0,0,0,95,95,95,95
Solano,56,2023-01-09,401,401,401,0,5182,5210,5209,1,54,1,1,6,474,474,473,473
Sonoma,56,2023-01-09,287,287,287,0,4752,4779,4778,1,31,3,3,4,546,546,543,543
Stanislaus,56,2023-01-09,303,303,303,0,5178,5206,5205,1,87,6,6,8,1833,1833,1827,1827
Sutter,56,2023-01-09,62,62,62,0,870,876,875,1,0,0,0,0,234,234,234,234
Tehama,56,2023-01-09,28,28,28,0,491,493,492,1,1,2,2,0,230,230,228,228
Trinity,56,2023-01-09,3,3,3,0,30,31,30,1,0,0,0,0,22,22,22,22
Tulare,56,2023-01-09,334,334,334,0,5103,5131,5130,1,53,5,5,2,1569,1569,1564,1564
Tuolumne,56,2023-01-09,74,74,74,0,655,660,659,1,2,1,1,0,208,208,207,207
Ventura,56,2023-01-09,662,665,665,0,9382,9432,9431,1,65,5,5,12,1653,1653,1648,1648
Yolo,56,2023-01-09,107,107,107,0,1665,1675,1674,1,2,2,2,1,437,437,435,435
Yuba,56,2023-01-09,48,48,48,0,735,740,739,1,21,0,0,1,122,122,122,122
Alameda,57,2023-01-16,871,878,878,0,19087,19202,19201,1,105,5,5,11,2170,2170,2165,2165
Amador,57,2023-01-16,21,21,21,0,585,587,586,1,4,0,0,0,97,97,97,97
Butte,57,2023-01-16,58,58,58,0,1157,1165,1164,1,21,1,1,0,485,485,484,484
Calaveras,57,2023-01-16,10,10,10,0,308,309,308,1,2,0,0,1,139,139,139,139
Colusa,57,2023-01-16,7,7,7,0,86,87,86,1,1,0,0,0,22,22,22,22
Contra Costa,57,2023-01-16,616,620,620,0,12109,12181,12180,1,61,5,5,11,1534,1534,1529,1529
Del Norte,57,2023-01-16,10,10,10,0,303,304,303,1,3,2,2,1,58,58,56,56
El Dorado,57,2023-01-16,60,60,60,0,978,985,984,1,2,1,1,1,242,242,241,241
Fresno,57,2023-01-16,462,463,463,0,9705,9764,9763,1,162,7,7,13,2978,2978,2971,2971
Glenn,57,2023-01-16,3,3,3,0,163,165,164,1,0,0,0,0,53,53,53,53
Humboldt,57,2023-01-16,35,35,35,0,497,499,498,1,9,1,1,2,168,168,167,167
Imperial,57,2023-01-16,127,127,127,0,2067,2080,2079,1,10,2,2,2,977,977,975,975
Inyo,57,2023-01-16,11,11,11,0,199,200,199,1,0,0,0,0,62,62,62,62
Kern,57,2023-01-16,386,386,386,0,8283,8335,8334,1,55,4,4,13,2472,2472,2468,2468
Kings,57,2023-01-16,126,126,126,0,1982,1996,1995,1,5,2,2,0,481,481,479,479
Lake,57,2023-01-16,23,23,23,0,576,582,581,1,2,1,1,1,155,155,154,154
Lassen,57,2023-01-16,6,6,6,0,441,443,442,1,0,0,0,0,64,64,64,64
Los Angeles,57,2023-01-16,6114,6151,6151,0,148491,149382,149380,2,855,143,150,113,35098,35110,34955,34960
Madera,57,2023-01-16,67,67,67,0,1350,1358,1357,1,4,0,0,2,375,375,375,375
Marin,57,2023-01-16,125,125,125,0,2136,2149,2148,1,20,0,0,1,317,317,317,317
Mariposa,57,2023-01-16,11,11,11,0,95,96,95,1,0,0,0,0,31,31,31,31
Mendocino,57,2023-01-16,25,25,25,0,499,502,501,1,6,0,0,0,142,142,142,142
Merced,57,2023-01-16,120,120,120,0,1682,1693,1692,1,12,3,3,5,901,901,898,898
Modoc,57,2023-01-16,2,2,2,0,9,10,9,1,0,0,0,0,9,9,9,9
Mono,57,2023-01-16,6,6,6,0,68,69,68,1,0,0,0,0,8,8,8,8
Monterey,57,2023-01-16,112,112,112,0,2602,2619,2618,1,20,3,3,2,795,795,792,792
Napa,57,2023-01-16,63,63,63,0,1509,1520,1519,1,5,0,0,0,161,161,161,161
Nevada,57,2023-01-16,25,25,25,0,565,569,568,1,4,0,0,0,136,136,136,136
Orange,57,2023-01-16,1455,1463,1463,0,24148,24295,24294,1,245,39,39,32,7906,7906,7867,7867
Placer,57,2023-01-16,163,163,163,0,2638,2654,2653,1,68,0,0,6,678,678,678,678
Plumas,57,2023-01-16,2,2,2,0,73,74,73,1,1,0,0,0,14,14,14,14
Riverside,57,2023-01-16,1217,1224,1224,0,17157,17260,17259,1,169,15,15,36,6785,6785,6770,6770
Sacramento,57,2023-01-16,569,572,572,0,12428,12504,12503,1,149,19,19,23,3501,3501,3482,3482
San Benito,57,2023-01-16,28,28,28,0,468,471,470,1,0,1,1,0,110,110,109,109
San Bernardino,57,2023-01-16,993,1000,1000,0,16754,16858,16857,1,148,2,2,35,8132,8132,8130,8130
San Diego,57,2023-01-16,2064,2076,2076,0,28610,28783,28782,1,327,15,15,39,5759,5759,5744,5744
San Francisco,57,2023-01-16,439,439,439,0,10151,10213,10212,1,75,2,2,12,1162,1162,1160,1160
San Joaquin,57,2023-01-16,356,356,356,0,8775,8829,8828,1,42,8,8,11,2414,2414,2406,2406
San Luis Obispo,57,2023-01-16,108,108,108,0,1777,1790,1789,1,12,2,2,3,553,553,551,551
San Mateo,57,2023-01-16,395,395,395,0,7743,7790,7789,1,37,0,0,3,742,742,742,742
Santa Barbara,57,2023-01-16,242,242,242,0,3919,3944,3943,1,34,2,2,0,755,755,753,753
Santa Clara,57,2023-01-16,1102,1109,1109,0,24071,24215,24214,1,106,15,15,16,2676,2676,2661,2661
Santa Cruz,57,2023-01-16,171,171,171,0,6497,6536,6535,1,23,0,0,1,276,276,276,276
Shasta,57,2023-01-16,40,40,40,0,691,696,695,1,13,2,2,2,599,599,597,597
Siskiyou,57,2023-01-16,6,6,6,0,208,209,208,1,0,0,0,0,95,95,95,95
Solano,57,2023-01-16,222,222,222,0,3710,3734,3733,1,49,0,0,6,474,474,474,474
Sonoma,57,2023-01-16,189,189,189,0,3769,3794,3793,1,26,5,5,2,551,551,546,546
Stanislaus,57,2023-01-16,205,205,205,0,4244,4271,4270,1,72,3,3,3,1836,1836,1833,1833
Sutter,57,2023-01-16,47,47,47,0,714,719,718,1,0,0,0,0,234,234,234,234
Tehama,57,2023-01-16,16,16,16,0,367,368,367,1,1,0,0,0,230,230,230,230
Trinity,57,2023-01-16,3,3,3,0,23,24,23,1,0,0,0,0,22,22,22,22
Tulare,57,2023-01-16,263,263,263,0,4115,4142,4141,1,45,3,3,2,1572,1572,1569,1569
Tuolumne,57,2023-01-16,44,44,44,0,548,552,551,1,1,2,2,0,210,210,208,208
Ventura,57,2023-01-16,413,413,413,0,7843,7891,7890,1,53,4,4,12,1657,1657,1653,1653
Yolo,57,2023-01-16,74,74,74,0,1251,1260,1259,1,2,2,2,0,439,439,437,437
Yuba,57,2023-01-16,38,38,38,0,595,599,598,1,9,0,0,2,122,122,122,122
Alameda,58,2023-01-23,743,749,749,0,21198,21349,21348,1,100,11,11,9,2181,2181,2170,2170
Amador,58,2023-01-23,34,34,34,0,590,595,594,1,1,1,1,0,98,98,97,97
Butte,58,2023-01-23,43,43,43,0,1081,1090,1089,1,13,1,1,0,486,486,485,485
Calaveras,58,2023-01-23,15,15,15,0,279,280,279,1,0,0,0,0,139,139,139,139
Colusa,58,2023-01-23,10,10,10,0,142,144,143,1,0,0,0,0,22,22,22,22
Contra Costa,58,2023-01-23,516,520,520,0,13305,13400,13399,1,61,6,6,6,1540,1540,1534,1534
Del Norte,58,2023-01-23,22,22,22,0,359,360,359,1,1,0,0,0,58,58,58,58
El Dorado,58,2023-01-23,40,40,40,0,1082,1091,1090,1,2,0,0,0,242,242,242,242
Fresno,58,2023-01-23,441,443,443,0,10085,10160,10159,1,117,5,5,19,2983,2983,2978,2978
Glenn,58,2023-01-23,3,3,3,0,153,155,154,1,0,0,0,0,53,53,53,53
Humboldt,58,2023-01-23,34,34,34,0,554,560,559,1,9,1,1,4,169,169,168,168
Imperial,58,2023-01-23,85,85,85,0,2256,2272,2271,1,10,0,0,1,977,977,977,977
Inyo,58,2023-01-23,6,6,6,0,165,166,165,1,0,1,1,0,63,63,62,62
Kern,58,2023-01-23,313,313,313,0,9390,9458,9457,1,34,5,5,8,2477,2477,2472,2472
Kings,58,2023-01-23,107,107,107,0,1985,2001,2000,1,6,0,0,0,481,481,481,481
Lake,58,2023-01-23,28,28,28,0,579,585,584,1,2,2,2,2,157,157,155,155
Lassen,58,2023-01-23,5,5,5,0,465,469,468,1,0,0,0,0,64,64,64,64
Los Angeles,58,2023-01-23,5600,5640,5640,0,169725,170930,170928,2,665,109,114,96,35207,35224,35098,35110
Madera,58,2023-01-23,51,51,51,0,1433,1444,1443,1,6,0,0,2,375,375,375,375
Marin,58,2023-01-23,108,108,108,0,2350,2369,2368,1,18,0,0,3,317,317,317,317
Mariposa,58,2023-01-23,7,7,7,0,103,104,103,1,0,0,0,0,31,31,31,31
Mendocino,58,2023-01-23,21,21,21,0,546,551,550,1,4,0,0,0,142,142,142,142
Merced,58,2023-01-23,126,126,126,0,1923,1937,1936,1,9,2,2,3,903,903,901,901
Modoc,58,2023-01-23,1,1,1,0,11,12,11,1,1,0,0,0,9,9,9,9
Mono,58,2023-01-23,5,5,5,0,73,74,73,1,0,0,0,0,8,8,8,8
Monterey,58,2023-01-23,107,107,107,0,2755,2775,2774,1,15,1,1,2,796,796,795,795
Napa,58,2023-01-23,77,77,77,0,1505,1517,1516,1,4,0,0,1,161,161,161,161
Nevada,58,2023-01-23,20,20,20,0,600,606,605,1,3,0,0,2,136,136,136,136
Orange,58,2023-01-23,1160,1167,1167,0,24078,24249,24248,1,177,26,26,27,7932,7932,7906,7906
Placer,58,2023-01-23,139,139,139,0,2730,2751,2750,1,42,1,1,7,679,679,678,678
Plumas,58,2023-01-23,5,5,5,0,91,92,91,1,1,0,0,0,14,14,14,14
Riverside,58,2023-01-23,1013,1020,1020,0,16222,16337,16336,1,111,14,14,22,6799,6799,6785,6785
Sacramento,58,2023-01-23,594,598,598,0,13719,13818,13817,1,134,9,9,21,3510,3510,3501,3501
San Benito,58,2023-01-23,27,27,27,0,564,570,569,1,0,0,0,0,110,110,110,110
San Bernardino,58,2023-01-23,1030,1037,1037,0,19082,19218,19217,1,127,1,1,33,8133,8133,8132,8132
San Diego,58,2023-01-23,2028,2042,2042,0,33206,33443,33442,1,236,11,11,37,5770,5770,5759,5759
San Francisco,58,2023-01-23,449,452,452,0,11282,11361,11360,1,58,6,6,5,1168,1168,1162,1162
San Joaquin,58,2023-01-23,242,242,242,0,8403,8464,8463,1,29,3,3,8,2417,2417,2414,2414
San Luis Obispo,58,2023-01-23,110,110,110,0,1951,1966,1965,1,8,3,3,2,556,556,553,553
San Mateo,58,2023-01-23,346,347,347,0,8730,8793,8792,1,21,0,0,0,742,742,742,742
Santa Barbara,58,2023-01-23,209,209,209,0,4241,4271,4270,1,28,2,2,4,757,757,755,755
Santa Clara,58,2023-01-23,1019,1026,1026,0,24679,24854,24853,1,119,5,5,23,2681,2681,2676,2676
Santa Cruz,58,2023-01-23,122,122,122,0,9483,9551,9550,1,16,0,0,0,276,276,276,276
Shasta,58,2023-01-23,23,23,23,0,755,761,760,1,6,1,1,1,600,600,599,599
Siskiyou,58,2023-01-23,6,6,6,0,178,179,178,1,0,0,0,0,95,95,95,95
Solano,58,2023-01-23,228,228,228,0,4216,4248,4247,1,33,0,0,2,474,474,474,474
Sonoma,58,2023-01-23,198,198,198,0,4276,4308,4307,1,26,0,0,4,551,551,551,551
Stanislaus,58,2023-01-23,180,180,180,0,4287,4320,4319,1,57,2,2,6,1838,1838,1836,1836
Sutter,58,2023-01-23,41,41,41,0,778,784,783,1,0,1,1,0,235,235,234,234
Tehama,58,2023-01-23,15,15,15,0,339,341,340,1,1,0,0,0,230,230,230,230
Trinity,58,2023-01-23,4,4,4,0,31,32,31,1,0,1,1,0,23,23,22,22
Tulare,58,2023-01-23,221,221,221,0,4167,4197,4196,1,27,2,2,5,1574,1574,1572,1572
Tuolumne,58,2023-01-23,36,36,36,0,484,488,487,1,0,1,1,1,211,211,210,210
Ventura,58,2023-01-23,368,368,368,0,8586,8647,8646,1,57,5,5,3,1662,1662,1657,1657
Yolo,58,2023-01-23,85,85,85,0,1371,1381,1380,1,2,3,3,0,442,442,439,439
Yuba,58,2023-01-23,30,30,30,0,725,732,731,1,3,0,0,0,122,122,122,122
Alameda,59,2023-01-30,846,853,853,0,18454,18607,18606,1,85,4,4,4,2185,2185,2181,2181
Amador,59,2023-01-30,24,24,24,0,620,628,627,1,3,0,0,0,98,98,98,98
Butte,59,2023-01-30,55,55,55,0,1124,1135,1134,1,13,2,2,2,488,488,486,486
Calaveras,59,2023-01-30,16,16,16,0,318,320,319,1,0,1,1,0,140,140,139,139
Colusa,59,2023-01-30,7,7,7,0,169,171,170,1,0,0,0,0,22,22,22,22
Contra Costa,59,2023-01-30,662,669,669,0,12411,12514,12513,1,38,9,9,6,1549,1549,1540,1540
Del Norte,59,2023-01-30,31,31,31,0,382,386,385,1,1,1,1,0,59,59,58,58
El Dorado,59,2023-01-30,61,61,61,0,1190,1202,1201,1,4,2,2,0,244,244,242,242
Fresno,59,2023-01-30,447,452,452,0,9857,9940,9939,1,117,8,8,10,2991,2991,2983,2983
Glenn,59,2023-01-30,2,2,2,0,155,157,156,1,0,0,0,0,53,53,53,53
Humboldt,59,2023-01-30,29,29,29,0,565,571,570,1,6,0,0,1,169,169,169,169
Imperial,59,2023-01-30,103,103,103,0,2067,2085,2084,1,7,1,1,0,978,978,977,977
Inyo,59,2023-01-30,10,10,10,0,202,203,202,1,1,0,0,0,63,63,63,63
Kern,59,2023-01-30,298,299,299,0,8957,9032,9031,1,36,1,1,8,2478,2478,2477,2477
Kings,59,2023-01-30,136,136,136,0,2211,2229,2228,1,7,1,1,1,482,482,481,481
Lake,59,2023-01-30,26,26,26,0,555,561,560,1,5,2,2,1,159,159,157,157
Lassen,59,2023-01-30,4,4,4,0,490,495,494,1,0,0,0,0,64,64,64,64
Los Angeles,59,2023-01-30,5791,5839,5839,0,151701,152961,152959,2,633,107,114,72,35314,35338,35207,35224
Madera,59,2023-01-30,48,48,48,0,1479,1491,1490,1,7,0,0,0,375,375,375,375
Marin,59,2023-01-30,104,104,104,0,2159,2178,2177,1,19,0,0,1,317,317,317,317
Mariposa,59,2023-01-30,5,5,5,0,105,106,105,1,0,0,0,0,31,31,31,31
Mendocino,59,2023-01-30,24,24,24,0,518,524,523,1,2,0,0,1,142,142,142,142
Merced,59,2023-01-30,135,135,135,0,1798,1813,1812,1,11,0,0,3,903,903,903,903
Modoc,59,2023-01-30,0,0,0,0,8,9,8,1,1,0,0,0,9,9,9,9
Mono,59,2023-01-30,2,2,2,0,67,68,67,1,0,0,0,0,8,8,8,8
Monterey,59,2023-01-30,155,155,155,0,2846,2872,2871,1,8,1,1,1,797,797,796,796
Napa,59,2023-01-30,73,73,73,0,1370,1384,1383,1,4,0,0,0,161,161,161,161
Nevada,59,2023-01-30,29,29,29,0,591,597,596,1,2,0,0,1,136,136,136,136
Orange,59,2023-01-30,1192,1203,1203,0,22723,22912,22911,1,136,13,13,25,7945,7945,7932,7932
Placer,59,2023-01-30,170,170,170,0,2707,2731,2730,1,49,2,2,3,681,681,679,679
Plumas,59,2023-01-30,3,3,3,0,75,76,75,1,0,0,0,0,14,14,14,14
Riverside,59,2023-01-30,1072,1080,1080,0,15989,16123,16122,1,84,5,5,17,6804,6804,6799,6799
Sacramento,59,2023-01-30,664,671,671,0,13387,13498,13497,1,117,8,8,13,3518,3518,3510,3510
San Benito,59,2023-01-30,32,32,32,0,563,570,569,1,0,0,0,0,110,110,110,110
San Bernardino,59,2023-01-30,931,939,939,0,17213,17356,17355,1,140,0,0,19,8133,8133,8133,8133
San Diego,59,2023-01-30,1860,1876,1876,0,30118,30370,30369,1,202,11,11,32,5781,5781,5770,5770
San Francisco,59,2023-01-30,473,478,478,0,10899,10989,10988,1,51,2,2,4,1170,1170,1168,1168
San Joaquin,59,2023-01-30,308,309,309,0,7657,7721,7720,1,22,3,3,5,2420,2420,2417,2417
San Luis Obispo,59,2023-01-30,140,140,140,0,1912,1929,1928,1,13,5,5,0,561,561,556,556
San Mateo,59,2023-01-30,429,433,433,0,8643,8716,8715,1,25,0,0,3,742,742,742,742
Santa Barbara,59,2023-01-30,227,227,227,0,4266,4301,4300,1,25,1,1,2,758,758,757,757
Santa Clara,59,2023-01-30,1180,1189,1189,0,23637,23834,23833,1,132,5,5,14,2686,2686,2681,2681
Santa Cruz,59,2023-01-30,133,133,133,0,9330,9409,9408,1,12,0,0,0,276,276,276,276
Shasta,59,2023-01-30,18,18,18,0,665,671,670,1,7,0,0,0,600,600,600,600
Siskiyou,59,2023-01-30,6,6,6,0,195,196,195,1,0,0,0,0,95,95,95,95
Solano,59,2023-01-30,235,235,235,0,4171,4206,4205,1,40,0,0,1,474,474,474,474
Sonoma,59,2023-01-30,156,156,156,0,3596,3626,3625,1,23,1,1,1,552,552,551,551
Stanislaus,59,2023-01-30,231,231,231,0,4127,4164,4163,1,43,2,2,3,1840,1840,1838,1838
Sutter,59,2023-01-30,36,36,36,0,611,617,616,1,0,1,1,0,236,236,235,235
Tehama,59,2023-01-30,8,8,8,0,317,320,319,1,1,1,1,0,231,231,230,230
Trinity,59,2023-01-30,7,7,7,0,26,27,26,1,0,0,0,0,23,23,23,23
Tulare,59,2023-01-30,262,262,262,0,4019,4053,4052,1,28,3,3,3,1577,1577,1574,1574
Tuolumne,59,2023-01-30,45,45,45,0,600,607,606,1,3,0,0,0,211,211,211,211
Ventura,59,2023-01-30,363,366,366,0,8126,8193,8192,1,46,7,7,8,1669,1669,1662,1662
Yolo,59,2023-01-30,86,86,86,0,1297,1309,1308,1,2,1,1,0,443,443,442,442
Yuba,59,2023-01-30,31,31,31,0,656,664,663,1,3,0,0,1,122,122,122,122
Alameda,60,2023-02-06,1104,1114,1114,0,18252,18431,18430,1,86,5,5,9,2190,2190,2185,2185
Amador,60,2023-02-06,29,29,29,0,637,646,645,1,1,0,0,0,98,98,98,98
Butte,60,2023-02-06,83,83,83,0,1208,1221,1220,1,20,0,0,1,488,488,488,488
Calaveras,60,2023-02-06,14,14,14,0,323,325,324,1,0,0,0,0,140,140,140,140
Colusa,60,2023-02-06,6,6,6,0,184,186,185,1,0,0,0,0,22,22,22,22
Contra Costa,60,2023-02-06,714,721,721,0,11856,11971,11970,1,50,2,2,9,1551,1551,1549,1549
Del Norte,60,2023-02-06,58,58,58,0,394,398,397,1,0,0,0,0,59,59,59,59
El Dorado,60,2023-02-06,59,59,59,0,1133,1146,1145,1,3,0,0,0,244,244,244,244
Fresno,60,2023-02-06,510,517,517,0,9027,9115,9114,1,89,4,4,15,2995,2995,2991,2991
Glenn,60,2023-02-06,10,10,10,0,170,172,171,1,0,0,0,0,53,53,53,53
Humboldt,60,2023-02-06,56,56,56,0,566,574,573,1,6,1,1,0,170,170,169,169
Imperial,60,2023-02-06,122,122,122,0,2097,2119,2118,1,7,1,1,0,979,979,978,978
Inyo,60,2023-02-06,9,9,9,0,210,211,210,1,0,0,0,0,63,63,63,63
Kern,60,2023-02-06,328,330,330,0,8598,8682,8681,1,34,2,2,4,2480,2480,2478,2478
Kings,60,2023-02-06,126,126,126,0,2056,2077,2076,1,3,0,0,1,482,482,482,482
Lake,60,2023-02-06,25,25,25,0,561,568,567,1,5,1,1,0,160,160,159,159
Lassen,60,2023-02-06,6,6,6,0,445,448,447,1,0,0,0,0,64,64,64,64
Los Angeles,60,2023-02-06,5895,5953,5953,0,141911,143289,143287,2,609,89,96,83,35403,35434,35314,35338
Madera,60,2023-02-06,55,55,55,0,1308,1322,1321,1,4,1,1,0,376,376,375,375
Marin,60,2023-02-06,144,144,144,0,2132,2154,2153,1,13,0,0,3,317,317,317,317
Mariposa,60,2023-02-06,2,2,2,0,105,106,105,1,0,0,0,0,31,31,31,31
Mendocino,60,2023-02-06,31,31,31,0,513,519,518,1,4,0,0,2,142,142,142,142
Merced,60,2023-02-06,166,166,166,0,1885,1904,1903,1,12,0,0,0,903,903,903,903
Modoc,60,2023-02-06,2,2,2,0,6,7,6,1,0,0,0,0,9,9,9,9
Mono,60,2023-02-06,4,4,4,0,92,93,92,1,0,0,0,0,8,8,8,8
Monterey,60,2023-02-06,227,227,227,0,2938,2968,2967,1,22,3,3,1,800,800,797,797
Napa,60,2023-02-06,110,110,110,0,1404,1419,1418,1,4,0,0,3,161,161,161,161
Nevada,60,2023-02-06,32,32,32,0,572,579,578,1,4,0,0,0,136,136,136,136
Orange,60,2023-02-06,1293,1306,1306,0,22312,22529,22528,1,154,23,23,20,7968,7968,7945,7945
Placer,60,2023-02-06,164,164,164,0,2656,2683,2682,1,41,0,0,4,681,681,681,681
Plumas,60,2023-02-06,2,2,2,0,72,73,72,1,0,1,1,0,15,15,14,14
Riverside,60,2023-02-06,1127,1138,1138,0,15528,15680,15679,1,89,5,5,14,6809,6809,6804,6804
Sacramento,60,2023-02-06,731,739,739,0,13188,13317,13316,1,96,5,5,19,3523,3523,3518,3518
San Benito,60,2023-02-06,50,50,50,0,538,545,544,1,1,0,0,0,110,110,110,110
San Bernardino,60,2023-02-06,1081,1090,1090,0,17430,17599,17598,1,152,0,0,17,8133,8133,8133,8133
San Diego,60,2023-02-06,1869,1887,1887,0,30063,30359,30358,1,230,8,8,23,5789,5789,5781,5781
San Francisco,60,2023-02-06,575,581,581,0,10536,10639,10638,1,58,3,3,2,1173,1173,1170,1170
San Joaquin,60,2023-02-06,434,438,438,0,6930,6999,6998,1,32,1,1,3,2421,2421,2420,2420
San Luis Obispo,60,2023-02-06,150,150,150,0,1906,1926,1925,1,7,1,1,0,562,562,561,561
San Mateo,60,2023-02-06,528,535,535,0,8193,8272,8271,1,42,0,0,1,742,742,742,742
Santa Barbara,60,2023-02-06,238,238,238,0,4365,4409,4408,1,21,1,1,0,759,759,758,758
Santa Clara,60,2023-02-06,1302,1315,1315,0,23466,23696,23695,1,123,9,9,23,2695,2695,2686,2686
Santa Cruz,60,2023-02-06,232,233,233,0,10396,10498,10497,1,11,0,0,0,276,276,276,276
Shasta,60,2023-02-06,24,24,24,0,660,667,666,1,9,0,0,0,600,600,600,600
Siskiyou,60,2023-02-06,11,11,11,0,221,222,221,1,0,0,0,0,95,95,95,95
Solano,60,2023-02-06,284,285,285,0,3852,3891,3890,1,41,0,0,5,474,474,474,474
Sonoma,60,2023-02-06,265,265,265,0,3566,3601,3600,1,17,3,3,1,555,555,552,552
Stanislaus,60,2023-02-06,277,278,278,0,3926,3966,3965,1,54,1,1,6,1841,1841,1840,1840
Sutter,60,2023-02-06,50,50,50,0,706,715,714,1,0,0,0,0,236,236,236,236
Tehama,60,2023-02-06,17,17,17,0,344,347,346,1,2,0,0,0,231,231,231,231
Trinity,60,2023-02-06,1,1,1,0,19,20,19,1,0,0,0,0,23,23,23,23
Tulare,60,2023-02-06,272,273,273,0,4388,4433,4432,1,28,2,2,3,1579,1579,1577,1577
Tuolumne,60,2023-02-06,48,48,48,0,555,563,562,1,1,0,0,0,211,211,211,211
Ventura,60,2023-02-06,326,328,328,0,6929,6999,6998,1,39,1,1,5,1670,1670,1669,1669
Yolo,60,2023-02-06,79,79,79,0,1254,1268,1267,1,4,1,1,2,444,444,443,443
Yuba,60,2023-02-06,22,22,22,0,623,631,630,1,3,0,0,1,122,122,122,122
Alameda,61,2023-02-13,1115,1127,1127,0,17632,17830,17829,1,90,2,2,8,2192,2192,2190,2190
Amador,61,2023-02-13,19,19,19,0,497,505,504,1,0,0,0,0,98,98,98,98
Butte,61,2023-02-13,86,86,86,0,1252,1266,1265,1,25,1,1,2,489,489,488,488
Calaveras,61,2023-02-13,14,14,14,0,295,298,297,1,0,0,0,0,140,140,140,140
Colusa,61,2023-02-13,8,8,8,0,136,138,137,1,0,0,0,0,22,22,22,22
Contra Costa,61,2023-02-13,695,702,702,0,11538,11668,11667,1,44,2,2,10,1553,1553,1551,1551
Del Norte,61,2023-02-13,19,19,19,0,299,303,302,1,2,0,0,0,59,59,59,59
El Dorado,61,2023-02-13,65,65,65,0,1101,1115,1114,1,2,0,0,0,244,244,244,244
Fresno,61,2023-02-13,470,476,476,0,8725,8824,8823,1,106,4,4,7,2999,2999,2995,2995
Glenn,61,2023-02-13,11,11,11,0,175,177,176,1,5,0,0,0,53,53,53,53
Humboldt,61,2023-02-13,37,37,37,0,578,585,584,1,7,0,0,1,170,170,170,170
Imperial,61,2023-02-13,142,142,142,0,1856,1877,1876,1,3,1,1,5,980,980,979,979
Inyo,61,2023-02-13,6,6,6,0,200,202,201,1,0,0,0,0,63,63,63,63
Kern,61,2023-02-13,328,332,332,0,8265,8357,8356,1,37,2,2,6,2482,2482,2480,2480
Kings,61,2023-02-13,88,88,88,0,1900,1922,1921,1,6,1,1,0,483,483,482,482
Lake,61,2023-02-13,20,20,20,0,567,574,573,1,2,0,0,0,160,160,160,160
Lassen,61,2023-02-13,5,5,5,0,361,366,365,1,0,0,0,0,64,64,64,64
Los Angeles,61,2023-02-13,5907,5972,5972,0,130222,131676,131675,1,613,75,82,67,35478,35516,35403,35434
Madera,61,2023-02-13,60,60,60,0,1238,1253,1252,1,7,0,0,2,376,376,376,376
Marin,61,2023-02-13,143,143,143,0,1931,1953,1952,1,19,0,0,3,317,317,317,317
Mariposa,61,2023-02-13,3,3,3,0,102,103,102,1,0,0,0,0,31,31,31,31
Mendocino,61,2023-02-13,28,28,28,0,538,545,544,1,3,2,2,1,144,144,142,142
Merced,61,2023-02-13,167,167,167,0,1856,1878,1877,1,8,0,0,0,903,903,903,903
Modoc,61,2023-02-13,0,0,0,0,2,3,2,1,0,0,0,0,9,9,9,9
Mono,61,2023-02-13,1,1,1,0,66,67,66,1,0,0,0,0,8,8,8,8
Monterey,61,2023-02-13,223,223,223,0,2490,2517,2516,1,25,3,3,1,803,803,800,800
Napa,61,2023-02-13,92,92,92,0,1364,1379,1378,1,4,1,1,0,162,162,161,161
Nevada,61,2023-02-13,37,37,37,0,596,604,603,1,4,0,0,1,136,136,136,136
Orange,61,2023-02-13,1377,1394,1394,0,20600,20830,20829,1,161,11,11,21,7979,7979,7968,7968
Placer,61,2023-02-13,161,161,161,0,2613,2642,2641,1,35,0,0,6,681,681,681,681
Plumas,61,2023-02-13,3,3,3,0,80,81,80,1,1,0,0,0,15,15,15,15
Riverside,61,2023-02-13,1093,1105,1105,0,16091,16269,16268,1,93,7,7,16,6816,6816,6809,6809
Sacramento,61,2023-02-13,822,831,831,0,13050,13195,13194,1,113,5,5,19,3528,3528,3523,3523
San Benito,61,2023-02-13,43,43,43,0,566,574,573,1,1,0,0,0,110,110,110,110
San Bernardino,61,2023-02-13,1020,1031,1031,0,16936,17125,17124,1,134,0,0,18,8133,8133,8133,8133
San Diego,61,2023-02-13,2021,2043,2043,0,29199,29526,29525,1,218,4,4,25,5793,5793,5789,5789
San Francisco,61,2023-02-13,597,604,604,0,10689,10808,10807,1,59,3,3,5,1176,1176,1173,1173
San Joaquin,61,2023-02-13,456,462,462,0,6971,7051,7050,1,28,1,1,3,2422,2422,2421,2421
San Luis Obispo,61,2023-02-13,133,133,133,0,1683,1702,1701,1,4,1,1,4,563,563,562,562
San Mateo,61,2023-02-13,522,529,529,0,8197,8290,8289,1,29,0,0,5,742,742,742,742
Santa Barbara,61,2023-02-13,188,188,188,0,3937,3982,3981,1,16,1,1,5,760,760,759,759
Santa Clara,61,2023-02-13,1372,1387,1387,0,23133,23393,23392,1,114,9,9,25,2704,2704,2695,2695
Santa Cruz,61,2023-02-13,206,207,207,0,9623,9732,9731,1,19,0,0,0,276,276,276,276
Shasta,61,2023-02-13,33,33,33,0,674,681,680,1,7,0,0,0,600,600,600,600
Siskiyou,61,2023-02-13,11,11,11,0,199,200,199,1,0,0,0,0,95,95,95,95
Solano,61,2023-02-13,258,260,260,0,3774,3817,3816,1,28,0,0,3,474,474,474,474
Sonoma,61,2023-02-13,235,236,236,0,3422,3461,3460,1,32,1,1,1,556,556,555,555
Stanislaus,61,2023-02-13,268,270,270,0,3816,3860,3859,1,47,1,1,9,1842,1842,1841,1841
Sutter,61,2023-02-13,46,46,46,0,658,667,666,1,0,1,1,0,237,237,236,236
Tehama,61,2023-02-13,16,16,16,0,346,352,351,1,1,2,2,0,233,233,231,231
Trinity,61,2023-02-13,1,1,1,0,26,27,26,1,0,0,0,0,23,23,23,23
Tulare,61,2023-02-13,247,248,248,0,4114,4162,4161,1,29,2,2,1,1581,1581,1579,1579
Tuolumne,61,2023-02-13,37,37,37,0,508,515,514,1,2,0,0,0,211,211,211,211
Ventura,61,2023-02-13,316,319,319,0,6664,6739,6738,1,29,4,4,6,1674,1674,1670,1670
Yolo,61,2023-02-13,76,76,76,0,1247,1261,1260,1,3,0,0,1,444,444,444,444
Yuba,61,2023-02-13,30,30,30,0,643,651,650,1,8,0,0,0,122,122,122,122
Alameda,62,2023-02-20,1017,1030,1030,0,15443,15637,15636,1,79,3,3,5,2195,2195,2192,2192
Amador,62,2023-02-20,25,25,25,0,496,504,503,1,1,0,0,1,98,98,98,98
Butte,62,2023-02-20,43,43,43,0,1051,1065,1064,1,7,2,2,1,491,491,489,489
Calaveras,62,2023-02-20,17,17,17,0,289,295,294,1,0,0,0,1,140,140,140,140
Colusa,62,2023-02-20,12,12,12,0,92,93,92,1,0,0,0,0,22,22,22,22
Contra Costa,62,2023-02-20,667,675,675,0,10000,10127,10126,1,57,5,5,6,1558,1558,1553,1553
Del Norte,62,2023-02-20,11,11,11,0,258,261,260,1,2,0,0,0,59,59,59,59
El Dorado,62,2023-02-20,51,51,51,0,976,989,988,1,2,1,1,1,245,245,244,244
Fresno,62,2023-02-20,455,462,462,0,8217,8320,8319,1,84,5,5,17,3004,3004,2999,2999
Glenn,62,2023-02-20,5,5,5,0,146,148,147,1,5,0,0,0,53,53,53,53
Humboldt,62,2023-02-20,33,33,33,0,576,584,583,1,7,0,0,1,170,170,170,170
Imperial,62,2023-02-20,120,120,120,0,1781,1805,1804,1,8,0,0,0,980,980,980,980
Inyo,62,2023-02-20,6,6,6,0,162,164,163,1,0,0,0,0,63,63,63,63
Kern,62,2023-02-20,402,409,409,0,7473,7568,7567,1,29,3,3,5,2485,2485,2482,2482
Kings,62,2023-02-20,77,77,77,0,1639,1661,1660,1,5,1,1,0,484,484,483,483
Lake,62,2023-02-20,19,19,19,0,483,491,490,1,2,1,1,1,161,161,160,160
Lassen,62,2023-02-20,2,2,2,0,327,333,332,1,0,0,0,0,64,64,64,64
Los Angeles,62,2023-02-20,5641,5711,5711,0,118366,119851,119850,1,601,77,84,76,35555,35600,35478,35516
Madera,62,2023-02-20,61,61,61,0,1089,1104,1103,1,3,0,0,2,376,376,376,376
Marin,62,2023-02-20,153,153,153,0,1855,1880,1879,1,13,0,0,2,317,317,317,317
Mariposa,62,2023-02-20,6,6,6,0,121,122,121,1,0,0,0,0,31,31,31,31
Mendocino,62,2023-02-20,25,25,25,0,489,496,495,1,3,0,0,0,144,144,144,144
Merced,62,2023-02-20,122,122,122,0,1753,1776,1775,1,19,0,0,1,903,903,903,903
Modoc,62,2023-02-20,1,1,1,0,15,16,15,1,0,0,0,0,9,9,9,9
Mono,62,2023-02-20,2,2,2,0,67,68,67,1,0,0,0,0,8,8,8,8
Monterey,62,2023-02-20,157,157,157,0,2319,2348,2347,1,22,0,0,0,803,803,803,803
Napa,62,2023-02-20,78,78,78,0,1085,1099,1098,1,3,1,1,1,163,163,162,162
Nevada,62,2023-02-20,28,28,28,0,611,621,620,1,7,1,1,1,137,137,136,136
Orange,62,2023-02-20,1324,1341,1341,0,19407,19650,19649,1,158,18,19,21,7997,7998,7979,7979
Placer,62,2023-02-20,161,161,161,0,2422,2453,2452,1,48,1,1,3,682,682,681,681
Plumas,62,2023-02-20,8,8,8,0,75,76,75,1,0,0,0,0,15,15,15,15
Riverside,62,2023-02-20,990,1002,1002,0,15213,15404,15403,1,92,7,7,9,6823,6823,6816,6816
Sacramento,62,2023-02-20,729,737,737,0,11556,11703,11702,1,103,11,11,16,3539,3539,3528,3528
San Benito,62,2023-02-20,28,28,28,0,476,484,483,1,1,2,2,0,112,112,110,110
San Bernardino,62,2023-02-20,901,912,912,0,15186,15379,15378,1,117,0,0,27,8133,8133,8133,8133
San Diego,62,2023-02-20,1762,1784,1784,0,25337,25655,25654,1,201,7,7,25,5800,5800,5793,5793
San Francisco,62,2023-02-20,592,599,599,0,9931,10056,10055,1,79,0,0,7,1176,1176,1176,1176
San Joaquin,62,2023-02-20,412,419,419,0,7367,7461,7460,1,30,1,1,7,2423,2423,2422,2422
San Luis Obispo,62,2023-02-20,96,96,96,0,1435,1454,1453,1,11,0,0,0,563,563,563,563
San Mateo,62,2023-02-20,464,471,471,0,7428,7523,7522,1,44,0,0,3,742,742,742,742
Santa Barbara,62,2023-02-20,206,206,206,0,3629,3676,3675,1,18,0,0,5,760,760,760,760
Santa Clara,62,2023-02-20,1213,1228,1228,0,19502,19747,19746,1,111,11,11,26,2715,2715,2704,2704
Santa Cruz,62,2023-02-20,136,136,136,0,6262,6340,6339,1,20,0,0,2,276,276,276,276
Shasta,62,2023-02-20,18,18,18,0,728,739,738,1,2,0,0,0,600,600,600,600
Siskiyou,62,2023-02-20,14,14,14,0,198,199,198,1,0,0,0,0,95,95,95,95
Solano,62,2023-02-20,230,232,232,0,3263,3306,3305,1,26,0,0,3,474,474,474,474
Sonoma,62,2023-02-20,260,262,262,0,3199,3240,3239,1,24,1,1,4,557,557,556,556
Stanislaus,62,2023-02-20,264,266,266,0,3643,3691,3690,1,55,0,0,4,1842,1842,1842,1842
Sutter,62,2023-02-20,38,38,38,0,539,547,546,1,0,1,1,0,238,238,237,237
Tehama,62,2023-02-20,13,13,13,0,279,283,282,1,0,0,0,0,233,233,233,233
Trinity,62,2023-02-20,0,0,0,0,30,31,30,1,0,0,0,0,23,23,23,23
Tulare,62,2023-02-20,215,216,216,0,3794,3843,3842,1,23,0,0,0,1581,1581,1581,1581
Tuolumne,62,2023-02-20,32,32,32,0,446,453,452,1,0,0,0,0,211,211,211,211
Ventura,62,2023-02-20,283,287,287,0,5625,5695,5694,1,30,4,4,7,1678,1678,1674,1674
Yolo,62,2023-02-20,87,87,87,0,1280,1297,1296,1,1,2,2,1,446,446,444,444
Yuba,62,2023-02-20,25,25,25,0,507,515,514,1,6,0,0,0,122,122,122,122
Alameda,63,2023-02-27,1116,1131,1131,0,18629,18896,18895,1,96,7,7,9,2202,2202,2195,2195
Amador,63,2023-02-27,19,19,19,0,521,530,529,1,1,0,0,1,98,98,98,98
Butte,63,2023-02-27,52,52,52,0,944,958,957,1,8,1,1,1,492,492,491,491
Calaveras,63,2023-02-27,15,15,15,0,306,312,311,1,1,0,0,0,140,140,140,140
Colusa,63,2023-02-27,12,12,12,0,85,86,85,1,0,0,0,0,22,22,22,22
Contra Costa,63,2023-02-27,718,729,729,0,11446,11609,11608,1,63,3,3,11,1561,1561,1558,1558
Del Norte,63,2023-02-27,7,7,7,0,288,294,293,1,0,0,0,0,59,59,59,59
El Dorado,63,2023-02-27,61,61,61,0,1037,1052,1051,1,2,1,1,0,246,246,245,245
Fresno,63,2023-02-27,466,473,473,0,8990,9120,9119,1,93,2,2,7,3006,3006,3004,3004
Glenn,63,2023-02-27,3,3,3,0,143,145,144,1,1,0,0,0,53,53,53,53
Humboldt,63,2023-02-27,29,29,29,0,490,498,497,1,4,0,0,1,170,170,170,170
Imperial,63,2023-02-27,176,176,176,0,1832,1860,1859,1,13,0,0,0,980,980,980,980
Inyo,63,2023-02-27,4,4,4,0,156,158,157,1,0,0,0,0,63,63,63,63
Kern,63,2023-02-27,401,407,407,0,8253,8372,8371,1,42,3,3,7,2488,2488,2485,2485
Kings,63,2023-02-27,62,62,62,0,1687,1711,1710,1,4,1,1,0,485,485,484,484
Lake,63,2023-02-27,21,21,21,0,465,473,472,1,2,1,1,1,162,162,161,161
Lassen,63,2023-02-27,3,3,3,0,352,358,357,1,0,0,0,0,64,64,64,64
Los Angeles,63,2023-02-27,5349,5426,5426,0,134582,136505,136503,2,573,66,76,75,35621,35676,35555,35600
Madera,63,2023-02-27,62,62,62,0,1187,1205,1204,1,7,0,0,1,376,376,376,376
Marin,63,2023-02-27,145,145,145,0,1966,1995,1994,1,16,0,0,3,317,317,317,317
Mariposa,63,2023-02-27,7,7,7,0,97,98,97,1,0,0,0,0,31,31,31,31
Mendocino,63,2023-02-27,21,21,21,0,492,500,499,1,5,1,1,1,145,145,144,144
Merced,63,2023-02-27,124,124,124,0,1885,1913,1912,1,19,0,0,1,903,903,903,903
Modoc,63,2023-02-27,1,1,1,0,8,9,8,1,0,0,0,0,9,9,9,9
Mono,63,2023-02-27,5,5,5,0,52,53,52,1,0,0,0,0,8,8,8,8
Monterey,63,2023-02-27,182,182,182,0,2579,2617,2616,1,30,2,2,1,805,805,803,803
Napa,63,2023-02-27,79,79,79,0,1316,1336,1335,1,7,2,2,4,165,165,163,163
Nevada,63,2023-02-27,25,25,25,0,566,575,574,1,2,0,0,0,137,137,137,137
Orange,63,2023-02-27,1195,1213,1213,0,19613,19893,19892,1,161,18,21,21,8015,8019,7997,7998
Placer,63,2023-02-27,179,180,180,0,2567,2605,2604,1,44,0,0,7,682,682,682,682
Plumas,63,2023-02-27,3,3,3,0,88,89,88,1,0,0,0,0,15,15,15,15
Riverside,63,2023-02-27,913,924,924,0,15463,15684,15683,1,76,7,7,15,6830,6830,6823,6823
Sacramento,63,2023-02-27,928,941,941,0,12781,12964,12963,1,121,5,5,19,3544,3544,3539,3539
San Benito,63,2023-02-27,29,29,29,0,473,482,481,1,2,0,0,0,112,112,112,112
San Bernardino,63,2023-02-27,864,876,876,0,16328,16563,16562,1,111,0,0,24,8133,8133,8133,8133
San Diego,63,2023-02-27,1804,1830,1830,0,27530,27924,27923,1,210,5,5,21,5805,5805,5800,5800
San Francisco,63,2023-02-27,660,670,670,0,11614,11780,11779,1,76,6,6,8,1182,1182,1176,1176
San Joaquin,63,2023-02-27,415,422,422,0,7519,7628,7627,1,33,2,2,3,2425,2425,2423,2423
San Luis Obispo,63,2023-02-27,83,83,83,0,1670,1695,1694,1,11,2,2,0,565,565,563,563
San Mateo,63,2023-02-27,477,484,484,0,7460,7569,7568,1,43,0,0,4,742,742,742,742
Santa Barbara,63,2023-02-27,176,177,177,0,3561,3612,3611,1,18,2,2,8,762,762,760,760
Santa Clara,63,2023-02-27,1331,1350,1350,0,21571,21881,21880,1,126,8,8,26,2723,2723,2715,2715
Santa Cruz,63,2023-02-27,160,161,161,0,8755,8881,8880,1,7,0,0,1,276,276,276,276
Shasta,63,2023-02-27,37,37,37,0,656,668,667,1,9,0,0,1,600,600,600,600
Siskiyou,63,2023-02-27,11,11,11,0,235,238,237,1,0,0,0,0,95,95,95,95
Solano,63,2023-02-27,294,298,298,0,3679,3732,3731,1,30,0,0,8,474,474,474,474
Sonoma,63,2023-02-27,217,220,220,0,3410,3460,3459,1,33,1,1,5,558,558,557,557
Stanislaus,63,2023-02-27,243,245,245,0,3839,3896,3895,1,58,0,0,3,1842,1842,1842,1842
Sutter,63,2023-02-27,46,46,46,0,503,511,510,1,0,0,0,0,238,238,238,238
Tehama,63,2023-02-27,14,14,14,0,267,272,271,1,2,0,0,1,233,233,233,233
Trinity,63,2023-02-27,0,0,0,0,20,21,20,1,0,0,0,0,23,23,23,23
Tulare,63,2023-02-27,216,218,218,0,4010,4069,4068,1,22,3,3,2,1584,1584,1581,1581
Tuolumne,63,2023-02-27,40,40,40,0,472,481,480,1,0,0,0,1,211,211,211,211
Ventura,63,2023-02-27,276,280,280,0,5916,6003,6002,1,35,2,2,7,1680,1680,1678,1678
Yolo,63,2023-02-27,92,92,92,0,1367,1388,1387,1,3,1,1,1,447,447,446,446
Yuba,63,2023-02-27,35,35,35,0,508,516,515,1,0,0,0,0,122,122,122,122
Alameda,64,2023-03-06,924,939,939,0,16586,16861,16860,1,96,3,3,12,2205,2205,2202,2202
Amador,64,2023-03-06,13,13,13,0,461,470,469,1,0,0,0,0,98,98,98,98
Butte,64,2023-03-06,36,36,36,0,590,601,600,1,5,1,1,0,493,493,492,492
Calaveras,64,2023-03-06,19,19,19,0,269,275,274,1,0,2,2,0,142,142,140,140
Colusa,64,2023-03-06,13,13,13,0,161,164,163,1,0,0,0,0,22,22,22,22
Contra Costa,64,2023-03-06,692,703,703,0,10260,10430,10429,1,64,3,3,8,1564,1564,1561,1561
Del Norte,64,2023-03-06,6,6,6,0,253,259,258,1,1,1,1,1,60,60,59,59
El Dorado,64,2023-03-06,52,52,52,0,955,971,970,1,2,0,0,0,246,246,246,246
Fresno,64,2023-03-06,393,400,400,0,7964,8096,8095,1,77,5,5,16,3011,3011,3006,3006
Glenn,64,2023-03-06,4,4,4,0,163,166,165,1,0,0,0,0,53,53,53,53
Humboldt,64,2023-03-06,20,20,20,0,491,500,499,1,1,0,0,1,170,170,170,170
Imperial,64,2023-03-06,169,170,170,0,1608,1636,1635,1,9,0,0,0,980,980,980,980
Inyo,64,2023-03-06,4,4,4,0,136,139,138,1,1,0,0,0,63,63,63,63
Kern,64,2023-03-06,329,335,335,0,7768,7899,7898,1,35,3,3,4,2491,2491,2488,2488
Kings,64,2023-03-06,64,64,64,0,1566,1595,1594,1,1,0,0,0,485,485,485,485
Lake,64,2023-03-06,19,19,19,0,487,496,495,1,1,0,0,0,162,162,162,162
Lassen,64,2023-03-06,4,4,4,0,306,314,313,1,1,0,0,0,64,64,64,64
Los Angeles,64,2023-03-06,4594,4671,4671,0,123322,125360,125359,1,509,64,76,60,35685,35752,35621,35676
Madera,64,2023-03-06,82,82,82,0,1146,1166,1165,1,5,0,0,0,376,376,376,376
Marin,64,2023-03-06,139,139,139,0,1776,1806,1805,1,21,0,0,2,317,317,317,317
Mariposa,64,2023-03-06,0,0,0,0,69,70,69,1,0,0,0,0,31,31,31,31
Mendocino,64,2023-03-06,26,26,26,0,448,457,456,1,7,0,0,1,145,145,145,145
Merced,64,2023-03-06,147,148,148,0,1718,1747,1746,1,14,0,0,2,903,903,903,903
Modoc,64,2023-03-06,1,1,1,0,9,10,9,1,0,0,0,0,9,9,9,9
Mono,64,2023-03-06,5,5,5,0,56,57,56,1,0,0,0,0,8,8,8,8
Monterey,64,2023-03-06,146,146,146,0,2158,2195,2194,1,29,4,4,3,809,809,805,805
Napa,64,2023-03-06,52,52,52,0,1056,1075,1074,1,9,1,1,2,166,166,165,165
Nevada,64,2023-03-06,18,18,18,0,484,493,492,1,2,0,0,0,137,137,137,137
Orange,64,2023-03-06,977,993,993,0,18890,19204,19203,1,111,17,20,18,8032,8039,8015,8019
Placer,64,2023-03-06,172,174,174,0,2461,2503,2502,1,62,0,0,5,682,682,682,682
Plumas,64,2023-03-06,1,1,1,0,68,69,68,1,0,0,0,0,15,15,15,15
Riverside,64,2023-03-06,879,893,893,0,13997,14228,14227,1,78,3,3,8,6833,6833,6830,6830
Sacramento,64,2023-03-06,858,873,873,0,11807,12004,12003,1,113,5,5,6,3549,3549,3544,3544
San Benito,64,2023-03-06,16,16,16,0,465,473,472,1,1,0,0,0,112,112,112,112
San Bernardino,64,2023-03-06,743,755,755,0,15025,15275,15274,1,99,0,0,18,8133,8133,8133,8133
San Diego,64,2023-03-06,1409,1432,1432,0,25282,25701,25700,1,179,11,13,13,5816,5818,5805,5805
San Francisco,64,2023-03-06,600,611,611,0,10708,10885,10884,1,73,5,5,11,1187,1187,1182,1182
San Joaquin,64,2023-03-06,381,388,388,0,6809,6922,6921,1,42,0,0,8,2425,2425,2425,2425
San Luis Obispo,64,2023-03-06,92,92,92,0,1309,1331,1330,1,9,4,4,0,569,569,565,565
San Mateo,64,2023-03-06,422,429,429,0,7222,7344,7343,1,28,0,0,3,742,742,742,742
Santa Barbara,64,2023-03-06,149,150,150,0,3681,3742,3741,1,18,2,2,1,764,764,762,762
Santa Clara,64,2023-03-06,1080,1097,1097,0,20931,21276,21275,1,133,6,6,32,2729,2729,2723,2723
Santa Cruz,64,2023-03-06,133,134,134,0,5123,5208,5207,1,20,0,0,0,276,276,276,276
Shasta,64,2023-03-06,24,24,24,0,633,645,644,1,5,0,0,2,600,600,600,600
Siskiyou,64,2023-03-06,6,6,6,0,223,228,227,1,1,0,0,0,95,95,95,95
Solano,64,2023-03-06,256,261,261,0,3342,3398,3397,1,34,0,0,5,474,474,474,474
Sonoma,64,2023-03-06,209,212,212,0,3228,3282,3281,1,23,0,0,2,558,558,558,558
Stanislaus,64,2023-03-06,257,262,262,0,3547,3608,3607,1,67,0,0,9,1842,1842,1842,1842
Sutter,64,2023-03-06,35,35,35,0,593,604,603,1,0,0,0,0,238,238,238,238
Tehama,64,2023-03-06,12,12,12,0,251,257,256,1,5,0,0,1,233,233,233,233
Trinity,64,2023-03-06,2,2,2,0,18,19,18,1,0,0,0,0,23,23,23,23
Tulare,64,2023-03-06,208,211,211,0,3264,3318,3317,1,29,0,0,3,1584,1584,1584,1584
Tuolumne,64,2023-03-06,37,37,37,0,401,409,408,1,1,0,0,0,211,211,211,211
Ventura,64,2023-03-06,252,257,257,0,4970,5053,5052,1,42,2,2,5,1682,1682,1680,1680
Yolo,64,2023-03-06,62,62,62,0,1261,1283,1282,1,4,0,0,0,447,447,447,447
Yuba,64,2023-03-06,38,38,38,0,509,518,517,1,7,0,0,0,122,122,122,122
Alameda,65,2023-03-13,858,876,876,0,15315,15619,15618,1,76,2,2,18,2207,2207,2205,2205
Amador,65,2023-03-13,14,14,14,0,380,388,387,1,5,0,0,1,98,98,98,98
Butte,65,2023-03-13,38,38,38,0,600,613,612,1,9,1,1,1,494,494,493,493
Calaveras,65,2023-03-13,14,14,14,0,243,250,249,1,0,0,0,0,142,142,142,142
Colusa,65,2023-03-13,4,4,4,0,159,163,162,1,0,1,1,0,23,23,22,22
Contra Costa,65,2023-03-13,582,594,594,0,9861,10058,10057,1,44,2,2,7,1566,1566,1564,1564
Del Norte,65,2023-03-13,8,8,8,0,256,264,263,1,1,0,0,0,60,60,60,60
El Dorado,65,2023-03-13,47,47,47,0,897,916,915,1,1,0,0,0,246,246,246,246
Fresno,65,2023-03-13,385,393,393,0,7756,7910,7909,1,79,0,0,10,3011,3011,3011,3011
Glenn,65,2023-03-13,10,10,10,0,141,144,143,1,0,0,0,0,53,53,53,53
Humboldt,65,2023-03-13,29,29,29,0,504,514,513,1,4,0,0,1,170,170,170,170
Imperial,65,2023-03-13,212,217,217,0,2037,2079,2078,1,12,1,1,0,981,981,980,980
Inyo,65,2023-03-13,0,0,0,0,259,264,263,1,0,0,0,0,63,63,63,63
Kern,65,2023-03-13,337,343,343,0,7631,7783,7782,1,52,0,0,12,2491,2491,2491,2491
Kings,65,2023-03-13,60,60,60,0,1437,1468,1467,1,1,0,0,0,485,485,485,485
Lake,65,2023-03-13,11,11,11,0,410,419,418,1,1,0,0,0,162,162,162,162
Lassen,65,2023-03-13,6,6,6,0,335,344,343,1,0,0,0,0,64,64,64,64
Los Angeles,65,2023-03-13,3868,3945,3945,0,120256,122634,122633,1,418,66,82,56,35751,35834,35685,35752
Madera,65,2023-03-13,50,50,50,0,1149,1174,1173,1,6,0,0,0,376,376,376,376
Marin,65,2023-03-13,98,98,98,0,1720,1755,1754,1,21,0,0,1,317,317,317,317
Mariposa,65,2023-03-13,5,5,5,0,93,95,94,1,0,0,0,0,31,31,31,31
Mendocino,65,2023-03-13,17,17,17,0,458,469,468,1,6,0,0,1,145,145,145,145
Merced,65,2023-03-13,102,102,102,0,1506,1537,1536,1,12,0,0,2,903,903,903,903
Modoc,65,2023-03-13,1,1,1,0,12,13,12,1,0,0,0,0,9,9,9,9
Mono,65,2023-03-13,1,1,1,0,50,51,50,1,0,0,0,0,8,8,8,8
Monterey,65,2023-03-13,73,73,73,0,1810,1847,1846,1,27,0,0,2,809,809,809,809
Napa,65,2023-03-13,55,55,55,0,940,959,958,1,4,3,4,2,169,170,166,166
Nevada,65,2023-03-13,18,18,18,0,478,488,487,1,4,0,0,0,137,137,137,137
Orange,65,2023-03-13,898,916,916,0,18046,18403,18402,1,129,25,31,21,8057,8070,8032,8039
Placer,65,2023-03-13,169,171,171,0,2135,2179,2178,1,66,0,0,8,682,682,682,682
Plumas,65,2023-03-13,5,5,5,0,64,65,64,1,0,0,0,0,15,15,15,15
Riverside,65,2023-03-13,908,927,927,0,14717,15009,15008,1,79,4,4,14,6837,6837,6833,6833
Sacramento,65,2023-03-13,710,723,723,0,10734,10948,10947,1,105,6,7,21,3555,3556,3549,3549
San Benito,65,2023-03-13,13,13,13,0,412,421,420,1,0,0,0,0,112,112,112,112
San Bernardino,65,2023-03-13,701,714,714,0,14703,14995,14994,1,94,0,0,20,8133,8133,8133,8133
San Diego,65,2023-03-13,1315,1342,1342,0,23677,24146,24145,1,177,9,10,13,5825,5828,5816,5818
San Francisco,65,2023-03-13,555,566,566,0,9393,9579,9578,1,73,3,3,14,1190,1190,1187,1187
San Joaquin,65,2023-03-13,370,378,378,0,6804,6941,6940,1,34,3,3,6,2428,2428,2425,2425
San Luis Obispo,65,2023-03-13,78,78,78,0,1326,1353,1352,1,9,0,0,0,569,569,569,569
San Mateo,65,2023-03-13,370,377,377,0,6697,6831,6830,1,24,0,0,5,742,742,742,742
Santa Barbara,65,2023-03-13,150,151,151,0,3416,3484,3483,1,12,0,0,1,764,764,764,764
Santa Clara,65,2023-03-13,1038,1059,1059,0,20662,21071,21070,1,139,7,9,20,2736,2738,2729,2729
Santa Cruz,65,2023-03-13,109,110,110,0,3216,3282,3281,1,21,0,0,1,276,276,276,276
Shasta,65,2023-03-13,25,25,25,0,586,598,597,1,6,0,0,1,600,600,600,600
Siskiyou,65,2023-03-13,10,10,10,0,159,162,161,1,0,0,0,0,95,95,95,95
Solano,65,2023-03-13,229,234,234,0,3080,3142,3141,1,27,0,0,4,474,474,474,474
Sonoma,65,2023-03-13,195,201,201,0,2820,2877,2876,1,41,3,3,4,561,561,558,558
Stanislaus,65,2023-03-13,194,197,197,0,3440,3509,3508,1,52,0,0,4,1842,1842,1842,1842
Sutter,65,2023-03-13,27,27,27,0,518,529,528,1,0,0,0,0,238,238,238,238
Tehama,65,2023-03-13,17,17,17,0,229,235,234,1,1,0,0,0,233,233,233,233
Trinity,65,2023-03-13,0,0,0,0,22,23,22,1,0,0,0,0,23,23,23,23
Tulare,65,2023-03-13,164,167,167,0,3263,3329,3328,1,31,3,3,2,1587,1587,1584,1584
Tuolumne,65,2023-03-13,18,18,18,0,367,376,375,1,2,0,0,0,211,211,211,211
Ventura,65,2023-03-13,229,234,234,0,4362,4449,4448,1,25,4,4,5,1686,1686,1682,1682
Yolo,65,2023-03-13,71,71,71,0,1077,1099,1098,1,2,0,0,0,447,447,447,447
Yuba,65,2023-03-13,33,33,33,0,473,483,482,1,7,0,0,0,122,122,122,122
Alameda,66,2023-03-20,759,779,779,0,14842,15217,15216,1,69,6,8,10,2213,2215,2207,2207
Amador,66,2023-03-20,15,15,15,0,396,406,405,1,3,0,0,1,98,98,98,98
Butte,66,2023-03-20,44,44,44,0,502,516,515,1,5,1,1,3,495,495,494,494
Calaveras,66,2023-03-20,9,9,9,0,246,254,253,1,0,0,0,0,142,142,142,142
Colusa,66,2023-03-20,4,4,4,0,153,157,156,1,0,0,0,0,23,23,23,23
Contra Costa,66,2023-03-20,435,446,446,0,9440,9679,9678,1,31,3,4,8,1569,1570,1566,1566
Del Norte,66,2023-03-20,2,2,2,0,224,231,230,1,0,0,0,1,60,60,60,60
El Dorado,66,2023-03-20,46,46,46,0,849,871,870,1,2,0,0,0,246,246,246,246
Fresno,66,2023-03-20,370,378,378,0,7750,7945,7944,1,66,2,2,16,3013,3013,3011,3011
Glenn,66,2023-03-20,4,4,4,0,132,135,134,1,0,0,0,0,53,53,53,53
Humboldt,66,2023-03-20,21,21,21,0,477,491,490,1,4,0,0,2,170,170,170,170
Imperial,66,2023-03-20,151,155,155,0,1628,1670,1669,1,9,0,0,1,981,981,981,981
Inyo,66,2023-03-20,10,10,10,0,280,287,286,1,0,0,0,0,63,63,63,63
Kern,66,2023-03-20,205,210,210,0,7572,7764,7763,1,29,2,2,8,2493,2493,2491,2491
Kings,66,2023-03-20,40,40,40,0,1448,1484,1483,1,1,1,1,0,486,486,485,485
Lake,66,2023-03-20,12,12,12,0,404,417,416,1,2,0,0,0,162,162,162,162
Lassen,66,2023-03-20,4,4,4,0,307,316,315,1,0,0,0,0,64,64,64,64
Los Angeles,66,2023-03-20,3205,3286,3286,0,108737,111469,111468,1,397,56,80,44,35807,35914,35751,35834
Madera,66,2023-03-20,50,50,50,0,1112,1141,1140,1,4,0,0,0,376,376,376,376
Marin,66,2023-03-20,87,87,87,0,1521,1561,1560,1,25,0,0,2,317,317,317,317
Mariposa,66,2023-03-20,2,2,2,0,91,94,93,1,0,0,0,0,31,31,31,31
Mendocino,66,2023-03-20,11,11,11,0,423,433,432,1,2,0,0,0,145,145,145,145
Merced,66,2023-03-20,105,106,106,0,1471,1509,1508,1,6,0,0,2,903,903,903,903
Modoc,66,2023-03-20,1,1,1,0,10,11,10,1,0,0,0,0,9,9,9,9
Mono,66,2023-03-20,4,4,4,0,52,53,52,1,0,0,0,0,8,8,8,8
Monterey,66,2023-03-20,58,58,58,0,1428,1465,1464,1,21,0,0,1,809,809,809,809
Napa,66,2023-03-20,29,29,29,0,905,929,928,1,3,0,0,1,169,170,169,170
Nevada,66,2023-03-20,17,17,17,0,457,471,470,1,4,0,0,0,137,137,137,137
Orange,66,2023-03-20,730,748,748,0,16296,16707,16706,1,115,10,14,25,8067,8084,8057,8070
Placer,66,2023-03-20,124,127,127,0,2145,2199,2198,1,58,0,0,8,682,682,682,682
Plumas,66,2023-03-20,2,2,2,0,52,53,52,1,0,0,0,0,15,15,15,15
Riverside,66,2023-03-20,589,604,604,0,12280,12587,12586,1,57,1,1,7,6838,6838,6837,6837
Sacramento,66,2023-03-20,482,493,493,0,9725,9972,9971,1,85,2,3,16,3557,3559,3555,3556
San Benito,66,2023-03-20,40,41,41,0,553,567,566,1,0,0,0,0,112,112,112,112
San Bernardino,66,2023-03-20,515,528,528,0,13746,14092,14091,1,77,0,0,12,8133,8133,8133,8133
San Diego,66,2023-03-20,1115,1143,1143,0,22659,23226,23225,1,139,9,12,13,5834,5840,5825,5828
San Francisco,66,2023-03-20,417,427,427,0,8429,8642,8641,1,63,4,5,8,1194,1195,1190,1190
San Joaquin,66,2023-03-20,266,272,272,0,5776,5922,5921,1,28,2,2,5,2430,2430,2428,2428
San Luis Obispo,66,2023-03-20,48,48,48,0,1154,1185,1184,1,9,1,1,0,570,570,569,569
San Mateo,66,2023-03-20,307,316,316,0,6303,6461,6460,1,24,0,0,1,742,742,742,742
Santa Barbara,66,2023-03-20,110,111,111,0,3108,3186,3185,1,15,1,1,1,765,765,764,764
Santa Clara,66,2023-03-20,792,812,812,0,16859,17283,17282,1,151,4,6,22,2740,2744,2736,2738
Santa Cruz,66,2023-03-20,120,121,121,0,3045,3125,3124,1,9,0,0,1,276,276,276,276
Shasta,66,2023-03-20,18,18,18,0,569,584,583,1,2,0,0,3,600,600,600,600
Siskiyou,66,2023-03-20,3,3,3,0,156,161,160,1,0,0,0,0,95,95,95,95
Solano,66,2023-03-20,184,188,188,0,2887,2960,2959,1,26,1,2,5,475,476,474,474
Sonoma,66,2023-03-20,182,186,186,0,2729,2797,2796,1,33,0,0,1,561,561,561,561
Stanislaus,66,2023-03-20,199,206,206,0,3278,3363,3362,1,48,0,0,6,1842,1842,1842,1842
Sutter,66,2023-03-20,38,38,38,0,486,499,498,1,0,0,0,0,238,238,238,238
Tehama,66,2023-03-20,14,14,14,0,218,225,224,1,2,0,0,0,233,233,233,233
Trinity,66,2023-03-20,0,0,0,0,17,18,17,1,0,0,0,0,23,23,23,23
Tulare,66,2023-03-20,119,121,121,0,2674,2744,2743,1,25,0,0,0,1587,1587,1587,1587
Tuolumne,66,2023-03-20,14,14,14,0,387,397,396,1,0,0,0,0,211,211,211,211
Ventura,66,2023-03-20,176,183,183,0,4141,4246,4245,1,39,3,4,2,1689,1690,1686,1686
Yolo,66,2023-03-20,54,54,54,0,1059,1086,1085,1,6,0,0,1,447,447,447,447
Yuba,66,2023-03-20,18,18,18,0,461,474,473,1,7,0,0,0,122,122,122,122
Alameda,67,2023-03-27,591,611,611,0,13338,13806,13805,1,91,2,4,9,2215,2219,2213,2215
Amador,67,2023-03-27,10,10,10,0,359,374,373,1,3,0,0,1,98,98,98,98
Butte,67,2023-03-27,29,29,29,0,500,519,518,1,8,1,2,0,496,497,495,495
Calaveras,67,2023-03-27,11,11,11,0,244,254,253,1,0,1,2,0,143,144,142,142
Colusa,67,2023-03-27,4,4,4,0,162,168,167,1,0,0,0,0,23,23,23,23
Contra Costa,67,2023-03-27,396,409,409,0,8884,9198,9197,1,33,0,0,6,1569,1570,1569,1570
Del Norte,67,2023-03-27,6,6,6,0,206,215,214,1,0,0,0,1,60,60,60,60
El Dorado,67,2023-03-27,35,36,36,0,781,809,808,1,2,0,0,0,246,246,246,246
Fresno,67,2023-03-27,249,257,257,0,7242,7497,7496,1,59,1,2,5,3014,3015,3013,3013
Glenn,67,2023-03-27,6,6,6,0,133,137,136,1,0,0,0,0,53,53,53,53
Humboldt,67,2023-03-27,13,13,13,0,447,463,462,1,5,0,0,1,170,170,170,170
Imperial,67,2023-03-27,144,149,149,0,1679,1740,1739,1,10,0,0,1,981,981,981,981
Inyo,67,2023-03-27,10,10,10,0,224,233,232,1,0,0,0,0,63,63,63,63
Kern,67,2023-03-27,187,194,194,0,6942,7186,7185,1,29,0,0,3,2493,2493,2493,2493
Kings,67,2023-03-27,37,37,37,0,1306,1354,1353,1,2,0,0,1,486,486,486,486
Lake,67,2023-03-27,13,13,13,0,349,363,362,1,2,0,0,0,162,162,162,162
Lassen,67,2023-03-27,7,7,7,0,315,326,325,1,0,0,0,0,64,64,64,64
Los Angeles,67,2023-03-27,2392,2477,2477,0,102153,105740,105739,1,348,22,44,46,35829,35958,35807,35914
Madera,67,2023-03-27,32,32,32,0,957,992,991,1,5,0,0,0,376,376,376,376
Marin,67,2023-03-27,78,80,80,0,1285,1332,1331,1,18,0,0,1,317,317,317,317
Mariposa,67,2023-03-27,0,0,0,0,74,76,75,1,0,0,0,0,31,31,31,31
Mendocino,67,2023-03-27,15,15,15,0,410,427,426,1,1,0,0,1,145,145,145,145
Merced,67,2023-03-27,91,93,93,0,1331,1380,1379,1,6,0,0,2,903,903,903,903
Modoc,67,2023-03-27,0,0,0,0,5,6,5,1,0,0,0,0,9,9,9,9
Mono,67,2023-03-27,1,1,1,0,49,50,49,1,0,0,0,0,8,8,8,8
Monterey,67,2023-03-27,49,49,49,0,1695,1757,1756,1,19,0,0,0,809,809,809,809
Napa,67,2023-03-27,43,43,43,0,886,917,916,1,3,0,0,1,169,170,169,170
Nevada,67,2023-03-27,24,24,24,0,473,490,489,1,3,0,0,0,137,137,137,137
Orange,67,2023-03-27,622,643,643,0,15569,16117,16116,1,112,10,20,19,8077,8104,8067,8084
Placer,67,2023-03-27,103,106,106,0,1877,1945,1944,1,43,0,0,6,682,682,682,682
Plumas,67,2023-03-27,1,1,1,0,55,57,56,1,0,0,0,0,15,15,15,15
Riverside,67,2023-03-27,538,557,557,0,11187,11581,11580,1,41,5,11,6,6843,6849,6838,6838
Sacramento,67,2023-03-27,437,451,451,0,9389,9721,9720,1,79,7,12,11,3564,3571,3557,3559
San Benito,67,2023-03-27,23,23,23,0,752,779,778,1,1,0,0,0,112,112,112,112
San Bernardino,67,2023-03-27,426,443,443,0,12473,12917,12916,1,67,0,0,12,8133,8133,8133,8133
San Diego,67,2023-03-27,878,910,910,0,20524,21245,21244,1,137,1,3,7,5835,5843,5834,5840
San Francisco,67,2023-03-27,369,384,384,0,7827,8102,8101,1,45,1,2,5,1195,1197,1194,1195
San Joaquin,67,2023-03-27,243,251,251,0,5538,5735,5734,1,23,0,0,11,2430,2430,2430,2430
San Luis Obispo,67,2023-03-27,39,39,39,0,1138,1179,1178,1,4,0,0,0,570,570,570,570
San Mateo,67,2023-03-27,268,277,277,0,5693,5893,5892,1,29,0,0,1,742,742,742,742
Santa Barbara,67,2023-03-27,89,91,91,0,3227,3341,3340,1,9,0,0,2,765,765,765,765
Santa Clara,67,2023-03-27,682,707,707,0,15849,16403,16402,1,100,4,7,14,2744,2751,2740,2744
Santa Cruz,67,2023-03-27,129,134,134,0,2947,3050,3049,1,8,0,0,1,276,276,276,276
Shasta,67,2023-03-27,15,15,15,0,536,555,554,1,2,0,0,3,600,600,600,600
Siskiyou,67,2023-03-27,1,1,1,0,147,154,153,1,0,0,0,0,95,95,95,95
Solano,67,2023-03-27,167,173,173,0,2660,2755,2754,1,23,0,0,4,475,476,475,476
Sonoma,67,2023-03-27,153,160,160,0,2420,2507,2506,1,29,1,2,4,562,563,561,561
Stanislaus,67,2023-03-27,151,156,156,0,2573,2666,2665,1,39,0,0,6,1842,1842,1842,1842
Sutter,67,2023-03-27,37,37,37,0,419,435,434,1,0,0,0,0,238,238,238,238
Tehama,67,2023-03-27,5,5,5,0,196,205,204,1,2,0,0,0,233,233,233,233
Trinity,67,2023-03-27,0,0,0,0,24,25,24,1,0,0,0,0,23,23,23,23
Tulare,67,2023-03-27,102,105,105,0,2715,2813,2812,1,25,0,0,1,1587,1587,1587,1587
Tuolumne,67,2023-03-27,8,8,8,0,308,320,319,1,1,0,0,0,211,211,211,211
Ventura,67,2023-03-27,145,151,151,0,4099,4244,4243,1,25,2,4,2,1691,1694,1689,1690
Yolo,67,2023-03-27,61,61,61,0,1064,1102,1101,1,6,0,0,1,447,447,447,447
Yuba,67,2023-03-27,14,14,14,0,417,433,432,1,1,0,0,1,122,122,122,122
Alameda,68,2023-04-03,556,593,593,0,12431,13236,13235,1,58,0,0,9,2215,2219,2215,2219
Amador,68,2023-04-03,16,16,16,0,285,306,305,1,2,0,0,0,98,98,98,98
Butte,68,2023-04-03,20,20,20,0,463,497,496,1,7,0,0,0,496,497,496,497
Calaveras,68,2023-04-03,5,5,5,0,202,217,216,1,0,0,0,0,143,144,143,144
Colusa,68,2023-04-03,8,8,8,0,174,186,185,1,2,0,0,0,23,23,23,23
Contra Costa,68,2023-04-03,378,404,404,0,8658,9228,9227,1,37,0,0,4,1569,1570,1569,1570
Del Norte,68,2023-04-03,5,5,5,0,195,209,208,1,0,0,0,0,60,60,60,60
El Dorado,68,2023-04-03,61,66,66,0,745,795,794,1,4,0,0,0,246,246,246,246
Fresno,68,2023-04-03,268,285,285,0,7083,7547,7546,1,54,0,0,12,3014,3015,3014,3015
Glenn,68,2023-04-03,7,7,7,0,127,139,138,1,0,0,0,0,53,53,53,53
Humboldt,68,2023-04-03,20,20,20,0,451,480,479,1,5,0,0,0,170,170,170,170
Imperial,68,2023-04-03,175,187,187,0,1497,1594,1593,1,14,0,0,1,981,981,981,981
Inyo,68,2023-04-03,2,2,2,0,139,149,148,1,0,0,0,0,63,63,63,63
Kern,68,2023-04-03,154,163,163,0,5493,5847,5846,1,28,1,3,1,2494,2496,2493,2493
Kings,68,2023-04-03,32,33,33,0,981,1044,1043,1,5,0,0,0,486,486,486,486
Lake,68,2023-04-03,16,16,16,0,342,365,364,1,0,0,0,0,162,162,162,162
Lassen,68,2023-04-03,3,3,3,0,164,175,174,1,0,0,0,0,64,64,64,64
Los Angeles,68,2023-04-03,2307,2456,2456,0,71580,75652,75651,1,318,18,93,40,35847,36051,35829,35958
Madera,68,2023-04-03,38,40,40,0,852,909,908,1,1,0,0,0,376,376,376,376
Marin,68,2023-04-03,101,107,107,0,1241,1323,1322,1,16,0,0,0,317,317,317,317
Mariposa,68,2023-04-03,6,6,6,0,71,77,76,1,0,0,0,0,31,31,31,31
Mendocino,68,2023-04-03,14,14,14,0,362,387,386,1,3,0,0,1,145,145,145,145
Merced,68,2023-04-03,73,78,78,0,922,983,982,1,6,0,0,0,903,903,903,903
Modoc,68,2023-04-03,4,4,4,0,12,13,12,1,0,0,0,0,9,9,9,9
Mono,68,2023-04-03,2,2,2,0,40,42,41,1,0,0,0,0,8,8,8,8
Monterey,68,2023-04-03,52,54,54,0,1642,1760,1759,1,16,2,10,1,811,819,809,809
Napa,68,2023-04-03,40,42,42,0,801,855,854,1,8,0,0,1,169,170,169,170
Nevada,68,2023-04-03,51,55,55,0,433,466,465,1,4,1,6,0,138,143,137,137
Orange,68,2023-04-03,639,682,682,0,15291,16295,16294,1,93,1,3,14,8078,8107,8077,8104
Placer,68,2023-04-03,97,103,103,0,1864,1986,1985,1,39,0,0,5,682,682,682,682
Plumas,68,2023-04-03,2,2,2,0,57,63,62,1,0,0,0,0,15,15,15,15
Riverside,68,2023-04-03,439,468,468,0,10854,11570,11569,1,61,2,7,8,6845,6856,6843,6849
Sacramento,68,2023-04-03,507,542,542,0,8914,9502,9501,1,70,0,0,16,3564,3571,3564,3571
San Benito,68,2023-04-03,24,25,25,0,549,587,586,1,0,0,0,0,112,112,112,112
San Bernardino,68,2023-04-03,455,486,486,0,11605,12382,12381,1,54,0,0,12,8133,8133,8133,8133
San Diego,68,2023-04-03,765,816,816,0,19387,20659,20658,1,128,5,18,10,5840,5861,5835,5843
San Francisco,68,2023-04-03,328,350,350,0,6761,7206,7205,1,37,1,3,9,1196,1200,1195,1197
San Joaquin,68,2023-04-03,218,233,233,0,4967,5291,5290,1,31,0,0,8,2430,2430,2430,2430
San Luis Obispo,68,2023-04-03,44,47,47,0,963,1027,1026,1,5,0,0,0,570,570,570,570
San Mateo,68,2023-04-03,249,266,266,0,5627,5995,5994,1,29,0,0,0,742,742,742,742
Santa Barbara,68,2023-04-03,95,102,102,0,2622,2796,2795,1,16,0,0,1,765,765,765,765
Santa Clara,68,2023-04-03,638,680,680,0,15152,16135,16134,1,70,0,0,15,2744,2751,2744,2751
Santa Cruz,68,2023-04-03,127,135,135,0,2407,2561,2560,1,15,0,0,0,276,276,276,276
Shasta,68,2023-04-03,16,16,16,0,500,533,532,1,1,0,0,1,600,600,600,600
Siskiyou,68,2023-04-03,2,2,2,0,92,101,100,1,0,0,0,0,95,95,95,95
Solano,68,2023-04-03,124,131,131,0,2336,2489,2488,1,20,0,0,2,475,476,475,476
Sonoma,68,2023-04-03,136,145,145,0,2084,2222,2221,1,27,0,0,0,562,563,562,563
Stanislaus,68,2023-04-03,115,123,123,0,2506,2677,2676,1,33,0,0,4,1842,1842,1842,1842
Sutter,68,2023-04-03,33,34,34,0,399,427,426,1,0,0,0,0,238,238,238,238
Tehama,68,2023-04-03,8,8,8,0,190,204,203,1,0,0,0,0,233,233,233,233
Trinity,68,2023-04-03,0,0,0,0,11,12,11,1,0,0,0,0,23,23,23,23
Tulare,68,2023-04-03,94,101,101,0,2604,2777,2776,1,19,0,0,1,1587,1587,1587,1587
Tuolumne,68,2023-04-03,6,6,6,0,243,261,260,1,1,0,0,0,211,211,211,211
Ventura,68,2023-04-03,139,148,148,0,3516,3745,3744,1,22,0,0,0,1691,1694,1691,1694
Yolo,68,2023-04-03,51,53,53,0,966,1032,1031,1,3,0,0,0,447,447,447,447
Yuba,68,2023-04-03,23,23,23,0,397,424,423,1,1,0,0,0,122,122,122,122
Alameda,69,2023-04-10,449,1524,1524,0,9558,26087,26086,1,58,0,0,10,2215,2219,2215,2219
Amador,69,2023-04-10,6,20,20,0,166,472,471,1,1,0,0,0,98,98,98,98
Butte,69,2023-04-10,10,16,16,0,304,750,749,1,4,0,0,0,496,497,496,497
Calaveras,69,2023-04-10,6,26,26,0,169,431,430,1,0,0,0,0,143,144,143,144
Colusa,69,2023-04-10,1,1,1,0,92,199,198,1,1,0,0,0,23,23,23,23
Contra Costa,69,2023-04-10,340,1158,1158,0,7020,19015,19014,1,42,0,0,2,1569,1570,1569,1570
Del Norte,69,2023-04-10,2,2,2,0,101,193,192,1,0,0,0,0,60,60,60,60
El Dorado,69,2023-04-10,32,168,168,0,525,1395,1394,1,3,0,0,1,246,246,246,246
Fresno,69,2023-04-10,193,511,511,0,5269,14128,14127,1,63,0,0,3,3014,3015,3014,3015
Glenn,69,2023-04-10,0,0,0,0,50,115,114,1,1,0,0,0,53,53,53,53
Humboldt,69,2023-04-10,14,45,45,0,372,1177,1176,1,4,0,0,0,170,170,170,170
Imperial,69,2023-04-10,109,308,308,0,1063,3373,3372,1,7,0,0,3,981,981,981,981
Inyo,69,2023-04-10,4,4,4,0,158,294,293,1,0,0,0,0,63,63,63,63
Kern,69,2023-04-10,105,279,279,0,3806,6613,6612,1,28,0,0,2,2494,2496,2494,2496
Kings,69,2023-04-10,38,171,171,0,749,2019,2018,1,4,0,0,0,486,486,486,486
Lake,69,2023-04-10,11,69,69,0,273,846,845,1,0,0,0,0,162,162,162,162
Lassen,69,2023-04-10,0,0,0,0,87,182,181,1,0,0,0,0,64,64,64,64
Los Angeles,69,2023-04-10,1276,2308,2308,0,5422,11618,11617,1,299,9,154,35,35856,36205,35847,36051
Madera,69,2023-04-10,49,106,106,0,713,1834,1833,1,0,0,0,0,376,376,376,376
Marin,69,2023-04-10,72,184,184,0,1028,2628,2627,1,12,0,0,2,317,317,317,317
Mariposa,69,2023-04-10,4,32,32,0,53,185,184,1,0,0,0,0,31,31,31,31
Mendocino,69,2023-04-10,11,19,19,0,313,901,900,1,2,0,0,1,145,145,145,145
Merced,69,2023-04-10,36,79,79,0,615,1507,1506,1,5,0,0,1,903,903,903,903
Modoc,69,2023-04-10,1,1,1,0,5,7,6,1,0,0,0,0,9,9,9,9
Mono,69,2023-04-10,1,1,1,0,40,149,148,1,0,0,0,0,8,8,8,8
Monterey,69,2023-04-10,42,137,137,0,1080,3030,3029,1,12,0,0,1,811,819,811,819
Napa,69,2023-04-10,22,101,101,0,592,1887,1886,1,5,0,0,0,169,170,169,170
Nevada,69,2023-04-10,27,37,37,0,215,372,371,1,3,0,0,0,138,143,138,143
Orange,69,2023-04-10,431,1094,1094,0,12322,29370,29369,1,87,0,0,15,8078,8107,8078,8107
Placer,69,2023-04-10,92,319,319,0,1361,3946,3945,1,32,0,0,7,682,682,682,682
Plumas,69,2023-04-10,1,15,15,0,33,103,102,1,0,0,0,0,15,15,15,15
Riverside,69,2023-04-10,279,618,618,0,8208,15738,15737,1,53,0,0,6,6845,6856,6845,6856
Sacramento,69,2023-04-10,381,1065,1065,0,6419,15780,15779,1,74,0,0,13,3564,3571,3564,3571
San Benito,69,2023-04-10,21,37,37,0,386,1431,1430,1,2,0,0,0,112,112,112,112
San Bernardino,69,2023-04-10,299,616,616,0,8640,16162,16161,1,71,0,0,11,8133,8133,8133,8133
San Diego,69,2023-04-10,680,1645,1645,0,17019,35616,35615,1,114,1,18,17,5841,5879,5840,5861
San Francisco,69,2023-04-10,235,827,827,0,5089,13314,13313,1,39,0,0,6,1196,1200,1196,1200
San Joaquin,69,2023-04-10,164,395,395,0,3541,8430,8429,1,22,0,0,10,2430,2430,2430,2430
San Luis Obispo,69,2023-04-10,43,151,151,0,725,1955,1954,1,3,0,0,1,570,570,570,570
San Mateo,69,2023-04-10,175,487,487,0,4179,10305,10304,1,21,0,0,1,742,742,742,742
Santa Barbara,69,2023-04-10,79,256,256,0,2477,6286,6285,1,16,0,0,3,765,765,765,765
Santa Clara,69,2023-04-10,497,1493,1493,0,12463,28423,28422,1,95,0,0,14,2744,2751,2744,2751
Santa Cruz,69,2023-04-10,71,131,131,0,1115,1974,1973,1,17,0,0,0,276,276,276,276
Shasta,69,2023-04-10,14,17,17,0,313,534,533,1,3,0,0,1,600,600,600,600
Siskiyou,69,2023-04-10,6,9,9,0,87,186,185,1,0,0,0,0,95,95,95,95
Solano,69,2023-04-10,123,442,442,0,1798,5342,5341,1,20,0,0,2,475,476,475,476
Sonoma,69,2023-04-10,96,378,378,0,1777,4926,4925,1,18,0,0,2,562,563,562,563
Stanislaus,69,2023-04-10,105,383,383,0,1892,5154,5153,1,25,0,0,2,1842,1842,1842,1842
Sutter,69,2023-04-10,28,83,83,0,384,1233,1232,1,0,0,0,0,238,238,238,238
Tehama,69,2023-04-10,4,5,5,0,111,201,200,1,1,0,0,0,233,233,233,233
Trinity,69,2023-04-10,2,5,5,0,9,29,28,1,0,0,0,0,23,23,23,23
Tulare,69,2023-04-10,54,160,160,0,1757,3788,3787,1,17,0,0,0,1587,1587,1587,1587
Tuolumne,69,2023-04-10,4,8,8,0,176,529,528,1,0,0,0,0,211,211,211,211
Ventura,69,2023-04-10,109,364,364,0,2804,7469,7468,1,22,0,0,0,1691,1694,1691,1694
Yolo,69,2023-04-10,38,92,92,0,727,1745,1744,1,3,0,0,1,447,447,447,447
Yuba,69,2023-04-10,18,41,41,0,344,1065,1064,1,3,0,0,0,122,122,122,122
California,1,2021-12-20,84319,84319,47196,37123,2163198,2163219,1234296,928923,2585,503,503,932,77359,77359,76856,76856
California,2,2021-12-27,241966,241967,151934,90033,1954036,1954069,1192474,761595,3348,496,496,1030,77855,77855,77359,77359
California,3,2022-01-03,549871,549879,369462,180417,2956116,2956192,1966350,989842,6125,592,592,1280,78447,78447,77855,77855
California,4,2022-01-10,867431,867447,619968,247479,4665935,4666090,3353575,1312515,10002,946,946,1813,79393,79393,78447,78447
California,5,2022-01-17,661905,661918,493185,168733,3983758,3983907,3022112,961795,12343,1432,1432,2311,80825,80825,79393,79393
California,6,2022-01-24,527393,527401,412572,114829,3988758,3988913,3193291,795622,12648,1778,1778,2600,82603,82603,80825,80825
California,7,2022-01-31,270337,270342,219707,50635,3154737,3154867,2635983,518884,10873,1907,1907,2494,84510,84510,82603,82603
California,8,2022-02-07,149322,149322,125787,23535,2670193,2670315,2318152,352163,8405,1779,1779,2007,86289,86289,84510,84510
California,9,2022-02-14,85820,85820,74808,11012,2322811,2322950,2079759,243191,6407,1435,1435,1564,87724,87724,86289,86289
California,10,2022-02-21,48081,48081,43054,5027,1850734,1850853,1692096,158757,4557,1004,1004,1098,88728,88728,87724,87724
California,11,2022-02-28,32661,32661,29951,2710,2098621,2098776,1961850,136926,3357,695,695,772,89423,89423,88728,88728
California,12,2022-03-07,22988,22988,21482,1506,1819513,1819673,1725088,94585,2435,501,501,581,89924,89924,89423,89423
California,13,2022-03-14,16975,16975,16098,877,1725390,1725574,1655235,70339,1844,358,358,419,90282,90282,89924,89924
California,14,2022-03-21,14642,14642,14059,583,1646362,1646556,1593848,52708,1537,253,253,313,90535,90535,90282,90282
California,15,2022-03-28,15469,15469,14988,481,1463257,1463456,1425855,37601,1150,180,180,264,90715,90715,90535,90535
California,16,2022-04-04,17681,17681,17264,417,1525011,1525290,1495753,29537,943,141,141,211,90856,90856,90715,90715
California,17,2022-04-11,21517,21517,21124,393,1343264,1343577,1322731,20846,905,125,125,148,90981,90981,90856,90856
California,18,2022-04-18,26874,26875,26486,389,1131660,1132011,1117120,14891,823,111,111,141,91092,91092,90981,90981
California,19,2022-04-25,37239,37244,36816,428,1622604,1623267,1608409,14858,838,92,92,112,91184,91184,91092,91092
California,20,2022-05-02,48952,48961,48526,435,1701776,1702644,1690409,12235,950,85,85,143,91269,91269,91184,91184
California,21,2022-05-09,63354,63370,62925,445,1770484,1771531,1761491,10040,1050,86,86,153,91355,91355,91269,91269
California,22,2022-05-16,80342,80376,79924,452,1840090,1841344,1833090,8254,1345,120,120,182,91475,91475,91355,91355
California,23,2022-05-23,97920,97973,97553,420,1870579,1871982,1865382,6600,1714,117,117,217,91592,91592,91475,91475
California,24,2022-05-30,90567,90624,90314,310,1499206,1500440,1496189,4251,1918,152,152,272,91744,91744,91592,91592
California,25,2022-06-06,120600,120693,120375,318,1939258,1941075,1936979,4096,2305,138,138,276,91882,91882,91744,91744
California,26,2022-06-13,105293,105383,105166,217,1406784,1408231,1405748,2483,2471,181,181,291,92063,92063,91882,91882
California,27,2022-06-20,101451,101542,101381,161,1026810,1027932,1026342,1590,2552,209,209,310,92272,92272,92063,92063
California,28,2022-06-27,115561,115672,115534,138,1044019,1045231,1043979,1252,3006,220,220,339,92492,92492,92272,92272
California,29,2022-07-04,108346,108449,108347,102,837021,838036,837230,806,3167,271,271,393,92763,92763,92492,92492
California,30,2022-07-11,141411,141561,141462,99,1082577,1083930,1083139,791,3824,298,298,453,93061,93061,92763,92763
California,31,2022-07-18,129806,129954,129881,73,993053,994333,993769,564,4148,296,296,528,93357,93357,93061,93061
California,32,2022-07-25,117705,117835,117787,48,948690,949940,949516,424,4310,360,360,516,93717,93717,93357,93357
California,33,2022-08-01,99321,99431,99398,33,875764,876972,876659,313,4119,362,362,535,94079,94079,93717,93717
California,34,2022-08-08,83525,83618,83598,20,825474,826680,826448,232,3754,336,336,474,94415,94415,94079,94079
California,35,2022-08-15,69105,69182,69170,12,794431,795644,795462,182,3363,299,299,448,94714,94714,94415,94415
California,36,2022-08-22,61520,61590,61584,6,778720,779949,779803,146,3087,288,288,418,95002,95002,94714,94714
California,37,2022-08-29,51888,51950,51947,3,769163,770413,770292,121,2752,219,219,351,95221,95221,95002,95002
California,38,2022-09-05,36774,36813,36813,0,631168,632224,632135,89,2525,248,248,350,95469,95469,95221,95221
California,39,2022-09-12,36469,36506,36506,0,755911,757211,757126,85,2422,223,223,346,95692,95692,95469,95469
California,40,2022-09-19,27822,27847,27847,0,690153,691375,691304,71,2041,182,182,272,95874,95874,95692,95692
California,41,2022-09-26,25508,25529,25529,0,641815,642989,642925,64,1818,166,166,230,96040,96040,95874,95874
California,42,2022-10-03,23490,23509,23509,0,588028,589156,589096,60,1647,149,149,247,96189,96189,96040,96040
California,43,2022-10-10,23550,23568,23568,0,628756,630029,629971,58,1537,153,153,228,96324,96324,96171,96171
California,44,2022-10-17,18797,18813,18813,0,524189,525305,525248,57,1397,121,121,218,96445,96445,96324,96324
California,45,2022-10-24,18673,18691,18691,0,514472,515617,515560,57,1324,120,120,190,96565,96565,96445,96445
California,46,2022-10-31,20806,20828,20828,0,523939,525164,525107,57,1401,113,113,191,96678,96678,96565,96565
California,47,2022-11-07,27011,27052,27052,0,548672,550013,549956,57,1525,134,134,231,96812,96812,96678,96678
California,48,2022-11-14,30961,31020,31020,0,550417,551841,551784,57,1775,114,114,260,96926,96926,96812,96812
California,49,2022-11-21,40396,40485,40485,0,576601,578190,578133,57,2268,153,153,330,97079,97079,96926,96926
California,50,2022-11-28,54487,54618,54618,0,518545,520102,520045,57,3153,207,207,379,97286,97286,97079,97079
California,51,2022-12-05,66344,66530,66530,0,659365,661469,661411,58,3715,243,243,493,97529,97529,97286,97286
California,52,2022-12-12,56818,56993,56993,0,621560,623756,623698,58,3944,350,350,527,97879,97879,97529,97529
California,53,2022-12-19,51075,51257,51257,0,575359,577672,577615,57,3997,326,326,523,98205,98205,97879,97879
California,54,2022-12-26,45746,45923,45923,0,420946,422804,422747,57,3906,405,405,510,98610,98610,98205,98205
California,55,2023-01-02,45408,45608,45608,0,425299,427401,427344,57,4077,360,361,528,98970,98971,98610,98610
California,56,2023-01-09,33916,34072,34072,0,507527,510247,510190,57,3672,343,347,487,99313,99318,98970,98971
California,57,2023-01-16,20366,20459,20459,0,410819,413326,413269,57,3075,321,328,425,99634,99646,99313,99318
California,58,2023-01-23,18496,18598,18598,0,453346,456610,456553,57,2400,242,247,369,99876,99893,99634,99646
California,59,2023-01-30,19421,19561,19561,0,419894,423427,423370,57,2214,211,218,266,100087,100111,99876,99893
California,60,2023-02-06,21379,21558,21558,0,405205,409197,409140,57,2231,174,181,280,100261,100292,100087,100111
California,61,2023-02-13,21377,21587,21587,0,385241,389578,389522,56,2223,147,154,287,100408,100446,100261,100292
California,62,2023-02-20,19737,19959,19959,0,345936,350326,350270,56,2159,166,174,292,100574,100620,100408,100446
California,63,2023-02-27,19903,20160,20160,0,382229,387743,387686,57,2220,152,165,310,100726,100785,100574,100620
California,64,2023-03-06,17281,17546,17546,0,348284,354095,354039,56,2074,142,159,262,100868,100944,100726,100785
California,65,2023-03-13,15504,15793,15793,0,333091,339736,339680,56,1939,143,170,278,101011,101114,100868,100944
California,66,2023-03-20,12376,12666,12666,0,304049,311737,311681,56,1701,109,149,237,101120,101263,101011,101114
California,67,2023-03-27,10179,10519,10519,0,284052,294088,294032,56,1498,58,115,196,101178,101378,101120,101263
California,68,2023-04-03,9788,10418,10418,0,240250,255440,255384,56,1363,31,143,176,101209,101521,101178,101378
California,69,2023-04-10,6910,18443,18443,0,135994,322441,322385,56,1312,10,172,173,101219,101693,101209,101521
