county,time,date,cases,est_cases,est_omicron_cases,est_other_cases,tests,est_tests,est_omicron_tests,est_other_tests,hospitalizations,deaths,est_deaths,icu,cum_deaths,cum_est_deaths,prev_cum_deaths,prev_cum_est_deaths
Alameda,1,2021-12-20,2976,2976,1416,1560,89682,89695,41883,47812,47,9,9,14,1547,1547,1538,1538
Amador,1,2021-12-20,49,49,18,31,1716,1716,602,1114,2,0,0,3,70,70,70,70
Butte,1,2021-12-20,193,193,101,92,4386,4386,2286,2100,24,5,5,1,359,359,354,354
Calaveras,1,2021-12-20,59,59,23,36,1520,1520,582,938,1,2,2,0,92,92,90,90
Colusa,1,2021-12-20,11,11,5,6,397,397,170,227,1,0,0,0,21,21,21,21
Contra Costa,1,2021-12-20,1686,1686,590,1096,43207,43213,14842,28371,27,4,4,7,1080,1080,1076,1076
Del Norte,1,2021-12-20,19,19,8,11,1378,1378,570,808,0,0,0,0,42,42,42,42
El Dorado,1,2021-12-20,236,236,92,144,4467,4467,1729,2738,4,4,4,3,178,178,174,174
Fresno,1,2021-12-20,1054,1054,379,675,25401,25406,9044,16362,131,19,19,45,2420,2420,2401,2401
Glenn,1,2021-12-20,20,20,8,12,462,462,185,277,0,0,0,0,41,41,41,41
Humboldt,1,2021-12-20,164,164,67,97,3774,3774,1530,2244,11,1,1,2,120,120,119,119
Imperial,1,2021-12-20,585,585,225,360,5585,5585,2128,3457,40,9,9,27,817,817,808,808
Inyo,1,2021-12-20,31,31,14,17,358,358,154,204,1,1,1,0,49,49,48,48
Kern,1,2021-12-20,928,928,401,527,26094,26099,11163,14936,84,24,24,27,2023,2023,1999,1999
Kings,1,2021-12-20,244,244,94,150,6913,6913,2639,4274,15,6,6,3,387,387,381,381
Lake,1,2021-12-20,37,37,13,24,1317,1317,464,853,0,0,0,0,116,116,116,116
Lassen,1,2021-12-20,11,11,5,6,2387,2387,1093,1294,0,0,0,0,54,54,54,54
Los Angeles,1,2021-12-20,31638,31644,22020,9624,985575,985722,676328,309394,574,107,107,174,27373,27373,27266,27266
Madera,1,2021-12-20,159,159,56,103,6014,6014,2122,3892,9,3,3,5,334,334,331,331
Marin,1,2021-12-20,566,566,210,356,11811,11811,4295,7516,5,1,1,1,256,256,255,255
Mariposa,1,2021-12-20,21,21,7,14,448,448,154,294,0,0,0,0,21,21,21,21
Mendocino,1,2021-12-20,91,91,27,64,2687,2687,789,1898,3,2,2,4,103,103,101,101
Merced,1,2021-12-20,323,323,138,185,5616,5616,2366,3250,11,6,6,12,693,693,687,687
Modoc,1,2021-12-20,5,5,2,3,67,67,30,37,2,0,0,0,6,6,6,6
Mono,1,2021-12-20,37,37,10,27,310,310,80,230,1,0,0,0,4,4,4,4
Monterey,1,2021-12-20,479,479,125,354,13256,13256,3420,9836,23,3,3,8,642,642,639,639
Napa,1,2021-12-20,229,229,106,123,5390,5390,2432,2958,2,1,1,2,108,108,107,107
Nevada,1,2021-12-20,161,161,58,103,2765,2765,999,1766,4,1,1,2,110,110,109,109
Orange,1,2021-12-20,4860,4860,2402,2458,99353,99367,48399,50968,132,34,34,56,6005,6005,5971,5971
Placer,1,2021-12-20,547,547,187,360,11155,11155,3769,7386,53,6,6,24,501,501,495,495
Plumas,1,2021-12-20,16,16,6,10,513,513,195,318,0,0,0,0,12,12,12,12
Riverside,1,2021-12-20,5594,5594,2346,3248,78334,78347,32455,45892,238,40,40,82,5578,5578,5538,5538
Sacramento,1,2021-12-20,2144,2144,856,1288,54120,54128,21387,32741,101,21,21,41,2496,2496,2475,2475
San Benito,1,2021-12-20,92,92,41,51,1928,1928,860,1068,2,3,3,2,81,81,78,78
San Bernardino,1,2021-12-20,5005,5005,2366,2639,79687,79700,37182,42518,299,65,65,112,6506,6506,6441,6441
San Diego,1,2021-12-20,8680,8680,5932,2748,149614,149636,101541,48095,249,29,29,94,4479,4479,4450,4450
San Francisco,1,2021-12-20,2985,2985,740,2245,56980,56988,13802,43186,28,3,3,10,693,693,690,690
San Joaquin,1,2021-12-20,962,962,362,600,25357,25362,9407,15955,48,13,13,27,1972,1972,1959,1959
San Luis Obispo,1,2021-12-20,423,423,186,237,9999,9999,4352,5647,11,3,3,6,371,371,368,368
San Mateo,1,2021-12-20,1559,1559,770,789,50584,50591,24509,26082,9,0,0,5,601,601,601,601
Santa Barbara,1,2021-12-20,788,788,326,462,15818,15819,6435,9384,18,8,8,12,570,570,562,562
Santa Clara,1,2021-12-20,2950,2950,1982,968,118687,118705,78669,40036,85,8,8,38,1978,1978,1970,1970
Santa Cruz,1,2021-12-20,404,404,182,222,19811,19814,8759,11055,11,2,2,5,230,230,228,228
Shasta,1,2021-12-20,163,163,65,98,6035,6035,2392,3643,28,8,8,8,448,448,440,440
Siskiyou,1,2021-12-20,20,20,9,11,449,449,207,242,2,2,2,2,63,63,61,61
Solano,1,2021-12-20,496,496,207,289,14805,14805,6091,8714,21,4,4,5,389,389,385,385
Sonoma,1,2021-12-20,751,751,319,432,20780,20784,8670,12114,22,1,1,6,420,420,419,419
Stanislaus,1,2021-12-20,669,669,209,460,13027,13027,4037,8990,90,13,13,22,1431,1431,1418,1418
Sutter,1,2021-12-20,123,123,51,72,2314,2314,946,1368,0,2,2,0,193,193,191,191
Tehama,1,2021-12-20,52,52,17,35,1324,1324,425,899,4,0,0,3,165,165,165,165
Trinity,1,2021-12-20,1,1,0,1,98,98,31,67,0,1,1,0,19,19,18,18
Tulare,1,2021-12-20,403,403,125,278,12352,12353,3799,8554,36,19,19,13,1309,1309,1290,1290
Tuolumne,1,2021-12-20,97,97,35,62,1940,1940,693,1247,7,0,0,0,153,153,153,153
Ventura,1,2021-12-20,2046,2046,1052,994,39236,39241,19903,19338,62,9,9,14,1216,1216,1207,1207
Yolo,1,2021-12-20,318,318,141,177,24688,24693,10818,13875,4,0,0,1,296,296,296,296
Yuba,1,2021-12-20,99,99,42,57,1873,1873,799,1074,3,0,0,4,102,102,102,102
Alameda,2,2021-12-27,7503,7503,4021,3482,87311,87327,46158,41169,89,12,12,19,1559,1559,1547,1547
Amador,2,2021-12-27,92,92,38,54,1445,1445,590,855,2,0,0,3,70,70,70,70
Butte,2,2021-12-27,540,540,318,222,4554,4554,2664,1890,37,3,3,3,362,362,359,359
Calaveras,2,2021-12-27,100,100,45,55,989,989,442,547,1,1,1,1,93,93,92,92
Colusa,2,2021-12-27,27,27,14,13,243,243,119,124,4,0,0,0,21,21,21,21
Contra Costa,2,2021-12-27,5130,5130,2101,3029,46321,46331,18594,27737,44,3,3,16,1083,1083,1080,1080
Del Norte,2,2021-12-27,25,25,12,13,1423,1423,679,744,0,0,0,1,42,42,42,42
El Dorado,2,2021-12-27,514,514,232,282,4080,4080,1813,2267,7,0,0,4,178,178,178,178
Fresno,2,2021-12-27,2199,2199,930,1269,24262,24266,10101,14165,122,16,16,41,2436,2436,2420,2420
Glenn,2,2021-12-27,53,53,24,29,451,451,207,244,0,1,1,0,42,42,41,41
Humboldt,2,2021-12-27,500,500,237,263,3457,3457,1618,1839,10,1,1,0,121,121,120,120
Imperial,2,2021-12-27,881,881,396,485,5969,5969,2643,3326,35,10,10,26,827,827,817,817
Inyo,2,2021-12-27,109,109,54,55,447,447,219,228,0,1,1,0,50,50,49,49
Kern,2,2021-12-27,1988,1988,996,992,22591,22596,11167,11429,79,18,18,36,2041,2041,2023,2023
Kings,2,2021-12-27,505,505,229,276,5481,5481,2433,3048,17,1,1,3,388,388,387,387
Lake,2,2021-12-27,67,67,28,39,1203,1203,495,708,0,1,1,0,117,117,116,116
Lassen,2,2021-12-27,21,21,11,10,2242,2242,1160,1082,0,0,0,0,54,54,54,54
Los Angeles,2,2021-12-27,96108,96129,71594,24535,717649,717793,531006,186787,862,115,115,207,27488,27488,27373,27373
Madera,2,2021-12-27,341,341,144,197,4210,4210,1748,2462,9,2,2,4,336,336,334,334
Marin,2,2021-12-27,1607,1607,688,919,16780,16784,7088,9696,3,0,0,1,256,256,256,256
Mariposa,2,2021-12-27,36,36,15,21,493,493,195,298,0,0,0,0,21,21,21,21
Mendocino,2,2021-12-27,152,152,55,97,2496,2496,862,1634,5,0,0,2,103,103,103,103
Merced,2,2021-12-27,652,652,321,331,5104,5104,2473,2631,11,7,7,10,700,700,693,693
Modoc,2,2021-12-27,3,3,1,2,38,38,19,19,1,0,0,0,6,6,6,6
Mono,2,2021-12-27,123,123,38,85,366,366,110,256,1,0,0,0,4,4,4,4
Monterey,2,2021-12-27,1010,1010,319,691,12882,12884,3972,8912,21,3,3,11,645,645,642,642
Napa,2,2021-12-27,809,809,422,387,6660,6660,3443,3217,6,0,0,1,108,108,108,108
Nevada,2,2021-12-27,236,236,100,136,1984,1984,815,1169,6,1,1,1,111,111,110,110
Orange,2,2021-12-27,18028,18030,10057,7973,130272,130298,71855,58443,256,31,31,66,6036,6036,6005,6005
Placer,2,2021-12-27,1231,1231,494,737,10769,10770,4262,6508,63,2,2,27,503,503,501,501
Plumas,2,2021-12-27,18,18,8,10,299,299,129,170,0,0,0,0,12,12,12,12
Riverside,2,2021-12-27,13686,13687,6602,7085,87495,87512,41719,45793,306,53,53,81,5631,5631,5578,5578
Sacramento,2,2021-12-27,5195,5195,2412,2783,53053,53064,24272,28792,135,22,22,44,2518,2518,2496,2496
San Benito,2,2021-12-27,317,317,163,154,2307,2307,1173,1134,1,3,3,3,84,84,81,81
San Bernardino,2,2021-12-27,14357,14358,7714,6644,87888,87905,46461,41444,341,69,69,141,6575,6575,6506,6506
San Diego,2,2021-12-27,27104,27110,19924,7186,177584,177619,129657,47962,315,34,34,96,4513,4513,4479,4479
San Francisco,2,2021-12-27,6855,6855,2009,4846,65898,65910,19037,46873,31,1,1,14,694,694,693,693
San Joaquin,2,2021-12-27,2363,2363,1042,1321,22794,22798,9894,12904,61,15,15,25,1987,1987,1972,1972
San Luis Obispo,2,2021-12-27,1153,1153,583,570,11184,11185,5564,5621,11,1,1,8,372,372,371,371
San Mateo,2,2021-12-27,5280,5280,2931,2349,55506,55516,30381,25135,19,2,2,5,603,603,601,601
Santa Barbara,2,2021-12-27,2142,2142,1022,1120,15278,15281,7174,8107,33,5,5,10,575,575,570,570
Santa Clara,2,2021-12-27,9055,9056,6554,2502,106761,106784,76609,30175,95,10,10,38,1988,1988,1978,1978
Santa Cruz,2,2021-12-27,946,946,489,457,12416,12418,6302,6116,11,0,0,2,230,230,230,230
Shasta,2,2021-12-27,261,261,122,139,4624,4624,2123,2501,32,5,5,12,453,453,448,448
Siskiyou,2,2021-12-27,21,21,11,10,360,360,190,170,0,0,0,0,63,63,63,63
Solano,2,2021-12-27,1298,1298,626,672,17117,17121,8123,8998,25,5,5,5,394,394,389,389
Sonoma,2,2021-12-27,1913,1913,933,980,21661,21666,10425,11241,19,1,1,5,421,421,420,420
Stanislaus,2,2021-12-27,1252,1252,469,783,11152,11153,4115,7038,94,17,17,18,1448,1448,1431,1431
Sutter,2,2021-12-27,225,225,108,117,2131,2131,1006,1125,0,2,2,0,195,195,193,193
Tehama,2,2021-12-27,103,103,40,63,1106,1106,419,687,6,2,2,3,167,167,165,165
Trinity,2,2021-12-27,4,4,2,2,101,101,37,64,0,0,0,0,19,19,19,19
Tulare,2,2021-12-27,814,814,301,513,11118,11119,4058,7061,36,10,10,9,1319,1319,1309,1309
Tuolumne,2,2021-12-27,170,170,72,98,1670,1670,692,978,5,0,0,1,153,153,153,153
Ventura,2,2021-12-27,5720,5720,3307,2413,39327,39334,22504,16830,66,8,8,19,1224,1224,1216,1216
Yolo,2,2021-12-27,819,819,418,401,22113,22118,11081,11037,7,1,1,4,297,297,296,296
Yuba,2,2021-12-27,164,164,81,83,1534,1534,749,785,8,1,1,4,103,103,102,102
Alameda,3,2022-01-03,17643,17648,10475,7173,117219,117249,69447,47802,156,5,5,31,1564,1564,1559,1559
Amador,3,2022-01-03,218,218,104,114,2179,2179,1029,1150,5,1,1,2,71,71,70,70
Butte,3,2022-01-03,1200,1200,777,423,6876,6877,4434,2443,32,0,0,4,362,362,362,362
Calaveras,3,2022-01-03,232,232,120,112,1305,1305,666,639,0,1,1,1,94,94,93,93
Colusa,3,2022-01-03,48,48,26,22,393,393,217,176,5,0,0,0,21,21,21,21
Contra Costa,3,2022-01-03,13498,13501,6280,7221,69095,69113,32064,37049,76,10,10,21,1093,1093,1083,1083
Del Norte,3,2022-01-03,86,86,47,39,2132,2132,1143,989,0,0,0,0,42,42,42,42
El Dorado,3,2022-01-03,1282,1282,656,626,6063,6063,3080,2983,7,4,4,6,182,182,178,178
Fresno,3,2022-01-03,6420,6420,3083,3337,39131,39142,18686,20456,175,14,14,44,2450,2450,2436,2436
Glenn,3,2022-01-03,76,76,39,37,610,610,318,292,0,1,1,0,43,43,42,42
Humboldt,3,2022-01-03,880,880,470,410,5300,5300,2812,2488,9,1,1,3,122,122,121,121
Imperial,3,2022-01-03,1877,1877,955,922,9229,9230,4660,4570,35,14,14,29,841,841,827,827
Inyo,3,2022-01-03,265,265,147,118,713,713,394,319,3,0,0,0,50,50,50,50
Kern,3,2022-01-03,5836,5837,3272,2565,35873,35881,20001,15880,100,16,16,32,2057,2057,2041,2041
Kings,3,2022-01-03,1093,1093,560,533,8511,8512,4310,4202,13,3,3,5,391,391,388,388
Lake,3,2022-01-03,220,220,106,114,1776,1776,846,930,1,0,0,1,117,117,117,117
Lassen,3,2022-01-03,61,61,35,26,3119,3119,1806,1313,2,0,0,0,54,54,54,54
Los Angeles,3,2022-01-03,204071,204122,160534,43588,1086768,1087042,855205,231837,1937,149,149,303,27637,27637,27488,27488
Madera,3,2022-01-03,829,829,397,432,6362,6362,3024,3338,17,3,3,6,339,339,336,336
Marin,3,2022-01-03,2367,2367,1150,1217,17675,17679,8534,9145,15,1,1,3,257,257,256,256
Mariposa,3,2022-01-03,103,103,48,55,657,657,304,353,0,0,0,0,21,21,21,21
Mendocino,3,2022-01-03,452,452,186,266,3572,3572,1454,2118,7,1,1,2,104,104,103,103
Merced,3,2022-01-03,1548,1548,850,698,8548,8549,4667,3882,3,9,9,4,709,709,700,700
Modoc,3,2022-01-03,15,15,8,7,59,59,33,26,0,0,0,0,6,6,6,6
Mono,3,2022-01-03,180,180,65,115,435,435,156,279,2,0,0,0,4,4,4,4
Monterey,3,2022-01-03,2461,2461,906,1555,20637,20643,7549,13094,30,4,4,10,649,649,645,645
Napa,3,2022-01-03,1855,1855,1075,780,11755,11757,6790,4967,9,1,1,3,109,109,108,108
Nevada,3,2022-01-03,646,646,313,333,3070,3070,1485,1585,7,1,1,3,112,112,111,111
Orange,3,2022-01-03,45440,45452,27773,17679,220122,220177,134331,85846,504,33,33,110,6069,6069,6036,6036
Placer,3,2022-01-03,2871,2871,1316,1555,15070,15074,6864,8210,113,15,15,24,518,518,503,503
Plumas,3,2022-01-03,54,54,27,27,496,496,248,248,1,0,0,0,12,12,12,12
Riverside,3,2022-01-03,32031,32038,17304,14734,138444,138478,74462,64016,564,54,54,94,5685,5685,5631,5631
Sacramento,3,2022-01-03,14134,14137,7382,6755,81272,81293,42248,39045,219,25,25,57,2543,2543,2518,2518
San Benito,3,2022-01-03,738,738,421,317,3465,3465,1977,1488,3,1,1,2,85,85,84,84
San Bernardino,3,2022-01-03,33808,33816,20002,13814,135022,135055,79603,55452,571,92,92,136,6667,6667,6575,6575
San Diego,3,2022-01-03,61076,61091,47458,13633,253607,253670,196964,56706,561,33,33,121,4546,4546,4513,4513
San Francisco,3,2022-01-03,11424,11425,3968,7457,85501,85522,29510,56012,78,5,5,22,699,699,694,694
San Joaquin,3,2022-01-03,6976,6977,3479,3498,36157,36166,17918,18248,80,13,13,27,2000,2000,1987,1987
San Luis Obispo,3,2022-01-03,2474,2474,1387,1087,15976,15980,8927,7053,24,5,5,7,377,377,372,372
San Mateo,3,2022-01-03,10631,10632,6509,4123,81916,81937,50070,31867,37,4,4,7,607,607,603,603
Santa Barbara,3,2022-01-03,5322,5322,2849,2473,28185,28192,15052,13140,53,5,5,7,580,580,575,575
Santa Clara,3,2022-01-03,23029,23037,17710,5327,169862,169906,130434,39472,186,10,10,58,1998,1998,1988,1988
Santa Cruz,3,2022-01-03,2405,2405,1385,1020,21654,21660,12484,9176,15,5,5,3,235,235,230,230
Shasta,3,2022-01-03,601,601,318,283,6174,6175,3229,2946,33,2,2,13,455,455,453,453
Siskiyou,3,2022-01-03,74,74,44,30,590,590,348,242,0,0,0,0,63,63,63,63
Solano,3,2022-01-03,4068,4068,2178,1890,26243,26249,14043,12206,54,2,2,9,396,396,394,394
Sonoma,3,2022-01-03,4540,4540,2480,2060,32188,32195,17533,14662,25,7,7,4,428,428,421,421
Stanislaus,3,2022-01-03,3332,3332,1435,1897,17994,17998,7694,10304,129,9,9,20,1457,1457,1448,1448
Sutter,3,2022-01-03,547,547,296,251,2980,2980,1594,1386,0,2,2,0,197,197,195,195
Tehama,3,2022-01-03,213,213,95,118,1465,1465,648,817,4,1,1,2,168,168,167,167
Trinity,3,2022-01-03,13,13,6,7,107,107,46,61,0,0,0,0,19,19,19,19
Tulare,3,2022-01-03,2125,2125,910,1215,16016,16020,6781,9239,57,5,5,7,1324,1324,1319,1319
Tuolumne,3,2022-01-03,383,383,186,197,2544,2544,1227,1317,7,3,3,0,156,156,153,153
Ventura,3,2022-01-03,12666,12667,7984,4683,59651,59665,37556,22109,136,11,11,28,1235,1235,1224,1224
Yolo,3,2022-01-03,2315,2315,1320,995,31691,31698,17930,13768,8,4,4,3,301,301,297,297
Yuba,3,2022-01-03,472,472,262,210,2334,2334,1286,1048,17,1,1,6,104,104,103,103
Alameda,4,2022-01-10,31200,31212,20221,10991,193862,193923,125763,68160,277,14,14,46,1578,1578,1564,1564
Amador,4,2022-01-10,391,391,209,182,2726,2726,1447,1279,4,0,0,4,71,71,71,71
Butte,4,2022-01-10,1999,1999,1395,604,10461,10465,7291,3174,55,2,2,4,364,364,362,362
Calaveras,4,2022-01-10,523,523,299,224,2608,2608,1479,1129,0,1,1,2,95,95,94,94
Colusa,4,2022-01-10,105,105,65,40,756,756,462,294,5,0,0,0,21,21,21,21
Contra Costa,4,2022-01-10,19683,19690,10313,9377,102198,102230,53532,48698,152,12,12,24,1105,1105,1093,1093
Del Norte,4,2022-01-10,178,178,106,72,3958,3958,2363,1595,2,0,0,0,42,42,42,42
El Dorado,4,2022-01-10,2219,2219,1263,956,9359,9362,5324,4038,14,6,6,2,188,188,182,182
Fresno,4,2022-01-10,13171,13176,7121,6055,60607,60626,32693,27933,301,14,14,47,2464,2464,2450,2450
Glenn,4,2022-01-10,219,219,127,92,938,938,544,394,2,0,0,0,43,43,43,43
Humboldt,4,2022-01-10,1401,1401,827,574,8363,8364,4930,3434,18,5,5,2,127,127,122,122
Imperial,4,2022-01-10,3623,3623,2047,1576,13951,13956,7869,6087,58,11,11,25,852,852,841,841
Inyo,4,2022-01-10,408,408,248,160,1356,1356,826,530,4,2,2,0,52,52,50,50
Kern,4,2022-01-10,11939,11944,7345,4599,57116,57135,35094,22041,181,26,26,35,2083,2083,2057,2057
Kings,4,2022-01-10,2415,2415,1382,1033,13013,13018,7404,5614,33,1,1,4,392,392,391,391
Lake,4,2022-01-10,499,499,268,231,2761,2761,1477,1284,0,3,3,1,120,120,117,117
Lassen,4,2022-01-10,194,194,124,70,3438,3438,2185,1253,1,0,0,0,54,54,54,54
Los Angeles,4,2022-01-10,328913,329016,270802,58214,1914392,1914995,1576701,338294,3253,270,270,513,27907,27907,27637,27637
Madera,4,2022-01-10,1910,1910,1027,883,10380,10383,5548,4835,19,1,1,6,340,340,339,339
Marin,4,2022-01-10,2938,2938,1600,1338,21014,21021,11443,9578,18,3,3,5,260,260,257,257
Mariposa,4,2022-01-10,199,199,105,94,1158,1158,607,551,0,1,1,0,22,22,21,21
Mendocino,4,2022-01-10,875,875,411,464,5535,5535,2580,2955,8,2,2,2,106,106,104,104
Merced,4,2022-01-10,3687,3687,2232,1455,14529,14534,8786,5748,33,10,10,11,719,719,709,709
Modoc,4,2022-01-10,13,13,8,5,109,109,67,42,0,0,0,0,6,6,6,6
Mono,4,2022-01-10,253,253,106,147,863,863,360,503,1,1,1,0,5,5,4,4
Monterey,4,2022-01-10,4976,4976,2115,2861,33232,33243,14056,19187,44,5,5,12,654,654,649,649
Napa,4,2022-01-10,2647,2647,1680,967,14352,14357,9106,5251,14,1,1,4,110,110,109,109
Nevada,4,2022-01-10,1185,1185,644,541,5232,5233,2839,2394,10,2,2,3,114,114,112,112
Orange,4,2022-01-10,60030,60049,39969,20080,317553,317654,211499,106155,854,100,100,159,6169,6169,6069,6069
Placer,4,2022-01-10,5231,5231,2710,2521,22559,22565,11671,10894,179,6,6,29,524,524,518,518
Plumas,4,2022-01-10,142,142,79,63,803,803,446,357,5,0,0,0,12,12,12,12
Riverside,4,2022-01-10,48247,48262,28853,19409,187730,187790,112235,75555,762,83,83,139,5768,5768,5685,5685
Sacramento,4,2022-01-10,27504,27512,15920,11592,122852,122891,71122,51769,375,37,37,89,2580,2580,2543,2543
San Benito,4,2022-01-10,1039,1039,655,384,4614,4614,2908,1706,3,1,1,2,86,86,85,85
San Bernardino,4,2022-01-10,50656,50672,32825,17847,192688,192747,124804,67943,784,113,113,187,6780,6780,6667,6667
San Diego,4,2022-01-10,82760,82787,67456,15331,330017,330121,269028,61093,895,65,65,166,4611,4611,4546,4546
San Francisco,4,2022-01-10,15083,15088,6031,9057,117249,117286,46955,70331,158,12,12,35,711,711,699,699
San Joaquin,4,2022-01-10,14508,14513,8087,6426,66894,66915,37224,29691,151,15,15,45,2015,2015,2000,2000
San Luis Obispo,4,2022-01-10,4334,4334,2674,1660,21642,21648,13373,8275,30,2,2,7,379,379,377,377
San Mateo,4,2022-01-10,15006,15011,9998,5013,113003,113039,75285,37754,95,5,5,16,612,612,607,607
Santa Barbara,4,2022-01-10,8535,8536,5053,3483,47379,47393,28058,19335,84,9,9,10,589,589,580,580
Santa Clara,4,2022-01-10,36515,36527,29477,7050,270807,270893,218561,52332,350,26,26,68,2024,2024,1998,1998
Santa Cruz,4,2022-01-10,4540,4540,2860,1680,42805,42818,26981,15837,25,2,2,2,237,237,235,235
Shasta,4,2022-01-10,1055,1055,616,439,8404,8405,4893,3512,37,7,7,12,462,462,455,455
Siskiyou,4,2022-01-10,120,120,77,43,919,919,591,328,3,1,1,1,64,64,63,63
Solano,4,2022-01-10,6915,6915,4120,2795,37251,37264,22215,15049,94,6,6,15,402,402,396,396
Sonoma,4,2022-01-10,8860,8863,5340,3523,47197,47212,28461,18751,72,9,9,8,437,437,428,428
Stanislaus,4,2022-01-10,6738,6739,3301,3438,29320,29329,14329,15000,173,13,13,19,1470,1470,1457,1457
Sutter,4,2022-01-10,1245,1245,743,502,5062,5062,3006,2056,0,2,2,0,199,199,197,197
Tehama,4,2022-01-10,512,512,257,255,2482,2482,1241,1241,13,1,1,1,169,169,168,168
Trinity,4,2022-01-10,38,38,19,19,275,275,135,140,0,0,0,0,19,19,19,19
Tulare,4,2022-01-10,5189,5190,2529,2661,24097,24103,11685,12418,66,9,9,8,1333,1333,1324,1324
Tuolumne,4,2022-01-10,804,804,435,369,4178,4178,2257,1921,13,1,1,1,157,157,156,156
Ventura,4,2022-01-10,17504,17510,11974,5536,88197,88225,60310,27915,227,23,23,34,1258,1258,1235,1235
Yolo,4,2022-01-10,3762,3762,2342,1420,48234,48249,30006,18243,6,4,4,1,305,305,301,301
Yuba,4,2022-01-10,1022,1022,624,398,4107,4107,2504,1603,41,0,0,7,104,104,104,104
Alameda,5,2022-01-17,24872,24883,17455,7428,170562,170634,119630,51004,366,32,32,62,1610,1610,1578,1578
Amador,5,2022-01-17,476,476,282,194,3558,3558,2081,1477,10,2,2,3,73,73,71,71
Butte,5,2022-01-17,2062,2062,1537,525,9334,9339,6958,2381,58,6,6,6,370,370,364,364
Calaveras,5,2022-01-17,564,564,353,211,2473,2473,1543,930,3,2,2,3,97,97,95,95
Colusa,5,2022-01-17,161,161,107,54,719,719,476,243,3,0,0,0,21,21,21,21
Contra Costa,5,2022-01-17,16183,16190,9453,6737,87991,88027,51313,36714,198,22,22,41,1127,1127,1105,1105
Del Norte,5,2022-01-17,200,200,131,69,3758,3759,2430,1329,2,0,0,1,42,42,42,42
El Dorado,5,2022-01-17,1963,1963,1227,736,8066,8070,5046,3024,9,4,4,2,192,192,188,188
Fresno,5,2022-01-17,16986,16992,10180,6812,66652,66681,39900,26781,386,27,27,61,2491,2491,2464,2464
Glenn,5,2022-01-17,307,307,194,113,1076,1076,683,393,3,2,2,0,45,45,43,43
Humboldt,5,2022-01-17,1140,1140,736,404,8326,8330,5370,2960,10,1,1,4,128,128,127,127
Imperial,5,2022-01-17,3409,3409,2120,1289,13364,13369,8311,5058,69,12,12,29,864,864,852,852
Inyo,5,2022-01-17,327,327,216,111,1040,1040,688,352,4,0,0,0,52,52,52,52
Kern,5,2022-01-17,11690,11695,7804,3891,51820,51841,34552,17289,242,29,29,44,2112,2112,2083,2083
Kings,5,2022-01-17,3193,3193,1994,1199,14869,14874,9263,5611,40,4,4,1,396,396,392,392
Lake,5,2022-01-17,583,583,348,235,3246,3246,1936,1310,2,1,1,2,121,121,120,120
Lassen,5,2022-01-17,283,283,195,88,3322,3322,2278,1044,0,0,0,0,54,54,54,54
Los Angeles,5,2022-01-17,218271,218363,186804,31559,1610009,1610682,1376958,233724,4034,504,504,680,28411,28411,27907,27907
Madera,5,2022-01-17,2394,2394,1428,966,10612,10617,6305,4312,32,5,5,10,345,345,340,340
Marin,5,2022-01-17,2420,2420,1461,959,17708,17716,10686,7030,38,4,4,6,264,264,260,260
Mariposa,5,2022-01-17,163,163,95,68,1115,1115,648,467,0,0,0,0,22,22,22,22
Mendocino,5,2022-01-17,921,921,486,435,5015,5015,2630,2385,18,3,3,2,109,109,106,106
Merced,5,2022-01-17,3917,3917,2582,1335,13641,13646,8994,4652,41,18,18,11,737,737,719,719
Modoc,5,2022-01-17,13,13,9,4,102,102,68,34,0,1,1,0,7,7,6,6
Mono,5,2022-01-17,198,198,94,104,809,809,386,423,2,0,0,0,5,5,5,5
Monterey,5,2022-01-17,5896,5896,2857,3039,28329,28341,13716,14625,69,6,6,14,660,660,654,654
Napa,5,2022-01-17,1927,1927,1327,600,11914,11919,8180,3739,21,2,2,5,112,112,110,110
Nevada,5,2022-01-17,1251,1251,751,500,5430,5431,3262,2169,19,1,1,1,115,115,114,114
Orange,5,2022-01-17,41280,41298,29623,11675,251451,251557,180274,71283,998,111,111,199,6280,6280,6169,6169
Placer,5,2022-01-17,4326,4326,2498,1828,19473,19481,11228,8253,178,14,14,36,538,538,524,524
Plumas,5,2022-01-17,193,193,119,74,852,852,524,328,3,0,0,0,12,12,12,12
Riverside,5,2022-01-17,41233,41251,26967,14284,168039,168110,109914,58196,920,97,97,158,5865,5865,5768,5768
Sacramento,5,2022-01-17,21454,21464,13659,7805,102478,102522,65168,37354,473,64,64,97,2644,2644,2580,2580
San Benito,5,2022-01-17,903,903,618,285,4271,4271,2921,1350,4,1,1,4,87,87,86,86
San Bernardino,5,2022-01-17,38527,38543,26962,11581,164313,164381,114986,49395,936,144,144,227,6924,6924,6780,6780
San Diego,5,2022-01-17,60733,60759,51576,9183,265915,266026,225838,40188,1067,101,101,193,4712,4712,4611,4611
San Francisco,5,2022-01-17,11260,11266,5203,6063,94038,94077,43335,50742,212,14,14,44,725,725,711,711
San Joaquin,5,2022-01-17,12718,12723,7806,4917,58136,58160,35688,22472,201,20,20,57,2035,2035,2015,2015
San Luis Obispo,5,2022-01-17,3933,3933,2646,1287,21036,21045,14141,6904,46,12,12,10,391,391,379,379
San Mateo,5,2022-01-17,12472,12478,8941,3537,95911,95950,68671,27279,92,10,10,30,622,622,612,612
Santa Barbara,5,2022-01-17,6849,6850,4444,2406,40485,40502,26241,14261,123,12,12,12,601,601,589,589
Santa Clara,5,2022-01-17,29588,29600,24905,4695,235491,235590,198101,37489,451,24,24,84,2048,2048,2024,2024
Santa Cruz,5,2022-01-17,4181,4181,2866,1315,42199,42218,28872,13346,23,3,3,3,240,240,237,237
Shasta,5,2022-01-17,1345,1345,862,483,9163,9168,5847,3321,55,7,7,14,469,469,462,462
Siskiyou,5,2022-01-17,158,158,110,48,927,927,640,287,3,1,1,2,65,65,64,64
Solano,5,2022-01-17,6430,6431,4197,2234,35309,35324,23052,12272,121,6,6,22,408,408,402,402
Sonoma,5,2022-01-17,7620,7624,5023,2601,42777,42795,28143,14652,73,7,7,15,444,444,437,437
Stanislaus,5,2022-01-17,7325,7329,4019,3310,29058,29070,15922,13148,206,10,10,31,1480,1480,1470,1470
Sutter,5,2022-01-17,1246,1246,810,436,4863,4863,3161,1702,0,4,4,0,203,203,199,199
Tehama,5,2022-01-17,614,614,343,271,2420,2420,1349,1071,15,5,5,2,174,174,169,169
Trinity,5,2022-01-17,41,41,23,18,255,255,140,115,0,1,1,0,20,20,19,19
Tulare,5,2022-01-17,7449,7453,4057,3396,27113,27125,14744,12381,97,16,16,16,1349,1349,1333,1333
Tuolumne,5,2022-01-17,884,884,530,354,3836,3836,2287,1549,10,8,8,1,165,165,157,157
Ventura,5,2022-01-17,11972,11977,8782,3195,66926,66953,49032,17921,300,41,41,56,1299,1299,1258,1258
Yolo,5,2022-01-17,2802,2802,1897,905,39489,39505,26711,12794,15,4,4,4,309,309,305,305
Yuba,5,2022-01-17,1063,1063,706,357,3750,3750,2491,1259,42,2,2,6,106,106,104,104
Alameda,6,2022-01-24,19840,19852,14904,4948,171863,171954,129267,42687,373,41,41,68,1651,1651,1610,1610
Amador,6,2022-01-24,545,545,353,192,4667,4668,3020,1648,8,0,0,5,73,73,73,73
Butte,6,2022-01-24,1903,1903,1500,403,9611,9616,7597,2019,82,10,10,9,380,380,370,370
Calaveras,6,2022-01-24,556,556,378,178,2507,2507,1705,802,6,2,2,2,99,99,97,97
Colusa,6,2022-01-24,177,177,127,50,952,952,681,271,6,0,0,0,21,21,21,21
Contra Costa,6,2022-01-24,13549,13556,8712,4844,85290,85334,54899,30435,217,25,25,64,1152,1152,1127,1127
Del Norte,6,2022-01-24,348,348,246,102,4326,4328,3044,1284,3,0,0,3,42,42,42,42
El Dorado,6,2022-01-24,1406,1406,958,448,7335,7340,5008,2332,17,2,2,6,194,194,192,192
Fresno,6,2022-01-24,17421,17430,11421,6009,69425,69463,45598,23865,491,43,43,83,2534,2534,2491,2491
Glenn,6,2022-01-24,249,249,172,77,971,971,670,301,0,0,0,0,45,45,45,45
Humboldt,6,2022-01-24,915,915,641,274,7722,7727,5418,2309,25,3,3,3,131,131,128,128
Imperial,6,2022-01-24,3612,3612,2452,1160,13311,13317,9057,4260,70,14,14,27,878,878,864,864
Inyo,6,2022-01-24,142,142,102,40,625,625,449,176,1,1,1,0,53,53,52,52
Kern,6,2022-01-24,10559,10564,7606,2958,53955,53982,38915,15067,267,47,47,51,2159,2159,2112,2112
Kings,6,2022-01-24,4301,4302,2922,1380,19069,19078,12986,6092,40,4,4,4,400,400,396,396
Lake,6,2022-01-24,746,746,488,258,3417,3418,2235,1183,6,2,2,3,123,123,121,121
Lassen,6,2022-01-24,418,418,307,111,3982,3983,2933,1050,6,0,0,0,54,54,54,54
Los Angeles,6,2022-01-24,164796,164881,145647,19234,1658928,1659792,1467203,192589,3769,611,611,785,29022,29022,28411,28411
Madera,6,2022-01-24,2708,2708,1766,942,12170,12176,7941,4235,49,7,7,10,352,352,345,345
Marin,6,2022-01-24,1856,1856,1227,629,17550,17561,11617,5944,38,4,4,10,268,268,264,264
Mariposa,6,2022-01-24,134,134,86,48,946,946,606,340,0,0,0,0,22,22,22,22
Mendocino,6,2022-01-24,917,917,538,379,4873,4874,2855,2019,23,2,2,3,111,111,109,109
Merced,6,2022-01-24,3158,3158,2253,905,12910,12915,9220,3695,55,9,9,12,746,746,737,737
Modoc,6,2022-01-24,14,14,10,4,114,114,82,32,2,0,0,0,7,7,7,7
Mono,6,2022-01-24,97,97,52,45,422,422,227,195,1,0,0,0,5,5,5,5
Monterey,6,2022-01-24,5079,5080,2770,2310,31797,31813,17343,14470,80,9,9,17,669,669,660,660
Napa,6,2022-01-24,1672,1672,1236,436,12465,12471,9210,3261,23,5,5,4,117,117,112,112
Nevada,6,2022-01-24,999,999,658,341,4807,4808,3172,1636,29,1,1,6,116,116,115,115
Orange,6,2022-01-24,26657,26671,20382,6289,230895,231014,176787,54227,923,175,175,191,6455,6455,6280,6280
Placer,6,2022-01-24,3658,3658,2328,1330,18651,18661,11878,6783,215,8,8,43,546,546,538,538
Plumas,6,2022-01-24,215,215,144,71,836,836,559,277,5,0,0,0,12,12,12,12
Riverside,6,2022-01-24,31897,31912,22579,9333,158779,158863,112523,46340,901,122,122,168,5987,5987,5865,5865
Sacramento,6,2022-01-24,17498,17508,12115,5393,99859,99910,69169,30741,542,63,63,105,2707,2707,2644,2644
San Benito,6,2022-01-24,776,776,570,206,3926,3926,2887,1039,7,1,1,3,88,88,87,87
San Bernardino,6,2022-01-24,28098,28112,21067,7045,153565,153646,115257,38389,975,170,170,223,7094,7094,6924,6924
San Diego,6,2022-01-24,51531,51558,45251,6307,252111,252242,221636,30606,1056,129,129,232,4841,4841,4712,4712
San Francisco,6,2022-01-24,8096,8101,4235,3866,88978,89024,46595,42429,232,19,19,37,744,744,725,725
San Joaquin,6,2022-01-24,11039,11044,7397,3647,59117,59147,39694,19453,241,34,34,71,2069,2069,2035,2035
San Luis Obispo,6,2022-01-24,3562,3562,2583,979,21537,21547,15625,5922,42,10,10,12,401,401,391,391
San Mateo,6,2022-01-24,8501,8506,6498,2008,95143,95193,72782,22411,139,19,19,28,641,641,622,622
Santa Barbara,6,2022-01-24,6483,6487,4561,1926,43827,43850,30839,13011,127,12,12,19,613,613,601,601
Santa Clara,6,2022-01-24,22809,22821,19903,2918,233015,233135,203308,29827,412,48,48,88,2096,2096,2048,2048
Santa Cruz,6,2022-01-24,5038,5039,3706,1333,45614,45638,33587,12051,31,1,1,2,241,241,240,240
Shasta,6,2022-01-24,1484,1484,1031,453,10137,10142,7037,3105,78,7,7,9,476,476,469,469
Siskiyou,6,2022-01-24,159,159,118,41,857,857,635,222,6,3,3,1,68,68,65,65
Solano,6,2022-01-24,5125,5127,3627,1500,32759,32776,23199,9577,143,14,14,26,422,422,408,408
Sonoma,6,2022-01-24,6916,6921,4927,1994,42488,42510,30272,12238,94,7,7,18,451,451,444,444
Stanislaus,6,2022-01-24,6369,6373,3875,2498,28270,28285,17222,11063,277,27,27,44,1507,1507,1480,1480
Sutter,6,2022-01-24,1046,1046,736,310,5001,5003,3522,1481,0,2,2,0,205,205,203,203
Tehama,6,2022-01-24,576,576,356,220,2702,2702,1674,1028,19,4,4,5,178,178,174,174
Trinity,6,2022-01-24,63,63,38,25,322,322,196,126,0,0,0,0,20,20,20,20
Tulare,6,2022-01-24,7643,7648,4614,3034,29546,29562,17874,11688,138,11,11,14,1360,1360,1349,1349
Tuolumne,6,2022-01-24,950,950,626,324,3824,3824,2508,1316,17,3,3,3,168,168,165,165
Ventura,6,2022-01-24,9409,9414,7333,2081,68515,68550,53451,15099,269,28,28,68,1327,1327,1299,1299
Yolo,6,2022-01-24,2297,2297,1675,622,40471,40492,29523,10969,18,12,12,5,321,321,309,309
Yuba,6,2022-01-24,911,911,653,258,3780,3780,2711,1069,54,3,3,10,109,109,106,106
Alameda,7,2022-01-31,11026,11032,8768,2264,137354,137437,109363,28074,336,50,50,75,1701,1701,1651,1651
Amador,7,2022-01-31,347,347,244,103,3228,3228,2275,953,15,1,1,4,74,74,73,73
Butte,7,2022-01-31,1167,1167,966,201,7615,7620,6315,1305,80,6,6,7,386,386,380,380
Calaveras,7,2022-01-31,263,263,193,70,1940,1940,1424,516,3,5,5,2,104,104,99,99
Colusa,7,2022-01-31,106,106,81,25,704,704,540,164,9,0,0,0,21,21,21,21
Contra Costa,7,2022-01-31,7303,7308,5095,2213,68618,68659,47943,20716,207,39,39,54,1191,1191,1152,1152
Del Norte,7,2022-01-31,315,315,237,78,3957,3959,2979,980,6,2,2,2,44,44,42,42
El Dorado,7,2022-01-31,741,741,544,197,6023,6028,4427,1601,13,4,4,5,198,198,194,194
Fresno,7,2022-01-31,10888,10894,7726,3168,55372,55403,39345,16058,503,39,39,98,2573,2573,2534,2534
Glenn,7,2022-01-31,189,189,140,49,759,759,563,196,2,2,2,0,47,47,45,45
Humboldt,7,2022-01-31,585,585,440,145,5794,5798,4354,1444,18,3,3,3,134,134,131,131
Imperial,7,2022-01-31,2192,2192,1598,594,11378,11383,8322,3061,71,17,17,28,895,895,878,878
Inyo,7,2022-01-31,55,55,42,13,467,467,357,110,5,3,3,0,56,56,53,53
Kern,7,2022-01-31,5645,5649,4340,1309,42263,42288,32522,9766,264,47,47,54,2206,2206,2159,2159
Kings,7,2022-01-31,2388,2388,1747,641,13693,13702,10033,3669,55,5,5,4,405,405,400,400
Lake,7,2022-01-31,478,478,338,140,3193,3194,2259,935,4,4,4,4,127,127,123,123
Lassen,7,2022-01-31,311,311,243,68,3624,3624,2838,786,7,1,1,0,55,55,54,54
Los Angeles,7,2022-01-31,74538,74582,67649,6933,1302674,1303458,1183096,120362,2991,640,640,719,29662,29662,29022,29022
Madera,7,2022-01-31,1740,1740,1230,510,9629,9634,6818,2816,50,6,6,7,358,358,352,352
Marin,7,2022-01-31,1063,1063,759,304,13831,13839,9904,3935,26,5,5,9,273,273,268,268
Mariposa,7,2022-01-31,101,101,70,31,840,840,584,256,0,2,2,0,24,24,22,22
Mendocino,7,2022-01-31,463,463,299,164,3486,3486,2252,1234,12,3,3,4,114,114,111,111
Merced,7,2022-01-31,2110,2110,1606,504,10464,10469,7978,2491,54,12,12,14,758,758,746,746
Modoc,7,2022-01-31,12,12,9,3,89,89,68,21,1,0,0,0,7,7,7,7
Mono,7,2022-01-31,41,41,25,16,339,339,203,136,0,0,0,0,5,5,5,5
Monterey,7,2022-01-31,3557,3557,2153,1404,26745,26762,16241,10521,82,9,9,13,678,678,669,669
Napa,7,2022-01-31,988,988,776,212,9376,9381,7358,2023,17,7,7,10,124,124,117,117
Nevada,7,2022-01-31,565,565,401,164,3912,3913,2789,1124,26,3,3,5,119,119,116,116
Orange,7,2022-01-31,11984,11990,9673,2317,177028,177134,143014,34120,708,169,169,164,6624,6624,6455,6455
Placer,7,2022-01-31,2263,2263,1565,698,15385,15395,10661,4734,152,19,19,42,565,565,546,546
Plumas,7,2022-01-31,137,137,98,39,753,753,542,211,1,0,0,0,12,12,12,12
Riverside,7,2022-01-31,15939,15949,12054,3895,121039,121112,91744,29368,740,111,111,171,6098,6098,5987,5987
Sacramento,7,2022-01-31,10171,10176,7551,2625,78392,78440,58288,20152,501,92,92,106,2799,2799,2707,2707
San Benito,7,2022-01-31,470,470,367,103,3319,3319,2593,726,5,2,2,3,90,90,88,88
San Bernardino,7,2022-01-31,13248,13256,10520,2736,116537,116606,92648,23958,744,185,185,207,7279,7279,7094,7094
San Diego,7,2022-01-31,24897,24912,22476,2436,181377,181486,163886,17600,944,105,105,214,4946,4946,4841,4841
San Francisco,7,2022-01-31,4040,4041,2356,1685,69225,69267,40460,28807,208,24,24,45,768,768,744,744
San Joaquin,7,2022-01-31,5702,5707,4129,1578,43687,43713,31690,12023,210,36,36,75,2105,2105,2069,2069
San Luis Obispo,7,2022-01-31,1978,1978,1527,451,16252,16260,12560,3700,40,12,12,10,413,413,401,401
San Mateo,7,2022-01-31,4309,4310,3474,836,75104,75149,60604,14545,131,10,10,19,651,651,641,641
Santa Barbara,7,2022-01-31,3634,3634,2733,901,35024,35044,26399,8645,103,23,23,13,636,636,613,613
Santa Clara,7,2022-01-31,13851,13860,12437,1423,206808,206932,185736,21196,427,54,54,93,2150,2150,2096,2096
Santa Cruz,7,2022-01-31,3436,3436,2678,758,51416,51446,40170,11276,35,5,5,6,246,246,241,241
Shasta,7,2022-01-31,900,900,670,230,8420,8425,6273,2152,59,14,14,11,490,490,476,476
Siskiyou,7,2022-01-31,119,119,94,25,691,691,545,146,8,2,2,2,70,70,68,68
Solano,7,2022-01-31,3811,3811,2884,927,28815,28833,21819,7014,126,6,6,30,428,428,422,422
Sonoma,7,2022-01-31,3570,3571,2712,859,32148,32167,24468,7699,84,12,12,15,463,463,451,451
Stanislaus,7,2022-01-31,3692,3692,2461,1231,22314,22327,14911,7416,261,33,33,53,1540,1540,1507,1507
Sutter,7,2022-01-31,618,618,465,153,3764,3765,2837,928,0,4,4,0,209,209,205,205
Tehama,7,2022-01-31,378,378,256,122,2022,2022,1368,654,17,2,2,5,180,180,178,178
Trinity,7,2022-01-31,43,43,29,14,227,227,151,76,0,0,0,0,20,20,20,20
Tulare,7,2022-01-31,4676,4677,3092,1585,22923,22937,15197,7740,150,22,22,21,1382,1382,1360,1360
Tuolumne,7,2022-01-31,708,708,501,207,3266,3266,2316,950,12,2,2,4,170,170,168,168
Ventura,7,2022-01-31,4601,4602,3769,833,52324,52357,42928,9429,253,39,39,48,1366,1366,1327,1327
Yolo,7,2022-01-31,1351,1351,1048,303,37506,37530,29122,8408,19,5,5,5,326,326,321,321
Yuba,7,2022-01-31,523,523,400,123,2931,2931,2243,688,78,2,2,11,111,111,109,109
Alameda,8,2022-02-07,5972,5977,4977,1000,115645,115725,96417,19308,254,45,45,62,1746,1746,1701,1701
Amador,8,2022-02-07,205,205,154,51,2907,2907,2186,721,14,4,4,5,78,78,74,74
Butte,8,2022-02-07,782,782,673,109,6398,6403,5514,889,74,8,8,12,394,394,386,386
Calaveras,8,2022-02-07,182,182,142,40,1427,1427,1112,315,2,2,2,1,106,106,104,104
Colusa,8,2022-02-07,71,71,57,14,555,555,449,106,0,0,0,0,21,21,21,21
Contra Costa,8,2022-02-07,4128,4130,3088,1042,54143,54181,40527,13654,149,32,32,52,1223,1223,1191,1191
Del Norte,8,2022-02-07,285,285,228,57,4003,4004,3184,820,5,0,0,0,44,44,44,44
El Dorado,8,2022-02-07,429,429,335,94,5035,5039,3931,1108,20,1,1,5,199,199,198,198
Fresno,8,2022-02-07,6307,6312,4781,1531,42971,42999,32614,10385,450,49,49,87,2622,2622,2573,2573
Glenn,8,2022-02-07,113,113,88,25,620,620,488,132,4,3,3,0,50,50,47,47
Humboldt,8,2022-02-07,468,468,372,96,4878,4882,3880,1002,15,1,1,2,135,135,134,134
Imperial,8,2022-02-07,1094,1094,850,244,8000,8005,6224,1781,46,12,12,26,907,907,895,895
Inyo,8,2022-02-07,38,38,30,8,447,447,361,86,5,0,0,0,56,56,56,56
Kern,8,2022-02-07,3474,3475,2813,662,34663,34686,28112,6574,190,32,32,43,2238,2238,2206,2206
Kings,8,2022-02-07,1350,1350,1050,300,10256,10262,7987,2275,52,14,14,5,419,419,405,405
Lake,8,2022-02-07,351,351,265,86,2625,2625,1985,640,11,1,1,5,128,128,127,127
Lassen,8,2022-02-07,140,140,115,25,3023,3024,2488,536,5,2,2,0,57,57,55,55
Los Angeles,8,2022-02-07,37485,37512,34743,2769,1151430,1152230,1067623,84607,2155,638,638,547,30300,30300,29662,29662
Madera,8,2022-02-07,1057,1057,799,258,8081,8086,6122,1964,38,4,4,9,362,362,358,358
Marin,8,2022-02-07,657,657,501,156,11293,11301,8624,2677,29,8,8,6,281,281,273,273
Mariposa,8,2022-02-07,51,51,38,13,579,579,431,148,0,0,0,0,24,24,24,24
Mendocino,8,2022-02-07,327,327,229,98,2817,2817,1974,843,12,2,2,5,116,116,114,114
Merced,8,2022-02-07,1209,1209,973,236,8065,8070,6497,1573,53,13,13,12,771,771,758,758
Modoc,8,2022-02-07,25,25,20,5,219,219,179,40,3,0,0,0,7,7,7,7
Mono,8,2022-02-07,44,44,29,15,271,271,178,93,0,0,0,0,5,5,5,5
Monterey,8,2022-02-07,2221,2221,1474,747,22460,22476,14949,7527,68,11,11,14,689,689,678,678
Napa,8,2022-02-07,740,740,610,130,7766,7771,6400,1371,16,6,6,2,130,130,124,124
Nevada,8,2022-02-07,357,357,271,86,3187,3188,2430,758,24,3,3,1,122,122,119,119
Orange,8,2022-02-07,6394,6399,5395,1004,152267,152372,128512,23860,494,117,117,125,6741,6741,6624,6624
Placer,8,2022-02-07,1294,1294,960,334,11886,11895,8837,3058,148,22,22,34,587,587,565,565
Plumas,8,2022-02-07,79,79,60,19,521,521,399,122,1,1,1,0,13,13,12,12
Riverside,8,2022-02-07,8141,8146,6513,1633,93433,93498,74830,18668,548,107,107,116,6205,6205,6098,6098
Sacramento,8,2022-02-07,6074,6079,4787,1292,64718,64763,51039,13724,390,71,71,95,2870,2870,2799,2799
San Benito,8,2022-02-07,311,311,255,56,2660,2660,2184,476,3,0,0,4,90,90,90,90
San Bernardino,8,2022-02-07,7044,7049,5863,1186,90077,90141,75034,15107,528,140,140,156,7419,7419,7279,7279
San Diego,8,2022-02-07,13647,13657,12598,1059,151877,151983,140261,11722,773,116,116,169,5062,5062,4946,4946
San Francisco,8,2022-02-07,2410,2410,1553,857,55803,55841,35953,19888,171,25,25,40,793,793,768,768
San Joaquin,8,2022-02-07,3339,3340,2575,765,36558,36583,28251,8332,186,42,42,62,2147,2147,2105,2105
San Luis Obispo,8,2022-02-07,1201,1201,976,225,12351,12359,10057,2302,23,16,16,7,429,429,413,413
San Mateo,8,2022-02-07,2464,2464,2076,388,62109,62152,52370,9782,83,16,16,18,667,667,651,651
Santa Barbara,8,2022-02-07,2282,2282,1814,468,30723,30744,24449,6295,75,15,15,17,651,651,636,636
Santa Clara,8,2022-02-07,8041,8046,7388,658,174973,175094,160797,14297,377,31,31,74,2181,2181,2150,2150
Santa Cruz,8,2022-02-07,1899,1899,1559,340,38675,38702,31781,6921,28,4,4,5,250,250,246,246
Shasta,8,2022-02-07,672,672,530,142,6857,6862,5417,1445,64,15,15,10,505,505,490,490
Siskiyou,8,2022-02-07,91,91,75,16,720,720,595,125,10,2,2,0,72,72,70,70
Solano,8,2022-02-07,2238,2238,1784,454,24304,24321,19436,4885,91,5,5,28,433,433,428,428
Sonoma,8,2022-02-07,2083,2083,1674,409,27055,27073,21751,5322,57,7,7,11,470,470,463,463
Stanislaus,8,2022-02-07,2490,2490,1791,699,18740,18753,13512,5241,243,43,43,43,1583,1583,1540,1540
Sutter,8,2022-02-07,360,360,286,74,3305,3306,2632,674,0,5,5,0,214,214,209,209
Tehama,8,2022-02-07,282,282,205,77,1644,1644,1197,447,17,3,3,6,183,183,180,180
Trinity,8,2022-02-07,18,18,13,5,136,136,98,38,0,0,0,0,20,20,20,20
Tulare,8,2022-02-07,2695,2695,1926,769,17927,17939,12854,5085,130,26,26,21,1408,1408,1382,1382
Tuolumne,8,2022-02-07,348,348,263,85,2577,2577,1954,623,10,2,2,1,172,172,170,170
Ventura,8,2022-02-07,2695,2695,2301,394,42326,42355,36189,6166,207,40,40,45,1406,1406,1366,1366
Yolo,8,2022-02-07,865,865,707,158,30851,30873,25193,5680,12,11,11,6,337,337,326,326
Yuba,8,2022-02-07,333,333,269,64,2409,2409,1945,464,42,4,4,13,115,115,111,111
Alameda,9,2022-02-14,3397,3398,2938,460,98897,98973,85590,13383,190,40,40,48,1786,1786,1746,1746
Amador,9,2022-02-14,109,109,87,22,2343,2343,1864,479,8,3,3,3,81,81,78,78
Butte,9,2022-02-14,463,463,411,52,5325,5329,4731,598,64,10,10,9,404,404,394,394
Calaveras,9,2022-02-14,78,78,64,14,1162,1162,950,212,4,2,2,2,108,108,106,106
Colusa,9,2022-02-14,35,35,29,6,406,406,341,65,5,0,0,0,21,21,21,21
Contra Costa,9,2022-02-14,2402,2402,1902,500,44841,44876,35553,9323,123,23,23,31,1246,1246,1223,1223
Del Norte,9,2022-02-14,209,209,174,35,3337,3338,2775,563,6,0,0,3,44,44,44,44
El Dorado,9,2022-02-14,261,261,214,47,4432,4437,3635,802,21,4,4,3,203,203,199,199
Fresno,9,2022-02-14,3850,3852,3084,768,35259,35287,28260,7027,375,32,32,75,2654,2654,2622,2622
Glenn,9,2022-02-14,58,58,48,10,482,482,398,84,3,1,1,0,51,51,50,50
Humboldt,9,2022-02-14,333,333,277,56,4202,4206,3498,708,23,0,0,2,135,135,135,135
Imperial,9,2022-02-14,587,587,479,108,6004,6009,4909,1100,44,14,14,18,921,921,907,907
Inyo,9,2022-02-14,29,29,24,5,413,413,348,65,3,0,0,0,56,56,56,56
Kern,9,2022-02-14,2014,2014,1701,313,27234,27256,23031,4225,156,28,28,40,2266,2266,2238,2238
Kings,9,2022-02-14,771,771,631,140,8003,8009,6554,1455,43,8,8,5,427,427,419,419
Lake,9,2022-02-14,256,256,205,51,2307,2307,1842,465,6,2,2,5,130,130,128,128
Lassen,9,2022-02-14,154,154,132,22,2789,2789,2383,406,3,2,2,0,59,59,57,57
Los Angeles,9,2022-02-14,21589,21605,20342,1263,1052313,1053111,991726,61385,1572,490,490,423,30790,30790,30300,30300
Madera,9,2022-02-14,619,619,495,124,6463,6468,5169,1299,29,2,2,7,364,364,362,362
Marin,9,2022-02-14,383,383,309,74,10148,10155,8177,1978,23,5,5,4,286,286,281,281
Mariposa,9,2022-02-14,24,24,19,5,434,434,342,92,0,0,0,0,24,24,24,24
Mendocino,9,2022-02-14,207,207,155,52,2445,2445,1834,611,13,1,1,7,117,117,116,116
Merced,9,2022-02-14,744,744,626,118,6834,6839,5750,1089,37,13,13,8,784,784,771,771
Modoc,9,2022-02-14,16,16,13,3,124,124,104,20,0,0,0,0,7,7,7,7
Mono,9,2022-02-14,10,10,7,3,179,179,127,52,0,0,0,0,5,5,5,5
Monterey,9,2022-02-14,1227,1227,880,347,16949,16963,12164,4799,48,12,12,12,701,701,689,689
Napa,9,2022-02-14,399,399,342,57,6577,6582,5639,943,10,1,1,1,131,131,130,130
Nevada,9,2022-02-14,169,169,136,33,2568,2569,2067,502,19,1,1,5,123,123,122,122
Orange,9,2022-02-14,3998,4000,3495,505,132290,132391,115611,16780,354,115,115,77,6856,6856,6741,6741
Placer,9,2022-02-14,593,593,466,127,9962,9969,7846,2123,105,12,12,23,599,599,587,587
Plumas,9,2022-02-14,43,43,35,8,431,431,348,83,1,0,0,0,13,13,13,13
Riverside,9,2022-02-14,4605,4609,3856,753,74743,74800,62606,12194,400,85,85,86,6290,6290,6205,6205
Sacramento,9,2022-02-14,3420,3420,2826,594,53695,53735,44419,9316,349,58,58,66,2928,2928,2870,2870
San Benito,9,2022-02-14,158,158,135,23,2158,2158,1844,314,0,1,1,3,91,91,90,90
San Bernardino,9,2022-02-14,3696,3698,3194,504,72744,72799,62909,9890,338,117,117,128,7536,7536,7419,7419
San Diego,9,2022-02-14,8092,8098,7599,499,126062,126157,118441,7716,589,87,87,135,5149,5149,5062,5062
San Francisco,9,2022-02-14,1612,1612,1125,487,47571,47606,33265,14341,130,25,25,39,818,818,793,793
San Joaquin,9,2022-02-14,1994,1994,1620,374,30662,30685,24934,5751,123,37,37,53,2184,2184,2147,2147
San Luis Obispo,9,2022-02-14,798,798,677,121,10064,10071,8547,1524,24,9,9,7,438,438,429,429
San Mateo,9,2022-02-14,1345,1345,1174,171,54924,54965,47970,6995,63,16,16,11,683,683,667,667
Santa Barbara,9,2022-02-14,1056,1056,880,176,22481,22498,18767,3731,68,8,8,14,659,659,651,651
Santa Clara,9,2022-02-14,4645,4650,4348,302,154720,154838,144786,10052,296,27,27,59,2208,2208,2181,2181
Santa Cruz,9,2022-02-14,980,980,837,143,30363,30387,25935,4452,23,3,3,4,253,253,250,250
Shasta,9,2022-02-14,443,443,366,77,5851,5856,4845,1011,62,13,13,13,518,518,505,505
Siskiyou,9,2022-02-14,66,66,57,9,520,520,447,73,7,1,1,2,73,73,72,72
Solano,9,2022-02-14,1198,1198,1001,197,19067,19083,15955,3128,73,2,2,20,435,435,433,433
Sonoma,9,2022-02-14,1138,1138,955,183,21173,21190,17774,3416,55,8,8,7,478,478,470,470
Stanislaus,9,2022-02-14,1361,1361,1043,318,15082,15094,11582,3512,206,28,28,41,1611,1611,1583,1583
Sutter,9,2022-02-14,229,229,191,38,2862,2862,2386,476,0,3,3,0,217,217,214,214
Tehama,9,2022-02-14,180,180,139,41,1405,1405,1088,317,15,5,5,5,188,188,183,183
Trinity,9,2022-02-14,22,22,17,5,171,171,131,40,0,0,0,0,20,20,20,20
Tulare,9,2022-02-14,1477,1477,1126,351,15057,15068,11513,3555,116,25,25,19,1433,1433,1408,1408
Tuolumne,9,2022-02-14,190,190,152,38,2221,2221,1778,443,12,4,4,1,176,176,172,172
Ventura,9,2022-02-14,1512,1512,1334,178,35522,35549,31366,4183,141,36,36,26,1442,1442,1406,1406
Yolo,9,2022-02-14,479,479,407,72,26808,26829,22796,4033,10,7,7,3,344,344,337,337
Yuba,9,2022-02-14,220,220,185,35,2111,2111,1779,332,19,0,0,11,115,115,115,115
Alameda,10,2022-02-21,1926,1926,1716,210,77501,77566,68999,8567,138,27,27,26,1813,1813,1786,1786
Amador,10,2022-02-21,70,70,58,12,1921,1921,1598,323,7,3,3,3,84,84,81,81
Butte,10,2022-02-21,257,257,234,23,4425,4429,4029,400,63,12,12,4,416,416,404,404
Calaveras,10,2022-02-21,44,44,37,7,839,839,713,126,3,6,6,0,114,114,108,108
Colusa,10,2022-02-21,25,25,22,3,361,361,314,47,4,0,0,0,21,21,21,21
Contra Costa,10,2022-02-21,1304,1304,1081,223,34117,34145,28267,5878,66,17,17,30,1263,1263,1246,1246
Del Norte,10,2022-02-21,128,128,111,17,2702,2703,2328,375,8,0,0,1,44,44,44,44
El Dorado,10,2022-02-21,157,157,134,23,3612,3615,3080,535,8,1,1,5,204,204,203,203
Fresno,10,2022-02-21,2010,2010,1682,328,27199,27221,22772,4449,272,26,26,54,2680,2680,2654,2654
Glenn,10,2022-02-21,28,28,24,4,405,405,348,57,2,1,1,0,52,52,51,51
Humboldt,10,2022-02-21,193,193,166,27,3333,3336,2877,459,22,3,3,1,138,138,135,135
Imperial,10,2022-02-21,392,392,334,58,4786,4791,4076,715,31,6,6,10,927,927,921,921
Inyo,10,2022-02-21,10,10,9,1,326,326,284,42,1,0,0,0,56,56,56,56
Kern,10,2022-02-21,1284,1284,1123,161,24324,24345,21283,3062,95,23,23,25,2289,2289,2266,2266
Kings,10,2022-02-21,454,454,387,67,6544,6550,5582,968,32,4,4,5,431,431,427,427
Lake,10,2022-02-21,184,184,154,30,1935,1935,1614,321,7,2,2,1,132,132,130,130
Lassen,10,2022-02-21,111,111,98,13,2135,2135,1883,252,1,0,0,0,59,59,59,59
Los Angeles,10,2022-02-21,11876,11887,11337,550,832086,832780,793727,39053,997,321,321,279,31111,31111,30790,30790
Madera,10,2022-02-21,316,316,264,52,5176,5179,4318,861,27,2,2,7,366,366,364,364
Marin,10,2022-02-21,198,198,166,32,8844,8851,7430,1421,13,3,3,4,289,289,286,286
Mariposa,10,2022-02-21,23,23,19,4,372,372,307,65,0,1,1,0,25,25,24,24
Mendocino,10,2022-02-21,113,113,90,23,1942,1942,1539,403,9,2,2,3,119,119,117,117
Merced,10,2022-02-21,429,429,373,56,5162,5167,4496,671,26,10,10,7,794,794,784,784
Modoc,10,2022-02-21,9,9,8,1,65,65,57,8,2,0,0,0,7,7,7,7
Mono,10,2022-02-21,7,7,5,2,162,162,123,39,0,1,1,0,6,6,5,5
Monterey,10,2022-02-21,778,778,594,184,12976,12988,9902,3086,47,5,5,7,706,706,701,701
Napa,10,2022-02-21,229,229,202,27,4985,4990,4409,581,6,4,4,3,135,135,131,131
Nevada,10,2022-02-21,102,102,85,17,1985,1985,1665,320,16,2,2,5,125,125,123,123
Orange,10,2022-02-21,2461,2461,2211,250,110369,110461,99063,11398,256,79,79,69,6935,6935,6856,6856
Placer,10,2022-02-21,324,324,267,57,8678,8685,7162,1523,92,9,9,13,608,608,599,599
Plumas,10,2022-02-21,21,21,18,3,328,328,276,52,0,0,0,0,13,13,13,13
Riverside,10,2022-02-21,2433,2433,2110,323,61401,61453,53308,8145,262,53,53,61,6343,6343,6290,6290
Sacramento,10,2022-02-21,1957,1957,1680,277,43320,43357,37187,6170,249,34,34,47,2962,2962,2928,2928
San Benito,10,2022-02-21,105,105,92,13,1696,1696,1494,202,0,0,0,1,91,91,91,91
San Bernardino,10,2022-02-21,1902,1902,1694,208,60235,60285,53659,6626,251,82,82,78,7618,7618,7536,7536
San Diego,10,2022-02-21,4626,4631,4405,226,100563,100647,95744,4903,468,61,61,106,5210,5210,5149,5149
San Francisco,10,2022-02-21,974,974,729,245,40291,40326,30085,10241,98,11,11,24,829,829,818,818
San Joaquin,10,2022-02-21,1052,1052,890,162,23865,23886,20202,3684,91,25,25,31,2209,2209,2184,2184
San Luis Obispo,10,2022-02-21,440,440,385,55,7659,7665,6717,948,16,16,16,3,454,454,438,438
San Mateo,10,2022-02-21,693,693,622,71,42430,42465,38061,4404,47,8,8,8,691,691,683,683
Santa Barbara,10,2022-02-21,609,609,526,83,19192,19208,16589,2619,40,6,6,10,665,665,659,659
Santa Clara,10,2022-02-21,2506,2506,2377,129,119653,119753,113493,6260,224,25,25,53,2233,2233,2208,2208
Santa Cruz,10,2022-02-21,577,577,508,69,25006,25028,22028,3000,21,1,1,4,254,254,253,253
Shasta,10,2022-02-21,259,259,222,37,4976,4981,4280,701,46,9,9,10,527,527,518,518
Siskiyou,10,2022-02-21,47,47,42,5,450,450,398,52,6,4,4,1,77,77,73,73
Solano,10,2022-02-21,696,696,603,93,15171,15184,13157,2027,51,5,5,15,440,440,435,435
Sonoma,10,2022-02-21,629,629,547,82,16816,16830,14609,2221,36,2,2,8,480,480,478,478
Stanislaus,10,2022-02-21,730,730,589,141,11761,11772,9499,2273,168,29,29,30,1640,1640,1611,1611
Sutter,10,2022-02-21,122,122,105,17,2108,2108,1821,287,0,2,2,0,219,219,217,217
Tehama,10,2022-02-21,96,96,78,18,1219,1219,993,226,8,10,10,2,198,198,188,188
Trinity,10,2022-02-21,15,15,12,3,199,199,160,39,0,0,0,0,20,20,20,20
Tulare,10,2022-02-21,778,778,625,153,10927,10935,8792,2143,86,14,14,9,1447,1447,1433,1433
Tuolumne,10,2022-02-21,107,107,90,17,1784,1784,1491,293,2,6,6,2,182,182,176,176
Ventura,10,2022-02-21,886,886,802,84,27533,27556,24938,2618,107,21,21,22,1463,1463,1442,1442
Yolo,10,2022-02-21,283,283,249,34,20966,20983,18403,2580,7,6,6,3,350,350,344,344
Yuba,10,2022-02-21,134,134,117,17,1682,1682,1469,213,22,1,1,8,116,116,115,115
Alameda,11,2022-02-28,1468,1468,1341,127,78649,78724,71901,6823,113,17,17,23,1830,1830,1813,1813
Amador,11,2022-02-28,56,56,48,8,2077,2077,1796,281,7,0,0,2,84,84,84,84
Butte,11,2022-02-28,188,188,175,13,4469,4474,4155,319,45,6,6,4,422,422,416,416
Calaveras,11,2022-02-28,40,40,35,5,1255,1255,1105,150,0,3,3,0,117,117,114,114
Colusa,11,2022-02-28,10,10,9,1,406,406,364,42,5,0,0,0,21,21,21,21
Contra Costa,11,2022-02-28,933,933,804,129,34987,35021,30195,4826,56,15,15,19,1278,1278,1263,1263
Del Norte,11,2022-02-28,84,84,75,9,2874,2875,2556,319,5,3,3,2,47,47,44,44
El Dorado,11,2022-02-28,107,107,94,13,3684,3689,3255,434,5,2,2,3,206,206,204,204
Fresno,11,2022-02-28,1313,1313,1141,172,26638,26664,23165,3499,196,28,28,44,2708,2708,2680,2680
Glenn,11,2022-02-28,18,18,16,2,435,435,386,49,1,0,0,0,52,52,52,52
Humboldt,11,2022-02-28,156,156,139,17,2953,2955,2631,324,6,1,1,1,139,139,138,138
Imperial,11,2022-02-28,264,264,233,31,4816,4821,4244,577,13,6,6,10,933,933,927,927
Inyo,11,2022-02-28,10,10,9,1,379,379,341,38,0,0,0,0,56,56,56,56
Kern,11,2022-02-28,790,790,711,79,24602,24626,22171,2455,77,16,16,16,2305,2305,2289,2289
Kings,11,2022-02-28,246,246,216,30,6079,6084,5360,724,19,7,7,3,438,438,431,431
Lake,11,2022-02-28,110,110,95,15,1956,1956,1695,261,0,4,4,1,136,136,132,132
Lassen,11,2022-02-28,44,44,40,4,2097,2097,1899,198,1,2,2,0,61,61,59,59
Los Angeles,11,2022-02-28,8257,8265,7966,299,1057203,1058207,1019636,38571,753,222,222,174,31333,31333,31111,31111
Madera,11,2022-02-28,188,188,163,25,4623,4628,4017,611,20,2,2,6,368,368,366,366
Marin,11,2022-02-28,160,160,140,20,7662,7667,6683,984,13,3,3,3,292,292,289,289
Mariposa,11,2022-02-28,29,29,25,4,347,347,298,49,0,1,1,0,26,26,25,25
Mendocino,11,2022-02-28,83,83,69,14,1889,1889,1571,318,11,2,2,2,121,121,119,119
Merced,11,2022-02-28,285,285,256,29,5030,5035,4513,522,25,7,7,5,801,801,794,794
Modoc,11,2022-02-28,6,6,5,1,57,57,51,6,1,0,0,0,7,7,7,7
Mono,11,2022-02-28,5,5,4,1,169,169,136,33,0,0,0,0,6,6,6,6
Monterey,11,2022-02-28,355,355,286,69,14334,14348,11570,2778,28,9,9,5,715,715,706,706
Napa,11,2022-02-28,194,194,176,18,5593,5598,5083,515,8,3,3,2,138,138,135,135
Nevada,11,2022-02-28,70,70,61,9,2016,2016,1753,263,9,0,0,1,125,125,125,125
Orange,11,2022-02-28,1684,1684,1548,136,126304,126425,116157,10268,198,41,41,35,6976,6976,6935,6935
Placer,11,2022-02-28,250,250,215,35,8419,8427,7238,1189,65,4,4,13,612,612,608,608
Plumas,11,2022-02-28,23,23,20,3,370,370,323,47,0,0,0,0,13,13,13,13
Riverside,11,2022-02-28,1687,1687,1508,179,63263,63322,56620,6702,185,37,37,35,6380,6380,6343,6343
Sacramento,11,2022-02-28,1164,1164,1033,131,46258,46302,41052,5250,163,24,24,35,2986,2986,2962,2962
San Benito,11,2022-02-28,55,55,50,5,1809,1809,1638,171,0,0,0,1,91,91,91,91
San Bernardino,11,2022-02-28,1174,1174,1072,102,61075,61133,55810,5323,157,60,60,45,7678,7678,7618,7618
San Diego,11,2022-02-28,3035,3036,2920,116,100000,100096,96290,3806,341,37,37,83,5247,5247,5210,5210
San Francisco,11,2022-02-28,835,835,662,173,40010,40048,31728,8320,74,16,16,19,845,845,829,829
San Joaquin,11,2022-02-28,657,657,576,81,26106,26131,22903,3228,58,10,10,24,2219,2219,2209,2209
San Luis Obispo,11,2022-02-28,378,378,341,37,8519,8526,7692,834,9,5,5,2,459,459,454,454
San Mateo,11,2022-02-28,599,599,551,48,41301,41341,37995,3346,33,4,4,7,695,695,691,691
Santa Barbara,11,2022-02-28,369,369,329,40,21380,21400,19076,2324,36,5,5,10,670,670,665,665
Santa Clara,11,2022-02-28,1732,1732,1662,70,102557,102655,98553,4102,191,22,22,46,2255,2255,2233,2233
Santa Cruz,11,2022-02-28,459,459,416,43,27967,27995,25363,2632,20,2,2,4,256,256,254,254
Shasta,11,2022-02-28,167,167,148,19,4925,4930,4377,553,36,11,11,8,538,538,527,527
Siskiyou,11,2022-02-28,25,25,23,2,475,475,432,43,4,2,2,1,79,79,77,77
Solano,11,2022-02-28,476,476,425,51,15400,15415,13777,1638,47,3,3,17,443,443,440,440
Sonoma,11,2022-02-28,455,455,408,47,16943,16959,15193,1766,28,3,3,5,483,483,480,480
Stanislaus,11,2022-02-28,477,477,402,75,13366,13380,11291,2089,124,11,11,21,1651,1651,1640,1640
Sutter,11,2022-02-28,107,107,95,12,2333,2334,2080,254,0,2,2,0,221,221,219,219
Tehama,11,2022-02-28,60,60,51,9,1221,1221,1039,182,7,1,1,2,199,199,198,198
Trinity,11,2022-02-28,5,5,4,1,118,118,99,19,0,0,0,0,20,20,20,20
Tulare,11,2022-02-28,462,462,389,73,11881,11894,10005,1889,67,14,14,9,1461,1461,1447,1447
Tuolumne,11,2022-02-28,67,67,58,9,1486,1486,1291,195,6,3,3,1,185,185,182,182
Ventura,11,2022-02-28,548,548,507,41,29882,29910,27668,2242,75,10,10,11,1473,1473,1463,1463
Yolo,11,2022-02-28,206,206,186,20,26239,26264,23717,2547,4,5,5,6,355,355,350,350
Yuba,11,2022-02-28,75,75,67,8,1713,1713,1538,175,12,1,1,6,117,117,116,116
Alameda,12,2022-03-07,1091,1091,1016,75,72244,72320,67340,4980,77,12,12,16,1842,1842,1830,1830
Amador,12,2022-03-07,75,75,67,8,1428,1428,1274,154,6,2,2,1,86,86,84,84
Butte,12,2022-03-07,99,99,93,6,3642,3646,3441,205,33,4,4,3,426,426,422,422
Calaveras,12,2022-03-07,25,25,23,2,1049,1049,949,100,1,1,1,0,118,118,117,117
Colusa,12,2022-03-07,9,9,8,1,355,355,326,29,6,0,0,0,21,21,21,21
Contra Costa,12,2022-03-07,629,629,560,69,30941,30974,27549,3425,47,8,8,13,1286,1286,1278,1278
Del Norte,12,2022-03-07,50,50,46,4,1779,1779,1624,155,7,0,0,1,47,47,47,47
El Dorado,12,2022-03-07,76,76,69,7,3196,3200,2899,301,5,3,3,2,209,209,206,206
Fresno,12,2022-03-07,859,859,769,90,22505,22529,20170,2359,145,18,18,27,2726,2726,2708,2708
Glenn,12,2022-03-07,19,19,17,2,395,395,359,36,2,1,1,0,53,53,52,52
Humboldt,12,2022-03-07,81,81,74,7,3045,3049,2783,266,10,3,3,4,142,142,139,139
Imperial,12,2022-03-07,122,122,110,12,4519,4524,4092,432,16,5,5,10,938,938,933,933
Inyo,12,2022-03-07,10,10,9,1,269,269,247,22,0,0,0,0,56,56,56,56
Kern,12,2022-03-07,433,433,398,35,20834,20856,19205,1651,67,12,12,16,2317,2317,2305,2305
Kings,12,2022-03-07,201,201,182,19,4986,4991,4518,473,13,4,4,2,442,442,438,438
Lake,12,2022-03-07,63,63,56,7,1760,1760,1572,188,2,2,2,1,138,138,136,136
Lassen,12,2022-03-07,95,95,88,7,1889,1889,1748,141,0,1,1,0,62,62,61,61
Los Angeles,12,2022-03-07,5558,5564,5406,158,875949,876863,851917,24946,573,171,171,133,31504,31504,31333,31333
Madera,12,2022-03-07,133,133,119,14,3916,3921,3506,415,15,1,1,2,369,369,368,368
Marin,12,2022-03-07,154,154,138,16,7559,7566,6785,781,10,1,1,2,293,293,292,292
Mariposa,12,2022-03-07,11,11,10,1,296,296,263,33,0,1,1,0,27,27,26,26
Mendocino,12,2022-03-07,65,65,56,9,1643,1643,1418,225,6,0,0,2,121,121,121,121
Merced,12,2022-03-07,173,173,159,14,4537,4542,4167,375,17,7,7,5,808,808,801,801
Modoc,12,2022-03-07,0,0,0,0,54,54,50,4,0,0,0,0,7,7,7,7
Mono,12,2022-03-07,2,2,2,0,128,128,108,20,0,0,0,1,6,6,6,6
Monterey,12,2022-03-07,245,245,206,39,11053,11065,9334,1731,19,5,5,2,720,720,715,715
Napa,12,2022-03-07,199,199,185,14,4874,4879,4523,356,2,1,1,2,139,139,138,138
Nevada,12,2022-03-07,50,50,45,5,1750,1750,1568,182,0,1,1,0,126,126,125,125
Orange,12,2022-03-07,1251,1251,1171,80,107251,107363,100464,6899,138,29,29,28,7005,7005,6976,6976
Placer,12,2022-03-07,162,162,144,18,7797,7805,6923,882,54,3,3,11,615,615,612,612
Plumas,12,2022-03-07,7,7,6,1,266,266,239,27,0,0,0,0,13,13,13,13
Riverside,12,2022-03-07,982,982,899,83,53620,53676,49159,4517,125,26,26,30,6406,6406,6380,6380
Sacramento,12,2022-03-07,774,774,704,70,40643,40685,37022,3663,124,18,18,28,3004,3004,2986,2986
San Benito,12,2022-03-07,41,41,38,3,1525,1525,1411,114,0,2,2,1,93,93,91,91
San Bernardino,12,2022-03-07,792,792,737,55,53255,53310,49633,3677,95,43,43,38,7721,7721,7678,7678
San Diego,12,2022-03-07,2337,2337,2267,70,96625,96726,93840,2886,237,31,31,57,5278,5278,5247,5247
San Francisco,12,2022-03-07,697,697,579,118,37368,37406,31051,6355,62,5,5,11,850,850,845,845
San Joaquin,12,2022-03-07,441,441,398,43,21211,21233,19151,2082,33,9,9,19,2228,2228,2219,2219
San Luis Obispo,12,2022-03-07,245,245,226,19,7312,7318,6752,566,7,5,5,1,464,464,459,459
San Mateo,12,2022-03-07,534,534,500,34,39936,39978,37395,2583,30,2,2,3,697,697,695,695
Santa Barbara,12,2022-03-07,203,203,186,17,17713,17732,16203,1529,15,4,4,8,674,674,670,670
Santa Clara,12,2022-03-07,1468,1468,1422,46,111508,111625,108072,3553,128,13,13,38,2268,2268,2255,2255
Santa Cruz,12,2022-03-07,334,334,309,25,24967,24994,23134,1860,11,0,0,7,256,256,256,256
Shasta,12,2022-03-07,140,140,127,13,4940,4945,4502,443,24,8,8,3,546,546,538,538
Siskiyou,12,2022-03-07,12,12,11,1,399,399,370,29,2,1,1,0,80,80,79,79
Solano,12,2022-03-07,353,353,323,30,14149,14165,12965,1200,46,2,2,10,445,445,443,443
Sonoma,12,2022-03-07,320,320,293,27,14916,14932,13694,1238,26,3,3,6,486,486,483,483
Stanislaus,12,2022-03-07,276,276,241,35,10858,10870,9510,1360,94,10,10,13,1661,1661,1651,1651
Sutter,12,2022-03-07,79,79,72,7,1908,1908,1742,166,0,1,1,0,222,222,221,221
Tehama,12,2022-03-07,40,40,35,5,1115,1115,980,135,5,2,2,1,201,201,199,199
Trinity,12,2022-03-07,4,4,3,1,114,114,100,14,0,0,0,0,20,20,20,20
Tulare,12,2022-03-07,303,303,264,39,10284,10295,8985,1310,37,13,13,3,1474,1474,1461,1461
Tuolumne,12,2022-03-07,48,48,43,5,1253,1253,1122,131,2,0,0,1,185,185,185,185
Ventura,12,2022-03-07,417,417,392,25,26712,26741,25159,1582,45,4,4,11,1477,1477,1473,1473
Yolo,12,2022-03-07,160,160,148,12,22145,22168,20463,1705,3,2,2,2,357,357,355,355
Yuba,12,2022-03-07,58,58,53,5,1554,1554,1427,127,13,0,0,6,117,117,117,117
Alameda,13,2022-03-14,870,870,822,48,68766,68842,65097,3745,64,9,9,6,1851,1851,1842,1842
Amador,13,2022-03-14,32,32,29,3,1439,1439,1315,124,4,0,0,0,86,86,86,86
Butte,13,2022-03-14,82,82,78,4,3597,3601,3441,160,24,1,1,0,427,427,426,426
Calaveras,13,2022-03-14,17,17,16,1,991,991,915,76,1,1,1,1,119,119,118,118
Colusa,13,2022-03-14,4,4,4,0,257,257,240,17,4,0,0,0,21,21,21,21
Contra Costa,13,2022-03-14,565,565,515,50,29113,29146,26577,2569,19,5,5,9,1291,1291,1286,1286
Del Norte,13,2022-03-14,31,31,29,2,1415,1415,1317,98,1,2,2,1,49,49,47,47
El Dorado,13,2022-03-14,46,46,43,3,2977,2981,2758,223,4,1,1,0,210,210,209,209
Fresno,13,2022-03-14,522,522,478,44,21405,21429,19639,1790,120,10,10,20,2736,2736,2726,2726
Glenn,13,2022-03-14,11,11,10,1,342,342,318,24,1,0,0,0,53,53,53,53
Humboldt,13,2022-03-14,56,56,52,4,2652,2656,2471,185,3,1,1,2,143,143,142,142
Imperial,13,2022-03-14,75,75,69,6,4584,4589,4238,351,5,2,2,7,940,940,938,938
Inyo,13,2022-03-14,6,6,6,0,165,165,154,11,0,0,0,0,56,56,56,56
Kern,13,2022-03-14,301,301,282,19,20272,20294,19022,1272,42,14,14,12,2331,2331,2317,2317
Kings,13,2022-03-14,155,155,143,12,4695,4700,4346,354,17,1,1,2,443,443,442,442
Lake,13,2022-03-14,48,48,44,4,1570,1570,1436,134,1,1,1,0,139,139,138,138
Lassen,13,2022-03-14,5,5,5,0,1515,1516,1427,89,0,0,0,0,62,62,62,62
Los Angeles,13,2022-03-14,4084,4089,3998,91,845484,846419,827547,18872,412,116,116,91,31620,31620,31504,31504
Madera,13,2022-03-14,52,52,48,4,3575,3579,3276,303,12,0,0,2,369,369,369,369
Marin,13,2022-03-14,170,170,156,14,6533,6539,6003,536,7,1,1,0,294,294,293,293
Mariposa,13,2022-03-14,9,9,8,1,222,222,202,20,0,0,0,0,27,27,27,27
Mendocino,13,2022-03-14,34,34,30,4,1433,1433,1275,158,4,2,2,1,123,123,121,121
Merced,13,2022-03-14,133,133,124,9,4167,4172,3899,273,17,2,2,4,810,810,808,808
Modoc,13,2022-03-14,3,3,3,0,52,52,49,3,1,0,0,0,7,7,7,7
Mono,13,2022-03-14,2,2,2,0,118,118,103,15,0,0,0,0,6,6,6,6
Monterey,13,2022-03-14,155,155,135,20,10109,10122,8842,1280,14,4,4,2,724,724,720,720
Napa,13,2022-03-14,120,120,113,7,4103,4108,3870,238,6,1,1,3,140,140,139,139
Nevada,13,2022-03-14,50,50,46,4,1571,1571,1441,130,2,0,0,0,126,126,126,126
Orange,13,2022-03-14,821,821,779,42,101452,101564,96409,5155,109,31,31,31,7036,7036,7005,7005
Placer,13,2022-03-14,150,150,136,14,7318,7326,6664,662,45,3,3,5,618,618,615,615
Plumas,13,2022-03-14,4,4,4,0,317,317,291,26,0,0,0,0,13,13,13,13
Riverside,13,2022-03-14,737,737,688,49,52727,52785,49266,3519,87,15,15,16,6421,6421,6406,6406
Sacramento,13,2022-03-14,587,587,545,42,35490,35530,32979,2551,122,16,16,22,3020,3020,3004,3004
San Benito,13,2022-03-14,36,36,34,2,1461,1461,1374,87,0,0,0,1,93,93,93,93
San Bernardino,13,2022-03-14,566,566,535,31,51660,51716,48894,2822,68,26,26,32,7747,7747,7721,7721
San Diego,13,2022-03-14,1842,1842,1799,43,96017,96124,93868,2256,174,17,17,47,5295,5295,5278,5278
San Francisco,13,2022-03-14,609,609,526,83,34267,34305,29586,4719,28,7,7,7,857,857,850,850
San Joaquin,13,2022-03-14,270,270,249,21,18882,18903,17415,1488,28,7,7,11,2235,2235,2228,2228
San Luis Obispo,13,2022-03-14,160,160,150,10,6676,6682,6271,411,7,7,7,1,471,471,464,464
San Mateo,13,2022-03-14,441,441,419,22,35706,35745,33915,1830,27,0,0,3,697,697,697,697
Santa Barbara,13,2022-03-14,195,195,182,13,16855,16874,15714,1160,16,7,7,2,681,681,674,674
Santa Clara,13,2022-03-14,1178,1178,1149,29,99229,99339,96855,2484,108,12,12,28,2280,2280,2268,2268
Santa Cruz,13,2022-03-14,239,239,225,14,22167,22194,20886,1308,10,3,3,3,259,259,256,256
Shasta,13,2022-03-14,97,97,90,7,4836,4841,4494,347,16,5,5,2,551,551,546,546
Siskiyou,13,2022-03-14,9,9,8,1,370,370,349,21,0,3,3,0,83,83,80,80
Solano,13,2022-03-14,221,221,206,15,12380,12395,11560,835,34,1,1,6,446,446,445,445
Sonoma,13,2022-03-14,229,229,214,15,13394,13410,12524,886,14,1,1,4,487,487,486,486
Stanislaus,13,2022-03-14,215,215,193,22,9404,9415,8466,949,82,11,11,17,1672,1672,1661,1661
Sutter,13,2022-03-14,41,41,38,3,1815,1816,1690,126,0,0,0,0,222,222,222,222
Tehama,13,2022-03-14,17,17,15,2,981,981,886,95,2,3,3,0,204,204,201,201
Trinity,13,2022-03-14,3,3,3,0,96,96,86,10,0,0,0,0,20,20,20,20
Tulare,13,2022-03-14,172,172,154,18,9302,9312,8358,954,33,0,0,6,1474,1474,1474,1474
Tuolumne,13,2022-03-14,22,22,20,2,1246,1246,1142,104,1,0,0,0,185,185,185,185
Ventura,13,2022-03-14,326,326,311,15,24584,24610,23458,1152,37,6,6,7,1483,1483,1477,1477
Yolo,13,2022-03-14,118,118,111,7,21608,21631,20312,1319,1,3,3,2,360,360,357,357
Yuba,13,2022-03-14,35,35,33,2,1420,1420,1328,92,10,0,0,3,117,117,117,117
Alameda,14,2022-03-21,719,719,688,31,65645,65722,62894,2828,58,7,7,3,1858,1858,1851,1851
Amador,14,2022-03-21,29,29,27,2,1356,1356,1263,93,2,0,0,0,86,86,86,86
Butte,14,2022-03-21,81,81,78,3,3160,3164,3054,110,17,0,0,2,427,427,427,427
Calaveras,14,2022-03-21,8,8,8,0,658,658,619,39,0,0,0,0,119,119,119,119
Colusa,14,2022-03-21,3,3,3,0,231,231,219,12,2,0,0,0,21,21,21,21
Contra Costa,14,2022-03-21,466,466,434,32,26898,26929,25037,1892,27,7,7,9,1298,1298,1291,1291
Del Norte,14,2022-03-21,19,19,18,1,1192,1192,1127,65,0,0,0,0,49,49,49,49
El Dorado,14,2022-03-21,44,44,41,3,2810,2815,2648,167,1,2,2,0,212,212,210,210
Fresno,14,2022-03-21,347,347,324,23,19606,19630,18328,1302,97,11,11,12,2747,2747,2736,2736
Glenn,14,2022-03-21,7,7,7,0,366,366,345,21,1,0,0,0,53,53,53,53
Humboldt,14,2022-03-21,31,31,29,2,2457,2460,2326,134,5,1,1,2,144,144,143,143
Imperial,14,2022-03-21,59,59,55,4,3989,3994,3754,240,4,3,3,4,943,943,940,940
Inyo,14,2022-03-21,1,1,1,0,148,148,140,8,0,0,0,0,56,56,56,56
Kern,14,2022-03-21,206,206,196,10,19489,19511,18545,966,34,4,4,9,2335,2335,2331,2331
Kings,14,2022-03-21,79,79,74,5,4411,4416,4152,264,7,1,1,1,444,444,443,443
Lake,14,2022-03-21,18,18,17,1,1365,1365,1272,93,0,0,0,0,139,139,139,139
Lassen,14,2022-03-21,10,10,10,0,1388,1388,1323,65,0,0,0,0,62,62,62,62
Los Angeles,14,2022-03-21,4138,4143,4072,71,822715,823680,809293,14387,338,76,76,66,31696,31696,31620,31620
Madera,14,2022-03-21,40,40,37,3,3392,3396,3168,228,9,1,1,1,370,370,369,369
Marin,14,2022-03-21,133,133,124,9,6227,6233,5827,406,6,1,1,0,295,295,294,294
Mariposa,14,2022-03-21,7,7,6,1,236,236,219,17,0,0,0,0,27,27,27,27
Mendocino,14,2022-03-21,28,28,26,2,1505,1505,1373,132,4,0,0,1,123,123,123,123
Merced,14,2022-03-21,87,87,82,5,3771,3776,3581,195,13,5,5,1,815,815,810,810
Modoc,14,2022-03-21,2,2,2,0,60,60,57,3,0,0,0,0,7,7,7,7
Mono,14,2022-03-21,4,4,4,0,134,134,120,14,1,0,0,0,6,6,6,6
Monterey,14,2022-03-21,152,152,137,15,10083,10097,9072,1025,22,0,0,1,724,724,724,724
Napa,14,2022-03-21,54,54,52,2,3450,3455,3298,157,6,1,1,2,141,141,140,140
Nevada,14,2022-03-21,18,18,17,1,1528,1528,1428,100,2,0,0,0,126,126,126,126
Orange,14,2022-03-21,753,753,723,30,96039,96153,92300,3853,100,12,12,25,7048,7048,7036,7036
Placer,14,2022-03-21,111,111,103,8,6472,6479,6014,465,40,2,2,6,620,620,618,618
Plumas,14,2022-03-21,2,2,2,0,228,228,213,15,0,0,0,0,13,13,13,13
Riverside,14,2022-03-21,617,617,584,33,51885,51946,49187,2759,69,13,13,18,6434,6434,6421,6421
Sacramento,14,2022-03-21,457,457,431,26,33336,33375,31482,1893,89,12,12,13,3032,3032,3020,3020
San Benito,14,2022-03-21,19,19,18,1,1385,1385,1320,65,0,1,1,0,94,94,93,93
San Bernardino,14,2022-03-21,473,473,453,20,49291,49349,47216,2133,49,20,20,31,7767,7767,7747,7747
San Diego,14,2022-03-21,1370,1370,1345,25,84562,84662,83105,1557,146,14,14,39,5309,5309,5295,5295
San Francisco,14,2022-03-21,688,688,613,75,33505,33544,29834,3710,34,3,3,3,860,860,857,857
San Joaquin,14,2022-03-21,222,222,208,14,15679,15697,14724,973,23,6,6,6,2241,2241,2235,2235
San Luis Obispo,14,2022-03-21,107,107,102,5,6429,6436,6122,314,3,5,5,0,476,476,471,471
San Mateo,14,2022-03-21,367,367,352,15,34822,34863,33461,1402,30,1,1,1,698,698,697,697
Santa Barbara,14,2022-03-21,161,161,152,9,14292,14310,13520,790,17,5,5,4,686,686,681,681
Santa Clara,14,2022-03-21,1095,1095,1074,21,94591,94701,92846,1855,101,5,5,20,2285,2285,2280,2280
Santa Cruz,14,2022-03-21,183,183,174,9,20023,20047,19111,936,8,0,0,3,259,259,259,259
Shasta,14,2022-03-21,42,42,40,2,4136,4140,3905,235,10,6,6,2,557,557,551,551
Siskiyou,14,2022-03-21,9,9,9,0,370,370,353,17,1,0,0,0,83,83,83,83
Solano,14,2022-03-21,187,187,177,10,11811,11825,11196,629,17,1,1,5,447,447,446,446
Sonoma,14,2022-03-21,228,228,216,12,12374,12389,11737,652,15,2,2,2,489,489,487,487
Stanislaus,14,2022-03-21,142,142,131,11,8429,8440,7764,676,59,12,12,8,1684,1684,1672,1672
Sutter,14,2022-03-21,35,35,33,2,1479,1479,1399,80,0,1,1,0,223,223,222,222
Tehama,14,2022-03-21,10,10,9,1,926,926,854,72,2,0,0,0,204,204,204,204
Trinity,14,2022-03-21,0,0,0,0,111,111,102,9,0,0,0,0,20,20,20,20
Tulare,14,2022-03-21,112,112,103,9,8167,8176,7509,667,27,5,5,4,1479,1479,1474,1474
Tuolumne,14,2022-03-21,19,19,18,1,1131,1131,1055,76,2,0,0,0,185,185,185,185
Ventura,14,2022-03-21,289,289,278,11,23278,23305,22445,860,30,5,5,6,1488,1488,1483,1483
Yolo,14,2022-03-21,107,107,102,5,21384,21408,20371,1037,1,0,0,1,360,360,360,360
Yuba,14,2022-03-21,42,42,40,2,1318,1318,1251,67,8,0,0,2,117,117,117,117
Alameda,15,2022-03-28,932,932,901,31,59099,59170,57174,1996,35,4,4,5,1862,1862,1858,1858
Amador,15,2022-03-28,8,8,8,0,1374,1374,1300,74,3,0,0,0,86,86,86,86
Butte,15,2022-03-28,64,64,62,2,2855,2858,2780,78,11,0,0,1,427,427,427,427
Calaveras,15,2022-03-28,15,15,14,1,581,581,554,27,0,0,0,0,119,119,119,119
Colusa,15,2022-03-28,4,4,4,0,207,207,199,8,0,0,0,0,21,21,21,21
Contra Costa,15,2022-03-28,532,532,503,29,24838,24868,23489,1379,29,1,1,6,1299,1299,1298,1298
Del Norte,15,2022-03-28,16,16,15,1,1038,1038,993,45,1,0,0,0,49,49,49,49
El Dorado,15,2022-03-28,60,60,57,3,2802,2806,2675,131,0,0,0,0,212,212,212,212
Fresno,15,2022-03-28,274,274,260,14,18147,18170,17217,953,71,5,5,18,2752,2752,2747,2747
Glenn,15,2022-03-28,8,8,8,0,333,333,318,15,0,0,0,0,53,53,53,53
Humboldt,15,2022-03-28,27,27,26,1,2609,2613,2500,113,4,0,0,3,144,144,144,144
Imperial,15,2022-03-28,62,62,59,3,3554,3559,3390,169,4,1,1,3,944,944,943,943
Inyo,15,2022-03-28,4,4,4,0,186,186,178,8,1,0,0,0,56,56,56,56
Kern,15,2022-03-28,144,144,138,6,18179,18201,17490,711,17,4,4,8,2339,2339,2335,2335
Kings,15,2022-03-28,56,56,53,3,4275,4280,4078,202,6,2,2,0,446,446,444,444
Lake,15,2022-03-28,10,10,9,1,1068,1068,1010,58,0,0,0,0,139,139,139,139
Lassen,15,2022-03-28,4,4,4,0,1284,1284,1236,48,0,0,0,0,62,62,62,62
Los Angeles,15,2022-03-28,4482,4489,4428,61,703735,704593,694856,9737,264,51,51,57,31747,31747,31696,31696
Madera,15,2022-03-28,24,24,23,1,3451,3456,3273,183,4,0,0,2,370,370,370,370
Marin,15,2022-03-28,179,179,170,9,6003,6010,5702,308,3,0,0,0,295,295,295,295
Mariposa,15,2022-03-28,5,5,5,0,179,179,169,10,0,1,1,0,28,28,27,27
Mendocino,15,2022-03-28,31,31,29,2,1314,1314,1223,91,0,1,1,0,124,124,123,123
Merced,15,2022-03-28,64,64,61,3,3359,3364,3227,137,5,1,1,3,816,816,815,815
Modoc,15,2022-03-28,3,3,3,0,45,45,43,2,0,0,0,0,7,7,7,7
Mono,15,2022-03-28,1,1,1,0,134,134,123,11,0,0,0,0,6,6,6,6
Monterey,15,2022-03-28,148,148,136,12,8782,8793,8079,714,14,1,1,0,725,725,724,724
Napa,15,2022-03-28,67,67,65,2,3327,3332,3213,119,1,2,2,1,143,143,141,141
Nevada,15,2022-03-28,27,27,26,1,1431,1431,1357,74,1,1,1,0,127,127,126,126
Orange,15,2022-03-28,813,813,788,25,90127,90237,87400,2837,81,12,12,17,7060,7060,7048,7048
Placer,15,2022-03-28,107,107,101,6,6222,6229,5876,353,26,4,4,6,624,624,620,620
Plumas,15,2022-03-28,3,3,3,0,267,267,253,14,0,0,0,0,13,13,13,13
Riverside,15,2022-03-28,521,521,500,21,43920,43975,42142,1833,47,7,7,10,6441,6441,6434,6434
Sacramento,15,2022-03-28,455,455,435,20,32830,32870,31403,1467,68,6,6,19,3038,3038,3032,3032
San Benito,15,2022-03-28,14,14,13,1,1365,1365,1315,50,0,0,0,0,94,94,94,94
San Bernardino,15,2022-03-28,543,543,525,18,41295,41346,39947,1399,40,18,18,24,7785,7785,7767,7767
San Diego,15,2022-03-28,1325,1325,1306,19,72102,72188,71152,1036,114,9,9,26,5318,5318,5309,5309
San Francisco,15,2022-03-28,844,844,771,73,32743,32783,29890,2893,23,5,5,5,865,865,860,860
San Joaquin,15,2022-03-28,190,190,181,9,17501,17521,16665,856,20,4,4,4,2245,2245,2241,2241
San Luis Obispo,15,2022-03-28,96,96,92,4,5713,5719,5501,218,5,1,1,1,477,477,476,476
San Mateo,15,2022-03-28,580,580,562,18,33834,33876,32803,1073,26,3,3,3,701,701,698,698
Santa Barbara,15,2022-03-28,135,135,129,6,10212,10225,9794,431,15,1,1,4,687,687,686,686
Santa Clara,15,2022-03-28,1270,1270,1251,19,94519,94634,93190,1444,88,10,10,18,2295,2295,2285,2285
Santa Cruz,15,2022-03-28,145,145,140,5,19667,19692,18975,717,3,0,0,2,259,259,259,259
Shasta,15,2022-03-28,33,33,32,1,3878,3883,3710,173,7,2,2,3,559,559,557,557
Siskiyou,15,2022-03-28,5,5,5,0,292,292,282,10,0,0,0,0,83,83,83,83
Solano,15,2022-03-28,169,169,162,7,10990,11004,10544,460,18,0,0,6,447,447,447,447
Sonoma,15,2022-03-28,256,256,246,10,8550,8562,8215,347,13,0,0,1,489,489,489,489
Stanislaus,15,2022-03-28,116,116,109,7,8186,8196,7676,520,28,2,2,3,1686,1686,1684,1684
Sutter,15,2022-03-28,25,25,24,1,1490,1490,1426,64,0,1,1,0,224,224,223,223
Tehama,15,2022-03-28,13,13,12,1,798,798,749,49,3,1,1,0,205,205,204,204
Trinity,15,2022-03-28,0,0,0,0,79,79,74,5,0,0,0,0,20,20,20,20
Tulare,15,2022-03-28,79,79,74,5,7838,7847,7339,508,20,6,6,1,1485,1485,1479,1479
Tuolumne,15,2022-03-28,7,7,7,0,1083,1083,1026,57,3,1,1,0,186,186,185,185
Ventura,15,2022-03-28,334,334,324,10,21201,21227,20612,615,23,5,5,3,1493,1493,1488,1488
Yolo,15,2022-03-28,103,103,99,4,20456,20483,19721,762,3,2,2,0,362,362,360,360
Yuba,15,2022-03-28,26,26,25,1,1215,1215,1166,49,2,2,2,1,119,119,117,117
Alameda,16,2022-04-04,1061,1061,1033,28,55980,56052,54562,1490,40,3,3,3,1865,1865,1862,1862
Amador,16,2022-04-04,2,2,2,0,1107,1107,1060,47,1,0,0,0,86,86,86,86
Butte,16,2022-04-04,44,44,43,1,2582,2585,2529,56,8,2,2,1,429,429,427,427
Calaveras,16,2022-04-04,8,8,8,0,589,589,567,22,0,0,0,0,119,119,119,119
Colusa,16,2022-04-04,2,2,2,0,202,202,196,6,0,0,0,0,21,21,21,21
Contra Costa,16,2022-04-04,542,542,519,23,23499,23529,22495,1034,13,1,1,4,1300,1300,1299,1299
Del Norte,16,2022-04-04,8,8,8,0,1118,1118,1080,38,0,0,0,1,49,49,49,49
El Dorado,16,2022-04-04,48,48,46,2,2714,2719,2619,100,0,1,1,1,213,213,212,212
Fresno,16,2022-04-04,188,188,180,8,17017,17038,16335,703,62,4,4,12,2756,2756,2752,2752
Glenn,16,2022-04-04,3,3,3,0,287,287,277,10,0,0,0,0,53,53,53,53
Humboldt,16,2022-04-04,22,22,21,1,2385,2389,2307,82,5,0,0,2,144,144,144,144
Imperial,16,2022-04-04,38,38,37,1,3467,3472,3342,130,3,0,0,2,944,944,944,944
Inyo,16,2022-04-04,9,9,9,0,182,182,176,6,0,0,0,0,56,56,56,56
Kern,16,2022-04-04,152,152,147,5,16749,16770,16254,516,16,2,2,7,2341,2341,2339,2339
Kings,16,2022-04-04,47,47,45,2,4176,4181,4025,156,2,0,0,1,446,446,446,446
Lake,16,2022-04-04,14,14,13,1,973,973,931,42,0,0,0,0,139,139,139,139
Lassen,16,2022-04-04,5,5,5,0,1284,1284,1247,37,0,0,0,0,62,62,62,62
Los Angeles,16,2022-04-04,5484,5492,5434,58,803237,804244,795626,8618,255,47,47,42,31794,31794,31747,31747
Madera,16,2022-04-04,27,27,26,1,3190,3195,3062,133,3,0,0,1,370,370,370,370
Marin,16,2022-04-04,167,167,160,7,6342,6348,6090,258,3,0,0,1,295,295,295,295
Mariposa,16,2022-04-04,7,7,7,0,235,235,225,10,0,0,0,0,28,28,28,28
Mendocino,16,2022-04-04,25,25,24,1,1196,1196,1130,66,2,0,0,0,124,124,124,124
Merced,16,2022-04-04,58,58,56,2,3350,3355,3248,107,2,2,2,0,818,818,816,816
Modoc,16,2022-04-04,4,4,4,0,43,43,42,1,0,0,0,0,7,7,7,7
Mono,16,2022-04-04,1,1,1,0,142,142,133,9,0,0,0,0,6,6,6,6
Monterey,16,2022-04-04,128,128,120,8,7487,7497,7017,480,8,3,3,0,728,728,725,725
Napa,16,2022-04-04,75,75,73,2,3142,3147,3059,88,1,0,0,1,143,143,143,143
Nevada,16,2022-04-04,30,30,29,1,1447,1447,1388,59,1,1,1,0,128,128,127,127
Orange,16,2022-04-04,988,988,964,24,81457,81559,79526,2033,56,17,17,14,7077,7077,7060,7060
Placer,16,2022-04-04,129,129,123,6,6693,6700,6401,299,19,1,1,5,625,625,624,624
Plumas,16,2022-04-04,4,4,4,0,235,235,225,10,0,0,0,0,13,13,13,13
Riverside,16,2022-04-04,693,693,671,22,38899,38946,37672,1274,36,5,5,8,6446,6446,6441,6441
Sacramento,16,2022-04-04,430,430,415,15,33197,33238,32070,1168,50,8,8,11,3046,3046,3038,3038
San Benito,16,2022-04-04,13,13,13,0,1187,1187,1153,34,0,0,0,0,94,94,94,94
San Bernardino,16,2022-04-04,611,611,595,16,42043,42097,40978,1119,32,11,11,13,7796,7796,7785,7785
San Diego,16,2022-04-04,1549,1549,1532,17,66648,66732,65988,744,88,6,6,29,5324,5324,5318,5318
San Francisco,16,2022-04-04,999,999,930,69,28653,28689,26685,2004,20,1,1,3,866,866,865,865
San Joaquin,16,2022-04-04,229,229,220,9,15677,15696,15092,604,9,2,2,8,2247,2247,2245,2245
San Luis Obispo,16,2022-04-04,99,99,96,3,5390,5396,5233,163,2,1,1,1,478,478,477,477
San Mateo,16,2022-04-04,715,715,698,17,29220,29257,28534,723,14,2,2,1,703,703,701,701
Santa Barbara,16,2022-04-04,187,187,181,6,15270,15290,14773,517,7,2,2,1,689,689,687,687
Santa Clara,16,2022-04-04,1492,1492,1474,18,87482,87592,86542,1050,89,2,2,18,2297,2297,2295,2295
Santa Cruz,16,2022-04-04,210,210,204,6,16675,16696,16206,490,4,0,0,2,259,259,259,259
Shasta,16,2022-04-04,29,29,28,1,3319,3323,3206,117,4,1,1,2,560,560,559,559
Siskiyou,16,2022-04-04,2,2,2,0,294,294,286,8,0,0,0,0,83,83,83,83
Solano,16,2022-04-04,172,172,166,6,10286,10300,9961,339,21,1,1,4,448,448,447,447
Sonoma,16,2022-04-04,329,329,319,10,10651,10665,10321,344,9,1,1,1,490,490,489,489
Stanislaus,16,2022-04-04,113,113,107,6,7964,7974,7575,399,21,3,3,5,1689,1689,1686,1686
Sutter,16,2022-04-04,24,24,23,1,1324,1324,1280,44,0,0,0,0,224,224,224,224
Tehama,16,2022-04-04,6,6,6,0,765,765,728,37,0,1,1,0,206,206,205,205
Trinity,16,2022-04-04,1,1,1,0,87,87,83,4,0,0,0,0,20,20,20,20
Tulare,16,2022-04-04,49,49,46,3,7735,7743,7347,396,13,3,3,0,1488,1488,1485,1485
Tuolumne,16,2022-04-04,9,9,9,0,1034,1034,991,43,1,1,1,0,187,187,186,186
Ventura,16,2022-04-04,300,300,293,7,20329,20354,19890,464,19,5,5,5,1498,1498,1493,1493
Yolo,16,2022-04-04,104,104,101,3,26189,26222,25436,786,0,0,0,0,362,362,362,362
Yuba,16,2022-04-04,11,11,11,0,1072,1072,1038,34,4,0,0,1,119,119,119,119
Alameda,17,2022-04-11,1492,1492,1462,30,49603,49668,48642,1026,51,6,6,2,1871,1871,1865,1865
Amador,17,2022-04-11,9,9,9,0,1068,1068,1032,36,1,0,0,0,86,86,86,86
Butte,17,2022-04-11,33,33,32,1,2262,2265,2227,38,3,0,0,1,429,429,429,429
Calaveras,17,2022-04-11,14,14,14,0,649,649,630,19,0,0,0,0,119,119,119,119
Colusa,17,2022-04-11,6,6,6,0,203,203,198,5,0,0,0,0,21,21,21,21
Contra Costa,17,2022-04-11,712,712,688,24,20795,20821,20112,709,15,1,1,5,1301,1301,1300,1300
Del Norte,17,2022-04-11,9,9,9,0,1012,1012,985,27,0,0,0,0,49,49,49,49
El Dorado,17,2022-04-11,48,48,47,1,2508,2512,2439,73,1,0,0,0,213,213,213,213
Fresno,17,2022-04-11,194,194,188,6,15984,16005,15484,521,54,3,3,6,2759,2759,2756,2756
Glenn,17,2022-04-11,2,2,2,0,258,258,251,7,0,0,0,0,53,53,53,53
Humboldt,17,2022-04-11,46,46,45,1,2348,2352,2289,63,5,1,1,2,145,145,144,144
Imperial,17,2022-04-11,28,28,27,1,3476,3481,3379,102,2,1,1,1,945,945,944,944
Inyo,17,2022-04-11,4,4,4,0,188,188,183,5,0,0,0,0,56,56,56,56
Kern,17,2022-04-11,135,135,132,3,16363,16385,15987,398,20,2,2,6,2343,2343,2341,2341
Kings,17,2022-04-11,31,31,30,1,4156,4161,4039,122,3,0,0,0,446,446,446,446
Lake,17,2022-04-11,22,22,21,1,869,869,840,29,0,0,0,0,139,139,139,139
Lassen,17,2022-04-11,1,1,1,0,1291,1291,1262,29,1,0,0,0,62,62,62,62
Los Angeles,17,2022-04-11,6773,6781,6725,56,675546,676425,670713,5712,234,46,46,36,31840,31840,31794,31794
Madera,17,2022-04-11,29,29,28,1,3076,3081,2980,101,4,0,0,2,370,370,370,370
Marin,17,2022-04-11,204,204,198,6,5553,5560,5384,176,6,0,0,1,295,295,295,295
Mariposa,17,2022-04-11,7,7,7,0,246,246,237,9,0,0,0,0,28,28,28,28
Mendocino,17,2022-04-11,32,32,31,1,1158,1158,1108,50,0,0,0,0,124,124,124,124
Merced,17,2022-04-11,69,69,67,2,3221,3226,3145,81,6,2,2,0,820,820,818,818
Modoc,17,2022-04-11,0,0,0,0,40,40,39,1,0,0,0,0,7,7,7,7
Mono,17,2022-04-11,9,9,9,0,170,170,161,9,0,0,0,0,6,6,6,6
Monterey,17,2022-04-11,109,109,103,6,6884,6894,6544,350,9,2,2,0,730,730,728,728
Napa,17,2022-04-11,120,120,117,3,2799,2804,2742,62,1,0,0,0,143,143,143,143
Nevada,17,2022-04-11,45,45,44,1,1431,1431,1385,46,2,0,0,0,128,128,128,128
Orange,17,2022-04-11,1159,1159,1137,22,61960,62040,60861,1179,70,8,8,16,7085,7085,7077,7077
Placer,17,2022-04-11,126,126,122,4,5632,5639,5440,199,18,2,2,2,627,627,625,625
Plumas,17,2022-04-11,6,6,6,0,247,247,239,8,0,0,0,0,13,13,13,13
Riverside,17,2022-04-11,728,728,710,18,37765,37815,36844,971,35,5,5,9,6451,6451,6446,6446
Sacramento,17,2022-04-11,507,507,493,14,30455,30495,29652,843,47,11,11,5,3057,3057,3046,3046
San Benito,17,2022-04-11,17,17,17,0,1182,1182,1155,27,0,0,0,0,94,94,94,94
San Bernardino,17,2022-04-11,910,910,891,19,41998,42052,41176,876,33,5,5,7,7801,7801,7796,7796
San Diego,17,2022-04-11,1836,1836,1820,16,74059,74155,73506,649,91,4,4,22,5328,5328,5324,5324
San Francisco,17,2022-04-11,1178,1178,1113,65,29796,29833,28181,1652,19,6,6,4,872,872,866,866
San Joaquin,17,2022-04-11,221,221,214,7,15244,15263,14801,462,10,0,0,1,2247,2247,2247,2247
San Luis Obispo,17,2022-04-11,118,118,115,3,4914,4920,4804,116,2,1,1,0,479,479,478,478
San Mateo,17,2022-04-11,845,845,829,16,30237,30277,29688,589,8,2,2,1,705,705,703,703
Santa Barbara,17,2022-04-11,303,303,295,8,15107,15127,14725,402,6,2,2,1,691,691,689,689
Santa Clara,17,2022-04-11,1660,1660,1645,15,80648,80753,80001,752,61,4,4,13,2301,2301,2297,2297
Santa Cruz,17,2022-04-11,326,326,319,7,10986,11001,10760,241,7,1,1,0,260,260,259,259
Shasta,17,2022-04-11,18,18,18,0,3123,3128,3041,87,2,1,1,1,561,561,560,560
Siskiyou,17,2022-04-11,1,1,1,0,340,340,332,8,0,0,0,0,83,83,83,83
Solano,17,2022-04-11,249,249,243,6,9462,9474,9229,245,16,0,0,1,448,448,448,448
Sonoma,17,2022-04-11,416,416,406,10,10681,10695,10424,271,8,1,1,0,491,491,490,490
Stanislaus,17,2022-04-11,124,124,119,5,7642,7651,7349,302,22,1,1,1,1690,1690,1689,1689
Sutter,17,2022-04-11,20,20,19,1,1237,1237,1204,33,0,1,1,0,225,225,224,224
Tehama,17,2022-04-11,9,9,9,0,753,753,724,29,1,0,0,0,206,206,206,206
Trinity,17,2022-04-11,0,0,0,0,77,77,74,3,0,0,0,0,20,20,20,20
Tulare,17,2022-04-11,54,54,52,2,7834,7843,7526,317,11,3,3,0,1491,1491,1488,1488
Tuolumne,17,2022-04-11,22,22,21,1,1062,1062,1027,35,1,0,0,0,187,187,187,187
Ventura,17,2022-04-11,323,323,317,6,17583,17605,17291,314,16,2,2,2,1500,1500,1498,1498
Yolo,17,2022-04-11,130,130,127,3,18028,18051,17632,419,1,0,0,0,362,362,362,362
Yuba,17,2022-04-11,15,15,15,0,1021,1021,996,25,2,0,0,0,119,119,119,119
Alameda,18,2022-04-18,1779,1780,1751,29,54069,54142,53261,881,42,4,4,4,1875,1875,1871,1871
Amador,18,2022-04-18,12,12,12,0,1194,1194,1162,32,2,0,0,0,86,86,86,86
Butte,18,2022-04-18,47,47,46,1,2269,2272,2242,30,5,2,2,0,431,431,429,429
Calaveras,18,2022-04-18,16,16,16,0,576,576,563,13,0,1,1,0,120,120,119,119
Colusa,18,2022-04-18,3,3,3,0,157,157,154,3,0,0,0,0,21,21,21,21
Contra Costa,18,2022-04-18,1046,1046,1018,28,24725,24759,24090,669,26,1,1,5,1302,1302,1301,1301
Del Norte,18,2022-04-18,12,12,12,0,1010,1010,989,21,0,0,0,0,49,49,49,49
El Dorado,18,2022-04-18,69,69,67,2,2455,2459,2404,55,0,0,0,0,213,213,213,213
Fresno,18,2022-04-18,246,246,240,6,14195,14214,13854,360,42,4,4,5,2763,2763,2759,2759
Glenn,18,2022-04-18,4,4,4,0,278,278,272,6,0,0,0,0,53,53,53,53
Humboldt,18,2022-04-18,106,106,104,2,2052,2054,2011,43,4,1,1,2,146,146,145,145
Imperial,18,2022-04-18,49,49,48,1,3243,3248,3173,75,2,0,0,1,945,945,945,945
Inyo,18,2022-04-18,2,2,2,0,164,164,161,3,0,0,0,0,56,56,56,56
Kern,18,2022-04-18,150,150,147,3,13634,13652,13394,258,9,1,1,5,2344,2344,2343,2343
Kings,18,2022-04-18,44,44,43,1,3580,3585,3503,82,3,1,1,1,447,447,446,446
Lake,18,2022-04-18,16,16,16,0,782,782,762,20,2,1,1,1,140,140,139,139
Lassen,18,2022-04-18,1,1,1,0,1340,1341,1317,24,0,0,0,0,62,62,62,62
Los Angeles,18,2022-04-18,8361,8373,8319,54,469120,469748,466773,2975,200,35,35,26,31875,31875,31840,31840
Madera,18,2022-04-18,23,23,22,1,2521,2524,2459,65,2,0,0,2,370,370,370,370
Marin,18,2022-04-18,312,312,304,8,5989,5997,5846,151,6,0,0,0,295,295,295,295
Mariposa,18,2022-04-18,18,18,18,0,248,248,241,7,0,0,0,0,28,28,28,28
Mendocino,18,2022-04-18,53,53,51,2,1285,1285,1241,44,0,1,1,0,125,125,124,124
Merced,18,2022-04-18,65,65,64,1,3047,3052,2992,60,3,2,2,0,822,822,820,820
Modoc,18,2022-04-18,1,1,1,0,40,40,39,1,0,0,0,0,7,7,7,7
Mono,18,2022-04-18,9,9,9,0,122,122,117,5,0,0,0,0,6,6,6,6
Monterey,18,2022-04-18,157,157,151,6,6520,6528,6268,260,2,1,1,0,731,731,730,730
Napa,18,2022-04-18,164,164,161,3,2853,2858,2809,49,1,0,0,0,143,143,143,143
Nevada,18,2022-04-18,41,41,40,1,1260,1260,1228,32,1,0,0,0,128,128,128,128
Orange,18,2022-04-18,1442,1442,1421,21,79743,79849,78640,1209,50,5,5,10,7090,7090,7085,7085
Placer,18,2022-04-18,162,162,158,4,4801,4807,4675,132,30,0,0,3,627,627,627,627
Plumas,18,2022-04-18,6,6,6,0,225,225,219,6,0,0,0,0,13,13,13,13
Riverside,18,2022-04-18,933,933,914,19,36712,36761,36020,741,36,7,7,7,6458,6458,6451,6451
Sacramento,18,2022-04-18,711,711,696,15,28139,28178,27570,608,47,9,9,8,3066,3066,3057,3057
San Benito,18,2022-04-18,24,24,24,0,1170,1170,1149,21,0,0,0,0,94,94,94,94
San Bernardino,18,2022-04-18,1059,1059,1042,17,40079,40133,39479,654,35,7,7,8,7808,7808,7801,7801
San Diego,18,2022-04-18,2052,2053,2039,14,67074,67164,66705,459,78,9,9,17,5337,5337,5328,5328
San Francisco,18,2022-04-18,1437,1437,1375,62,30506,30547,29211,1336,27,2,2,2,874,874,872,872
San Joaquin,18,2022-04-18,248,248,242,6,14744,14763,14412,351,8,1,1,4,2248,2248,2247,2247
San Luis Obispo,18,2022-04-18,180,180,177,3,4963,4969,4877,92,2,2,2,0,481,481,479,479
San Mateo,18,2022-04-18,1112,1112,1095,17,30555,30595,30132,463,15,2,2,2,707,707,705,705
Santa Barbara,18,2022-04-18,299,299,293,6,14681,14702,14396,306,8,0,0,0,691,691,691,691
Santa Clara,18,2022-04-18,2233,2234,2218,16,70739,70832,70314,518,67,4,4,16,2305,2305,2301,2301
Santa Cruz,18,2022-04-18,436,436,428,8,12225,12241,12026,215,3,0,0,1,260,260,260,260
Shasta,18,2022-04-18,33,33,32,1,2849,2854,2792,62,2,1,1,2,562,562,561,561
Siskiyou,18,2022-04-18,8,8,8,0,318,318,312,6,0,0,0,0,83,83,83,83
Solano,18,2022-04-18,253,253,248,5,9324,9336,9147,189,6,1,1,1,449,449,448,448
Sonoma,18,2022-04-18,502,502,492,10,11185,11199,10976,223,16,1,1,4,492,492,491,491
Stanislaus,18,2022-04-18,161,161,156,5,7669,7681,7442,239,15,0,0,3,1690,1690,1690,1690
Sutter,18,2022-04-18,24,24,24,0,1173,1173,1149,24,0,0,0,0,225,225,225,225
Tehama,18,2022-04-18,7,7,7,0,685,685,664,21,1,0,0,0,206,206,206,206
Trinity,18,2022-04-18,1,1,1,0,72,72,70,2,0,0,0,0,20,20,20,20
Tulare,18,2022-04-18,77,77,75,2,6658,6665,6454,211,13,0,0,0,1491,1491,1491,1491
Tuolumne,18,2022-04-18,25,25,24,1,1025,1025,999,26,1,1,1,0,188,188,187,187
Ventura,18,2022-04-18,367,367,362,5,16410,16433,16205,228,8,3,3,0,1503,1503,1500,1500
Yolo,18,2022-04-18,217,217,213,4,17889,17912,17583,329,2,1,1,0,363,363,362,362
Yuba,18,2022-04-18,28,28,27,1,996,996,977,19,1,0,0,1,119,119,119,119
Alameda,19,2022-04-25,2523,2525,2493,32,60757,60842,60075,767,44,6,6,4,1881,1881,1875,1875
Amador,19,2022-04-25,26,26,25,1,1316,1316,1289,27,0,0,0,0,86,86,86,86
Butte,19,2022-04-25,66,66,65,1,2597,2601,2574,27,5,1,1,1,432,432,431,431
Calaveras,19,2022-04-25,34,34,33,1,687,687,675,12,0,0,0,0,120,120,120,120
Colusa,19,2022-04-25,3,3,3,0,199,199,196,3,0,0,0,0,21,21,21,21
Contra Costa,19,2022-04-25,1510,1510,1478,32,27235,27274,26700,574,25,3,3,3,1305,1305,1302,1302
Del Norte,19,2022-04-25,25,25,25,0,1104,1104,1086,18,0,0,0,0,49,49,49,49
El Dorado,19,2022-04-25,102,102,100,2,2646,2651,2604,47,1,0,0,0,213,213,213,213
Fresno,19,2022-04-25,332,332,325,7,16200,16223,15900,323,34,3,3,2,2766,2766,2763,2763
Glenn,19,2022-04-25,4,4,4,0,287,287,282,5,0,0,0,0,53,53,53,53
Humboldt,19,2022-04-25,168,168,165,3,2853,2858,2811,47,2,0,0,2,146,146,146,146
Imperial,19,2022-04-25,65,65,64,1,3541,3546,3482,64,4,0,0,1,945,945,945,945
Inyo,19,2022-04-25,7,7,7,0,194,194,191,3,0,0,0,0,56,56,56,56
Kern,19,2022-04-25,250,250,246,4,18299,18323,18052,271,14,2,2,4,2346,2346,2344,2344
Kings,19,2022-04-25,54,54,53,1,4515,4520,4439,81,3,0,0,1,447,447,447,447
Lake,19,2022-04-25,21,21,21,0,887,887,869,18,0,0,0,0,140,140,140,140
Lassen,19,2022-04-25,1,1,1,0,1556,1557,1535,22,0,0,0,0,62,62,62,62
Los Angeles,19,2022-04-25,11417,11431,11374,57,884825,886047,881556,4491,207,29,29,25,31904,31904,31875,31875
Madera,19,2022-04-25,44,44,43,1,2916,2920,2861,59,2,0,0,0,370,370,370,370
Marin,19,2022-04-25,329,329,323,6,6440,6449,6323,126,7,0,0,0,295,295,295,295
Mariposa,19,2022-04-25,9,9,9,0,205,205,201,4,0,0,0,0,28,28,28,28
Mendocino,19,2022-04-25,55,55,54,1,1254,1254,1220,34,0,1,1,0,126,126,125,125
Merced,19,2022-04-25,100,100,98,2,3030,3035,2989,46,5,0,0,0,822,822,822,822
Modoc,19,2022-04-25,1,1,1,0,41,41,40,1,0,0,0,0,7,7,7,7
Mono,19,2022-04-25,4,4,4,0,94,94,91,3,0,0,0,0,6,6,6,6
Monterey,19,2022-04-25,321,321,311,10,8007,8020,7770,250,5,1,1,0,732,732,731,731
Napa,19,2022-04-25,199,199,196,3,3375,3380,3334,46,2,0,0,0,143,143,143,143
Nevada,19,2022-04-25,52,52,51,1,1399,1400,1372,28,1,0,0,1,128,128,128,128
Orange,19,2022-04-25,1971,1972,1949,23,86593,86712,85689,1023,53,7,7,13,7097,7097,7090,7090
Placer,19,2022-04-25,237,237,232,5,6091,6098,5966,132,18,0,0,4,627,627,627,627
Plumas,19,2022-04-25,2,2,2,0,228,228,223,5,0,0,0,0,13,13,13,13
Riverside,19,2022-04-25,1302,1302,1282,20,40524,40579,39939,640,33,4,4,5,6462,6462,6458,6458
Sacramento,19,2022-04-25,1014,1014,997,17,32206,32250,31704,546,44,4,4,4,3070,3070,3066,3066
San Benito,19,2022-04-25,34,34,34,0,1118,1118,1102,16,0,0,0,0,94,94,94,94
San Bernardino,19,2022-04-25,1292,1292,1276,16,42974,43033,42485,548,21,10,10,7,7818,7818,7808,7808
San Diego,19,2022-04-25,3017,3022,3006,16,74308,74411,74015,396,86,5,5,10,5342,5342,5337,5337
San Francisco,19,2022-04-25,1995,1996,1928,68,32482,32528,31412,1116,23,1,1,3,875,875,874,874
San Joaquin,19,2022-04-25,393,393,386,7,15488,15509,15219,290,12,0,0,1,2248,2248,2248,2248
San Luis Obispo,19,2022-04-25,209,209,206,3,5039,5045,4972,73,6,0,0,0,481,481,481,481
San Mateo,19,2022-04-25,1511,1511,1493,18,32793,32838,32450,388,14,1,1,3,708,708,707,707
Santa Barbara,19,2022-04-25,371,371,365,6,15227,15248,15000,248,7,2,2,1,693,693,691,691
Santa Clara,19,2022-04-25,3142,3148,3130,18,76581,76687,76256,431,73,4,4,9,2309,2309,2305,2305
Santa Cruz,19,2022-04-25,473,473,467,6,20459,20489,20207,282,4,1,1,0,261,261,260,260
Shasta,19,2022-04-25,48,48,47,1,3316,3321,3265,56,3,0,0,1,562,562,562,562
Siskiyou,19,2022-04-25,7,7,7,0,322,322,318,4,0,0,0,0,83,83,83,83
Solano,19,2022-04-25,475,475,468,7,10618,10632,10464,168,11,0,0,2,449,449,449,449
Sonoma,19,2022-04-25,672,672,662,10,12067,12083,11895,188,19,0,0,2,492,492,492,492
Stanislaus,19,2022-04-25,240,240,234,6,7897,7908,7716,192,25,3,3,0,1693,1693,1690,1690
Sutter,19,2022-04-25,39,39,38,1,1399,1399,1376,23,0,1,1,0,226,226,225,225
Tehama,19,2022-04-25,17,17,17,0,711,711,694,17,1,0,0,0,206,206,206,206
Trinity,19,2022-04-25,1,1,1,0,72,72,70,2,0,0,0,0,20,20,20,20
Tulare,19,2022-04-25,90,90,88,2,6913,6922,6750,172,11,1,1,0,1492,1492,1491,1491
Tuolumne,19,2022-04-25,43,43,42,1,1124,1124,1101,23,2,0,0,0,188,188,188,188
Ventura,19,2022-04-25,604,604,597,7,18900,18926,18721,205,10,1,1,3,1504,1504,1503,1503
Yolo,19,2022-04-25,272,272,268,4,19349,19376,19098,278,1,0,0,0,363,363,363,363
Yuba,19,2022-04-25,31,31,31,0,1106,1106,1089,17,0,0,0,0,119,119,119,119
Alameda,20,2022-05-02,3370,3376,3343,33,67880,67978,67302,676,42,2,2,5,1883,1883,1881,1881
Amador,20,2022-05-02,19,19,19,0,1335,1335,1313,22,0,0,0,0,86,86,86,86
Butte,20,2022-05-02,90,90,89,1,2385,2389,2370,19,4,2,2,0,434,434,432,432
Calaveras,20,2022-05-02,23,23,23,0,726,726,716,10,0,0,0,0,120,120,120,120
Colusa,20,2022-05-02,2,2,2,0,203,203,201,2,0,0,0,0,21,21,21,21
Contra Costa,20,2022-05-02,1879,1880,1849,31,29219,29262,28779,483,40,2,2,5,1307,1307,1305,1305
Del Norte,20,2022-05-02,40,40,39,1,1202,1202,1187,15,1,0,0,0,49,49,49,49
El Dorado,20,2022-05-02,138,138,136,2,2753,2758,2720,38,1,1,1,0,214,214,213,213
Fresno,20,2022-05-02,496,496,488,8,17016,17041,16775,266,42,3,3,4,2769,2769,2766,2766
Glenn,20,2022-05-02,4,4,4,0,252,252,249,3,0,0,0,0,53,53,53,53
Humboldt,20,2022-05-02,268,268,265,3,2941,2946,2908,38,6,0,0,2,146,146,146,146
Imperial,20,2022-05-02,122,122,120,2,3666,3671,3619,52,1,0,0,1,945,945,945,945
Inyo,20,2022-05-02,2,2,2,0,179,179,177,2,0,0,0,0,56,56,56,56
Kern,20,2022-05-02,292,292,289,3,17932,17957,17749,208,10,0,0,5,2346,2346,2346,2346
Kings,20,2022-05-02,58,58,57,1,4848,4853,4785,68,3,0,0,1,447,447,447,447
Lake,20,2022-05-02,29,29,29,0,1003,1003,987,16,1,0,0,0,140,140,140,140
Lassen,20,2022-05-02,8,8,8,0,1608,1609,1591,18,0,0,0,0,62,62,62,62
Los Angeles,20,2022-05-02,14894,14915,14857,58,917521,918858,915211,3647,214,23,23,22,31927,31927,31904,31904
Madera,20,2022-05-02,75,75,74,1,3307,3312,3260,52,5,0,0,0,370,370,370,370
Marin,20,2022-05-02,427,427,421,6,6539,6549,6449,100,10,0,0,0,295,295,295,295
Mariposa,20,2022-05-02,7,7,7,0,244,244,240,4,0,0,0,0,28,28,28,28
Mendocino,20,2022-05-02,60,60,59,1,1223,1223,1197,26,0,0,0,0,126,126,126,126
Merced,20,2022-05-02,128,128,126,2,3282,3287,3248,39,8,4,4,0,826,826,822,822
Modoc,20,2022-05-02,0,0,0,0,36,37,36,1,0,0,0,0,7,7,7,7
Mono,20,2022-05-02,6,6,6,0,106,106,103,3,0,0,0,0,6,6,6,6
Monterey,20,2022-05-02,353,353,344,9,8384,8397,8191,206,8,1,1,0,733,733,732,732
Napa,20,2022-05-02,228,228,226,2,3546,3551,3513,38,4,0,0,0,143,143,143,143
Nevada,20,2022-05-02,80,80,79,1,1535,1536,1512,24,2,0,0,0,128,128,128,128
Orange,20,2022-05-02,2635,2640,2616,24,87471,87598,86788,810,61,5,5,13,7102,7102,7097,7097
Placer,20,2022-05-02,301,301,296,5,6372,6381,6273,108,20,0,0,4,627,627,627,627
Plumas,20,2022-05-02,9,9,9,0,256,256,252,4,0,0,0,0,13,13,13,13
Riverside,20,2022-05-02,2045,2046,2021,25,42953,43017,42487,530,37,3,3,5,6465,6465,6462,6462
Sacramento,20,2022-05-02,1385,1385,1367,18,33988,34037,33588,449,43,5,5,9,3075,3075,3070,3070
San Benito,20,2022-05-02,50,50,49,1,1285,1285,1271,14,0,0,0,0,94,94,94,94
San Bernardino,20,2022-05-02,1489,1489,1474,15,43529,43593,43159,434,30,7,7,6,7825,7825,7818,7818
San Diego,20,2022-05-02,4130,4137,4120,17,72911,73019,72716,303,79,3,3,13,5345,5345,5342,5342
San Francisco,20,2022-05-02,2413,2417,2352,65,35446,35498,34540,958,39,3,3,13,878,878,875,875
San Joaquin,20,2022-05-02,547,547,539,8,15197,15219,14997,222,14,1,1,1,2249,2249,2248,2248
San Luis Obispo,20,2022-05-02,249,249,246,3,5116,5122,5064,58,5,2,2,0,483,483,481,481
San Mateo,20,2022-05-02,1798,1799,1783,16,35870,35921,35588,333,22,2,2,5,710,710,708,708
Santa Barbara,20,2022-05-02,439,439,434,5,15309,15332,15137,195,10,0,0,2,693,693,693,693
Santa Clara,20,2022-05-02,4341,4348,4329,19,95860,96000,95574,426,88,5,5,15,2314,2314,2309,2309
Santa Cruz,20,2022-05-02,678,678,671,7,22014,22046,21808,238,2,1,1,0,262,262,261,261
Shasta,20,2022-05-02,67,67,66,1,3450,3455,3409,46,7,0,0,1,562,562,562,562
Siskiyou,20,2022-05-02,9,9,9,0,329,329,326,3,0,0,0,0,83,83,83,83
Solano,20,2022-05-02,622,622,614,8,11773,11790,11644,146,20,0,0,2,449,449,449,449
Sonoma,20,2022-05-02,899,899,888,11,12798,12816,12661,155,16,1,1,4,493,493,492,492
Stanislaus,20,2022-05-02,269,269,264,5,8082,8096,7941,155,22,0,0,3,1693,1693,1693,1693
Sutter,20,2022-05-02,47,47,46,1,1263,1263,1247,16,0,1,1,0,227,227,226,226
Tehama,20,2022-05-02,17,17,17,0,699,699,686,13,0,0,0,0,206,206,206,206
Trinity,20,2022-05-02,1,1,1,0,84,84,82,2,0,0,0,0,20,20,20,20
Tulare,20,2022-05-02,161,161,158,3,7288,7298,7156,142,10,3,3,0,1495,1495,1492,1492
Tuolumne,20,2022-05-02,93,93,92,1,1297,1297,1277,20,5,0,0,0,188,188,188,188
Ventura,20,2022-05-02,743,743,737,6,19918,19947,19778,169,15,4,4,1,1508,1508,1504,1504
Yolo,20,2022-05-02,352,352,348,4,18772,18799,18588,211,1,1,1,0,364,364,363,363
Yuba,20,2022-05-02,47,47,46,1,1054,1054,1042,12,2,0,0,1,119,119,119,119
Alameda,21,2022-05-09,4147,4154,4122,32,71315,71424,70871,553,44,6,6,6,1889,1889,1883,1883
Amador,21,2022-05-09,25,25,25,0,1518,1519,1500,19,0,0,0,0,86,86,86,86
Butte,21,2022-05-09,115,115,114,1,2412,2416,2401,15,5,0,0,0,434,434,434,434
Calaveras,21,2022-05-09,33,33,33,0,689,689,681,8,1,0,0,0,120,120,120,120
Colusa,21,2022-05-09,3,3,3,0,215,215,213,2,0,0,0,0,21,21,21,21
Contra Costa,21,2022-05-09,2516,2521,2489,32,30502,30549,30154,395,48,4,4,12,1311,1311,1307,1307
Del Norte,21,2022-05-09,49,49,49,0,1356,1357,1343,14,0,0,0,0,49,49,49,49
El Dorado,21,2022-05-09,176,176,174,2,2888,2893,2862,31,3,0,0,1,214,214,214,214
Fresno,21,2022-05-09,741,741,732,9,18158,18186,17964,222,29,1,1,1,2770,2770,2769,2769
Glenn,21,2022-05-09,8,8,8,0,228,228,226,2,0,0,0,0,53,53,53,53
Humboldt,21,2022-05-09,273,273,270,3,3149,3154,3122,32,5,0,0,2,146,146,146,146
Imperial,21,2022-05-09,131,131,130,1,3843,3848,3806,42,0,0,0,1,945,945,945,945
Inyo,21,2022-05-09,26,26,26,0,236,236,234,2,0,0,0,0,56,56,56,56
Kern,21,2022-05-09,467,467,463,4,18696,18725,18556,169,18,2,2,2,2348,2348,2346,2346
Kings,21,2022-05-09,91,91,90,1,4938,4945,4891,54,1,0,0,1,447,447,447,447
Lake,21,2022-05-09,30,30,30,0,1029,1029,1016,13,1,0,0,0,140,140,140,140
Lassen,21,2022-05-09,6,6,6,0,1689,1691,1677,14,0,0,0,0,62,62,62,62
Los Angeles,21,2022-05-09,18528,18557,18500,57,926811,928219,925351,2868,225,29,29,27,31956,31956,31927,31927
Madera,21,2022-05-09,132,132,130,2,3725,3730,3684,46,3,0,0,0,370,370,370,370
Marin,21,2022-05-09,708,708,700,8,7775,7787,7694,93,12,0,0,0,295,295,295,295
Mariposa,21,2022-05-09,32,32,32,0,287,287,283,4,0,0,0,0,28,28,28,28
Mendocino,21,2022-05-09,92,92,91,1,1264,1264,1243,21,0,1,1,0,127,127,126,126
Merced,21,2022-05-09,199,199,197,2,3429,3434,3402,32,4,1,1,0,827,827,826,826
Modoc,21,2022-05-09,2,2,2,0,41,42,41,1,0,0,0,0,7,7,7,7
Mono,21,2022-05-09,9,9,9,0,113,113,111,2,0,0,0,0,6,6,6,6
Monterey,21,2022-05-09,439,439,431,8,9377,9392,9211,181,11,0,0,0,733,733,733,733
Napa,21,2022-05-09,232,232,230,2,3119,3124,3098,26,2,0,0,0,143,143,143,143
Nevada,21,2022-05-09,101,101,100,1,1655,1656,1636,20,5,0,0,0,128,128,128,128
Orange,21,2022-05-09,3508,3515,3490,25,91755,91894,91231,663,84,8,8,17,7110,7110,7102,7102
Placer,21,2022-05-09,536,536,529,7,6753,6765,6675,90,25,0,0,2,627,627,627,627
Plumas,21,2022-05-09,13,13,13,0,274,274,271,3,0,0,0,0,13,13,13,13
Riverside,21,2022-05-09,2400,2405,2382,23,45138,45207,44771,436,42,4,4,8,6469,6469,6465,6465
Sacramento,21,2022-05-09,2242,2244,2221,23,36449,36505,36127,378,62,4,4,10,3079,3079,3075,3075
San Benito,21,2022-05-09,73,73,72,1,1433,1433,1421,12,0,0,0,0,94,94,94,94
San Bernardino,21,2022-05-09,1930,1931,1916,15,46589,46659,46296,363,31,5,5,4,7830,7830,7825,7825
San Diego,21,2022-05-09,5223,5231,5214,17,87117,87250,86966,284,98,2,2,11,5347,5347,5345,5345
San Francisco,21,2022-05-09,3037,3043,2979,64,38058,38117,37310,807,52,6,6,9,884,884,878,878
San Joaquin,21,2022-05-09,774,774,765,9,16068,16094,15911,183,11,1,1,3,2250,2250,2249,2249
San Luis Obispo,21,2022-05-09,289,289,286,3,5229,5235,5189,46,0,0,0,0,483,483,483,483
San Mateo,21,2022-05-09,2300,2303,2287,16,37593,37651,37379,272,26,3,3,1,713,713,710,710
Santa Barbara,21,2022-05-09,638,638,632,6,15588,15612,15457,155,10,0,0,3,693,693,693,693
Santa Clara,21,2022-05-09,5619,5627,5608,19,105573,105733,105367,366,87,3,3,23,2317,2317,2314,2314
Santa Cruz,21,2022-05-09,729,729,723,6,23965,24000,23798,202,2,0,0,0,262,262,262,262
Shasta,21,2022-05-09,106,106,105,1,3301,3306,3272,34,7,0,0,0,562,562,562,562
Siskiyou,21,2022-05-09,16,16,16,0,285,285,283,2,0,0,0,0,83,83,83,83
Solano,21,2022-05-09,917,917,908,9,12299,12318,12198,120,20,0,0,1,449,449,449,449
Sonoma,21,2022-05-09,1179,1179,1168,11,13975,13995,13862,133,18,1,1,2,494,494,493,493
Stanislaus,21,2022-05-09,460,460,453,7,8943,8957,8823,134,27,0,0,2,1693,1693,1693,1693
Sutter,21,2022-05-09,61,61,60,1,1565,1566,1550,16,0,0,0,0,227,227,227,227
Tehama,21,2022-05-09,28,28,28,0,691,691,681,10,1,0,0,0,206,206,206,206
Trinity,21,2022-05-09,4,4,4,0,69,69,68,1,0,0,0,0,20,20,20,20
Tulare,21,2022-05-09,182,182,179,3,7633,7645,7528,117,11,1,1,1,1496,1496,1495,1495
Tuolumne,21,2022-05-09,71,71,70,1,1429,1430,1413,17,1,2,2,0,190,190,188,188
Ventura,21,2022-05-09,1151,1151,1143,8,20948,20981,20842,139,15,1,1,2,1509,1509,1508,1508
Yolo,21,2022-05-09,492,492,488,4,19642,19672,19499,173,1,0,0,1,364,364,364,364
Yuba,21,2022-05-09,77,77,76,1,1243,1243,1231,12,2,0,0,0,119,119,119,119
Alameda,22,2022-05-16,4984,4992,4962,30,74820,74936,74482,454,73,8,8,6,1897,1897,1889,1889
Amador,22,2022-05-16,54,54,53,1,1672,1673,1656,17,0,0,0,0,86,86,86,86
Butte,22,2022-05-16,206,206,205,1,2665,2670,2657,13,7,2,2,0,436,436,434,434
Calaveras,22,2022-05-16,43,43,43,0,765,765,758,7,0,1,1,1,121,121,120,120
Colusa,22,2022-05-16,7,7,7,0,217,217,215,2,0,0,0,0,21,21,21,21
Contra Costa,22,2022-05-16,3481,3488,3453,35,33495,33546,33207,339,50,5,5,7,1316,1316,1311,1311
Del Norte,22,2022-05-16,172,172,171,1,1859,1861,1846,15,0,0,0,0,49,49,49,49
El Dorado,22,2022-05-16,267,267,265,2,3039,3044,3018,26,5,0,0,1,214,214,214,214
Fresno,22,2022-05-16,1138,1138,1127,11,19343,19373,19189,184,46,2,2,6,2772,2772,2770,2770
Glenn,22,2022-05-16,15,15,15,0,259,259,257,2,0,0,0,0,53,53,53,53
Humboldt,22,2022-05-16,274,274,272,2,3253,3258,3232,26,9,1,1,2,147,147,146,146
Imperial,22,2022-05-16,207,207,205,2,4299,4305,4268,37,1,0,0,1,945,945,945,945
Inyo,22,2022-05-16,19,19,19,0,228,228,226,2,1,0,0,0,56,56,56,56
Kern,22,2022-05-16,686,686,681,5,19977,20009,19868,141,22,3,3,3,2351,2351,2348,2348
Kings,22,2022-05-16,221,221,219,2,5418,5426,5380,46,0,0,0,0,447,447,447,447
Lake,22,2022-05-16,74,74,73,1,1118,1118,1107,11,2,0,0,0,140,140,140,140
Lassen,22,2022-05-16,20,20,20,0,1704,1706,1695,11,1,0,0,0,62,62,62,62
Los Angeles,22,2022-05-16,21523,21556,21505,51,938027,939495,937231,2264,283,39,39,44,31995,31995,31956,31956
Madera,22,2022-05-16,199,199,197,2,3632,3637,3602,35,2,0,0,0,370,370,370,370
Marin,22,2022-05-16,814,814,806,8,8382,8395,8316,79,12,0,0,0,295,295,295,295
Mariposa,22,2022-05-16,23,23,23,0,340,340,336,4,0,0,0,0,28,28,28,28
Mendocino,22,2022-05-16,99,99,98,1,1326,1326,1309,17,0,1,1,1,128,128,127,127
Merced,22,2022-05-16,316,316,314,2,4013,4018,3989,29,8,1,1,1,828,828,827,827
Modoc,22,2022-05-16,4,4,4,0,43,44,43,1,0,0,0,0,7,7,7,7
Mono,22,2022-05-16,11,11,11,0,112,112,110,2,0,0,0,0,6,6,6,6
Monterey,22,2022-05-16,508,508,500,8,9600,9615,9470,145,6,1,1,0,734,734,733,733
Napa,22,2022-05-16,299,299,297,2,3736,3741,3717,24,3,0,0,0,143,143,143,143
Nevada,22,2022-05-16,146,146,145,1,1833,1835,1818,17,2,0,0,0,128,128,128,128
Orange,22,2022-05-16,4547,4555,4530,25,94612,94760,94227,533,74,7,7,15,7117,7117,7110,7110
Placer,22,2022-05-16,738,738,730,8,7776,7789,7708,81,43,2,2,3,629,629,627,627
Plumas,22,2022-05-16,48,48,48,0,242,242,240,2,1,0,0,0,13,13,13,13
Riverside,22,2022-05-16,3342,3349,3324,25,47978,48054,47693,361,65,1,1,6,6470,6470,6469,6469
Sacramento,22,2022-05-16,3132,3138,3113,25,40224,40287,39962,325,89,8,8,12,3087,3087,3079,3079
San Benito,22,2022-05-16,110,110,109,1,1529,1530,1520,10,1,0,0,0,94,94,94,94
San Bernardino,22,2022-05-16,2466,2471,2456,15,49160,49236,48937,299,44,8,8,5,7838,7838,7830,7830
San Diego,22,2022-05-16,6674,6685,6668,17,94780,94929,94689,240,91,6,6,25,5353,5353,5347,5347
San Francisco,22,2022-05-16,3396,3403,3347,56,39289,39351,38698,653,68,5,5,8,889,889,884,884
San Joaquin,22,2022-05-16,1195,1195,1184,11,19022,19052,18882,170,16,1,1,1,2251,2251,2250,2250
San Luis Obispo,22,2022-05-16,425,425,422,3,6062,6071,6029,42,3,0,0,0,483,483,483,483
San Mateo,22,2022-05-16,2752,2758,2743,15,39871,39933,39708,225,39,1,1,1,714,714,713,713
Santa Barbara,22,2022-05-16,912,912,905,7,17036,17063,16931,132,13,0,0,2,693,693,693,693
Santa Clara,22,2022-05-16,7195,7207,7188,19,112710,112886,112582,304,111,9,9,15,2326,2326,2317,2317
Santa Cruz,22,2022-05-16,808,808,803,5,20738,20770,20630,140,5,0,0,0,262,262,262,262
Shasta,22,2022-05-16,127,127,126,1,3813,3818,3787,31,6,0,0,1,562,562,562,562
Siskiyou,22,2022-05-16,19,19,19,0,372,372,370,2,0,0,0,0,83,83,83,83
Solano,22,2022-05-16,1269,1270,1261,9,14179,14202,14095,107,29,0,0,2,449,449,449,449
Sonoma,22,2022-05-16,1567,1568,1557,11,15543,15568,15453,115,28,0,0,4,494,494,494,494
Stanislaus,22,2022-05-16,742,742,733,9,9946,9961,9845,116,33,2,2,5,1695,1695,1693,1693
Sutter,22,2022-05-16,109,109,108,1,1828,1831,1817,14,0,0,0,0,227,227,227,227
Tehama,22,2022-05-16,37,37,37,0,840,840,831,9,0,1,1,1,207,207,206,206
Trinity,22,2022-05-16,5,5,5,0,69,69,68,1,0,0,0,0,20,20,20,20
Tulare,22,2022-05-16,386,386,382,4,8319,8332,8233,99,14,1,1,0,1497,1497,1496,1496
Tuolumne,22,2022-05-16,139,139,138,1,1448,1449,1435,14,1,1,1,0,191,191,190,190
Ventura,22,2022-05-16,1551,1552,1544,8,23859,23897,23773,124,34,2,2,2,1511,1511,1509,1509
Yolo,22,2022-05-16,688,688,683,5,22146,22180,22028,152,0,0,0,1,364,364,364,364
Yuba,22,2022-05-16,119,119,118,1,1336,1336,1326,10,4,0,0,0,119,119,119,119
Alameda,23,2022-05-23,5598,5607,5581,26,77744,77870,77502,368,76,4,4,4,1901,1901,1897,1897
Amador,23,2022-05-23,80,80,79,1,1440,1440,1429,11,0,0,0,0,86,86,86,86
Butte,23,2022-05-23,283,283,282,1,2767,2772,2761,11,5,1,1,1,437,437,436,436
Calaveras,23,2022-05-23,52,52,52,0,743,743,738,5,0,1,1,0,122,122,121,121
Colusa,23,2022-05-23,7,7,7,0,232,232,231,1,0,0,0,0,21,21,21,21
Contra Costa,23,2022-05-23,3831,3838,3808,30,35350,35407,35127,280,71,10,10,7,1326,1326,1316,1316
Del Norte,23,2022-05-23,64,64,64,0,1346,1347,1339,8,0,1,1,0,50,50,49,49
El Dorado,23,2022-05-23,360,360,358,2,3417,3422,3399,23,6,2,2,0,216,216,214,214
Fresno,23,2022-05-23,1638,1639,1627,12,21584,21619,21458,161,63,2,2,8,2774,2774,2772,2772
Glenn,23,2022-05-23,26,26,26,0,273,273,271,2,0,0,0,0,53,53,53,53
Humboldt,23,2022-05-23,245,245,244,1,2911,2916,2898,18,14,1,1,3,148,148,147,147
Imperial,23,2022-05-23,343,343,341,2,4765,4772,4740,32,2,0,0,1,945,945,945,945
Inyo,23,2022-05-23,27,27,27,0,221,221,220,1,0,0,0,0,56,56,56,56
Kern,23,2022-05-23,1005,1005,1000,5,21275,21310,21193,117,34,0,0,7,2351,2351,2351,2351
Kings,23,2022-05-23,249,249,247,2,5643,5651,5613,38,1,0,0,0,447,447,447,447
Lake,23,2022-05-23,96,96,95,1,1238,1238,1228,10,1,0,0,1,140,140,140,140
Lassen,23,2022-05-23,41,41,41,0,1762,1764,1755,9,0,0,0,0,62,62,62,62
Los Angeles,23,2022-05-23,27844,27889,27837,52,946246,947778,945998,1780,366,31,31,53,32026,32026,31995,31995
Madera,23,2022-05-23,214,214,212,2,3763,3769,3740,29,1,0,0,2,370,370,370,370
Marin,23,2022-05-23,798,798,792,6,8778,8792,8728,64,15,0,0,1,295,295,295,295
Mariposa,23,2022-05-23,32,32,32,0,340,340,337,3,0,0,0,0,28,28,28,28
Mendocino,23,2022-05-23,150,150,149,1,1658,1661,1644,17,3,1,1,1,129,129,128,128
Merced,23,2022-05-23,409,409,407,2,4204,4210,4186,24,4,0,0,0,828,828,828,828
Modoc,23,2022-05-23,2,2,2,0,40,41,40,1,0,0,0,0,7,7,7,7
Mono,23,2022-05-23,14,14,14,0,163,163,161,2,0,0,0,0,6,6,6,6
Monterey,23,2022-05-23,697,697,689,8,9612,9627,9514,113,17,1,1,1,735,735,734,734
Napa,23,2022-05-23,331,331,329,2,3937,3942,3922,20,5,0,0,0,143,143,143,143
Nevada,23,2022-05-23,150,150,149,1,1904,1907,1893,14,2,0,0,0,128,128,128,128
Orange,23,2022-05-23,5574,5582,5558,24,94571,94724,94308,416,111,11,11,20,7128,7128,7117,7117
Placer,23,2022-05-23,878,878,871,7,7834,7847,7783,64,49,2,2,4,631,631,629,629
Plumas,23,2022-05-23,46,46,46,0,279,279,277,2,0,0,0,0,13,13,13,13
Riverside,23,2022-05-23,4448,4455,4429,26,52416,52501,52193,308,73,6,6,10,6476,6476,6470,6470
Sacramento,23,2022-05-23,3876,3883,3859,24,41428,41495,41233,262,122,7,7,10,3094,3094,3087,3087
San Benito,23,2022-05-23,167,167,166,1,1667,1669,1660,9,0,0,0,0,94,94,94,94
San Bernardino,23,2022-05-23,3315,3322,3306,16,50638,50719,50479,240,53,3,3,10,7841,7841,7838,7838
San Diego,23,2022-05-23,8844,8857,8840,17,103266,103434,103229,205,138,4,4,20,5357,5357,5353,5353
San Francisco,23,2022-05-23,3595,3602,3555,47,41604,41672,41131,541,85,6,6,9,895,895,889,889
San Joaquin,23,2022-05-23,1547,1548,1537,11,20971,21006,20860,146,20,3,3,7,2254,2254,2251,2251
San Luis Obispo,23,2022-05-23,668,668,664,4,7278,7291,7252,39,10,3,3,0,486,486,483,483
San Mateo,23,2022-05-23,3123,3130,3116,14,40765,40831,40651,180,35,0,0,0,714,714,714,714
Santa Barbara,23,2022-05-23,1064,1064,1058,6,17776,17804,17696,108,20,0,0,3,693,693,693,693
Santa Clara,23,2022-05-23,7824,7836,7820,16,111007,111186,110952,234,126,7,7,18,2333,2333,2326,2326
Santa Cruz,23,2022-05-23,505,505,502,3,7812,7825,7785,40,16,0,0,0,262,262,262,262
Shasta,23,2022-05-23,196,196,195,1,3608,3614,3591,23,4,1,1,3,563,563,562,562
Siskiyou,23,2022-05-23,29,29,29,0,364,364,362,2,1,0,0,0,83,83,83,83
Solano,23,2022-05-23,1503,1503,1494,9,14907,14932,14844,88,24,1,1,3,450,450,449,449
Sonoma,23,2022-05-23,1486,1486,1477,9,16332,16358,16263,95,34,2,2,3,496,496,494,494
Stanislaus,23,2022-05-23,868,868,860,8,10692,10708,10610,98,37,2,2,3,1697,1697,1695,1695
Sutter,23,2022-05-23,140,140,139,1,1912,1914,1903,11,0,1,1,0,228,228,227,227
Tehama,23,2022-05-23,49,49,49,0,811,811,804,7,1,0,0,1,207,207,207,207
Trinity,23,2022-05-23,3,3,3,0,90,90,89,1,0,0,0,0,20,20,20,20
Tulare,23,2022-05-23,551,551,546,5,9071,9087,9003,84,26,0,0,0,1497,1497,1497,1497
Tuolumne,23,2022-05-23,136,136,135,1,1576,1578,1566,12,0,1,1,0,192,192,191,191
Ventura,23,2022-05-23,1917,1920,1912,8,24017,24056,23959,97,36,1,1,1,1512,1512,1511,1511
Yolo,23,2022-05-23,729,729,725,4,22658,22694,22572,122,1,1,1,1,365,365,364,364
Yuba,23,2022-05-23,151,151,150,1,1455,1456,1448,8,6,0,0,1,119,119,119,119
Alameda,24,2022-05-30,4890,4898,4880,18,60659,60761,60532,229,95,4,4,7,1905,1905,1901,1901
Amador,24,2022-05-30,88,88,87,1,1191,1192,1185,7,0,1,1,0,87,87,86,86
Butte,24,2022-05-30,275,275,274,1,2710,2714,2706,8,20,0,0,1,437,437,437,437
Calaveras,24,2022-05-30,54,54,54,0,617,617,614,3,0,0,0,0,122,122,122,122
Colusa,24,2022-05-30,13,13,13,0,170,170,169,1,0,0,0,0,21,21,21,21
Contra Costa,24,2022-05-30,3313,3318,3297,21,28973,29020,28838,182,65,7,7,9,1333,1333,1326,1326
Del Norte,24,2022-05-30,36,36,36,0,975,975,970,5,2,1,1,0,51,51,50,50
El Dorado,24,2022-05-30,333,333,331,2,2938,2942,2926,16,6,2,2,2,218,218,216,216
Fresno,24,2022-05-30,1670,1672,1662,10,19662,19695,19578,117,71,6,6,7,2780,2780,2774,2774
Glenn,24,2022-05-30,27,27,27,0,290,290,289,1,2,0,0,0,53,53,53,53
Humboldt,24,2022-05-30,181,181,180,1,2296,2300,2289,11,10,0,0,5,148,148,148,148
Imperial,24,2022-05-30,332,332,330,2,4164,4171,4149,22,2,1,1,2,946,946,945,945
Inyo,24,2022-05-30,18,18,18,0,151,151,150,1,0,0,0,0,56,56,56,56
Kern,24,2022-05-30,1078,1078,1073,5,17985,18014,17935,79,36,0,0,6,2351,2351,2351,2351
Kings,24,2022-05-30,290,290,288,2,4664,4672,4647,25,2,0,0,1,447,447,447,447
Lake,24,2022-05-30,89,89,88,1,994,994,988,6,1,0,0,0,140,140,140,140
Lassen,24,2022-05-30,50,50,50,0,1615,1616,1609,7,1,0,0,0,62,62,62,62
Los Angeles,24,2022-05-30,26029,26073,26034,39,746577,747810,746683,1127,425,47,47,54,32073,32073,32026,32026
Madera,24,2022-05-30,235,235,234,1,3310,3315,3295,20,4,0,0,1,370,370,370,370
Marin,24,2022-05-30,649,649,645,4,7145,7157,7115,42,16,3,3,1,298,298,295,295
Mariposa,24,2022-05-30,39,39,39,0,303,303,301,2,0,0,0,0,28,28,28,28
Mendocino,24,2022-05-30,137,137,136,1,1264,1265,1255,10,4,0,0,1,129,129,129,129
Merced,24,2022-05-30,370,370,368,2,3407,3411,3395,16,6,0,0,2,828,828,828,828
Modoc,24,2022-05-30,4,4,4,0,38,39,38,1,0,0,0,0,7,7,7,7
Mono,24,2022-05-30,6,6,6,0,81,81,80,1,0,0,0,0,6,6,6,6
Monterey,24,2022-05-30,526,526,521,5,7139,7151,7084,67,19,1,1,1,736,736,735,735
Napa,24,2022-05-30,312,312,311,1,3179,3183,3170,13,4,0,0,0,143,143,143,143
Nevada,24,2022-05-30,181,181,180,1,1595,1598,1589,9,3,2,2,1,130,130,128,128
Orange,24,2022-05-30,5593,5603,5584,19,81959,82094,81807,287,122,9,9,18,7137,7137,7128,7128
Placer,24,2022-05-30,747,747,742,5,6131,6142,6102,40,52,0,0,8,631,631,631,631
Plumas,24,2022-05-30,35,35,35,0,200,200,199,1,1,0,0,0,13,13,13,13
Riverside,24,2022-05-30,3861,3868,3850,18,43856,43929,43724,205,82,3,3,10,6479,6479,6476,6476
Sacramento,24,2022-05-30,3838,3844,3825,19,33420,33474,33306,168,130,8,8,20,3102,3102,3094,3094
San Benito,24,2022-05-30,153,153,152,1,1274,1275,1270,5,0,0,0,0,94,94,94,94
San Bernardino,24,2022-05-30,3321,3327,3315,12,42865,42936,42774,162,49,5,5,10,7846,7846,7841,7841
San Diego,24,2022-05-30,8413,8426,8413,13,85850,85992,85857,135,153,10,10,26,5367,5367,5357,5357
San Francisco,24,2022-05-30,3116,3123,3091,32,33354,33408,33064,344,88,11,11,14,906,906,895,895
San Joaquin,24,2022-05-30,1398,1398,1390,8,17021,17049,16955,94,25,1,1,9,2255,2255,2254,2254
San Luis Obispo,24,2022-05-30,646,646,643,3,5443,5453,5430,23,12,1,1,0,487,487,486,486
San Mateo,24,2022-05-30,2723,2727,2718,9,31127,31179,31069,110,33,3,3,2,717,717,714,714
Santa Barbara,24,2022-05-30,1029,1029,1024,5,14449,14473,14403,70,23,2,2,5,695,695,693,693
Santa Clara,24,2022-05-30,7012,7023,7011,12,85018,85158,85015,143,154,10,10,22,2343,2343,2333,2333
Santa Cruz,24,2022-05-30,526,526,524,2,6241,6253,6227,26,7,1,1,1,263,263,262,262
Shasta,24,2022-05-30,133,133,132,1,2838,2842,2828,14,4,3,3,4,566,566,563,563
Siskiyou,24,2022-05-30,53,53,53,0,340,340,339,1,3,0,0,0,83,83,83,83
Solano,24,2022-05-30,1170,1170,1164,6,11547,11567,11512,55,28,0,0,7,450,450,450,450
Sonoma,24,2022-05-30,1198,1198,1193,5,13240,13263,13202,61,38,2,2,5,498,498,496,496
Stanislaus,24,2022-05-30,801,801,795,6,8579,8592,8530,62,55,2,2,3,1699,1699,1697,1697
Sutter,24,2022-05-30,157,157,156,1,1701,1702,1694,8,0,0,0,0,228,228,228,228
Tehama,24,2022-05-30,62,62,62,0,757,757,752,5,2,0,0,0,207,207,207,207
Trinity,24,2022-05-30,8,8,8,0,96,96,95,1,0,0,0,0,20,20,20,20
Tulare,24,2022-05-30,594,594,590,4,7483,7496,7440,56,19,0,0,0,1497,1497,1497,1497
Tuolumne,24,2022-05-30,121,121,120,1,1306,1307,1299,8,3,0,0,0,192,192,192,192
Ventura,24,2022-05-30,1681,1683,1678,5,19539,19570,19507,63,30,1,1,4,1513,1513,1512,1512
Yolo,24,2022-05-30,612,612,609,3,17618,17647,17572,75,4,0,0,1,365,365,365,365
Yuba,24,2022-05-30,144,144,143,1,1279,1279,1273,6,7,0,0,2,119,119,119,119
Alameda,25,2022-06-06,6458,6470,6451,19,73058,73183,72971,212,112,5,5,12,1910,1910,1905,1905
Amador,25,2022-06-06,115,115,114,1,1724,1727,1719,8,1,0,0,1,87,87,87,87
Butte,25,2022-06-06,452,452,451,1,3621,3626,3618,8,24,1,1,1,438,438,437,437
Calaveras,25,2022-06-06,73,73,73,0,737,737,734,3,0,2,2,0,124,124,122,122
Colusa,25,2022-06-06,22,22,22,0,276,276,275,1,3,0,0,0,21,21,21,21
Contra Costa,25,2022-06-06,4234,4241,4221,20,35645,35707,35534,173,107,9,9,7,1342,1342,1333,1333
Del Norte,25,2022-06-06,63,63,63,0,1134,1135,1131,4,2,0,0,0,51,51,51,51
El Dorado,25,2022-06-06,412,412,410,2,3635,3640,3625,15,5,0,0,5,218,218,218,218
Fresno,25,2022-06-06,2444,2449,2438,11,22980,23020,22915,105,94,2,2,6,2782,2782,2780,2780
Glenn,25,2022-06-06,41,41,41,0,325,325,324,1,3,0,0,0,53,53,53,53
Humboldt,25,2022-06-06,260,260,259,1,3054,3059,3048,11,14,1,1,3,149,149,148,148
Imperial,25,2022-06-06,465,465,463,2,4894,4902,4882,20,2,0,0,0,946,946,946,946
Inyo,25,2022-06-06,20,20,20,0,213,213,212,1,1,0,0,0,56,56,56,56
Kern,25,2022-06-06,1607,1608,1603,5,22974,23013,22935,78,35,1,1,6,2352,2352,2351,2351
Kings,25,2022-06-06,398,398,396,2,5504,5512,5489,23,10,0,0,1,447,447,447,447
Lake,25,2022-06-06,136,136,135,1,1180,1180,1174,6,5,0,0,2,140,140,140,140
Lassen,25,2022-06-06,69,69,69,0,2398,2403,2395,8,2,0,0,0,62,62,62,62
Los Angeles,25,2022-06-06,35176,35234,35194,40,1041593,1043368,1042164,1204,496,39,39,61,32112,32112,32073,32073
Madera,25,2022-06-06,351,351,349,2,4126,4133,4114,19,7,0,0,1,370,370,370,370
Marin,25,2022-06-06,735,735,732,3,7638,7651,7617,34,10,2,2,5,300,300,298,298
Mariposa,25,2022-06-06,58,58,58,0,404,404,402,2,0,0,0,0,28,28,28,28
Mendocino,25,2022-06-06,209,209,208,1,1711,1713,1702,11,9,1,1,2,130,130,129,129
Merced,25,2022-06-06,536,536,534,2,4530,4537,4521,16,16,0,0,0,828,828,828,828
Modoc,25,2022-06-06,11,11,11,0,37,38,37,1,0,0,0,0,7,7,7,7
Mono,25,2022-06-06,15,15,15,0,120,120,119,1,0,0,0,0,6,6,6,6
Monterey,25,2022-06-06,999,999,992,7,10219,10236,10162,74,17,2,2,1,738,738,736,736
Napa,25,2022-06-06,543,543,541,2,4203,4209,4196,13,8,1,1,0,144,144,143,143
Nevada,25,2022-06-06,248,248,247,1,2150,2154,2144,10,5,0,0,0,130,130,130,130
Orange,25,2022-06-06,7561,7573,7553,20,73540,73665,73468,197,140,12,12,18,7149,7149,7137,7137
Placer,25,2022-06-06,869,869,865,4,7604,7617,7579,38,65,0,0,11,631,631,631,631
Plumas,25,2022-06-06,40,40,40,0,321,321,320,1,0,0,0,0,13,13,13,13
Riverside,25,2022-06-06,5350,5360,5341,19,55952,56047,55846,201,88,6,6,10,6485,6485,6479,6479
Sacramento,25,2022-06-06,4941,4950,4931,19,42895,42968,42801,167,149,14,14,20,3116,3116,3102,3102
San Benito,25,2022-06-06,272,272,271,1,2015,2019,2013,6,0,0,0,1,94,94,94,94
San Bernardino,25,2022-06-06,5132,5141,5126,15,55831,55925,55763,162,77,7,7,14,7853,7853,7846,7846
San Diego,25,2022-06-06,10791,10809,10796,13,100441,100612,100490,122,185,8,8,22,5375,5375,5367,5367
San Francisco,25,2022-06-06,3513,3520,3492,28,38199,38264,37959,305,77,0,0,11,906,906,906,906
San Joaquin,25,2022-06-06,2127,2132,2123,9,22170,22208,22114,94,40,4,4,9,2259,2259,2255,2255
San Luis Obispo,25,2022-06-06,898,898,895,3,7543,7556,7531,25,16,1,1,1,488,488,487,487
San Mateo,25,2022-06-06,3197,3203,3194,9,36953,37015,36915,100,36,2,2,4,719,719,717,717
Santa Barbara,25,2022-06-06,1246,1246,1241,5,15068,15093,15037,56,22,1,1,5,696,696,695,695
Santa Clara,25,2022-06-06,8489,8504,8493,11,102114,102288,102156,132,176,6,6,22,2349,2349,2343,2343
Santa Cruz,25,2022-06-06,896,896,893,3,9700,9716,9686,30,24,1,1,3,264,264,263,263
Shasta,25,2022-06-06,209,209,208,1,4425,4432,4415,17,10,2,2,2,568,568,566,566
Siskiyou,25,2022-06-06,39,39,39,0,431,431,430,1,1,0,0,0,83,83,83,83
Solano,25,2022-06-06,1728,1731,1725,6,15143,15169,15114,55,29,2,2,1,452,452,450,450
Sonoma,25,2022-06-06,1633,1633,1627,6,13987,14011,13962,49,38,1,1,1,499,499,498,498
Stanislaus,25,2022-06-06,1188,1188,1181,7,10912,10932,10871,61,60,1,1,2,1700,1700,1699,1699
Sutter,25,2022-06-06,206,206,205,1,1941,1944,1937,7,0,0,0,0,228,228,228,228
Tehama,25,2022-06-06,82,82,82,0,1051,1051,1045,6,2,0,0,0,207,207,207,207
Trinity,25,2022-06-06,7,7,7,0,110,110,109,1,0,0,0,0,20,20,20,20
Tulare,25,2022-06-06,861,861,856,5,10776,10795,10734,61,24,0,0,0,1497,1497,1497,1497
Tuolumne,25,2022-06-06,123,123,122,1,1723,1725,1717,8,4,0,0,1,192,192,192,192
Ventura,25,2022-06-06,1973,1976,1971,5,24758,24800,24739,61,43,3,3,3,1516,1516,1513,1513
Yolo,25,2022-06-06,821,821,818,3,21418,21454,21384,70,2,1,1,0,366,366,365,365
Yuba,25,2022-06-06,186,186,185,1,1559,1562,1557,5,9,0,0,1,119,119,119,119
Alameda,26,2022-06-13,5068,5077,5066,11,55765,55863,55738,125,106,4,4,18,1914,1914,1910,1910
Amador,26,2022-06-13,130,130,130,0,1413,1415,1410,5,1,0,0,0,87,87,87,87
Butte,26,2022-06-13,394,394,393,1,3464,3469,3463,6,31,4,4,0,442,442,438,438
Calaveras,26,2022-06-13,69,69,69,0,658,658,656,2,0,0,0,0,124,124,124,124
Colusa,26,2022-06-13,12,12,12,0,328,328,327,1,17,0,0,0,21,21,21,21
Contra Costa,26,2022-06-13,3405,3411,3398,13,27935,27983,27877,106,89,8,8,12,1350,1350,1342,1342
Del Norte,26,2022-06-13,79,79,79,0,658,658,656,2,4,0,0,0,51,51,51,51
El Dorado,26,2022-06-13,329,329,328,1,3200,3205,3195,10,7,3,3,1,221,221,218,218
Fresno,26,2022-06-13,2395,2400,2392,8,20955,20991,20917,74,103,4,4,13,2786,2786,2782,2782
Glenn,26,2022-06-13,32,32,32,0,329,329,328,1,2,0,0,0,53,53,53,53
Humboldt,26,2022-06-13,262,262,261,1,2325,2330,2323,7,11,0,0,3,149,149,149,149
Imperial,26,2022-06-13,444,444,443,1,4556,4563,4548,15,6,1,1,0,947,947,946,946
Inyo,26,2022-06-13,13,13,13,0,189,189,188,1,0,0,0,0,56,56,56,56
Kern,26,2022-06-13,1558,1559,1555,4,21421,21458,21402,56,38,1,1,5,2353,2353,2352,2352
Kings,26,2022-06-13,358,358,357,1,5158,5167,5151,16,4,1,1,0,448,448,447,447
Lake,26,2022-06-13,138,138,137,1,1227,1227,1223,4,1,0,0,0,140,140,140,140
Lassen,26,2022-06-13,77,77,77,0,1994,1997,1992,5,2,0,0,0,62,62,62,62
Los Angeles,26,2022-06-13,30048,30101,30074,27,660303,661457,660858,599,519,54,54,60,32166,32166,32112,32112
Madera,26,2022-06-13,380,380,379,1,4230,4237,4222,15,7,0,0,2,370,370,370,370
Marin,26,2022-06-13,684,684,682,2,7022,7034,7009,25,16,2,2,2,302,302,300,300
Mariposa,26,2022-06-13,45,45,45,0,372,372,371,1,0,0,0,0,28,28,28,28
Mendocino,26,2022-06-13,161,161,160,1,1567,1569,1561,8,9,0,0,1,130,130,130,130
Merced,26,2022-06-13,562,562,560,2,4169,4175,4164,11,13,0,0,2,828,828,828,828
Modoc,26,2022-06-13,7,7,7,0,34,35,34,1,1,1,1,0,8,8,7,7
Mono,26,2022-06-13,19,19,19,0,92,92,91,1,0,0,0,0,6,6,6,6
Monterey,26,2022-06-13,835,835,830,5,8642,8656,8607,49,25,3,3,1,741,741,738,738
Napa,26,2022-06-13,432,432,431,1,3929,3934,3925,9,2,1,1,1,145,145,144,144
Nevada,26,2022-06-13,186,186,185,1,1874,1877,1870,7,8,0,0,0,130,130,130,130
Orange,26,2022-06-13,6993,7005,6991,14,65079,65193,65057,136,175,14,14,19,7163,7163,7149,7149
Placer,26,2022-06-13,791,791,788,3,6801,6813,6787,26,79,2,2,7,633,633,631,631
Plumas,26,2022-06-13,34,34,34,0,271,271,270,1,0,0,0,0,13,13,13,13
Riverside,26,2022-06-13,5037,5046,5032,14,47823,47906,47772,134,105,3,3,11,6488,6488,6485,6485
Sacramento,26,2022-06-13,4171,4178,4165,13,37976,38042,37928,114,190,12,12,20,3128,3128,3116,3116
San Benito,26,2022-06-13,200,200,200,0,1780,1783,1779,4,1,0,0,1,94,94,94,94
San Bernardino,26,2022-06-13,4657,4665,4655,10,48689,48775,48665,110,96,6,6,15,7859,7859,7853,7853
San Diego,26,2022-06-13,9622,9639,9630,9,84880,85029,84949,80,192,9,9,27,5384,5384,5375,5375
San Francisco,26,2022-06-13,3034,3041,3022,19,31089,31144,30951,193,72,11,11,13,917,917,906,906
San Joaquin,26,2022-06-13,1912,1916,1910,6,19014,19048,18985,63,32,5,5,3,2264,2264,2259,2259
San Luis Obispo,26,2022-06-13,661,661,659,2,6053,6065,6050,15,21,0,0,0,488,488,488,488
San Mateo,26,2022-06-13,2627,2632,2627,5,29044,29094,29033,61,44,3,3,3,722,722,719,719
Santa Barbara,26,2022-06-13,931,931,928,3,9468,9484,9457,27,15,1,1,5,697,697,696,696
Santa Clara,26,2022-06-13,7023,7035,7028,7,76215,76349,76272,77,182,13,13,23,2362,2362,2349,2349
Santa Cruz,26,2022-06-13,843,843,841,2,9939,9956,9932,24,23,0,0,1,264,264,264,264
Shasta,26,2022-06-13,220,220,219,1,3390,3395,3385,10,8,1,1,0,569,569,568,568
Siskiyou,26,2022-06-13,50,50,50,0,372,372,371,1,1,0,0,0,83,83,83,83
Solano,26,2022-06-13,1676,1679,1674,5,12877,12899,12863,36,33,0,0,2,452,452,452,452
Sonoma,26,2022-06-13,1337,1337,1333,4,11646,11667,11635,32,36,3,3,6,502,502,499,499
Stanislaus,26,2022-06-13,1132,1132,1127,5,9449,9464,9423,41,63,1,1,7,1701,1701,1700,1700
Sutter,26,2022-06-13,194,194,193,1,1722,1724,1719,5,0,0,0,0,228,228,228,228
Tehama,26,2022-06-13,87,87,87,0,967,967,963,4,3,0,0,0,207,207,207,207
Trinity,26,2022-06-13,11,11,11,0,84,85,84,1,0,0,0,0,20,20,20,20
Tulare,26,2022-06-13,816,816,812,4,9453,9470,9428,42,26,2,2,1,1499,1499,1497,1497
Tuolumne,26,2022-06-13,147,147,146,1,1444,1445,1440,5,2,0,0,0,192,192,192,192
Ventura,26,2022-06-13,1934,1937,1933,4,20977,21014,20974,40,38,3,3,5,1519,1519,1516,1516
Yolo,26,2022-06-13,766,766,764,2,14234,14258,14221,37,4,1,1,0,367,367,366,366
Yuba,26,2022-06-13,188,188,187,1,1423,1423,1419,4,8,0,0,1,119,119,119,119
Alameda,27,2022-06-20,4945,4953,4944,9,48501,48588,48503,85,105,12,12,14,1926,1926,1914,1914
Amador,27,2022-06-20,104,104,104,0,1247,1248,1244,4,2,0,0,0,87,87,87,87
Butte,27,2022-06-20,413,413,412,1,3561,3566,3561,5,28,4,4,1,446,446,442,442
Calaveras,27,2022-06-20,82,82,82,0,624,624,622,2,0,0,0,0,124,124,124,124
Colusa,27,2022-06-20,17,17,17,0,176,177,176,1,15,1,1,0,22,22,21,21
Contra Costa,27,2022-06-20,3330,3337,3327,10,25979,26026,25949,77,81,7,7,8,1357,1357,1350,1350
Del Norte,27,2022-06-20,82,82,82,0,611,611,610,1,3,1,1,1,52,52,51,51
El Dorado,27,2022-06-20,351,351,350,1,3075,3080,3072,8,5,2,2,1,223,223,221,221
Fresno,27,2022-06-20,2467,2472,2465,7,19762,19798,19743,55,100,3,3,16,2789,2789,2786,2786
Glenn,27,2022-06-20,41,41,41,0,314,314,313,1,3,0,0,0,53,53,53,53
Humboldt,27,2022-06-20,272,272,271,1,2273,2278,2273,5,11,0,0,3,149,149,149,149
Imperial,27,2022-06-20,602,602,601,1,3697,3703,3694,9,5,0,0,0,947,947,947,947
Inyo,27,2022-06-20,18,18,18,0,187,188,187,1,0,0,0,0,56,56,56,56
Kern,27,2022-06-20,1647,1648,1645,3,20129,20166,20125,41,39,5,5,9,2358,2358,2353,2353
Kings,27,2022-06-20,413,413,412,1,4866,4875,4863,12,6,1,1,0,449,449,448,448
Lake,27,2022-06-20,120,120,120,0,1234,1235,1232,3,1,0,0,2,140,140,140,140
Lassen,27,2022-06-20,43,43,43,0,1223,1224,1222,2,1,0,0,0,62,62,62,62
Los Angeles,27,2022-06-20,27643,27692,27673,19,351338,351971,351727,244,596,57,57,68,32223,32223,32166,32166
Madera,27,2022-06-20,335,335,334,1,4163,4171,4159,12,4,0,0,1,370,370,370,370
Marin,27,2022-06-20,691,691,689,2,6317,6329,6312,17,21,0,0,1,302,302,302,302
Mariposa,27,2022-06-20,53,53,53,0,335,335,334,1,0,0,0,0,28,28,28,28
Mendocino,27,2022-06-20,179,179,178,1,1577,1580,1574,6,3,0,0,0,130,130,130,130
Merced,27,2022-06-20,542,542,541,1,3956,3962,3954,8,7,3,3,1,831,831,828,828
Modoc,27,2022-06-20,5,5,5,0,37,38,37,1,0,0,0,0,8,8,8,8
Mono,27,2022-06-20,6,6,6,0,82,83,82,1,1,1,1,0,7,7,6,6
Monterey,27,2022-06-20,894,894,890,4,8900,8916,8877,39,38,1,1,2,742,742,741,741
Napa,27,2022-06-20,364,364,363,1,3130,3135,3129,6,3,1,1,0,146,146,145,145
Nevada,27,2022-06-20,170,170,170,0,1619,1621,1617,4,6,1,1,0,131,131,130,130
Orange,27,2022-06-20,6965,6977,6966,11,60365,60473,60375,98,152,10,10,23,7173,7173,7163,7163
Placer,27,2022-06-20,671,671,669,2,6052,6064,6046,18,69,1,1,7,634,634,633,633
Plumas,27,2022-06-20,38,38,38,0,239,239,238,1,0,0,0,0,13,13,13,13
Riverside,27,2022-06-20,4953,4961,4950,11,43290,43368,43273,95,112,5,5,14,6493,6493,6488,6488
Sacramento,27,2022-06-20,3922,3929,3920,9,35214,35276,35193,83,171,12,12,21,3140,3140,3128,3128
San Benito,27,2022-06-20,172,172,172,0,1597,1599,1596,3,0,1,1,2,95,95,94,94
San Bernardino,27,2022-06-20,4507,4515,4507,8,46246,46329,46248,81,105,12,12,17,7871,7871,7859,7859
San Diego,27,2022-06-20,9697,9715,9708,7,77458,77597,77540,57,203,10,10,17,5394,5394,5384,5384
San Francisco,27,2022-06-20,3048,3055,3040,15,28263,28313,28176,137,72,12,12,14,929,929,917,917
San Joaquin,27,2022-06-20,1667,1668,1664,4,17902,17934,17888,46,38,5,5,6,2269,2269,2264,2264
San Luis Obispo,27,2022-06-20,596,596,595,1,5819,5831,5819,12,27,10,10,0,498,498,488,488
San Mateo,27,2022-06-20,2610,2616,2612,4,25825,25872,25830,42,42,2,2,1,724,724,722,722
Santa Barbara,27,2022-06-20,933,933,931,2,8161,8176,8158,18,33,2,2,6,699,699,697,697
Santa Clara,27,2022-06-20,6793,6805,6800,5,62928,63041,62992,49,170,8,8,21,2370,2370,2362,2362
Santa Cruz,27,2022-06-20,818,818,816,2,9113,9130,9113,17,19,1,1,2,265,265,264,264
Shasta,27,2022-06-20,240,240,239,1,3372,3378,3370,8,9,1,1,1,570,570,569,569
Siskiyou,27,2022-06-20,61,61,61,0,394,394,393,1,5,1,1,0,84,84,83,83
Solano,27,2022-06-20,1406,1406,1403,3,11441,11463,11438,25,41,0,0,5,452,452,452,452
Sonoma,27,2022-06-20,1400,1400,1397,3,10790,10810,10787,23,28,1,1,3,503,503,502,502
Stanislaus,27,2022-06-20,1040,1040,1036,4,8833,8848,8818,30,70,6,6,7,1707,1707,1701,1701
Sutter,27,2022-06-20,196,196,196,0,1858,1860,1856,4,0,0,0,0,228,228,228,228
Tehama,27,2022-06-20,98,98,98,0,889,889,886,3,3,0,0,0,207,207,207,207
Trinity,27,2022-06-20,10,10,10,0,106,107,106,1,0,0,0,0,20,20,20,20
Tulare,27,2022-06-20,868,868,865,3,8729,8744,8714,30,32,8,8,0,1507,1507,1499,1499
Tuolumne,27,2022-06-20,141,141,141,0,1554,1556,1552,4,3,0,0,1,192,192,192,192
Ventura,27,2022-06-20,1835,1838,1835,3,18660,18694,18666,28,50,1,1,7,1520,1520,1519,1519
Yolo,27,2022-06-20,678,678,677,1,10553,10571,10550,21,1,2,2,2,369,369,367,367
Yuba,27,2022-06-20,149,149,149,0,1340,1340,1337,3,13,0,0,5,119,119,119,119
Alameda,28,2022-06-27,5456,5467,5460,7,48144,48236,48170,66,124,8,8,16,1934,1934,1926,1926
Amador,28,2022-06-27,88,88,88,0,1149,1149,1146,3,3,0,0,1,87,87,87,87
Butte,28,2022-06-27,410,410,410,0,3471,3476,3472,4,30,2,2,0,448,448,446,446
Calaveras,28,2022-06-27,68,68,68,0,570,570,569,1,1,2,2,0,126,126,124,124
Colusa,28,2022-06-27,28,28,28,0,282,283,282,1,6,0,0,0,22,22,22,22
Contra Costa,28,2022-06-27,3519,3526,3518,8,25881,25931,25872,59,82,11,11,7,1368,1368,1357,1357
Del Norte,28,2022-06-27,140,140,140,0,669,669,668,1,5,1,1,2,53,53,52,52
El Dorado,28,2022-06-27,432,432,431,1,3362,3367,3361,6,5,0,0,1,223,223,223,223
Fresno,28,2022-06-27,2815,2821,2815,6,20029,20067,20024,43,136,2,2,17,2791,2791,2789,2789
Glenn,28,2022-06-27,28,28,28,0,296,296,295,1,1,0,0,0,53,53,53,53
Humboldt,28,2022-06-27,261,261,261,0,2189,2194,2190,4,10,1,1,2,150,150,149,149
Imperial,28,2022-06-27,702,702,701,1,4022,4029,4021,8,7,0,0,4,947,947,947,947
Inyo,28,2022-06-27,32,32,32,0,311,311,310,1,1,0,0,0,56,56,56,56
Kern,28,2022-06-27,1813,1818,1815,3,17278,17311,17283,28,52,7,7,8,2365,2365,2358,2358
Kings,28,2022-06-27,468,468,467,1,3931,3938,3930,8,9,0,0,0,449,449,449,449
Lake,28,2022-06-27,121,121,121,0,1139,1140,1137,3,2,0,0,0,140,140,140,140
Lassen,28,2022-06-27,51,51,51,0,848,848,847,1,1,0,0,0,62,62,62,62
Los Angeles,28,2022-06-27,32789,32851,32833,18,364219,364905,364708,197,679,73,73,68,32296,32296,32223,32223
Madera,28,2022-06-27,413,413,412,1,4286,4295,4286,9,8,0,0,0,370,370,370,370
Marin,28,2022-06-27,659,659,658,1,6226,6238,6225,13,20,1,1,2,303,303,302,302
Mariposa,28,2022-06-27,55,55,55,0,310,310,309,1,0,0,0,0,28,28,28,28
Mendocino,28,2022-06-27,153,153,153,0,1447,1449,1445,4,5,1,1,1,131,131,130,130
Merced,28,2022-06-27,614,614,613,1,4035,4041,4034,7,14,2,2,0,833,833,831,831
Modoc,28,2022-06-27,7,7,7,0,32,33,32,1,0,0,0,0,8,8,8,8
Mono,28,2022-06-27,24,24,24,0,109,110,109,1,1,0,0,0,7,7,7,7
Monterey,28,2022-06-27,933,933,930,3,8267,8284,8256,28,44,2,2,3,744,744,742,742
Napa,28,2022-06-27,391,391,390,1,3311,3316,3311,5,3,2,2,1,148,148,146,146
Nevada,28,2022-06-27,189,189,189,0,1619,1621,1618,3,4,0,0,3,131,131,131,131
Orange,28,2022-06-27,7531,7544,7535,9,59227,59338,59263,75,183,16,16,26,7189,7189,7173,7173
Placer,28,2022-06-27,806,806,804,2,6181,6193,6178,15,79,6,6,6,640,640,634,634
Plumas,28,2022-06-27,50,50,50,0,257,257,256,1,1,0,0,0,13,13,13,13
Riverside,28,2022-06-27,6181,6193,6183,10,44922,45008,44932,76,141,11,11,17,6504,6504,6493,6493
Sacramento,28,2022-06-27,4157,4165,4157,8,35673,35741,35676,65,173,9,9,25,3149,3149,3140,3140
San Benito,28,2022-06-27,221,221,221,0,1655,1658,1656,2,0,0,0,1,95,95,95,95
San Bernardino,28,2022-06-27,5721,5732,5724,8,48811,48903,48836,67,130,12,12,24,7883,7883,7871,7871
San Diego,28,2022-06-27,10869,10890,10884,6,80581,80734,80688,46,264,8,8,28,5402,5402,5394,5394
San Francisco,28,2022-06-27,3271,3278,3266,12,29216,29271,29161,110,92,5,5,23,934,934,929,929
San Joaquin,28,2022-06-27,1889,1893,1889,4,17978,18012,17976,36,46,2,2,5,2271,2271,2269,2269
San Luis Obispo,28,2022-06-27,645,645,644,1,5647,5658,5649,9,25,3,3,0,501,501,498,498
San Mateo,28,2022-06-27,2871,2878,2874,4,26806,26857,26823,34,36,1,1,2,725,725,724,724
Santa Barbara,28,2022-06-27,1145,1145,1143,2,9771,9789,9772,17,26,2,2,2,701,701,699,699
Santa Clara,28,2022-06-27,7522,7537,7532,5,60848,60962,60925,37,213,11,11,19,2381,2381,2370,2370
Santa Cruz,28,2022-06-27,861,861,860,1,9146,9164,9150,14,26,2,2,1,267,267,265,265
Shasta,28,2022-06-27,338,338,337,1,3309,3315,3309,6,21,0,0,4,570,570,570,570
Siskiyou,28,2022-06-27,63,63,63,0,355,355,354,1,2,1,1,0,85,85,84,84
Solano,28,2022-06-27,1593,1595,1592,3,12987,13012,12990,22,47,0,0,4,452,452,452,452
Sonoma,28,2022-06-27,1367,1367,1365,2,10095,10115,10098,17,33,2,2,3,505,505,503,503
Stanislaus,28,2022-06-27,1211,1211,1208,3,8583,8598,8575,23,96,2,2,6,1709,1709,1707,1707
Sutter,28,2022-06-27,197,197,197,0,1843,1846,1843,3,0,0,0,0,228,228,228,228
Tehama,28,2022-06-27,91,91,91,0,888,888,886,2,3,0,0,0,207,207,207,207
Trinity,28,2022-06-27,24,24,24,0,142,143,142,1,1,0,0,0,20,20,20,20
Tulare,28,2022-06-27,901,901,899,2,7884,7900,7879,21,35,0,0,2,1507,1507,1507,1507
Tuolumne,28,2022-06-27,171,171,171,0,1404,1405,1402,3,1,4,4,1,196,196,192,192
Ventura,28,2022-06-27,2090,2095,2093,2,18527,18561,18539,22,61,3,3,1,1523,1523,1520,1520
Yolo,28,2022-06-27,786,786,785,1,11207,11229,11212,17,8,0,0,1,369,369,369,369
Yuba,28,2022-06-27,171,171,171,0,1435,1436,1434,2,10,2,2,2,121,121,119,119
Alameda,29,2022-07-04,4818,4829,4824,5,38602,38679,38637,42,128,11,11,10,1945,1945,1934,1934
Amador,29,2022-07-04,66,66,66,0,1534,1536,1533,3,3,1,1,1,88,88,87,87
Butte,29,2022-07-04,283,283,283,0,2490,2494,2492,2,28,2,2,1,450,450,448,448
Calaveras,29,2022-07-04,82,82,82,0,487,487,486,1,0,2,2,0,128,128,126,126
Colusa,29,2022-07-04,21,21,21,0,150,151,150,1,4,0,0,0,22,22,22,22
Contra Costa,29,2022-07-04,3319,3326,3320,6,20838,20879,20841,38,76,10,10,12,1378,1378,1368,1368
Del Norte,29,2022-07-04,138,138,138,0,587,587,586,1,3,0,0,0,53,53,53,53
El Dorado,29,2022-07-04,307,307,307,0,2392,2396,2392,4,10,1,1,0,224,224,223,223
Fresno,29,2022-07-04,2462,2468,2464,4,15714,15744,15717,27,158,6,6,17,2797,2797,2791,2791
Glenn,29,2022-07-04,24,24,24,0,157,158,157,1,1,0,0,0,53,53,53,53
Humboldt,29,2022-07-04,188,188,188,0,1584,1588,1586,2,12,2,2,3,152,152,150,150
Imperial,29,2022-07-04,697,697,696,1,3239,3244,3239,5,8,1,1,3,948,948,947,947
Inyo,29,2022-07-04,41,41,41,0,292,293,292,1,1,0,0,0,56,56,56,56
Kern,29,2022-07-04,1757,1761,1759,2,14149,14176,14158,18,63,4,4,9,2369,2369,2365,2365
Kings,29,2022-07-04,437,437,436,1,3446,3452,3447,5,5,0,0,0,449,449,449,449
Lake,29,2022-07-04,107,107,107,0,790,790,789,1,3,2,2,0,142,142,140,140
Lassen,29,2022-07-04,31,31,31,0,640,640,639,1,2,0,0,0,62,62,62,62
Los Angeles,29,2022-07-04,32284,32349,32335,14,285758,286323,286200,123,801,88,88,85,32384,32384,32296,32296
Madera,29,2022-07-04,341,341,340,1,3179,3186,3180,6,9,0,0,1,370,370,370,370
Marin,29,2022-07-04,608,608,607,1,5159,5170,5161,9,25,1,1,2,304,304,303,303
Mariposa,29,2022-07-04,36,36,36,0,222,223,222,1,0,0,0,0,28,28,28,28
Mendocino,29,2022-07-04,164,164,164,0,1120,1121,1118,3,6,2,2,1,133,133,131,131
Merced,29,2022-07-04,594,594,593,1,2918,2922,2918,4,14,2,2,1,835,835,833,833
Modoc,29,2022-07-04,10,10,10,0,31,32,31,1,0,0,0,0,8,8,8,8
Mono,29,2022-07-04,22,22,22,0,81,82,81,1,1,0,0,0,7,7,7,7
Monterey,29,2022-07-04,842,842,840,2,6313,6325,6308,17,39,2,2,4,746,746,744,744
Napa,29,2022-07-04,340,340,340,0,2554,2558,2555,3,13,0,0,1,148,148,148,148
Nevada,29,2022-07-04,177,177,177,0,1268,1269,1267,2,5,0,0,1,131,131,131,131
Orange,29,2022-07-04,6950,6963,6956,7,50651,50751,50700,51,203,25,25,34,7214,7214,7189,7189
Placer,29,2022-07-04,806,806,805,1,5048,5059,5050,9,72,3,3,6,643,643,640,640
Plumas,29,2022-07-04,31,31,31,0,172,173,172,1,0,0,0,0,13,13,13,13
Riverside,29,2022-07-04,6385,6396,6387,9,38507,38583,38531,52,137,5,5,8,6509,6509,6504,6504
Sacramento,29,2022-07-04,3571,3578,3573,5,26843,26896,26857,39,163,19,19,22,3168,3168,3149,3149
San Benito,29,2022-07-04,210,210,210,0,1273,1275,1273,2,3,0,0,0,95,95,95,95
San Bernardino,29,2022-07-04,6058,6069,6062,7,41588,41669,41624,45,147,12,12,26,7895,7895,7883,7883
San Diego,29,2022-07-04,9608,9627,9623,4,65441,65570,65540,30,262,10,10,43,5412,5412,5402,5402
San Francisco,29,2022-07-04,2897,2904,2895,9,24142,24190,24118,72,100,11,11,18,945,945,934,934
San Joaquin,29,2022-07-04,1676,1680,1677,3,14663,14693,14670,23,41,5,5,4,2276,2276,2271,2271
San Luis Obispo,29,2022-07-04,616,616,615,1,4165,4173,4168,5,24,0,0,0,501,501,501,501
San Mateo,29,2022-07-04,2577,2584,2581,3,21461,21505,21483,22,39,1,1,3,726,726,725,725
Santa Barbara,29,2022-07-04,1057,1057,1056,1,7649,7664,7653,11,26,4,4,4,705,705,701,701
Santa Clara,29,2022-07-04,6803,6815,6812,3,50024,50122,50098,24,191,16,16,34,2397,2397,2381,2381
Santa Cruz,29,2022-07-04,732,732,731,1,7122,7137,7129,8,22,0,0,0,267,267,267,267
Shasta,29,2022-07-04,280,280,280,0,2396,2400,2396,4,15,5,5,3,575,575,570,570
Siskiyou,29,2022-07-04,34,34,34,0,326,327,326,1,1,0,0,1,85,85,85,85
Solano,29,2022-07-04,1336,1338,1336,2,9820,9840,9827,13,50,0,0,5,452,452,452,452
Sonoma,29,2022-07-04,1084,1084,1083,1,8088,8104,8093,11,35,2,2,1,507,507,505,505
Stanislaus,29,2022-07-04,1168,1168,1166,2,6990,7002,6987,15,84,7,7,16,1716,1716,1709,1709
Sutter,29,2022-07-04,230,230,230,0,1671,1673,1671,2,0,0,0,0,228,228,228,228
Tehama,29,2022-07-04,132,132,132,0,821,821,819,2,3,1,1,0,208,208,207,207
Trinity,29,2022-07-04,17,17,17,0,143,144,143,1,2,0,0,0,20,20,20,20
Tulare,29,2022-07-04,940,940,938,2,6104,6117,6104,13,40,4,4,1,1511,1511,1507,1507
Tuolumne,29,2022-07-04,164,164,164,0,938,939,937,2,8,0,0,1,196,196,196,196
Ventura,29,2022-07-04,1948,1952,1950,2,15405,15435,15421,14,66,2,2,8,1525,1525,1523,1523
Yolo,29,2022-07-04,534,534,533,1,7183,7196,7187,9,6,3,3,2,372,372,369,369
Yuba,29,2022-07-04,168,168,168,0,1080,1081,1080,1,9,0,0,1,121,121,121,121
Alameda,30,2022-07-11,5787,5799,5794,5,48248,48349,48309,40,119,8,8,16,1953,1953,1945,1945
Amador,30,2022-07-11,91,91,91,0,1504,1507,1505,2,2,0,0,0,88,88,88,88
Butte,30,2022-07-11,497,497,497,0,3298,3304,3302,2,27,1,1,4,451,451,450,450
Calaveras,30,2022-07-11,78,78,78,0,566,566,565,1,0,1,1,1,129,129,128,128
Colusa,30,2022-07-11,26,26,26,0,483,484,483,1,0,0,0,0,22,22,22,22
Contra Costa,30,2022-07-11,3680,3687,3682,5,26528,26583,26546,37,91,11,11,11,1389,1389,1378,1378
Del Norte,30,2022-07-11,174,174,174,0,677,677,676,1,5,0,0,1,53,53,53,53
El Dorado,30,2022-07-11,383,383,383,0,3151,3157,3153,4,12,1,1,3,225,225,224,224
Fresno,30,2022-07-11,3659,3666,3661,5,21640,21684,21656,28,161,7,7,14,2804,2804,2797,2797
Glenn,30,2022-07-11,45,45,45,0,382,383,382,1,0,0,0,0,53,53,53,53
Humboldt,30,2022-07-11,291,291,291,0,2190,2195,2193,2,11,1,1,2,153,153,152,152
Imperial,30,2022-07-11,1114,1114,1113,1,4754,4764,4758,6,14,1,1,1,949,949,948,948
Inyo,30,2022-07-11,38,38,38,0,389,390,389,1,0,1,1,0,57,57,56,56
Kern,30,2022-07-11,2452,2458,2456,2,16952,16987,16971,16,77,2,2,9,2371,2371,2369,2369
Kings,30,2022-07-11,730,730,729,1,4341,4350,4345,5,11,3,3,0,452,452,449,449
Lake,30,2022-07-11,126,126,126,0,1115,1115,1113,2,0,0,0,0,142,142,142,142
Lassen,30,2022-07-11,59,59,59,0,821,821,820,1,2,1,1,0,63,63,62,62
Los Angeles,30,2022-07-11,43304,43392,43378,14,381115,381908,381782,126,1038,88,88,115,32472,32472,32384,32384
Madera,30,2022-07-11,532,532,531,1,4126,4135,4129,6,15,0,0,3,370,370,370,370
Marin,30,2022-07-11,603,603,602,1,5926,5938,5930,8,17,1,1,1,305,305,304,304
Mariposa,30,2022-07-11,52,52,52,0,283,284,283,1,0,0,0,0,28,28,28,28
Mendocino,30,2022-07-11,189,189,189,0,1387,1388,1386,2,4,0,0,0,133,133,133,133
Merced,30,2022-07-11,761,761,760,1,4272,4279,4275,4,16,5,5,1,840,840,835,835
Modoc,30,2022-07-11,28,28,28,0,57,58,57,1,0,0,0,0,8,8,8,8
Mono,30,2022-07-11,11,11,11,0,105,106,105,1,0,0,0,0,7,7,7,7
Monterey,30,2022-07-11,1091,1091,1089,2,7945,7961,7944,17,47,4,4,3,750,750,746,746
Napa,30,2022-07-11,367,367,367,0,3660,3666,3663,3,13,1,1,1,149,149,148,148
Nevada,30,2022-07-11,221,221,221,0,1826,1831,1829,2,7,0,0,1,131,131,131,131
Orange,30,2022-07-11,9718,9739,9732,7,64133,64267,64217,50,257,20,20,30,7234,7234,7214,7214
Placer,30,2022-07-11,786,786,785,1,5965,5978,5969,9,76,2,2,8,645,645,643,643
Plumas,30,2022-07-11,71,71,71,0,282,283,282,1,0,0,0,0,13,13,13,13
Riverside,30,2022-07-11,9198,9217,9208,9,52052,52160,52106,54,225,17,17,12,6526,6526,6509,6509
Sacramento,30,2022-07-11,4193,4201,4196,5,35998,36072,36032,40,184,21,21,24,3189,3189,3168,3168
San Benito,30,2022-07-11,235,235,235,0,1666,1669,1667,2,1,0,0,0,95,95,95,95
San Bernardino,30,2022-07-11,8423,8442,8435,7,57661,57781,57733,48,188,14,14,20,7909,7909,7895,7895
San Diego,30,2022-07-11,13679,13707,13702,5,85543,85722,85692,30,332,10,10,41,5422,5422,5412,5412
San Francisco,30,2022-07-11,2987,2993,2986,7,27836,27894,27830,64,105,11,11,23,956,956,945,945
San Joaquin,30,2022-07-11,2134,2139,2136,3,19364,19406,19382,24,55,7,7,11,2283,2283,2276,2276
San Luis Obispo,30,2022-07-11,752,752,751,1,5271,5283,5278,5,22,3,3,1,504,504,501,501
San Mateo,30,2022-07-11,2764,2771,2769,2,25574,25628,25608,20,42,6,6,4,732,732,726,726
Santa Barbara,30,2022-07-11,1326,1326,1325,1,9700,9719,9709,10,46,5,5,9,710,710,705,705
Santa Clara,30,2022-07-11,7405,7420,7417,3,59706,59829,59807,22,211,12,12,38,2409,2409,2397,2397
Santa Cruz,30,2022-07-11,1026,1026,1025,1,9506,9525,9516,9,16,0,0,0,267,267,267,267
Shasta,30,2022-07-11,327,327,327,0,3565,3572,3568,4,21,2,2,6,577,577,575,575
Siskiyou,30,2022-07-11,29,29,29,0,361,362,361,1,1,1,1,1,86,86,85,85
Solano,30,2022-07-11,1617,1622,1620,2,11636,11661,11649,12,40,1,1,6,453,453,452,452
Sonoma,30,2022-07-11,1297,1299,1298,1,9941,9963,9953,10,50,0,0,7,507,507,507,507
Stanislaus,30,2022-07-11,1495,1497,1495,2,8685,8703,8689,14,103,7,7,11,1723,1723,1716,1716
Sutter,30,2022-07-11,287,287,287,0,1777,1781,1779,2,0,0,0,0,228,228,228,228
Tehama,30,2022-07-11,134,134,134,0,925,925,924,1,5,0,0,1,208,208,208,208
Trinity,30,2022-07-11,35,35,35,0,120,121,120,1,0,0,0,0,20,20,20,20
Tulare,30,2022-07-11,1382,1383,1381,2,9561,9582,9566,16,47,4,4,2,1515,1515,1511,1511
Tuolumne,30,2022-07-11,250,250,250,0,1303,1305,1303,2,6,0,0,0,196,196,196,196
Ventura,30,2022-07-11,2549,2556,2554,2,19713,19753,19739,14,89,9,9,6,1534,1534,1525,1525
Yolo,30,2022-07-11,500,500,500,0,5413,5425,5420,5,4,3,3,4,375,375,372,372
Yuba,30,2022-07-11,218,218,218,0,1405,1408,1407,1,9,0,0,1,121,121,121,121
Alameda,31,2022-07-18,4927,4939,4936,3,42847,42941,42913,28,149,9,9,25,1962,1962,1953,1953
Amador,31,2022-07-18,85,85,85,0,1348,1350,1349,1,6,0,0,1,88,88,88,88
Butte,31,2022-07-18,334,334,334,0,2794,2799,2798,1,25,1,1,3,452,452,451,451
Calaveras,31,2022-07-18,78,78,78,0,545,546,545,1,0,0,0,0,129,129,129,129
Colusa,31,2022-07-18,23,23,23,0,349,350,349,1,2,0,0,0,22,22,22,22
Contra Costa,31,2022-07-18,3050,3057,3054,3,22693,22742,22717,25,88,4,4,16,1393,1393,1389,1389
Del Norte,31,2022-07-18,167,167,167,0,705,705,704,1,7,0,0,0,53,53,53,53
El Dorado,31,2022-07-18,279,279,279,0,2637,2642,2640,2,11,1,1,1,226,226,225,225
Fresno,31,2022-07-18,3691,3699,3695,4,21172,21218,21196,22,199,9,9,15,2813,2813,2804,2804
Glenn,31,2022-07-18,34,34,34,0,263,264,263,1,0,0,0,0,53,53,53,53
Humboldt,31,2022-07-18,293,293,293,0,2024,2029,2027,2,10,0,0,4,153,153,153,153
Imperial,31,2022-07-18,1023,1023,1022,1,4439,4451,4447,4,18,2,2,3,951,951,949,949
Inyo,31,2022-07-18,30,30,30,0,331,332,331,1,0,0,0,0,57,57,57,57
Kern,31,2022-07-18,2290,2295,2293,2,16469,16504,16492,12,72,9,9,14,2380,2380,2371,2371
Kings,31,2022-07-18,705,705,704,1,4156,4165,4161,4,16,1,1,0,453,453,452,452
Lake,31,2022-07-18,132,132,132,0,993,994,993,1,3,0,0,0,142,142,142,142
Lassen,31,2022-07-18,77,77,77,0,1238,1240,1239,1,1,0,0,0,63,63,63,63
Los Angeles,31,2022-07-18,41811,41902,41891,11,352111,352879,352789,90,1162,113,113,137,32585,32585,32472,32472
Madera,31,2022-07-18,528,528,527,1,3632,3639,3635,4,5,0,0,3,370,370,370,370
Marin,31,2022-07-18,516,516,515,1,5500,5512,5506,6,12,1,1,5,306,306,305,305
Mariposa,31,2022-07-18,42,42,42,0,242,243,242,1,0,1,1,0,29,29,28,28
Mendocino,31,2022-07-18,185,185,185,0,1491,1494,1492,2,6,0,0,2,133,133,133,133
Merced,31,2022-07-18,751,751,750,1,3981,3989,3986,3,15,1,1,1,841,841,840,840
Modoc,31,2022-07-18,13,13,13,0,34,35,34,1,1,0,0,0,8,8,8,8
Mono,31,2022-07-18,10,10,10,0,85,86,85,1,1,0,0,0,7,7,7,7
Monterey,31,2022-07-18,980,980,978,2,7189,7204,7192,12,46,6,6,4,756,756,750,750
Napa,31,2022-07-18,318,318,318,0,2953,2958,2956,2,10,2,2,2,151,151,149,149
Nevada,31,2022-07-18,135,135,135,0,1330,1332,1331,1,8,0,0,3,131,131,131,131
Orange,31,2022-07-18,8776,8796,8791,5,59761,59891,59855,36,253,24,24,45,7258,7258,7234,7234
Placer,31,2022-07-18,684,684,683,1,5240,5252,5246,6,89,1,1,5,646,646,645,645
Plumas,31,2022-07-18,60,60,60,0,279,280,279,1,0,0,0,0,13,13,13,13
Riverside,31,2022-07-18,8245,8264,8257,7,48065,48170,48131,39,222,16,16,17,6542,6542,6526,6526
Sacramento,31,2022-07-18,3533,3540,3537,3,30803,30869,30842,27,180,12,12,26,3201,3201,3189,3189
San Benito,31,2022-07-18,197,197,197,0,1586,1590,1589,1,1,1,1,0,96,96,95,95
San Bernardino,31,2022-07-18,7964,7983,7978,5,53728,53845,53810,35,214,13,13,35,7922,7922,7909,7909
San Diego,31,2022-07-18,13088,13116,13112,4,79845,80019,79997,22,402,18,18,52,5440,5440,5422,5422
San Francisco,31,2022-07-18,2481,2487,2483,4,25492,25547,25502,45,111,10,10,24,966,966,956,956
San Joaquin,31,2022-07-18,2044,2049,2047,2,18049,18087,18070,17,66,2,2,11,2285,2285,2283,2283
San Luis Obispo,31,2022-07-18,559,559,559,0,4628,4638,4635,3,17,3,3,1,507,507,504,504
San Mateo,31,2022-07-18,2280,2287,2286,1,23030,23080,23066,14,33,0,0,4,732,732,732,732
Santa Barbara,31,2022-07-18,1296,1297,1296,1,9269,9288,9280,8,47,1,1,6,711,711,710,710
Santa Clara,31,2022-07-18,6208,6221,6219,2,54220,54337,54321,16,199,12,12,30,2421,2421,2409,2409
Santa Cruz,31,2022-07-18,874,874,873,1,7442,7459,7454,5,24,1,1,2,268,268,267,267
Shasta,31,2022-07-18,323,323,323,0,3213,3219,3216,3,40,3,3,3,580,580,577,577
Siskiyou,31,2022-07-18,34,34,34,0,345,346,345,1,3,0,0,0,86,86,86,86
Solano,31,2022-07-18,1236,1236,1235,1,9516,9537,9529,8,49,1,1,6,454,454,453,453
Sonoma,31,2022-07-18,1052,1052,1051,1,8741,8761,8754,7,44,0,0,5,507,507,507,507
Stanislaus,31,2022-07-18,1401,1403,1401,2,8395,8414,8403,11,109,5,5,9,1728,1728,1723,1723
Sutter,31,2022-07-18,251,251,251,0,1673,1676,1675,1,0,0,0,0,228,228,228,228
Tehama,31,2022-07-18,110,110,110,0,896,896,895,1,7,1,1,0,209,209,208,208
Trinity,31,2022-07-18,20,20,20,0,111,112,111,1,1,0,0,0,20,20,20,20
Tulare,31,2022-07-18,1181,1181,1180,1,8089,8107,8097,10,45,0,0,0,1515,1515,1515,1515
Tuolumne,31,2022-07-18,239,239,239,0,1143,1144,1143,1,7,4,4,0,200,200,196,196
Ventura,31,2022-07-18,2325,2331,2330,1,19561,19604,19593,11,92,3,3,7,1537,1537,1534,1534
Yolo,31,2022-07-18,430,430,430,0,4643,4654,4651,3,2,3,3,1,378,378,375,375
Yuba,31,2022-07-18,213,213,213,0,1293,1296,1295,1,18,0,0,0,121,121,121,121
Alameda,32,2022-07-25,4398,4410,4408,2,40377,40469,40449,20,143,12,12,19,1974,1974,1962,1962
Amador,32,2022-07-25,89,89,89,0,1206,1208,1207,1,3,0,0,1,88,88,88,88
Butte,32,2022-07-25,359,359,359,0,2946,2952,2951,1,30,1,1,2,453,453,452,452
Calaveras,32,2022-07-25,82,82,82,0,558,559,558,1,0,2,2,1,131,131,129,129
Colusa,32,2022-07-25,26,26,26,0,373,374,373,1,1,0,0,0,22,22,22,22
Contra Costa,32,2022-07-25,2819,2826,2824,2,21949,22000,21981,19,102,6,6,18,1399,1399,1393,1393
Del Norte,32,2022-07-25,66,66,66,0,534,535,534,1,6,0,0,0,53,53,53,53
El Dorado,32,2022-07-25,272,272,272,0,2487,2492,2490,2,9,1,1,0,227,227,226,226
Fresno,32,2022-07-25,3351,3359,3356,3,20442,20488,20472,16,195,6,6,29,2819,2819,2813,2813
Glenn,32,2022-07-25,31,31,31,0,271,272,271,1,0,0,0,0,53,53,53,53
Humboldt,32,2022-07-25,230,230,230,0,1923,1928,1927,1,13,2,2,4,155,155,153,153
Imperial,32,2022-07-25,873,873,872,1,4345,4356,4353,3,18,1,1,6,952,952,951,951
Inyo,32,2022-07-25,18,18,18,0,284,285,284,1,2,1,1,0,58,58,57,57
Kern,32,2022-07-25,1896,1901,1900,1,14987,15021,15012,9,82,3,3,12,2383,2383,2380,2380
Kings,32,2022-07-25,572,572,572,0,3888,3897,3894,3,15,1,1,0,454,454,453,453
Lake,32,2022-07-25,128,128,128,0,1041,1042,1041,1,5,1,1,2,143,143,142,142
Lassen,32,2022-07-25,52,52,52,0,1070,1071,1070,1,1,0,0,0,63,63,63,63
Los Angeles,32,2022-07-25,37102,37187,37180,7,334145,334909,334842,67,1152,120,120,134,32705,32705,32585,32585
Madera,32,2022-07-25,537,537,537,0,3828,3836,3833,3,11,1,1,5,371,371,370,370
Marin,32,2022-07-25,488,488,488,0,5410,5422,5418,4,26,2,2,2,308,308,306,306
Mariposa,32,2022-07-25,40,40,40,0,232,233,232,1,0,0,0,0,29,29,29,29
Mendocino,32,2022-07-25,196,196,196,0,1426,1428,1426,2,6,0,0,0,133,133,133,133
Merced,32,2022-07-25,730,730,730,0,3904,3912,3910,2,22,2,2,2,843,843,841,841
Modoc,32,2022-07-25,5,5,5,0,28,29,28,1,0,1,1,0,9,9,8,8
Mono,32,2022-07-25,15,15,15,0,84,85,84,1,0,0,0,0,7,7,7,7
Monterey,32,2022-07-25,932,932,931,1,7128,7144,7135,9,39,1,1,3,757,757,756,756
Napa,32,2022-07-25,296,296,296,0,2930,2935,2933,2,6,3,3,0,154,154,151,151
Nevada,32,2022-07-25,116,116,116,0,1316,1319,1318,1,3,1,1,0,132,132,131,131
Orange,32,2022-07-25,7986,8005,8001,4,58126,58259,58232,27,306,37,37,35,7295,7295,7258,7258
Placer,32,2022-07-25,604,604,603,1,5087,5100,5096,4,77,5,5,11,651,651,646,646
Plumas,32,2022-07-25,25,25,25,0,188,189,188,1,0,0,0,0,13,13,13,13
Riverside,32,2022-07-25,7499,7516,7511,5,45922,46028,45999,29,259,16,16,27,6558,6558,6542,6542
Sacramento,32,2022-07-25,3625,3633,3631,2,30214,30284,30264,20,207,18,18,32,3219,3219,3201,3201
San Benito,32,2022-07-25,198,198,198,0,1396,1399,1398,1,0,1,1,0,97,97,96,96
San Bernardino,32,2022-07-25,7077,7092,7088,4,52121,52241,52215,26,214,30,30,23,7952,7952,7922,7922
San Diego,32,2022-07-25,11897,11924,11921,3,76163,76336,76320,16,393,17,17,41,5457,5457,5440,5440
San Francisco,32,2022-07-25,2288,2293,2290,3,24254,24310,24276,34,126,9,9,24,975,975,966,966
San Joaquin,32,2022-07-25,1835,1840,1839,1,16591,16629,16617,12,73,5,5,9,2290,2290,2285,2285
San Luis Obispo,32,2022-07-25,538,538,538,0,4382,4391,4388,3,16,4,4,1,511,511,507,507
San Mateo,32,2022-07-25,1997,2003,2002,1,21584,21633,21623,10,57,1,1,7,733,733,732,732
Santa Barbara,32,2022-07-25,1177,1178,1177,1,8769,8789,8783,6,37,4,4,3,715,715,711,711
Santa Clara,32,2022-07-25,5796,5809,5808,1,50454,50570,50559,11,238,16,16,26,2437,2437,2421,2421
Santa Cruz,32,2022-07-25,832,832,832,0,7652,7670,7666,4,23,0,0,0,268,268,268,268
Shasta,32,2022-07-25,306,306,306,0,3080,3087,3085,2,38,2,2,6,582,582,580,580
Siskiyou,32,2022-07-25,36,36,36,0,333,334,333,1,1,0,0,0,86,86,86,86
Solano,32,2022-07-25,1196,1199,1198,1,9462,9484,9478,6,56,0,0,5,454,454,454,454
Sonoma,32,2022-07-25,1065,1065,1064,1,8648,8668,8663,5,48,1,1,4,508,508,507,507
Stanislaus,32,2022-07-25,1379,1382,1381,1,8156,8174,8166,8,104,8,8,11,1736,1736,1728,1728
Sutter,32,2022-07-25,222,222,222,0,1721,1724,1723,1,0,0,0,0,228,228,228,228
Tehama,32,2022-07-25,102,102,102,0,920,920,919,1,5,2,2,0,211,211,209,209
Trinity,32,2022-07-25,12,12,12,0,102,103,102,1,0,0,0,0,20,20,20,20
Tulare,32,2022-07-25,1121,1121,1120,1,8017,8036,8028,8,42,2,2,2,1517,1517,1515,1515
Tuolumne,32,2022-07-25,200,200,200,0,1150,1152,1151,1,5,1,1,0,201,201,200,200
Ventura,32,2022-07-25,2154,2159,2158,1,18388,18430,18422,8,76,4,4,8,1541,1541,1537,1537
Yolo,32,2022-07-25,411,411,411,0,4383,4394,4392,2,4,3,3,1,381,381,378,378
Yuba,32,2022-07-25,175,175,175,0,1282,1286,1285,1,15,0,0,0,121,121,121,121
Alameda,33,2022-08-01,3809,3819,3818,1,37153,37243,37228,15,176,7,7,21,1981,1981,1974,1974
Amador,33,2022-08-01,53,53,53,0,1132,1133,1132,1,3,1,1,0,89,89,88,88
Butte,33,2022-08-01,368,368,368,0,2843,2849,2848,1,33,2,2,3,455,455,453,453
Calaveras,33,2022-08-01,68,68,68,0,573,574,573,1,2,1,1,2,132,132,131,131
Colusa,33,2022-08-01,26,26,26,0,362,363,362,1,7,0,0,0,22,22,22,22
Contra Costa,33,2022-08-01,2608,2615,2613,2,20991,21043,21029,14,86,13,13,15,1412,1412,1399,1399
Del Norte,33,2022-08-01,52,52,52,0,476,477,476,1,4,0,0,2,53,53,53,53
El Dorado,33,2022-08-01,234,234,234,0,2455,2460,2459,1,4,3,3,2,230,230,227,227
Fresno,33,2022-08-01,2983,2990,2988,2,18371,18417,18406,11,231,9,9,16,2828,2828,2819,2819
Glenn,33,2022-08-01,28,28,28,0,251,252,251,1,0,0,0,0,53,53,53,53
Humboldt,33,2022-08-01,222,222,222,0,1878,1883,1882,1,12,0,0,3,155,155,155,155
Imperial,33,2022-08-01,635,635,635,0,3531,3539,3537,2,22,5,5,3,957,957,952,952
Inyo,33,2022-08-01,20,20,20,0,280,281,280,1,2,0,0,0,58,58,58,58
Kern,33,2022-08-01,1686,1691,1690,1,14820,14855,14848,7,81,6,6,17,2389,2389,2383,2383
Kings,33,2022-08-01,624,624,624,0,4045,4055,4053,2,6,0,0,1,454,454,454,454
Lake,33,2022-08-01,125,125,125,0,994,995,994,1,7,0,0,2,143,143,143,143
Lassen,33,2022-08-01,102,102,102,0,947,949,948,1,0,0,0,0,63,63,63,63
Los Angeles,33,2022-08-01,30579,30652,30647,5,308901,309644,309596,48,1105,130,130,137,32835,32835,32705,32705
Madera,33,2022-08-01,463,463,463,0,3482,3491,3489,2,10,0,0,7,371,371,371,371
Marin,33,2022-08-01,411,411,411,0,5129,5141,5138,3,32,1,1,4,309,309,308,308
Mariposa,33,2022-08-01,22,22,22,0,225,226,225,1,0,0,0,0,29,29,29,29
Mendocino,33,2022-08-01,175,175,175,0,1258,1259,1258,1,6,1,1,1,134,134,133,133
Merced,33,2022-08-01,634,634,634,0,3549,3555,3553,2,22,6,6,2,849,849,843,843
Modoc,33,2022-08-01,16,16,16,0,31,32,31,1,0,0,0,0,9,9,9,9
Mono,33,2022-08-01,8,8,8,0,67,68,67,1,0,0,0,0,7,7,7,7
Monterey,33,2022-08-01,923,923,922,1,6398,6413,6407,6,33,2,2,1,759,759,757,757
Napa,33,2022-08-01,282,282,282,0,2836,2841,2840,1,8,0,0,2,154,154,154,154
Nevada,33,2022-08-01,123,123,123,0,1404,1408,1407,1,12,0,0,0,132,132,132,132
Orange,33,2022-08-01,6463,6478,6476,2,52398,52524,52505,19,246,33,33,49,7328,7328,7295,7295
Placer,33,2022-08-01,587,587,587,0,4744,4756,4753,3,71,1,1,11,652,652,651,651
Plumas,33,2022-08-01,24,24,24,0,162,163,162,1,0,0,0,0,13,13,13,13
Riverside,33,2022-08-01,6107,6121,6118,3,42270,42371,42350,21,200,5,5,23,6563,6563,6558,6558
Sacramento,33,2022-08-01,3088,3095,3093,2,28183,28251,28236,15,179,18,18,26,3237,3237,3219,3219
San Benito,33,2022-08-01,177,177,177,0,839,840,839,1,2,1,1,0,98,98,97,97
San Bernardino,33,2022-08-01,6046,6060,6058,2,48909,49027,49008,19,184,26,26,23,7978,7978,7952,7952
San Diego,33,2022-08-01,9378,9400,9398,2,68637,68803,68792,11,396,15,15,46,5472,5472,5457,5457
San Francisco,33,2022-08-01,1807,1812,1810,2,21991,22043,22019,24,105,13,13,20,988,988,975,975
San Joaquin,33,2022-08-01,1732,1737,1736,1,16128,16167,16158,9,69,7,7,11,2297,2297,2290,2290
San Luis Obispo,33,2022-08-01,574,574,574,0,4141,4152,4150,2,14,3,3,0,514,514,511,511
San Mateo,33,2022-08-01,1764,1769,1768,1,20298,20347,20340,7,67,1,1,3,734,734,733,733
Santa Barbara,33,2022-08-01,1107,1108,1107,1,7778,7797,7793,4,40,1,1,3,716,716,715,715
Santa Clara,33,2022-08-01,4835,4847,4846,1,45106,45214,45206,8,230,19,19,36,2456,2456,2437,2437
Santa Cruz,33,2022-08-01,747,747,747,0,6864,6881,6878,3,20,1,1,3,269,269,268,268
Shasta,33,2022-08-01,241,241,241,0,2967,2974,2972,2,34,1,1,7,583,583,582,582
Siskiyou,33,2022-08-01,29,29,29,0,298,299,298,1,2,0,0,0,86,86,86,86
Solano,33,2022-08-01,1139,1140,1139,1,9124,9146,9142,4,53,0,0,4,454,454,454,454
Sonoma,33,2022-08-01,917,917,917,0,8181,8201,8197,4,46,3,3,3,511,511,508,508
Stanislaus,33,2022-08-01,1233,1235,1234,1,7718,7736,7730,6,115,6,6,8,1742,1742,1736,1736
Sutter,33,2022-08-01,232,232,232,0,1634,1637,1636,1,0,3,3,0,231,231,228,228
Tehama,33,2022-08-01,89,89,89,0,757,757,756,1,4,0,0,0,211,211,211,211
Trinity,33,2022-08-01,11,11,11,0,71,72,71,1,0,1,1,0,21,21,20,20
Tulare,33,2022-08-01,1031,1031,1030,1,7465,7483,7477,6,46,1,1,3,1518,1518,1517,1517
Tuolumne,33,2022-08-01,143,143,143,0,1111,1112,1111,1,4,0,0,1,201,201,201,201
Ventura,33,2022-08-01,1801,1806,1805,1,16967,17008,17002,6,75,10,10,10,1551,1551,1541,1541
Yolo,33,2022-08-01,331,331,331,0,4165,4175,4173,2,3,3,3,1,384,384,381,381
Yuba,33,2022-08-01,159,159,159,0,1218,1221,1220,1,10,0,0,3,121,121,121,121
Alameda,34,2022-08-08,3274,3282,3281,1,35191,35280,35269,11,133,13,13,20,1994,1994,1981,1981
Amador,34,2022-08-08,50,50,50,0,852,853,852,1,3,0,0,1,89,89,89,89
Butte,34,2022-08-08,329,329,329,0,2497,2502,2501,1,33,1,1,1,456,456,455,455
Calaveras,34,2022-08-08,57,57,57,0,559,560,559,1,1,1,1,0,133,133,132,132
Colusa,34,2022-08-08,15,15,15,0,362,363,362,1,0,0,0,0,22,22,22,22
Contra Costa,34,2022-08-08,2166,2172,2171,1,19780,19830,19820,10,102,4,4,14,1416,1416,1412,1412
Del Norte,34,2022-08-08,49,49,49,0,498,499,498,1,4,1,1,1,54,54,53,53
El Dorado,34,2022-08-08,196,196,196,0,2321,2326,2325,1,4,0,0,2,230,230,230,230
Fresno,34,2022-08-08,2399,2404,2403,1,17809,17854,17845,9,207,8,8,25,2836,2836,2828,2828
Glenn,34,2022-08-08,21,21,21,0,249,250,249,1,0,0,0,0,53,53,53,53
Humboldt,34,2022-08-08,202,202,202,0,1919,1924,1923,1,12,1,1,2,156,156,155,155
Imperial,34,2022-08-08,544,544,544,0,3283,3291,3290,1,16,2,2,2,959,959,957,957
Inyo,34,2022-08-08,8,8,8,0,276,277,276,1,1,0,0,1,58,58,58,58
Kern,34,2022-08-08,1312,1316,1316,0,13659,13694,13689,5,61,6,6,16,2395,2395,2389,2389
Kings,34,2022-08-08,465,465,465,0,3323,3332,3331,1,20,0,0,2,454,454,454,454
Lake,34,2022-08-08,99,99,99,0,893,895,894,1,4,0,0,1,143,143,143,143
Lassen,34,2022-08-08,132,132,132,0,1023,1026,1025,1,1,0,0,0,63,63,63,63
Los Angeles,34,2022-08-08,25735,25800,25797,3,290967,291705,291670,35,1030,126,126,121,32961,32961,32835,32835
Madera,34,2022-08-08,376,376,376,0,3175,3183,3181,2,16,0,0,3,371,371,371,371
Marin,34,2022-08-08,354,354,354,0,4482,4494,4492,2,26,2,2,2,311,311,309,309
Mariposa,34,2022-08-08,25,25,25,0,197,198,197,1,0,0,0,0,29,29,29,29
Mendocino,34,2022-08-08,128,128,128,0,1128,1129,1128,1,3,1,1,1,135,135,134,134
Merced,34,2022-08-08,523,523,523,0,3378,3387,3386,1,17,1,1,5,850,850,849,849
Modoc,34,2022-08-08,2,2,2,0,22,23,22,1,0,0,0,0,9,9,9,9
Mono,34,2022-08-08,9,9,9,0,85,86,85,1,0,0,0,0,7,7,7,7
Monterey,34,2022-08-08,732,732,731,1,5749,5764,5760,4,28,1,1,0,760,760,759,759
Napa,34,2022-08-08,252,252,252,0,2609,2614,2613,1,10,2,2,3,156,156,154,154
Nevada,34,2022-08-08,91,91,91,0,1290,1292,1291,1,4,0,0,0,132,132,132,132
Orange,34,2022-08-08,5262,5274,5273,1,48031,48154,48140,14,242,28,28,40,7356,7356,7328,7328
Placer,34,2022-08-08,504,504,504,0,4517,4530,4528,2,65,3,3,9,655,655,652,652
Plumas,34,2022-08-08,23,23,23,0,190,191,190,1,1,0,0,0,13,13,13,13
Riverside,34,2022-08-08,5484,5496,5494,2,40548,40650,40635,15,174,13,13,13,6576,6576,6563,6563
Sacramento,34,2022-08-08,2611,2617,2616,1,27265,27334,27323,11,156,16,16,20,3253,3253,3237,3237
San Benito,34,2022-08-08,183,183,183,0,872,873,872,1,1,0,0,0,98,98,98,98
San Bernardino,34,2022-08-08,5021,5033,5031,2,45828,45945,45931,14,204,20,20,15,7998,7998,7978,7978
San Diego,34,2022-08-08,7274,7293,7292,1,64400,64564,64556,8,337,10,10,30,5482,5482,5472,5472
San Francisco,34,2022-08-08,1487,1492,1491,1,20606,20658,20641,17,94,11,11,21,999,999,988,988
San Joaquin,34,2022-08-08,1515,1520,1519,1,15746,15786,15779,7,55,6,6,12,2303,2303,2297,2297
San Luis Obispo,34,2022-08-08,496,496,496,0,3610,3617,3616,1,14,0,0,2,514,514,514,514
San Mateo,34,2022-08-08,1502,1506,1506,0,18470,18517,18512,5,60,0,0,5,734,734,734,734
Santa Barbara,34,2022-08-08,954,954,954,0,7517,7537,7534,3,46,3,3,4,719,719,716,716
Santa Clara,34,2022-08-08,4153,4163,4162,1,40456,40559,40554,5,203,16,16,40,2472,2472,2456,2456
Santa Cruz,34,2022-08-08,616,616,616,0,6043,6058,6056,2,28,1,1,0,270,270,269,269
Shasta,34,2022-08-08,190,190,190,0,2831,2839,2838,1,33,1,1,3,584,584,583,583
Siskiyou,34,2022-08-08,27,27,27,0,291,292,291,1,0,1,1,0,87,87,86,86
Solano,34,2022-08-08,875,875,875,0,7948,7968,7965,3,54,0,0,9,454,454,454,454
Sonoma,34,2022-08-08,830,830,830,0,7722,7742,7739,3,34,4,4,3,515,515,511,511
Stanislaus,34,2022-08-08,1029,1030,1029,1,7168,7187,7183,4,90,7,7,11,1749,1749,1742,1742
Sutter,34,2022-08-08,223,223,223,0,1552,1555,1554,1,0,0,0,0,231,231,231,231
Tehama,34,2022-08-08,75,75,75,0,681,682,681,1,0,0,0,1,211,211,211,211
Trinity,34,2022-08-08,5,5,5,0,71,72,71,1,0,0,0,0,21,21,21,21
Tulare,34,2022-08-08,874,874,873,1,7328,7348,7344,4,46,4,4,3,1522,1522,1518,1518
Tuolumne,34,2022-08-08,117,117,117,0,1054,1054,1053,1,4,3,3,0,204,204,201,201
Ventura,34,2022-08-08,1486,1491,1491,0,15930,15970,15966,4,67,6,6,7,1557,1557,1551,1551
Yolo,34,2022-08-08,281,281,281,0,3875,3885,3884,1,4,1,1,3,385,385,384,384
Yuba,34,2022-08-08,135,135,135,0,1085,1088,1087,1,6,0,0,0,121,121,121,121
Alameda,35,2022-08-15,2555,2562,2561,1,33653,33744,33736,8,105,9,9,22,2003,2003,1994,1994
Amador,35,2022-08-15,47,47,47,0,848,850,849,1,2,0,0,0,89,89,89,89
Butte,35,2022-08-15,256,256,256,0,2246,2252,2251,1,19,0,0,2,456,456,456,456
Calaveras,35,2022-08-15,45,45,45,0,528,529,528,1,0,0,0,0,133,133,133,133
Colusa,35,2022-08-15,16,16,16,0,359,360,359,1,1,0,0,0,22,22,22,22
Contra Costa,35,2022-08-15,1754,1759,1758,1,18944,18996,18988,8,72,6,6,9,1422,1422,1416,1416
Del Norte,35,2022-08-15,49,49,49,0,499,500,499,1,2,0,0,1,54,54,54,54
El Dorado,35,2022-08-15,177,177,177,0,2306,2312,2311,1,5,0,0,3,230,230,230,230
Fresno,35,2022-08-15,1854,1860,1859,1,16168,16212,16206,6,170,6,6,17,2842,2842,2836,2836
Glenn,35,2022-08-15,15,15,15,0,225,226,225,1,3,0,0,0,53,53,53,53
Humboldt,35,2022-08-15,173,173,173,0,1587,1593,1592,1,16,0,0,2,156,156,156,156
Imperial,35,2022-08-15,361,361,361,0,3101,3110,3109,1,11,0,0,2,959,959,959,959
Inyo,35,2022-08-15,14,14,14,0,236,237,236,1,2,1,1,0,59,59,58,58
Kern,35,2022-08-15,1213,1218,1218,0,13478,13514,13510,4,59,7,7,16,2402,2402,2395,2395
Kings,35,2022-08-15,332,332,332,0,3235,3244,3243,1,9,0,0,1,454,454,454,454
Lake,35,2022-08-15,102,102,102,0,1027,1030,1029,1,3,1,1,2,144,144,143,143
Lassen,35,2022-08-15,59,59,59,0,897,900,899,1,0,0,0,0,63,63,63,63
Los Angeles,35,2022-08-15,20912,20969,20967,2,287424,288205,288178,27,905,110,110,117,33071,33071,32961,32961
Madera,35,2022-08-15,297,297,297,0,2954,2962,2961,1,12,0,0,3,371,371,371,371
Marin,35,2022-08-15,290,290,290,0,4106,4118,4116,2,15,0,0,0,311,311,311,311
Mariposa,35,2022-08-15,11,11,11,0,192,193,192,1,0,0,0,0,29,29,29,29
Mendocino,35,2022-08-15,99,99,99,0,996,997,996,1,7,0,0,3,135,135,135,135
Merced,35,2022-08-15,437,437,437,0,3403,3412,3411,1,12,2,2,1,852,852,850,850
Modoc,35,2022-08-15,4,4,4,0,23,24,23,1,0,0,0,0,9,9,9,9
Mono,35,2022-08-15,3,3,3,0,61,62,61,1,0,0,0,0,7,7,7,7
Monterey,35,2022-08-15,660,660,660,0,5800,5815,5812,3,30,0,0,1,760,760,760,760
Napa,35,2022-08-15,210,210,210,0,2280,2285,2284,1,13,0,0,0,156,156,156,156
Nevada,35,2022-08-15,94,94,94,0,1209,1213,1212,1,7,0,0,0,132,132,132,132
Orange,35,2022-08-15,4564,4576,4575,1,43009,43124,43114,10,270,31,31,44,7387,7387,7356,7356
Placer,35,2022-08-15,403,403,403,0,4469,4482,4480,2,61,1,1,11,656,656,655,655
Plumas,35,2022-08-15,17,17,17,0,184,185,184,1,0,0,0,0,13,13,13,13
Riverside,35,2022-08-15,4544,4556,4555,1,38020,38123,38112,11,143,16,16,22,6592,6592,6576,6576
Sacramento,35,2022-08-15,2349,2356,2355,1,25637,25706,25698,8,149,11,11,22,3264,3264,3253,3253
San Benito,35,2022-08-15,137,137,137,0,718,719,718,1,3,1,1,1,99,99,98,98
San Bernardino,35,2022-08-15,4651,4663,4662,1,44139,44259,44248,11,144,14,14,22,8012,8012,7998,7998
San Diego,35,2022-08-15,5506,5520,5519,1,59489,59650,59644,6,288,13,13,34,5495,5495,5482,5482
San Francisco,35,2022-08-15,1256,1259,1258,1,19549,19602,19589,13,103,15,15,11,1014,1014,999,999
San Joaquin,35,2022-08-15,1438,1443,1442,1,15223,15263,15258,5,64,8,8,8,2311,2311,2303,2303
San Luis Obispo,35,2022-08-15,318,318,318,0,3301,3310,3309,1,15,4,4,3,518,518,514,514
San Mateo,35,2022-08-15,1209,1213,1213,0,17319,17366,17362,4,56,1,1,5,735,735,734,734
Santa Barbara,35,2022-08-15,822,822,822,0,7118,7137,7135,2,44,1,1,4,720,720,719,719
Santa Clara,35,2022-08-15,3333,3342,3342,0,39265,39372,39368,4,200,8,8,24,2480,2480,2472,2472
Santa Cruz,35,2022-08-15,491,491,491,0,7531,7551,7549,2,23,3,3,1,273,273,270,270
Shasta,35,2022-08-15,188,188,188,0,2786,2794,2793,1,19,1,1,1,585,585,584,584
Siskiyou,35,2022-08-15,18,18,18,0,284,285,284,1,3,0,0,1,87,87,87,87
Solano,35,2022-08-15,655,655,655,0,7441,7461,7459,2,45,0,0,10,454,454,454,454
Sonoma,35,2022-08-15,621,621,621,0,7281,7301,7299,2,39,2,2,2,517,517,515,515
Stanislaus,35,2022-08-15,930,931,931,0,7651,7672,7668,4,99,9,9,11,1758,1758,1749,1749
Sutter,35,2022-08-15,195,195,195,0,1587,1592,1591,1,0,1,1,0,232,232,231,231
Tehama,35,2022-08-15,58,58,58,0,645,647,646,1,1,0,0,0,211,211,211,211
Trinity,35,2022-08-15,8,8,8,0,58,59,58,1,0,0,0,0,21,21,21,21
Tulare,35,2022-08-15,714,714,714,0,7331,7351,7348,3,32,3,3,1,1525,1525,1522,1522
Tuolumne,35,2022-08-15,108,108,108,0,991,994,993,1,1,0,0,0,204,204,204,204
Ventura,35,2022-08-15,1476,1481,1481,0,15260,15301,15298,3,70,5,5,7,1562,1562,1557,1557
Yolo,35,2022-08-15,261,261,261,0,3527,3536,3535,1,2,4,4,1,389,389,385,385
Yuba,35,2022-08-15,128,128,128,0,1080,1084,1083,1,9,0,0,0,121,121,121,121
Alameda,36,2022-08-22,2228,2235,2235,0,33062,33158,33152,6,117,8,8,21,2011,2011,2003,2003
Amador,36,2022-08-22,49,49,49,0,815,817,816,1,2,1,1,0,90,90,89,89
Butte,36,2022-08-22,215,215,215,0,2131,2137,2136,1,17,1,1,2,457,457,456,456
Calaveras,36,2022-08-22,43,43,43,0,572,573,572,1,1,0,0,0,133,133,133,133
Colusa,36,2022-08-22,16,16,16,0,394,395,394,1,0,0,0,0,22,22,22,22
Contra Costa,36,2022-08-22,1504,1509,1509,0,18809,18864,18858,6,56,5,5,9,1427,1427,1422,1422
Del Norte,36,2022-08-22,31,31,31,0,461,462,461,1,3,1,1,0,55,55,54,54
El Dorado,36,2022-08-22,146,146,146,0,2221,2227,2226,1,4,1,1,0,231,231,230,230
Fresno,36,2022-08-22,1582,1587,1587,0,15813,15859,15854,5,162,6,6,14,2848,2848,2842,2842
Glenn,36,2022-08-22,23,23,23,0,227,228,227,1,1,0,0,0,53,53,53,53
Humboldt,36,2022-08-22,146,146,146,0,1677,1683,1682,1,6,1,1,3,157,157,156,156
Imperial,36,2022-08-22,286,286,286,0,2845,2853,2852,1,15,0,0,0,959,959,959,959
Inyo,36,2022-08-22,8,8,8,0,213,214,213,1,0,0,0,0,59,59,59,59
Kern,36,2022-08-22,976,978,978,0,13745,13785,13782,3,69,6,6,10,2408,2408,2402,2402
Kings,36,2022-08-22,370,370,370,0,3638,3650,3649,1,10,1,1,0,455,455,454,454
Lake,36,2022-08-22,97,97,97,0,884,887,886,1,5,0,0,0,144,144,144,144
Lassen,36,2022-08-22,36,36,36,0,833,836,835,1,0,0,0,0,63,63,63,63
Los Angeles,36,2022-08-22,18481,18535,18534,1,274583,275386,275366,20,811,116,116,104,33187,33187,33071,33071
Madera,36,2022-08-22,293,293,293,0,2612,2619,2618,1,14,2,2,4,373,373,371,371
Marin,36,2022-08-22,248,248,248,0,3959,3971,3970,1,17,0,0,3,311,311,311,311
Mariposa,36,2022-08-22,12,12,12,0,172,173,172,1,0,0,0,0,29,29,29,29
Mendocino,36,2022-08-22,115,115,115,0,1145,1151,1150,1,3,0,0,2,135,135,135,135
Merced,36,2022-08-22,435,435,435,0,3633,3645,3644,1,12,4,4,1,856,856,852,852
Modoc,36,2022-08-22,6,6,6,0,27,28,27,1,0,0,0,0,9,9,9,9
Mono,36,2022-08-22,4,4,4,0,63,64,63,1,0,0,0,0,7,7,7,7
Monterey,36,2022-08-22,539,539,539,0,5902,5919,5916,3,27,1,1,2,761,761,760,760
Napa,36,2022-08-22,127,127,127,0,1998,2004,2003,1,5,2,2,1,158,158,156,156
Nevada,36,2022-08-22,80,80,80,0,1180,1184,1183,1,6,0,0,0,132,132,132,132
Orange,36,2022-08-22,3782,3793,3792,1,40754,40873,40866,7,224,21,21,35,7408,7408,7387,7387
Placer,36,2022-08-22,372,372,372,0,4305,4318,4317,1,61,1,1,14,657,657,656,656
Plumas,36,2022-08-22,20,20,20,0,175,176,175,1,1,0,0,0,13,13,13,13
Riverside,36,2022-08-22,4365,4378,4377,1,37499,37608,37599,9,142,13,13,19,6605,6605,6592,6592
Sacramento,36,2022-08-22,2072,2078,2077,1,25157,25230,25224,6,144,14,14,25,3278,3278,3264,3264
San Benito,36,2022-08-22,102,102,102,0,593,594,593,1,1,1,1,1,100,100,99,99
San Bernardino,36,2022-08-22,4575,4588,4587,1,44240,44370,44362,8,160,18,18,22,8030,8030,8012,8012
San Diego,36,2022-08-22,4792,4805,4805,0,57534,57701,57697,4,287,6,6,28,5501,5501,5495,5495
San Francisco,36,2022-08-22,1090,1092,1091,1,18827,18882,18872,10,81,16,16,12,1030,1030,1014,1014
San Joaquin,36,2022-08-22,1187,1191,1191,0,15736,15781,15777,4,56,1,1,8,2312,2312,2311,2311
San Luis Obispo,36,2022-08-22,251,251,251,0,3087,3096,3095,1,16,1,1,0,519,519,518,518
San Mateo,36,2022-08-22,1007,1009,1009,0,17140,17190,17187,3,42,0,0,2,735,735,735,735
Santa Barbara,36,2022-08-22,720,720,720,0,7435,7457,7455,2,37,1,1,2,721,721,720,720
Santa Clara,36,2022-08-22,3014,3022,3022,0,39685,39800,39797,3,173,10,10,27,2490,2490,2480,2480
Santa Cruz,36,2022-08-22,499,499,499,0,11951,11987,11985,2,13,0,0,0,273,273,273,273
Shasta,36,2022-08-22,171,171,171,0,2757,2766,2765,1,10,2,2,2,587,587,585,585
Siskiyou,36,2022-08-22,25,25,25,0,249,250,249,1,4,1,1,2,88,88,87,87
Solano,36,2022-08-22,521,521,521,0,7193,7214,7212,2,35,0,0,12,454,454,454,454
Sonoma,36,2022-08-22,596,596,596,0,7369,7391,7389,2,42,2,2,1,519,519,517,517
Stanislaus,36,2022-08-22,884,884,884,0,7646,7669,7666,3,79,7,7,16,1765,1765,1758,1758
Sutter,36,2022-08-22,189,189,189,0,1657,1663,1662,1,0,0,0,0,232,232,232,232
Tehama,36,2022-08-22,51,51,51,0,629,631,630,1,1,0,0,0,211,211,211,211
Trinity,36,2022-08-22,10,10,10,0,63,64,63,1,0,0,0,0,21,21,21,21
Tulare,36,2022-08-22,710,710,710,0,6780,6802,6800,2,33,3,3,1,1528,1528,1525,1525
Tuolumne,36,2022-08-22,103,103,103,0,1018,1022,1021,1,0,1,1,0,205,205,204,204
Ventura,36,2022-08-22,1291,1296,1296,0,14997,15042,15040,2,59,3,3,9,1565,1565,1562,1562
Yolo,36,2022-08-22,199,199,199,0,3472,3482,3481,1,10,1,1,1,390,390,389,389
Yuba,36,2022-08-22,126,126,126,0,1109,1113,1112,1,13,0,0,3,121,121,121,121
Alameda,37,2022-08-29,1955,1962,1962,0,34097,34205,34200,5,99,11,11,20,2022,2022,2011,2011
Amador,37,2022-08-29,46,46,46,0,804,807,806,1,2,1,1,0,91,91,90,90
Butte,37,2022-08-29,235,235,235,0,2171,2179,2178,1,18,0,0,3,457,457,457,457
Calaveras,37,2022-08-29,59,59,59,0,591,592,591,1,1,0,0,0,133,133,133,133
Colusa,37,2022-08-29,10,10,10,0,329,330,329,1,3,0,0,0,22,22,22,22
Contra Costa,37,2022-08-29,1330,1335,1335,0,18763,18821,18816,5,44,5,5,7,1432,1432,1427,1427
Del Norte,37,2022-08-29,27,27,27,0,431,432,431,1,5,0,0,1,55,55,55,55
El Dorado,37,2022-08-29,142,142,142,0,1946,1952,1951,1,1,0,0,1,231,231,231,231
Fresno,37,2022-08-29,1401,1406,1406,0,15775,15825,15821,4,159,3,3,15,2851,2851,2848,2848
Glenn,37,2022-08-29,22,22,22,0,220,221,220,1,1,0,0,0,53,53,53,53
Humboldt,37,2022-08-29,122,122,122,0,1662,1668,1667,1,4,0,0,0,157,157,157,157
Imperial,37,2022-08-29,290,290,290,0,2936,2945,2944,1,14,1,1,2,960,960,959,959
Inyo,37,2022-08-29,7,7,7,0,175,176,175,1,0,0,0,0,59,59,59,59
Kern,37,2022-08-29,877,877,877,0,13227,13270,13268,2,50,0,0,8,2408,2408,2408,2408
Kings,37,2022-08-29,313,313,313,0,3490,3502,3501,1,8,0,0,0,455,455,455,455
Lake,37,2022-08-29,85,85,85,0,870,873,872,1,1,1,1,0,145,145,144,144
Lassen,37,2022-08-29,27,27,27,0,771,774,773,1,0,0,0,0,63,63,63,63
Los Angeles,37,2022-08-29,15567,15616,15615,1,271277,272130,272114,16,753,85,85,83,33272,33272,33187,33187
Madera,37,2022-08-29,293,293,293,0,3019,3030,3029,1,13,0,0,3,373,373,373,373
Marin,37,2022-08-29,212,212,212,0,3840,3852,3851,1,16,2,2,2,313,313,311,311
Mariposa,37,2022-08-29,22,22,22,0,186,187,186,1,0,0,0,0,29,29,29,29
Mendocino,37,2022-08-29,86,86,86,0,968,972,971,1,2,0,0,1,135,135,135,135
Merced,37,2022-08-29,381,381,381,0,3396,3408,3407,1,11,3,3,0,859,859,856,856
Modoc,37,2022-08-29,1,1,1,0,30,31,30,1,0,0,0,0,9,9,9,9
Mono,37,2022-08-29,2,2,2,0,45,46,45,1,0,0,0,0,7,7,7,7
Monterey,37,2022-08-29,391,391,391,0,5345,5362,5360,2,33,2,2,5,763,763,761,761
Napa,37,2022-08-29,127,127,127,0,2157,2164,2163,1,10,0,0,1,158,158,158,158
Nevada,37,2022-08-29,116,116,116,0,1207,1213,1212,1,6,0,0,0,132,132,132,132
Orange,37,2022-08-29,2930,2939,2939,0,39156,39279,39274,5,195,18,18,25,7426,7426,7408,7408
Placer,37,2022-08-29,366,366,366,0,4208,4221,4220,1,55,1,1,12,658,658,657,657
Plumas,37,2022-08-29,18,18,18,0,159,160,159,1,1,0,0,0,13,13,13,13
Riverside,37,2022-08-29,3639,3651,3650,1,36821,36937,36930,7,124,9,9,11,6614,6614,6605,6605
Sacramento,37,2022-08-29,1847,1853,1853,0,24890,24969,24964,5,137,10,10,20,3288,3288,3278,3278
San Benito,37,2022-08-29,118,118,118,0,659,660,659,1,1,0,0,0,100,100,100,100
San Bernardino,37,2022-08-29,3589,3601,3600,1,42067,42199,42193,6,156,14,14,18,8044,8044,8030,8030
San Diego,37,2022-08-29,3938,3950,3950,0,56582,56760,56757,3,222,12,12,25,5513,5513,5501,5501
San Francisco,37,2022-08-29,867,868,868,0,19123,19182,19174,8,57,7,7,12,1037,1037,1030,1030
San Joaquin,37,2022-08-29,993,995,995,0,14307,14351,14348,3,27,5,5,11,2317,2317,2312,2312
San Luis Obispo,37,2022-08-29,315,315,315,0,3216,3228,3227,1,17,3,3,0,522,522,519,519
San Mateo,37,2022-08-29,842,842,842,0,16703,16756,16754,2,26,0,0,5,735,735,735,735
Santa Barbara,37,2022-08-29,630,630,630,0,7623,7648,7647,1,24,1,1,3,722,722,721,721
Santa Clara,37,2022-08-29,2301,2308,2308,0,39028,39151,39148,3,135,5,5,24,2495,2495,2490,2490
Santa Cruz,37,2022-08-29,381,381,381,0,12664,12704,12702,2,16,0,0,1,273,273,273,273
Shasta,37,2022-08-29,123,123,123,0,2576,2585,2584,1,19,1,1,1,588,588,587,587
Siskiyou,37,2022-08-29,24,24,24,0,249,250,249,1,0,1,1,0,89,89,88,88
Solano,37,2022-08-29,542,542,542,0,7266,7289,7288,1,33,1,1,8,455,455,454,454
Sonoma,37,2022-08-29,480,480,480,0,7102,7123,7122,1,37,0,0,4,519,519,519,519
Stanislaus,37,2022-08-29,838,838,838,0,8082,8109,8107,2,79,7,7,6,1772,1772,1765,1765
Sutter,37,2022-08-29,169,169,169,0,1638,1644,1643,1,0,0,0,0,232,232,232,232
Tehama,37,2022-08-29,65,65,65,0,737,739,738,1,4,0,0,1,211,211,211,211
Trinity,37,2022-08-29,6,6,6,0,56,57,56,1,0,0,0,0,21,21,21,21
Tulare,37,2022-08-29,665,665,665,0,7370,7393,7391,2,42,0,0,1,1528,1528,1528,1528
Tuolumne,37,2022-08-29,90,90,90,0,856,858,857,1,1,0,0,0,205,205,205,205
Ventura,37,2022-08-29,1006,1009,1009,0,14598,14646,14644,2,71,5,5,7,1570,1570,1565,1565
Yolo,37,2022-08-29,201,201,201,0,3704,3717,3716,1,5,0,0,3,390,390,390,390
Yuba,37,2022-08-29,135,135,135,0,1176,1182,1181,1,14,0,0,1,121,121,121,121
Alameda,38,2022-09-05,1424,1429,1429,0,28019,28116,28113,3,89,4,4,16,2026,2026,2022,2022
Amador,38,2022-09-05,44,44,44,0,748,750,749,1,3,0,0,2,91,91,91,91
Butte,38,2022-09-05,190,190,190,0,2123,2133,2132,1,14,2,2,2,459,459,457,457
Calaveras,38,2022-09-05,21,21,21,0,451,452,451,1,0,0,0,0,133,133,133,133
Colusa,38,2022-09-05,7,7,7,0,197,198,197,1,2,0,0,0,22,22,22,22
Contra Costa,38,2022-09-05,940,944,944,0,15403,15457,15454,3,62,5,5,9,1437,1437,1432,1432
Del Norte,38,2022-09-05,7,7,7,0,345,346,345,1,1,0,0,1,55,55,55,55
El Dorado,38,2022-09-05,85,85,85,0,1521,1526,1525,1,3,1,1,3,232,232,231,231
Fresno,38,2022-09-05,1075,1079,1079,0,13067,13112,13110,2,162,10,10,16,2861,2861,2851,2851
Glenn,38,2022-09-05,11,11,11,0,188,189,188,1,1,0,0,0,53,53,53,53
Humboldt,38,2022-09-05,108,108,108,0,1295,1300,1299,1,9,1,1,2,158,158,157,157
Imperial,38,2022-09-05,232,232,232,0,2522,2532,2531,1,8,1,1,2,961,961,960,960
Inyo,38,2022-09-05,12,12,12,0,139,140,139,1,0,0,0,1,59,59,59,59
Kern,38,2022-09-05,718,719,719,0,11239,11278,11276,2,50,5,5,8,2413,2413,2408,2408
Kings,38,2022-09-05,229,229,229,0,2869,2881,2880,1,8,0,0,0,455,455,455,455
Lake,38,2022-09-05,63,63,63,0,655,656,655,1,1,2,2,1,147,147,145,145
Lassen,38,2022-09-05,19,19,19,0,633,635,634,1,0,0,0,0,63,63,63,63
Los Angeles,38,2022-09-05,10676,10713,10713,0,221923,222685,222675,10,695,95,95,91,33367,33367,33272,33272
Madera,38,2022-09-05,201,201,201,0,2504,2515,2514,1,12,0,0,4,373,373,373,373
Marin,38,2022-09-05,188,188,188,0,3551,3563,3562,1,12,0,0,1,313,313,313,313
Mariposa,38,2022-09-05,11,11,11,0,166,167,166,1,0,0,0,0,29,29,29,29
Mendocino,38,2022-09-05,54,54,54,0,828,832,831,1,2,1,1,1,136,136,135,135
Merced,38,2022-09-05,243,243,243,0,2620,2632,2631,1,12,2,2,1,861,861,859,859
Modoc,38,2022-09-05,3,3,3,0,17,18,17,1,0,0,0,0,9,9,9,9
Mono,38,2022-09-05,4,4,4,0,52,53,52,1,1,0,0,0,7,7,7,7
Monterey,38,2022-09-05,239,239,239,0,4343,4358,4357,1,24,3,3,0,766,766,763,763
Napa,38,2022-09-05,100,100,100,0,1720,1726,1725,1,6,1,1,2,159,159,158,158
Nevada,38,2022-09-05,79,79,79,0,900,905,904,1,3,0,0,0,132,132,132,132
Orange,38,2022-09-05,2158,2165,2165,0,32112,32223,32220,3,169,13,13,34,7439,7439,7426,7426
Placer,38,2022-09-05,237,237,237,0,3468,3480,3479,1,36,0,0,4,658,658,658,658
Plumas,38,2022-09-05,9,9,9,0,129,130,129,1,0,0,0,0,13,13,13,13
Riverside,38,2022-09-05,2391,2399,2399,0,28551,28650,28646,4,99,7,7,14,6621,6621,6614,6614
Sacramento,38,2022-09-05,1239,1244,1244,0,19829,19897,19894,3,139,12,12,22,3300,3300,3288,3288
San Benito,38,2022-09-05,64,64,64,0,600,601,600,1,0,0,0,2,100,100,100,100
San Bernardino,38,2022-09-05,2313,2322,2322,0,34198,34315,34311,4,122,14,14,19,8058,8058,8044,8044
San Diego,38,2022-09-05,2808,2818,2818,0,48210,48375,48373,2,212,14,14,25,5527,5527,5513,5513
San Francisco,38,2022-09-05,674,674,674,0,15688,15741,15736,5,52,9,9,9,1046,1046,1037,1037
San Joaquin,38,2022-09-05,824,826,826,0,11959,11999,11997,2,43,4,4,10,2321,2321,2317,2317
San Luis Obispo,38,2022-09-05,171,171,171,0,2675,2686,2685,1,7,2,2,1,524,524,522,522
San Mateo,38,2022-09-05,608,608,608,0,13456,13503,13502,1,23,1,1,2,736,736,735,735
Santa Barbara,38,2022-09-05,478,478,478,0,6629,6652,6651,1,39,4,4,3,726,726,722,722
Santa Clara,38,2022-09-05,1890,1897,1897,0,32532,32644,32642,2,127,9,9,20,2504,2504,2495,2495
Santa Cruz,38,2022-09-05,279,279,279,0,10202,10237,10236,1,16,0,0,0,273,273,273,273
Shasta,38,2022-09-05,101,101,101,0,2022,2031,2030,1,15,0,0,0,588,588,588,588
Siskiyou,38,2022-09-05,30,30,30,0,216,217,216,1,0,0,0,0,89,89,89,89
Solano,38,2022-09-05,365,365,365,0,5942,5961,5960,1,34,1,1,11,456,456,455,455
Sonoma,38,2022-09-05,363,363,363,0,5995,6014,6013,1,40,0,0,2,519,519,519,519
Stanislaus,38,2022-09-05,543,543,543,0,6346,6370,6369,1,69,5,5,4,1777,1777,1772,1772
Sutter,38,2022-09-05,114,114,114,0,1482,1487,1486,1,0,0,0,0,232,232,232,232
Tehama,38,2022-09-05,49,49,49,0,581,583,582,1,2,1,1,0,212,212,211,211
Trinity,38,2022-09-05,4,4,4,0,51,52,51,1,0,0,0,0,21,21,21,21
Tulare,38,2022-09-05,418,418,418,0,5168,5186,5185,1,37,2,2,1,1530,1530,1528,1528
Tuolumne,38,2022-09-05,67,67,67,0,737,739,738,1,1,0,0,0,205,205,205,205
Ventura,38,2022-09-05,850,852,852,0,12305,12347,12346,1,48,8,8,1,1578,1578,1570,1570
Yolo,38,2022-09-05,136,136,136,0,2891,2903,2902,1,1,3,3,2,393,393,390,390
Yuba,38,2022-09-05,87,87,87,0,978,983,982,1,14,0,0,1,121,121,121,121
Alameda,39,2022-09-12,1601,1608,1608,0,31916,32042,32039,3,94,5,5,16,2031,2031,2026,2026
Amador,39,2022-09-12,32,32,32,0,873,877,876,1,3,0,0,2,91,91,91,91
Butte,39,2022-09-12,190,190,190,0,2468,2480,2479,1,15,3,3,2,462,462,459,459
Calaveras,39,2022-09-12,14,14,14,0,500,501,500,1,1,0,0,0,133,133,133,133
Colusa,39,2022-09-12,17,17,17,0,414,416,415,1,0,0,0,0,22,22,22,22
Contra Costa,39,2022-09-12,963,967,967,0,17299,17367,17364,3,59,6,6,12,1443,1443,1437,1437
Del Norte,39,2022-09-12,33,33,33,0,594,596,595,1,1,0,0,1,55,55,55,55
El Dorado,39,2022-09-12,100,100,100,0,1899,1906,1905,1,3,0,0,1,232,232,232,232
Fresno,39,2022-09-12,891,893,893,0,14696,14755,14753,2,155,6,6,15,2867,2867,2861,2861
Glenn,39,2022-09-12,15,15,15,0,208,209,208,1,0,0,0,0,53,53,53,53
Humboldt,39,2022-09-12,106,106,106,0,1652,1658,1657,1,6,0,0,5,158,158,158,158
Imperial,39,2022-09-12,256,256,256,0,3291,3306,3305,1,10,0,0,2,961,961,961,961
Inyo,39,2022-09-12,14,14,14,0,194,195,194,1,0,1,1,0,60,60,59,59
Kern,39,2022-09-12,634,634,634,0,12821,12872,12871,1,45,7,7,13,2420,2420,2413,2413
Kings,39,2022-09-12,228,228,228,0,3171,3186,3185,1,6,1,1,0,456,456,455,455
Lake,39,2022-09-12,46,46,46,0,882,885,884,1,3,0,0,1,147,147,147,147
Lassen,39,2022-09-12,19,19,19,0,917,921,920,1,0,0,0,0,63,63,63,63
Los Angeles,39,2022-09-12,10976,11019,11019,0,282341,283453,283443,10,652,85,85,83,33452,33452,33367,33367
Madera,39,2022-09-12,237,237,237,0,2923,2936,2935,1,8,0,0,3,373,373,373,373
Marin,39,2022-09-12,171,171,171,0,3907,3921,3920,1,12,2,2,2,315,315,313,313
Mariposa,39,2022-09-12,14,14,14,0,192,193,192,1,0,0,0,0,29,29,29,29
Mendocino,39,2022-09-12,51,51,51,0,952,957,956,1,2,0,0,1,136,136,136,136
Merced,39,2022-09-12,230,230,230,0,3289,3304,3303,1,6,2,2,1,863,863,861,861
Modoc,39,2022-09-12,2,2,2,0,22,23,22,1,0,0,0,0,9,9,9,9
Mono,39,2022-09-12,7,7,7,0,76,77,76,1,0,0,0,0,7,7,7,7
Monterey,39,2022-09-12,220,220,220,0,5089,5108,5107,1,22,1,1,1,767,767,766,766
Napa,39,2022-09-12,116,116,116,0,2247,2257,2256,1,10,0,0,1,159,159,159,159
Nevada,39,2022-09-12,58,58,58,0,1179,1185,1184,1,2,0,0,0,132,132,132,132
Orange,39,2022-09-12,2077,2085,2085,0,36652,36796,36793,3,159,27,27,22,7466,7466,7439,7439
Placer,39,2022-09-12,235,235,235,0,4071,4087,4086,1,38,0,0,5,658,658,658,658
Plumas,39,2022-09-12,22,22,22,0,194,195,194,1,1,0,0,0,13,13,13,13
Riverside,39,2022-09-12,2225,2234,2234,0,32976,33104,33100,4,124,5,5,12,6626,6626,6621,6621
Sacramento,39,2022-09-12,1270,1276,1276,0,23584,23677,23674,3,119,16,16,15,3316,3316,3300,3300
San Benito,39,2022-09-12,89,89,89,0,715,719,718,1,1,0,0,1,100,100,100,100
San Bernardino,39,2022-09-12,1904,1912,1912,0,38547,38700,38697,3,92,13,13,26,8071,8071,8058,8058
San Diego,39,2022-09-12,3046,3057,3057,0,55684,55903,55901,2,194,7,7,24,5534,5534,5527,5527
San Francisco,39,2022-09-12,807,811,811,0,17382,17451,17447,4,58,8,8,15,1054,1054,1046,1046
San Joaquin,39,2022-09-12,635,636,636,0,14275,14330,14328,2,35,5,5,9,2326,2326,2321,2321
San Luis Obispo,39,2022-09-12,175,175,175,0,3218,3232,3231,1,10,0,0,1,524,524,524,524
San Mateo,39,2022-09-12,648,648,648,0,14069,14125,14124,1,20,1,1,2,737,737,736,736
Santa Barbara,39,2022-09-12,320,320,320,0,7229,7257,7256,1,27,1,1,2,727,727,726,726
Santa Clara,39,2022-09-12,1880,1887,1887,0,37678,37826,37825,1,144,6,6,28,2510,2510,2504,2504
Santa Cruz,39,2022-09-12,269,269,269,0,13326,13379,13378,1,15,0,0,0,273,273,273,273
Shasta,39,2022-09-12,173,173,173,0,2589,2600,2599,1,26,1,1,2,589,589,588,588
Siskiyou,39,2022-09-12,27,27,27,0,289,290,289,1,1,0,0,0,89,89,89,89
Solano,39,2022-09-12,413,413,413,0,6721,6748,6747,1,32,0,0,4,456,456,456,456
Sonoma,39,2022-09-12,388,388,388,0,7015,7043,7042,1,39,3,3,1,522,522,519,519
Stanislaus,39,2022-09-12,442,442,442,0,7740,7771,7770,1,73,1,1,4,1778,1778,1777,1777
Sutter,39,2022-09-12,118,118,118,0,1531,1538,1537,1,0,0,0,0,232,232,232,232
Tehama,39,2022-09-12,48,48,48,0,699,702,701,1,2,0,0,0,212,212,212,212
Trinity,39,2022-09-12,2,2,2,0,74,75,74,1,0,0,0,0,21,21,21,21
Tulare,39,2022-09-12,351,351,351,0,6886,6912,6911,1,39,4,4,0,1534,1534,1530,1530
Tuolumne,39,2022-09-12,59,59,59,0,809,813,812,1,2,0,0,1,205,205,205,205
Ventura,39,2022-09-12,819,822,822,0,14802,14860,14859,1,49,1,1,7,1579,1579,1578,1578
Yolo,39,2022-09-12,143,143,143,0,3442,3457,3456,1,1,2,2,3,395,395,393,393
Yuba,39,2022-09-12,92,92,92,0,1165,1171,1170,1,6,0,0,0,121,121,121,121
Alameda,40,2022-09-19,1223,1230,1230,0,29012,29139,29137,2,80,4,4,7,2035,2035,2031,2031
Amador,40,2022-09-19,33,33,33,0,759,763,762,1,1,3,3,1,94,94,91,91
Butte,40,2022-09-19,117,117,117,0,2120,2131,2130,1,18,0,0,1,462,462,462,462
Calaveras,40,2022-09-19,28,28,28,0,476,477,476,1,0,0,0,0,133,133,133,133
Colusa,40,2022-09-19,12,12,12,0,289,290,289,1,3,0,0,0,22,22,22,22
Contra Costa,40,2022-09-19,812,816,816,0,16747,16821,16819,2,52,8,8,8,1451,1451,1443,1443
Del Norte,40,2022-09-19,21,21,21,0,478,479,478,1,2,0,0,0,55,55,55,55
El Dorado,40,2022-09-19,75,75,75,0,1615,1622,1621,1,3,0,0,0,232,232,232,232
Fresno,40,2022-09-19,592,593,593,0,13323,13381,13380,1,110,7,7,14,2874,2874,2867,2867
Glenn,40,2022-09-19,14,14,14,0,201,202,201,1,2,0,0,0,53,53,53,53
Humboldt,40,2022-09-19,101,101,101,0,1458,1464,1463,1,8,0,0,3,158,158,158,158
Imperial,40,2022-09-19,147,147,147,0,2865,2879,2878,1,11,0,0,2,961,961,961,961
Inyo,40,2022-09-19,8,8,8,0,169,170,169,1,0,0,0,0,60,60,60,60
Kern,40,2022-09-19,437,437,437,0,11537,11587,11586,1,34,2,2,6,2422,2422,2420,2420
Kings,40,2022-09-19,136,136,136,0,2642,2655,2654,1,7,2,2,0,458,458,456,456
Lake,40,2022-09-19,35,35,35,0,902,907,906,1,0,0,0,0,147,147,147,147
Lassen,40,2022-09-19,7,7,7,0,704,707,706,1,0,0,0,0,63,63,63,63
Los Angeles,40,2022-09-19,8540,8577,8577,0,254569,255680,255673,7,564,65,65,69,33517,33517,33452,33452
Madera,40,2022-09-19,108,108,108,0,2691,2704,2703,1,9,1,1,2,374,374,373,373
Marin,40,2022-09-19,137,137,137,0,3696,3714,3713,1,6,0,0,0,315,315,315,315
Mariposa,40,2022-09-19,10,10,10,0,170,171,170,1,0,1,1,0,30,30,29,29
Mendocino,40,2022-09-19,39,39,39,0,928,934,933,1,0,0,0,1,136,136,136,136
Merced,40,2022-09-19,162,162,162,0,2891,2905,2904,1,8,3,3,1,866,866,863,863
Modoc,40,2022-09-19,2,2,2,0,17,18,17,1,0,0,0,0,9,9,9,9
Mono,40,2022-09-19,4,4,4,0,63,64,63,1,0,0,0,0,7,7,7,7
Monterey,40,2022-09-19,159,159,159,0,4248,4266,4265,1,14,1,1,2,768,768,767,767
Napa,40,2022-09-19,97,97,97,0,1771,1779,1778,1,4,0,0,0,159,159,159,159
Nevada,40,2022-09-19,63,63,63,0,1110,1116,1115,1,2,0,0,0,132,132,132,132
Orange,40,2022-09-19,1703,1710,1710,0,33927,34075,34073,2,129,15,15,19,7481,7481,7466,7466
Placer,40,2022-09-19,221,221,221,0,3820,3838,3837,1,51,1,1,4,659,659,658,658
Plumas,40,2022-09-19,22,22,22,0,183,184,183,1,1,0,0,0,13,13,13,13
Riverside,40,2022-09-19,1402,1409,1409,0,29072,29199,29197,2,68,4,4,19,6630,6630,6626,6626
Sacramento,40,2022-09-19,1009,1014,1014,0,21364,21458,21456,2,102,7,7,17,3323,3323,3316,3316
San Benito,40,2022-09-19,53,53,53,0,608,610,609,1,0,0,0,0,100,100,100,100
San Bernardino,40,2022-09-19,1444,1451,1451,0,32523,32667,32665,2,83,7,7,19,8078,8078,8071,8071
San Diego,40,2022-09-19,2576,2588,2588,0,55896,56139,56137,2,175,9,9,19,5543,5543,5534,5534
San Francisco,40,2022-09-19,681,682,682,0,16784,16856,16853,3,43,9,9,11,1063,1063,1054,1054
San Joaquin,40,2022-09-19,449,449,449,0,12862,12920,12919,1,35,5,5,2,2331,2331,2326,2326
San Luis Obispo,40,2022-09-19,151,151,151,0,2763,2776,2775,1,8,0,0,0,524,524,524,524
San Mateo,40,2022-09-19,580,580,580,0,13510,13569,13568,1,20,0,0,2,737,737,737,737
Santa Barbara,40,2022-09-19,263,263,263,0,6788,6818,6817,1,34,2,2,0,729,729,727,727
Santa Clara,40,2022-09-19,1422,1429,1429,0,36498,36658,36657,1,137,7,7,21,2517,2517,2510,2510
Santa Cruz,40,2022-09-19,147,147,147,0,12304,12359,12358,1,5,0,0,1,273,273,273,273
Shasta,40,2022-09-19,96,96,96,0,2112,2121,2120,1,21,0,0,3,589,589,589,589
Siskiyou,40,2022-09-19,21,21,21,0,232,233,232,1,2,1,1,0,90,90,89,89
Solano,40,2022-09-19,271,271,271,0,6109,6136,6135,1,24,1,1,5,457,457,456,456
Sonoma,40,2022-09-19,311,311,311,0,6357,6384,6383,1,27,3,3,1,525,525,522,522
Stanislaus,40,2022-09-19,327,327,327,0,6289,6315,6314,1,57,4,4,4,1782,1782,1778,1778
Sutter,40,2022-09-19,75,75,75,0,1388,1395,1394,1,0,0,0,0,232,232,232,232
Tehama,40,2022-09-19,35,35,35,0,599,602,601,1,2,1,1,0,213,213,212,212
Trinity,40,2022-09-19,3,3,3,0,53,54,53,1,0,0,0,0,21,21,21,21
Tulare,40,2022-09-19,219,219,219,0,5726,5751,5750,1,32,1,1,0,1535,1535,1534,1534
Tuolumne,40,2022-09-19,57,57,57,0,717,721,720,1,0,0,0,0,205,205,205,205
Ventura,40,2022-09-19,596,597,597,0,13372,13430,13429,1,42,2,2,6,1581,1581,1579,1579
Yolo,40,2022-09-19,80,80,80,0,3720,3738,3737,1,2,3,3,2,398,398,395,395
Yuba,40,2022-09-19,60,60,60,0,1035,1041,1040,1,3,0,0,0,121,121,121,121
Alameda,41,2022-09-26,1122,1129,1129,0,27581,27715,27714,1,77,2,2,4,2037,2037,2035,2035
Amador,41,2022-09-26,26,26,26,0,721,725,724,1,1,0,0,1,94,94,94,94
Butte,41,2022-09-26,90,90,90,0,1792,1802,1801,1,23,0,0,1,462,462,462,462
Calaveras,41,2022-09-26,20,20,20,0,388,389,388,1,2,1,1,0,134,134,133,133
Colusa,41,2022-09-26,7,7,7,0,299,302,301,1,1,0,0,0,22,22,22,22
Contra Costa,41,2022-09-26,748,752,752,0,16253,16331,16330,1,48,5,5,7,1456,1456,1451,1451
Del Norte,41,2022-09-26,21,21,21,0,468,470,469,1,2,0,0,0,55,55,55,55
El Dorado,41,2022-09-26,84,84,84,0,1580,1589,1588,1,5,0,0,0,232,232,232,232
Fresno,41,2022-09-26,507,508,508,0,12093,12153,12152,1,84,3,3,13,2877,2877,2874,2874
Glenn,41,2022-09-26,7,7,7,0,176,177,176,1,2,0,0,0,53,53,53,53
Humboldt,41,2022-09-26,93,93,93,0,1311,1317,1316,1,10,2,2,0,160,160,158,158
Imperial,41,2022-09-26,113,113,113,0,2628,2642,2641,1,4,1,1,1,962,962,961,961
Inyo,41,2022-09-26,5,5,5,0,165,166,165,1,0,0,0,0,60,60,60,60
Kern,41,2022-09-26,341,341,341,0,10733,10785,10784,1,32,3,3,7,2425,2425,2422,2422
Kings,41,2022-09-26,106,106,106,0,2619,2632,2631,1,2,1,1,0,459,459,458,458
Lake,41,2022-09-26,23,23,23,0,815,820,819,1,0,0,0,0,147,147,147,147
Lassen,41,2022-09-26,13,13,13,0,533,536,535,1,0,0,0,0,63,63,63,63
Los Angeles,41,2022-09-26,7703,7742,7742,0,239227,240393,240388,5,443,62,62,53,33579,33579,33517,33517
Madera,41,2022-09-26,79,79,79,0,2231,2244,2243,1,8,0,0,2,374,374,374,374
Marin,41,2022-09-26,171,171,171,0,3659,3678,3677,1,10,0,0,0,315,315,315,315
Mariposa,41,2022-09-26,3,3,3,0,155,156,155,1,0,0,0,0,30,30,30,30
Mendocino,41,2022-09-26,36,36,36,0,850,856,855,1,1,0,0,0,136,136,136,136
Merced,41,2022-09-26,119,119,119,0,2837,2853,2852,1,10,1,1,0,867,867,866,866
Modoc,41,2022-09-26,0,0,0,0,13,14,13,1,0,0,0,0,9,9,9,9
Mono,41,2022-09-26,1,1,1,0,60,61,60,1,0,0,0,0,7,7,7,7
Monterey,41,2022-09-26,134,134,134,0,4023,4042,4041,1,14,0,0,2,768,768,768,768
Napa,41,2022-09-26,85,85,85,0,1955,1965,1964,1,5,0,0,1,159,159,159,159
Nevada,41,2022-09-26,47,47,47,0,1074,1080,1079,1,1,0,0,0,132,132,132,132
Orange,41,2022-09-26,1663,1671,1671,0,31053,31205,31203,2,117,19,19,23,7500,7500,7481,7481
Placer,41,2022-09-26,207,207,207,0,3592,3611,3610,1,42,1,1,4,660,660,659,659
Plumas,41,2022-09-26,21,21,21,0,151,152,151,1,1,0,0,0,13,13,13,13
Riverside,41,2022-09-26,1270,1277,1277,0,25761,25885,25883,2,55,8,8,15,6638,6638,6630,6630
Sacramento,41,2022-09-26,915,920,920,0,19308,19402,19401,1,106,11,11,20,3334,3334,3323,3323
San Benito,41,2022-09-26,47,47,47,0,497,499,498,1,0,1,1,2,101,101,100,100
San Bernardino,41,2022-09-26,1199,1206,1206,0,27801,27937,27936,1,75,5,5,12,8083,8083,8078,8078
San Diego,41,2022-09-26,2483,2495,2495,0,50917,51166,51165,1,201,7,7,15,5550,5550,5543,5543
San Francisco,41,2022-09-26,667,669,669,0,16114,16193,16191,2,45,2,2,9,1065,1065,1063,1063
San Joaquin,41,2022-09-26,400,400,400,0,11064,11118,11117,1,35,1,1,3,2332,2332,2331,2331
San Luis Obispo,41,2022-09-26,125,125,125,0,2517,2531,2530,1,7,1,1,0,525,525,524,524
San Mateo,41,2022-09-26,589,590,590,0,12958,13022,13021,1,25,0,0,1,737,737,737,737
Santa Barbara,41,2022-09-26,252,252,252,0,6382,6413,6412,1,22,2,2,0,731,731,729,729
Santa Clara,41,2022-09-26,1364,1371,1371,0,35347,35520,35519,1,113,10,10,17,2527,2527,2517,2517
Santa Cruz,41,2022-09-26,220,220,220,0,12494,12555,12554,1,13,0,0,0,273,273,273,273
Shasta,41,2022-09-26,67,67,67,0,1738,1746,1745,1,14,0,0,3,589,589,589,589
Siskiyou,41,2022-09-26,18,18,18,0,183,184,183,1,1,2,2,0,92,92,90,90
Solano,41,2022-09-26,306,306,306,0,5714,5745,5744,1,23,1,1,2,458,458,457,457
Sonoma,41,2022-09-26,288,288,288,0,6331,6362,6361,1,31,1,1,2,526,526,525,525
Stanislaus,41,2022-09-26,260,260,260,0,5811,5839,5838,1,46,2,2,3,1784,1784,1782,1782
Sutter,41,2022-09-26,68,68,68,0,1146,1152,1151,1,0,0,0,0,232,232,232,232
Tehama,41,2022-09-26,33,33,33,0,550,553,552,1,1,2,2,0,215,215,213,213
Trinity,41,2022-09-26,3,3,3,0,44,45,44,1,0,0,0,0,21,21,21,21
Tulare,41,2022-09-26,163,163,163,0,5091,5116,5115,1,18,3,3,2,1538,1538,1535,1535
Tuolumne,41,2022-09-26,43,43,43,0,689,693,692,1,1,0,0,0,205,205,205,205
Ventura,41,2022-09-26,530,530,530,0,11569,11625,11624,1,33,4,4,1,1585,1585,1581,1581
Yolo,41,2022-09-26,124,124,124,0,3970,3991,3990,1,2,3,3,3,401,401,398,398
Yuba,41,2022-09-26,40,40,40,0,933,939,938,1,6,0,0,1,121,121,121,121
Alameda,42,2022-10-03,1114,1121,1121,0,26068,26205,26204,1,54,3,3,5,2040,2040,2037,2037
Amador,42,2022-10-03,13,13,13,0,690,693,692,1,0,0,0,1,94,94,94,94
Butte,42,2022-10-03,63,63,63,0,1752,1763,1762,1,11,2,2,2,464,464,462,462
Calaveras,42,2022-10-03,18,18,18,0,334,335,334,1,1,0,0,0,134,134,134,134
Colusa,42,2022-10-03,7,7,7,0,188,190,189,1,0,0,0,0,22,22,22,22
Contra Costa,42,2022-10-03,698,703,703,0,15674,15756,15755,1,34,3,3,6,1459,1459,1456,1456
Del Norte,42,2022-10-03,12,12,12,0,382,383,382,1,1,0,0,1,55,55,55,55
El Dorado,42,2022-10-03,80,80,80,0,1450,1457,1456,1,3,0,0,1,232,232,232,232
Fresno,42,2022-10-03,455,455,455,0,11208,11267,11266,1,77,2,2,11,2879,2879,2877,2877
Glenn,42,2022-10-03,6,6,6,0,155,156,155,1,0,0,0,0,53,53,53,53
Humboldt,42,2022-10-03,77,77,77,0,1157,1163,1162,1,6,0,0,1,160,160,160,160
Imperial,42,2022-10-03,139,139,139,0,2563,2578,2577,1,6,0,0,0,962,962,962,962
Inyo,42,2022-10-03,5,5,5,0,159,160,159,1,0,0,0,1,60,60,60,60
Kern,42,2022-10-03,282,282,282,0,9962,10015,10014,1,24,4,4,5,2429,2429,2425,2425
Kings,42,2022-10-03,87,87,87,0,2415,2429,2428,1,2,0,0,0,459,459,459,459
Lake,42,2022-10-03,32,32,32,0,759,765,764,1,3,1,1,0,148,148,147,147
Lassen,42,2022-10-03,7,7,7,0,530,533,532,1,2,0,0,0,63,63,63,63
Los Angeles,42,2022-10-03,7007,7043,7043,0,219944,221101,221097,4,439,50,50,69,33629,33629,33579,33579
Madera,42,2022-10-03,65,65,65,0,1563,1573,1572,1,6,0,0,2,374,374,374,374
Marin,42,2022-10-03,187,187,187,0,3469,3488,3487,1,6,0,0,2,315,315,315,315
Mariposa,42,2022-10-03,5,5,5,0,131,132,131,1,0,0,0,0,30,30,30,30
Mendocino,42,2022-10-03,45,45,45,0,778,784,783,1,4,0,0,0,136,136,136,136
Merced,42,2022-10-03,104,104,104,0,2595,2609,2608,1,5,3,3,1,870,870,867,867
Modoc,42,2022-10-03,2,2,2,0,14,15,14,1,0,0,0,0,9,9,9,9
Mono,42,2022-10-03,4,4,4,0,69,70,69,1,0,0,0,0,7,7,7,7
Monterey,42,2022-10-03,110,110,110,0,3755,3776,3775,1,11,1,1,1,769,769,768,768
Napa,42,2022-10-03,88,88,88,0,1697,1706,1705,1,4,0,0,2,159,159,159,159
Nevada,42,2022-10-03,47,47,47,0,954,960,959,1,1,0,0,4,132,132,132,132
Orange,42,2022-10-03,1521,1528,1528,0,27894,28041,28040,1,131,22,22,16,7522,7522,7500,7500
Placer,42,2022-10-03,204,204,204,0,3335,3354,3353,1,41,2,2,3,662,662,660,660
Plumas,42,2022-10-03,12,12,12,0,107,108,107,1,1,0,0,0,13,13,13,13
Riverside,42,2022-10-03,1131,1138,1138,0,22042,22157,22156,1,59,7,7,12,6645,6645,6638,6638
Sacramento,42,2022-10-03,894,899,899,0,18207,18303,18302,1,88,12,12,19,3346,3346,3334,3334
San Benito,42,2022-10-03,29,29,29,0,437,438,437,1,0,0,0,0,101,101,101,101
San Bernardino,42,2022-10-03,1198,1205,1205,0,24828,24958,24957,1,77,4,4,7,8087,8087,8083,8083
San Diego,42,2022-10-03,2087,2098,2098,0,46597,46844,46843,1,162,9,9,18,5559,5559,5550,5550
San Francisco,42,2022-10-03,636,639,639,0,15299,15381,15379,2,44,3,3,9,1068,1068,1065,1065
San Joaquin,42,2022-10-03,336,336,336,0,9930,9982,9981,1,25,4,4,3,2336,2336,2332,2332
San Luis Obispo,42,2022-10-03,141,141,141,0,2382,2396,2395,1,2,1,1,1,526,526,525,525
San Mateo,42,2022-10-03,542,543,543,0,12233,12298,12297,1,22,0,0,2,737,737,737,737
Santa Barbara,42,2022-10-03,250,250,250,0,6289,6322,6321,1,15,0,0,2,731,731,731,731
Santa Clara,42,2022-10-03,1399,1406,1406,0,31868,32035,32034,1,109,6,6,20,2533,2533,2527,2527
Santa Cruz,42,2022-10-03,223,223,223,0,11218,11277,11276,1,10,0,0,1,273,273,273,273
Shasta,42,2022-10-03,53,53,53,0,1441,1449,1448,1,10,0,0,2,589,589,589,589
Siskiyou,42,2022-10-03,10,10,10,0,204,205,204,1,0,0,0,0,92,92,92,92
Solano,42,2022-10-03,246,246,246,0,5345,5375,5374,1,17,0,0,2,458,458,458,458
Sonoma,42,2022-10-03,321,321,321,0,5928,5960,5959,1,17,0,0,3,526,526,526,526
Stanislaus,42,2022-10-03,196,196,196,0,5351,5381,5380,1,49,1,1,6,1785,1785,1784,1784
Sutter,42,2022-10-03,57,57,57,0,1108,1115,1114,1,0,0,0,0,232,232,232,232
Tehama,42,2022-10-03,19,19,19,0,526,530,529,1,1,0,0,0,215,215,215,215
Trinity,42,2022-10-03,1,1,1,0,43,44,43,1,0,0,0,0,21,21,21,21
Tulare,42,2022-10-03,152,152,152,0,5050,5078,5077,1,19,2,2,1,1540,1540,1538,1538
Tuolumne,42,2022-10-03,21,21,21,0,623,627,626,1,0,0,0,0,205,205,205,205
Ventura,42,2022-10-03,462,462,462,0,10424,10479,10478,1,41,1,1,2,1586,1586,1585,1585
Yolo,42,2022-10-03,121,121,121,0,2981,2998,2997,1,3,2,2,2,403,403,401,401
Yuba,42,2022-10-03,35,35,35,0,801,807,806,1,4,0,0,1,121,121,121,121
Alameda,43,2022-10-10,1124,1132,1132,0,27700,27871,27870,1,45,2,2,7,2042,2042,2040,2040
Amador,43,2022-10-10,15,15,15,0,801,806,805,1,0,0,0,2,94,94,94,94
Butte,43,2022-10-10,65,65,65,0,1750,1762,1761,1,12,3,3,1,466,466,463,463
Calaveras,43,2022-10-10,15,15,15,0,373,374,373,1,0,1,1,0,135,135,134,134
Colusa,43,2022-10-10,1,1,1,0,120,121,120,1,1,0,0,0,22,22,22,22
Contra Costa,43,2022-10-10,744,749,749,0,16750,16853,16852,1,31,7,7,6,1464,1464,1457,1457
Del Norte,43,2022-10-10,10,10,10,0,492,496,495,1,1,0,0,1,55,55,55,55
El Dorado,43,2022-10-10,79,79,79,0,1747,1758,1757,1,7,0,0,4,232,232,232,232
Fresno,43,2022-10-10,474,476,476,0,12390,12467,12466,1,60,3,3,9,2882,2882,2879,2879
Glenn,43,2022-10-10,10,10,10,0,226,229,228,1,1,0,0,0,53,53,53,53
Humboldt,43,2022-10-10,92,92,92,0,1418,1426,1425,1,7,1,1,0,161,161,160,160
Imperial,43,2022-10-10,194,194,194,0,2957,2976,2975,1,7,0,0,0,962,962,962,962
Inyo,43,2022-10-10,4,4,4,0,123,124,123,1,0,0,0,0,60,60,60,60
Kern,43,2022-10-10,324,324,324,0,11646,11718,11717,1,24,2,2,2,2431,2431,2429,2429
Kings,43,2022-10-10,102,102,102,0,2748,2766,2765,1,1,1,1,0,460,460,459,459
Lake,43,2022-10-10,33,33,33,0,920,927,926,1,1,0,0,0,148,148,148,148
Lassen,43,2022-10-10,3,3,3,0,573,577,576,1,0,0,0,0,63,63,63,63
Los Angeles,43,2022-10-10,6794,6837,6837,0,226441,227832,227829,3,436,69,69,51,33690,33690,33621,33621
Madera,43,2022-10-10,65,65,65,0,1716,1727,1726,1,7,1,1,2,375,375,374,374
Marin,43,2022-10-10,205,205,205,0,3772,3796,3795,1,9,0,0,0,315,315,315,315
Mariposa,43,2022-10-10,8,8,8,0,128,129,128,1,0,0,0,0,30,30,30,30
Mendocino,43,2022-10-10,27,27,27,0,973,980,979,1,1,0,0,2,136,136,136,136
Merced,43,2022-10-10,102,102,102,0,2763,2780,2779,1,8,1,1,3,871,871,870,870
Modoc,43,2022-10-10,5,5,5,0,12,13,12,1,0,0,0,0,9,9,9,9
Mono,43,2022-10-10,1,1,1,0,55,56,55,1,0,0,0,0,7,7,7,7
Monterey,43,2022-10-10,106,106,106,0,4342,4370,4369,1,9,0,0,1,769,769,769,769
Napa,43,2022-10-10,78,78,78,0,1765,1778,1777,1,3,0,0,2,159,159,159,159
Nevada,43,2022-10-10,37,37,37,0,979,986,985,1,1,0,0,1,132,132,132,132
Orange,43,2022-10-10,1478,1486,1486,0,29611,29793,29792,1,129,14,14,19,7534,7534,7520,7520
Placer,43,2022-10-10,186,186,186,0,3819,3844,3843,1,24,0,0,7,662,662,662,662
Plumas,43,2022-10-10,20,20,20,0,106,107,106,1,0,0,0,0,13,13,13,13
Riverside,43,2022-10-10,1170,1178,1178,0,23894,24041,24040,1,56,5,5,4,6650,6650,6645,6645
Sacramento,43,2022-10-10,936,943,943,0,20426,20553,20552,1,81,5,5,16,3351,3351,3346,3346
San Benito,43,2022-10-10,34,34,34,0,467,469,468,1,3,0,0,0,101,101,101,101
San Bernardino,43,2022-10-10,1081,1088,1088,0,27118,27284,27283,1,66,0,0,13,8087,8087,8087,8087
San Diego,43,2022-10-10,1995,2008,2008,0,51315,51629,51628,1,130,7,7,21,5564,5564,5557,5557
San Francisco,43,2022-10-10,679,684,684,0,16021,16118,16117,1,37,2,2,9,1070,1070,1068,1068
San Joaquin,43,2022-10-10,424,426,426,0,11569,11640,11639,1,17,2,2,8,2338,2338,2336,2336
San Luis Obispo,43,2022-10-10,85,85,85,0,2565,2583,2582,1,2,2,2,0,528,528,526,526
San Mateo,43,2022-10-10,640,642,642,0,13536,13619,13618,1,19,0,0,0,737,737,737,737
Santa Barbara,43,2022-10-10,239,239,239,0,7844,7894,7893,1,20,1,1,1,732,732,731,731
Santa Clara,43,2022-10-10,1415,1423,1423,0,33684,33893,33892,1,107,2,2,18,2535,2535,2533,2533
Santa Cruz,43,2022-10-10,337,337,337,0,12256,12333,12332,1,9,0,0,1,273,273,273,273
Shasta,43,2022-10-10,98,98,98,0,1297,1308,1307,1,13,3,3,1,592,592,589,589
Siskiyou,43,2022-10-10,9,9,9,0,244,245,244,1,0,1,1,0,93,93,92,92
Solano,43,2022-10-10,326,326,326,0,6250,6291,6290,1,23,0,0,4,458,458,458,458
Sonoma,43,2022-10-10,284,284,284,0,6768,6811,6810,1,15,1,1,3,527,527,526,526
Stanislaus,43,2022-10-10,204,204,204,0,5923,5959,5958,1,51,7,7,7,1790,1790,1783,1783
Sutter,43,2022-10-10,56,56,56,0,1126,1133,1132,1,0,0,0,0,232,232,232,232
Tehama,43,2022-10-10,20,20,20,0,566,569,568,1,1,0,0,0,215,215,215,215
Trinity,43,2022-10-10,1,1,1,0,53,54,53,1,0,0,0,0,21,21,21,21
Tulare,43,2022-10-10,164,164,164,0,4974,5005,5004,1,16,1,1,1,1541,1541,1540,1540
Tuolumne,43,2022-10-10,36,36,36,0,661,666,665,1,1,1,1,0,206,206,205,205
Ventura,43,2022-10-10,420,420,420,0,10969,11037,11036,1,41,4,4,1,1589,1589,1585,1585
Yolo,43,2022-10-10,125,125,125,0,3083,3103,3102,1,4,2,2,0,405,405,403,403
Yuba,43,2022-10-10,24,24,24,0,927,934,933,1,0,0,0,0,121,121,121,121
Alameda,44,2022-10-17,905,912,912,0,24394,24568,24567,1,60,5,5,8,2047,2047,2042,2042
Amador,44,2022-10-17,14,14,14,0,591,595,594,1,1,0,0,0,94,94,94,94
Butte,44,2022-10-17,75,75,75,0,1424,1435,1434,1,13,0,0,0,466,466,466,466
Calaveras,44,2022-10-17,19,19,19,0,305,307,306,1,0,0,0,0,135,135,135,135
Colusa,44,2022-10-17,4,4,4,0,80,81,80,1,0,0,0,0,22,22,22,22
Contra Costa,44,2022-10-17,658,664,664,0,14487,14590,14589,1,30,4,4,6,1468,1468,1464,1464
Del Norte,44,2022-10-17,10,10,10,0,379,382,381,1,1,0,0,0,55,55,55,55
El Dorado,44,2022-10-17,83,83,83,0,1380,1392,1391,1,2,0,0,1,232,232,232,232
Fresno,44,2022-10-17,340,341,341,0,10210,10284,10283,1,62,2,2,11,2884,2884,2882,2882
Glenn,44,2022-10-17,6,6,6,0,141,143,142,1,1,0,0,0,53,53,53,53
Humboldt,44,2022-10-17,70,70,70,0,1148,1158,1157,1,1,0,0,0,161,161,161,161
Imperial,44,2022-10-17,115,115,115,0,2319,2336,2335,1,5,0,0,0,962,962,962,962
Inyo,44,2022-10-17,5,5,5,0,122,123,122,1,1,0,0,0,60,60,60,60
Kern,44,2022-10-17,230,230,230,0,9626,9696,9695,1,32,0,0,1,2431,2431,2431,2431
Kings,44,2022-10-17,70,70,70,0,2320,2337,2336,1,2,0,0,0,460,460,460,460
Lake,44,2022-10-17,25,25,25,0,774,781,780,1,1,0,0,0,148,148,148,148
Lassen,44,2022-10-17,7,7,7,0,513,517,516,1,1,0,0,0,63,63,63,63
Los Angeles,44,2022-10-17,5120,5157,5157,0,188125,189465,189463,2,350,41,41,53,33731,33731,33690,33690
Madera,44,2022-10-17,54,54,54,0,1465,1476,1475,1,3,0,0,2,375,375,375,375
Marin,44,2022-10-17,132,132,132,0,3093,3117,3116,1,8,0,0,1,315,315,315,315
Mariposa,44,2022-10-17,5,5,5,0,119,120,119,1,0,0,0,0,30,30,30,30
Mendocino,44,2022-10-17,45,45,45,0,741,748,747,1,2,0,0,0,136,136,136,136
Merced,44,2022-10-17,123,123,123,0,2333,2351,2350,1,15,0,0,2,871,871,871,871
Modoc,44,2022-10-17,1,1,1,0,7,8,7,1,0,0,0,0,9,9,9,9
Mono,44,2022-10-17,6,6,6,0,41,42,41,1,1,0,0,0,7,7,7,7
Monterey,44,2022-10-17,119,119,119,0,3530,3557,3556,1,12,1,1,1,770,770,769,769
Napa,44,2022-10-17,58,58,58,0,1415,1427,1426,1,2,0,0,1,159,159,159,159
Nevada,44,2022-10-17,44,44,44,0,777,784,783,1,0,0,0,5,132,132,132,132
Orange,44,2022-10-17,1080,1088,1088,0,24707,24884,24883,1,91,21,21,18,7555,7555,7534,7534
Placer,44,2022-10-17,143,143,143,0,2919,2943,2942,1,32,0,0,3,662,662,662,662
Plumas,44,2022-10-17,11,11,11,0,98,99,98,1,0,0,0,0,13,13,13,13
Riverside,44,2022-10-17,881,888,888,0,20667,20816,20815,1,66,2,2,2,6652,6652,6650,6650
Sacramento,44,2022-10-17,850,857,857,0,16143,16259,16258,1,84,9,9,14,3360,3360,3351,3351
San Benito,44,2022-10-17,26,26,26,0,363,365,364,1,0,1,1,0,102,102,101,101
San Bernardino,44,2022-10-17,810,817,817,0,23204,23369,23368,1,63,1,1,9,8088,8088,8087,8087
San Diego,44,2022-10-17,1662,1674,1674,0,43402,43713,43712,1,117,8,8,24,5572,5572,5564,5564
San Francisco,44,2022-10-17,559,564,564,0,14393,14496,14495,1,34,3,3,13,1073,1073,1070,1070
San Joaquin,44,2022-10-17,342,343,343,0,9070,9137,9136,1,8,2,2,8,2340,2340,2338,2338
San Luis Obispo,44,2022-10-17,102,102,102,0,2129,2145,2144,1,4,1,1,0,529,529,528,528
San Mateo,44,2022-10-17,537,542,542,0,11180,11260,11259,1,21,0,0,1,737,737,737,737
Santa Barbara,44,2022-10-17,174,174,174,0,5623,5664,5663,1,18,0,0,2,732,732,732,732
Santa Clara,44,2022-10-17,1145,1152,1152,0,28086,28288,28287,1,93,4,4,16,2539,2539,2535,2535
Santa Cruz,44,2022-10-17,281,282,282,0,10275,10349,10348,1,7,1,1,0,274,274,273,273
Shasta,44,2022-10-17,78,78,78,0,1105,1114,1113,1,12,0,0,2,592,592,592,592
Siskiyou,44,2022-10-17,12,12,12,0,181,182,181,1,2,1,1,0,94,94,93,93
Solano,44,2022-10-17,258,258,258,0,4825,4860,4859,1,25,1,1,3,459,459,458,458
Sonoma,44,2022-10-17,237,237,237,0,5368,5408,5407,1,20,1,1,1,528,528,527,527
Stanislaus,44,2022-10-17,217,217,217,0,5292,5331,5330,1,45,0,0,5,1790,1790,1790,1790
Sutter,44,2022-10-17,38,38,38,0,909,917,916,1,0,0,0,0,232,232,232,232
Tehama,44,2022-10-17,21,21,21,0,396,398,397,1,0,0,0,0,215,215,215,215
Trinity,44,2022-10-17,0,0,0,0,34,35,34,1,0,0,0,0,21,21,21,21
Tulare,44,2022-10-17,135,135,135,0,4269,4300,4299,1,11,1,1,1,1542,1542,1541,1541
Tuolumne,44,2022-10-17,35,35,35,0,620,626,625,1,2,0,0,0,206,206,206,206
Ventura,44,2022-10-17,364,365,365,0,9332,9398,9397,1,32,3,3,1,1592,1592,1589,1589
Yolo,44,2022-10-17,103,103,103,0,2200,2217,2216,1,3,2,2,3,407,407,405,405
Yuba,44,2022-10-17,44,44,44,0,772,778,777,1,1,0,0,0,121,121,121,121
Alameda,45,2022-10-24,920,928,928,0,23120,23313,23312,1,46,5,5,10,2052,2052,2047,2047
Amador,45,2022-10-24,18,18,18,0,635,641,640,1,2,0,0,0,94,94,94,94
Butte,45,2022-10-24,66,66,66,0,1405,1419,1418,1,10,1,1,1,467,467,466,466
Calaveras,45,2022-10-24,20,20,20,0,322,324,323,1,0,0,0,0,135,135,135,135
Colusa,45,2022-10-24,3,3,3,0,95,96,95,1,0,0,0,0,22,22,22,22
Contra Costa,45,2022-10-24,614,621,621,0,13853,13968,13967,1,37,5,5,5,1473,1473,1468,1468
Del Norte,45,2022-10-24,6,6,6,0,361,365,364,1,0,0,0,1,55,55,55,55
El Dorado,45,2022-10-24,90,90,90,0,1519,1532,1531,1,1,0,0,0,232,232,232,232
Fresno,45,2022-10-24,369,372,372,0,9747,9829,9828,1,63,0,0,6,2884,2884,2884,2884
Glenn,45,2022-10-24,9,9,9,0,148,150,149,1,0,0,0,0,53,53,53,53
Humboldt,45,2022-10-24,67,67,67,0,1148,1159,1158,1,7,0,0,2,161,161,161,161
Imperial,45,2022-10-24,90,90,90,0,2346,2366,2365,1,8,0,0,0,962,962,962,962
Inyo,45,2022-10-24,4,4,4,0,272,275,274,1,0,0,0,0,60,60,60,60
Kern,45,2022-10-24,268,268,268,0,9630,9712,9711,1,24,2,2,2,2433,2433,2431,2431
Kings,45,2022-10-24,87,87,87,0,2339,2359,2358,1,8,0,0,0,460,460,460,460
Lake,45,2022-10-24,21,21,21,0,643,649,648,1,1,0,0,1,148,148,148,148
Lassen,45,2022-10-24,16,16,16,0,484,489,488,1,1,0,0,0,63,63,63,63
Los Angeles,45,2022-10-24,5314,5357,5357,0,185567,187109,187107,2,332,53,54,43,33784,33785,33731,33731
Madera,45,2022-10-24,60,60,60,0,1388,1401,1400,1,4,0,0,2,375,375,375,375
Marin,45,2022-10-24,138,138,138,0,3077,3104,3103,1,12,1,1,2,316,316,315,315
Mariposa,45,2022-10-24,11,11,11,0,120,121,120,1,0,0,0,0,30,30,30,30
Mendocino,45,2022-10-24,39,39,39,0,770,776,775,1,2,0,0,0,136,136,136,136
Merced,45,2022-10-24,85,85,85,0,2404,2425,2424,1,7,3,3,3,874,874,871,871
Modoc,45,2022-10-24,1,1,1,0,13,14,13,1,0,0,0,0,9,9,9,9
Mono,45,2022-10-24,3,3,3,0,63,64,63,1,0,1,1,0,8,8,7,7
Monterey,45,2022-10-24,128,128,128,0,3702,3733,3732,1,18,0,0,0,770,770,770,770
Napa,45,2022-10-24,51,51,51,0,1467,1481,1480,1,3,0,0,0,159,159,159,159
Nevada,45,2022-10-24,37,37,37,0,784,793,792,1,6,0,0,0,132,132,132,132
Orange,45,2022-10-24,1121,1130,1130,0,25596,25809,25808,1,84,10,10,14,7565,7565,7555,7555
Placer,45,2022-10-24,190,190,190,0,3026,3052,3051,1,39,0,0,6,662,662,662,662
Plumas,45,2022-10-24,12,12,12,0,91,92,91,1,0,0,0,0,13,13,13,13
Riverside,45,2022-10-24,916,924,924,0,20044,20212,20211,1,53,0,0,6,6652,6652,6652,6652
Sacramento,45,2022-10-24,794,801,801,0,15254,15381,15380,1,84,4,4,19,3364,3364,3360,3360
San Benito,45,2022-10-24,38,38,38,0,447,452,451,1,0,0,0,1,102,102,102,102
San Bernardino,45,2022-10-24,771,778,778,0,21401,21579,21578,1,39,3,3,10,8091,8091,8088,8088
San Diego,45,2022-10-24,1688,1701,1701,0,41850,42198,42197,1,83,5,5,18,5577,5577,5572,5572
San Francisco,45,2022-10-24,499,504,504,0,13841,13956,13955,1,35,1,1,5,1074,1074,1073,1073
San Joaquin,45,2022-10-24,269,270,270,0,8493,8564,8563,1,13,2,2,3,2342,2342,2340,2340
San Luis Obispo,45,2022-10-24,86,86,86,0,2052,2070,2069,1,2,0,0,0,529,529,529,529
San Mateo,45,2022-10-24,461,466,466,0,10993,11086,11085,1,19,0,0,2,737,737,737,737
Santa Barbara,45,2022-10-24,160,160,160,0,5728,5775,5774,1,19,2,2,4,734,734,732,732
Santa Clara,45,2022-10-24,1183,1192,1192,0,28814,29055,29054,1,92,2,2,9,2541,2541,2539,2539
Santa Cruz,45,2022-10-24,234,234,234,0,10194,10280,10279,1,14,1,1,0,275,275,274,274
Shasta,45,2022-10-24,72,72,72,0,984,991,990,1,5,0,0,2,592,592,592,592
Siskiyou,45,2022-10-24,12,12,12,0,171,172,171,1,0,0,0,0,94,94,94,94
Solano,45,2022-10-24,235,235,235,0,5014,5057,5056,1,20,0,0,1,459,459,459,459
Sonoma,45,2022-10-24,242,243,243,0,5433,5479,5478,1,23,0,0,1,528,528,528,528
Stanislaus,45,2022-10-24,198,198,198,0,4850,4891,4890,1,40,3,3,3,1793,1793,1790,1790
Sutter,45,2022-10-24,27,27,27,0,881,890,889,1,0,0,0,0,232,232,232,232
Tehama,45,2022-10-24,35,35,35,0,405,410,409,1,1,0,0,0,215,215,215,215
Trinity,45,2022-10-24,1,1,1,0,34,35,34,1,0,0,0,0,21,21,21,21
Tulare,45,2022-10-24,105,105,105,0,4341,4379,4378,1,16,1,1,1,1543,1543,1542,1542
Tuolumne,45,2022-10-24,29,29,29,0,625,632,631,1,1,1,1,0,207,207,206,206
Ventura,45,2022-10-24,283,283,283,0,9021,9096,9095,1,40,3,3,6,1595,1595,1592,1592
Yolo,45,2022-10-24,90,90,90,0,2031,2049,2048,1,5,1,1,0,408,408,407,407
Yuba,45,2022-10-24,48,48,48,0,801,809,808,1,5,0,0,1,121,121,121,121
Alameda,46,2022-10-31,1018,1027,1027,0,22758,22980,22979,1,57,5,5,4,2057,2057,2052,2052
Amador,46,2022-10-31,18,18,18,0,577,584,583,1,2,1,1,0,95,95,94,94
Butte,46,2022-10-31,82,82,82,0,1457,1472,1471,1,11,0,0,3,467,467,467,467
Calaveras,46,2022-10-31,13,13,13,0,256,258,257,1,0,0,0,0,135,135,135,135
Colusa,46,2022-10-31,10,10,10,0,95,96,95,1,0,0,0,0,22,22,22,22
Contra Costa,46,2022-10-31,739,747,747,0,13827,13963,13962,1,37,6,6,7,1479,1479,1473,1473
Del Norte,46,2022-10-31,16,16,16,0,357,361,360,1,1,0,0,0,55,55,55,55
El Dorado,46,2022-10-31,99,99,99,0,1402,1416,1415,1,2,0,0,0,232,232,232,232
Fresno,46,2022-10-31,417,422,422,0,10503,10606,10605,1,57,4,4,8,2888,2888,2884,2884
Glenn,46,2022-10-31,16,16,16,0,156,158,157,1,1,0,0,0,53,53,53,53
Humboldt,46,2022-10-31,43,43,43,0,1019,1030,1029,1,6,0,0,2,161,161,161,161
Imperial,46,2022-10-31,124,124,124,0,2784,2813,2812,1,7,0,0,0,962,962,962,962
Inyo,46,2022-10-31,7,7,7,0,242,244,243,1,0,0,0,0,60,60,60,60
Kern,46,2022-10-31,331,333,333,0,9782,9878,9877,1,20,2,2,2,2435,2435,2433,2433
Kings,46,2022-10-31,117,118,118,0,2459,2485,2484,1,3,0,0,1,460,460,460,460
Lake,46,2022-10-31,28,28,28,0,752,761,760,1,1,0,0,1,148,148,148,148
Lassen,46,2022-10-31,19,19,19,0,522,527,526,1,1,0,0,0,63,63,63,63
Los Angeles,46,2022-10-31,6191,6250,6250,0,190433,192286,192284,2,344,37,40,44,33821,33825,33784,33785
Madera,46,2022-10-31,54,54,54,0,1433,1449,1448,1,3,0,0,2,375,375,375,375
Marin,46,2022-10-31,134,134,134,0,3468,3503,3502,1,10,1,1,1,317,317,316,316
Mariposa,46,2022-10-31,8,8,8,0,126,127,126,1,0,0,0,0,30,30,30,30
Mendocino,46,2022-10-31,21,21,21,0,709,718,717,1,1,0,0,2,136,136,136,136
Merced,46,2022-10-31,108,108,108,0,2134,2155,2154,1,5,0,0,0,874,874,874,874
Modoc,46,2022-10-31,1,1,1,0,13,14,13,1,0,0,0,0,9,9,9,9
Mono,46,2022-10-31,1,1,1,0,85,86,85,1,1,0,0,0,8,8,8,8
Monterey,46,2022-10-31,143,143,143,0,3681,3718,3717,1,18,2,2,0,772,772,770,770
Napa,46,2022-10-31,53,53,53,0,1501,1515,1514,1,2,0,0,0,159,159,159,159
Nevada,46,2022-10-31,34,34,34,0,773,782,781,1,6,0,0,0,132,132,132,132
Orange,46,2022-10-31,1149,1161,1161,0,26703,26962,26961,1,91,14,14,14,7579,7579,7565,7565
Placer,46,2022-10-31,145,145,145,0,2746,2774,2773,1,40,0,0,5,662,662,662,662
Plumas,46,2022-10-31,5,5,5,0,87,88,87,1,0,0,0,0,13,13,13,13
Riverside,46,2022-10-31,1023,1032,1032,0,19420,19609,19608,1,64,5,5,5,6657,6657,6652,6652
Sacramento,46,2022-10-31,730,737,737,0,14079,14215,14214,1,80,8,8,16,3372,3372,3364,3364
San Benito,46,2022-10-31,32,32,32,0,408,414,413,1,1,0,0,1,102,102,102,102
San Bernardino,46,2022-10-31,1019,1029,1029,0,22267,22485,22484,1,64,2,2,11,8093,8093,8091,8091
San Diego,46,2022-10-31,1774,1793,1793,0,42441,42855,42854,1,109,5,5,13,5582,5582,5577,5577
San Francisco,46,2022-10-31,603,610,610,0,14563,14706,14705,1,45,3,3,3,1077,1077,1074,1074
San Joaquin,46,2022-10-31,324,327,327,0,8591,8675,8674,1,21,6,6,3,2348,2348,2342,2342
San Luis Obispo,46,2022-10-31,74,74,74,0,2009,2029,2028,1,1,1,1,0,530,530,529,529
San Mateo,46,2022-10-31,505,512,512,0,11476,11589,11588,1,30,0,0,2,737,737,737,737
Santa Barbara,46,2022-10-31,173,173,173,0,6035,6095,6094,1,20,1,1,6,735,735,734,734
Santa Clara,46,2022-10-31,1259,1271,1271,0,30456,30753,30752,1,85,2,2,16,2543,2543,2541,2541
Santa Cruz,46,2022-10-31,185,186,186,0,9945,10043,10042,1,7,0,0,0,275,275,275,275
Shasta,46,2022-10-31,61,61,61,0,829,838,837,1,6,2,2,1,594,594,592,592
Siskiyou,46,2022-10-31,17,17,17,0,216,217,216,1,1,1,1,0,95,95,94,94
Solano,46,2022-10-31,309,311,311,0,5235,5287,5286,1,16,0,0,4,459,459,459,459
Sonoma,46,2022-10-31,202,202,202,0,5585,5640,5639,1,24,0,0,3,528,528,528,528
Stanislaus,46,2022-10-31,232,232,232,0,4828,4876,4875,1,49,1,1,8,1794,1794,1793,1793
Sutter,46,2022-10-31,55,55,55,0,901,910,909,1,0,0,0,0,232,232,232,232
Tehama,46,2022-10-31,25,25,25,0,395,401,400,1,1,0,0,0,215,215,215,215
Trinity,46,2022-10-31,17,17,17,0,73,74,73,1,5,0,0,0,21,21,21,21
Tulare,46,2022-10-31,153,153,153,0,3675,3712,3711,1,12,0,0,0,1543,1543,1543,1543
Tuolumne,46,2022-10-31,23,23,23,0,518,525,524,1,3,0,0,0,207,207,207,207
Ventura,46,2022-10-31,365,368,368,0,9511,9604,9603,1,24,2,2,2,1597,1597,1595,1595
Yolo,46,2022-10-31,81,81,81,0,1825,1845,1844,1,3,0,0,1,408,408,408,408
Yuba,46,2022-10-31,44,44,44,0,776,784,783,1,3,0,0,0,121,121,121,121
Alameda,47,2022-11-07,1292,1307,1307,0,23830,24097,24096,1,58,8,8,11,2065,2065,2057,2057
Amador,47,2022-11-07,32,32,32,0,685,695,694,1,3,0,0,0,95,95,95,95
Butte,47,2022-11-07,117,117,117,0,1371,1387,1386,1,11,0,0,2,467,467,467,467
Calaveras,47,2022-11-07,16,16,16,0,333,337,336,1,0,0,0,0,135,135,135,135
Colusa,47,2022-11-07,2,2,2,0,102,103,102,1,0,0,0,0,22,22,22,22
Contra Costa,47,2022-11-07,857,866,866,0,15391,15564,15563,1,43,3,3,4,1482,1482,1479,1479
Del Norte,47,2022-11-07,4,4,4,0,375,380,379,1,0,0,0,0,55,55,55,55
El Dorado,47,2022-11-07,106,106,106,0,1598,1617,1616,1,7,2,2,0,234,234,232,232
Fresno,47,2022-11-07,582,590,590,0,10713,10834,10833,1,61,3,3,9,2891,2891,2888,2888
Glenn,47,2022-11-07,29,29,29,0,131,133,132,1,0,0,0,0,53,53,53,53
Humboldt,47,2022-11-07,77,77,77,0,984,996,995,1,9,0,0,2,161,161,161,161
Imperial,47,2022-11-07,208,209,209,0,3710,3753,3752,1,7,0,0,0,962,962,962,962
Inyo,47,2022-11-07,19,19,19,0,264,268,267,1,0,0,0,0,60,60,60,60
Kern,47,2022-11-07,453,459,459,0,10638,10759,10758,1,29,1,1,5,2436,2436,2435,2435
Kings,47,2022-11-07,149,150,150,0,2457,2486,2485,1,7,1,1,0,461,461,460,460
Lake,47,2022-11-07,46,46,46,0,795,804,803,1,3,0,0,1,148,148,148,148
Lassen,47,2022-11-07,10,10,10,0,451,457,456,1,0,0,0,0,63,63,63,63
Los Angeles,47,2022-11-07,8046,8135,8135,0,189907,192027,192025,2,387,54,59,53,33875,33884,33821,33825
Madera,47,2022-11-07,76,76,76,0,1612,1630,1629,1,3,0,0,4,375,375,375,375
Marin,47,2022-11-07,147,147,147,0,3232,3269,3268,1,9,0,0,0,317,317,317,317
Mariposa,47,2022-11-07,12,12,12,0,121,122,121,1,0,0,0,0,30,30,30,30
Mendocino,47,2022-11-07,34,34,34,0,819,830,829,1,4,0,0,0,136,136,136,136
Merced,47,2022-11-07,136,136,136,0,2582,2613,2612,1,9,3,3,0,877,877,874,874
Modoc,47,2022-11-07,2,2,2,0,6,7,6,1,0,0,0,0,9,9,9,9
Mono,47,2022-11-07,3,3,3,0,96,97,96,1,0,0,0,0,8,8,8,8
Monterey,47,2022-11-07,213,214,214,0,3917,3961,3960,1,18,1,1,0,773,773,772,772
Napa,47,2022-11-07,77,77,77,0,1754,1775,1774,1,6,0,0,0,159,159,159,159
Nevada,47,2022-11-07,58,58,58,0,744,753,752,1,3,0,0,1,132,132,132,132
Orange,47,2022-11-07,1237,1251,1251,0,28375,28691,28690,1,94,9,9,20,7588,7588,7579,7579
Placer,47,2022-11-07,226,227,227,0,3331,3370,3369,1,53,2,2,7,664,664,662,662
Plumas,47,2022-11-07,5,5,5,0,69,70,69,1,0,0,0,0,13,13,13,13
Riverside,47,2022-11-07,1489,1505,1505,0,21526,21768,21767,1,71,2,2,5,6659,6659,6657,6657
Sacramento,47,2022-11-07,1082,1095,1095,0,15931,16109,16108,1,90,7,7,9,3379,3379,3372,3372
San Benito,47,2022-11-07,43,43,43,0,488,495,494,1,1,0,0,0,102,102,102,102
San Bernardino,47,2022-11-07,1408,1424,1424,0,23807,24073,24072,1,76,2,2,17,8095,8095,8093,8093
San Diego,47,2022-11-07,2152,2177,2177,0,45115,45619,45618,1,117,7,7,24,5589,5589,5582,5582
San Francisco,47,2022-11-07,712,720,720,0,14665,14829,14828,1,42,2,2,8,1079,1079,1077,1077
San Joaquin,47,2022-11-07,473,480,480,0,8800,8900,8899,1,24,2,2,3,2350,2350,2348,2348
San Luis Obispo,47,2022-11-07,121,121,121,0,2267,2295,2294,1,4,0,0,2,530,530,530,530
San Mateo,47,2022-11-07,561,568,568,0,12145,12282,12281,1,27,0,0,3,737,737,737,737
Santa Barbara,47,2022-11-07,223,224,224,0,6673,6749,6748,1,18,0,0,2,735,735,735,735
Santa Clara,47,2022-11-07,1632,1650,1650,0,30987,31333,31332,1,76,7,7,19,2550,2550,2543,2543
Santa Cruz,47,2022-11-07,278,280,280,0,11323,11451,11450,1,8,0,0,0,275,275,275,275
Shasta,47,2022-11-07,96,96,96,0,1051,1065,1064,1,11,0,0,3,594,594,594,594
Siskiyou,47,2022-11-07,15,15,15,0,295,299,298,1,1,0,0,0,95,95,95,95
Solano,47,2022-11-07,371,377,377,0,5489,5552,5551,1,22,2,2,3,461,461,459,459
Sonoma,47,2022-11-07,241,242,242,0,5903,5971,5970,1,11,2,2,2,530,530,528,528
Stanislaus,47,2022-11-07,300,304,304,0,4927,4983,4982,1,42,2,2,9,1796,1796,1794,1794
Sutter,47,2022-11-07,85,85,85,0,956,967,966,1,0,0,0,0,232,232,232,232
Tehama,47,2022-11-07,45,45,45,0,471,477,476,1,2,0,0,0,215,215,215,215
Trinity,47,2022-11-07,3,3,3,0,34,35,34,1,0,0,0,0,21,21,21,21
Tulare,47,2022-11-07,158,158,158,0,4367,4417,4416,1,14,0,0,0,1543,1543,1543,1543
Tuolumne,47,2022-11-07,79,79,79,0,681,691,690,1,2,0,0,0,207,207,207,207
Ventura,47,2022-11-07,430,437,437,0,10338,10455,10454,1,36,2,2,1,1599,1599,1597,1597
Yolo,47,2022-11-07,172,173,173,0,2232,2258,2257,1,3,2,2,0,410,410,408,408
Yuba,47,2022-11-07,46,46,46,0,908,920,919,1,3,0,0,2,121,121,121,121
Alameda,48,2022-11-14,1445,1463,1463,0,23995,24299,24298,1,77,3,3,9,2068,2068,2065,2065
Amador,48,2022-11-14,20,20,20,0,656,666,665,1,2,0,0,0,95,95,95,95
Butte,48,2022-11-14,118,118,118,0,1379,1397,1396,1,20,0,0,1,467,467,467,467
Calaveras,48,2022-11-14,28,28,28,0,341,346,345,1,0,0,0,0,135,135,135,135
Colusa,48,2022-11-14,11,11,11,0,100,101,100,1,1,0,0,0,22,22,22,22
Contra Costa,48,2022-11-14,921,933,933,0,15568,15765,15764,1,56,1,1,5,1483,1483,1482,1482
Del Norte,48,2022-11-14,17,17,17,0,395,401,400,1,1,0,0,0,55,55,55,55
El Dorado,48,2022-11-14,140,140,140,0,1589,1611,1610,1,7,0,0,1,234,234,234,234
Fresno,48,2022-11-14,757,765,765,0,11274,11417,11416,1,72,7,7,13,2898,2898,2891,2891
Glenn,48,2022-11-14,20,20,20,0,160,162,161,1,0,0,0,0,53,53,53,53
Humboldt,48,2022-11-14,79,79,79,0,1030,1045,1044,1,6,0,0,0,161,161,161,161
Imperial,48,2022-11-14,246,248,248,0,3216,3256,3255,1,4,0,0,1,962,962,962,962
Inyo,48,2022-11-14,10,10,10,0,542,550,549,1,0,0,0,0,60,60,60,60
Kern,48,2022-11-14,444,451,451,0,10596,10729,10728,1,26,1,1,6,2437,2437,2436,2436
Kings,48,2022-11-14,196,198,198,0,2624,2658,2657,1,6,1,1,0,462,462,461,461
Lake,48,2022-11-14,53,53,53,0,801,813,812,1,2,0,0,1,148,148,148,148
Lassen,48,2022-11-14,35,35,35,0,544,553,552,1,0,1,1,0,64,64,63,63
Los Angeles,48,2022-11-14,9357,9475,9475,0,194694,197147,197145,2,477,45,50,75,33920,33934,33875,33884
Madera,48,2022-11-14,92,92,92,0,1712,1733,1732,1,4,0,0,3,375,375,375,375
Marin,48,2022-11-14,170,170,170,0,3567,3613,3612,1,8,0,0,2,317,317,317,317
Mariposa,48,2022-11-14,16,16,16,0,137,138,137,1,0,0,0,0,30,30,30,30
Mendocino,48,2022-11-14,35,35,35,0,908,920,919,1,3,0,0,1,136,136,136,136
Merced,48,2022-11-14,178,179,179,0,2619,2653,2652,1,6,0,0,0,877,877,877,877
Modoc,48,2022-11-14,3,3,3,0,11,12,11,1,0,0,0,0,9,9,9,9
Mono,48,2022-11-14,10,10,10,0,122,123,122,1,0,0,0,0,8,8,8,8
Monterey,48,2022-11-14,199,200,200,0,4133,4187,4186,1,20,1,1,1,774,774,773,773
Napa,48,2022-11-14,104,104,104,0,1918,1943,1942,1,5,0,0,0,159,159,159,159
Nevada,48,2022-11-14,64,64,64,0,794,804,803,1,3,0,0,2,132,132,132,132
Orange,48,2022-11-14,1549,1569,1569,0,26612,26948,26947,1,118,5,5,21,7593,7593,7588,7588
Placer,48,2022-11-14,307,313,313,0,3833,3883,3882,1,54,1,1,5,665,665,664,664
Plumas,48,2022-11-14,4,4,4,0,79,80,79,1,0,0,0,0,13,13,13,13
Riverside,48,2022-11-14,1635,1655,1655,0,22313,22595,22594,1,95,4,4,10,6663,6663,6659,6659
Sacramento,48,2022-11-14,1170,1184,1184,0,16876,17089,17088,1,82,6,6,18,3385,3385,3379,3379
San Benito,48,2022-11-14,39,39,39,0,427,434,433,1,1,0,0,0,102,102,102,102
San Bernardino,48,2022-11-14,1767,1789,1789,0,23956,24257,24256,1,83,0,0,14,8095,8095,8095,8095
San Diego,48,2022-11-14,2464,2495,2495,0,43208,43753,43752,1,124,5,5,21,5594,5594,5589,5589
San Francisco,48,2022-11-14,702,710,710,0,13672,13845,13844,1,52,6,6,5,1085,1085,1079,1079
San Joaquin,48,2022-11-14,597,605,605,0,9495,9616,9615,1,20,0,0,5,2350,2350,2350,2350
San Luis Obispo,48,2022-11-14,110,110,110,0,2195,2225,2224,1,6,0,0,1,530,530,530,530
San Mateo,48,2022-11-14,634,642,642,0,11288,11432,11431,1,27,0,0,2,737,737,737,737
Santa Barbara,48,2022-11-14,185,186,186,0,5883,5958,5957,1,15,1,1,2,736,736,735,735
Santa Clara,48,2022-11-14,1730,1752,1752,0,30380,30763,30762,1,117,3,3,14,2553,2553,2550,2550
Santa Cruz,48,2022-11-14,246,248,248,0,9594,9717,9716,1,11,1,1,0,276,276,275,275
Shasta,48,2022-11-14,102,102,102,0,1072,1088,1087,1,10,1,1,2,595,595,594,594
Siskiyou,48,2022-11-14,26,26,26,0,396,404,403,1,2,0,0,0,95,95,95,95
Solano,48,2022-11-14,421,426,426,0,5408,5479,5478,1,26,0,0,3,461,461,461,461
Sonoma,48,2022-11-14,258,260,260,0,6034,6111,6110,1,23,1,1,0,531,531,530,530
Stanislaus,48,2022-11-14,326,332,332,0,5215,5283,5282,1,48,0,0,10,1796,1796,1796,1796
Sutter,48,2022-11-14,94,94,94,0,1182,1197,1196,1,0,0,0,0,232,232,232,232
Tehama,48,2022-11-14,48,48,48,0,574,582,581,1,1,0,0,0,215,215,215,215
Trinity,48,2022-11-14,10,10,10,0,52,53,52,1,0,1,1,0,22,22,21,21
Tulare,48,2022-11-14,296,299,299,0,4283,4339,4338,1,16,0,0,1,1543,1543,1543,1543
Tuolumne,48,2022-11-14,68,68,68,0,695,705,704,1,2,0,0,0,207,207,207,207
Ventura,48,2022-11-14,558,565,565,0,10603,10738,10737,1,28,1,1,4,1600,1600,1599,1599
Yolo,48,2022-11-14,154,154,154,0,2156,2185,2184,1,2,6,6,0,416,416,410,410
Yuba,48,2022-11-14,60,60,60,0,989,1001,1000,1,6,0,0,1,121,121,121,121
Alameda,49,2022-11-21,1694,1719,1719,0,25148,25509,25508,1,82,8,8,16,2076,2076,2068,2068
Amador,49,2022-11-21,25,25,25,0,832,843,842,1,2,0,0,0,95,95,95,95
Butte,49,2022-11-21,141,141,141,0,1327,1348,1347,1,21,0,0,1,467,467,467,467
Calaveras,49,2022-11-21,39,39,39,0,421,428,427,1,2,0,0,0,135,135,135,135
Colusa,49,2022-11-21,9,9,9,0,110,111,110,1,0,0,0,0,22,22,22,22
Contra Costa,49,2022-11-21,984,998,998,0,16033,16263,16262,1,52,3,3,8,1486,1486,1483,1483
Del Norte,49,2022-11-21,16,16,16,0,452,459,458,1,4,0,0,0,55,55,55,55
El Dorado,49,2022-11-21,184,185,185,0,1826,1853,1852,1,10,0,0,1,234,234,234,234
Fresno,49,2022-11-21,1052,1067,1067,0,12145,12319,12318,1,114,4,4,9,2902,2902,2898,2898
Glenn,49,2022-11-21,21,21,21,0,214,217,216,1,0,0,0,0,53,53,53,53
Humboldt,49,2022-11-21,100,100,100,0,1078,1095,1094,1,4,1,1,1,162,162,161,161
Imperial,49,2022-11-21,272,276,276,0,3121,3166,3165,1,3,1,1,1,963,963,962,962
Inyo,49,2022-11-21,29,29,29,0,402,409,408,1,0,1,1,0,61,61,60,60
Kern,49,2022-11-21,511,519,519,0,10011,10155,10154,1,54,3,3,10,2440,2440,2437,2437
Kings,49,2022-11-21,292,297,297,0,2776,2817,2816,1,4,2,2,1,464,464,462,462
Lake,49,2022-11-21,52,52,52,0,926,939,938,1,0,0,0,1,148,148,148,148
Lassen,49,2022-11-21,34,34,34,0,539,547,546,1,0,0,0,0,64,64,64,64
Los Angeles,49,2022-11-21,13065,13255,13255,0,195007,197799,197797,2,648,69,77,93,33989,34011,33920,33934
Madera,49,2022-11-21,164,165,165,0,1858,1887,1886,1,11,0,0,1,375,375,375,375
Marin,49,2022-11-21,177,177,177,0,3350,3400,3399,1,8,0,0,0,317,317,317,317
Mariposa,49,2022-11-21,15,15,15,0,170,173,172,1,0,0,0,0,30,30,30,30
Mendocino,49,2022-11-21,36,36,36,0,888,902,901,1,4,0,0,1,136,136,136,136
Merced,49,2022-11-21,261,264,264,0,2917,2960,2959,1,9,1,1,4,878,878,877,877
Modoc,49,2022-11-21,8,8,8,0,13,14,13,1,0,0,0,0,9,9,9,9
Mono,49,2022-11-21,3,3,3,0,107,108,107,1,0,0,0,0,8,8,8,8
Monterey,49,2022-11-21,229,232,232,0,4412,4476,4475,1,17,1,1,0,775,775,774,774
Napa,49,2022-11-21,143,143,143,0,2037,2067,2066,1,4,0,0,1,159,159,159,159
Nevada,49,2022-11-21,90,90,90,0,931,945,944,1,2,0,0,2,132,132,132,132
Orange,49,2022-11-21,2135,2166,2166,0,27844,28242,28241,1,170,12,13,32,7605,7606,7593,7593
Placer,49,2022-11-21,356,363,363,0,4056,4116,4115,1,53,0,0,6,665,665,665,665
Plumas,49,2022-11-21,7,7,7,0,104,105,104,1,1,0,0,0,13,13,13,13
Riverside,49,2022-11-21,2134,2164,2164,0,24294,24643,24642,1,110,6,6,9,6669,6669,6663,6663
Sacramento,49,2022-11-21,1517,1537,1537,0,18948,19219,19218,1,105,3,3,18,3388,3388,3385,3385
San Benito,49,2022-11-21,63,63,63,0,488,496,495,1,2,0,0,0,102,102,102,102
San Bernardino,49,2022-11-21,2316,2350,2350,0,26396,26774,26773,1,89,1,1,19,8096,8096,8095,8095
San Diego,49,2022-11-21,3212,3260,3260,0,43377,43997,43996,1,198,3,3,26,5597,5597,5594,5594
San Francisco,49,2022-11-21,934,948,948,0,15029,15245,15244,1,54,5,5,7,1090,1090,1085,1085
San Joaquin,49,2022-11-21,759,771,771,0,11066,11226,11225,1,36,1,1,5,2351,2351,2350,2350
San Luis Obispo,49,2022-11-21,160,160,160,0,2292,2327,2326,1,4,1,1,0,531,531,530,530
San Mateo,49,2022-11-21,732,742,742,0,12277,12454,12453,1,36,0,0,1,737,737,737,737
Santa Barbara,49,2022-11-21,315,320,320,0,6014,6100,6099,1,15,3,3,3,739,739,736,736
Santa Clara,49,2022-11-21,2157,2187,2187,0,34158,34648,34647,1,119,8,8,23,2561,2561,2553,2553
Santa Cruz,49,2022-11-21,281,286,286,0,9435,9572,9571,1,12,0,0,2,276,276,276,276
Shasta,49,2022-11-21,89,89,89,0,1050,1066,1065,1,14,0,0,1,595,595,595,595
Siskiyou,49,2022-11-21,24,24,24,0,342,350,349,1,1,0,0,0,95,95,95,95
Solano,49,2022-11-21,482,489,489,0,5654,5736,5735,1,32,1,1,5,462,462,461,461
Sonoma,49,2022-11-21,311,316,316,0,5774,5858,5857,1,22,0,0,4,531,531,531,531
Stanislaus,49,2022-11-21,441,448,448,0,5969,6056,6055,1,51,0,0,10,1796,1796,1796,1796
Sutter,49,2022-11-21,90,90,90,0,1138,1156,1155,1,0,0,0,0,232,232,232,232
Tehama,49,2022-11-21,70,70,70,0,673,685,684,1,3,0,0,2,215,215,215,215
Trinity,49,2022-11-21,5,5,5,0,51,52,51,1,0,0,0,0,22,22,22,22
Tulare,49,2022-11-21,427,434,434,0,5498,5578,5577,1,23,0,0,1,1543,1543,1543,1543
Tuolumne,49,2022-11-21,81,81,81,0,762,773,772,1,3,0,0,0,207,207,207,207
Ventura,49,2022-11-21,715,725,725,0,10482,10633,10632,1,43,0,0,2,1600,1600,1600,1600
Yolo,49,2022-11-21,131,131,131,0,2233,2266,2265,1,7,4,4,2,420,420,416,416
Yuba,49,2022-11-21,69,69,69,0,1027,1042,1041,1,10,0,0,1,121,121,121,121
Alameda,50,2022-11-28,2214,2251,2251,0,21921,22288,22287,1,103,5,5,13,2081,2081,2076,2076
Amador,50,2022-11-28,30,30,30,0,755,768,767,1,5,1,1,1,96,96,95,95
Butte,50,2022-11-28,204,207,207,0,1471,1496,1495,1,41,0,0,1,467,467,467,467
Calaveras,50,2022-11-28,31,31,31,0,401,409,408,1,3,0,0,0,135,135,135,135
Colusa,50,2022-11-28,15,15,15,0,184,187,186,1,0,0,0,0,22,22,22,22
Contra Costa,50,2022-11-28,1411,1436,1436,0,14996,15246,15245,1,67,4,4,8,1490,1490,1486,1486
Del Norte,50,2022-11-28,28,28,28,0,426,435,434,1,1,1,1,0,56,56,55,55
El Dorado,50,2022-11-28,184,186,186,0,1548,1575,1574,1,13,0,0,1,234,234,234,234
Fresno,50,2022-11-28,1305,1327,1327,0,11699,11896,11895,1,136,4,4,19,2906,2906,2902,2902
Glenn,50,2022-11-28,17,17,17,0,194,197,196,1,3,0,0,0,53,53,53,53
Humboldt,50,2022-11-28,105,105,105,0,983,1000,999,1,10,0,0,0,162,162,162,162
Imperial,50,2022-11-28,376,384,384,0,2788,2836,2835,1,6,0,0,1,963,963,963,963
Inyo,50,2022-11-28,33,33,33,0,376,383,382,1,2,0,0,0,61,61,61,61
Kern,50,2022-11-28,622,633,633,0,9261,9417,9416,1,60,4,4,6,2444,2444,2440,2440
Kings,50,2022-11-28,243,246,246,0,2544,2588,2587,1,10,0,0,0,464,464,464,464
Lake,50,2022-11-28,47,47,47,0,846,861,860,1,1,0,0,0,148,148,148,148
Lassen,50,2022-11-28,27,27,27,0,493,503,502,1,0,0,0,0,64,64,64,64
Los Angeles,50,2022-11-28,18680,18994,18994,0,175890,178843,178841,2,918,83,97,122,34072,34108,33989,34011
Madera,50,2022-11-28,162,163,163,0,1626,1655,1654,1,13,0,0,2,375,375,375,375
Marin,50,2022-11-28,297,303,303,0,3066,3119,3118,1,19,0,0,1,317,317,317,317
Mariposa,50,2022-11-28,17,17,17,0,136,138,137,1,0,0,0,0,30,30,30,30
Mendocino,50,2022-11-28,47,47,47,0,726,739,738,1,5,0,0,2,136,136,136,136
Merced,50,2022-11-28,349,356,356,0,2529,2572,2571,1,18,3,3,2,881,881,878,878
Modoc,50,2022-11-28,5,5,5,0,9,10,9,1,0,0,0,0,9,9,9,9
Mono,50,2022-11-28,4,4,4,0,94,95,94,1,0,0,0,0,8,8,8,8
Monterey,50,2022-11-28,281,287,287,0,3869,3935,3934,1,26,1,1,0,776,776,775,775
Napa,50,2022-11-28,138,139,139,0,1887,1920,1919,1,6,0,0,3,159,159,159,159
Nevada,50,2022-11-28,116,117,117,0,1006,1023,1022,1,9,0,0,0,132,132,132,132
Orange,50,2022-11-28,3051,3101,3101,0,25797,26229,26228,1,221,13,14,34,7618,7620,7605,7606
Placer,50,2022-11-28,388,396,396,0,3775,3839,3838,1,69,1,1,5,666,666,665,665
Plumas,50,2022-11-28,6,6,6,0,143,146,145,1,0,0,0,0,13,13,13,13
Riverside,50,2022-11-28,3176,3230,3230,0,23017,23401,23400,1,188,11,12,22,6680,6681,6669,6669
Sacramento,50,2022-11-28,1788,1819,1819,0,17964,18263,18262,1,126,7,7,14,3395,3395,3388,3388
San Benito,50,2022-11-28,128,129,129,0,513,522,521,1,1,0,0,0,102,102,102,102
San Bernardino,50,2022-11-28,3274,3329,3329,0,25618,26046,26045,1,146,1,1,20,8097,8097,8096,8096
San Diego,50,2022-11-28,4096,4165,4165,0,31272,31797,31796,1,259,7,7,27,5604,5604,5597,5597
San Francisco,50,2022-11-28,1159,1179,1179,0,12712,12924,12923,1,67,6,6,8,1096,1096,1090,1090
San Joaquin,50,2022-11-28,984,1001,1001,0,10923,11108,11107,1,50,3,3,11,2354,2354,2351,2351
San Luis Obispo,50,2022-11-28,173,174,174,0,2240,2278,2277,1,9,3,3,1,534,534,531,531
San Mateo,50,2022-11-28,1080,1099,1099,0,10951,11136,11135,1,42,1,1,3,738,738,737,737
Santa Barbara,50,2022-11-28,464,473,473,0,5194,5282,5281,1,27,2,2,5,741,741,739,739
Santa Clara,50,2022-11-28,2898,2947,2947,0,27894,28363,28362,1,159,5,5,22,2566,2566,2561,2561
Santa Cruz,50,2022-11-28,367,374,374,0,6653,6768,6767,1,20,0,0,2,276,276,276,276
Shasta,50,2022-11-28,92,92,92,0,1006,1025,1024,1,16,1,1,3,596,596,595,595
Siskiyou,50,2022-11-28,27,27,27,0,277,283,282,1,2,0,0,0,95,95,95,95
Solano,50,2022-11-28,582,591,591,0,5172,5260,5259,1,34,2,2,7,464,464,462,462
Sonoma,50,2022-11-28,451,458,458,0,5000,5084,5083,1,48,2,2,3,533,533,531,531
Stanislaus,50,2022-11-28,506,514,514,0,5358,5448,5447,1,77,0,0,4,1796,1796,1796,1796
Sutter,50,2022-11-28,82,82,82,0,1119,1138,1137,1,0,0,0,0,232,232,232,232
Tehama,50,2022-11-28,70,70,70,0,580,592,591,1,6,0,0,3,215,215,215,215
Trinity,50,2022-11-28,3,3,3,0,59,60,59,1,0,0,0,0,22,22,22,22
Tulare,50,2022-11-28,510,519,519,0,4925,5009,5008,1,34,0,0,0,1543,1543,1543,1543
Tuolumne,50,2022-11-28,72,72,72,0,674,686,685,1,4,0,0,0,207,207,207,207
Ventura,50,2022-11-28,953,968,968,0,10300,10474,10473,1,58,2,2,2,1602,1602,1600,1600
Yolo,50,2022-11-28,169,170,170,0,2024,2060,2059,1,3,4,4,1,424,424,420,420
Yuba,50,2022-11-28,92,92,92,0,920,937,936,1,12,0,0,0,121,121,121,121
Alameda,51,2022-12-05,2742,2796,2796,0,28701,29270,29269,1,126,7,8,13,2088,2089,2081,2081
Amador,51,2022-12-05,40,40,40,0,811,829,828,1,3,0,0,2,96,96,96,96
Butte,51,2022-12-05,237,242,242,0,1869,1908,1907,1,38,7,8,5,474,475,467,467
Calaveras,51,2022-12-05,46,46,46,0,483,493,492,1,0,1,1,0,136,136,135,135
Colusa,51,2022-12-05,12,12,12,0,206,210,209,1,4,0,0,0,22,22,22,22
Contra Costa,51,2022-12-05,1714,1749,1749,0,18612,18981,18980,1,78,0,0,11,1490,1490,1490,1490
Del Norte,51,2022-12-05,31,31,31,0,490,501,500,1,2,0,0,0,56,56,56,56
El Dorado,51,2022-12-05,177,181,181,0,1575,1609,1608,1,14,0,0,0,234,234,234,234
Fresno,51,2022-12-05,1516,1547,1547,0,14275,14558,14557,1,177,4,5,17,2910,2911,2906,2906
Glenn,51,2022-12-05,24,24,24,0,232,237,236,1,2,0,0,0,53,53,53,53
Humboldt,51,2022-12-05,116,117,117,0,988,1008,1007,1,17,1,1,2,163,163,162,162
Imperial,51,2022-12-05,583,595,595,0,3395,3462,3461,1,18,1,1,5,964,964,963,963
Inyo,51,2022-12-05,22,22,22,0,332,339,338,1,1,1,1,0,62,62,61,61
Kern,51,2022-12-05,797,813,813,0,10491,10699,10698,1,55,1,1,10,2445,2445,2444,2444
Kings,51,2022-12-05,294,299,299,0,3022,3083,3082,1,8,0,0,0,464,464,464,464
Lake,51,2022-12-05,61,61,61,0,827,845,844,1,2,0,0,0,148,148,148,148
Lassen,51,2022-12-05,14,14,14,0,444,454,453,1,0,0,0,0,64,64,64,64
Los Angeles,51,2022-12-05,22202,22641,22641,0,230804,235369,235366,3,1119,101,127,151,34173,34235,34072,34108
Madera,51,2022-12-05,205,210,210,0,1978,2017,2016,1,12,0,0,3,375,375,375,375
Marin,51,2022-12-05,311,318,318,0,3479,3550,3549,1,14,0,0,2,317,317,317,317
Mariposa,51,2022-12-05,15,15,15,0,172,178,177,1,0,0,0,0,30,30,30,30
Mendocino,51,2022-12-05,44,44,44,0,793,810,809,1,6,1,1,2,137,137,136,136
Merced,51,2022-12-05,338,345,345,0,3130,3192,3191,1,23,1,1,2,882,882,881,881
Modoc,51,2022-12-05,12,12,12,0,12,13,12,1,0,0,0,0,9,9,9,9
Mono,51,2022-12-05,9,9,9,0,91,92,91,1,0,0,0,0,8,8,8,8
Monterey,51,2022-12-05,262,268,268,0,4343,4430,4429,1,34,1,1,0,777,777,776,776
Napa,51,2022-12-05,158,161,161,0,2333,2380,2379,1,7,0,0,0,159,159,159,159
Nevada,51,2022-12-05,112,113,113,0,1091,1114,1113,1,8,0,0,2,132,132,132,132
Orange,51,2022-12-05,4156,4238,4238,0,33029,33681,33680,1,301,17,21,48,7635,7641,7618,7620
Placer,51,2022-12-05,390,398,398,0,4031,4113,4112,1,72,1,1,4,667,667,666,666
Plumas,51,2022-12-05,22,22,22,0,184,188,187,1,1,0,0,0,13,13,13,13
Riverside,51,2022-12-05,3937,4015,4015,0,26827,27358,27357,1,186,10,12,25,6690,6693,6680,6681
Sacramento,51,2022-12-05,2119,2162,2162,0,21061,21478,21477,1,128,7,8,28,3402,3403,3395,3395
San Benito,51,2022-12-05,217,221,221,0,717,732,731,1,6,1,1,3,103,103,102,102
San Bernardino,51,2022-12-05,3979,4059,4059,0,27976,28531,28530,1,167,0,0,34,8097,8097,8097,8097
San Diego,51,2022-12-05,5712,5824,5824,0,43447,44305,44304,1,302,11,13,30,5615,5617,5604,5604
San Francisco,51,2022-12-05,1480,1510,1510,0,15917,16233,16232,1,77,7,8,7,1103,1104,1096,1096
San Joaquin,51,2022-12-05,1100,1121,1121,0,12372,12617,12616,1,70,7,8,16,2361,2362,2354,2354
San Luis Obispo,51,2022-12-05,199,203,203,0,2651,2704,2703,1,15,3,3,1,537,537,534,534
San Mateo,51,2022-12-05,1224,1248,1248,0,13339,13604,13603,1,56,0,0,1,738,738,738,738
Santa Barbara,51,2022-12-05,518,528,528,0,6736,6871,6870,1,38,1,1,9,742,742,741,741
Santa Clara,51,2022-12-05,3445,3513,3513,0,34675,35362,35361,1,207,9,10,26,2575,2576,2566,2566
Santa Cruz,51,2022-12-05,466,475,475,0,11780,12017,12016,1,22,0,0,3,276,276,276,276
Shasta,51,2022-12-05,132,133,133,0,1100,1123,1122,1,23,0,0,5,596,596,596,596
Siskiyou,51,2022-12-05,22,22,22,0,306,314,313,1,2,0,0,0,95,95,95,95
Solano,51,2022-12-05,622,635,635,0,6484,6613,6612,1,33,1,1,7,465,465,464,464
Sonoma,51,2022-12-05,505,514,514,0,5875,5992,5991,1,35,4,5,1,537,538,533,533
Stanislaus,51,2022-12-05,633,646,646,0,6712,6846,6845,1,76,0,0,7,1796,1796,1796,1796
Sutter,51,2022-12-05,95,95,95,0,1169,1192,1191,1,0,0,0,0,232,232,232,232
Tehama,51,2022-12-05,92,92,92,0,706,721,720,1,9,2,2,0,217,217,215,215
Trinity,51,2022-12-05,3,3,3,0,38,39,38,1,0,0,0,0,22,22,22,22
Tulare,51,2022-12-05,522,532,532,0,5939,6058,6057,1,35,0,0,1,1543,1543,1543,1543
Tuolumne,51,2022-12-05,103,103,103,0,850,867,866,1,2,0,0,0,207,207,207,207
Ventura,51,2022-12-05,1079,1101,1101,0,11818,12052,12051,1,71,2,2,6,1604,1604,1602,1602
Yolo,51,2022-12-05,213,219,219,0,2593,2646,2645,1,2,1,1,3,425,425,424,424
Yuba,51,2022-12-05,82,82,82,0,1020,1042,1041,1,11,0,0,1,121,121,121,121
Alameda,52,2022-12-12,2586,2650,2650,0,28641,29364,29363,1,147,2,2,20,2090,2091,2088,2089
Amador,52,2022-12-12,32,32,32,0,784,804,803,1,3,0,0,0,96,96,96,96
Butte,52,2022-12-12,180,185,185,0,1810,1855,1854,1,39,2,2,2,476,477,474,475
Calaveras,52,2022-12-12,39,39,39,0,451,464,463,1,1,0,0,0,136,136,136,136
Colusa,52,2022-12-12,13,13,13,0,272,280,279,1,1,0,0,0,22,22,22,22
Contra Costa,52,2022-12-12,1668,1712,1712,0,17613,18058,18057,1,78,6,9,4,1496,1499,1490,1490
Del Norte,52,2022-12-12,27,27,27,0,469,481,480,1,3,0,0,0,56,56,56,56
El Dorado,52,2022-12-12,143,147,147,0,1404,1441,1440,1,8,0,0,3,234,234,234,234
Fresno,52,2022-12-12,1451,1487,1487,0,13717,14062,14061,1,186,8,12,18,2918,2923,2910,2911
Glenn,52,2022-12-12,16,16,16,0,227,234,233,1,6,0,0,0,53,53,53,53
Humboldt,52,2022-12-12,96,96,96,0,911,936,935,1,13,1,1,2,164,164,163,163
Imperial,52,2022-12-12,444,456,456,0,2923,2997,2996,1,27,0,0,3,964,964,964,964
Inyo,52,2022-12-12,22,22,22,0,303,310,309,1,1,0,0,0,62,62,62,62
Kern,52,2022-12-12,937,960,960,0,10690,10959,10958,1,55,0,0,4,2445,2445,2445,2445
Kings,52,2022-12-12,256,262,262,0,2825,2897,2896,1,8,1,1,0,465,465,464,464
Lake,52,2022-12-12,53,53,53,0,759,779,778,1,3,0,0,1,148,148,148,148
Lassen,52,2022-12-12,15,15,15,0,423,435,434,1,0,0,0,0,64,64,64,64
Los Angeles,52,2022-12-12,17279,17716,17716,0,212187,217533,217531,2,1113,129,186,154,34302,34421,34173,34235
Madera,52,2022-12-12,209,215,215,0,2161,2215,2214,1,15,0,0,2,375,375,375,375
Marin,52,2022-12-12,305,313,313,0,3575,3667,3666,1,24,0,0,2,317,317,317,317
Mariposa,52,2022-12-12,12,12,12,0,121,124,123,1,0,0,0,0,30,30,30,30
Mendocino,52,2022-12-12,51,51,51,0,654,671,670,1,7,0,0,0,137,137,137,137
Merced,52,2022-12-12,275,283,283,0,3157,3238,3237,1,14,0,0,2,882,882,882,882
Modoc,52,2022-12-12,5,5,5,0,10,11,10,1,0,0,0,0,9,9,9,9
Mono,52,2022-12-12,9,9,9,0,121,124,123,1,0,0,0,0,8,8,8,8
Monterey,52,2022-12-12,260,268,268,0,4221,4330,4329,1,25,1,1,2,778,778,777,777
Napa,52,2022-12-12,161,164,164,0,2168,2223,2222,1,9,1,2,0,160,161,159,159
Nevada,52,2022-12-12,91,91,91,0,922,946,945,1,5,0,0,2,132,132,132,132
Orange,52,2022-12-12,3376,3460,3460,0,30114,30873,30872,1,300,27,38,48,7662,7679,7635,7641
Placer,52,2022-12-12,327,335,335,0,3858,3958,3957,1,73,4,6,6,671,673,667,667
Plumas,52,2022-12-12,7,7,7,0,186,192,191,1,2,0,0,0,13,13,13,13
Riverside,52,2022-12-12,3296,3379,3379,0,24128,24736,24735,1,204,11,15,25,6701,6708,6690,6693
Sacramento,52,2022-12-12,1800,1846,1846,0,19875,20376,20375,1,173,6,8,31,3408,3411,3402,3403
San Benito,52,2022-12-12,123,125,125,0,543,557,556,1,2,2,2,2,105,105,103,103
San Bernardino,52,2022-12-12,3508,3595,3595,0,26395,27059,27058,1,226,3,5,36,8100,8102,8097,8097
San Diego,52,2022-12-12,4688,4806,4806,0,39708,40707,40706,1,331,14,21,45,5629,5638,5615,5617
San Francisco,52,2022-12-12,1412,1448,1448,0,16568,16986,16985,1,103,4,6,12,1107,1110,1103,1104
San Joaquin,52,2022-12-12,990,1014,1014,0,12268,12579,12578,1,68,5,6,19,2366,2368,2361,2362
San Luis Obispo,52,2022-12-12,217,223,223,0,2600,2667,2666,1,10,1,1,0,538,538,537,537
San Mateo,52,2022-12-12,1143,1172,1172,0,12201,12508,12507,1,59,0,0,3,738,738,738,738
Santa Barbara,52,2022-12-12,502,515,515,0,5695,5839,5838,1,36,2,2,6,744,744,742,742
Santa Clara,52,2022-12-12,3213,3294,3294,0,33758,34609,34608,1,198,7,9,30,2582,2585,2575,2576
Santa Cruz,52,2022-12-12,571,586,586,0,12389,12706,12705,1,29,0,0,1,276,276,276,276
Shasta,52,2022-12-12,94,94,94,0,1121,1150,1149,1,22,0,0,5,596,596,596,596
Siskiyou,52,2022-12-12,15,15,15,0,237,244,243,1,2,0,0,0,95,95,95,95
Solano,52,2022-12-12,625,642,642,0,6111,6265,6264,1,42,1,2,7,466,467,465,465
Sonoma,52,2022-12-12,560,574,574,0,5561,5702,5701,1,41,0,0,7,537,538,537,538
Stanislaus,52,2022-12-12,578,591,591,0,6287,6446,6445,1,104,0,0,12,1796,1796,1796,1796
Sutter,52,2022-12-12,110,112,112,0,1146,1175,1174,1,0,0,0,0,232,232,232,232
Tehama,52,2022-12-12,75,75,75,0,534,549,548,1,6,1,1,0,218,218,217,217
Trinity,52,2022-12-12,3,3,3,0,45,46,45,1,0,0,0,0,22,22,22,22
Tulare,52,2022-12-12,434,444,444,0,5843,5991,5990,1,27,0,0,2,1543,1543,1543,1543
Tuolumne,52,2022-12-12,125,127,127,0,932,955,954,1,5,0,0,0,207,207,207,207
Ventura,52,2022-12-12,898,921,921,0,10268,10529,10528,1,72,2,2,7,1606,1606,1604,1604
Yolo,52,2022-12-12,207,213,213,0,2290,2348,2347,1,5,2,3,2,427,428,425,425
Yuba,52,2022-12-12,75,76,76,0,930,954,953,1,13,0,0,0,121,121,121,121
Alameda,53,2022-12-19,2240,2318,2318,0,26028,26943,26942,1,144,4,8,19,2094,2099,2090,2091
Amador,53,2022-12-19,40,40,40,0,804,834,833,1,6,0,0,0,96,96,96,96
Butte,53,2022-12-19,126,131,131,0,1499,1553,1552,1,34,2,5,2,478,482,476,477
Calaveras,53,2022-12-19,25,25,25,0,436,453,452,1,1,0,0,0,136,136,136,136
Colusa,53,2022-12-19,12,12,12,0,212,220,219,1,1,0,0,0,22,22,22,22
Contra Costa,53,2022-12-19,1618,1677,1677,0,16463,17042,17041,1,95,1,2,7,1497,1501,1496,1499
Del Norte,53,2022-12-19,29,29,29,0,490,510,509,1,3,0,0,0,56,56,56,56
El Dorado,53,2022-12-19,158,165,165,0,1625,1682,1681,1,9,1,2,2,235,236,234,234
Fresno,53,2022-12-19,1140,1180,1180,0,12740,13189,13188,1,212,2,5,22,2920,2928,2918,2923
Glenn,53,2022-12-19,20,20,20,0,203,212,211,1,6,0,0,0,53,53,53,53
Humboldt,53,2022-12-19,92,94,94,0,876,909,908,1,9,0,0,1,164,164,164,164
Imperial,53,2022-12-19,249,258,258,0,2515,2604,2603,1,16,0,0,0,964,964,964,964
Inyo,53,2022-12-19,11,11,11,0,323,336,335,1,1,0,0,0,62,62,62,62
Kern,53,2022-12-19,875,906,906,0,10405,10773,10772,1,60,0,0,5,2445,2445,2445,2445
Kings,53,2022-12-19,230,238,238,0,2700,2794,2793,1,6,1,2,1,466,467,465,465
Lake,53,2022-12-19,63,64,64,0,790,819,818,1,4,0,0,0,148,148,148,148
Lassen,53,2022-12-19,7,7,7,0,465,482,481,1,0,0,0,0,64,64,64,64
Los Angeles,53,2022-12-19,14703,15219,15219,0,188616,195205,195203,2,1096,84,162,155,34386,34583,34302,34421
Madera,53,2022-12-19,174,181,181,0,1880,1947,1946,1,10,0,0,1,375,375,375,375
Marin,53,2022-12-19,261,270,270,0,3187,3299,3298,1,17,0,0,0,317,317,317,317
Mariposa,53,2022-12-19,4,4,4,0,133,138,137,1,0,0,0,0,30,30,30,30
Mendocino,53,2022-12-19,61,63,63,0,751,779,778,1,4,0,0,0,137,137,137,137
Merced,53,2022-12-19,223,231,231,0,2676,2771,2770,1,15,0,0,2,882,882,882,882
Modoc,53,2022-12-19,9,9,9,0,21,22,21,1,0,0,0,0,9,9,9,9
Mono,53,2022-12-19,11,11,11,0,120,125,124,1,1,0,0,0,8,8,8,8
Monterey,53,2022-12-19,219,227,227,0,3801,3935,3934,1,13,0,0,1,778,778,778,778
Napa,53,2022-12-19,176,183,183,0,2085,2159,2158,1,8,0,0,0,160,161,160,161
Nevada,53,2022-12-19,66,67,67,0,848,879,878,1,5,0,0,2,132,132,132,132
Orange,53,2022-12-19,3189,3302,3302,0,28875,29890,29889,1,296,17,35,51,7679,7714,7662,7679
Placer,53,2022-12-19,354,367,367,0,3805,3942,3941,1,90,1,2,10,672,675,671,673
Plumas,53,2022-12-19,8,8,8,0,187,194,193,1,0,0,0,0,13,13,13,13
Riverside,53,2022-12-19,3086,3196,3196,0,22226,23009,23008,1,177,12,22,22,6713,6730,6701,6708
Sacramento,53,2022-12-19,1712,1774,1774,0,19362,20048,20047,1,210,7,14,22,3415,3425,3408,3411
San Benito,53,2022-12-19,98,101,101,0,436,451,450,1,0,4,9,1,109,114,105,105
San Bernardino,53,2022-12-19,3117,3227,3227,0,24033,24879,24878,1,200,3,6,38,8103,8108,8100,8102
San Diego,53,2022-12-19,4692,4857,4857,0,38287,39627,39626,1,381,16,32,45,5645,5670,5629,5638
San Francisco,53,2022-12-19,1196,1238,1238,0,15470,16013,16012,1,106,4,8,17,1111,1118,1107,1110
San Joaquin,53,2022-12-19,812,840,840,0,12373,12813,12812,1,58,2,4,19,2368,2372,2366,2368
San Luis Obispo,53,2022-12-19,215,223,223,0,2342,2424,2423,1,17,1,2,0,539,540,538,538
San Mateo,53,2022-12-19,899,931,931,0,11537,11942,11941,1,62,0,0,5,738,738,738,738
Santa Barbara,53,2022-12-19,448,464,464,0,5148,5331,5330,1,35,3,6,5,747,750,744,744
Santa Clara,53,2022-12-19,2750,2847,2847,0,31146,32237,32236,1,205,2,4,30,2584,2589,2582,2585
Santa Cruz,53,2022-12-19,250,260,260,0,10341,10704,10703,1,31,0,0,1,276,276,276,276
Shasta,53,2022-12-19,101,104,104,0,1093,1132,1131,1,24,0,0,4,596,596,596,596
Siskiyou,53,2022-12-19,15,15,15,0,258,267,266,1,2,0,0,0,95,95,95,95
Solano,53,2022-12-19,628,649,649,0,6061,6274,6273,1,41,1,2,6,467,469,466,467
Sonoma,53,2022-12-19,454,470,470,0,5388,5578,5577,1,38,0,0,4,537,538,537,538
Stanislaus,53,2022-12-19,459,476,476,0,5910,6118,6117,1,94,0,0,12,1796,1796,1796,1796
Sutter,53,2022-12-19,76,76,76,0,1052,1089,1088,1,0,0,0,0,232,232,232,232
Tehama,53,2022-12-19,60,60,60,0,519,538,537,1,6,0,0,0,218,218,218,218
Trinity,53,2022-12-19,2,2,2,0,31,32,31,1,0,0,0,0,22,22,22,22
Tulare,53,2022-12-19,449,466,466,0,5228,5414,5413,1,53,0,0,1,1543,1543,1543,1543
Tuolumne,53,2022-12-19,80,82,82,0,838,868,867,1,2,1,2,1,208,209,207,207
Ventura,53,2022-12-19,897,929,929,0,9500,9835,9834,1,81,0,0,9,1606,1606,1606,1606
Yolo,53,2022-12-19,164,171,171,0,1903,1973,1972,1,5,0,0,0,427,428,427,428
Yuba,53,2022-12-19,81,82,82,0,851,882,881,1,7,0,0,0,121,121,121,121
Alameda,54,2022-12-26,1867,1986,1986,0,19984,21216,21215,1,150,2,12,17,2096,2111,2094,2099
Amador,54,2022-12-26,41,43,43,0,758,806,805,1,5,0,0,0,96,96,96,96
Butte,54,2022-12-26,87,93,93,0,1293,1374,1373,1,33,0,0,1,478,482,478,482
Calaveras,54,2022-12-26,18,18,18,0,364,388,387,1,0,1,3,0,137,139,136,136
Colusa,54,2022-12-26,14,14,14,0,150,160,159,1,0,0,0,0,22,22,22,22
Contra Costa,54,2022-12-26,1354,1441,1441,0,13231,14049,14048,1,89,0,0,11,1497,1501,1497,1501
Del Norte,54,2022-12-26,28,28,28,0,395,422,421,1,3,0,0,0,56,56,56,56
El Dorado,54,2022-12-26,134,141,141,0,1314,1400,1399,1,7,0,0,0,235,236,235,236
Fresno,54,2022-12-26,1030,1096,1096,0,10475,11131,11130,1,186,1,3,33,2921,2931,2920,2928
Glenn,54,2022-12-26,11,11,11,0,193,208,207,1,0,0,0,0,53,53,53,53
Humboldt,54,2022-12-26,60,65,65,0,587,624,623,1,5,0,0,2,164,164,164,164
Imperial,54,2022-12-26,215,228,228,0,2107,2234,2233,1,67,0,0,0,964,964,964,964
Inyo,54,2022-12-26,13,13,13,0,157,168,167,1,1,0,0,0,62,62,62,62
Kern,54,2022-12-26,590,626,626,0,8631,9169,9168,1,51,0,0,8,2445,2445,2445,2445
Kings,54,2022-12-26,197,209,209,0,2249,2385,2384,1,5,0,0,2,466,467,466,467
Lake,54,2022-12-26,48,51,51,0,600,639,638,1,3,0,0,1,148,148,148,148
Lassen,54,2022-12-26,27,27,27,0,484,515,514,1,0,0,0,0,64,64,64,64
Los Angeles,54,2022-12-26,12338,13128,13128,0,123404,131027,131026,1,1032,79,355,164,34465,34938,34386,34583
Madera,54,2022-12-26,158,169,169,0,1558,1657,1656,1,6,0,0,1,375,375,375,375
Marin,54,2022-12-26,197,210,210,0,2538,2695,2694,1,29,0,0,2,317,317,317,317
Mariposa,54,2022-12-26,9,9,9,0,104,111,110,1,0,0,0,0,30,30,30,30
Mendocino,54,2022-12-26,69,74,74,0,644,685,684,1,10,0,0,0,137,137,137,137
Merced,54,2022-12-26,189,202,202,0,1917,2039,2038,1,17,0,0,3,882,882,882,882
Modoc,54,2022-12-26,4,4,4,0,11,12,11,1,0,0,0,0,9,9,9,9
Mono,54,2022-12-26,9,9,9,0,82,90,89,1,0,0,0,0,8,8,8,8
Monterey,54,2022-12-26,153,163,163,0,2934,3124,3123,1,21,0,0,0,778,778,778,778
Napa,54,2022-12-26,138,146,146,0,1716,1821,1820,1,12,0,0,0,160,161,160,161
Nevada,54,2022-12-26,55,58,58,0,747,797,796,1,9,0,0,1,132,132,132,132
Orange,54,2022-12-26,3104,3304,3304,0,23619,25094,25093,1,274,4,15,31,7683,7729,7679,7714
Placer,54,2022-12-26,280,298,298,0,3033,3225,3224,1,87,0,0,12,672,675,672,675
Plumas,54,2022-12-26,9,9,9,0,123,132,131,1,0,0,0,0,13,13,13,13
Riverside,54,2022-12-26,2759,2937,2937,0,17900,19023,19022,1,194,1,3,18,6714,6733,6713,6730
Sacramento,54,2022-12-26,1344,1428,1428,0,14436,15339,15338,1,179,0,0,25,3415,3425,3415,3425
San Benito,54,2022-12-26,101,107,107,0,339,361,360,1,1,0,0,1,109,114,109,114
San Bernardino,54,2022-12-26,2778,2956,2956,0,19286,20496,20495,1,210,1,7,26,8104,8115,8103,8108
San Diego,54,2022-12-26,4358,4632,4632,0,27591,29289,29288,1,395,16,77,45,5661,5747,5645,5670
San Francisco,54,2022-12-26,990,1053,1053,0,11703,12429,12428,1,90,2,11,15,1113,1129,1111,1118
San Joaquin,54,2022-12-26,724,770,770,0,10035,10670,10669,1,60,0,0,10,2368,2372,2368,2372
San Luis Obispo,54,2022-12-26,185,196,196,0,1947,2070,2069,1,20,0,0,0,539,540,539,540
San Mateo,54,2022-12-26,795,844,844,0,8683,9216,9215,1,55,0,0,6,738,738,738,738
Santa Barbara,54,2022-12-26,476,506,506,0,4073,4333,4332,1,40,0,0,4,747,750,747,750
Santa Clara,54,2022-12-26,2215,2355,2355,0,23214,24642,24641,1,179,0,0,35,2584,2589,2584,2589
Santa Cruz,54,2022-12-26,203,217,217,0,4544,4806,4805,1,25,0,0,2,276,276,276,276
Shasta,54,2022-12-26,89,94,94,0,897,954,953,1,18,0,0,1,596,596,596,596
Siskiyou,54,2022-12-26,16,16,16,0,264,284,283,1,1,0,0,0,95,95,95,95
Solano,54,2022-12-26,644,684,684,0,5227,5553,5552,1,59,1,7,7,468,476,467,469
Sonoma,54,2022-12-26,432,460,460,0,4236,4505,4504,1,39,0,0,4,537,538,537,538
Stanislaus,54,2022-12-26,436,465,465,0,4874,5180,5179,1,96,0,0,5,1796,1796,1796,1796
Sutter,54,2022-12-26,121,128,128,0,924,982,981,1,0,0,0,0,232,232,232,232
Tehama,54,2022-12-26,39,40,40,0,519,552,551,1,2,1,4,0,219,222,218,218
Trinity,54,2022-12-26,3,3,3,0,39,41,40,1,0,0,0,0,22,22,22,22
Tulare,54,2022-12-26,410,437,437,0,3858,4106,4105,1,41,0,0,3,1543,1543,1543,1543
Tuolumne,54,2022-12-26,86,93,93,0,755,803,802,1,6,0,0,2,208,209,208,209
Ventura,54,2022-12-26,831,884,884,0,7650,8132,8131,1,71,0,0,11,1606,1606,1606,1606
Yolo,54,2022-12-26,131,139,139,0,1597,1698,1697,1,9,0,0,1,427,428,427,428
Yuba,54,2022-12-26,97,105,105,0,752,800,799,1,14,0,0,0,121,121,121,121
Alameda,55,2023-01-02,1535,3533,3533,0,17626,39594,39593,1,175,2,23,19,2098,2134,2096,2111
Amador,55,2023-01-02,16,35,35,0,545,1163,1162,1,3,0,0,0,96,96,96,96
Butte,55,2023-01-02,74,181,181,0,1212,2784,2783,1,35,0,0,2,478,482,478,482
Calaveras,55,2023-01-02,31,57,57,0,329,642,641,1,0,0,0,0,137,139,137,139
Colusa,55,2023-01-02,3,17,17,0,80,139,138,1,0,0,0,0,22,22,22,22
Contra Costa,55,2023-01-02,1094,2756,2756,0,12649,28577,28576,1,89,0,0,13,1497,1501,1497,1501
Del Norte,55,2023-01-02,31,60,60,0,341,700,699,1,3,0,0,2,56,56,56,56
El Dorado,55,2023-01-02,115,249,249,0,1217,2466,2465,1,7,0,0,2,235,236,235,236
Fresno,55,2023-01-02,855,1630,1630,0,9527,18903,18902,1,195,0,0,28,2921,2931,2921,2931
Glenn,55,2023-01-02,10,25,25,0,106,217,216,1,0,0,0,0,53,53,53,53
Humboldt,55,2023-01-02,35,103,103,0,535,1375,1374,1,2,0,0,2,164,164,164,164
Imperial,55,2023-01-02,160,311,311,0,1864,4117,4116,1,11,0,0,1,964,964,964,964
Inyo,55,2023-01-02,16,56,56,0,222,691,690,1,1,0,0,0,62,62,62,62
Kern,55,2023-01-02,664,1076,1076,0,7915,12721,12720,1,66,0,0,8,2445,2445,2445,2445
Kings,55,2023-01-02,177,496,496,0,1861,3808,3807,1,4,0,0,1,466,467,466,467
Lake,55,2023-01-02,45,202,202,0,557,1598,1597,1,3,0,0,0,148,148,148,148
Lassen,55,2023-01-02,9,11,11,0,399,636,635,1,0,0,0,0,64,64,64,64
Los Angeles,55,2023-01-02,8699,12345,12345,0,41860,53004,53003,1,1091,23,256,154,34488,35194,34465,34938
Madera,55,2023-01-02,121,178,178,0,1414,2426,2425,1,7,0,0,0,375,375,375,375
Marin,55,2023-01-02,176,442,442,0,2126,4631,4630,1,24,0,0,2,317,317,317,317
Mariposa,55,2023-01-02,8,27,27,0,91,208,207,1,0,0,0,0,30,30,30,30
Mendocino,55,2023-01-02,58,206,206,0,646,1503,1502,1,6,0,0,3,137,137,137,137
Merced,55,2023-01-02,127,199,199,0,1657,3266,3265,1,8,0,0,4,882,882,882,882
Modoc,55,2023-01-02,9,10,10,0,12,16,15,1,0,0,0,0,9,9,9,9
Mono,55,2023-01-02,10,24,24,0,65,279,278,1,0,0,0,0,8,8,8,8
Monterey,55,2023-01-02,158,441,441,0,2615,6223,6222,1,27,0,0,0,778,778,778,778
Napa,55,2023-01-02,112,314,314,0,1595,3808,3807,1,8,1,9,1,161,170,160,161
Nevada,55,2023-01-02,38,54,54,0,561,999,998,1,8,0,0,2,132,132,132,132
Orange,55,2023-01-02,2782,5869,5869,0,21132,45144,45143,1,312,0,0,28,7683,7729,7683,7729
Placer,55,2023-01-02,262,617,617,0,2905,6865,6864,1,108,0,0,8,672,675,672,675
Plumas,55,2023-01-02,10,25,25,0,134,287,286,1,1,0,0,0,13,13,13,13
Riverside,55,2023-01-02,2163,3867,3867,0,15299,27292,27291,1,223,0,0,31,6714,6733,6714,6733
Sacramento,55,2023-01-02,1270,2579,2579,0,13360,27031,27030,1,201,0,0,26,3415,3425,3415,3425
San Benito,55,2023-01-02,49,97,97,0,329,963,962,1,1,0,0,1,109,114,109,114
San Bernardino,55,2023-01-02,2137,3497,3497,0,16628,29074,29073,1,183,0,0,31,8104,8115,8104,8115
San Diego,55,2023-01-02,3896,7077,7077,0,24082,50186,50185,1,401,1,11,43,5662,5758,5661,5747
San Francisco,55,2023-01-02,718,1707,1707,0,8885,20356,20354,2,77,1,11,15,1114,1140,1113,1129
San Joaquin,55,2023-01-02,605,1223,1223,0,8843,17149,17148,1,62,0,0,12,2368,2372,2368,2372
San Luis Obispo,55,2023-01-02,160,333,333,0,1742,3220,3219,1,17,0,0,0,539,540,539,540
San Mateo,55,2023-01-02,577,1210,1210,0,6872,13546,13545,1,50,0,0,9,738,738,738,738
Santa Barbara,55,2023-01-02,333,934,934,0,3471,9107,9106,1,47,0,0,5,747,750,747,750
Santa Clara,55,2023-01-02,1925,4655,4655,0,18751,42892,42891,1,200,0,0,32,2584,2589,2584,2589
Santa Cruz,55,2023-01-02,121,163,163,0,2343,3676,3675,1,27,0,0,0,276,276,276,276
Shasta,55,2023-01-02,69,115,115,0,692,1105,1104,1,20,0,0,1,596,596,596,596
Siskiyou,55,2023-01-02,15,50,50,0,244,650,649,1,1,0,0,0,95,95,95,95
Solano,55,2023-01-02,587,1419,1419,0,4890,12516,12515,1,60,2,18,11,470,494,468,476
Sonoma,55,2023-01-02,362,906,906,0,3872,9657,9656,1,56,0,0,2,537,538,537,538
Stanislaus,55,2023-01-02,406,929,929,0,4538,10436,10435,1,88,0,0,8,1796,1796,1796,1796
Sutter,55,2023-01-02,83,167,167,0,840,2088,2087,1,0,0,0,0,232,232,232,232
Tehama,55,2023-01-02,35,46,46,0,376,593,592,1,2,1,9,0,220,231,219,222
Trinity,55,2023-01-02,2,2,2,0,35,77,76,1,0,0,0,0,22,22,22,22
Tulare,55,2023-01-02,352,736,736,0,3644,6962,6961,1,52,0,0,6,1543,1543,1543,1543
Tuolumne,55,2023-01-02,50,86,86,0,604,1347,1346,1,5,0,0,0,208,209,208,209
Ventura,55,2023-01-02,726,1639,1639,0,6288,14475,14474,1,87,1,11,13,1607,1617,1606,1606
Yolo,55,2023-01-02,104,229,229,0,1279,2895,2894,1,4,0,0,1,427,428,427,428
Yuba,55,2023-01-02,68,192,192,0,676,1697,1696,1,19,0,0,1,121,121,121,121
California,1,2021-12-20,84259,84265,47174,37091,2163844,2164147,1234611,929536,2585,502,502,932,77343,77343,76841,76841
California,2,2021-12-27,241825,241857,151877,89980,1954649,1955019,1192844,762175,3348,496,496,1030,77839,77839,77343,77343
California,3,2022-01-03,549224,549341,369168,180173,2955788,2956510,1966121,990389,6125,586,586,1280,78425,78425,77839,77839
California,4,2022-01-10,865657,865913,619114,246799,4666585,4668038,3354559,1313479,10002,945,945,1813,79370,79370,78425,78425
California,5,2022-01-17,660369,660626,492418,168208,3984834,3986484,3023712,962772,12343,1427,1427,2311,80797,80797,79370,79370
California,6,2022-01-24,526923,527176,412460,114716,3990535,3992592,3195908,796684,12648,1774,1774,2600,82571,82571,80797,80797
California,7,2022-01-31,270226,270354,219738,50616,3156064,3157937,2638323,519614,10873,1905,1905,2494,84476,84476,82571,82571
California,8,2022-02-07,149352,149428,125901,23527,2671246,2673075,2320393,352682,8405,1777,1777,2007,86253,86253,84476,84476
California,9,2022-02-14,85943,85981,74964,11017,2323190,2324940,2081429,243511,6407,1426,1426,1564,87679,87679,86253,86253
California,10,2022-02-21,48119,48135,43108,5027,1850498,1852030,1693098,158932,4557,1001,1001,1098,88680,88680,87679,87679
California,11,2022-02-28,32700,32709,29998,2711,2098599,2100578,1963475,137103,3357,692,692,772,89372,89372,88680,88680
California,12,2022-03-07,23005,23011,21502,1509,1817939,1819821,1725203,94618,2435,500,500,581,89872,89872,89372,89372
California,13,2022-03-14,16978,16983,16104,879,1724782,1726676,1656258,70418,1844,358,358,419,90230,90230,89872,89872
California,14,2022-03-21,14637,14642,14059,583,1645723,1647638,1594878,52760,1537,251,251,313,90481,90481,90230,90230
California,15,2022-03-28,15458,15465,14988,477,1462562,1464333,1426692,37641,1150,177,177,264,90658,90658,90481,90481
California,16,2022-04-04,17696,17704,17287,417,1523897,1525793,1496242,29551,943,140,140,211,90798,90798,90658,90658
California,17,2022-04-11,21504,21512,21119,393,1342230,1343959,1323099,20860,905,124,124,148,90922,90922,90798,90798
California,18,2022-04-18,26843,26858,26467,391,1131337,1132834,1117920,14914,823,111,111,141,91033,91033,90922,90922
California,19,2022-04-25,37224,37253,36825,428,1622364,1624589,1609713,14876,838,91,91,112,91124,91124,91033,91033
California,20,2022-05-02,48934,48987,48553,434,1701255,1703715,1691467,12248,950,85,85,143,91209,91209,91124,91124
California,21,2022-05-09,63366,63447,63001,446,1770062,1772739,1762690,10049,1050,85,85,153,91294,91294,91209,91209
California,22,2022-05-16,80308,80421,79971,450,1839902,1842760,1834499,8261,1345,119,119,182,91413,91413,91294,91294
California,23,2022-05-23,97818,97952,97532,420,1870161,1873172,1866568,6604,1714,117,117,217,91530,91530,91413,91413
California,24,2022-05-30,90370,90495,90186,309,1498623,1501080,1496824,4256,1918,147,147,272,91677,91677,91530,91530
California,25,2022-06-06,120528,120708,120390,318,1938663,1941951,1937851,4100,2305,138,138,276,91815,91815,91677,91677
California,26,2022-06-13,105216,105377,105160,217,1405968,1408403,1405918,2485,2471,177,177,291,91992,91992,91815,91815
California,27,2022-06-20,101341,101493,101331,162,1025904,1027738,1026149,1589,2552,211,211,310,92203,92203,91992,91992
California,28,2022-06-27,115402,115598,115460,138,1042810,1044765,1043514,1251,3006,217,217,339,92420,92420,92203,92203
California,29,2022-07-04,108208,108398,108296,102,835408,837044,836239,805,3167,272,272,393,92692,92692,92420,92420
California,30,2022-07-11,141206,141471,141372,99,1082403,1084647,1083855,792,3824,292,292,453,92984,92984,92692,92692
California,31,2022-07-18,129611,129867,129795,72,992607,994761,994196,565,4148,294,294,528,93278,93278,92984,92984
California,32,2022-07-25,117472,117716,117668,48,947657,949821,949397,424,4310,354,354,516,93632,93632,93278,93278
California,33,2022-08-01,99071,99281,99248,33,874506,876603,876291,312,4119,359,359,535,93991,93991,93632,93632
California,34,2022-08-08,82777,82956,82937,19,819211,821286,821056,230,3754,324,324,474,94315,94315,93991,93991
California,35,2022-08-15,68437,68601,68589,12,788678,790821,790639,182,3363,294,294,448,94609,94609,94315,94315
California,36,2022-08-22,60820,60970,60964,6,772671,774944,774798,146,3087,279,279,418,94888,94888,94609,94609
California,37,2022-08-29,51264,51394,51391,3,762344,764764,764643,121,2752,214,214,351,95102,95102,94888,94888
California,38,2022-09-05,36253,36354,36354,0,624990,627161,627073,88,2525,242,242,350,95344,95344,95102,95102
California,39,2022-09-12,35918,36031,36031,0,749374,752347,752263,84,2422,220,220,346,95564,95564,95344,95344
California,40,2022-09-19,27393,27489,27489,0,684062,687072,687001,71,2041,179,179,272,95743,95743,95564,95564
California,41,2022-09-26,25069,25169,25169,0,635964,639092,639029,63,1818,167,167,230,95910,95910,95743,95743
California,42,2022-10-03,23056,23152,23152,0,582906,586004,585944,60,1647,145,145,247,96055,96055,95910,95910
California,43,2022-10-10,23203,23321,23321,0,622752,626613,626555,58,1537,151,151,228,96188,96188,96037,96037
California,44,2022-10-17,18488,18600,18600,0,519421,523171,523114,57,1397,115,115,218,96303,96303,96188,96188
California,45,2022-10-24,18334,18460,18460,0,509837,514118,514061,57,1324,110,111,190,96413,96414,96303,96303
California,46,2022-10-31,20429,20605,20605,0,518897,523990,523933,57,1401,111,114,191,96524,96528,96413,96414
California,47,2022-11-07,26486,26763,26763,0,541772,547878,547821,57,1525,126,131,231,96650,96659,96524,96528
California,48,2022-11-14,30328,30682,30682,0,543895,550802,550745,57,1775,102,107,260,96752,96766,96650,96659
California,49,2022-11-21,39659,40210,40210,0,565482,573624,573567,57,2268,142,151,330,96894,96917,96752,96766
California,50,2022-11-28,53629,54515,54515,0,503804,512292,512235,57,3153,177,193,379,97071,97110,96894,96917
California,51,2022-12-05,65161,66439,66439,0,634331,646930,646872,58,3715,211,253,493,97282,97363,97071,97110
California,52,2022-12-12,55607,56991,56991,0,595110,610144,610087,57,3944,243,343,527,97525,97706,97282,97363
California,53,2022-12-19,49134,50857,50857,0,546892,566118,566061,57,3997,169,334,523,97694,98040,97525,97706
California,54,2022-12-26,42709,45422,45422,0,400745,425661,425605,56,3906,109,497,510,97803,98537,97694,98040
California,55,2023-01-02,34253,65407,65407,0,282381,557780,557723,57,4077,32,348,528,97835,98885,97803,98537
