county,time,date,cases,est_cases,est_omicron_cases,est_other_cases,tests,est_tests,est_omicron_tests,est_other_tests,hospitalizations,deaths,est_deaths,icu,cum_deaths,cum_est_deaths,prev_cum_deaths,prev_cum_est_deaths
Alameda,1,2021-12-19,2369,2369,1097,1272,89505,89505,40795,48710,52,8,8,16,1538,1538,1530,1530
Amador,1,2021-12-19,45,45,16,29,1659,1659,563,1096,2,1,1,2,70,70,69,69
Butte,1,2021-12-19,162,162,83,79,4460,4460,2264,2196,24,5,5,1,358,358,353,353
Calaveras,1,2021-12-19,54,54,20,34,1684,1684,623,1061,1,2,2,0,92,92,90,90
Colusa,1,2021-12-19,16,16,7,9,473,473,197,276,0,0,0,0,21,21,21,21
Contra Costa,1,2021-12-19,1384,1384,468,916,43100,43100,14318,28782,25,4,4,8,1080,1080,1076,1076
Del Norte,1,2021-12-19,18,18,7,11,1389,1389,558,831,0,0,0,0,42,42,42,42
El Dorado,1,2021-12-19,215,215,81,134,4418,4418,1653,2765,7,4,4,2,178,178,174,174
Fresno,1,2021-12-19,978,978,340,638,25398,25398,8767,16631,128,22,22,45,2419,2419,2397,2397
Glenn,1,2021-12-19,19,19,7,12,450,450,171,279,0,0,0,0,41,41,41,41
Humboldt,1,2021-12-19,148,148,59,89,3640,3640,1434,2206,10,0,0,2,120,120,120,120
Imperial,1,2021-12-19,589,589,219,370,5696,5696,2097,3599,37,12,12,27,816,816,804,804
Inyo,1,2021-12-19,27,27,11,16,357,357,148,209,1,0,0,0,48,48,48,48
Kern,1,2021-12-19,894,894,375,519,28633,28633,11895,16738,91,26,26,29,2020,2020,1994,1994
Kings,1,2021-12-19,236,236,88,148,7324,7324,2706,4618,17,6,6,2,389,389,383,383
Lake,1,2021-12-19,36,36,12,24,1435,1435,489,946,0,0,0,0,116,116,116,116
Lassen,1,2021-12-19,8,8,4,4,2483,2483,1100,1383,0,0,0,0,54,54,54,54
Los Angeles,1,2021-12-19,25547,25547,17512,8035,999975,999984,677493,322491,569,109,109,172,27349,27349,27240,27240
Madera,1,2021-12-19,164,164,57,107,6031,6031,2059,3972,10,4,4,4,334,334,330,330
Marin,1,2021-12-19,443,443,159,284,11480,11480,4058,7422,3,1,1,1,200,200,199,199
Mariposa,1,2021-12-19,16,16,5,11,450,450,151,299,0,0,0,0,21,21,21,21
Mendocino,1,2021-12-19,87,87,25,62,2629,2629,747,1882,2,2,2,3,102,102,100,100
Merced,1,2021-12-19,262,262,108,154,5614,5614,2279,3335,9,4,4,13,691,691,687,687
Modoc,1,2021-12-19,4,4,2,2,50,50,21,29,2,0,0,0,6,6,6,6
Mono,1,2021-12-19,30,30,7,23,297,297,75,222,1,0,0,0,4,4,4,4
Monterey,1,2021-12-19,432,432,109,323,13087,13087,3269,9818,24,3,3,5,642,642,639,639
Napa,1,2021-12-19,199,199,89,110,5670,5670,2488,3182,2,1,1,1,110,110,109,109
Nevada,1,2021-12-19,151,151,53,98,2656,2656,919,1737,3,2,2,3,110,110,108,108
Orange,1,2021-12-19,3970,3970,1911,2059,96548,96548,45934,50614,139,32,32,56,6021,6021,5989,5989
Placer,1,2021-12-19,495,495,165,330,11088,11088,3612,7476,52,7,7,27,501,501,494,494
Plumas,1,2021-12-19,17,17,6,11,510,510,186,324,0,0,0,0,12,12,12,12
Riverside,1,2021-12-19,4840,4840,1972,2868,78673,78673,31630,47043,235,41,41,82,5577,5577,5536,5536
Sacramento,1,2021-12-19,1920,1920,745,1175,53518,53518,20525,32993,91,21,21,46,2489,2489,2468,2468
San Benito,1,2021-12-19,86,86,37,49,1959,1959,846,1113,3,1,1,2,79,79,78,78
San Bernardino,1,2021-12-19,4328,4328,1990,2338,78349,78349,35593,42756,286,65,65,117,6504,6504,6439,6439
San Diego,1,2021-12-19,7074,7074,4756,2318,146843,146843,98115,48728,258,30,30,93,4474,4474,4444,4444
San Francisco,1,2021-12-19,2366,2366,565,1801,53176,53176,12480,40696,25,3,3,10,692,692,689,689
San Joaquin,1,2021-12-19,833,833,303,530,25845,25845,9276,16569,51,13,13,27,1970,1970,1957,1957
San Luis Obispo,1,2021-12-19,356,356,152,204,9616,9616,4047,5569,12,3,3,4,370,370,367,367
San Mateo,1,2021-12-19,1210,1210,584,626,49929,49929,23679,26250,8,0,0,5,601,601,601,601
Santa Barbara,1,2021-12-19,641,641,257,384,15632,15632,6182,9450,19,7,7,12,569,569,562,562
Santa Clara,1,2021-12-19,2346,2346,1550,796,122529,122529,80058,42471,85,8,8,40,1977,1977,1969,1969
Santa Cruz,1,2021-12-19,354,354,156,198,21105,21105,9125,11980,10,2,2,6,230,230,228,228
Shasta,1,2021-12-19,154,154,60,94,6017,6017,2298,3719,26,6,6,9,451,451,445,445
Siskiyou,1,2021-12-19,17,17,8,9,476,476,213,263,4,1,1,0,62,62,61,61
Solano,1,2021-12-19,440,440,178,262,14683,14683,5865,8818,19,4,4,6,389,389,385,385
Sonoma,1,2021-12-19,662,662,274,388,21230,21230,8617,12613,27,1,1,3,420,420,419,419
Stanislaus,1,2021-12-19,631,631,191,440,13641,13641,4081,9560,91,11,11,22,1429,1429,1418,1418
Sutter,1,2021-12-19,94,94,38,56,2209,2209,878,1331,0,2,2,0,193,193,191,191
Tehama,1,2021-12-19,55,55,17,38,1327,1327,411,916,5,2,2,3,165,165,163,163
Trinity,1,2021-12-19,3,3,1,2,106,106,32,74,0,0,0,0,18,18,18,18
Tulare,1,2021-12-19,387,387,115,272,12508,12508,3683,8825,38,17,17,13,1308,1308,1291,1291
Tuolumne,1,2021-12-19,97,97,34,63,1963,1963,679,1284,6,0,0,1,150,150,150,150
Ventura,1,2021-12-19,1660,1660,833,827,38675,38675,19119,19556,67,9,9,13,1216,1216,1207,1207
Yolo,1,2021-12-19,303,303,131,172,25342,25342,10852,14490,4,0,0,1,297,297,297,297
Yuba,1,2021-12-19,97,97,40,57,1886,1886,781,1105,4,0,0,4,102,102,102,102
Alameda,2,2021-12-26,6290,6290,3287,3003,85039,85039,43867,41172,73,12,12,17,1550,1550,1538,1538
Amador,2,2021-12-26,88,88,36,52,1508,1508,596,912,2,0,0,2,70,70,70,70
Butte,2,2021-12-26,441,441,255,186,4141,4141,2355,1786,35,3,3,3,361,361,358,358
Calaveras,2,2021-12-26,94,94,41,53,999,999,428,571,1,1,1,1,93,93,92,92
Colusa,2,2021-12-26,16,16,8,8,237,237,112,125,2,0,0,0,21,21,21,21
Contra Costa,2,2021-12-26,3879,3879,1534,2345,44515,44515,17291,27224,37,2,2,15,1082,1082,1080,1080
Del Norte,2,2021-12-26,24,24,11,13,1246,1246,574,672,0,0,0,0,42,42,42,42
El Dorado,2,2021-12-26,416,416,183,233,4203,4203,1810,2393,6,1,1,4,179,179,178,178
Fresno,2,2021-12-26,1743,1743,713,1030,22607,22607,9100,13507,121,15,15,40,2434,2434,2419,2419
Glenn,2,2021-12-26,45,45,20,25,444,444,194,250,0,0,0,0,41,41,41,41
Humboldt,2,2021-12-26,403,403,186,217,3251,3251,1468,1783,9,2,2,0,122,122,120,120
Imperial,2,2021-12-26,709,709,307,402,5378,5378,2297,3081,29,11,11,26,827,827,816,816
Inyo,2,2021-12-26,94,94,46,48,411,411,194,217,0,2,2,0,50,50,48,48
Kern,2,2021-12-26,1462,1462,710,752,20578,20578,9839,10739,72,17,17,32,2037,2037,2020,2020
Kings,2,2021-12-26,412,412,181,231,5363,5363,2296,3067,15,1,1,4,390,390,389,389
Lake,2,2021-12-26,54,54,22,32,1154,1154,459,695,0,1,1,0,117,117,116,116
Lassen,2,2021-12-26,19,19,10,9,2327,2327,1172,1155,0,0,0,0,54,54,54,54
Los Angeles,2,2021-12-26,75260,75260,55260,20000,694205,694210,507639,186571,766,104,104,200,27453,27453,27349,27349
Madera,2,2021-12-26,248,248,102,146,4236,4236,1686,2550,6,1,1,5,335,335,334,334
Marin,2,2021-12-26,1403,1403,585,818,15716,15716,6474,9242,3,0,0,1,200,200,200,200
Mariposa,2,2021-12-26,36,36,14,22,505,505,196,309,0,0,0,0,21,21,21,21
Mendocino,2,2021-12-26,118,118,41,77,2488,2488,829,1659,3,1,1,3,103,103,102,102
Merced,2,2021-12-26,496,496,235,261,4949,4949,2305,2644,0,8,8,2,699,699,691,691
Modoc,2,2021-12-26,3,3,1,2,58,58,28,30,3,0,0,0,6,6,6,6
Mono,2,2021-12-26,108,108,33,75,366,366,108,258,1,0,0,0,4,4,4,4
Monterey,2,2021-12-26,830,830,253,577,12625,12625,3760,8865,25,2,2,11,644,644,642,642
Napa,2,2021-12-26,649,649,330,319,5762,5762,2892,2870,5,0,0,1,110,110,110,110
Nevada,2,2021-12-26,212,212,87,125,2537,2537,1014,1523,4,1,1,2,111,111,110,110
Orange,2,2021-12-26,13164,13164,7159,6005,114464,114464,61533,52931,216,33,33,66,6054,6054,6021,6021
Placer,2,2021-12-26,1020,1020,397,623,10370,10370,3947,6423,60,1,1,25,502,502,501,501
Plumas,2,2021-12-26,13,13,6,7,399,399,167,232,0,0,0,0,12,12,12,12
Riverside,2,2021-12-26,10943,10943,5131,5812,80375,80375,37149,43226,283,47,47,88,5624,5624,5577,5577
Sacramento,2,2021-12-26,3962,3962,1783,2179,49075,49075,21705,27370,122,16,16,43,2505,2505,2489,2489
San Benito,2,2021-12-26,254,254,128,126,2209,2209,1093,1116,1,3,3,3,82,82,79,79
San Bernardino,2,2021-12-26,10867,10867,5685,5182,82309,82309,42337,39972,311,72,72,127,6576,6576,6504,6504
San Diego,2,2021-12-26,20538,20538,14863,5675,164622,164622,118420,46202,292,33,33,92,4507,4507,4474,4474
San Francisco,2,2021-12-26,6160,6160,1745,4415,64328,64328,17984,46344,30,1,1,11,693,693,692,692
San Joaquin,2,2021-12-26,1804,1804,769,1035,21537,21537,9004,12533,53,18,18,25,1988,1988,1970,1970
San Luis Obispo,2,2021-12-26,830,830,405,425,10355,10355,4974,5381,14,1,1,8,371,371,370,370
San Mateo,2,2021-12-26,4345,4345,2363,1982,53251,53251,28546,24705,14,2,2,7,603,603,601,601
Santa Barbara,2,2021-12-26,1689,1689,783,906,14427,14427,6561,7866,28,4,4,11,573,573,569,569
Santa Clara,2,2021-12-26,7225,7225,5153,2072,101312,101312,71601,29711,84,10,10,34,1987,1987,1977,1977
Santa Cruz,2,2021-12-26,761,761,384,377,11970,11970,5891,6079,12,0,0,2,230,230,230,230
Shasta,2,2021-12-26,217,217,98,119,4661,4661,2051,2610,28,7,7,12,458,458,451,451
Siskiyou,2,2021-12-26,16,16,8,8,357,357,182,175,0,1,1,0,63,63,62,62
Solano,2,2021-12-26,918,918,427,491,15690,15690,7222,8468,26,3,3,3,392,392,389,389
Sonoma,2,2021-12-26,1601,1601,763,838,20137,20137,9415,10722,15,0,0,5,420,420,420,420
Stanislaus,2,2021-12-26,1014,1014,367,647,10803,10803,3836,6967,88,17,17,16,1446,1446,1429,1429
Sutter,2,2021-12-26,200,200,93,107,2065,2065,943,1122,0,2,2,0,195,195,193,193
Tehama,2,2021-12-26,78,78,29,49,1079,1079,392,687,9,0,0,2,165,165,165,165
Trinity,2,2021-12-26,4,4,2,2,96,96,35,61,0,1,1,0,19,19,18,18
Tulare,2,2021-12-26,658,658,235,423,10633,10633,3695,6938,37,13,13,9,1321,1321,1308,1308
Tuolumne,2,2021-12-26,151,151,62,89,1777,1777,716,1061,5,0,0,1,150,150,150,150
Ventura,2,2021-12-26,4467,4467,2524,1943,36838,36838,20508,16330,61,7,7,17,1223,1223,1216,1216
Yolo,2,2021-12-26,615,615,304,311,18985,18985,9186,9799,5,1,1,2,298,298,297,297
Yuba,2,2021-12-26,130,130,63,67,1523,1523,720,803,8,1,1,3,103,103,102,102
Alameda,3,2022-01-02,15228,15228,8849,6379,105563,105563,61088,44475,144,7,7,29,1557,1557,1550,1550
Amador,3,2022-01-02,167,167,78,89,1896,1896,869,1027,4,1,1,2,71,71,70,70
Butte,3,2022-01-02,1013,1013,644,369,6158,6158,3877,2281,27,1,1,6,362,362,361,361
Calaveras,3,2022-01-02,183,183,92,91,1143,1143,562,581,1,1,1,1,94,94,93,93
Colusa,3,2022-01-02,52,52,28,24,322,322,173,149,5,0,0,0,21,21,21,21
Contra Costa,3,2022-01-02,11685,11685,5280,6405,61015,61015,27432,33583,69,9,9,22,1091,1091,1082,1082
Del Norte,3,2022-01-02,60,60,32,28,2007,2007,1045,962,0,0,0,0,42,42,42,42
El Dorado,3,2022-01-02,1108,1108,553,555,5473,5473,2708,2765,12,4,4,5,183,183,179,179
Fresno,3,2022-01-02,5470,5470,2556,2914,35321,35321,16409,18912,155,12,12,38,2446,2446,2434,2434
Glenn,3,2022-01-02,69,69,35,34,551,551,275,276,0,1,1,0,42,42,41,41
Humboldt,3,2022-01-02,784,784,408,376,4856,4856,2504,2352,8,0,0,3,122,122,122,122
Imperial,3,2022-01-02,1532,1532,753,779,8166,8166,3993,4173,28,12,12,30,839,839,827,827
Inyo,3,2022-01-02,219,219,119,100,612,612,327,285,2,0,0,0,50,50,50,50
Kern,3,2022-01-02,4638,4638,2530,2108,30752,30752,16618,14134,90,15,15,34,2052,2052,2037,2037
Kings,3,2022-01-02,929,929,462,467,7695,7695,3783,3912,12,3,3,2,393,393,390,390
Lake,3,2022-01-02,175,175,82,93,1495,1495,688,807,1,0,0,1,117,117,117,117
Lassen,3,2022-01-02,51,51,29,22,2665,2665,1505,1160,2,0,0,0,54,54,54,54
Los Angeles,3,2022-01-02,182882,182882,142189,40693,996500,996507,775776,220731,1716,137,137,278,27590,27590,27453,27453
Madera,3,2022-01-02,697,697,324,373,5841,5841,2687,3154,14,3,3,4,338,338,335,335
Marin,3,2022-01-02,2181,2181,1031,1150,17071,17071,8020,9051,18,1,1,1,201,201,200,200
Mariposa,3,2022-01-02,78,78,36,42,538,538,242,296,0,0,0,0,21,21,21,21
Mendocino,3,2022-01-02,380,380,152,228,3178,3178,1252,1926,8,0,0,2,103,103,103,103
Merced,3,2022-01-02,1274,1274,678,596,7501,7501,3969,3532,13,8,8,13,707,707,699,699
Modoc,3,2022-01-02,14,14,8,6,52,52,28,24,0,0,0,0,6,6,6,6
Mono,3,2022-01-02,177,177,62,115,395,395,138,257,1,0,0,0,4,4,4,4
Monterey,3,2022-01-02,2114,2114,754,1360,18498,18498,6558,11940,26,5,5,10,649,649,644,644
Napa,3,2022-01-02,1556,1556,880,676,10236,10236,5753,4483,8,1,1,3,111,111,110,110
Nevada,3,2022-01-02,519,519,245,274,2245,2245,1052,1193,4,1,1,4,112,112,111,111
Orange,3,2022-01-02,41061,41061,24590,16471,202756,202756,121149,81607,441,32,32,104,6086,6086,6054,6054
Placer,3,2022-01-02,2540,2540,1133,1407,14263,14263,6295,7968,104,14,14,25,516,516,502,502
Plumas,3,2022-01-02,46,46,23,23,363,363,176,187,1,0,0,0,12,12,12,12
Riverside,3,2022-01-02,27903,27903,14706,13197,128340,128340,67313,61027,494,57,57,101,5681,5681,5624,5624
Sacramento,3,2022-01-02,11790,11790,5990,5800,73088,73088,36915,36173,206,27,27,61,2532,2532,2505,2505
San Benito,3,2022-01-02,647,647,362,285,3157,3157,1760,1397,3,3,3,3,85,85,82,82
San Bernardino,3,2022-01-02,30613,30613,17728,12885,125538,125538,72409,53129,514,88,88,141,6664,6664,6576,6576
San Diego,3,2022-01-02,54787,54787,42059,12728,235836,235836,180917,54919,542,33,33,122,4540,4540,4507,4507
San Francisco,3,2022-01-02,10069,10069,3378,6691,76885,76885,25614,51271,78,5,5,18,698,698,693,693
San Joaquin,3,2022-01-02,5896,5896,2863,3033,33126,33126,15936,17190,66,9,9,26,1997,1997,1988,1988
San Luis Obispo,3,2022-01-02,2183,2183,1189,994,14881,14881,8078,6803,16,6,6,6,377,377,371,371
San Mateo,3,2022-01-02,9459,9459,5680,3779,71374,71374,42708,28666,28,4,4,8,607,607,603,603
Santa Barbara,3,2022-01-02,4563,4563,2382,2181,24556,24556,12778,11778,49,7,7,8,580,580,573,573
Santa Clara,3,2022-01-02,19519,19519,14825,4694,144076,144076,109039,35037,169,8,8,56,1995,1995,1987,1987
Santa Cruz,3,2022-01-02,2025,2025,1140,885,16705,16705,9323,7382,18,4,4,4,234,234,230,230
Shasta,3,2022-01-02,490,490,252,238,5599,5599,2825,2774,30,2,2,13,460,460,458,458
Siskiyou,3,2022-01-02,58,58,33,25,460,460,263,197,0,0,0,0,63,63,63,63
Solano,3,2022-01-02,3631,3631,1900,1731,24270,24270,12662,11608,57,4,4,9,396,396,392,392
Sonoma,3,2022-01-02,3730,3730,1986,1744,28223,28223,14939,13284,26,7,7,3,427,427,420,420
Stanislaus,3,2022-01-02,2850,2850,1193,1657,16408,16408,6801,9607,111,9,9,19,1455,1455,1446,1446
Sutter,3,2022-01-02,440,440,232,208,2723,2723,1417,1306,0,2,2,0,197,197,195,195
Tehama,3,2022-01-02,182,182,79,103,1225,1225,518,707,1,3,3,2,168,168,165,165
Trinity,3,2022-01-02,12,12,5,7,100,100,42,58,0,0,0,0,19,19,19,19
Tulare,3,2022-01-02,1728,1728,716,1012,14936,14936,6080,8856,52,5,5,7,1326,1326,1321,1321
Tuolumne,3,2022-01-02,314,314,148,166,1972,1972,920,1052,6,1,1,0,151,151,150,150
Ventura,3,2022-01-02,11584,11584,7167,4417,55439,55439,34160,21279,120,9,9,33,1232,1232,1223,1223
Yolo,3,2022-01-02,1940,1940,1081,859,30107,30107,16566,13541,5,4,4,3,302,302,298,298
Yuba,3,2022-01-02,401,401,218,183,2112,2112,1134,978,18,1,1,6,104,104,103,103
Alameda,4,2022-01-09,31279,31279,20006,11273,191461,191461,122373,69088,277,13,13,45,1570,1570,1557,1557
Amador,4,2022-01-09,368,368,192,176,2754,2754,1426,1328,4,0,0,4,71,71,71,71
Butte,4,2022-01-09,1949,1949,1341,608,10296,10296,7060,3236,43,2,2,5,364,364,362,362
Calaveras,4,2022-01-09,462,462,259,203,2458,2458,1363,1095,0,1,1,2,95,95,94,94
Colusa,4,2022-01-09,85,85,51,34,681,681,406,275,5,0,0,0,21,21,21,21
Contra Costa,4,2022-01-09,20306,20306,10429,9877,103079,103079,52836,50243,144,12,12,23,1103,1103,1091,1091
Del Norte,4,2022-01-09,171,171,100,71,3831,3831,2249,1582,1,0,0,0,42,42,42,42
El Dorado,4,2022-01-09,2185,2185,1222,963,9007,9007,5022,3985,16,6,6,2,189,189,183,183
Fresno,4,2022-01-09,13434,13434,7118,6316,57489,57489,30373,27116,258,15,15,47,2461,2461,2446,2446
Glenn,4,2022-01-09,183,183,104,79,898,898,505,393,2,1,1,0,43,43,42,42
Humboldt,4,2022-01-09,1412,1412,819,593,8310,8310,4811,3499,14,6,6,2,128,128,122,122
Imperial,4,2022-01-09,3441,3441,1899,1542,13513,13513,7449,6064,49,12,12,24,851,851,839,839
Inyo,4,2022-01-09,374,374,223,151,1238,1238,737,501,3,1,1,0,51,51,50,50
Kern,4,2022-01-09,11413,11413,6891,4522,55750,55750,33520,22230,170,23,23,29,2075,2075,2052,2052
Kings,4,2022-01-09,2058,2058,1150,908,12202,12202,6778,5424,26,1,1,3,394,394,393,393
Lake,4,2022-01-09,455,455,239,216,2699,2699,1407,1292,0,3,3,2,120,120,117,117
Lassen,4,2022-01-09,147,147,92,55,3524,3524,2190,1334,2,0,0,0,54,54,54,54
Los Angeles,4,2022-01-09,332286,332286,271687,60599,1901672,1901688,1555158,346530,2990,267,267,482,27857,27857,27590,27590
Madera,4,2022-01-09,1784,1784,940,844,10214,10214,5346,4868,22,2,2,6,340,340,338,338
Marin,4,2022-01-09,3059,3059,1635,1424,21425,21425,11435,9990,18,2,2,5,203,203,201,201
Mariposa,4,2022-01-09,180,180,92,88,1101,1101,565,536,0,1,1,0,22,22,21,21
Mendocino,4,2022-01-09,790,790,361,429,5304,5304,2408,2896,4,3,3,3,106,106,103,103
Merced,4,2022-01-09,3582,3582,2124,1458,13800,13800,8166,5634,33,11,11,12,718,718,707,707
Modoc,4,2022-01-09,13,13,8,5,98,98,59,39,0,0,0,0,6,6,6,6
Mono,4,2022-01-09,247,247,101,146,824,824,337,487,1,1,1,0,5,5,4,4
Monterey,4,2022-01-09,4539,4539,1880,2659,31908,31908,13162,18746,42,4,4,10,653,653,649,649
Napa,4,2022-01-09,2703,2703,1685,1018,15021,15021,9343,5678,16,1,1,1,112,112,111,111
Nevada,4,2022-01-09,1125,1125,598,527,4917,4917,2595,2322,10,2,2,3,114,114,112,112
Orange,4,2022-01-09,61585,61585,40401,21184,311674,311674,204414,107260,824,88,88,140,6174,6174,6086,6086
Placer,4,2022-01-09,4937,4937,2505,2432,21527,21527,10876,10651,163,8,8,26,524,524,516,516
Plumas,4,2022-01-09,119,119,65,54,785,785,425,360,4,0,0,0,12,12,12,12
Riverside,4,2022-01-09,47586,47586,27930,19656,184711,184711,108331,76380,749,77,77,137,5758,5758,5681,5681
Sacramento,4,2022-01-09,26825,26825,15253,11572,119941,119941,68061,51880,354,35,35,72,2567,2567,2532,2532
San Benito,4,2022-01-09,1033,1033,640,393,4498,4498,2783,1715,4,0,0,2,85,85,85,85
San Bernardino,4,2022-01-09,50256,50256,32083,18173,190093,190093,121230,68863,760,109,109,177,6773,6773,6664,6664
San Diego,4,2022-01-09,83714,83714,67686,16028,338251,338253,273516,64737,820,51,51,168,4591,4591,4540,4540
San Francisco,4,2022-01-09,16194,16194,6329,9865,120787,120787,47195,73592,148,12,12,30,710,710,698,698
San Joaquin,4,2022-01-09,13296,13296,7259,6037,61634,61634,33567,28067,117,18,18,39,2015,2015,1997,1997
San Luis Obispo,4,2022-01-09,4270,4270,2589,1681,21465,21465,12996,8469,29,2,2,8,379,379,377,377
San Mateo,4,2022-01-09,15080,15080,9902,5178,113390,113390,74332,39058,96,4,4,14,611,611,607,607
Santa Barbara,4,2022-01-09,8289,8289,4813,3476,45252,45252,26278,18974,77,7,7,10,587,587,580,580
Santa Clara,4,2022-01-09,36363,36363,29099,7264,270324,270324,216110,54214,339,26,26,66,2021,2021,1995,1995
Santa Cruz,4,2022-01-09,4461,4461,2769,1692,41661,41661,25747,15914,20,3,3,2,237,237,234,234
Shasta,4,2022-01-09,1014,1014,579,435,8280,8280,4696,3584,34,8,8,12,468,468,460,460
Siskiyou,4,2022-01-09,115,115,72,43,888,888,557,331,5,1,1,1,64,64,63,63
Solano,4,2022-01-09,6719,6719,3941,2778,36531,36531,21390,15141,81,5,5,11,401,401,396,396
Sonoma,4,2022-01-09,8525,8525,5047,3478,46488,46488,27453,19035,69,9,9,7,436,436,427,427
Stanislaus,4,2022-01-09,6231,6231,2985,3246,27495,27495,13108,14387,154,13,13,24,1468,1468,1455,1455
Sutter,4,2022-01-09,1131,1131,662,469,4712,4712,2741,1971,0,1,1,0,198,198,197,197
Tehama,4,2022-01-09,457,457,224,233,2431,2431,1180,1251,11,1,1,1,169,169,168,168
Trinity,4,2022-01-09,36,36,18,18,267,267,129,138,0,0,0,0,19,19,19,19
Tulare,4,2022-01-09,4472,4472,2119,2353,22643,22643,10651,11992,56,8,8,10,1334,1334,1326,1326
Tuolumne,4,2022-01-09,754,754,400,354,4117,4117,2169,1948,13,3,3,2,154,154,151,151
Ventura,4,2022-01-09,17384,17384,11727,5657,86527,86527,58296,28231,218,22,22,30,1254,1254,1232,1232
Yolo,4,2022-01-09,3810,3810,2334,1476,49037,49037,30020,19017,6,3,3,2,305,305,302,302
Yuba,4,2022-01-09,943,943,567,376,3883,3883,2325,1558,37,0,0,9,104,104,104,104
Alameda,5,2022-01-16,26155,26155,18151,8004,183975,183975,127633,56342,357,29,29,58,1599,1599,1570,1570
Amador,5,2022-01-16,490,490,285,205,3797,3797,2195,1602,8,2,2,4,73,73,71,71
Butte,5,2022-01-16,2109,2109,1555,554,9802,9802,7208,2594,57,3,3,3,367,367,364,364
Calaveras,5,2022-01-16,594,594,365,229,2707,2707,1662,1045,3,2,2,3,97,97,95,95
Colusa,5,2022-01-16,173,173,114,59,844,844,551,293,3,0,0,0,21,21,21,21
Contra Costa,5,2022-01-16,17206,17206,9894,7312,95345,95345,54717,40628,198,22,22,44,1125,1125,1103,1103
Del Norte,5,2022-01-16,195,195,125,70,3949,3949,2519,1430,3,0,0,0,42,42,42,42
El Dorado,5,2022-01-16,2055,2055,1266,789,8802,8802,5419,3383,12,4,4,2,193,193,189,189
Fresno,5,2022-01-16,18250,18250,10760,7490,67391,67391,39683,27708,354,26,26,68,2487,2487,2461,2461
Glenn,5,2022-01-16,306,306,191,115,1105,1105,687,418,1,1,1,0,44,44,43,43
Humboldt,5,2022-01-16,1245,1245,793,452,8850,8850,5636,3214,9,0,0,6,128,128,128,128
Imperial,5,2022-01-16,3680,3680,2247,1433,13933,13933,8510,5423,64,10,10,28,861,861,851,851
Inyo,5,2022-01-16,393,393,256,137,1233,1233,802,431,2,1,1,0,52,52,51,51
Kern,5,2022-01-16,12869,12869,8486,4383,58701,58701,38611,20090,240,27,27,39,2102,2102,2075,2075
Kings,5,2022-01-16,3499,3499,2155,1344,16643,16643,10237,6406,41,3,3,2,397,397,394,394
Lake,5,2022-01-16,587,587,344,243,3178,3178,1856,1322,1,0,0,2,120,120,120,120
Lassen,5,2022-01-16,304,304,207,97,3790,3790,2567,1223,1,0,0,0,54,54,54,54
Los Angeles,5,2022-01-16,243408,243408,207143,36265,1733359,1733375,1475059,258316,3943,469,469,621,28326,28326,27857,27857
Madera,5,2022-01-16,2411,2411,1415,996,11043,11043,6457,4586,30,5,5,6,345,345,340,340
Marin,5,2022-01-16,2576,2576,1533,1043,18913,18913,11238,7675,38,4,4,4,207,207,203,203
Mariposa,5,2022-01-16,186,186,106,80,1216,1216,697,519,0,0,0,0,22,22,22,22
Mendocino,5,2022-01-16,983,983,508,475,5562,5562,2863,2699,18,3,3,3,109,109,106,106
Merced,5,2022-01-16,4499,4499,2922,1577,14958,14958,9709,5249,38,19,19,12,737,737,718,718
Modoc,5,2022-01-16,12,12,8,4,110,110,73,37,0,1,1,0,7,7,6,6
Mono,5,2022-01-16,229,229,107,122,881,881,415,466,1,0,0,0,5,5,5,5
Monterey,5,2022-01-16,6198,6198,2946,3252,30273,30273,14328,15945,58,7,7,13,660,660,653,653
Napa,5,2022-01-16,2166,2166,1471,695,13308,13308,9020,4288,18,2,2,5,114,114,112,112
Nevada,5,2022-01-16,1290,1290,761,529,5658,5658,3324,2334,21,1,1,1,115,115,114,114
Orange,5,2022-01-16,46311,46311,32827,13484,278875,278875,197554,81321,1012,113,113,188,6287,6287,6174,6174
Placer,5,2022-01-16,4608,4608,2609,1999,20996,20996,11861,9135,180,13,13,35,537,537,524,524
Plumas,5,2022-01-16,198,198,120,78,809,809,485,324,4,0,0,0,12,12,12,12
Riverside,5,2022-01-16,44747,44747,28843,15904,180912,180912,116612,64300,871,90,90,152,5848,5848,5758,5758
Sacramento,5,2022-01-16,23310,23310,14611,8699,110978,110978,69488,41490,451,58,58,96,2625,2625,2567,2567
San Benito,5,2022-01-16,928,928,626,302,4498,4498,3030,1468,5,2,2,3,87,87,85,85
San Bernardino,5,2022-01-16,42870,42870,29667,13203,181088,181088,125354,55734,909,138,138,217,6911,6911,6773,6773
San Diego,5,2022-01-16,65195,65195,55015,10180,284727,284727,240330,44397,1067,111,111,189,4702,4702,4591,4591
San Francisco,5,2022-01-16,11628,11628,5264,6364,99599,99599,44957,54642,204,14,14,45,724,724,710,710
San Joaquin,5,2022-01-16,14017,14017,8456,5561,64014,64014,38603,25411,194,20,20,55,2035,2035,2015,2015
San Luis Obispo,5,2022-01-16,4083,4083,2707,1376,22334,22334,14792,7542,38,11,11,8,390,390,379,379
San Mateo,5,2022-01-16,13470,13470,9550,3920,105823,105823,74922,30901,95,10,10,22,621,621,611,611
Santa Barbara,5,2022-01-16,7508,7508,4793,2715,44214,44214,28201,16013,118,11,11,10,598,598,587,587
Santa Clara,5,2022-01-16,32153,32153,26883,5270,258414,258414,215958,42456,437,25,25,78,2046,2046,2021,2021
Santa Cruz,5,2022-01-16,4300,4300,2910,1390,46081,46081,31115,14966,28,3,3,3,240,240,237,237
Shasta,5,2022-01-16,1331,1331,839,492,9674,9674,6063,3611,63,6,6,13,474,474,468,468
Siskiyou,5,2022-01-16,159,159,109,50,1026,1026,698,328,3,1,1,2,65,65,64,64
Solano,5,2022-01-16,6918,6918,4464,2454,37940,37940,24454,13486,103,8,8,21,409,409,401,401
Sonoma,5,2022-01-16,8241,8241,5353,2888,47075,47075,30524,16551,74,8,8,14,444,444,436,436
Stanislaus,5,2022-01-16,7637,7637,4113,3524,30841,30841,16563,14278,200,9,9,31,1477,1477,1468,1468
Sutter,5,2022-01-16,1335,1335,854,481,5102,5102,3257,1845,0,5,5,0,203,203,198,198
Tehama,5,2022-01-16,646,646,355,291,2652,2652,1449,1203,15,4,4,2,173,173,169,169
Trinity,5,2022-01-16,40,40,22,18,268,268,145,123,0,1,1,0,20,20,19,19
Tulare,5,2022-01-16,7573,7573,4038,3535,28116,28116,14939,13177,88,15,15,15,1349,1349,1334,1334
Tuolumne,5,2022-01-16,940,940,556,384,4358,4358,2559,1799,9,8,8,1,162,162,154,154
Ventura,5,2022-01-16,13454,13454,9753,3701,74989,74989,54307,20682,285,39,39,52,1293,1293,1254,1254
Yolo,5,2022-01-16,3006,3006,2008,998,42811,42811,28619,14192,13,5,5,4,310,310,305,305
Yuba,5,2022-01-16,1085,1085,711,374,3974,3974,2600,1374,39,2,2,5,106,106,104,104
Alameda,6,2022-01-23,20073,20073,14937,5136,160763,160763,119706,41057,381,37,37,61,1636,1636,1599,1599
Amador,6,2022-01-23,560,560,359,201,4357,4357,2790,1567,7,0,0,5,73,73,73,73
Butte,6,2022-01-23,1956,1956,1529,427,9135,9135,7136,1999,79,12,12,12,379,379,367,367
Calaveras,6,2022-01-23,592,592,398,194,2431,2431,1632,799,5,1,1,2,98,98,97,97
Colusa,6,2022-01-23,171,171,121,50,865,865,613,252,5,0,0,0,21,21,21,21
Contra Costa,6,2022-01-23,13659,13659,8665,4994,81176,81176,51500,29676,227,25,25,65,1150,1150,1125,1125
Del Norte,6,2022-01-23,320,320,223,97,3885,3885,2694,1191,4,0,0,1,42,42,42,42
El Dorado,6,2022-01-23,1491,1491,1004,487,7149,7149,4814,2335,14,1,1,5,194,194,193,193
Fresno,6,2022-01-23,18058,18058,11680,6378,66758,66758,43205,23553,485,37,37,83,2524,2524,2487,2487
Glenn,6,2022-01-23,260,260,176,84,976,976,661,315,0,1,1,0,45,45,44,44
Humboldt,6,2022-01-23,944,944,654,290,7217,7217,4998,2219,23,3,3,4,131,131,128,128
Imperial,6,2022-01-23,3603,3603,2414,1189,12622,12622,8449,4173,60,17,17,32,878,878,861,861
Inyo,6,2022-01-23,152,152,107,45,616,616,434,182,1,1,1,0,53,53,52,52
Kern,6,2022-01-23,10465,10465,7469,2996,50387,50387,35929,14458,256,51,51,53,2153,2153,2102,2102
Kings,6,2022-01-23,4045,4045,2720,1325,16919,16919,11383,5536,38,5,5,5,402,402,397,397
Lake,6,2022-01-23,679,679,436,243,3155,3155,2017,1138,5,2,2,3,122,122,120,120
Lassen,6,2022-01-23,414,414,302,112,3665,3665,2674,991,1,0,0,0,54,54,54,54
Los Angeles,6,2022-01-23,167815,167815,147685,20130,1555661,1555675,1369585,186090,3779,606,606,794,28932,28932,28326,28326
Madera,6,2022-01-23,2725,2725,1757,968,11575,11575,7449,4126,45,8,8,12,353,353,345,345
Marin,6,2022-01-23,1893,1893,1236,657,16847,16847,10999,5848,40,5,5,13,212,212,207,207
Mariposa,6,2022-01-23,145,145,92,53,935,935,591,344,0,0,0,0,22,22,22,22
Mendocino,6,2022-01-23,939,939,542,397,4767,4767,2752,2015,20,1,1,3,110,110,109,109
Merced,6,2022-01-23,3479,3479,2450,1029,12393,12393,8730,3663,53,9,9,10,746,746,737,737
Modoc,6,2022-01-23,15,15,11,4,104,104,74,30,2,0,0,0,7,7,7,7
Mono,6,2022-01-23,93,93,50,43,441,441,235,206,1,0,0,0,5,5,5,5
Monterey,6,2022-01-23,5011,5011,2683,2328,30687,30687,16435,14252,71,8,8,20,668,668,660,660
Napa,6,2022-01-23,1685,1685,1233,452,11861,11861,8672,3189,16,4,4,6,118,118,114,114
Nevada,6,2022-01-23,1053,1053,683,370,4767,4767,3080,1687,23,1,1,7,116,116,115,115
Orange,6,2022-01-23,29202,29202,22126,7076,224352,224352,170091,54261,967,172,172,195,6459,6459,6287,6287
Placer,6,2022-01-23,3799,3799,2381,1418,18240,18240,11416,6824,206,7,7,47,544,544,537,537
Plumas,6,2022-01-23,215,215,142,73,884,884,580,304,6,0,0,0,12,12,12,12
Riverside,6,2022-01-23,32970,32970,23071,9899,155324,155324,108735,46589,891,129,129,174,5977,5977,5848,5848
Sacramento,6,2022-01-23,17798,17798,12166,5632,94805,94805,64801,30004,513,68,68,110,2693,2693,2625,2625
San Benito,6,2022-01-23,815,815,592,223,3934,3934,2857,1077,5,1,1,3,88,88,87,87
San Bernardino,6,2022-01-23,28533,28533,21206,7327,146249,146249,108731,37518,966,169,169,216,7080,7080,6911,6911
San Diego,6,2022-01-23,51402,51402,44929,6473,244130,244130,213499,30631,1070,127,127,227,4829,4829,4702,4702
San Francisco,6,2022-01-23,8546,8546,4387,4159,85890,85890,44110,41780,239,15,15,39,739,739,724,724
San Joaquin,6,2022-01-23,11231,11231,7428,3803,56057,56057,37065,18992,231,33,33,66,2068,2068,2035,2035
San Luis Obispo,6,2022-01-23,3521,3521,2519,1002,20459,20459,14647,5812,42,11,11,10,401,401,390,390
San Mateo,6,2022-01-23,8920,8920,6755,2165,89981,89981,68176,21805,122,17,17,31,638,638,621,621
Santa Barbara,6,2022-01-23,6391,6391,4437,1954,41091,41091,28521,12570,122,15,15,17,613,613,598,598
Santa Clara,6,2022-01-23,23230,23230,20160,3070,222194,222194,192807,29387,458,51,51,94,2097,2097,2046,2046
Santa Cruz,6,2022-01-23,5140,5140,3752,1388,46371,46371,33880,12491,37,1,1,2,241,241,240,240
Shasta,6,2022-01-23,1463,1463,1002,461,9473,9473,6471,3002,65,5,5,10,479,479,474,474
Siskiyou,6,2022-01-23,161,161,118,43,832,832,609,223,5,3,3,1,68,68,65,65
Solano,6,2022-01-23,5012,5012,3507,1505,30830,30830,21567,9263,140,12,12,26,421,421,409,409
Sonoma,6,2022-01-23,7063,7063,4976,2087,40972,40972,28847,12125,91,7,7,15,451,451,444,444
Stanislaus,6,2022-01-23,6578,6578,3942,2636,27681,27681,16573,11108,270,27,27,39,1504,1504,1477,1477
Sutter,6,2022-01-23,1085,1085,754,331,4985,4985,3461,1524,0,2,2,0,205,205,203,203
Tehama,6,2022-01-23,561,561,342,219,2462,2462,1497,965,14,5,5,5,178,178,173,173
Trinity,6,2022-01-23,65,65,39,26,317,317,191,126,0,0,0,0,20,20,20,20
Tulare,6,2022-01-23,7730,7730,4587,3143,28291,28291,16769,11522,119,10,10,14,1359,1359,1349,1349
Tuolumne,6,2022-01-23,867,867,563,304,3507,3507,2269,1238,16,2,2,3,164,164,162,162
Ventura,6,2022-01-23,9808,9808,7581,2227,64842,64842,50113,14729,294,32,32,50,1325,1325,1293,1293
Yolo,6,2022-01-23,2305,2305,1662,643,38562,38562,27853,10709,16,12,12,5,322,322,310,310
Yuba,6,2022-01-23,961,961,682,279,3746,3746,2656,1090,56,2,2,7,108,108,106,106
Alameda,7,2022-01-30,12120,12120,9547,2573,141030,141030,111062,29968,339,53,53,77,1689,1689,1636,1636
Amador,7,2022-01-30,350,350,243,107,3285,3285,2283,1002,12,1,1,4,74,74,73,73
Butte,7,2022-01-30,1256,1256,1031,225,7986,7986,6545,1441,86,7,7,8,386,386,379,379
Calaveras,7,2022-01-30,272,272,197,75,1920,1920,1388,532,1,6,6,2,104,104,98,98
Colusa,7,2022-01-30,112,112,85,27,694,694,524,170,8,0,0,0,21,21,21,21
Contra Costa,7,2022-01-30,8253,8253,5676,2577,71153,71153,48968,22185,217,34,34,57,1184,1184,1150,1150
Del Norte,7,2022-01-30,341,341,254,87,4189,4189,3113,1076,5,2,2,3,44,44,42,42
El Dorado,7,2022-01-30,801,801,580,221,6148,6148,4456,1692,11,5,5,5,199,199,194,194
Fresno,7,2022-01-30,11996,11996,8401,3595,57045,57045,39953,17092,482,45,45,105,2569,2569,2524,2524
Glenn,7,2022-01-30,204,204,149,55,797,797,581,216,2,3,3,0,48,48,45,45
Humboldt,7,2022-01-30,597,597,443,154,6105,6105,4523,1582,23,4,4,2,135,135,131,131
Imperial,7,2022-01-30,2477,2477,1783,694,11842,11842,8534,3308,74,15,15,28,893,893,878,878
Inyo,7,2022-01-30,65,65,49,16,504,504,379,125,4,2,2,0,55,55,53,53
Kern,7,2022-01-30,6145,6145,4671,1474,43372,43372,32951,10421,258,39,39,49,2192,2192,2153,2153
Kings,7,2022-01-30,2672,2672,1931,741,14814,14814,10702,4112,49,4,4,4,406,406,402,402
Lake,7,2022-01-30,557,557,387,170,3381,3381,2346,1035,4,5,5,4,127,127,122,122
Lassen,7,2022-01-30,336,336,261,75,3558,3558,2756,802,6,1,1,0,55,55,54,54
Los Angeles,7,2022-01-30,84846,84846,76641,8205,1310040,1310050,1183978,126072,2971,618,618,749,29550,29550,28932,28932
Madera,7,2022-01-30,1807,1807,1261,546,9679,9679,6743,2936,48,4,4,7,357,357,353,353
Marin,7,2022-01-30,1168,1168,824,344,14164,14164,9995,4169,27,5,5,12,217,217,212,212
Mariposa,7,2022-01-30,104,104,72,32,878,878,604,274,0,1,1,0,23,23,22,22
Mendocino,7,2022-01-30,516,516,327,189,3550,3550,2255,1295,14,4,4,2,114,114,110,110
Merced,7,2022-01-30,2467,2467,1855,612,10870,10870,8177,2693,41,11,11,13,757,757,746,746
Modoc,7,2022-01-30,11,11,8,3,99,99,75,24,2,1,1,0,8,8,7,7
Mono,7,2022-01-30,43,43,25,18,340,340,202,138,0,0,0,0,5,5,5,5
Monterey,7,2022-01-30,3801,3801,2259,1542,26664,26664,15861,10803,79,9,9,16,677,677,668,668
Napa,7,2022-01-30,1091,1091,847,244,9709,9709,7532,2177,17,5,5,5,123,123,118,118
Nevada,7,2022-01-30,641,641,449,192,4118,4118,2880,1238,27,3,3,6,119,119,116,116
Orange,7,2022-01-30,13572,13572,10856,2716,182749,182749,146132,36617,760,173,173,174,6632,6632,6459,6459
Placer,7,2022-01-30,2494,2494,1700,794,15917,15917,10846,5071,163,16,16,40,560,560,544,544
Plumas,7,2022-01-30,144,144,102,42,752,752,532,220,2,0,0,0,12,12,12,12
Riverside,7,2022-01-30,18319,18319,13697,4622,125649,125649,94058,31591,748,111,111,163,6088,6088,5977,5977
Sacramento,7,2022-01-30,11331,11331,8310,3021,80818,80818,59282,21536,494,93,93,101,2786,2786,2693,2693
San Benito,7,2022-01-30,530,530,409,121,3344,3344,2582,762,4,1,1,3,89,89,88,88
San Bernardino,7,2022-01-30,15032,15032,11821,3211,121061,121061,95275,25786,736,183,183,217,7263,7263,7080,7080
San Diego,7,2022-01-30,27193,27193,24426,2767,189639,189639,170409,19230,969,108,108,211,4937,4937,4829,4829
San Francisco,7,2022-01-30,4576,4576,2620,1956,73565,73565,42186,31379,210,24,24,48,763,763,739,739
San Joaquin,7,2022-01-30,6335,6335,4518,1817,45232,45232,32250,12982,218,35,35,72,2103,2103,2068,2068
San Luis Obispo,7,2022-01-30,2280,2280,1737,543,17123,17123,13054,4069,45,11,11,8,412,412,401,401
San Mateo,7,2022-01-30,4871,4871,3893,978,78237,78237,62513,15724,121,14,14,30,652,652,638,638
Santa Barbara,7,2022-01-30,4080,4080,3027,1053,35741,35741,26535,9206,96,20,20,12,633,633,613,613
Santa Clara,7,2022-01-30,15211,15211,13587,1624,209488,209488,187132,22356,429,52,52,94,2149,2149,2097,2097
Santa Cruz,7,2022-01-30,3511,3511,2715,796,46804,46804,36250,10554,38,5,5,5,246,246,241,241
Shasta,7,2022-01-30,1019,1019,748,271,8738,8738,6406,2332,64,14,14,8,493,493,479,479
Siskiyou,7,2022-01-30,114,114,89,25,675,675,524,151,11,1,1,2,69,69,68,68
Solano,7,2022-01-30,4088,4088,3063,1025,29834,29834,22332,7502,126,8,8,31,429,429,421,421
Sonoma,7,2022-01-30,4010,4010,3013,997,33097,33097,24869,8228,82,10,10,12,461,461,451,451
Stanislaus,7,2022-01-30,3900,3900,2558,1342,22558,22558,14791,7767,266,32,32,51,1536,1536,1504,1504
Sutter,7,2022-01-30,686,686,511,175,3889,3889,2890,999,0,2,2,0,207,207,205,205
Tehama,7,2022-01-30,403,403,268,135,2164,2164,1435,729,17,3,3,5,181,181,178,178
Trinity,7,2022-01-30,40,40,27,13,217,217,143,74,0,0,0,0,20,20,20,20
Tulare,7,2022-01-30,5203,5203,3384,1819,24400,24400,15855,8545,141,19,19,17,1378,1378,1359,1359
Tuolumne,7,2022-01-30,792,792,553,239,3406,3406,2381,1025,14,1,1,4,165,165,164,164
Ventura,7,2022-01-30,5199,5199,4225,974,54462,54462,44236,10226,252,33,33,55,1358,1358,1325,1325
Yolo,7,2022-01-30,1508,1508,1157,351,37784,37784,29052,8732,17,3,3,5,325,325,322,322
Yuba,7,2022-01-30,557,557,422,135,3011,3011,2278,733,71,3,3,8,111,111,108,108
Alameda,8,2022-02-06,6613,6613,5463,1150,120099,120099,99210,20889,278,43,43,62,1732,1732,1689,1689
Amador,8,2022-02-06,225,225,167,58,2991,2991,2223,768,12,3,3,4,77,77,74,74
Butte,8,2022-02-06,859,859,734,125,6638,6638,5664,974,73,7,7,10,393,393,386,386
Calaveras,8,2022-02-06,212,212,163,49,1557,1557,1197,360,2,2,2,1,106,106,104,104
Colusa,8,2022-02-06,81,81,65,16,567,567,452,115,3,0,0,0,21,21,21,21
Contra Costa,8,2022-02-06,4462,4462,3298,1164,56461,56461,41703,14758,168,34,34,52,1218,1218,1184,1184
Del Norte,8,2022-02-06,271,271,214,57,4059,4059,3200,859,6,0,0,0,44,44,44,44
El Dorado,8,2022-02-06,488,488,376,112,5150,5150,3971,1179,24,1,1,5,200,200,199,199
Fresno,8,2022-02-06,7103,7103,5325,1778,44977,44977,33725,11252,429,45,45,95,2614,2614,2569,2569
Glenn,8,2022-02-06,132,132,102,30,658,658,509,149,2,2,2,0,50,50,48,48
Humboldt,8,2022-02-06,498,498,392,106,5006,5006,3934,1072,12,1,1,3,136,136,135,135
Imperial,8,2022-02-06,1239,1239,951,288,8572,8572,6581,1991,52,14,14,27,907,907,893,893
Inyo,8,2022-02-06,53,53,42,11,452,452,360,92,5,1,1,1,56,56,55,55
Kern,8,2022-02-06,3786,3786,3038,748,35784,35784,28694,7090,182,42,42,49,2234,2234,2192,2192
Kings,8,2022-02-06,1481,1481,1140,341,10651,10651,8195,2456,47,13,13,6,419,419,406,406
Lake,8,2022-02-06,367,367,274,93,2740,2740,2039,701,7,1,1,5,128,128,127,127
Lassen,8,2022-02-06,144,144,117,27,2968,2968,2414,554,5,2,2,0,57,57,55,55
Los Angeles,8,2022-02-06,41938,41938,38709,3229,1161385,1161395,1072344,89051,2181,649,649,592,30199,30199,29550,29550
Madera,8,2022-02-06,1173,1173,876,297,8446,8446,6308,2138,34,5,5,14,362,362,357,357
Marin,8,2022-02-06,705,705,532,173,11790,11790,8890,2900,28,6,6,6,223,223,217,217
Mariposa,8,2022-02-06,55,55,41,14,623,623,460,163,0,1,1,0,24,24,23,23
Mendocino,8,2022-02-06,357,357,247,110,2936,2936,2027,909,9,1,1,6,115,115,114,114
Merced,8,2022-02-06,1416,1416,1127,289,8383,8383,6670,1713,50,10,10,14,767,767,757,757
Modoc,8,2022-02-06,23,23,18,5,160,160,129,31,3,0,0,0,8,8,8,8
Mono,8,2022-02-06,45,45,29,16,268,268,174,94,0,0,0,0,5,5,5,5
Monterey,8,2022-02-06,2443,2443,1595,848,22906,22906,14944,7962,73,10,10,14,687,687,677,677
Napa,8,2022-02-06,798,798,652,146,8029,8029,6551,1478,12,8,8,1,131,131,123,123
Nevada,8,2022-02-06,381,381,286,95,3263,3263,2445,818,23,3,3,2,122,122,119,119
Orange,8,2022-02-06,7143,7143,5979,1164,155037,155037,129693,25344,497,118,118,123,6750,6750,6632,6632
Placer,8,2022-02-06,1444,1444,1059,385,12548,12548,9191,3357,148,24,24,35,584,584,560,560
Plumas,8,2022-02-06,91,91,69,22,579,579,437,142,1,1,1,0,13,13,12,12
Riverside,8,2022-02-06,9075,9075,7192,1883,98019,98019,77654,20365,564,107,107,122,6195,6195,6088,6088
Sacramento,8,2022-02-06,6674,6674,5206,1468,65705,65705,51207,14498,398,74,74,97,2860,2860,2786,2786
San Benito,8,2022-02-06,318,318,259,59,2775,2775,2254,521,4,1,1,4,90,90,89,89
San Bernardino,8,2022-02-06,7836,7836,6469,1367,93625,93625,77293,16332,527,154,154,170,7417,7417,7263,7263
San Diego,8,2022-02-06,14802,14802,13605,1197,156764,156764,144107,12657,783,116,116,176,5053,5053,4937,4937
San Francisco,8,2022-02-06,2561,2561,1624,937,56722,56722,35932,20790,175,26,26,39,789,789,763,763
San Joaquin,8,2022-02-06,3764,3764,2867,897,38200,38200,29091,9109,193,40,40,59,2143,2143,2103,2103
San Luis Obispo,8,2022-02-06,1378,1378,1108,270,13209,13209,10631,2578,29,15,15,7,427,427,412,412
San Mateo,8,2022-02-06,2698,2698,2258,440,63553,63553,53131,10422,99,16,16,18,668,668,652,652
Santa Barbara,8,2022-02-06,2641,2641,2079,562,33158,33158,26094,7064,79,17,17,19,650,650,633,633
Santa Clara,8,2022-02-06,8883,8883,8127,756,178891,178891,163606,15285,370,31,31,75,2180,2180,2149,2149
Santa Cruz,8,2022-02-06,2047,2047,1666,381,39173,39173,31834,7339,25,3,3,7,249,249,246,246
Shasta,8,2022-02-06,711,711,555,156,7100,7100,5528,1572,62,16,16,13,509,509,493,493
Siskiyou,8,2022-02-06,99,99,81,18,710,710,579,131,8,3,3,0,72,72,69,69
Solano,8,2022-02-06,2469,2469,1952,517,24394,24394,19308,5086,97,5,5,27,434,434,429,429
Sonoma,8,2022-02-06,2272,2272,1809,463,27713,27713,22030,5683,59,8,8,11,469,469,461,461
Stanislaus,8,2022-02-06,2751,2751,1952,799,19565,19565,13874,5691,231,43,43,41,1579,1579,1536,1536
Sutter,8,2022-02-06,407,407,321,86,3462,3462,2726,736,0,7,7,0,214,214,207,207
Tehama,8,2022-02-06,311,311,223,88,1725,1725,1235,490,17,1,1,6,182,182,181,181
Trinity,8,2022-02-06,23,23,16,7,149,149,105,44,0,0,0,0,20,20,20,20
Tulare,8,2022-02-06,3020,3020,2129,891,18558,18558,13068,5490,131,32,32,22,1410,1410,1378,1378
Tuolumne,8,2022-02-06,406,406,304,102,2674,2674,2002,672,11,3,3,1,168,168,165,165
Ventura,8,2022-02-06,2893,2893,2455,438,42923,42923,36365,6558,206,44,44,42,1402,1402,1358,1358
Yolo,8,2022-02-06,936,936,758,178,31964,31964,25877,6087,10,12,12,5,337,337,325,325
Yuba,8,2022-02-06,377,377,301,76,2477,2477,1979,498,50,5,5,13,116,116,111,111
Alameda,9,2022-02-13,3814,3814,3277,537,102454,102454,88002,14452,191,43,43,53,1775,1775,1732,1732
Amador,9,2022-02-13,110,110,87,23,2447,2447,1928,519,7,2,2,4,79,79,77,77
Butte,9,2022-02-13,519,519,458,61,5735,5735,5057,678,66,10,10,8,403,403,393,393
Calaveras,9,2022-02-13,99,99,80,19,1303,1303,1055,248,4,2,2,2,108,108,106,106
Colusa,9,2022-02-13,43,43,36,7,520,520,433,87,4,0,0,0,21,21,21,21
Contra Costa,9,2022-02-13,2697,2697,2115,582,46189,46189,36204,9985,133,25,25,33,1243,1243,1218,1218
Del Norte,9,2022-02-13,234,234,193,41,3537,3537,2921,616,7,0,0,2,44,44,44,44
El Dorado,9,2022-02-13,285,285,232,53,4640,4640,3767,873,22,4,4,3,204,204,200,200
Fresno,9,2022-02-13,4195,4195,3330,865,36170,36170,28705,7465,370,35,35,76,2649,2649,2614,2614
Glenn,9,2022-02-13,65,65,53,12,497,497,405,92,4,3,3,0,53,53,50,50
Humboldt,9,2022-02-13,366,366,302,64,4437,4437,3658,779,17,0,0,2,136,136,136,136
Imperial,9,2022-02-13,680,680,550,130,6455,6455,5224,1231,47,14,14,19,921,921,907,907
Inyo,9,2022-02-13,28,28,23,5,406,406,338,68,3,0,0,0,56,56,56,56
Kern,9,2022-02-13,2314,2314,1941,373,29985,29985,25140,4845,155,30,30,43,2264,2264,2234,2234
Kings,9,2022-02-13,872,872,707,165,8414,8414,6818,1596,44,9,9,5,428,428,419,419
Lake,9,2022-02-13,258,258,204,54,2406,2406,1896,510,6,2,2,5,130,130,128,128
Lassen,9,2022-02-13,149,149,127,22,3135,3135,2658,477,3,2,2,0,59,59,57,57
Los Angeles,9,2022-02-13,23798,23798,22347,1451,1066048,1066057,1001134,64923,1617,516,516,437,30715,30715,30199,30199
Madera,9,2022-02-13,686,686,543,143,6949,6949,5496,1453,35,3,3,9,365,365,362,362
Marin,9,2022-02-13,409,409,326,83,10309,10309,8221,2088,24,7,7,6,230,230,223,223
Mariposa,9,2022-02-13,26,26,20,6,434,434,340,94,0,0,0,0,24,24,24,24
Mendocino,9,2022-02-13,221,221,164,57,2486,2486,1841,645,13,2,2,5,117,117,115,115
Merced,9,2022-02-13,849,849,708,141,7250,7250,6040,1210,40,12,12,7,779,779,767,767
Modoc,9,2022-02-13,20,20,17,3,184,184,154,30,0,0,0,0,8,8,8,8
Mono,9,2022-02-13,14,14,10,4,183,183,129,54,0,0,0,0,5,5,5,5
Monterey,9,2022-02-13,1387,1387,980,407,18568,18568,13102,5466,70,14,14,12,701,701,687,687
Napa,9,2022-02-13,442,442,376,66,6807,6807,5787,1020,15,2,2,2,133,133,131,131
Nevada,9,2022-02-13,200,200,159,41,2707,2707,2145,562,17,1,1,3,123,123,122,122
Orange,9,2022-02-13,4375,4375,3800,575,135852,135852,117826,18026,364,121,121,89,6871,6871,6750,6750
Placer,9,2022-02-13,696,696,542,154,10389,10389,8085,2304,112,14,14,22,598,598,584,584
Plumas,9,2022-02-13,48,48,38,10,442,442,352,90,3,0,0,0,13,13,13,13
Riverside,9,2022-02-13,5150,5150,4279,871,78663,78663,65307,13356,395,91,91,95,6286,6286,6195,6195
Sacramento,9,2022-02-13,3772,3772,3092,680,55625,55625,45565,10060,345,58,58,67,2918,2918,2860,2860
San Benito,9,2022-02-13,178,178,151,27,2284,2284,1935,349,3,2,2,3,92,92,90,90
San Bernardino,9,2022-02-13,4196,4196,3603,593,76621,76621,65781,10840,374,111,111,125,7528,7528,7417,7417
San Diego,9,2022-02-13,8849,8849,8281,568,130980,130980,122581,8399,584,94,94,144,5147,5147,5053,5053
San Francisco,9,2022-02-13,1736,1736,1195,541,48826,48826,33633,15193,128,28,28,39,817,817,789,789
San Joaquin,9,2022-02-13,2252,2252,1812,440,32290,32290,25949,6341,136,38,38,48,2181,2181,2143,2143
San Luis Obispo,9,2022-02-13,878,878,738,140,10481,10481,8816,1665,22,10,10,7,437,437,427,427
San Mateo,9,2022-02-13,1461,1461,1268,193,56657,56657,49139,7518,61,17,17,16,685,685,668,668
Santa Barbara,9,2022-02-13,1208,1208,999,209,23305,23305,19260,4045,64,8,8,13,658,658,650,650
Santa Clara,9,2022-02-13,5117,5117,4771,346,159778,159778,148918,10860,302,29,29,60,2209,2209,2180,2180
Santa Cruz,9,2022-02-13,1139,1139,965,174,34451,34451,29194,5257,22,4,4,4,253,253,249,249
Shasta,9,2022-02-13,486,486,398,88,6152,6152,5034,1118,60,11,11,13,520,520,509,509
Siskiyou,9,2022-02-13,79,79,67,12,583,583,495,88,3,1,1,2,73,73,72,72
Solano,9,2022-02-13,1339,1339,1111,228,20189,20189,16744,3445,74,1,1,20,435,435,434,434
Sonoma,9,2022-02-13,1308,1308,1090,218,23115,23115,19233,3882,50,9,9,15,478,478,469,469
Stanislaus,9,2022-02-13,1567,1567,1188,379,16050,16050,12157,3893,214,28,28,43,1607,1607,1579,1579
Sutter,9,2022-02-13,233,233,193,40,2954,2954,2441,513,0,3,3,0,217,217,214,214
Tehama,9,2022-02-13,194,194,149,45,1481,1481,1132,349,14,7,7,5,189,189,182,182
Trinity,9,2022-02-13,20,20,15,5,172,172,131,41,0,0,0,0,20,20,20,20
Tulare,9,2022-02-13,1702,1702,1283,419,16191,16191,12206,3985,122,24,24,20,1434,1434,1410,1410
Tuolumne,9,2022-02-13,218,218,173,45,2321,2321,1840,481,11,4,4,1,172,172,168,168
Ventura,9,2022-02-13,1690,1690,1483,207,37980,37980,33291,4689,146,36,36,27,1438,1438,1402,1402
Yolo,9,2022-02-13,551,551,465,86,28601,28601,24173,4428,13,8,8,3,345,345,337,337
Yuba,9,2022-02-13,229,229,192,37,2197,2197,1837,360,24,2,2,12,118,118,116,116
Alameda,10,2022-02-20,2178,2178,1932,246,89854,89854,79642,10212,148,28,28,33,1803,1803,1775,1775
Amador,10,2022-02-20,86,86,71,15,2144,2144,1773,371,6,5,5,3,84,84,79,79
Butte,10,2022-02-20,302,302,274,28,4860,4860,4402,458,64,11,11,5,414,414,403,403
Calaveras,10,2022-02-20,48,48,41,7,936,936,791,145,4,5,5,1,113,113,108,108
Colusa,10,2022-02-20,25,25,22,3,382,382,331,51,4,0,0,0,21,21,21,21
Contra Costa,10,2022-02-20,1529,1529,1259,270,39490,39490,32484,7006,80,19,19,26,1262,1262,1243,1243
Del Norte,10,2022-02-20,147,147,126,21,2969,2969,2548,421,9,0,0,1,44,44,44,44
El Dorado,10,2022-02-20,170,170,144,26,4019,4019,3406,613,5,2,2,4,206,206,204,204
Fresno,10,2022-02-20,2357,2357,1960,397,29634,29634,24640,4994,274,31,31,63,2680,2680,2649,2649
Glenn,10,2022-02-20,31,31,26,5,444,444,377,67,2,0,0,0,53,53,53,53
Humboldt,10,2022-02-20,228,228,196,32,3730,3730,3200,530,17,3,3,2,139,139,136,136
Imperial,10,2022-02-20,426,426,360,66,5183,5183,4383,800,33,6,6,10,927,927,921,921
Inyo,10,2022-02-20,13,13,11,2,372,372,321,51,1,0,0,0,56,56,56,56
Kern,10,2022-02-20,1402,1402,1221,181,25803,25803,22451,3352,94,23,23,26,2287,2287,2264,2264
Kings,10,2022-02-20,553,553,469,84,7352,7352,6227,1125,29,5,5,6,433,433,428,428
Lake,10,2022-02-20,213,213,176,37,2208,2208,1827,381,7,2,2,1,132,132,130,130
Lassen,10,2022-02-20,125,125,110,15,2336,2336,2050,286,4,0,0,0,59,59,59,59
Los Angeles,10,2022-02-20,13640,13640,12984,656,947010,947018,901270,45748,1021,342,342,289,31057,31057,30715,30715
Madera,10,2022-02-20,401,401,332,69,5834,5834,4835,999,30,2,2,6,367,367,365,365
Marin,10,2022-02-20,253,253,211,42,9916,9916,8277,1639,13,3,3,4,233,233,230,230
Mariposa,10,2022-02-20,23,23,19,4,406,406,334,72,0,1,1,0,25,25,24,24
Mendocino,10,2022-02-20,132,132,104,28,2231,2231,1754,477,9,2,2,3,119,119,117,117
Merced,10,2022-02-20,540,540,468,72,5931,5931,5131,800,32,14,14,7,793,793,779,779
Modoc,10,2022-02-20,10,10,9,1,73,73,63,10,1,0,0,0,8,8,8,8
Mono,10,2022-02-20,8,8,6,2,174,174,131,43,0,1,1,0,6,6,5,5
Monterey,10,2022-02-20,925,925,700,225,15189,15189,11481,3708,53,6,6,7,707,707,701,701
Napa,10,2022-02-20,284,284,250,34,5779,5779,5082,697,6,3,3,3,136,136,133,133
Nevada,10,2022-02-20,125,125,104,21,2381,2381,1978,403,17,4,4,3,127,127,123,123
Orange,10,2022-02-20,2802,2802,2506,296,126511,126511,113034,13477,258,79,79,76,6950,6950,6871,6871
Placer,10,2022-02-20,368,368,302,66,9421,9421,7712,1709,100,10,10,12,608,608,598,598
Plumas,10,2022-02-20,25,25,21,4,391,391,326,65,1,0,0,0,13,13,13,13
Riverside,10,2022-02-20,2761,2761,2382,379,66933,66933,57753,9180,259,53,53,62,6339,6339,6286,6286
Sacramento,10,2022-02-20,2297,2297,1961,336,48700,48700,41554,7146,268,38,38,40,2956,2956,2918,2918
San Benito,10,2022-02-20,133,133,117,16,2053,2053,1801,252,0,0,0,1,92,92,92,92
San Bernardino,10,2022-02-20,2179,2179,1932,247,66257,66257,58741,7516,261,96,96,82,7624,7624,7528,7528
San Diego,10,2022-02-20,5137,5137,4877,260,110575,110575,104964,5611,461,67,67,115,5214,5214,5147,5147
San Francisco,10,2022-02-20,1090,1090,806,284,44602,44602,32976,11626,107,11,11,26,828,828,817,817
San Joaquin,10,2022-02-20,1224,1224,1029,195,27392,27392,23010,4382,89,24,24,34,2205,2205,2181,2181
San Luis Obispo,10,2022-02-20,557,557,485,72,8982,8982,7830,1152,21,14,14,2,451,451,437,437
San Mateo,10,2022-02-20,840,840,750,90,49042,49042,43804,5238,47,5,5,10,690,690,685,685
Santa Barbara,10,2022-02-20,725,725,623,102,21502,21502,18468,3034,41,7,7,11,665,665,658,658
Santa Clara,10,2022-02-20,2876,2876,2722,154,140229,140229,132672,7557,230,26,26,55,2235,2235,2209,2209
Santa Cruz,10,2022-02-20,667,667,585,82,28110,28110,24663,3447,19,1,1,4,254,254,253,253
Shasta,10,2022-02-20,311,311,265,46,5368,5368,4576,792,54,11,11,13,531,531,520,520
Siskiyou,10,2022-02-20,49,49,43,6,532,532,468,64,8,2,2,3,75,75,73,73
Solano,10,2022-02-20,779,779,671,108,16658,16658,14362,2296,52,5,5,15,440,440,435,435
Sonoma,10,2022-02-20,720,720,623,97,18882,18882,16319,2563,35,2,2,9,480,480,478,478
Stanislaus,10,2022-02-20,857,857,686,171,13267,13267,10618,2649,157,29,29,30,1636,1636,1607,1607
Sutter,10,2022-02-20,148,148,127,21,2396,2396,2058,338,0,1,1,0,218,218,217,217
Tehama,10,2022-02-20,106,106,86,20,1270,1270,1024,246,6,7,7,5,196,196,189,189
Trinity,10,2022-02-20,17,17,14,3,217,217,174,43,0,0,0,0,20,20,20,20
Tulare,10,2022-02-20,897,897,715,182,12332,12332,9823,2509,94,19,19,8,1453,1453,1434,1434
Tuolumne,10,2022-02-20,112,112,93,19,1942,1942,1612,330,4,5,5,2,177,177,172,172
Ventura,10,2022-02-20,982,982,886,96,30824,30824,27778,3046,107,22,22,20,1460,1460,1438,1438
Yolo,10,2022-02-20,323,323,283,40,23554,23554,20613,2941,7,5,5,3,350,350,345,345
Yuba,10,2022-02-20,148,148,128,20,1771,1771,1536,235,23,2,2,8,120,120,118,118
Alameda,11,2022-02-27,1430,1430,1302,128,69556,69556,63312,6244,115,14,14,24,1817,1817,1803,1803
Amador,11,2022-02-27,64,64,55,9,1975,1975,1701,274,7,0,0,2,84,84,84,84
Butte,11,2022-02-27,180,180,167,13,4189,4189,3876,313,42,7,7,2,421,421,414,414
Calaveras,11,2022-02-27,35,35,31,4,1073,1073,941,132,0,4,4,0,117,117,113,113
Colusa,11,2022-02-27,11,11,10,1,375,375,335,40,4,0,0,0,21,21,21,21
Contra Costa,11,2022-02-27,933,933,800,133,31817,31817,27286,4531,67,15,15,16,1277,1277,1262,1262
Del Norte,11,2022-02-27,81,81,72,9,2643,2643,2342,301,4,2,2,3,46,46,44,44
El Dorado,11,2022-02-27,109,109,96,13,3352,3352,2942,410,4,2,2,3,208,208,206,206
Fresno,11,2022-02-27,1307,1307,1130,177,24722,24722,21367,3355,198,26,26,51,2706,2706,2680,2680
Glenn,11,2022-02-27,19,19,17,2,395,395,347,48,0,1,1,0,54,54,53,53
Humboldt,11,2022-02-27,146,146,130,16,2765,2765,2450,315,6,1,1,2,140,140,139,139
Imperial,11,2022-02-27,282,282,247,35,4458,4458,3904,554,12,6,6,11,933,933,927,927
Inyo,11,2022-02-27,9,9,8,1,331,331,295,36,0,0,0,0,56,56,56,56
Kern,11,2022-02-27,810,810,726,84,22408,22408,20079,2329,78,17,17,21,2304,2304,2287,2287
Kings,11,2022-02-27,246,246,216,30,5783,5783,5069,714,23,6,6,3,439,439,433,433
Lake,11,2022-02-27,124,124,107,17,1816,1816,1563,253,3,3,3,1,135,135,132,132
Lassen,11,2022-02-27,48,48,43,5,1918,1918,1729,189,1,2,2,0,61,61,59,59
Los Angeles,11,2022-02-27,8233,8233,7923,310,954720,954730,918814,35916,734,223,223,182,31280,31280,31057,31057
Madera,11,2022-02-27,191,191,165,26,4221,4221,3642,579,22,2,2,5,369,369,367,367
Marin,11,2022-02-27,139,139,121,18,7126,7126,6180,946,10,3,3,2,236,236,233,233
Mariposa,11,2022-02-27,32,32,27,5,325,325,278,47,0,1,1,0,26,26,25,25
Mendocino,11,2022-02-27,77,77,64,13,1726,1726,1426,300,12,1,1,4,120,120,119,119
Merced,11,2022-02-27,258,258,231,27,4682,4682,4177,505,25,8,8,3,801,801,793,793
Modoc,11,2022-02-27,6,6,5,1,49,49,44,5,1,0,0,0,8,8,8,8
Mono,11,2022-02-27,4,4,3,1,162,162,129,33,0,0,0,0,6,6,6,6
Monterey,11,2022-02-27,357,357,286,71,12498,12498,9997,2501,27,9,9,6,716,716,707,707
Napa,11,2022-02-27,179,179,162,17,5010,5010,4531,479,8,4,4,2,140,140,136,136
Nevada,11,2022-02-27,74,74,64,10,1954,1954,1688,266,9,0,0,3,127,127,127,127
Orange,11,2022-02-27,1777,1777,1628,149,114537,114537,104915,9622,189,50,50,41,7000,7000,6950,6950
Placer,11,2022-02-27,242,242,207,35,7816,7816,6668,1148,71,3,3,14,611,611,608,608
Plumas,11,2022-02-27,24,24,21,3,338,338,293,45,0,0,0,0,13,13,13,13
Riverside,11,2022-02-27,1713,1713,1525,188,59410,59410,52888,6522,200,41,41,43,6380,6380,6339,6339
Sacramento,11,2022-02-27,1156,1156,1021,135,41254,41254,36413,4841,181,28,28,35,2984,2984,2956,2956
San Benito,11,2022-02-27,51,51,46,5,1594,1594,1439,155,0,0,0,1,92,92,92,92
San Bernardino,11,2022-02-27,1197,1197,1089,108,56509,56509,51412,5097,165,68,68,50,7692,7692,7624,7624
San Diego,11,2022-02-27,3079,3079,2957,122,93799,93799,90074,3725,351,36,36,84,5250,5250,5214,5214
San Francisco,11,2022-02-27,849,849,667,182,36927,36927,29015,7912,76,14,14,20,842,842,828,828
San Joaquin,11,2022-02-27,668,668,583,85,23715,23715,20669,3046,62,15,15,21,2220,2220,2205,2205
San Luis Obispo,11,2022-02-27,315,315,283,32,7533,7533,6766,767,12,8,8,3,459,459,451,451
San Mateo,11,2022-02-27,562,562,515,47,35511,35511,32515,2996,38,7,7,8,697,697,690,690
Santa Barbara,11,2022-02-27,373,373,331,42,19536,19536,17335,2201,31,5,5,11,670,670,665,665
Santa Clara,11,2022-02-27,1726,1726,1654,72,86168,86168,82560,3608,203,24,24,43,2259,2259,2235,2235
Santa Cruz,11,2022-02-27,465,465,420,45,23808,23808,21492,2316,15,2,2,4,256,256,254,254
Shasta,11,2022-02-27,164,164,145,19,4639,4639,4090,549,42,12,12,8,543,543,531,531
Siskiyou,11,2022-02-27,25,25,23,2,403,403,364,39,3,4,4,2,79,79,75,75
Solano,11,2022-02-27,476,476,424,52,14234,14234,12667,1567,45,2,2,17,442,442,440,440
Sonoma,11,2022-02-27,445,445,397,48,14990,14990,13369,1621,27,2,2,5,482,482,480,480
Stanislaus,11,2022-02-27,469,469,393,76,12109,12109,10148,1961,119,15,15,22,1651,1651,1636,1636
Sutter,11,2022-02-27,101,101,90,11,2200,2200,1953,247,0,2,2,0,220,220,218,218
Tehama,11,2022-02-27,57,57,48,9,1133,1133,955,178,7,4,4,2,200,200,196,196
Trinity,11,2022-02-27,5,5,4,1,107,107,90,17,0,0,0,0,20,20,20,20
Tulare,11,2022-02-27,482,482,403,79,11047,11047,9223,1824,68,16,16,9,1469,1469,1453,1453
Tuolumne,11,2022-02-27,77,77,66,11,1432,1432,1236,196,7,3,3,1,180,180,177,177
Ventura,11,2022-02-27,569,569,525,44,27253,27253,25122,2131,72,14,14,17,1474,1474,1460,1460
Yolo,11,2022-02-27,204,204,184,20,22970,22970,20694,2276,6,5,5,4,355,355,350,350
Yuba,11,2022-02-27,73,73,65,8,1701,1701,1520,181,14,2,2,6,122,122,120,120
Alameda,12,2022-03-06,1169,1169,1085,84,73661,73661,68346,5315,83,13,13,19,1830,1830,1817,1817
Amador,12,2022-03-06,76,76,67,9,1434,1434,1272,162,5,2,2,1,86,86,84,84
Butte,12,2022-03-06,122,122,115,7,3830,3830,3602,228,33,4,4,3,425,425,421,421
Calaveras,12,2022-03-06,31,31,28,3,1125,1125,1012,113,1,1,1,0,118,118,117,117
Colusa,12,2022-03-06,9,9,8,1,352,352,322,30,6,0,0,0,21,21,21,21
Contra Costa,12,2022-03-06,641,641,568,73,31729,31729,28066,3663,48,10,10,13,1287,1287,1277,1277
Del Norte,12,2022-03-06,52,52,47,5,1877,1877,1706,171,4,1,1,1,47,47,46,46
El Dorado,12,2022-03-06,87,87,79,8,3242,3242,2922,320,6,3,3,2,211,211,208,208
Fresno,12,2022-03-06,918,918,817,101,22465,22465,20005,2460,139,20,20,29,2726,2726,2706,2706
Glenn,12,2022-03-06,17,17,15,2,410,410,370,40,2,1,1,0,55,55,54,54
Humboldt,12,2022-03-06,92,92,84,8,3081,3081,2801,280,6,3,3,4,143,143,140,140
Imperial,12,2022-03-06,152,152,137,15,4461,4461,4015,446,9,5,5,10,938,938,933,933
Inyo,12,2022-03-06,9,9,8,1,364,364,332,32,0,0,0,0,56,56,56,56
Kern,12,2022-03-06,494,494,453,41,21520,21520,19723,1797,64,9,9,15,2313,2313,2304,2304
Kings,12,2022-03-06,159,159,143,16,5043,5043,4541,502,14,4,4,1,443,443,439,439
Lake,12,2022-03-06,69,69,61,8,1792,1792,1590,202,3,3,3,1,138,138,135,135
Lassen,12,2022-03-06,91,91,84,7,1917,1917,1766,151,0,1,1,0,62,62,61,61
Los Angeles,12,2022-03-06,5923,5923,5747,176,882178,882188,855932,26256,601,180,180,130,31460,31460,31280,31280
Madera,12,2022-03-06,128,128,114,14,4045,4045,3596,449,11,1,1,2,370,370,369,369
Marin,12,2022-03-06,166,166,148,18,7593,7593,6776,817,11,0,0,1,236,236,236,236
Mariposa,12,2022-03-06,13,13,11,2,303,303,268,35,0,1,1,0,27,27,26,26
Mendocino,12,2022-03-06,70,70,60,10,1745,1745,1497,248,7,1,1,1,121,121,120,120
Merced,12,2022-03-06,193,193,176,17,4663,4663,4260,403,19,7,7,6,808,808,801,801
Modoc,12,2022-03-06,1,1,1,0,54,54,49,5,0,0,0,0,8,8,8,8
Mono,12,2022-03-06,3,3,2,1,135,135,113,22,0,0,0,1,6,6,6,6
Monterey,12,2022-03-06,256,256,214,42,11407,11407,9528,1879,22,6,6,3,722,722,716,716
Napa,12,2022-03-06,202,202,187,15,4975,4975,4593,382,4,2,2,2,142,142,140,140
Nevada,12,2022-03-06,47,47,42,5,1741,1741,1550,191,4,2,2,0,129,129,127,127
Orange,12,2022-03-06,1355,1355,1265,90,109334,109334,101973,7361,142,29,29,37,7029,7029,7000,7000
Placer,12,2022-03-06,173,173,152,21,7835,7835,6904,931,57,3,3,12,614,614,611,611
Plumas,12,2022-03-06,5,5,4,1,275,275,245,30,0,0,0,0,13,13,13,13
Riverside,12,2022-03-06,1060,1060,967,93,54879,54879,50041,4838,141,30,30,31,6410,6410,6380,6380
Sacramento,12,2022-03-06,826,826,748,78,40165,40165,36367,3798,132,19,19,28,3003,3003,2984,2984
San Benito,12,2022-03-06,37,37,34,3,1542,1542,1421,121,0,2,2,1,94,94,92,92
San Bernardino,12,2022-03-06,855,855,793,62,54920,54920,50956,3964,88,37,37,45,7729,7729,7692,7692
San Diego,12,2022-03-06,2377,2377,2303,74,96488,96488,93458,3030,246,37,37,62,5287,5287,5250,5250
San Francisco,12,2022-03-06,691,691,570,121,38220,38220,31476,6744,56,8,8,11,850,850,842,842
San Joaquin,12,2022-03-06,461,461,414,47,21738,21738,19488,2250,41,9,9,17,2229,2229,2220,2220
San Luis Obispo,12,2022-03-06,299,299,274,25,7347,7347,6745,602,7,5,5,1,464,464,459,459
San Mateo,12,2022-03-06,556,556,519,37,41680,41680,38853,2827,32,1,1,4,698,698,697,697
Santa Barbara,12,2022-03-06,199,199,181,18,18123,18123,16479,1644,18,4,4,9,674,674,670,670
Santa Clara,12,2022-03-06,1488,1488,1439,49,116995,116995,113083,3912,140,13,13,43,2272,2272,2259,2259
Santa Cruz,12,2022-03-06,344,344,317,27,24982,24982,23022,1960,11,0,0,7,256,256,256,256
Shasta,12,2022-03-06,149,149,135,14,4965,4965,4494,471,33,11,11,4,554,554,543,543
Siskiyou,12,2022-03-06,15,15,14,1,414,414,382,32,2,1,1,0,80,80,79,79
Solano,12,2022-03-06,368,368,335,33,14032,14032,12788,1244,44,4,4,11,446,446,442,442
Sonoma,12,2022-03-06,371,371,339,32,15370,15370,14031,1339,26,4,4,7,486,486,482,482
Stanislaus,12,2022-03-06,296,296,257,39,11078,11078,9618,1460,98,11,11,14,1662,1662,1651,1651
Sutter,12,2022-03-06,86,86,78,8,1982,1982,1802,180,0,2,2,0,222,222,220,220
Tehama,12,2022-03-06,45,45,39,6,1202,1202,1049,153,3,2,2,1,202,202,200,200
Trinity,12,2022-03-06,5,5,4,1,114,114,99,15,0,0,0,0,20,20,20,20
Tulare,12,2022-03-06,316,316,274,42,10285,10285,8906,1379,39,9,9,5,1478,1478,1469,1469
Tuolumne,12,2022-03-06,54,54,48,6,1265,1265,1125,140,1,1,1,2,181,181,180,180
Ventura,12,2022-03-06,423,423,397,26,27176,27176,25480,1696,39,4,4,15,1478,1478,1474,1474
Yolo,12,2022-03-06,161,161,148,13,22287,22287,20506,1781,4,1,1,2,356,356,355,355
Yuba,12,2022-03-06,65,65,60,5,1586,1586,1451,135,17,0,0,6,122,122,122,122
Alameda,13,2022-03-13,946,946,892,54,68776,68776,64844,3932,71,9,9,6,1839,1839,1830,1830
Amador,13,2022-03-13,32,32,29,3,1434,1434,1305,129,4,0,0,0,86,86,86,86
Butte,13,2022-03-13,76,76,72,4,3609,3609,3440,169,22,2,2,1,427,427,425,425
Calaveras,13,2022-03-13,14,14,13,1,1034,1034,952,82,2,1,1,0,119,119,118,118
Colusa,13,2022-03-13,6,6,6,0,256,256,238,18,2,0,0,0,21,21,21,21
Contra Costa,13,2022-03-13,579,579,526,53,29136,29136,26449,2687,20,5,5,9,1292,1292,1287,1287
Del Norte,13,2022-03-13,42,42,39,3,1447,1447,1342,105,3,2,2,1,49,49,47,47
El Dorado,13,2022-03-13,46,46,42,4,3048,3048,2808,240,4,0,0,2,211,211,211,211
Fresno,13,2022-03-13,586,586,535,51,21421,21421,19549,1872,119,10,10,20,2736,2736,2726,2726
Glenn,13,2022-03-13,12,12,11,1,342,342,315,27,1,1,1,0,56,56,55,55
Humboldt,13,2022-03-13,59,59,55,4,2748,2748,2548,200,5,1,1,2,144,144,143,143
Imperial,13,2022-03-13,83,83,76,7,4556,4556,4191,365,5,2,2,8,940,940,938,938
Inyo,13,2022-03-13,8,8,7,1,170,170,158,12,0,0,0,0,56,56,56,56
Kern,13,2022-03-13,303,303,283,20,20230,20230,18892,1338,43,17,17,13,2330,2330,2313,2313
Kings,13,2022-03-13,217,217,200,17,4880,4880,4495,385,16,2,2,1,445,445,443,443
Lake,13,2022-03-13,57,57,52,5,1610,1610,1465,145,0,1,1,0,139,139,138,138
Lassen,13,2022-03-13,17,17,16,1,1489,1489,1396,93,0,0,0,0,62,62,62,62
Los Angeles,13,2022-03-13,4261,4261,4162,99,840947,840957,821310,19647,402,135,135,98,31595,31595,31460,31460
Madera,13,2022-03-13,74,74,67,7,3716,3716,3386,330,11,0,0,3,370,370,370,370
Marin,13,2022-03-13,172,172,157,15,6632,6632,6063,569,6,2,2,0,238,238,236,236
Mariposa,13,2022-03-13,8,8,7,1,228,228,207,21,0,0,0,0,27,27,27,27
Mendocino,13,2022-03-13,41,41,36,5,1482,1482,1313,169,4,0,0,1,121,121,121,121
Merced,13,2022-03-13,144,144,134,10,4213,4213,3924,289,19,2,2,5,810,810,808,808
Modoc,13,2022-03-13,3,3,3,0,56,56,52,4,1,0,0,0,8,8,8,8
Mono,13,2022-03-13,2,2,2,0,103,103,89,14,0,0,0,0,6,6,6,6
Monterey,13,2022-03-13,168,168,146,22,10355,10355,8974,1381,15,5,5,2,727,727,722,722
Napa,13,2022-03-13,140,140,131,9,4271,4271,4010,261,3,1,1,3,143,143,142,142
Nevada,13,2022-03-13,54,54,49,5,1609,1609,1468,141,2,0,0,1,129,129,129,129
Orange,13,2022-03-13,870,870,824,46,102991,102991,97514,5477,108,33,33,31,7062,7062,7029,7029
Placer,13,2022-03-13,156,156,141,15,7543,7543,6827,716,58,4,4,4,618,618,614,614
Plumas,13,2022-03-13,9,9,8,1,310,310,283,27,0,0,0,0,13,13,13,13
Riverside,13,2022-03-13,770,770,717,53,53117,53117,49411,3706,96,15,15,19,6425,6425,6410,6410
Sacramento,13,2022-03-13,615,615,569,46,37350,37350,34538,2812,113,15,15,21,3018,3018,3003,3003
San Benito,13,2022-03-13,40,40,38,2,1483,1483,1391,92,0,0,0,1,94,94,94,94
San Bernardino,13,2022-03-13,602,602,568,34,51566,51566,48615,2951,80,27,27,34,7756,7756,7729,7729
San Diego,13,2022-03-13,1868,1868,1822,46,96954,96954,94561,2393,168,18,18,50,5305,5305,5287,5287
San Francisco,13,2022-03-13,621,621,533,88,34994,34994,29991,5003,35,6,6,8,856,856,850,850
San Joaquin,13,2022-03-13,301,301,276,25,20532,20532,18840,1692,26,5,5,17,2234,2234,2229,2229
San Luis Obispo,13,2022-03-13,170,170,159,11,6944,6944,6492,452,6,7,7,1,471,471,464,464
San Mateo,13,2022-03-13,444,444,421,23,37441,37441,35436,2005,26,1,1,3,699,699,698,698
Santa Barbara,13,2022-03-13,194,194,180,14,17402,17402,16148,1254,17,6,6,2,680,680,674,674
Santa Clara,13,2022-03-13,1262,1262,1229,33,102658,102658,99966,2692,102,15,15,28,2287,2287,2272,2272
Santa Cruz,13,2022-03-13,238,238,223,15,22985,22985,21554,1431,8,3,3,4,259,259,256,256
Shasta,13,2022-03-13,103,103,95,8,4999,4999,4621,378,17,6,6,2,560,560,554,554
Siskiyou,13,2022-03-13,11,11,10,1,409,409,384,25,0,3,3,0,83,83,80,80
Solano,13,2022-03-13,242,242,225,17,12829,12829,11923,906,35,1,1,10,447,447,446,446
Sonoma,13,2022-03-13,230,230,214,16,13835,13835,12876,959,12,0,0,3,486,486,486,486
Stanislaus,13,2022-03-13,229,229,205,24,10175,10175,9099,1076,87,10,10,14,1672,1672,1662,1662
Sutter,13,2022-03-13,49,49,45,4,1811,1811,1680,131,0,0,0,0,222,222,222,222
Tehama,13,2022-03-13,23,23,21,2,1016,1016,912,104,1,2,2,0,204,204,202,202
Trinity,13,2022-03-13,3,3,3,0,97,97,87,10,0,0,0,0,20,20,20,20
Tulare,13,2022-03-13,196,196,175,21,9777,9777,8722,1055,34,4,4,3,1482,1482,1478,1478
Tuolumne,13,2022-03-13,25,25,23,2,1253,1253,1142,111,1,0,0,0,181,181,181,181
Ventura,13,2022-03-13,337,337,321,16,25117,25117,23876,1241,36,5,5,8,1483,1483,1478,1478
Yolo,13,2022-03-13,125,125,117,8,21634,21634,20262,1372,1,3,3,1,359,359,356,356
Yuba,13,2022-03-13,34,34,32,2,1453,1453,1355,98,9,2,2,3,124,124,122,122
Alameda,14,2022-03-20,715,715,683,32,67673,67673,64617,3056,57,6,6,2,1845,1845,1839,1839
Amador,14,2022-03-20,28,28,26,2,1376,1376,1277,99,2,0,0,0,86,86,86,86
Butte,14,2022-03-20,85,85,82,3,3216,3216,3097,119,16,0,0,1,427,427,427,427
Calaveras,14,2022-03-20,13,13,12,1,657,657,616,41,0,0,0,0,119,119,119,119
Colusa,14,2022-03-20,3,3,3,0,250,250,236,14,1,0,0,0,21,21,21,21
Contra Costa,14,2022-03-20,462,462,428,34,27869,27869,25821,2048,24,5,5,11,1297,1297,1292,1292
Del Norte,14,2022-03-20,21,21,20,1,1289,1289,1215,74,0,0,0,1,49,49,49,49
El Dorado,14,2022-03-20,42,42,39,3,2816,2816,2640,176,2,2,2,0,213,213,211,211
Fresno,14,2022-03-20,353,353,329,24,19672,19672,18305,1367,88,12,12,13,2748,2748,2736,2736
Glenn,14,2022-03-20,9,9,8,1,376,376,353,23,1,0,0,0,56,56,56,56
Humboldt,14,2022-03-20,38,38,36,2,2374,2374,2238,136,6,0,0,2,144,144,144,144
Imperial,14,2022-03-20,58,58,54,4,3985,3985,3733,252,5,1,1,4,941,941,940,940
Inyo,14,2022-03-20,1,1,1,0,152,152,144,8,0,0,0,0,56,56,56,56
Kern,14,2022-03-20,217,217,206,11,19708,19708,18677,1031,33,4,4,11,2334,2334,2330,2330
Kings,14,2022-03-20,77,77,72,5,4463,4463,4184,279,5,1,1,1,446,446,445,445
Lake,14,2022-03-20,16,16,15,1,1440,1440,1337,103,0,0,0,0,139,139,139,139
Lassen,14,2022-03-20,9,9,9,0,1453,1453,1380,73,0,0,0,0,62,62,62,62
Los Angeles,14,2022-03-20,4064,4064,3991,73,826170,826181,811060,15121,339,73,73,65,31668,31668,31595,31595
Madera,14,2022-03-20,43,43,40,3,3426,3426,3185,241,9,1,1,2,371,371,370,370
Marin,14,2022-03-20,141,141,131,10,6298,6298,5868,430,4,1,1,0,239,239,238,238
Mariposa,14,2022-03-20,9,9,8,1,252,252,233,19,0,0,0,0,27,27,27,27
Mendocino,14,2022-03-20,27,27,25,2,1493,1493,1358,135,4,2,2,1,123,123,121,121
Merced,14,2022-03-20,96,96,91,5,3891,3891,3680,211,13,4,4,2,814,814,810,810
Modoc,14,2022-03-20,2,2,2,0,53,53,50,3,0,0,0,0,8,8,8,8
Mono,14,2022-03-20,2,2,2,0,132,132,118,14,1,0,0,0,6,6,6,6
Monterey,14,2022-03-20,155,155,139,16,10234,10234,9140,1094,19,0,0,1,727,727,727,727
Napa,14,2022-03-20,61,61,58,3,3480,3480,3312,168,6,1,1,0,144,144,143,143
Nevada,14,2022-03-20,21,21,20,1,1518,1518,1412,106,2,0,0,0,129,129,129,129
Orange,14,2022-03-20,765,765,733,32,97925,97925,93817,4108,102,13,13,24,7075,7075,7062,7062
Placer,14,2022-03-20,114,114,105,9,6613,6613,6113,500,36,2,2,5,620,620,618,618
Plumas,14,2022-03-20,2,2,2,0,232,232,216,16,0,0,0,0,13,13,13,13
Riverside,14,2022-03-20,650,650,614,36,53479,53479,50518,2961,74,10,10,18,6435,6435,6425,6425
Sacramento,14,2022-03-20,490,490,461,29,32816,32816,30864,1952,95,14,14,10,3032,3032,3018,3018
San Benito,14,2022-03-20,25,25,24,1,1413,1413,1343,70,0,1,1,2,95,95,94,94
San Bernardino,14,2022-03-20,483,483,461,22,51474,51474,49150,2324,51,21,21,30,7777,7777,7756,7756
San Diego,14,2022-03-20,1456,1456,1428,28,88030,88030,86327,1703,158,13,13,34,5318,5318,5305,5305
San Francisco,14,2022-03-20,660,660,585,75,33638,33638,29771,3867,33,3,3,2,859,859,856,856
San Joaquin,14,2022-03-20,238,238,223,15,15553,15553,14539,1014,25,9,9,5,2243,2243,2234,2234
San Luis Obispo,14,2022-03-20,113,113,107,6,6583,6583,6244,339,2,5,5,1,476,476,471,471
San Mateo,14,2022-03-20,386,386,370,16,34229,34229,32787,1442,26,1,1,2,700,700,699,699
Santa Barbara,14,2022-03-20,175,175,165,10,15800,15800,14895,905,13,5,5,3,685,685,680,680
Santa Clara,14,2022-03-20,1075,1075,1053,22,96257,96257,94282,1975,104,4,4,22,2291,2291,2287,2287
Santa Cruz,14,2022-03-20,209,209,199,10,20514,20514,19503,1011,8,0,0,2,259,259,259,259
Shasta,14,2022-03-20,49,49,46,3,4220,4220,3966,254,8,5,5,2,565,565,560,560
Siskiyou,14,2022-03-20,8,8,8,0,353,353,336,17,1,0,0,0,83,83,83,83
Solano,14,2022-03-20,193,193,182,11,11680,11680,11029,651,20,1,1,4,448,448,447,447
Sonoma,14,2022-03-20,219,219,207,12,13351,13351,12621,730,14,3,3,2,489,489,486,486
Stanislaus,14,2022-03-20,150,150,137,13,8471,8471,7759,712,56,12,12,10,1684,1684,1672,1672
Sutter,14,2022-03-20,31,31,29,2,1516,1516,1430,86,0,1,1,0,223,223,222,222
Tehama,14,2022-03-20,9,9,8,1,947,947,870,77,1,1,1,0,205,205,204,204
Trinity,14,2022-03-20,0,0,0,0,100,100,92,8,0,0,0,0,20,20,20,20
Tulare,14,2022-03-20,122,122,112,10,8499,8499,7769,730,23,5,5,5,1487,1487,1482,1482
Tuolumne,14,2022-03-20,17,17,16,1,1171,1171,1089,82,2,0,0,0,181,181,181,181
Ventura,14,2022-03-20,293,293,282,11,23883,23883,22954,929,27,5,5,4,1488,1488,1483,1483
Yolo,14,2022-03-20,107,107,102,5,22314,22314,21195,1119,4,3,3,1,362,362,359,359
Yuba,14,2022-03-20,38,38,36,2,1313,1313,1243,70,8,0,0,0,124,124,124,124
Alameda,15,2022-03-27,877,877,846,31,59566,59566,57452,2114,39,3,3,4,1848,1848,1845,1845
Amador,15,2022-03-27,8,8,8,0,1366,1366,1288,78,3,0,0,0,86,86,86,86
Butte,15,2022-03-27,65,65,63,2,2900,2900,2816,84,15,0,0,1,427,427,427,427
Calaveras,15,2022-03-27,14,14,13,1,591,591,562,29,0,0,0,0,119,119,119,119
Colusa,15,2022-03-27,4,4,4,0,210,210,201,9,0,0,0,0,21,21,21,21
Contra Costa,15,2022-03-27,522,522,492,30,25115,25115,23658,1457,29,3,3,7,1300,1300,1297,1297
Del Norte,15,2022-03-27,17,17,16,1,1038,1038,991,47,0,0,0,0,49,49,49,49
El Dorado,15,2022-03-27,55,55,52,3,2834,2834,2695,139,1,1,1,0,214,214,213,213
Fresno,15,2022-03-27,305,305,288,17,18377,18377,17368,1009,79,5,5,12,2753,2753,2748,2748
Glenn,15,2022-03-27,7,7,7,0,334,334,317,17,0,0,0,0,56,56,56,56
Humboldt,15,2022-03-27,25,25,24,1,2608,2608,2489,119,5,1,1,2,145,145,144,144
Imperial,15,2022-03-27,59,59,56,3,3653,3653,3470,183,5,3,3,3,944,944,941,941
Inyo,15,2022-03-27,3,3,3,0,179,179,171,8,0,0,0,0,56,56,56,56
Kern,15,2022-03-27,148,148,142,6,18501,18501,17737,764,18,5,5,7,2339,2339,2334,2334
Kings,15,2022-03-27,59,59,56,3,4334,4334,4120,214,6,2,2,0,448,448,446,446
Lake,15,2022-03-27,13,13,12,1,1160,1160,1094,66,0,0,0,0,139,139,139,139
Lassen,15,2022-03-27,6,6,6,0,1353,1353,1300,53,0,0,0,0,62,62,62,62
Los Angeles,15,2022-03-27,4451,4451,4388,63,774349,774360,763263,11097,269,54,54,60,31722,31722,31668,31668
Madera,15,2022-03-27,25,25,24,1,3401,3401,3212,189,4,0,0,1,371,371,371,371
Marin,15,2022-03-27,159,159,150,9,6016,6016,5692,324,3,0,0,0,239,239,239,239
Mariposa,15,2022-03-27,5,5,5,0,171,171,161,10,0,1,1,0,28,28,27,27
Mendocino,15,2022-03-27,34,34,32,2,1312,1312,1217,95,0,1,1,0,124,124,123,123
Merced,15,2022-03-27,66,66,63,3,3360,3360,3216,144,7,2,2,2,816,816,814,814
Modoc,15,2022-03-27,2,2,2,0,50,50,48,2,0,0,0,0,8,8,8,8
Mono,15,2022-03-27,3,3,3,0,135,135,123,12,0,0,0,0,6,6,6,6
Monterey,15,2022-03-27,159,159,145,14,9426,9426,8623,803,17,1,1,0,728,728,727,727
Napa,15,2022-03-27,66,66,64,2,3372,3372,3244,128,1,2,2,0,146,146,144,144
Nevada,15,2022-03-27,27,27,26,1,1490,1490,1408,82,1,1,1,0,130,130,129,129
Orange,15,2022-03-27,809,809,783,26,90646,90646,87659,2987,75,13,13,20,7088,7088,7075,7075
Placer,15,2022-03-27,113,113,106,7,6173,6173,5804,369,25,4,4,8,624,624,620,620
Plumas,15,2022-03-27,2,2,2,0,274,274,259,15,0,0,0,0,13,13,13,13
Riverside,15,2022-03-27,530,530,507,23,44778,44778,42828,1950,52,10,10,12,6445,6445,6435,6435
Sacramento,15,2022-03-27,457,457,436,21,32003,32003,30498,1505,77,7,7,15,3039,3039,3032,3032
San Benito,15,2022-03-27,9,9,9,0,1334,1334,1282,52,0,0,0,0,95,95,95,95
San Bernardino,15,2022-03-27,509,509,491,18,41715,41715,40235,1480,47,22,22,23,7799,7799,7777,7777
San Diego,15,2022-03-27,1296,1296,1277,19,74660,74660,73533,1127,122,11,11,28,5329,5329,5318,5318
San Francisco,15,2022-03-27,805,805,732,73,33044,33044,30010,3034,24,2,2,3,861,861,859,859
San Joaquin,15,2022-03-27,184,184,175,9,16687,16687,15827,860,26,4,4,5,2247,2247,2243,2243
San Luis Obispo,15,2022-03-27,99,99,95,4,5818,5818,5583,235,3,1,1,1,477,477,476,476
San Mateo,15,2022-03-27,537,537,519,18,34717,34717,33566,1151,27,5,5,4,705,705,700,700
Santa Barbara,15,2022-03-27,125,125,119,6,9265,9265,8852,413,18,2,2,3,687,687,685,685
Santa Clara,15,2022-03-27,1274,1274,1254,20,93380,93380,91884,1496,83,9,9,19,2300,2300,2291,2291
Santa Cruz,15,2022-03-27,139,139,134,5,18864,18864,18134,730,3,0,0,2,259,259,259,259
Shasta,15,2022-03-27,38,38,36,2,3867,3867,3684,183,7,3,3,3,568,568,565,565
Siskiyou,15,2022-03-27,6,6,6,0,310,310,298,12,0,0,0,0,83,83,83,83
Solano,15,2022-03-27,157,157,150,7,10955,10955,10473,482,18,0,0,5,448,448,448,448
Sonoma,15,2022-03-27,251,251,240,11,8252,8252,7899,353,20,0,0,1,489,489,489,489
Stanislaus,15,2022-03-27,122,122,114,8,8033,8033,7496,537,30,3,3,5,1687,1687,1684,1684
Sutter,15,2022-03-27,26,26,25,1,1509,1509,1441,68,0,1,1,0,224,224,223,223
Tehama,15,2022-03-27,15,15,14,1,811,811,759,52,3,0,0,0,205,205,205,205
Trinity,15,2022-03-27,0,0,0,0,95,95,89,6,0,0,0,0,20,20,20,20
Tulare,15,2022-03-27,92,92,86,6,7869,7869,7333,536,19,3,3,0,1490,1490,1487,1487
Tuolumne,15,2022-03-27,12,12,11,1,1131,1131,1068,63,2,1,1,1,182,182,181,181
Ventura,15,2022-03-27,339,339,329,10,21824,21824,21159,665,21,7,7,3,1495,1495,1488,1488
Yolo,15,2022-03-27,100,100,96,4,18881,18881,18147,734,3,2,2,0,364,364,362,362
Yuba,15,2022-03-27,32,32,31,1,1261,1261,1208,53,2,2,2,1,126,126,124,124
Alameda,16,2022-04-03,989,989,962,27,58330,58330,56704,1626,35,4,4,3,1852,1852,1848,1848
Amador,16,2022-04-03,4,4,4,0,1152,1152,1100,52,1,0,0,0,86,86,86,86
Butte,16,2022-04-03,50,50,49,1,2737,2737,2675,62,7,2,2,1,429,429,427,427
Calaveras,16,2022-04-03,10,10,10,0,584,584,561,23,0,0,0,0,119,119,119,119
Colusa,16,2022-04-03,2,2,2,0,193,193,186,7,0,0,0,0,21,21,21,21
Contra Costa,16,2022-04-03,551,551,526,25,24453,24453,23333,1120,13,1,1,4,1301,1301,1300,1300
Del Norte,16,2022-04-03,9,9,9,0,1107,1107,1067,40,0,0,0,1,49,49,49,49
El Dorado,16,2022-04-03,49,49,47,2,2728,2728,2622,106,3,1,1,0,215,215,214,214
Fresno,16,2022-04-03,203,203,194,9,16750,16750,16025,725,63,4,4,14,2757,2757,2753,2753
Glenn,16,2022-04-03,5,5,5,0,296,296,284,12,0,0,0,0,56,56,56,56
Humboldt,16,2022-04-03,21,21,20,1,2479,2479,2390,89,2,0,0,3,145,145,145,145
Imperial,16,2022-04-03,50,50,48,2,3442,3442,3306,136,3,0,0,3,944,944,944,944
Inyo,16,2022-04-03,8,8,8,0,171,171,165,6,0,0,0,0,56,56,56,56
Kern,16,2022-04-03,165,165,160,5,17241,17241,16681,560,17,2,2,6,2341,2341,2339,2339
Kings,16,2022-04-03,50,50,48,2,4194,4194,4031,163,2,0,0,1,448,448,448,448
Lake,16,2022-04-03,12,12,11,1,989,989,945,44,0,0,0,0,139,139,139,139
Lassen,16,2022-04-03,4,4,4,0,1226,1226,1188,38,0,0,0,0,62,62,62,62
Los Angeles,16,2022-04-03,5088,5088,5032,56,735859,735869,727679,8190,244,48,48,43,31770,31770,31722,31722
Madera,16,2022-04-03,29,29,28,1,3318,3318,3172,146,3,0,0,1,371,371,371,371
Marin,16,2022-04-03,169,169,162,7,6464,6464,6190,274,2,0,0,0,239,239,239,239
Mariposa,16,2022-04-03,6,6,6,0,224,224,214,10,0,0,0,0,28,28,28,28
Mendocino,16,2022-04-03,23,23,22,1,1235,1235,1164,71,2,0,0,0,124,124,124,124
Merced,16,2022-04-03,53,53,51,2,3305,3305,3194,111,4,2,2,0,818,818,816,816
Modoc,16,2022-04-03,4,4,4,0,47,47,45,2,0,0,0,0,8,8,8,8
Mono,16,2022-04-03,1,1,1,0,151,151,141,10,0,0,0,0,6,6,6,6
Monterey,16,2022-04-03,131,131,122,9,7507,7507,7001,506,8,3,3,0,731,731,728,728
Napa,16,2022-04-03,73,73,71,2,3243,3243,3146,97,2,0,0,1,146,146,146,146
Nevada,16,2022-04-03,28,28,27,1,1408,1408,1347,61,0,1,1,0,131,131,130,130
Orange,16,2022-04-03,937,937,913,24,88553,88553,86260,2293,52,15,15,14,7103,7103,7088,7088
Placer,16,2022-04-03,120,120,114,6,6665,6665,6351,314,16,1,1,5,625,625,624,624
Plumas,16,2022-04-03,4,4,4,0,232,232,222,10,0,0,0,0,13,13,13,13
Riverside,16,2022-04-03,621,621,600,21,38714,38714,37384,1330,37,5,5,10,6450,6450,6445,6445
Sacramento,16,2022-04-03,437,437,421,16,32672,32672,31461,1211,49,7,7,11,3046,3046,3039,3039
San Benito,16,2022-04-03,14,14,14,0,1238,1238,1200,38,0,0,0,0,95,95,95,95
San Bernardino,16,2022-04-03,581,581,565,16,41628,41628,40467,1161,31,8,8,12,7807,7807,7799,7799
San Diego,16,2022-04-03,1455,1455,1438,17,65201,65201,64433,768,89,7,7,30,5336,5336,5329,5329
San Francisco,16,2022-04-03,955,955,886,69,28587,28587,26495,2092,20,5,5,5,866,866,861,861
San Joaquin,16,2022-04-03,207,207,199,8,15996,15996,15342,654,7,4,4,7,2251,2251,2247,2247
San Luis Obispo,16,2022-04-03,101,101,98,3,5562,5562,5385,177,2,0,0,1,477,477,477,477
San Mateo,16,2022-04-03,689,689,671,18,29664,29664,28893,771,13,3,3,1,708,708,705,705
Santa Barbara,16,2022-04-03,178,178,172,6,15017,15017,14485,532,7,2,2,1,689,689,687,687
Santa Clara,16,2022-04-03,1403,1403,1386,17,91851,91851,90696,1155,80,6,6,22,2306,2306,2300,2300
Santa Cruz,16,2022-04-03,187,187,181,6,20159,20159,19543,616,4,0,0,2,259,259,259,259
Shasta,16,2022-04-03,24,24,23,1,3552,3552,3419,133,2,2,2,2,570,570,568,568
Siskiyou,16,2022-04-03,2,2,2,0,301,301,292,9,0,0,0,0,83,83,83,83
Solano,16,2022-04-03,173,173,167,6,10334,10334,9975,359,17,1,1,7,449,449,448,448
Sonoma,16,2022-04-03,304,304,294,10,10640,10640,10281,359,8,1,1,2,490,490,489,489
Stanislaus,16,2022-04-03,102,102,97,5,7783,7783,7370,413,23,2,2,4,1689,1689,1687,1687
Sutter,16,2022-04-03,27,27,26,1,1284,1284,1239,45,0,0,0,0,224,224,224,224
Tehama,16,2022-04-03,4,4,4,0,786,786,746,40,0,2,2,0,207,207,205,205
Trinity,16,2022-04-03,1,1,1,0,78,78,74,4,0,0,0,0,20,20,20,20
Tulare,16,2022-04-03,50,50,47,3,7620,7620,7209,411,15,5,5,1,1495,1495,1490,1490
Tuolumne,16,2022-04-03,9,9,9,0,965,965,923,42,1,1,1,0,183,183,182,182
Ventura,16,2022-04-03,288,288,281,7,20854,20854,20356,498,18,5,5,4,1500,1500,1495,1495
Yolo,16,2022-04-03,104,104,101,3,26891,26891,26055,836,2,0,0,0,364,364,364,364
Yuba,16,2022-04-03,12,12,12,0,1023,1023,989,34,3,0,0,1,126,126,126,126
Alameda,17,2022-04-10,1413,1413,1383,30,49291,49291,48218,1073,51,4,4,1,1856,1856,1852,1852
Amador,17,2022-04-10,8,8,8,0,1064,1064,1026,38,1,0,0,0,86,86,86,86
Butte,17,2022-04-10,36,36,35,1,2299,2299,2258,41,3,0,0,1,429,429,429,429
Calaveras,17,2022-04-10,11,11,11,0,656,656,636,20,0,0,0,0,119,119,119,119
Colusa,17,2022-04-10,5,5,5,0,207,207,201,6,0,0,0,0,21,21,21,21
Contra Costa,17,2022-04-10,658,658,635,23,19848,19848,19136,712,15,1,1,6,1302,1302,1301,1301
Del Norte,17,2022-04-10,6,6,6,0,1017,1017,988,29,0,0,0,0,49,49,49,49
El Dorado,17,2022-04-10,55,55,53,2,2597,2597,2518,79,1,0,0,0,215,215,215,215
Fresno,17,2022-04-10,190,190,184,6,16465,16465,15905,560,53,1,1,5,2758,2758,2757,2757
Glenn,17,2022-04-10,2,2,2,0,258,258,250,8,0,0,0,0,56,56,56,56
Humboldt,17,2022-04-10,43,43,42,1,2344,2344,2278,66,4,1,1,2,146,146,145,145
Imperial,17,2022-04-10,26,26,25,1,3438,3438,3331,107,2,1,1,1,945,945,944,944
Inyo,17,2022-04-10,6,6,6,0,198,198,193,5,1,0,0,0,56,56,56,56
Kern,17,2022-04-10,142,142,138,4,17265,17265,16826,439,20,1,1,4,2342,2342,2341,2341
Kings,17,2022-04-10,35,35,34,1,4237,4237,4107,130,3,0,0,0,448,448,448,448
Lake,17,2022-04-10,20,20,19,1,853,853,823,30,0,0,0,0,139,139,139,139
Lassen,17,2022-04-10,1,1,1,0,1297,1297,1265,32,1,0,0,0,62,62,62,62
Los Angeles,17,2022-04-10,6606,6606,6549,57,746310,746322,739791,6531,227,46,46,38,31816,31816,31770,31770
Madera,17,2022-04-10,26,26,25,1,3121,3121,3013,108,3,0,0,1,371,371,371,371
Marin,17,2022-04-10,209,209,202,7,5524,5524,5340,184,4,0,0,2,239,239,239,239
Mariposa,17,2022-04-10,6,6,6,0,244,244,235,9,0,0,0,0,28,28,28,28
Mendocino,17,2022-04-10,30,30,29,1,1137,1137,1085,52,0,0,0,0,124,124,124,124
Merced,17,2022-04-10,73,73,71,2,3304,3304,3217,87,0,0,0,2,818,818,818,818
Modoc,17,2022-04-10,1,1,1,0,46,46,45,1,0,0,0,0,8,8,8,8
Mono,17,2022-04-10,6,6,6,0,137,137,130,7,0,0,0,0,6,6,6,6
Monterey,17,2022-04-10,107,107,101,6,7179,7179,6796,383,11,2,2,0,733,733,731,731
Napa,17,2022-04-10,117,117,114,3,3114,3114,3041,73,1,0,0,0,146,146,146,146
Nevada,17,2022-04-10,34,34,33,1,1495,1495,1444,51,2,0,0,1,131,131,131,131
Orange,17,2022-04-10,1137,1137,1114,23,54794,54794,53688,1106,64,11,11,13,7114,7114,7103,7103
Placer,17,2022-04-10,119,119,115,4,6058,6058,5832,226,20,2,2,3,627,627,625,625
Plumas,17,2022-04-10,5,5,5,0,260,260,251,9,0,0,0,0,13,13,13,13
Riverside,17,2022-04-10,737,737,717,20,37746,37746,36726,1020,32,4,4,9,6454,6454,6450,6450
Sacramento,17,2022-04-10,485,485,471,14,31367,31367,30452,915,40,10,10,5,3056,3056,3046,3046
San Benito,17,2022-04-10,17,17,17,0,1174,1174,1146,28,0,0,0,0,95,95,95,95
San Bernardino,17,2022-04-10,827,827,809,18,42204,42204,41281,923,30,9,9,4,7816,7816,7807,7807
San Diego,17,2022-04-10,1818,1818,1801,17,74433,74433,73748,685,86,5,5,22,5341,5341,5336,5336
San Francisco,17,2022-04-10,1172,1172,1105,67,30132,30132,28387,1745,20,6,6,4,872,872,866,866
San Joaquin,17,2022-04-10,228,228,221,7,15512,15512,15013,499,10,0,0,6,2251,2251,2251,2251
San Luis Obispo,17,2022-04-10,104,104,101,3,4933,4933,4810,123,2,3,3,0,480,480,477,477
San Mateo,17,2022-04-10,829,829,812,17,30750,30750,30123,627,4,1,1,1,709,709,708,708
Santa Barbara,17,2022-04-10,263,263,256,7,15209,15209,14786,423,8,2,2,0,691,691,689,689
Santa Clara,17,2022-04-10,1635,1635,1619,16,80896,80896,80104,792,69,3,3,12,2309,2309,2306,2306
Santa Cruz,17,2022-04-10,290,290,283,7,8401,8401,8202,199,6,1,1,0,260,260,259,259
Shasta,17,2022-04-10,21,21,20,1,3239,3239,3144,95,2,1,1,1,571,571,570,570
Siskiyou,17,2022-04-10,1,1,1,0,331,331,323,8,0,0,0,0,83,83,83,83
Solano,17,2022-04-10,244,244,237,7,9851,9851,9583,268,14,0,0,3,449,449,449,449
Sonoma,17,2022-04-10,397,397,387,10,10648,10648,10366,282,8,1,1,1,491,491,490,490
Stanislaus,17,2022-04-10,132,132,127,5,7892,7892,7562,330,19,1,1,1,1690,1690,1689,1689
Sutter,17,2022-04-10,19,19,18,1,1306,1306,1270,36,0,1,1,0,225,225,224,224
Tehama,17,2022-04-10,9,9,9,0,771,771,740,31,1,0,0,0,207,207,207,207
Trinity,17,2022-04-10,0,0,0,0,88,88,84,4,0,0,0,0,20,20,20,20
Tulare,17,2022-04-10,48,48,46,2,7858,7858,7523,335,8,4,4,0,1499,1499,1495,1495
Tuolumne,17,2022-04-10,16,16,15,1,1058,1058,1021,37,1,0,0,0,183,183,183,183
Ventura,17,2022-04-10,298,298,293,5,18036,18036,17699,337,15,2,2,2,1502,1502,1500,1500
Yolo,17,2022-04-10,121,121,118,3,18612,18612,18159,453,0,0,0,1,364,364,364,364
Yuba,17,2022-04-10,16,16,16,0,1084,1084,1056,28,1,0,0,0,126,126,126,126
Alameda,18,2022-04-17,1722,1722,1693,29,54176,54176,53249,927,40,3,3,6,1859,1859,1856,1856
Amador,18,2022-04-17,9,9,9,0,1158,1158,1126,32,2,0,0,0,86,86,86,86
Butte,18,2022-04-17,48,48,47,1,2239,2239,2208,31,6,2,2,0,431,431,429,429
Calaveras,18,2022-04-17,16,16,16,0,602,602,587,15,0,1,1,0,120,120,119,119
Colusa,18,2022-04-17,3,3,3,0,170,170,166,4,0,0,0,0,21,21,21,21
Contra Costa,18,2022-04-17,980,980,953,27,24608,24608,23910,698,26,1,1,4,1303,1303,1302,1302
Del Norte,18,2022-04-17,11,11,11,0,998,998,976,22,0,0,0,0,49,49,49,49
El Dorado,18,2022-04-17,64,64,63,1,2330,2330,2274,56,0,0,0,0,215,215,215,215
Fresno,18,2022-04-17,207,207,202,5,13445,13445,13087,358,42,5,5,4,2763,2763,2758,2758
Glenn,18,2022-04-17,4,4,4,0,276,276,269,7,0,0,0,0,56,56,56,56
Humboldt,18,2022-04-17,81,81,79,2,1941,1941,1898,43,4,0,0,2,146,146,146,146
Imperial,18,2022-04-17,43,43,42,1,3280,3280,3200,80,2,0,0,1,945,945,945,945
Inyo,18,2022-04-17,0,0,0,0,165,165,162,3,0,0,0,0,56,56,56,56
Kern,18,2022-04-17,133,133,130,3,13435,13435,13168,267,8,2,2,6,2344,2344,2342,2342
Kings,18,2022-04-17,35,35,34,1,3565,3565,3479,86,2,1,1,0,449,449,448,448
Lake,18,2022-04-17,19,19,18,1,798,798,776,22,2,0,0,1,139,139,139,139
Lassen,18,2022-04-17,2,2,2,0,1340,1340,1314,26,0,0,0,0,62,62,62,62
Los Angeles,18,2022-04-17,7660,7660,7608,52,375870,375877,373320,2557,190,43,43,31,31859,31859,31816,31816
Madera,18,2022-04-17,22,22,21,1,2615,2615,2544,71,2,0,0,2,371,371,371,371
Marin,18,2022-04-17,295,295,287,8,5984,5984,5827,157,5,0,0,0,239,239,239,239
Mariposa,18,2022-04-17,12,12,12,0,258,258,251,7,0,0,0,0,28,28,28,28
Mendocino,18,2022-04-17,46,46,44,2,1293,1293,1247,46,2,1,1,1,125,125,124,124
Merced,18,2022-04-17,54,54,53,1,3130,3130,3065,65,5,3,3,0,821,821,818,818
Modoc,18,2022-04-17,1,1,1,0,33,33,32,1,0,0,0,0,8,8,8,8
Mono,18,2022-04-17,11,11,11,0,163,163,156,7,0,0,0,0,6,6,6,6
Monterey,18,2022-04-17,140,140,134,6,6223,6223,5961,262,5,0,0,0,733,733,733,733
Napa,18,2022-04-17,141,141,138,3,2660,2660,2612,48,1,0,0,0,146,146,146,146
Nevada,18,2022-04-17,42,42,41,1,1227,1227,1194,33,0,0,0,1,131,131,131,131
Orange,18,2022-04-17,1344,1344,1323,21,81403,81403,80106,1297,51,6,6,9,7120,7120,7114,7114
Placer,18,2022-04-17,155,155,151,4,4677,4677,4541,136,24,0,0,4,627,627,627,627
Plumas,18,2022-04-17,9,9,9,0,206,206,200,6,0,0,0,0,13,13,13,13
Riverside,18,2022-04-17,864,864,846,18,36785,36785,36003,782,41,7,7,4,6461,6461,6454,6454
Sacramento,18,2022-04-17,652,652,637,15,27566,27566,26937,629,48,10,10,8,3066,3066,3056,3056
San Benito,18,2022-04-17,26,26,26,0,1178,1178,1156,22,0,0,0,0,95,95,95,95
San Bernardino,18,2022-04-17,1052,1052,1034,18,39402,39402,38724,678,34,7,7,9,7823,7823,7816,7816
San Diego,18,2022-04-17,1876,1876,1863,13,66880,66880,66397,483,88,8,8,19,5349,5349,5341,5341
San Francisco,18,2022-04-17,1366,1366,1304,62,30460,30460,29068,1392,26,2,2,2,874,874,872,872
San Joaquin,18,2022-04-17,245,245,239,6,14788,14788,14415,373,8,1,1,4,2252,2252,2251,2251
San Luis Obispo,18,2022-04-17,146,146,143,3,4867,4867,4772,95,3,2,2,0,482,482,480,480
San Mateo,18,2022-04-17,1084,1084,1067,17,29517,29517,29047,470,14,3,3,1,712,712,709,709
Santa Barbara,18,2022-04-17,322,322,315,7,14751,14751,14429,322,8,0,0,0,691,691,691,691
Santa Clara,18,2022-04-17,2076,2076,2060,16,74611,74611,74038,573,61,5,5,13,2314,2314,2309,2309
Santa Cruz,18,2022-04-17,406,406,398,8,12236,12236,12001,235,2,0,0,2,260,260,260,260
Shasta,18,2022-04-17,29,29,28,1,2820,2820,2755,65,1,1,1,2,572,572,571,571
Siskiyou,18,2022-04-17,3,3,3,0,322,322,316,6,1,0,0,1,83,83,83,83
Solano,18,2022-04-17,233,233,228,5,9098,9098,8904,194,10,1,1,1,450,450,449,449
Sonoma,18,2022-04-17,491,491,481,10,11149,11149,10916,233,15,1,1,3,492,492,491,491
Stanislaus,18,2022-04-17,155,155,150,5,7664,7664,7411,253,15,1,1,4,1691,1691,1690,1690
Sutter,18,2022-04-17,23,23,23,0,1170,1170,1145,25,0,0,0,0,225,225,225,225
Tehama,18,2022-04-17,8,8,8,0,680,680,658,22,1,0,0,0,207,207,207,207
Trinity,18,2022-04-17,0,0,0,0,68,68,66,2,0,0,0,0,20,20,20,20
Tulare,18,2022-04-17,82,82,79,3,6744,6744,6517,227,12,0,0,0,1499,1499,1499,1499
Tuolumne,18,2022-04-17,27,27,26,1,1074,1074,1045,29,0,0,0,0,183,183,183,183
Ventura,18,2022-04-17,349,349,344,5,15602,15602,15373,229,8,1,1,0,1503,1503,1502,1502
Yolo,18,2022-04-17,198,198,194,4,17689,17689,17349,340,2,1,1,0,365,365,364,364
Yuba,18,2022-04-17,22,22,22,0,973,973,953,20,1,0,0,0,126,126,126,126
Alameda,19,2022-04-24,2349,2349,2318,31,56964,56964,56206,758,39,7,7,3,1866,1866,1859,1859
Amador,19,2022-04-24,22,22,22,0,1312,1312,1283,29,0,0,0,0,86,86,86,86
Butte,19,2022-04-24,52,52,51,1,2476,2476,2449,27,7,1,1,1,432,432,431,431
Calaveras,19,2022-04-24,28,28,27,1,637,637,625,12,0,0,0,0,120,120,120,120
Colusa,19,2022-04-24,3,3,3,0,184,184,181,3,0,0,0,0,21,21,21,21
Contra Costa,19,2022-04-24,1435,1435,1404,31,26296,26296,25714,582,31,2,2,2,1305,1305,1303,1303
Del Norte,19,2022-04-24,21,21,21,0,1092,1092,1073,19,0,0,0,0,49,49,49,49
El Dorado,19,2022-04-24,95,95,93,2,2715,2715,2664,51,0,0,0,0,215,215,215,215
Fresno,19,2022-04-24,334,334,327,7,15618,15618,15292,326,35,3,3,2,2766,2766,2763,2763
Glenn,19,2022-04-24,4,4,4,0,284,284,279,5,0,0,0,0,56,56,56,56
Humboldt,19,2022-04-24,179,179,176,3,2775,2775,2727,48,2,1,1,2,147,147,146,146
Imperial,19,2022-04-24,62,62,61,1,3373,3373,3309,64,3,0,0,1,945,945,945,945
Inyo,19,2022-04-24,5,5,5,0,175,175,172,3,0,0,0,0,56,56,56,56
Kern,19,2022-04-24,233,233,229,4,17326,17326,17057,269,15,2,2,5,2346,2346,2344,2344
Kings,19,2022-04-24,56,56,55,1,4498,4498,4414,84,2,0,0,0,449,449,449,449
Lake,19,2022-04-24,14,14,14,0,820,820,802,18,1,1,1,0,140,140,139,139
Lassen,19,2022-04-24,0,0,0,0,1505,1505,1483,22,0,0,0,0,62,62,62,62
Los Angeles,19,2022-04-24,11016,11016,10958,58,865883,865899,861281,4618,204,26,26,27,31885,31885,31859,31859
Madera,19,2022-04-24,35,35,34,1,2842,2842,2782,60,2,0,0,0,371,371,371,371
Marin,19,2022-04-24,341,341,334,7,6224,6224,6096,128,9,0,0,0,239,239,239,239
Mariposa,19,2022-04-24,14,14,14,0,217,217,212,5,0,0,0,0,28,28,28,28
Mendocino,19,2022-04-24,65,65,63,2,1221,1221,1187,34,0,1,1,1,126,126,125,125
Merced,19,2022-04-24,96,96,94,2,2968,2968,2920,48,6,1,1,0,822,822,821,821
Modoc,19,2022-04-24,1,1,1,0,39,39,38,1,0,0,0,0,8,8,8,8
Mono,19,2022-04-24,3,3,3,0,93,93,90,3,0,0,0,0,6,6,6,6
Monterey,19,2022-04-24,303,303,293,10,7604,7604,7353,251,3,2,2,1,735,735,733,733
Napa,19,2022-04-24,214,214,211,3,3378,3378,3330,48,1,0,0,0,146,146,146,146
Nevada,19,2022-04-24,52,52,51,1,1373,1373,1344,29,1,0,0,0,131,131,131,131
Orange,19,2022-04-24,1941,1941,1917,24,85109,85109,84054,1055,55,9,9,14,7129,7129,7120,7120
Placer,19,2022-04-24,226,226,221,5,5852,5852,5718,134,20,0,0,5,627,627,627,627
Plumas,19,2022-04-24,0,0,0,0,239,239,234,5,0,0,0,0,13,13,13,13
Riverside,19,2022-04-24,1248,1248,1228,20,39929,39929,39267,662,36,3,3,6,6464,6464,6461,6461
Sacramento,19,2022-04-24,979,979,962,17,31268,31268,30710,558,40,5,5,7,3071,3071,3066,3066
San Benito,19,2022-04-24,32,32,32,0,1142,1142,1125,17,0,0,0,0,95,95,95,95
San Bernardino,19,2022-04-24,1295,1295,1278,17,42968,42968,42392,576,23,8,8,5,7831,7831,7823,7823
San Diego,19,2022-04-24,2846,2846,2830,16,73878,73878,73463,415,85,5,5,13,5354,5354,5349,5349
San Francisco,19,2022-04-24,1868,1868,1801,67,31629,31629,30492,1137,29,1,1,2,875,875,874,874
San Joaquin,19,2022-04-24,352,352,345,7,15437,15437,15132,305,11,0,0,2,2252,2252,2252,2252
San Luis Obispo,19,2022-04-24,202,202,199,3,5056,5056,4979,77,4,0,0,0,482,482,482,482
San Mateo,19,2022-04-24,1463,1463,1445,18,32297,32297,31894,403,15,1,1,4,713,713,712,712
Santa Barbara,19,2022-04-24,359,359,353,6,14814,14814,14561,253,8,0,0,0,691,691,691,691
Santa Clara,19,2022-04-24,2951,2951,2934,17,71084,71084,70661,423,79,3,3,10,2317,2317,2314,2314
Santa Cruz,19,2022-04-24,482,482,475,7,19694,19694,19406,288,2,1,1,0,261,261,260,260
Shasta,19,2022-04-24,48,48,47,1,3106,3106,3050,56,0,0,0,0,572,572,572,572
Siskiyou,19,2022-04-24,10,10,10,0,324,324,319,5,0,0,0,0,83,83,83,83
Solano,19,2022-04-24,436,436,429,7,10361,10361,10188,173,9,0,0,2,450,450,450,450
Sonoma,19,2022-04-24,651,651,641,10,11865,11865,11672,193,18,0,0,2,492,492,492,492
Stanislaus,19,2022-04-24,219,219,214,5,7716,7716,7517,199,23,4,4,0,1695,1695,1691,1691
Sutter,19,2022-04-24,34,34,33,1,1350,1350,1327,23,0,1,1,0,226,226,225,225
Tehama,19,2022-04-24,14,14,14,0,697,697,680,17,1,0,0,0,207,207,207,207
Trinity,19,2022-04-24,2,2,2,0,73,73,71,2,0,0,0,0,20,20,20,20
Tulare,19,2022-04-24,84,84,82,2,7047,7047,6861,186,12,0,0,0,1499,1499,1499,1499
Tuolumne,19,2022-04-24,36,36,35,1,1127,1127,1103,24,1,0,0,0,183,183,183,183
Ventura,19,2022-04-24,588,588,581,7,18907,18907,18691,216,15,3,3,2,1506,1506,1503,1503
Yolo,19,2022-04-24,280,280,276,4,19596,19596,19303,293,1,0,0,0,365,365,365,365
Yuba,19,2022-04-24,33,33,32,1,1116,1116,1098,18,0,0,0,0,126,126,126,126
Alameda,20,2022-05-01,3261,3261,3228,33,69456,69456,68730,726,45,2,2,4,1868,1868,1866,1866
Amador,20,2022-05-01,28,28,28,0,1337,1337,1314,23,0,0,0,0,86,86,86,86
Butte,20,2022-05-01,81,81,80,1,2456,2456,2435,21,4,2,2,0,434,434,432,432
Calaveras,20,2022-05-01,28,28,28,0,730,730,719,11,0,0,0,0,120,120,120,120
Colusa,20,2022-05-01,4,4,4,0,212,212,209,3,0,0,0,0,21,21,21,21
Contra Costa,20,2022-05-01,1797,1797,1766,31,28977,28977,28473,504,39,3,3,5,1308,1308,1305,1305
Del Norte,20,2022-05-01,43,43,42,1,1200,1200,1184,16,0,0,0,0,49,49,49,49
El Dorado,20,2022-05-01,128,128,126,2,2732,2732,2692,40,1,1,1,0,216,216,215,215
Fresno,20,2022-05-01,477,477,469,8,16447,16447,16178,269,35,3,3,4,2769,2769,2766,2766
Glenn,20,2022-05-01,4,4,4,0,261,261,257,4,0,0,0,0,56,56,56,56
Humboldt,20,2022-05-01,229,229,226,3,2944,2944,2904,40,6,0,0,2,147,147,147,147
Imperial,20,2022-05-01,111,111,109,2,3607,3607,3553,54,1,0,0,1,945,945,945,945
Inyo,20,2022-05-01,5,5,5,0,207,207,204,3,0,0,0,0,56,56,56,56
Kern,20,2022-05-01,283,283,280,3,17976,17976,17757,219,12,0,0,5,2346,2346,2346,2346
Kings,20,2022-05-01,47,47,46,1,4736,4736,4666,70,4,0,0,1,449,449,449,449
Lake,20,2022-05-01,29,29,29,0,1015,1015,998,17,1,0,0,0,140,140,140,140
Lassen,20,2022-05-01,9,9,9,0,1614,1614,1595,19,0,0,0,0,62,62,62,62
Los Angeles,20,2022-05-01,14149,14149,14091,58,925205,925222,921363,3859,201,26,26,24,31911,31911,31885,31885
Madera,20,2022-05-01,74,74,73,1,3296,3296,3242,54,4,0,0,1,371,371,371,371
Marin,20,2022-05-01,394,394,388,6,6454,6454,6350,104,10,0,0,0,239,239,239,239
Mariposa,20,2022-05-01,9,9,9,0,242,242,238,4,0,0,0,0,28,28,28,28
Mendocino,20,2022-05-01,45,45,44,1,1268,1268,1240,28,0,0,0,0,126,126,126,126
Merced,20,2022-05-01,123,123,121,2,3256,3256,3215,41,7,3,3,0,825,825,822,822
Modoc,20,2022-05-01,0,0,0,0,41,41,40,1,0,0,0,0,8,8,8,8
Mono,20,2022-05-01,5,5,5,0,86,86,84,2,0,0,0,0,6,6,6,6
Monterey,20,2022-05-01,329,329,321,8,8328,8328,8111,217,8,1,1,0,736,736,735,735
Napa,20,2022-05-01,223,223,221,2,3533,3533,3494,39,5,0,0,0,146,146,146,146
Nevada,20,2022-05-01,77,77,76,1,1507,1507,1482,25,2,0,0,0,131,131,131,131
Orange,20,2022-05-01,2535,2535,2511,24,88179,88179,87324,855,67,5,5,14,7134,7134,7129,7129
Placer,20,2022-05-01,285,285,280,5,6236,6236,6124,112,24,0,0,5,627,627,627,627
Plumas,20,2022-05-01,10,10,10,0,252,252,248,4,0,0,0,0,13,13,13,13
Riverside,20,2022-05-01,1868,1868,1844,24,42457,42457,41907,550,31,5,5,6,6469,6469,6464,6464
Sacramento,20,2022-05-01,1271,1271,1254,17,32717,32717,32260,457,43,5,5,10,3076,3076,3071,3071
San Benito,20,2022-05-01,45,45,44,1,1233,1233,1219,14,0,0,0,0,95,95,95,95
San Bernardino,20,2022-05-01,1403,1403,1389,14,43380,43380,42926,454,26,8,8,10,7839,7839,7831,7831
San Diego,20,2022-05-01,3844,3844,3827,17,71375,71375,71062,313,71,3,3,13,5357,5357,5354,5354
San Francisco,20,2022-05-01,2379,2379,2312,67,35393,35393,34393,1000,38,1,1,6,876,876,875,875
San Joaquin,20,2022-05-01,488,488,481,7,15366,15366,15129,237,12,1,1,3,2253,2253,2252,2252
San Luis Obispo,20,2022-05-01,253,253,250,3,5140,5140,5079,61,8,2,2,0,484,484,482,482
San Mateo,20,2022-05-01,1770,1770,1753,17,36239,36239,35886,353,22,2,2,2,715,715,713,713
Santa Barbara,20,2022-05-01,404,404,399,5,15564,15564,15356,208,8,2,2,2,693,693,691,691
Santa Clara,20,2022-05-01,4096,4096,4077,19,96958,96958,96506,452,85,5,5,18,2322,2322,2317,2317
Santa Cruz,20,2022-05-01,639,639,632,7,22144,22144,21891,253,2,0,0,0,261,261,261,261
Shasta,20,2022-05-01,63,63,62,1,3397,3397,3349,48,8,0,0,1,572,572,572,572
Siskiyou,20,2022-05-01,10,10,10,0,324,324,320,4,0,0,0,0,83,83,83,83
Solano,20,2022-05-01,602,602,594,8,11575,11575,11424,151,9,0,0,2,450,450,450,450
Sonoma,20,2022-05-01,815,815,805,10,12446,12446,12288,158,14,1,1,3,493,493,492,492
Stanislaus,20,2022-05-01,267,267,262,5,8210,8210,8044,166,18,0,0,3,1695,1695,1695,1695
Sutter,20,2022-05-01,46,46,45,1,1258,1258,1241,17,0,1,1,0,227,227,226,226
Tehama,20,2022-05-01,20,20,20,0,698,698,684,14,0,0,0,0,207,207,207,207
Trinity,20,2022-05-01,1,1,1,0,88,88,86,2,0,0,0,0,20,20,20,20
Tulare,20,2022-05-01,159,159,156,3,7185,7185,7037,148,11,3,3,0,1502,1502,1499,1499
Tuolumne,20,2022-05-01,87,87,86,1,1234,1234,1214,20,5,0,0,0,183,183,183,183
Ventura,20,2022-05-01,683,683,677,6,19440,19440,19266,174,15,4,4,2,1510,1510,1506,1506
Yolo,20,2022-05-01,325,325,321,4,19007,19007,18784,223,1,1,1,0,366,366,365,365
Yuba,20,2022-05-01,40,40,40,0,1060,1060,1047,13,1,0,0,1,126,126,126,126
Alameda,21,2022-05-08,3960,3960,3928,32,70570,70570,69996,574,61,4,4,6,1872,1872,1868,1868
Amador,21,2022-05-08,14,14,14,0,1430,1430,1411,19,0,0,0,0,86,86,86,86
Butte,21,2022-05-08,119,119,118,1,2403,2403,2387,16,4,0,0,0,434,434,434,434
Calaveras,21,2022-05-08,30,30,30,0,692,692,684,8,1,0,0,0,120,120,120,120
Colusa,21,2022-05-08,2,2,2,0,216,216,214,2,0,0,0,0,21,21,21,21
Contra Costa,21,2022-05-08,2387,2387,2355,32,30576,30576,30161,415,34,3,3,12,1311,1311,1308,1308
Del Norte,21,2022-05-08,41,41,41,0,1233,1233,1220,13,0,0,0,0,49,49,49,49
El Dorado,21,2022-05-08,172,172,170,2,2822,2822,2790,32,4,0,0,0,216,216,216,216
Fresno,21,2022-05-08,683,683,674,9,17501,17501,17277,224,33,2,2,2,2771,2771,2769,2769
Glenn,21,2022-05-08,6,6,6,0,231,231,228,3,0,0,0,0,56,56,56,56
Humboldt,21,2022-05-08,284,284,281,3,3257,3257,3223,34,2,0,0,2,147,147,147,147
Imperial,21,2022-05-08,121,121,120,1,3744,3744,3700,44,0,0,0,1,945,945,945,945
Inyo,21,2022-05-08,20,20,20,0,199,199,197,2,1,0,0,0,56,56,56,56
Kern,21,2022-05-08,437,437,433,4,18479,18479,18303,176,19,1,1,2,2347,2347,2346,2346
Kings,21,2022-05-08,95,95,94,1,4932,4932,4875,57,2,0,0,0,449,449,449,449
Lake,21,2022-05-08,29,29,29,0,1011,1011,998,13,1,0,0,0,140,140,140,140
Lassen,21,2022-05-08,3,3,3,0,1699,1699,1684,15,0,0,0,0,62,62,62,62
Los Angeles,21,2022-05-08,17848,17848,17791,57,920038,920056,917068,2988,215,29,29,27,31940,31940,31911,31911
Madera,21,2022-05-08,127,127,125,2,3704,3704,3656,48,3,0,0,0,371,371,371,371
Marin,21,2022-05-08,672,672,664,8,7671,7671,7575,96,10,0,0,1,239,239,239,239
Mariposa,21,2022-05-08,26,26,26,0,270,270,266,4,0,0,0,0,28,28,28,28
Mendocino,21,2022-05-08,91,91,89,2,1220,1220,1199,21,0,1,1,0,127,127,126,126
Merced,21,2022-05-08,181,181,179,2,3432,3432,3398,34,5,1,1,0,826,826,825,825
Modoc,21,2022-05-08,2,2,2,0,41,42,41,1,0,0,0,0,8,8,8,8
Mono,21,2022-05-08,11,11,11,0,127,127,124,3,0,0,0,0,6,6,6,6
Monterey,21,2022-05-08,425,425,416,9,9169,9169,8982,187,9,0,0,0,736,736,736,736
Napa,21,2022-05-08,238,238,236,2,3239,3239,3211,28,3,0,0,0,146,146,146,146
Nevada,21,2022-05-08,97,97,96,1,1626,1626,1605,21,4,0,0,0,131,131,131,131
Orange,21,2022-05-08,3440,3440,3414,26,91203,91203,90513,690,100,7,7,17,7141,7141,7134,7134
Placer,21,2022-05-08,499,499,492,7,6726,6726,6632,94,27,0,0,3,627,627,627,627
Plumas,21,2022-05-08,10,10,10,0,275,275,271,4,0,0,0,0,13,13,13,13
Riverside,21,2022-05-08,2372,2372,2348,24,45081,45081,44624,457,35,4,4,8,6473,6473,6469,6469
Sacramento,21,2022-05-08,2082,2082,2060,22,36466,36466,36068,398,63,3,3,10,3079,3079,3076,3076
San Benito,21,2022-05-08,66,66,65,1,1437,1437,1424,13,0,0,0,0,95,95,95,95
San Bernardino,21,2022-05-08,1817,1817,1802,15,45985,45985,45609,376,35,6,6,4,7845,7845,7839,7839
San Diego,21,2022-05-08,5045,5045,5028,17,86603,86603,86307,296,85,3,3,12,5360,5360,5357,5357
San Francisco,21,2022-05-08,2882,2882,2819,63,37738,37738,36903,835,51,8,8,7,884,884,876,876
San Joaquin,21,2022-05-08,730,730,721,9,15972,15972,15780,192,13,1,1,2,2254,2254,2253,2253
San Luis Obispo,21,2022-05-08,290,290,287,3,5211,5211,5162,49,0,0,0,0,484,484,484,484
San Mateo,21,2022-05-08,2216,2216,2199,17,36991,36991,36710,281,25,1,1,1,716,716,715,715
Santa Barbara,21,2022-05-08,608,608,602,6,15358,15358,15198,160,9,0,0,2,693,693,693,693
Santa Clara,21,2022-05-08,5501,5501,5481,20,104000,104000,103622,378,82,2,2,25,2324,2324,2322,2322
Santa Cruz,21,2022-05-08,701,701,695,6,22982,22982,22777,205,4,1,1,0,262,262,261,261
Shasta,21,2022-05-08,94,94,93,1,3453,3453,3415,38,3,0,0,2,572,572,572,572
Siskiyou,21,2022-05-08,14,14,14,0,285,285,282,3,0,0,0,0,83,83,83,83
Solano,21,2022-05-08,878,878,869,9,12396,12396,12269,127,18,0,0,0,450,450,450,450
Sonoma,21,2022-05-08,1181,1181,1169,12,13988,13988,13849,139,0,1,1,23,494,494,493,493
Stanislaus,21,2022-05-08,408,408,402,6,8753,8753,8615,138,25,0,0,1,1695,1695,1695,1695
Sutter,21,2022-05-08,48,48,48,0,1543,1543,1527,16,0,0,0,0,227,227,227,227
Tehama,21,2022-05-08,23,23,23,0,686,686,676,10,1,0,0,0,207,207,207,207
Trinity,21,2022-05-08,3,3,3,0,68,68,67,1,0,0,0,0,20,20,20,20
Tulare,21,2022-05-08,178,178,175,3,7595,7595,7472,123,13,2,2,0,1504,1504,1502,1502
Tuolumne,21,2022-05-08,76,76,75,1,1323,1323,1306,17,2,2,2,0,185,185,183,183
Ventura,21,2022-05-08,1087,1087,1080,7,21165,21165,21017,148,12,1,1,2,1511,1511,1510,1510
Yolo,21,2022-05-08,446,446,442,4,19682,19682,19503,179,1,0,0,1,366,366,366,366
Yuba,21,2022-05-08,65,65,64,1,1196,1196,1184,12,2,0,0,0,126,126,126,126
Alameda,22,2022-05-15,4822,4822,4792,30,74688,74688,74213,475,65,7,7,4,1879,1879,1872,1872
Amador,22,2022-05-15,49,49,48,1,1687,1687,1669,18,1,0,0,0,86,86,86,86
Butte,22,2022-05-15,173,173,172,1,2632,2632,2618,14,5,2,2,1,436,436,434,434
Calaveras,22,2022-05-15,31,31,31,0,763,763,756,7,1,1,1,1,121,121,120,120
Colusa,22,2022-05-15,5,5,5,0,213,213,211,2,0,0,0,0,21,21,21,21
Contra Costa,22,2022-05-15,3230,3230,3196,34,32734,32734,32386,348,48,4,4,8,1315,1315,1311,1311
Del Norte,22,2022-05-15,117,117,116,1,1749,1749,1735,14,0,0,0,0,49,49,49,49
El Dorado,22,2022-05-15,242,242,240,2,3058,3058,3031,27,6,0,0,1,216,216,216,216
Fresno,22,2022-05-15,1041,1041,1031,10,18719,18719,18532,187,45,2,2,4,2773,2773,2771,2771
Glenn,22,2022-05-15,14,14,14,0,258,258,256,2,0,0,0,0,56,56,56,56
Humboldt,22,2022-05-15,281,281,279,2,3242,3242,3215,27,9,1,1,2,148,148,147,147
Imperial,22,2022-05-15,205,205,203,2,4173,4173,4135,38,3,0,0,1,945,945,945,945
Inyo,22,2022-05-15,22,22,22,0,225,225,223,2,1,0,0,0,56,56,56,56
Kern,22,2022-05-15,604,604,600,4,19854,19854,19706,148,18,4,4,3,2351,2351,2347,2347
Kings,22,2022-05-15,177,177,175,2,5348,5348,5300,48,0,1,1,0,450,450,449,449
Lake,22,2022-05-15,64,64,63,1,1127,1127,1115,12,0,0,0,0,140,140,140,140
Lassen,22,2022-05-15,16,16,16,0,1683,1683,1671,12,0,0,0,0,62,62,62,62
Los Angeles,22,2022-05-15,20424,20424,20373,51,937846,937870,935494,2376,268,38,38,44,31978,31978,31940,31940
Madera,22,2022-05-15,178,178,176,2,3643,3643,3606,37,2,0,0,0,371,371,371,371
Marin,22,2022-05-15,771,771,764,7,8211,8211,8130,81,12,0,0,0,239,239,239,239
Mariposa,22,2022-05-15,26,26,26,0,354,354,350,4,0,0,0,0,28,28,28,28
Mendocino,22,2022-05-15,97,97,96,1,1347,1347,1329,18,0,1,1,3,128,128,127,127
Merced,22,2022-05-15,279,279,277,2,3877,3877,3847,30,9,2,2,1,828,828,826,826
Modoc,22,2022-05-15,3,3,3,0,43,44,43,1,0,0,0,0,8,8,8,8
Mono,22,2022-05-15,9,9,9,0,109,109,107,2,0,0,0,0,6,6,6,6
Monterey,22,2022-05-15,496,496,488,8,9588,9588,9435,153,7,1,1,0,737,737,736,736
Napa,22,2022-05-15,285,285,283,2,3507,3507,3483,24,2,0,0,0,146,146,146,146
Nevada,22,2022-05-15,140,140,139,1,1851,1851,1832,19,1,0,0,0,131,131,131,131
Orange,22,2022-05-15,4346,4346,4321,25,94117,94118,93563,555,74,8,8,13,7149,7149,7141,7141
Placer,22,2022-05-15,676,676,669,7,7473,7473,7391,82,40,1,1,3,628,628,627,627
Plumas,22,2022-05-15,46,46,46,0,257,257,254,3,1,0,0,0,13,13,13,13
Riverside,22,2022-05-15,3118,3118,3094,24,47077,47077,46705,372,49,1,1,8,6474,6474,6473,6473
Sacramento,22,2022-05-15,2934,2934,2909,25,38970,38970,38638,332,86,8,8,15,3087,3087,3079,3079
San Benito,22,2022-05-15,100,100,99,1,1550,1550,1539,11,0,0,0,1,95,95,95,95
San Bernardino,22,2022-05-15,2350,2350,2335,15,48851,48851,48539,312,40,7,7,4,7852,7852,7845,7845
San Diego,22,2022-05-15,6164,6164,6148,16,92857,92857,92610,247,87,6,6,23,5366,5366,5360,5360
San Francisco,22,2022-05-15,3339,3339,3281,58,38835,38835,38160,675,51,5,5,6,889,889,884,884
San Joaquin,22,2022-05-15,1141,1141,1130,11,18256,18256,18085,171,12,1,1,1,2255,2255,2254,2254
San Luis Obispo,22,2022-05-15,370,370,367,3,5777,5777,5735,42,4,1,1,0,485,485,484,484
San Mateo,22,2022-05-15,2701,2701,2685,16,39770,39770,39534,236,37,3,3,1,719,719,716,716
Santa Barbara,22,2022-05-15,816,816,809,7,16595,16595,16460,135,10,0,0,2,693,693,693,693
Santa Clara,22,2022-05-15,6867,6867,6848,19,111720,111723,111407,316,95,12,12,20,2336,2336,2324,2324
Santa Cruz,22,2022-05-15,883,883,877,6,24942,24942,24768,174,4,0,0,1,262,262,262,262
Shasta,22,2022-05-15,115,115,114,1,3766,3766,3734,32,5,0,0,1,572,572,572,572
Siskiyou,22,2022-05-15,20,20,20,0,392,392,389,3,0,0,0,0,83,83,83,83
Solano,22,2022-05-15,1133,1133,1124,9,13662,13662,13553,109,24,0,0,2,450,450,450,450
Sonoma,22,2022-05-15,1468,1468,1457,11,15255,15255,15137,118,24,0,0,5,494,494,494,494
Stanislaus,22,2022-05-15,685,685,677,8,9823,9823,9702,121,31,1,1,6,1696,1696,1695,1695
Sutter,22,2022-05-15,101,101,100,1,1756,1756,1742,14,0,0,0,0,227,227,227,227
Tehama,22,2022-05-15,26,26,26,0,810,810,800,10,1,1,1,2,208,208,207,207
Trinity,22,2022-05-15,5,5,5,0,66,66,65,1,0,0,0,0,20,20,20,20
Tulare,22,2022-05-15,338,338,334,4,7858,7858,7759,99,11,1,1,1,1505,1505,1504,1504
Tuolumne,22,2022-05-15,96,96,95,1,1464,1464,1449,15,2,1,1,0,186,186,185,185
Ventura,22,2022-05-15,1443,1443,1435,8,23197,23197,23071,126,22,1,1,3,1512,1512,1511,1511
Yolo,22,2022-05-15,682,682,677,5,21627,21627,21473,154,1,0,0,0,366,366,366,366
Yuba,22,2022-05-15,107,107,106,1,1270,1270,1260,10,4,0,0,0,126,126,126,126
Alameda,23,2022-05-22,5583,5583,5556,27,76602,76602,76222,380,78,5,5,5,1884,1884,1879,1879
Amador,23,2022-05-22,79,79,78,1,1558,1558,1545,13,0,0,0,0,86,86,86,86
Butte,23,2022-05-22,290,290,289,1,2731,2731,2720,11,8,1,1,0,437,437,436,436
Calaveras,23,2022-05-22,60,60,60,0,757,757,752,5,0,1,1,0,122,122,121,121
Colusa,23,2022-05-22,6,6,6,0,224,224,223,1,0,0,0,0,21,21,21,21
Contra Costa,23,2022-05-22,3868,3868,3836,32,35142,35142,34850,292,64,11,11,8,1326,1326,1315,1315
Del Norte,23,2022-05-22,125,125,124,1,1578,1578,1568,10,1,1,1,0,50,50,49,49
El Dorado,23,2022-05-22,345,345,343,2,3359,3359,3336,23,6,2,2,0,218,218,216,216
Fresno,23,2022-05-22,1574,1574,1562,12,20851,20851,20688,163,52,1,1,8,2774,2774,2773,2773
Glenn,23,2022-05-22,19,19,19,0,269,269,267,2,0,0,0,0,56,56,56,56
Humboldt,23,2022-05-22,246,246,244,2,2876,2876,2858,18,10,1,1,5,149,149,148,148
Imperial,23,2022-05-22,311,311,309,2,4692,4692,4659,33,2,0,0,2,945,945,945,945
Inyo,23,2022-05-22,23,23,23,0,239,239,238,1,0,0,0,0,56,56,56,56
Kern,23,2022-05-22,946,946,941,5,20668,20668,20548,120,32,0,0,6,2351,2351,2351,2351
Kings,23,2022-05-22,248,248,246,2,5616,5616,5577,39,0,0,0,0,450,450,450,450
Lake,23,2022-05-22,82,82,81,1,1251,1251,1241,10,0,0,0,2,140,140,140,140
Lassen,23,2022-05-22,34,34,34,0,1733,1733,1723,10,0,0,0,0,62,62,62,62
Los Angeles,23,2022-05-22,26498,26498,26446,52,946969,947002,945133,1869,338,29,29,53,32007,32007,31978,31978
Madera,23,2022-05-22,211,211,209,2,3729,3729,3699,30,0,0,0,1,371,371,371,371
Marin,23,2022-05-22,824,824,818,6,8906,8906,8838,68,13,0,0,1,239,239,239,239
Mariposa,23,2022-05-22,34,34,34,0,341,341,338,3,0,0,0,0,28,28,28,28
Mendocino,23,2022-05-22,141,141,140,1,1614,1614,1597,17,3,1,1,1,129,129,128,128
Merced,23,2022-05-22,417,417,415,2,4137,4137,4112,25,4,0,0,0,828,828,828,828
Modoc,23,2022-05-22,2,2,2,0,39,40,39,1,0,0,0,0,8,8,8,8
Mono,23,2022-05-22,16,16,16,0,163,163,161,2,0,0,0,0,6,6,6,6
Monterey,23,2022-05-22,653,653,645,8,9689,9689,9568,121,14,1,1,1,738,738,737,737
Napa,23,2022-05-22,320,320,318,2,4050,4050,4029,21,5,0,0,0,146,146,146,146
Nevada,23,2022-05-22,146,146,145,1,1834,1834,1820,14,1,0,0,0,131,131,131,131
Orange,23,2022-05-22,5532,5532,5507,25,96004,96008,95566,442,104,9,9,22,7158,7158,7149,7149
Placer,23,2022-05-22,902,902,894,8,7965,7965,7897,68,36,3,3,5,631,631,628,628
Plumas,23,2022-05-22,44,44,44,0,259,259,257,2,0,0,0,0,13,13,13,13
Riverside,23,2022-05-22,4327,4327,4301,26,51498,51498,51181,317,69,5,5,11,6479,6479,6474,6474
Sacramento,23,2022-05-22,3814,3814,3789,25,40994,40994,40721,273,104,7,7,12,3094,3094,3087,3087
San Benito,23,2022-05-22,163,163,162,1,1566,1566,1558,8,0,0,0,0,95,95,95,95
San Bernardino,23,2022-05-22,3154,3154,3139,15,50203,50203,49953,250,48,4,4,8,7856,7856,7852,7852
San Diego,23,2022-05-22,8677,8677,8659,18,102287,102291,102078,213,121,2,2,21,5368,5368,5366,5366
San Francisco,23,2022-05-22,3628,3628,3579,49,41650,41650,41085,565,81,6,6,11,895,895,889,889
San Joaquin,23,2022-05-22,1479,1479,1468,11,20642,20642,20491,151,19,3,3,9,2258,2258,2255,2255
San Luis Obispo,23,2022-05-22,642,642,638,4,7086,7086,7046,40,11,3,3,0,488,488,485,485
San Mateo,23,2022-05-22,3117,3117,3103,14,40594,40594,40406,188,35,0,0,2,719,719,719,719
Santa Barbara,23,2022-05-22,1061,1061,1054,7,17946,17946,17832,114,17,0,0,3,693,693,693,693
Santa Clara,23,2022-05-22,7812,7812,7795,17,112722,112727,112478,249,109,7,7,22,2343,2343,2336,2336
Santa Cruz,23,2022-05-22,518,518,515,3,7974,7974,7931,43,13,0,0,2,262,262,262,262
Shasta,23,2022-05-22,186,186,185,1,3546,3546,3522,24,4,1,1,3,573,573,572,572
Siskiyou,23,2022-05-22,22,22,22,0,346,346,344,2,1,0,0,0,83,83,83,83
Solano,23,2022-05-22,1548,1548,1538,10,14803,14803,14711,92,24,1,1,3,451,451,450,450
Sonoma,23,2022-05-22,1529,1529,1520,9,16400,16400,16301,99,34,2,2,3,496,496,494,494
Stanislaus,23,2022-05-22,871,871,863,8,10421,10421,10321,100,36,3,3,5,1699,1699,1696,1696
Sutter,23,2022-05-22,138,138,137,1,1806,1806,1795,11,0,1,1,0,228,228,227,227
Tehama,23,2022-05-22,59,59,58,1,816,816,808,8,0,0,0,1,208,208,208,208
Trinity,23,2022-05-22,4,4,4,0,89,89,88,1,0,0,0,0,20,20,20,20
Tulare,23,2022-05-22,560,560,555,5,9081,9081,8991,90,24,0,0,0,1505,1505,1505,1505
Tuolumne,23,2022-05-22,168,168,167,1,1609,1609,1596,13,0,1,1,0,187,187,186,186
Ventura,23,2022-05-22,1919,1919,1911,8,24202,24202,24099,103,36,2,2,2,1514,1514,1512,1512
Yolo,23,2022-05-22,720,720,716,4,22723,22723,22596,127,0,1,1,0,367,367,366,366
Yuba,23,2022-05-22,158,158,157,1,1442,1442,1433,9,5,0,0,1,126,126,126,126
Alameda,24,2022-05-29,5510,5510,5489,21,73336,73339,73054,285,91,4,4,11,1888,1888,1884,1884
Amador,24,2022-05-29,101,101,100,1,1281,1281,1273,8,0,1,1,0,87,87,86,86
Butte,24,2022-05-29,312,312,311,1,3135,3135,3125,10,13,0,0,1,437,437,437,437
Calaveras,24,2022-05-29,54,54,54,0,721,721,717,4,0,0,0,0,122,122,122,122
Colusa,24,2022-05-29,15,15,15,0,208,208,207,1,0,0,0,0,21,21,21,21
Contra Costa,24,2022-05-29,3704,3704,3680,24,34263,34263,34040,223,70,7,7,8,1333,1333,1326,1326
Del Norte,24,2022-05-29,50,50,50,0,1132,1132,1126,6,1,1,1,1,51,51,50,50
El Dorado,24,2022-05-29,382,382,380,2,3434,3434,3415,19,4,2,2,1,220,220,218,218
Fresno,24,2022-05-29,1885,1885,1874,11,22133,22133,21998,135,57,6,6,9,2780,2780,2774,2774
Glenn,24,2022-05-29,32,32,32,0,323,323,321,2,2,0,0,0,56,56,56,56
Humboldt,24,2022-05-29,212,212,211,1,2798,2798,2784,14,10,0,0,5,149,149,149,149
Imperial,24,2022-05-29,362,362,360,2,4878,4878,4851,27,2,0,0,2,945,945,945,945
Inyo,24,2022-05-29,25,25,25,0,191,191,190,1,0,0,0,0,56,56,56,56
Kern,24,2022-05-29,1217,1217,1212,5,21129,21129,21033,96,32,0,0,4,2351,2351,2351,2351
Kings,24,2022-05-29,329,329,327,2,5350,5350,5321,29,2,0,0,1,450,450,450,450
Lake,24,2022-05-29,112,112,111,1,1154,1154,1147,7,1,0,0,0,140,140,140,140
Lassen,24,2022-05-29,62,62,62,0,1927,1927,1919,8,1,0,0,0,62,62,62,62
Los Angeles,24,2022-05-29,29654,29654,29609,45,897113,897148,895759,1389,434,43,43,52,32050,32050,32007,32007
Madera,24,2022-05-29,259,259,257,2,3766,3766,3743,23,5,0,0,1,371,371,371,371
Marin,24,2022-05-29,728,728,724,4,8224,8224,8175,49,17,3,3,1,242,242,239,239
Mariposa,24,2022-05-29,38,38,38,0,346,346,344,2,0,0,0,0,28,28,28,28
Mendocino,24,2022-05-29,143,143,142,1,1444,1444,1432,12,4,0,0,1,129,129,129,129
Merced,24,2022-05-29,423,423,421,2,4120,4120,4101,19,7,0,0,2,828,828,828,828
Modoc,24,2022-05-29,5,5,5,0,44,45,44,1,0,0,0,0,8,8,8,8
Mono,24,2022-05-29,6,6,6,0,107,107,106,1,0,0,0,0,6,6,6,6
Monterey,24,2022-05-29,618,618,612,6,8855,8855,8768,87,14,1,1,1,739,739,738,738
Napa,24,2022-05-29,367,367,365,2,3790,3790,3774,16,4,0,0,0,146,146,146,146
Nevada,24,2022-05-29,200,200,199,1,1968,1968,1956,12,2,2,2,0,133,133,131,131
Orange,24,2022-05-29,6256,6256,6234,22,95590,95595,95251,344,118,13,13,19,7171,7171,7158,7158
Placer,24,2022-05-29,831,831,825,6,7324,7324,7275,49,51,0,0,7,631,631,631,631
Plumas,24,2022-05-29,35,35,35,0,262,262,260,2,1,0,0,0,13,13,13,13
Riverside,24,2022-05-29,4356,4356,4335,21,51988,51988,51737,251,86,4,4,10,6483,6483,6479,6479
Sacramento,24,2022-05-29,4190,4190,4168,22,39019,39019,38816,203,123,8,8,16,3102,3102,3094,3094
San Benito,24,2022-05-29,179,179,178,1,1563,1563,1556,7,0,0,0,0,95,95,95,95
San Bernardino,24,2022-05-29,3753,3753,3739,14,50154,50154,49959,195,50,5,5,10,7861,7861,7856,7856
San Diego,24,2022-05-29,9239,9239,9224,15,99306,99311,99149,162,150,11,11,24,5379,5379,5368,5368
San Francisco,24,2022-05-29,3382,3382,3346,36,38160,38160,37754,406,85,8,8,9,903,903,895,895
San Joaquin,24,2022-05-29,1548,1548,1539,9,19869,19869,19755,114,28,1,1,5,2259,2259,2258,2258
San Luis Obispo,24,2022-05-29,756,756,753,3,6739,6739,6709,30,13,1,1,0,489,489,488,488
San Mateo,24,2022-05-29,3072,3072,3061,11,37658,37658,37522,136,39,2,2,1,721,721,719,719
Santa Barbara,24,2022-05-29,1133,1133,1127,6,17152,17152,17067,85,28,1,1,6,694,694,693,693
Santa Clara,24,2022-05-29,7687,7687,7674,13,100736,100740,100566,174,150,11,11,20,2354,2354,2343,2343
Santa Cruz,24,2022-05-29,543,543,541,2,7463,7463,7431,32,8,1,1,0,263,263,262,262
Shasta,24,2022-05-29,170,170,169,1,3567,3567,3548,19,5,3,3,4,576,576,573,573
Siskiyou,24,2022-05-29,57,57,57,0,386,386,384,2,3,0,0,0,83,83,83,83
Solano,24,2022-05-29,1416,1416,1409,7,14080,14080,14011,69,33,0,0,5,451,451,451,451
Sonoma,24,2022-05-29,1399,1399,1392,7,15623,15623,15549,74,37,2,2,5,498,498,496,496
Stanislaus,24,2022-05-29,873,873,867,6,10370,10370,10292,78,59,2,2,4,1701,1701,1699,1699
Sutter,24,2022-05-29,167,167,166,1,1968,1968,1958,10,0,0,0,0,228,228,228,228
Tehama,24,2022-05-29,60,60,60,0,879,879,873,6,2,0,0,0,208,208,208,208
Trinity,24,2022-05-29,7,7,7,0,100,100,99,1,0,0,0,0,20,20,20,20
Tulare,24,2022-05-29,619,619,614,5,9086,9086,9016,70,22,0,0,0,1505,1505,1505,1505
Tuolumne,24,2022-05-29,126,126,125,1,1536,1536,1527,9,3,0,0,0,187,187,187,187
Ventura,24,2022-05-29,1884,1884,1878,6,22932,22932,22856,76,33,1,1,3,1515,1515,1514,1514
Yolo,24,2022-05-29,682,682,679,3,20833,20833,20742,91,2,0,0,2,367,367,367,367
Yuba,24,2022-05-29,155,155,154,1,1443,1443,1436,7,11,0,0,0,126,126,126,126
Alameda,25,2022-06-05,5933,5933,5915,18,64793,64796,64603,193,103,3,3,14,1891,1891,1888,1888
Amador,25,2022-06-05,82,82,82,0,1597,1597,1589,8,1,0,0,1,87,87,87,87
Butte,25,2022-06-05,389,389,388,1,3196,3196,3188,8,22,1,1,1,438,438,437,437
Calaveras,25,2022-06-05,68,68,68,0,619,619,616,3,0,2,2,0,124,124,122,122
Colusa,25,2022-06-05,17,17,17,0,235,235,234,1,3,0,0,0,21,21,21,21
Contra Costa,25,2022-06-05,3862,3862,3843,19,31465,31465,31307,158,102,8,8,12,1341,1341,1333,1333
Del Norte,25,2022-06-05,55,55,55,0,1108,1108,1104,4,2,0,0,0,51,51,51,51
El Dorado,25,2022-06-05,362,362,360,2,3155,3155,3142,13,7,0,0,3,220,220,220,220
Fresno,25,2022-06-05,2109,2109,2099,10,20030,20030,19935,95,95,2,2,6,2782,2782,2780,2780
Glenn,25,2022-06-05,39,39,39,0,292,292,291,1,3,0,0,0,56,56,56,56
Humboldt,25,2022-06-05,233,233,232,1,2593,2593,2583,10,11,1,1,2,150,150,149,149
Imperial,25,2022-06-05,411,411,409,2,4208,4208,4190,18,5,1,1,0,946,946,945,945
Inyo,25,2022-06-05,17,17,17,0,166,166,165,1,0,0,0,0,56,56,56,56
Kern,25,2022-06-05,1398,1398,1393,5,20275,20275,20204,71,34,0,0,7,2351,2351,2351,2351
Kings,25,2022-06-05,348,348,347,1,4909,4909,4888,21,7,0,0,1,450,450,450,450
Lake,25,2022-06-05,126,126,125,1,1023,1023,1018,5,3,0,0,2,140,140,140,140
Lassen,25,2022-06-05,67,67,67,0,2012,2012,2005,7,1,0,0,0,62,62,62,62
Los Angeles,25,2022-06-05,31290,31290,31253,37,907923,907963,906884,1079,467,44,44,63,32094,32094,32050,32050
Madera,25,2022-06-05,314,314,313,1,3589,3589,3572,17,6,0,0,0,371,371,371,371
Marin,25,2022-06-05,694,694,691,3,7107,7107,7074,33,10,1,1,3,243,243,242,242
Mariposa,25,2022-06-05,61,61,61,0,367,367,365,2,0,0,0,0,28,28,28,28
Mendocino,25,2022-06-05,194,194,193,1,1515,1515,1505,10,8,0,0,2,129,129,129,129
Merced,25,2022-06-05,461,461,459,2,3766,3766,3752,14,12,0,0,0,828,828,828,828
Modoc,25,2022-06-05,10,10,10,0,35,36,35,1,0,0,0,0,8,8,8,8
Mono,25,2022-06-05,13,13,13,0,111,111,110,1,0,0,0,0,6,6,6,6
Monterey,25,2022-06-05,902,902,895,7,9075,9075,9007,68,18,1,1,1,740,740,739,739
Napa,25,2022-06-05,461,461,460,1,3495,3495,3484,11,7,1,1,0,147,147,146,146
Nevada,25,2022-06-05,217,217,216,1,1823,1823,1814,9,4,0,0,1,133,133,133,133
Orange,25,2022-06-05,6983,6983,6964,19,65960,65963,65781,182,130,12,12,21,7183,7183,7171,7171
Placer,25,2022-06-05,795,795,791,4,6689,6689,6655,34,67,0,0,11,631,631,631,631
Plumas,25,2022-06-05,39,39,39,0,261,261,260,1,0,0,0,0,13,13,13,13
Riverside,25,2022-06-05,4762,4762,4744,18,48582,48583,48403,180,93,5,5,9,6488,6488,6483,6483
Sacramento,25,2022-06-05,4496,4496,4478,18,37422,37422,37272,150,131,14,14,19,3116,3116,3102,3102
San Benito,25,2022-06-05,234,234,233,1,1753,1753,1747,6,0,0,0,0,95,95,95,95
San Bernardino,25,2022-06-05,4428,4428,4415,13,48737,48738,48592,146,78,6,6,11,7867,7867,7861,7861
San Diego,25,2022-06-05,9571,9571,9559,12,91377,91381,91267,114,187,6,6,26,5385,5385,5379,5379
San Francisco,25,2022-06-05,3354,3354,3327,27,35053,35053,34765,288,73,3,3,8,906,906,903,903
San Joaquin,25,2022-06-05,1857,1857,1849,8,19537,19537,19451,86,35,4,4,9,2263,2263,2259,2259
San Luis Obispo,25,2022-06-05,791,791,788,3,6520,6520,6498,22,11,1,1,1,490,490,489,489
San Mateo,25,2022-06-05,2955,2955,2947,8,32953,32953,32861,92,29,3,3,4,724,724,721,721
Santa Barbara,25,2022-06-05,1180,1180,1175,5,13680,13680,13628,52,16,2,2,6,696,696,694,694
Santa Clara,25,2022-06-05,7884,7884,7874,10,92101,92105,91983,122,163,7,7,19,2361,2361,2354,2354
Santa Cruz,25,2022-06-05,780,780,777,3,7499,7499,7475,24,19,0,0,2,263,263,263,263
Shasta,25,2022-06-05,181,181,180,1,3723,3723,3708,15,9,1,1,1,577,577,576,576
Siskiyou,25,2022-06-05,41,41,41,0,391,391,390,1,2,0,0,0,83,83,83,83
Solano,25,2022-06-05,1461,1461,1456,5,13036,13036,12987,49,38,2,2,1,453,453,451,451
Sonoma,25,2022-06-05,1451,1451,1446,5,12103,12103,12059,44,31,1,1,2,499,499,498,498
Stanislaus,25,2022-06-05,1087,1087,1081,6,9633,9633,9577,56,56,1,1,2,1702,1702,1701,1701
Sutter,25,2022-06-05,194,194,193,1,1820,1820,1813,7,0,0,0,0,228,228,228,228
Tehama,25,2022-06-05,74,74,74,0,914,914,909,5,1,0,0,0,208,208,208,208
Trinity,25,2022-06-05,8,8,8,0,111,111,110,1,0,0,0,0,20,20,20,20
Tulare,25,2022-06-05,761,761,757,4,8963,8963,8910,53,27,0,0,1,1505,1505,1505,1505
Tuolumne,25,2022-06-05,108,108,107,1,1459,1459,1452,7,2,0,0,1,187,187,187,187
Ventura,25,2022-06-05,1765,1765,1761,4,21977,21977,21921,56,45,1,1,2,1516,1516,1515,1515
Yolo,25,2022-06-05,748,748,745,3,18940,18940,18877,63,3,2,2,0,369,369,367,367
Yuba,25,2022-06-05,162,162,161,1,1407,1407,1402,5,9,0,0,0,126,126,126,126
Alameda,26,2022-06-12,5315,5315,5303,12,57556,57557,57421,136,116,6,6,17,1897,1897,1891,1891
Amador,26,2022-06-12,143,143,142,1,1432,1432,1426,6,2,0,0,0,87,87,87,87
Butte,26,2022-06-12,416,416,415,1,3425,3425,3418,7,30,3,3,0,441,441,438,438
Calaveras,26,2022-06-12,71,71,71,0,699,699,697,2,0,0,0,0,124,124,124,124
Colusa,26,2022-06-12,17,17,17,0,277,277,276,1,17,0,0,0,21,21,21,21
Contra Costa,26,2022-06-12,3523,3523,3509,14,29326,29326,29210,116,89,8,8,11,1349,1349,1341,1341
Del Norte,26,2022-06-12,76,76,76,0,652,652,650,2,3,0,0,0,51,51,51,51
El Dorado,26,2022-06-12,340,340,339,1,3386,3386,3375,11,6,3,3,3,223,223,220,220
Fresno,26,2022-06-12,2399,2399,2390,9,20599,20599,20522,77,119,5,5,9,2787,2787,2782,2782
Glenn,26,2022-06-12,36,36,36,0,327,327,326,1,5,0,0,0,56,56,56,56
Humboldt,26,2022-06-12,247,247,246,1,2433,2433,2426,7,16,0,0,2,150,150,150,150
Imperial,26,2022-06-12,464,464,462,2,4502,4502,4487,15,5,1,1,1,947,947,946,946
Inyo,26,2022-06-12,15,15,15,0,207,207,206,1,0,0,0,0,56,56,56,56
Kern,26,2022-06-12,1595,1595,1591,4,21321,21321,21262,59,28,2,2,7,2353,2353,2351,2351
Kings,26,2022-06-12,356,356,355,1,5144,5144,5127,17,6,1,1,0,451,451,450,450
Lake,26,2022-06-12,131,131,131,0,1216,1216,1211,5,1,0,0,0,140,140,140,140
Lassen,26,2022-06-12,66,66,66,0,1993,1993,1988,5,3,0,0,0,62,62,62,62
Los Angeles,26,2022-06-12,31114,31114,31085,29,761427,761461,760745,716,531,51,51,62,32145,32145,32094,32094
Madera,26,2022-06-12,351,351,350,1,4016,4016,4001,15,8,0,0,1,371,371,371,371
Marin,26,2022-06-12,690,690,688,2,6994,6994,6969,25,16,3,3,2,246,246,243,243
Mariposa,26,2022-06-12,41,41,41,0,380,380,378,2,0,0,0,0,28,28,28,28
Mendocino,26,2022-06-12,175,175,174,1,1614,1614,1606,8,7,1,1,1,130,130,129,129
Merced,26,2022-06-12,539,539,537,2,4087,4087,4075,12,16,0,0,2,828,828,828,828
Modoc,26,2022-06-12,8,8,8,0,35,36,35,1,1,1,1,0,9,9,8,8
Mono,26,2022-06-12,18,18,18,0,83,83,82,1,0,0,0,0,6,6,6,6
Monterey,26,2022-06-12,837,837,832,5,8760,8760,8708,52,26,4,4,1,744,744,740,740
Napa,26,2022-06-12,514,514,513,1,4161,4161,4151,10,3,1,1,1,148,148,147,147
Nevada,26,2022-06-12,185,185,184,1,1899,1899,1892,7,6,0,0,0,133,133,133,133
Orange,26,2022-06-12,7096,7096,7081,15,66415,66418,66273,145,186,15,15,20,7198,7198,7183,7183
Placer,26,2022-06-12,818,818,815,3,7004,7004,6975,29,75,2,2,7,633,633,631,631
Plumas,26,2022-06-12,36,36,36,0,286,286,285,1,0,0,0,0,13,13,13,13
Riverside,26,2022-06-12,5037,5037,5022,15,49292,49292,49148,144,95,3,3,10,6491,6491,6488,6488
Sacramento,26,2022-06-12,4347,4347,4333,14,37903,37903,37783,120,151,14,14,25,3130,3130,3116,3116
San Benito,26,2022-06-12,210,210,209,1,1779,1779,1774,5,0,0,0,2,95,95,95,95
San Bernardino,26,2022-06-12,4735,4735,4724,11,50065,50065,49947,118,83,7,7,15,7874,7874,7867,7867
San Diego,26,2022-06-12,9721,9721,9711,10,85709,85714,85630,84,178,12,12,30,5397,5397,5385,5385
San Francisco,26,2022-06-12,3060,3060,3040,20,31772,31772,31566,206,68,9,9,12,915,915,906,906
San Joaquin,26,2022-06-12,2000,2000,1993,7,19459,19459,19391,68,34,6,6,3,2269,2269,2263,2263
San Luis Obispo,26,2022-06-12,686,686,684,2,6195,6195,6178,17,18,0,0,0,490,490,490,490
San Mateo,26,2022-06-12,2683,2683,2677,6,29873,29873,29807,66,44,3,3,2,727,727,724,724
Santa Barbara,26,2022-06-12,949,949,946,3,9894,9894,9864,30,22,1,1,5,697,697,696,696
Santa Clara,26,2022-06-12,7281,7281,7273,8,81096,81100,81015,85,171,11,11,24,2372,2372,2361,2361
Santa Cruz,26,2022-06-12,874,874,872,2,10570,10570,10543,27,23,1,1,1,264,264,263,263
Shasta,26,2022-06-12,214,214,213,1,3531,3531,3520,11,0,2,2,0,579,579,577,577
Siskiyou,26,2022-06-12,47,47,47,0,374,374,373,1,1,0,0,0,83,83,83,83
Solano,26,2022-06-12,1741,1741,1736,5,13314,13314,13275,39,38,0,0,3,453,453,453,453
Sonoma,26,2022-06-12,1361,1361,1357,4,11988,11988,11954,34,35,0,0,5,499,499,499,499
Stanislaus,26,2022-06-12,1126,1126,1121,5,9573,9573,9529,44,59,1,1,6,1703,1703,1702,1702
Sutter,26,2022-06-12,185,185,184,1,1800,1800,1795,5,0,0,0,0,228,228,228,228
Tehama,26,2022-06-12,86,86,86,0,1002,1002,998,4,3,0,0,0,208,208,208,208
Trinity,26,2022-06-12,8,8,8,0,79,80,79,1,0,0,0,0,20,20,20,20
Tulare,26,2022-06-12,824,824,820,4,9618,9618,9573,45,23,2,2,1,1507,1507,1505,1505
Tuolumne,26,2022-06-12,146,146,145,1,1516,1516,1510,6,2,0,0,0,187,187,187,187
Ventura,26,2022-06-12,1933,1933,1929,4,21119,21119,21076,43,39,6,6,5,1522,1522,1516,1516
Yolo,26,2022-06-12,775,775,773,2,15441,15441,15400,41,2,0,0,0,369,369,369,369
Yuba,26,2022-06-12,201,201,200,1,1465,1465,1461,4,9,0,0,1,126,126,126,126
Alameda,27,2022-06-19,4847,4847,4838,9,51243,51243,51149,94,93,10,10,13,1907,1907,1897,1897
Amador,27,2022-06-19,77,77,77,0,1235,1235,1231,4,1,0,0,0,87,87,87,87
Butte,27,2022-06-19,409,409,408,1,3610,3610,3605,5,25,5,5,0,446,446,441,441
Calaveras,27,2022-06-19,78,78,78,0,619,619,617,2,0,0,0,0,124,124,124,124
Colusa,27,2022-06-19,13,13,13,0,258,258,257,1,18,0,0,0,21,21,21,21
Contra Costa,27,2022-06-19,3247,3247,3237,10,26442,26442,26361,81,68,7,7,7,1356,1356,1349,1349
Del Norte,27,2022-06-19,79,79,79,0,616,616,615,1,2,1,1,1,52,52,51,51
El Dorado,27,2022-06-19,330,330,329,1,3048,3048,3040,8,7,2,2,1,225,225,223,223
Fresno,27,2022-06-19,2488,2488,2481,7,20052,20052,19994,58,85,1,1,15,2788,2788,2787,2787
Glenn,27,2022-06-19,35,35,35,0,317,317,316,1,3,0,0,0,56,56,56,56
Humboldt,27,2022-06-19,292,292,291,1,2280,2280,2275,5,14,0,0,3,150,150,150,150
Imperial,27,2022-06-19,557,557,556,1,4071,4071,4060,11,7,0,0,0,947,947,947,947
Inyo,27,2022-06-19,20,20,20,0,185,186,185,1,0,0,0,0,56,56,56,56
Kern,27,2022-06-19,1566,1566,1563,3,20670,20670,20626,44,35,5,5,10,2358,2358,2353,2353
Kings,27,2022-06-19,397,397,396,1,5030,5030,5017,13,4,1,1,0,452,452,451,451
Lake,27,2022-06-19,129,129,129,0,1190,1190,1186,4,2,0,0,1,140,140,140,140
Lassen,27,2022-06-19,48,48,48,0,1282,1282,1279,3,1,0,0,0,62,62,62,62
Los Angeles,27,2022-06-19,27617,27617,27597,20,362602,362619,362356,263,610,57,57,61,32202,32202,32145,32145
Madera,27,2022-06-19,342,342,341,1,4136,4136,4124,12,6,0,0,0,371,371,371,371
Marin,27,2022-06-19,675,675,673,2,6508,6508,6490,18,19,0,0,2,246,246,246,246
Mariposa,27,2022-06-19,52,52,52,0,346,346,345,1,0,0,0,0,28,28,28,28
Mendocino,27,2022-06-19,175,175,174,1,1572,1572,1566,6,5,0,0,1,130,130,130,130
Merced,27,2022-06-19,557,557,556,1,4139,4139,4130,9,11,3,3,1,831,831,828,828
Modoc,27,2022-06-19,2,2,2,0,34,35,34,1,1,0,0,0,9,9,9,9
Mono,27,2022-06-19,8,8,8,0,91,92,91,1,0,1,1,0,7,7,6,6
Monterey,27,2022-06-19,902,902,898,4,8981,8981,8940,41,35,1,1,2,745,745,744,744
Napa,27,2022-06-19,372,372,371,1,3305,3305,3298,7,0,1,1,3,149,149,148,148
Nevada,27,2022-06-19,184,184,183,1,1729,1729,1724,5,7,1,1,0,134,134,133,133
Orange,27,2022-06-19,7104,7104,7092,12,61901,61903,61798,105,158,9,9,21,7207,7207,7198,7198
Placer,27,2022-06-19,669,669,667,2,6135,6135,6116,19,65,1,1,6,634,634,633,633
Plumas,27,2022-06-19,36,36,36,0,231,231,230,1,0,0,0,0,13,13,13,13
Riverside,27,2022-06-19,5034,5034,5023,11,44730,44730,44628,102,103,6,6,8,6497,6497,6491,6491
Sacramento,27,2022-06-19,3949,3949,3939,10,35800,35800,35712,88,156,10,10,25,3140,3140,3130,3130
San Benito,27,2022-06-19,185,185,185,0,1678,1678,1675,3,0,1,1,1,96,96,95,95
San Bernardino,27,2022-06-19,4632,4632,4624,8,47013,47013,46926,87,102,11,11,14,7885,7885,7874,7874
San Diego,27,2022-06-19,9856,9856,9848,8,80400,80405,80343,62,203,8,8,17,5405,5405,5397,5397
San Francisco,27,2022-06-19,3085,3085,3070,15,29888,29888,29737,151,70,13,13,15,928,928,915,915
San Joaquin,27,2022-06-19,1706,1706,1701,5,18233,18233,18183,50,37,5,5,7,2274,2274,2269,2269
San Luis Obispo,27,2022-06-19,597,597,596,1,5838,5838,5826,12,30,9,9,0,499,499,490,490
San Mateo,27,2022-06-19,2634,2634,2630,4,27395,27395,27348,47,47,2,2,4,729,729,727,727
Santa Barbara,27,2022-06-19,937,937,935,2,8694,8694,8674,20,31,2,2,6,699,699,697,697
Santa Clara,27,2022-06-19,6813,6813,6808,5,65976,65980,65926,54,156,10,10,20,2382,2382,2372,2372
Santa Cruz,27,2022-06-19,815,815,813,2,9307,9307,9288,19,18,1,1,2,265,265,264,264
Shasta,27,2022-06-19,229,229,228,1,3291,3291,3283,8,8,1,1,1,580,580,579,579
Siskiyou,27,2022-06-19,57,57,57,0,399,399,398,1,2,1,1,0,84,84,83,83
Solano,27,2022-06-19,1454,1454,1451,3,11788,11788,11761,27,38,0,0,6,453,453,453,453
Sonoma,27,2022-06-19,1416,1416,1413,3,10988,10988,10963,25,34,2,2,2,501,501,499,499
Stanislaus,27,2022-06-19,1051,1051,1047,4,8901,8901,8869,32,72,5,5,6,1708,1708,1703,1703
Sutter,27,2022-06-19,201,201,201,0,1870,1870,1866,4,0,0,0,0,228,228,228,228
Tehama,27,2022-06-19,107,107,107,0,924,924,921,3,2,0,0,0,208,208,208,208
Trinity,27,2022-06-19,10,10,10,0,108,109,108,1,0,0,0,0,20,20,20,20
Tulare,27,2022-06-19,912,912,909,3,9374,9374,9340,34,31,6,6,0,1513,1513,1507,1507
Tuolumne,27,2022-06-19,140,140,140,0,1561,1561,1556,5,2,0,0,1,187,187,187,187
Ventura,27,2022-06-19,1839,1839,1836,3,19157,19157,19127,30,52,1,1,4,1523,1523,1522,1522
Yolo,27,2022-06-19,709,709,708,1,12071,12071,12046,25,1,2,2,2,371,371,369,369
Yuba,27,2022-06-19,146,146,146,0,1377,1377,1374,3,9,0,0,6,126,126,126,126
Alameda,28,2022-06-26,5311,5311,5303,8,46868,46869,46802,67,134,7,7,14,1914,1914,1907,1907
Amador,28,2022-06-26,99,99,99,0,1163,1163,1160,3,1,0,0,2,87,87,87,87
Butte,28,2022-06-26,399,399,399,0,3377,3377,3373,4,27,2,2,0,448,448,446,446
Calaveras,28,2022-06-26,72,72,72,0,578,578,577,1,1,2,2,0,126,126,124,124
Colusa,28,2022-06-26,23,23,23,0,188,189,188,1,8,1,1,0,22,22,21,21
Contra Costa,28,2022-06-26,3590,3590,3581,9,25372,25372,25311,61,93,11,11,5,1367,1367,1356,1356
Del Norte,28,2022-06-26,135,135,135,0,664,664,663,1,5,1,1,0,53,53,52,52
El Dorado,28,2022-06-26,425,425,424,1,3145,3145,3139,6,7,0,0,1,225,225,225,225
Fresno,28,2022-06-26,2739,2739,2733,6,19773,19773,19728,45,129,3,3,14,2791,2791,2788,2788
Glenn,28,2022-06-26,32,32,32,0,296,296,295,1,2,0,0,0,56,56,56,56
Humboldt,28,2022-06-26,274,274,273,1,2215,2215,2211,4,4,1,1,2,151,151,150,150
Imperial,28,2022-06-26,679,679,678,1,3848,3848,3840,8,7,0,0,2,947,947,947,947
Inyo,28,2022-06-26,22,22,22,0,233,234,233,1,0,0,0,0,56,56,56,56
Kern,28,2022-06-26,1876,1876,1873,3,18358,18358,18327,31,43,6,6,10,2364,2364,2358,2358
Kings,28,2022-06-26,456,456,455,1,4146,4146,4138,8,8,0,0,0,452,452,452,452
Lake,28,2022-06-26,117,117,117,0,1130,1130,1127,3,1,0,0,0,140,140,140,140
Lassen,28,2022-06-26,55,55,55,0,1096,1096,1094,2,1,0,0,0,62,62,62,62
Los Angeles,28,2022-06-26,31042,31042,31025,17,356797,356816,356615,201,690,72,72,69,32274,32274,32202,32202
Madera,28,2022-06-26,437,437,436,1,4315,4315,4305,10,7,0,0,0,371,371,371,371
Marin,28,2022-06-26,667,667,666,1,6230,6230,6216,14,23,0,0,3,246,246,246,246
Mariposa,28,2022-06-26,54,54,54,0,304,304,303,1,0,0,0,0,28,28,28,28
Mendocino,28,2022-06-26,151,151,151,0,1422,1422,1418,4,4,0,0,0,130,130,130,130
Merced,28,2022-06-26,587,587,586,1,4029,4029,4022,7,5,2,2,3,833,833,831,831
Modoc,28,2022-06-26,9,9,9,0,33,34,33,1,0,0,0,0,9,9,9,9
Mono,28,2022-06-26,17,17,17,0,81,82,81,1,0,0,0,0,7,7,7,7
Monterey,28,2022-06-26,903,903,900,3,8470,8470,8440,30,36,2,2,5,747,747,745,745
Napa,28,2022-06-26,374,374,373,1,3207,3207,3202,5,2,2,2,1,151,151,149,149
Nevada,28,2022-06-26,175,175,175,0,1586,1586,1582,4,3,0,0,1,134,134,134,134
Orange,28,2022-06-26,7440,7440,7430,10,58597,58601,58524,77,172,13,13,25,7220,7220,7207,7207
Placer,28,2022-06-26,798,798,796,2,6153,6153,6138,15,87,6,6,7,640,640,634,634
Plumas,28,2022-06-26,46,46,46,0,263,263,262,1,0,0,0,0,13,13,13,13
Riverside,28,2022-06-26,5843,5843,5833,10,44025,44025,43947,78,125,10,10,21,6507,6507,6497,6497
Sacramento,28,2022-06-26,4072,4072,4064,8,34548,34548,34482,66,181,13,13,23,3153,3153,3140,3140
San Benito,28,2022-06-26,194,194,194,0,1547,1547,1545,2,0,0,0,2,96,96,96,96
San Bernardino,28,2022-06-26,5333,5333,5325,8,47647,47648,47580,68,120,12,12,21,7897,7897,7885,7885
San Diego,28,2022-06-26,10181,10181,10175,6,77843,77848,77802,46,249,10,10,22,5415,5415,5405,5405
San Francisco,28,2022-06-26,3154,3154,3142,12,27797,27797,27688,109,95,4,4,18,932,932,928,928
San Joaquin,28,2022-06-26,1839,1839,1835,4,18213,18213,18174,39,39,3,3,9,2277,2277,2274,2274
San Luis Obispo,28,2022-06-26,651,651,650,1,5818,5818,5808,10,26,4,4,0,503,503,499,499
San Mateo,28,2022-06-26,2828,2828,2824,4,25719,25719,25685,34,37,1,1,1,730,730,729,729
Santa Barbara,28,2022-06-26,1111,1111,1109,2,9319,9319,9302,17,26,2,2,2,701,701,699,699
Santa Clara,28,2022-06-26,7336,7336,7331,5,59873,59877,59839,38,185,12,12,13,2394,2394,2382,2382
Santa Cruz,28,2022-06-26,866,866,865,1,9126,9126,9112,14,21,2,2,1,267,267,265,265
Shasta,28,2022-06-26,315,315,314,1,3304,3304,3298,6,21,0,0,3,580,580,580,580
Siskiyou,28,2022-06-26,57,57,57,0,344,344,343,1,1,1,1,0,85,85,84,84
Solano,28,2022-06-26,1600,1600,1597,3,12736,12736,12713,23,39,0,0,4,453,453,453,453
Sonoma,28,2022-06-26,1376,1376,1374,2,10016,10016,9999,17,36,2,2,3,503,503,501,501
Stanislaus,28,2022-06-26,1196,1196,1193,3,8801,8801,8777,24,95,2,2,6,1710,1710,1708,1708
Sutter,28,2022-06-26,188,188,188,0,1839,1839,1836,3,0,0,0,0,228,228,228,228
Tehama,28,2022-06-26,85,85,85,0,829,829,827,2,3,0,0,0,208,208,208,208
Trinity,28,2022-06-26,22,22,22,0,139,140,139,1,1,0,0,0,20,20,20,20
Tulare,28,2022-06-26,915,915,912,3,7819,7819,7797,22,38,2,2,1,1515,1515,1513,1513
Tuolumne,28,2022-06-26,167,167,167,0,1416,1416,1413,3,1,4,4,0,191,191,187,187
Ventura,28,2022-06-26,2047,2047,2045,2,18783,18783,18760,23,58,2,2,1,1525,1525,1523,1523
Yolo,28,2022-06-26,765,765,764,1,10596,10596,10579,17,8,1,1,1,372,372,371,371
Yuba,28,2022-06-26,167,167,167,0,1402,1402,1400,2,8,2,2,2,128,128,126,126
Alameda,29,2022-07-03,5360,5360,5354,6,45362,45366,45315,51,126,12,12,11,1926,1926,1914,1914
Amador,29,2022-07-03,97,97,97,0,1661,1661,1658,3,3,0,0,2,87,87,87,87
Butte,29,2022-07-03,343,343,343,0,3089,3089,3086,3,24,2,2,1,450,450,448,448
Calaveras,29,2022-07-03,80,80,80,0,562,562,561,1,0,2,2,0,128,128,126,126
Colusa,29,2022-07-03,28,28,28,0,263,264,263,1,3,0,0,0,22,22,22,22
Contra Costa,29,2022-07-03,3586,3586,3579,7,24611,24611,24565,46,78,10,10,18,1377,1377,1367,1367
Del Norte,29,2022-07-03,153,153,153,0,667,667,666,1,4,0,0,0,53,53,53,53
El Dorado,29,2022-07-03,357,357,356,1,3023,3023,3018,5,11,1,1,0,226,226,225,225
Fresno,29,2022-07-03,2757,2757,2752,5,18215,18215,18183,32,146,4,4,18,2795,2795,2791,2791
Glenn,29,2022-07-03,28,28,28,0,267,268,267,1,1,0,0,0,56,56,56,56
Humboldt,29,2022-07-03,203,203,203,0,1914,1914,1911,3,8,2,2,4,153,153,151,151
Imperial,29,2022-07-03,768,768,767,1,3797,3797,3791,6,8,1,1,3,948,948,947,947
Inyo,29,2022-07-03,49,49,49,0,366,366,365,1,2,0,0,0,56,56,56,56
Kern,29,2022-07-03,1959,1959,1956,3,16434,16434,16413,21,53,5,5,6,2369,2369,2364,2364
Kings,29,2022-07-03,521,521,520,1,3917,3917,3911,6,5,0,0,0,452,452,452,452
Lake,29,2022-07-03,115,115,115,0,1021,1021,1019,2,2,2,2,1,142,142,140,140
Lassen,29,2022-07-03,37,37,37,0,821,821,820,1,2,0,0,0,62,62,62,62
Los Angeles,29,2022-07-03,36042,36042,36026,16,322792,322814,322671,143,759,82,82,87,32356,32356,32274,32274
Madera,29,2022-07-03,383,383,382,1,4047,4047,4040,7,10,0,0,1,371,371,371,371
Marin,29,2022-07-03,659,659,658,1,5706,5706,5696,10,24,1,1,2,247,247,246,246
Mariposa,29,2022-07-03,40,40,40,0,251,252,251,1,0,0,0,0,28,28,28,28
Mendocino,29,2022-07-03,180,180,180,0,1311,1311,1308,3,5,3,3,0,133,133,130,130
Merced,29,2022-07-03,682,682,681,1,3688,3688,3683,5,12,1,1,1,834,834,833,833
Modoc,29,2022-07-03,11,11,11,0,34,35,34,1,1,0,0,0,9,9,9,9
Mono,29,2022-07-03,31,31,31,0,119,120,119,1,1,0,0,0,7,7,7,7
Monterey,29,2022-07-03,901,901,898,3,7296,7296,7275,21,47,2,2,3,749,749,747,747
Napa,29,2022-07-03,406,406,406,0,3154,3154,3150,4,12,0,0,0,151,151,151,151
Nevada,29,2022-07-03,202,202,202,0,1527,1527,1524,3,6,0,0,1,134,134,134,134
Orange,29,2022-07-03,8049,8049,8041,8,58344,58349,58289,60,195,26,26,35,7246,7246,7220,7220
Placer,29,2022-07-03,850,850,848,2,5844,5844,5833,11,78,2,2,5,642,642,640,640
Plumas,29,2022-07-03,36,36,36,0,222,223,222,1,5,0,0,0,13,13,13,13
Riverside,29,2022-07-03,7053,7053,7043,10,44723,44727,44665,62,128,7,7,8,6514,6514,6507,6507
Sacramento,29,2022-07-03,4134,4134,4128,6,31978,31978,31930,48,165,12,12,24,3165,3165,3153,3153
San Benito,29,2022-07-03,248,248,248,0,1584,1584,1582,2,2,0,0,1,96,96,96,96
San Bernardino,29,2022-07-03,6671,6671,6664,7,48568,48573,48519,54,138,12,12,24,7909,7909,7897,7897
San Diego,29,2022-07-03,10994,10994,10989,5,76385,76390,76354,36,262,10,10,41,5425,5425,5415,5415
San Francisco,29,2022-07-03,3188,3188,3178,10,27643,27643,27558,85,104,9,9,16,941,941,932,932
San Joaquin,29,2022-07-03,1886,1886,1883,3,16663,16663,16635,28,43,4,4,6,2281,2281,2277,2277
San Luis Obispo,29,2022-07-03,682,682,681,1,4981,4981,4975,6,23,0,0,0,503,503,503,503
San Mateo,29,2022-07-03,2812,2812,2809,3,25311,25311,25285,26,34,2,2,3,732,732,730,730
Santa Barbara,29,2022-07-03,1157,1157,1155,2,9125,9125,9112,13,25,4,4,5,705,705,701,701
Santa Clara,29,2022-07-03,7461,7461,7457,4,58035,58040,58011,29,195,16,16,32,2410,2410,2394,2394
Santa Cruz,29,2022-07-03,829,829,828,1,8886,8886,8875,11,21,0,0,1,267,267,267,267
Shasta,29,2022-07-03,328,328,328,0,3092,3092,3087,5,14,4,4,2,584,584,580,580
Siskiyou,29,2022-07-03,49,49,49,0,387,388,387,1,1,0,0,1,85,85,85,85
Solano,29,2022-07-03,1539,1539,1537,2,11727,11727,11711,16,49,0,0,6,453,453,453,453
Sonoma,29,2022-07-03,1220,1220,1218,2,9610,9610,9597,13,38,1,1,0,504,504,503,503
Stanislaus,29,2022-07-03,1246,1246,1243,3,7954,7954,7937,17,88,7,7,14,1717,1717,1710,1710
Sutter,29,2022-07-03,245,245,245,0,1845,1845,1842,3,0,0,0,0,228,228,228,228
Tehama,29,2022-07-03,130,130,130,0,984,984,982,2,4,2,2,0,210,210,208,208
Trinity,29,2022-07-03,21,21,21,0,150,151,150,1,2,0,0,0,20,20,20,20
Tulare,29,2022-07-03,1030,1030,1028,2,7609,7609,7592,17,30,2,2,3,1517,1517,1515,1515
Tuolumne,29,2022-07-03,166,166,166,0,1172,1172,1170,2,8,0,0,1,191,191,191,191
Ventura,29,2022-07-03,2132,2132,2130,2,17762,17762,17745,17,86,3,3,3,1528,1528,1525,1525
Yolo,29,2022-07-03,607,607,606,1,8443,8443,8432,11,5,3,3,2,375,375,372,372
Yuba,29,2022-07-03,190,190,190,0,1239,1239,1237,2,6,1,1,2,129,129,128,128
Alameda,30,2022-07-10,5357,5357,5352,5,42092,42096,42060,36,120,4,4,19,1930,1930,1926,1926
Amador,30,2022-07-10,90,90,90,0,1442,1442,1440,2,0,0,0,2,87,87,87,87
Butte,30,2022-07-10,411,411,411,0,2717,2717,2715,2,26,1,1,3,451,451,450,450
Calaveras,30,2022-07-10,85,85,85,0,493,493,492,1,0,1,1,0,129,129,128,128
Colusa,30,2022-07-10,24,24,24,0,360,361,360,1,0,0,0,0,22,22,22,22
Contra Costa,30,2022-07-10,3425,3425,3420,5,23043,23043,23010,33,98,13,13,13,1390,1390,1377,1377
Del Norte,30,2022-07-10,143,143,143,0,590,590,589,1,6,0,0,2,53,53,53,53
El Dorado,30,2022-07-10,331,331,331,0,2687,2687,2684,3,14,0,0,2,226,226,226,226
Fresno,30,2022-07-10,3238,3238,3234,4,18552,18552,18527,25,156,8,8,13,2803,2803,2795,2795
Glenn,30,2022-07-10,41,41,41,0,283,284,283,1,0,0,0,0,56,56,56,56
Humboldt,30,2022-07-10,254,254,254,0,1830,1830,1828,2,8,1,1,2,154,154,153,153
Imperial,30,2022-07-10,967,967,966,1,3913,3913,3908,5,9,0,0,1,948,948,948,948
Inyo,30,2022-07-10,39,39,39,0,330,331,330,1,0,1,1,0,57,57,56,56
Kern,30,2022-07-10,2107,2107,2105,2,14701,14701,14686,15,70,2,2,11,2371,2371,2369,2369
Kings,30,2022-07-10,581,581,580,1,3795,3795,3790,5,11,4,4,1,456,456,452,452
Lake,30,2022-07-10,112,112,112,0,974,974,973,1,1,0,0,0,142,142,142,142
Lassen,30,2022-07-10,47,47,47,0,701,701,700,1,5,1,1,0,63,63,62,62
Los Angeles,30,2022-07-10,38839,38843,38830,13,346149,346176,346058,118,982,91,91,97,32447,32447,32356,32356
Madera,30,2022-07-10,450,450,449,1,3428,3428,3423,5,12,0,0,4,371,371,371,371
Marin,30,2022-07-10,576,576,575,1,5372,5372,5365,7,17,1,1,2,248,248,247,247
Mariposa,30,2022-07-10,49,49,49,0,267,268,267,1,0,0,0,0,28,28,28,28
Mendocino,30,2022-07-10,172,172,172,0,1247,1247,1245,2,6,0,0,0,133,133,133,133
Merced,30,2022-07-10,655,655,654,1,3594,3594,3590,4,16,5,5,1,839,839,834,834
Modoc,30,2022-07-10,27,27,27,0,53,54,53,1,0,1,1,0,10,10,9,9
Mono,30,2022-07-10,11,11,11,0,85,86,85,1,0,0,0,0,7,7,7,7
Monterey,30,2022-07-10,1010,1010,1008,2,7055,7055,7040,15,46,4,4,1,753,753,749,749
Napa,30,2022-07-10,329,329,329,0,3103,3103,3100,3,11,1,1,2,152,152,151,151
Nevada,30,2022-07-10,179,179,179,0,1533,1533,1531,2,5,0,0,1,134,134,134,134
Orange,30,2022-07-10,8729,8729,8722,7,56875,56879,56834,45,245,23,23,31,7269,7269,7246,7246
Placer,30,2022-07-10,754,754,753,1,5244,5244,5236,8,87,3,3,8,645,645,642,642
Plumas,30,2022-07-10,65,65,65,0,245,246,245,1,0,0,0,0,13,13,13,13
Riverside,30,2022-07-10,8192,8192,8183,9,45021,45025,44977,48,200,16,16,13,6530,6530,6514,6514
Sacramento,30,2022-07-10,3775,3775,3771,4,30704,30705,30670,35,191,26,26,23,3191,3191,3165,3165
San Benito,30,2022-07-10,206,206,206,0,1454,1454,1453,1,1,0,0,0,96,96,96,96
San Bernardino,30,2022-07-10,7574,7574,7568,6,49386,49390,49347,43,174,12,12,24,7921,7921,7909,7909
San Diego,30,2022-07-10,11842,11842,11838,4,74688,74693,74666,27,316,9,9,50,5434,5434,5425,5425
San Francisco,30,2022-07-10,2781,2781,2774,7,24834,24834,24775,59,107,14,14,19,955,955,941,941
San Joaquin,30,2022-07-10,1936,1936,1934,2,17159,17159,17137,22,58,7,7,7,2288,2288,2281,2281
San Luis Obispo,30,2022-07-10,702,702,701,1,4714,4714,4709,5,25,3,3,0,506,506,503,503
San Mateo,30,2022-07-10,2614,2614,2612,2,22348,22348,22330,18,36,5,5,12,737,737,732,732
Santa Barbara,30,2022-07-10,1201,1201,1200,1,8354,8354,8345,9,37,4,4,11,709,709,705,705
Santa Clara,30,2022-07-10,6992,6992,6989,3,53777,53781,53761,20,203,12,12,42,2422,2422,2410,2410
Santa Cruz,30,2022-07-10,901,901,900,1,7921,7921,7914,7,16,0,0,0,267,267,267,267
Shasta,30,2022-07-10,296,296,296,0,2923,2923,2920,3,18,3,3,5,587,587,584,584
Siskiyou,30,2022-07-10,29,29,29,0,317,318,317,1,1,1,1,1,86,86,85,85
Solano,30,2022-07-10,1457,1457,1455,2,10060,10060,10049,11,48,1,1,6,454,454,453,453
Sonoma,30,2022-07-10,1210,1210,1209,1,8755,8755,8746,9,39,1,1,6,505,505,504,504
Stanislaus,30,2022-07-10,1374,1374,1372,2,7974,7974,7961,13,101,7,7,10,1724,1724,1717,1717
Sutter,30,2022-07-10,258,258,258,0,1611,1611,1609,2,0,0,0,0,228,228,228,228
Tehama,30,2022-07-10,124,124,124,0,782,782,781,1,6,0,0,1,210,210,210,210
Trinity,30,2022-07-10,30,30,30,0,113,114,113,1,0,0,0,0,20,20,20,20
Tulare,30,2022-07-10,1231,1231,1229,2,7637,7637,7624,13,46,5,5,1,1522,1522,1517,1517
Tuolumne,30,2022-07-10,239,239,239,0,1127,1127,1125,2,5,0,0,0,191,191,191,191
Ventura,30,2022-07-10,2285,2285,2283,2,17318,17318,17305,13,78,8,8,4,1536,1536,1528,1528
Yolo,30,2022-07-10,466,466,466,0,4772,4772,4767,5,7,3,3,3,378,378,375,375
Yuba,30,2022-07-10,193,193,193,0,1254,1254,1253,1,6,0,0,2,129,129,129,129
Alameda,31,2022-07-17,5092,5092,5089,3,43702,43707,43677,30,141,6,6,29,1936,1936,1930,1930
Amador,31,2022-07-17,86,86,86,0,1264,1264,1263,1,3,0,0,2,87,87,87,87
Butte,31,2022-07-17,374,374,374,0,2918,2918,2916,2,28,1,1,3,452,452,451,451
Calaveras,31,2022-07-17,71,71,71,0,548,548,547,1,0,0,0,0,129,129,129,129
Colusa,31,2022-07-17,21,21,21,0,347,348,347,1,0,0,0,0,22,22,22,22
Contra Costa,31,2022-07-17,3101,3101,3097,4,23050,23050,23024,26,92,3,3,15,1393,1393,1390,1390
Del Norte,31,2022-07-17,181,181,181,0,689,689,688,1,7,0,0,0,53,53,53,53
El Dorado,31,2022-07-17,316,316,316,0,2688,2688,2685,3,8,2,2,0,228,228,226,226
Fresno,31,2022-07-17,3678,3678,3674,4,21095,21095,21072,23,180,9,9,15,2812,2812,2803,2803
Glenn,31,2022-07-17,33,33,33,0,264,265,264,1,0,0,0,0,56,56,56,56
Humboldt,31,2022-07-17,300,300,300,0,2024,2024,2022,2,8,0,0,4,154,154,154,154
Imperial,31,2022-07-17,1050,1050,1049,1,4639,4639,4634,5,17,3,3,0,951,951,948,948
Inyo,31,2022-07-17,25,25,25,0,331,332,331,1,1,0,0,0,57,57,57,57
Kern,31,2022-07-17,2334,2334,2332,2,16147,16147,16134,13,71,9,9,17,2380,2380,2371,2371
Kings,31,2022-07-17,744,744,743,1,4161,4161,4157,4,12,0,0,0,456,456,456,456
Lake,31,2022-07-17,125,125,125,0,939,939,938,1,0,0,0,0,142,142,142,142
Lassen,31,2022-07-17,67,67,67,0,994,994,993,1,1,0,0,0,63,63,63,63
Los Angeles,31,2022-07-17,41854,41859,41848,11,353548,353579,353485,94,1142,112,112,131,32559,32559,32447,32447
Madera,31,2022-07-17,528,528,527,1,3862,3862,3858,4,9,0,0,5,371,371,371,371
Marin,31,2022-07-17,515,515,514,1,5464,5464,5458,6,12,1,1,6,249,249,248,248
Mariposa,31,2022-07-17,42,42,42,0,247,248,247,1,0,1,1,0,29,29,28,28
Mendocino,31,2022-07-17,174,174,174,0,1453,1453,1451,2,7,0,0,2,133,133,133,133
Merced,31,2022-07-17,774,774,773,1,3922,3922,3919,3,16,2,2,1,841,841,839,839
Modoc,31,2022-07-17,11,11,11,0,31,32,31,1,1,0,0,0,10,10,10,10
Mono,31,2022-07-17,9,9,9,0,81,82,81,1,0,0,0,1,7,7,7,7
Monterey,31,2022-07-17,976,976,974,2,7153,7153,7141,12,49,7,7,7,760,760,753,753
Napa,31,2022-07-17,331,331,331,0,3118,3118,3116,2,9,0,0,0,152,152,152,152
Nevada,31,2022-07-17,169,169,169,0,1349,1349,1348,1,10,0,0,2,134,134,134,134
Orange,31,2022-07-17,9068,9068,9062,6,59821,59826,59789,37,255,22,22,40,7291,7291,7269,7269
Placer,31,2022-07-17,712,712,711,1,5357,5357,5351,6,86,1,1,4,646,646,645,645
Plumas,31,2022-07-17,58,58,58,0,256,257,256,1,1,0,0,0,13,13,13,13
Riverside,31,2022-07-17,8370,8370,8363,7,48235,48240,48199,41,214,16,16,15,6546,6546,6530,6530
Sacramento,31,2022-07-17,3580,3580,3577,3,30476,30477,30449,28,172,13,13,25,3204,3204,3191,3191
San Benito,31,2022-07-17,209,209,209,0,1616,1616,1615,1,0,1,1,0,97,97,96,96
San Bernardino,31,2022-07-17,8033,8033,8028,5,54647,54652,54615,37,190,15,15,26,7936,7936,7921,7921
San Diego,31,2022-07-17,13142,13142,13138,4,80492,80498,80475,23,388,14,14,46,5448,5448,5434,5434
San Francisco,31,2022-07-17,2573,2573,2568,5,25659,25659,25611,48,111,10,10,25,965,965,955,955
San Joaquin,31,2022-07-17,2050,2050,2048,2,17943,17943,17925,18,66,3,3,14,2291,2291,2288,2288
San Luis Obispo,31,2022-07-17,562,562,562,0,4617,4617,4613,4,16,3,3,1,509,509,506,506
San Mateo,31,2022-07-17,2388,2388,2387,1,23617,23617,23602,15,45,1,1,2,738,738,737,737
Santa Barbara,31,2022-07-17,1262,1262,1261,1,9257,9257,9249,8,43,2,2,6,711,711,709,709
Santa Clara,31,2022-07-17,6268,6268,6266,2,54738,54743,54727,16,195,10,10,34,2432,2432,2422,2422
Santa Cruz,31,2022-07-17,869,869,868,1,7677,7677,7671,6,22,1,1,3,268,268,267,267
Shasta,31,2022-07-17,335,335,335,0,3200,3200,3197,3,37,3,3,4,590,590,587,587
Siskiyou,31,2022-07-17,31,31,31,0,324,325,324,1,1,0,0,0,86,86,86,86
Solano,31,2022-07-17,1297,1297,1296,1,9672,9672,9664,8,47,1,1,6,455,455,454,454
Sonoma,31,2022-07-17,1066,1066,1065,1,8869,8869,8862,7,40,0,0,5,505,505,505,505
Stanislaus,31,2022-07-17,1368,1368,1366,2,8108,8108,8097,11,111,4,4,8,1728,1728,1724,1724
Sutter,31,2022-07-17,248,248,248,0,1665,1665,1664,1,0,0,0,0,228,228,228,228
Tehama,31,2022-07-17,111,111,111,0,903,903,902,1,5,1,1,1,211,211,210,210
Trinity,31,2022-07-17,23,23,23,0,108,109,108,1,1,0,0,0,20,20,20,20
Tulare,31,2022-07-17,1220,1220,1218,2,8447,8447,8435,12,40,1,1,1,1523,1523,1522,1522
Tuolumne,31,2022-07-17,242,242,242,0,1156,1156,1155,1,5,4,4,0,195,195,191,191
Ventura,31,2022-07-17,2343,2343,2342,1,19091,19091,19080,11,81,5,5,6,1541,1541,1536,1536
Yolo,31,2022-07-17,433,433,433,0,4647,4647,4643,4,4,4,4,1,382,382,378,378
Yuba,31,2022-07-17,211,211,211,0,1260,1260,1259,1,15,0,0,0,129,129,129,129
Alameda,32,2022-07-24,4494,4494,4492,2,41361,41366,41344,22,138,10,10,20,1946,1946,1936,1936
Amador,32,2022-07-24,77,77,77,0,1300,1300,1299,1,3,0,0,1,87,87,87,87
Butte,32,2022-07-24,355,355,355,0,2983,2983,2982,1,28,2,2,2,454,454,452,452
Calaveras,32,2022-07-24,81,81,81,0,553,554,553,1,1,2,2,0,131,131,129,129
Colusa,32,2022-07-24,26,26,26,0,374,375,374,1,1,0,0,0,22,22,22,22
Contra Costa,32,2022-07-24,2856,2856,2853,3,22452,22452,22432,20,91,7,7,17,1400,1400,1393,1393
Del Norte,32,2022-07-24,75,75,75,0,578,579,578,1,7,0,0,0,53,53,53,53
El Dorado,32,2022-07-24,272,272,272,0,2490,2490,2488,2,9,1,1,0,229,229,228,228
Fresno,32,2022-07-24,3402,3402,3399,3,20402,20402,20385,17,203,7,7,28,2819,2819,2812,2812
Glenn,32,2022-07-24,31,31,31,0,269,270,269,1,1,0,0,0,56,56,56,56
Humboldt,32,2022-07-24,254,254,254,0,2010,2010,2009,1,14,2,2,4,156,156,154,154
Imperial,32,2022-07-24,906,906,905,1,4355,4355,4352,3,20,1,1,1,952,952,951,951
Inyo,32,2022-07-24,24,24,24,0,309,310,309,1,1,0,0,0,57,57,57,57
Kern,32,2022-07-24,2057,2057,2056,1,16014,16014,16004,10,77,3,3,13,2383,2383,2380,2380
Kings,32,2022-07-24,585,585,585,0,3956,3956,3953,3,14,2,2,0,458,458,456,456
Lake,32,2022-07-24,134,134,134,0,995,995,994,1,4,0,0,2,142,142,142,142
Lassen,32,2022-07-24,52,52,52,0,1097,1097,1096,1,0,0,0,0,63,63,63,63
Los Angeles,32,2022-07-24,37971,37976,37968,8,336073,336106,336036,70,1111,115,115,124,32674,32674,32559,32559
Madera,32,2022-07-24,550,550,550,0,3780,3780,3777,3,11,1,1,4,372,372,371,371
Marin,32,2022-07-24,517,517,517,0,5573,5573,5568,5,18,2,2,3,251,251,249,249
Mariposa,32,2022-07-24,44,44,44,0,231,232,231,1,0,0,0,0,29,29,29,29
Mendocino,32,2022-07-24,185,185,185,0,1378,1378,1376,2,7,0,0,1,133,133,133,133
Merced,32,2022-07-24,709,709,709,0,3857,3857,3855,2,18,2,2,2,843,843,841,841
Modoc,32,2022-07-24,8,8,8,0,29,30,29,1,0,1,1,0,11,11,10,10
Mono,32,2022-07-24,16,16,16,0,92,93,92,1,0,0,0,0,7,7,7,7
Monterey,32,2022-07-24,941,941,940,1,7147,7147,7137,10,38,1,1,4,761,761,760,760
Napa,32,2022-07-24,303,303,303,0,2901,2901,2899,2,5,5,5,0,157,157,152,152
Nevada,32,2022-07-24,124,124,124,0,1362,1362,1361,1,8,1,1,0,135,135,134,134
Orange,32,2022-07-24,8370,8370,8366,4,58837,58842,58813,29,271,34,34,37,7325,7325,7291,7291
Placer,32,2022-07-24,570,570,569,1,4995,4995,4990,5,78,3,3,10,649,649,646,646
Plumas,32,2022-07-24,39,39,39,0,212,213,212,1,0,0,0,0,13,13,13,13
Riverside,32,2022-07-24,7679,7679,7674,5,46779,46784,46753,31,242,16,16,19,6562,6562,6546,6546
Sacramento,32,2022-07-24,3618,3618,3615,3,29865,29867,29846,21,194,17,17,27,3221,3221,3204,3204
San Benito,32,2022-07-24,203,203,203,0,1841,1841,1840,1,1,1,1,1,98,98,97,97
San Bernardino,32,2022-07-24,7144,7144,7140,4,52155,52160,52132,28,196,25,25,23,7961,7961,7936,7936
San Diego,32,2022-07-24,12114,12114,12111,3,76691,76698,76681,17,397,19,19,43,5467,5467,5448,5448
San Francisco,32,2022-07-24,2303,2303,2300,3,24595,24595,24559,36,120,8,8,26,973,973,965,965
San Joaquin,32,2022-07-24,1855,1855,1854,1,17052,17052,17039,13,74,4,4,9,2295,2295,2291,2291
San Luis Obispo,32,2022-07-24,509,509,509,0,4418,4418,4415,3,15,4,4,1,513,513,509,509
San Mateo,32,2022-07-24,2059,2059,2058,1,21812,21812,21801,11,51,1,1,9,739,739,738,738
Santa Barbara,32,2022-07-24,1220,1220,1219,1,9029,9029,9023,6,39,3,3,3,714,714,711,711
Santa Clara,32,2022-07-24,5867,5867,5866,1,51917,51922,51910,12,234,18,18,25,2450,2450,2432,2432
Santa Cruz,32,2022-07-24,857,857,857,0,7774,7774,7770,4,26,0,0,0,268,268,268,268
Shasta,32,2022-07-24,294,294,294,0,3135,3135,3133,2,38,2,2,6,592,592,590,590
Siskiyou,32,2022-07-24,38,38,38,0,367,368,367,1,2,0,0,0,86,86,86,86
Solano,32,2022-07-24,1189,1189,1188,1,9631,9631,9625,6,56,0,0,6,455,455,455,455
Sonoma,32,2022-07-24,1056,1056,1055,1,8628,8628,8622,6,45,0,0,4,505,505,505,505
Stanislaus,32,2022-07-24,1351,1351,1350,1,8078,8078,8070,8,102,8,8,11,1736,1736,1728,1728
Sutter,32,2022-07-24,219,219,219,0,1709,1709,1708,1,0,0,0,0,228,228,228,228
Tehama,32,2022-07-24,115,115,115,0,898,898,897,1,6,1,1,0,212,212,211,211
Trinity,32,2022-07-24,14,14,14,0,98,99,98,1,0,0,0,0,20,20,20,20
Tulare,32,2022-07-24,1179,1179,1178,1,8055,8055,8046,9,37,1,1,1,1524,1524,1523,1523
Tuolumne,32,2022-07-24,197,197,197,0,1161,1161,1160,1,5,1,1,0,196,196,195,195
Ventura,32,2022-07-24,2203,2203,2202,1,18824,18824,18816,8,70,5,5,7,1546,1546,1541,1541
Yolo,32,2022-07-24,413,413,413,0,4548,4548,4545,3,5,3,3,2,385,385,382,382
Yuba,32,2022-07-24,188,188,188,0,1328,1328,1327,1,13,0,0,1,129,129,129,129
Alameda,33,2022-07-31,3880,3880,3878,2,37674,37679,37664,15,174,9,9,20,1955,1955,1946,1946
Amador,33,2022-07-31,62,62,62,0,1146,1146,1145,1,4,1,1,0,88,88,87,87
Butte,33,2022-07-31,357,357,357,0,2775,2775,2774,1,34,1,1,1,455,455,454,454
Calaveras,33,2022-07-31,73,73,73,0,562,563,562,1,1,1,1,2,132,132,131,131
Colusa,33,2022-07-31,28,28,28,0,375,376,375,1,5,0,0,0,22,22,22,22
Contra Costa,33,2022-07-31,2679,2679,2677,2,21327,21327,21312,15,92,12,12,19,1412,1412,1400,1400
Del Norte,33,2022-07-31,60,60,60,0,478,479,478,1,4,0,0,2,53,53,53,53
El Dorado,33,2022-07-31,251,251,251,0,2486,2486,2485,1,3,3,3,2,232,232,229,229
Fresno,33,2022-07-31,3096,3096,3094,2,18969,18969,18957,12,217,9,9,18,2828,2828,2819,2819
Glenn,33,2022-07-31,31,31,31,0,249,250,249,1,0,0,0,0,56,56,56,56
Humboldt,33,2022-07-31,217,217,217,0,1876,1876,1875,1,9,0,0,4,156,156,156,156
Imperial,33,2022-07-31,691,691,691,0,3700,3700,3698,2,23,3,3,4,955,955,952,952
Inyo,33,2022-07-31,19,19,19,0,287,288,287,1,2,1,1,0,58,58,57,57
Kern,33,2022-07-31,1789,1789,1788,1,14928,14928,14921,7,78,6,6,12,2389,2389,2383,2383
Kings,33,2022-07-31,622,622,622,0,4006,4006,4004,2,7,0,0,1,458,458,458,458
Lake,33,2022-07-31,135,135,135,0,1039,1039,1038,1,5,1,1,1,143,143,142,142
Lassen,33,2022-07-31,50,50,50,0,913,914,913,1,1,0,0,0,63,63,63,63
Los Angeles,33,2022-07-31,31850,31855,31850,5,312115,312152,312101,51,1071,132,132,129,32806,32806,32674,32674
Madera,33,2022-07-31,474,474,474,0,3553,3553,3551,2,9,0,0,5,372,372,372,372
Marin,33,2022-07-31,409,409,409,0,5204,5204,5201,3,32,0,0,3,251,251,251,251
Mariposa,33,2022-07-31,19,19,19,0,208,209,208,1,0,0,0,0,29,29,29,29
Mendocino,33,2022-07-31,205,205,205,0,1367,1367,1366,1,4,1,1,0,134,134,133,133
Merced,33,2022-07-31,675,675,675,0,3702,3702,3700,2,23,6,6,3,849,849,843,843
Modoc,33,2022-07-31,12,12,12,0,31,32,31,1,0,0,0,0,11,11,11,11
Mono,33,2022-07-31,9,9,9,0,78,79,78,1,0,0,0,0,7,7,7,7
Monterey,33,2022-07-31,946,946,945,1,6727,6727,6720,7,39,1,1,2,762,762,761,761
Napa,33,2022-07-31,274,274,274,0,2871,2871,2870,1,14,0,0,0,157,157,157,157
Nevada,33,2022-07-31,106,106,106,0,1372,1372,1371,1,10,0,0,0,135,135,135,135
Orange,33,2022-07-31,6945,6945,6942,3,53676,53681,53661,20,253,38,38,43,7363,7363,7325,7325
Placer,33,2022-07-31,610,610,610,0,4919,4919,4915,4,75,3,3,9,652,652,649,649
Plumas,33,2022-07-31,18,18,18,0,178,179,178,1,0,0,0,0,13,13,13,13
Riverside,33,2022-07-31,6343,6343,6340,3,42853,42858,42836,22,204,5,5,20,6567,6567,6562,6562
Sacramento,33,2022-07-31,3184,3184,3182,2,28683,28688,28672,16,161,18,18,26,3239,3239,3221,3221
San Benito,33,2022-07-31,163,163,163,0,1463,1463,1462,1,2,2,2,0,100,100,98,98
San Bernardino,33,2022-07-31,6303,6303,6300,3,49987,49992,49971,21,183,29,29,24,7990,7990,7961,7961
San Diego,33,2022-07-31,9775,9775,9773,2,70091,70100,70088,12,377,22,22,48,5489,5489,5467,5467
San Francisco,33,2022-07-31,1871,1871,1869,2,22321,22322,22297,25,100,13,13,21,986,986,973,973
San Joaquin,33,2022-07-31,1735,1735,1734,1,15862,15862,15852,10,74,6,6,15,2301,2301,2295,2295
San Luis Obispo,33,2022-07-31,577,577,577,0,4118,4118,4116,2,14,3,3,0,516,516,513,513
San Mateo,33,2022-07-31,1869,1869,1868,1,20733,20733,20725,8,66,1,1,4,740,740,739,739
Santa Barbara,33,2022-07-31,1114,1114,1113,1,7829,7829,7825,4,30,2,2,3,716,716,714,714
Santa Clara,33,2022-07-31,5011,5011,5010,1,46769,46774,46765,9,219,16,16,42,2466,2466,2450,2450
Santa Cruz,33,2022-07-31,752,752,752,0,7121,7121,7118,3,17,1,1,0,269,269,268,268
Shasta,33,2022-07-31,261,261,261,0,2981,2981,2979,2,41,3,3,8,595,595,592,592
Siskiyou,33,2022-07-31,23,23,23,0,286,287,286,1,1,0,0,0,86,86,86,86
Solano,33,2022-07-31,1163,1163,1162,1,9212,9212,9207,5,45,0,0,5,455,455,455,455
Sonoma,33,2022-07-31,973,973,973,0,8357,8357,8353,4,47,5,5,3,510,510,505,505
Stanislaus,33,2022-07-31,1288,1288,1287,1,7785,7785,7779,6,116,7,7,10,1743,1743,1736,1736
Sutter,33,2022-07-31,232,232,232,0,1657,1657,1656,1,0,3,3,0,231,231,228,228
Tehama,33,2022-07-31,93,93,93,0,795,795,794,1,2,2,2,0,214,214,212,212
Trinity,33,2022-07-31,10,10,10,0,80,81,80,1,0,1,1,0,21,21,20,20
Tulare,33,2022-07-31,1033,1033,1032,1,7560,7560,7554,6,39,1,1,2,1525,1525,1524,1524
Tuolumne,33,2022-07-31,154,154,154,0,1091,1091,1090,1,5,0,0,0,196,196,196,196
Ventura,33,2022-07-31,1897,1897,1896,1,17200,17200,17194,6,76,9,9,6,1555,1555,1546,1546
Yolo,33,2022-07-31,345,345,345,0,4153,4153,4151,2,4,3,3,1,388,388,385,385
Yuba,33,2022-07-31,154,154,154,0,1203,1203,1202,1,9,0,0,0,129,129,129,129
Alameda,34,2022-08-07,3487,3487,3486,1,35839,35844,35833,11,128,9,9,21,1964,1964,1955,1955
Amador,34,2022-08-07,56,56,56,0,877,878,877,1,3,0,0,0,88,88,88,88
Butte,34,2022-08-07,337,337,337,0,2600,2600,2599,1,28,2,2,1,457,457,455,455
Calaveras,34,2022-08-07,56,56,56,0,565,566,565,1,1,1,1,0,133,133,132,132
Colusa,34,2022-08-07,15,15,15,0,350,351,350,1,2,0,0,0,22,22,22,22
Contra Costa,34,2022-08-07,2257,2257,2256,1,20084,20084,20073,11,96,5,5,16,1417,1417,1412,1412
Del Norte,34,2022-08-07,49,49,49,0,501,502,501,1,5,0,0,0,53,53,53,53
El Dorado,34,2022-08-07,178,178,178,0,2286,2286,2285,1,7,0,0,0,232,232,232,232
Fresno,34,2022-08-07,2550,2550,2549,1,17296,17296,17287,9,207,7,7,25,2835,2835,2828,2828
Glenn,34,2022-08-07,23,23,23,0,252,253,252,1,2,0,0,0,56,56,56,56
Humboldt,34,2022-08-07,210,210,210,0,1967,1967,1966,1,9,1,1,3,157,157,156,156
Imperial,34,2022-08-07,568,568,568,0,3344,3344,3342,2,19,3,3,3,958,958,955,955
Inyo,34,2022-08-07,13,13,13,0,257,258,257,1,0,0,0,1,58,58,58,58
Kern,34,2022-08-07,1422,1422,1421,1,14483,14483,14478,5,63,6,6,15,2395,2395,2389,2389
Kings,34,2022-08-07,496,496,496,0,3478,3478,3476,2,9,0,0,3,458,458,458,458
Lake,34,2022-08-07,108,108,108,0,925,926,925,1,2,0,0,1,143,143,143,143
Lassen,34,2022-08-07,156,156,156,0,1096,1097,1096,1,0,1,1,0,64,64,63,63
Los Angeles,34,2022-08-07,26591,26594,26591,3,293012,293051,293014,37,975,134,134,122,32940,32940,32806,32806
Madera,34,2022-08-07,411,411,411,0,3131,3131,3129,2,18,0,0,5,372,372,372,372
Marin,34,2022-08-07,376,376,376,0,4594,4594,4592,2,25,3,3,3,254,254,251,251
Mariposa,34,2022-08-07,31,31,31,0,211,212,211,1,0,0,0,0,29,29,29,29
Mendocino,34,2022-08-07,130,130,130,0,1130,1130,1129,1,1,1,1,1,135,135,134,134
Merced,34,2022-08-07,545,545,545,0,3457,3457,3456,1,16,0,0,6,849,849,849,849
Modoc,34,2022-08-07,5,5,5,0,28,29,28,1,0,0,0,0,11,11,11,11
Mono,34,2022-08-07,8,8,8,0,67,68,67,1,1,0,0,0,7,7,7,7
Monterey,34,2022-08-07,756,756,755,1,5857,5857,5852,5,34,3,3,0,765,765,762,762
Napa,34,2022-08-07,285,285,285,0,2683,2683,2682,1,6,2,2,1,159,159,157,157
Nevada,34,2022-08-07,107,107,107,0,1334,1334,1333,1,6,0,0,0,135,135,135,135
Orange,34,2022-08-07,5630,5630,5628,2,49628,49633,49618,15,231,28,28,43,7391,7391,7363,7363
Placer,34,2022-08-07,526,526,526,0,4533,4533,4530,3,66,2,2,8,654,654,652,652
Plumas,34,2022-08-07,28,28,28,0,183,184,183,1,1,0,0,0,13,13,13,13
Riverside,34,2022-08-07,5715,5715,5713,2,40938,40943,40927,16,188,11,11,16,6578,6578,6567,6567
Sacramento,34,2022-08-07,2740,2740,2739,1,26910,26915,26903,12,179,21,21,24,3260,3260,3239,3239
San Benito,34,2022-08-07,189,189,189,0,1433,1433,1432,1,1,0,0,0,100,100,100,100
San Bernardino,34,2022-08-07,5361,5361,5359,2,46305,46310,46295,15,204,17,17,15,8007,8007,7990,7990
San Diego,34,2022-08-07,7573,7573,7572,1,65874,65883,65874,9,329,11,11,33,5500,5500,5489,5489
San Francisco,34,2022-08-07,1612,1612,1611,1,20651,20652,20634,18,89,13,13,22,999,999,986,986
San Joaquin,34,2022-08-07,1579,1579,1578,1,15922,15922,15914,8,61,7,7,7,2308,2308,2301,2301
San Luis Obispo,34,2022-08-07,559,559,559,0,3705,3705,3704,1,15,0,0,0,516,516,516,516
San Mateo,34,2022-08-07,1525,1525,1525,0,18654,18654,18648,6,56,0,0,3,740,740,740,740
Santa Barbara,34,2022-08-07,1007,1007,1007,0,7564,7564,7561,3,36,2,2,1,718,718,716,716
Santa Clara,34,2022-08-07,4244,4244,4243,1,41590,41595,41589,6,206,23,23,37,2489,2489,2466,2466
Santa Cruz,34,2022-08-07,665,665,665,0,6053,6053,6051,2,24,1,1,0,270,270,269,269
Shasta,34,2022-08-07,200,200,200,0,2899,2899,2898,1,32,4,4,3,599,599,595,595
Siskiyou,34,2022-08-07,36,36,36,0,283,284,283,1,0,1,1,0,87,87,86,86
Solano,34,2022-08-07,924,924,924,0,8043,8043,8040,3,52,0,0,10,455,455,455,455
Sonoma,34,2022-08-07,880,880,880,0,7795,7795,7792,3,40,4,4,2,514,514,510,510
Stanislaus,34,2022-08-07,1077,1077,1076,1,7267,7267,7262,5,92,7,7,11,1750,1750,1743,1743
Sutter,34,2022-08-07,224,224,224,0,1572,1572,1571,1,0,0,0,0,231,231,231,231
Tehama,34,2022-08-07,75,75,75,0,679,680,679,1,4,0,0,0,214,214,214,214
Trinity,34,2022-08-07,6,6,6,0,73,74,73,1,0,0,0,0,21,21,21,21
Tulare,34,2022-08-07,921,921,920,1,7425,7425,7420,5,41,5,5,3,1530,1530,1525,1525
Tuolumne,34,2022-08-07,125,125,125,0,1124,1124,1123,1,5,2,2,0,198,198,196,196
Ventura,34,2022-08-07,1563,1563,1563,0,16059,16059,16055,4,67,6,6,7,1561,1561,1555,1555
Yolo,34,2022-08-07,298,298,298,0,3844,3844,3843,1,6,1,1,1,389,389,388,388
Yuba,34,2022-08-07,148,148,148,0,1127,1128,1127,1,5,1,1,0,130,130,129,129
Alameda,35,2022-08-14,2681,2681,2680,1,34417,34422,34413,9,118,8,8,21,1972,1972,1964,1964
Amador,35,2022-08-14,45,45,45,0,812,813,812,1,3,0,0,0,88,88,88,88
Butte,35,2022-08-14,283,283,283,0,2347,2348,2347,1,18,0,0,2,457,457,457,457
Calaveras,35,2022-08-14,50,50,50,0,548,549,548,1,0,0,0,1,133,133,133,133
Colusa,35,2022-08-14,20,20,20,0,378,379,378,1,1,0,0,0,22,22,22,22
Contra Costa,35,2022-08-14,1894,1894,1893,1,19167,19169,19161,8,69,7,7,11,1424,1424,1417,1417
Del Norte,35,2022-08-14,55,55,55,0,494,495,494,1,3,1,1,1,54,54,53,53
El Dorado,35,2022-08-14,187,187,187,0,2297,2297,2296,1,6,0,0,3,232,232,232,232
Fresno,35,2022-08-14,1996,1996,1995,1,16740,16741,16734,7,165,10,10,17,2845,2845,2835,2835
Glenn,35,2022-08-14,14,14,14,0,238,239,238,1,2,0,0,0,56,56,56,56
Humboldt,35,2022-08-14,188,188,188,0,1609,1609,1608,1,12,0,0,2,157,157,157,157
Imperial,35,2022-08-14,382,382,382,0,3132,3132,3131,1,15,1,1,2,959,959,958,958
Inyo,35,2022-08-14,7,7,7,0,246,247,246,1,0,1,1,0,59,59,58,58
Kern,35,2022-08-14,1281,1281,1281,0,13762,13762,13758,4,69,8,8,11,2403,2403,2395,2395
Kings,35,2022-08-14,373,373,373,0,3239,3239,3238,1,8,1,1,1,459,459,458,458
Lake,35,2022-08-14,99,99,99,0,950,951,950,1,3,0,0,2,143,143,143,143
Lassen,35,2022-08-14,95,95,95,0,980,981,980,1,1,0,0,0,64,64,64,64
Los Angeles,35,2022-08-14,21849,21852,21850,2,292196,292241,292212,29,888,114,114,123,33054,33054,32940,32940
Madera,35,2022-08-14,300,300,300,0,2958,2958,2957,1,12,0,0,4,372,372,372,372
Marin,35,2022-08-14,305,305,305,0,4027,4027,4025,2,16,0,0,0,254,254,254,254
Mariposa,35,2022-08-14,16,16,16,0,194,195,194,1,0,0,0,0,29,29,29,29
Mendocino,35,2022-08-14,104,104,104,0,1012,1012,1011,1,6,0,0,2,135,135,135,135
Merced,35,2022-08-14,469,469,469,0,3369,3369,3368,1,11,3,3,3,852,852,849,849
Modoc,35,2022-08-14,4,4,4,0,19,20,19,1,0,0,0,0,11,11,11,11
Mono,35,2022-08-14,5,5,5,0,74,75,74,1,0,0,0,0,7,7,7,7
Monterey,35,2022-08-14,668,668,668,0,5792,5792,5788,4,36,0,0,0,765,765,765,765
Napa,35,2022-08-14,220,220,220,0,2378,2378,2377,1,12,0,0,0,159,159,159,159
Nevada,35,2022-08-14,102,102,102,0,1213,1214,1213,1,6,0,0,0,135,135,135,135
Orange,35,2022-08-14,4912,4912,4911,1,44909,44915,44905,10,261,34,34,38,7425,7425,7391,7391
Placer,35,2022-08-14,437,437,437,0,4476,4476,4474,2,62,2,2,11,656,656,654,654
Plumas,35,2022-08-14,16,16,16,0,176,177,176,1,0,0,0,0,13,13,13,13
Riverside,35,2022-08-14,4720,4720,4719,1,38148,38153,38141,12,141,17,17,18,6595,6595,6578,6578
Sacramento,35,2022-08-14,2362,2362,2361,1,25810,25815,25806,9,159,9,9,16,3269,3269,3260,3260
San Benito,35,2022-08-14,142,142,142,0,1347,1348,1347,1,2,1,1,1,101,101,100,100
San Bernardino,35,2022-08-14,4766,4766,4765,1,45099,45104,45093,11,147,18,18,24,8025,8025,8007,8007
San Diego,35,2022-08-14,5859,5859,5858,1,60474,60484,60478,6,281,14,14,34,5514,5514,5500,5500
San Francisco,35,2022-08-14,1333,1333,1332,1,19900,19901,19887,14,100,15,15,13,1014,1014,999,999
San Joaquin,35,2022-08-14,1454,1454,1453,1,15214,15214,15208,6,60,9,9,8,2317,2317,2308,2308
San Luis Obispo,35,2022-08-14,361,361,361,0,3344,3344,3343,1,15,4,4,2,520,520,516,516
San Mateo,35,2022-08-14,1278,1278,1278,0,17492,17493,17489,4,50,1,1,5,741,741,740,740
Santa Barbara,35,2022-08-14,881,881,881,0,7181,7181,7179,2,47,2,2,3,720,720,718,718
Santa Clara,35,2022-08-14,3534,3534,3534,0,39853,39858,39854,4,203,8,8,24,2497,2497,2489,2489
Santa Cruz,35,2022-08-14,508,508,508,0,6000,6000,5998,2,24,2,2,1,272,272,270,270
Shasta,35,2022-08-14,198,198,198,0,2750,2750,2749,1,17,2,2,0,601,601,599,599
Siskiyou,35,2022-08-14,15,15,15,0,289,290,289,1,0,1,1,3,88,88,87,87
Solano,35,2022-08-14,682,682,682,0,7483,7483,7481,2,46,0,0,7,455,455,455,455
Sonoma,35,2022-08-14,644,644,644,0,7302,7302,7300,2,37,2,2,2,516,516,514,514
Stanislaus,35,2022-08-14,951,951,951,0,7436,7436,7432,4,93,7,7,12,1757,1757,1750,1750
Sutter,35,2022-08-14,188,188,188,0,1561,1561,1560,1,0,1,1,0,232,232,231,231
Tehama,35,2022-08-14,61,61,61,0,615,616,615,1,2,0,0,0,214,214,214,214
Trinity,35,2022-08-14,9,9,9,0,58,59,58,1,0,0,0,0,21,21,21,21
Tulare,35,2022-08-14,733,733,733,0,6974,6974,6970,4,26,2,2,3,1532,1532,1530,1530
Tuolumne,35,2022-08-14,107,107,107,0,986,987,986,1,1,0,0,0,198,198,198,198
Ventura,35,2022-08-14,1487,1487,1487,0,15418,15418,15415,3,72,7,7,8,1568,1568,1561,1561
Yolo,35,2022-08-14,267,267,267,0,3727,3727,3726,1,3,4,4,0,393,393,389,389
Yuba,35,2022-08-14,125,125,125,0,1088,1089,1088,1,6,0,0,0,130,130,130,130
Alameda,36,2022-08-21,2286,2286,2286,0,32643,32648,32642,6,111,8,8,21,1980,1980,1972,1972
Amador,36,2022-08-21,51,51,51,0,852,853,852,1,1,1,1,0,89,89,88,88
Butte,36,2022-08-21,227,227,227,0,2094,2095,2094,1,16,1,1,2,458,458,457,457
Calaveras,36,2022-08-21,39,39,39,0,540,541,540,1,2,0,0,0,133,133,133,133
Colusa,36,2022-08-21,10,10,10,0,380,381,380,1,0,0,0,0,22,22,22,22
Contra Costa,36,2022-08-21,1513,1513,1513,0,18626,18631,18625,6,48,6,6,13,1430,1430,1424,1424
Del Norte,36,2022-08-21,35,35,35,0,480,481,480,1,2,1,1,1,55,55,54,54
El Dorado,36,2022-08-21,150,150,150,0,2269,2269,2268,1,7,0,0,0,232,232,232,232
Fresno,36,2022-08-21,1621,1621,1621,0,15822,15825,15820,5,151,4,4,16,2849,2849,2845,2845
Glenn,36,2022-08-21,22,22,22,0,223,224,223,1,1,0,0,0,56,56,56,56
Humboldt,36,2022-08-21,157,157,157,0,1679,1680,1679,1,4,1,1,4,158,158,157,157
Imperial,36,2022-08-21,297,297,297,0,2864,2864,2863,1,10,0,0,0,959,959,959,959
Inyo,36,2022-08-21,15,15,15,0,251,252,251,1,0,0,0,0,59,59,59,59
Kern,36,2022-08-21,994,994,994,0,13691,13692,13689,3,63,4,4,13,2407,2407,2403,2403
Kings,36,2022-08-21,354,354,354,0,3499,3499,3498,1,5,2,2,1,461,461,459,459
Lake,36,2022-08-21,99,99,99,0,958,959,958,1,2,1,1,1,144,144,143,143
Lassen,36,2022-08-21,50,50,50,0,877,878,877,1,0,0,0,0,64,64,64,64
Los Angeles,36,2022-08-21,18812,18817,18816,1,275671,275725,275704,21,801,121,121,108,33175,33175,33054,33054
Madera,36,2022-08-21,312,312,312,0,2726,2726,2725,1,16,2,2,4,374,374,372,372
Marin,36,2022-08-21,248,248,248,0,3979,3979,3978,1,16,0,0,3,254,254,254,254
Mariposa,36,2022-08-21,14,14,14,0,169,170,169,1,0,0,0,0,29,29,29,29
Mendocino,36,2022-08-21,111,111,111,0,1090,1091,1090,1,3,0,0,3,135,135,135,135
Merced,36,2022-08-21,467,467,467,0,3649,3649,3648,1,11,4,4,1,856,856,852,852
Modoc,36,2022-08-21,6,6,6,0,28,29,28,1,0,0,0,0,11,11,11,11
Mono,36,2022-08-21,6,6,6,0,61,62,61,1,0,0,0,0,7,7,7,7
Monterey,36,2022-08-21,568,568,568,0,5659,5659,5656,3,25,0,0,3,765,765,765,765
Napa,36,2022-08-21,142,142,142,0,2025,2026,2025,1,3,2,2,1,161,161,159,159
Nevada,36,2022-08-21,92,92,92,0,1208,1209,1208,1,4,0,0,1,135,135,135,135
Orange,36,2022-08-21,4018,4018,4017,1,41310,41318,41311,7,220,20,20,33,7445,7445,7425,7425
Placer,36,2022-08-21,386,386,386,0,4358,4358,4357,1,55,1,1,14,657,657,656,656
Plumas,36,2022-08-21,15,15,15,0,174,175,174,1,0,0,0,0,13,13,13,13
Riverside,36,2022-08-21,4399,4399,4398,1,37588,37595,37586,9,150,14,14,16,6609,6609,6595,6595
Sacramento,36,2022-08-21,2200,2200,2199,1,25144,25149,25142,7,137,17,17,24,3286,3286,3269,3269
San Benito,36,2022-08-21,100,100,100,0,1247,1248,1247,1,2,1,1,0,102,102,101,101
San Bernardino,36,2022-08-21,4702,4702,4701,1,44385,44394,44385,9,139,17,17,19,8042,8042,8025,8025
San Diego,36,2022-08-21,4806,4806,4806,0,57546,57558,57553,5,276,5,5,28,5519,5519,5514,5514
San Francisco,36,2022-08-21,1108,1108,1107,1,19149,19154,19144,10,86,14,14,12,1028,1028,1014,1014
San Joaquin,36,2022-08-21,1244,1244,1244,0,15664,15668,15663,5,54,0,0,8,2317,2317,2317,2317
San Luis Obispo,36,2022-08-21,269,269,269,0,3153,3153,3152,1,21,1,1,0,521,521,520,520
San Mateo,36,2022-08-21,1076,1076,1076,0,17313,17317,17314,3,39,0,0,2,741,741,741,741
Santa Barbara,36,2022-08-21,745,745,745,0,7322,7322,7320,2,42,1,1,4,721,721,720,720
Santa Clara,36,2022-08-21,3120,3120,3120,0,40339,40346,40343,3,178,11,11,23,2508,2508,2497,2497
Santa Cruz,36,2022-08-21,493,493,493,0,11464,11465,11463,2,15,1,1,2,273,273,272,272
Shasta,36,2022-08-21,179,179,179,0,2757,2757,2756,1,3,5,5,0,606,606,601,601
Siskiyou,36,2022-08-21,30,30,30,0,263,264,263,1,1,0,0,0,88,88,88,88
Solano,36,2022-08-21,590,590,590,0,7226,7226,7224,2,32,1,1,9,456,456,455,455
Sonoma,36,2022-08-21,607,607,607,0,7277,7277,7275,2,36,2,2,4,518,518,516,516
Stanislaus,36,2022-08-21,911,911,911,0,7629,7629,7626,3,83,7,7,14,1764,1764,1757,1757
Sutter,36,2022-08-21,195,195,195,0,1657,1658,1657,1,0,0,0,0,232,232,232,232
Tehama,36,2022-08-21,46,46,46,0,636,637,636,1,1,0,0,0,214,214,214,214
Trinity,36,2022-08-21,9,9,9,0,63,64,63,1,0,0,0,0,21,21,21,21
Tulare,36,2022-08-21,755,755,755,0,7235,7235,7232,3,31,4,4,1,1536,1536,1532,1532
Tuolumne,36,2022-08-21,109,109,109,0,1023,1024,1023,1,1,0,0,0,198,198,198,198
Ventura,36,2022-08-21,1353,1353,1353,0,14918,14920,14918,2,64,5,5,6,1573,1573,1568,1568
Yolo,36,2022-08-21,207,207,207,0,3441,3441,3440,1,7,1,1,0,394,394,393,393
Yuba,36,2022-08-21,126,126,126,0,1089,1090,1089,1,12,0,0,3,130,130,130,130
Alameda,37,2022-08-28,2092,2092,2092,0,34204,34213,34208,5,101,12,12,22,1992,1992,1980,1980
Amador,37,2022-08-28,46,46,46,0,792,793,792,1,4,1,1,0,90,90,89,89
Butte,37,2022-08-28,231,231,231,0,2145,2146,2145,1,22,0,0,2,458,458,458,458
Calaveras,37,2022-08-28,64,64,64,0,606,607,606,1,1,0,0,0,133,133,133,133
Colusa,37,2022-08-28,14,14,14,0,376,377,376,1,0,0,0,0,22,22,22,22
Contra Costa,37,2022-08-28,1427,1427,1427,0,18828,18833,18828,5,48,5,5,7,1435,1435,1430,1430
Del Norte,37,2022-08-28,29,29,29,0,450,451,450,1,3,0,0,2,55,55,55,55
El Dorado,37,2022-08-28,144,144,144,0,2003,2004,2003,1,6,1,1,1,233,233,232,232
Fresno,37,2022-08-28,1447,1447,1447,0,15786,15791,15787,4,162,4,4,15,2853,2853,2849,2849
Glenn,37,2022-08-28,23,23,23,0,227,228,227,1,0,0,0,0,56,56,56,56
Humboldt,37,2022-08-28,122,122,122,0,1690,1691,1690,1,6,0,0,0,158,158,158,158
Imperial,37,2022-08-28,301,301,301,0,2899,2899,2898,1,0,1,1,0,960,960,959,959
Inyo,37,2022-08-28,7,7,7,0,187,188,187,1,0,0,0,0,59,59,59,59
Kern,37,2022-08-28,959,959,959,0,13703,13707,13705,2,57,2,2,9,2409,2409,2407,2407
Kings,37,2022-08-28,329,329,329,0,3645,3645,3644,1,5,0,0,0,461,461,461,461
Lake,37,2022-08-28,105,105,105,0,898,899,898,1,0,1,1,0,145,145,144,144
Lassen,37,2022-08-28,23,23,23,0,784,785,784,1,0,0,0,0,64,64,64,64
Los Angeles,37,2022-08-28,16147,16152,16151,1,275384,275451,275435,16,703,95,95,77,33270,33270,33175,33175
Madera,37,2022-08-28,302,302,302,0,2905,2905,2904,1,15,0,0,4,374,374,374,374
Marin,37,2022-08-28,232,232,232,0,3932,3932,3931,1,15,2,2,1,256,256,254,254
Mariposa,37,2022-08-28,21,21,21,0,183,184,183,1,0,0,0,0,29,29,29,29
Mendocino,37,2022-08-28,103,103,103,0,994,995,994,1,2,0,0,2,135,135,135,135
Merced,37,2022-08-28,410,410,410,0,3563,3563,3562,1,9,3,3,1,859,859,856,856
Modoc,37,2022-08-28,2,2,2,0,28,29,28,1,0,0,0,0,11,11,11,11
Mono,37,2022-08-28,1,1,1,0,52,53,52,1,0,0,0,0,7,7,7,7
Monterey,37,2022-08-28,431,431,431,0,5610,5610,5608,2,30,3,3,3,768,768,765,765
Napa,37,2022-08-28,123,123,123,0,2098,2099,2098,1,7,0,0,2,161,161,161,161
Nevada,37,2022-08-28,105,105,105,0,1142,1143,1142,1,7,0,0,1,135,135,135,135
Orange,37,2022-08-28,3274,3274,3274,0,40578,40589,40583,6,199,19,19,26,7464,7464,7445,7445
Placer,37,2022-08-28,386,386,386,0,4214,4214,4213,1,60,1,1,10,658,658,657,657
Plumas,37,2022-08-28,22,22,22,0,175,176,175,1,0,0,0,0,13,13,13,13
Riverside,37,2022-08-28,3880,3880,3879,1,37437,37446,37439,7,105,8,8,13,6617,6617,6609,6609
Sacramento,37,2022-08-28,1923,1923,1923,0,24822,24827,24822,5,138,11,11,19,3297,3297,3286,3286
San Benito,37,2022-08-28,124,124,124,0,1434,1435,1434,1,2,0,0,0,102,102,102,102
San Bernardino,37,2022-08-28,3937,3937,3936,1,43209,43221,43214,7,146,16,16,15,8058,8058,8042,8042
San Diego,37,2022-08-28,4013,4013,4013,0,57258,57272,57268,4,220,11,11,27,5530,5530,5519,5519
San Francisco,37,2022-08-28,923,923,923,0,19062,19067,19059,8,40,8,8,8,1036,1036,1028,1028
San Joaquin,37,2022-08-28,1016,1016,1016,0,14552,14556,14553,3,26,5,5,11,2322,2322,2317,2317
San Luis Obispo,37,2022-08-28,329,329,329,0,3229,3229,3228,1,16,1,1,0,522,522,521,521
San Mateo,37,2022-08-28,877,877,877,0,16988,16993,16991,2,27,0,0,3,741,741,741,741
Santa Barbara,37,2022-08-28,634,634,634,0,7577,7577,7576,1,21,1,1,4,722,722,721,721
Santa Clara,37,2022-08-28,2485,2485,2485,0,39934,39944,39941,3,123,5,5,21,2513,2513,2508,2508
Santa Cruz,37,2022-08-28,398,398,398,0,12024,12027,12025,2,16,0,0,0,273,273,273,273
Shasta,37,2022-08-28,135,135,135,0,2682,2682,2681,1,15,1,1,1,607,607,606,606
Siskiyou,37,2022-08-28,19,19,19,0,251,252,251,1,0,2,2,0,90,90,88,88
Solano,37,2022-08-28,539,539,539,0,7298,7298,7297,1,38,1,1,9,457,457,456,456
Sonoma,37,2022-08-28,513,513,513,0,7132,7132,7131,1,33,1,1,3,519,519,518,518
Stanislaus,37,2022-08-28,864,864,864,0,8117,8117,8115,2,75,5,5,3,1769,1769,1764,1764
Sutter,37,2022-08-28,168,168,168,0,1635,1636,1635,1,0,0,0,0,232,232,232,232
Tehama,37,2022-08-28,59,59,59,0,733,734,733,1,5,0,0,0,214,214,214,214
Trinity,37,2022-08-28,11,11,11,0,58,59,58,1,0,0,0,0,21,21,21,21
Tulare,37,2022-08-28,697,697,697,0,7346,7346,7344,2,36,1,1,1,1537,1537,1536,1536
Tuolumne,37,2022-08-28,100,100,100,0,864,865,864,1,2,1,1,0,199,199,198,198
Ventura,37,2022-08-28,1056,1056,1056,0,14815,14820,14818,2,48,5,5,3,1578,1578,1573,1573
Yolo,37,2022-08-28,192,192,192,0,3764,3764,3763,1,3,0,0,3,394,394,394,394
Yuba,37,2022-08-28,139,139,139,0,1144,1145,1144,1,17,0,0,1,130,130,130,130
Alameda,38,2022-09-04,1642,1642,1642,0,33078,33089,33085,4,92,3,3,17,1995,1995,1992,1992
Amador,38,2022-09-04,47,47,47,0,825,826,825,1,3,0,0,2,90,90,90,90
Butte,38,2022-09-04,222,222,222,0,2411,2412,2411,1,17,2,2,1,460,460,458,458
Calaveras,38,2022-09-04,28,28,28,0,524,525,524,1,0,0,0,0,133,133,133,133
Colusa,38,2022-09-04,10,10,10,0,268,269,268,1,2,0,0,0,22,22,22,22
Contra Costa,38,2022-09-04,1069,1069,1069,0,17863,17868,17864,4,56,5,5,11,1440,1440,1435,1435
Del Norte,38,2022-09-04,13,13,13,0,377,378,377,1,2,0,0,1,55,55,55,55
El Dorado,38,2022-09-04,105,105,105,0,1845,1846,1845,1,2,0,0,1,233,233,233,233
Fresno,38,2022-09-04,1229,1229,1229,0,15016,15021,15018,3,167,10,10,12,2863,2863,2853,2853
Glenn,38,2022-09-04,13,13,13,0,203,204,203,1,1,0,0,0,56,56,56,56
Humboldt,38,2022-09-04,125,125,125,0,1497,1498,1497,1,12,0,0,2,158,158,158,158
Imperial,38,2022-09-04,261,261,261,0,2917,2918,2917,1,9,1,1,0,961,961,960,960
Inyo,38,2022-09-04,11,11,11,0,164,165,164,1,0,0,0,0,59,59,59,59
Kern,38,2022-09-04,794,794,794,0,13032,13037,13035,2,52,4,4,9,2413,2413,2409,2409
Kings,38,2022-09-04,271,271,271,0,3237,3237,3236,1,5,0,0,0,461,461,461,461
Lake,38,2022-09-04,67,67,67,0,792,793,792,1,3,3,3,0,148,148,145,145
Lassen,38,2022-09-04,28,28,28,0,754,755,754,1,0,0,0,0,64,64,64,64
Los Angeles,38,2022-09-04,12462,12467,12466,1,248467,248543,248531,12,668,90,90,95,33360,33360,33270,33270
Madera,38,2022-09-04,242,242,242,0,3023,3023,3022,1,11,0,0,5,374,374,374,374
Marin,38,2022-09-04,196,196,196,0,3785,3785,3784,1,11,0,0,1,256,256,256,256
Mariposa,38,2022-09-04,21,21,21,0,183,184,183,1,0,0,0,0,29,29,29,29
Mendocino,38,2022-09-04,67,67,67,0,977,978,977,1,2,1,1,2,136,136,135,135
Merced,38,2022-09-04,302,302,302,0,3159,3160,3159,1,11,1,1,1,860,860,859,859
Modoc,38,2022-09-04,3,3,3,0,23,24,23,1,0,0,0,0,11,11,11,11
Mono,38,2022-09-04,5,5,5,0,53,54,53,1,0,0,0,0,7,7,7,7
Monterey,38,2022-09-04,277,277,277,0,5126,5126,5124,2,18,3,3,1,771,771,768,768
Napa,38,2022-09-04,122,122,122,0,2136,2137,2136,1,3,1,1,2,162,162,161,161
Nevada,38,2022-09-04,94,94,94,0,1172,1173,1172,1,3,0,0,0,135,135,135,135
Orange,38,2022-09-04,2566,2566,2566,0,37746,37757,37753,4,172,13,13,37,7477,7477,7464,7464
Placer,38,2022-09-04,249,249,249,0,3938,3938,3937,1,42,0,0,7,658,658,658,658
Plumas,38,2022-09-04,9,9,9,0,157,158,157,1,0,0,0,0,13,13,13,13
Riverside,38,2022-09-04,2874,2874,2874,0,34303,34314,34309,5,81,8,8,8,6625,6625,6617,6617
Sacramento,38,2022-09-04,1496,1496,1496,0,23000,23007,23003,4,133,13,13,22,3310,3310,3297,3297
San Benito,38,2022-09-04,73,73,73,0,1340,1341,1340,1,0,0,0,2,102,102,102,102
San Bernardino,38,2022-09-04,2821,2821,2821,0,40183,40197,40192,5,121,15,15,18,8073,8073,8058,8058
San Diego,38,2022-09-04,3313,3313,3313,0,55633,55649,55646,3,211,16,16,27,5546,5546,5530,5530
San Francisco,38,2022-09-04,752,752,752,0,18102,18107,18101,6,50,9,9,11,1045,1045,1036,1036
San Joaquin,38,2022-09-04,941,941,941,0,13706,13711,13709,2,43,5,5,10,2327,2327,2322,2322
San Luis Obispo,38,2022-09-04,215,215,215,0,3132,3133,3132,1,8,4,4,0,526,526,522,522
San Mateo,38,2022-09-04,724,724,724,0,16101,16106,16104,2,21,1,1,3,742,742,741,741
Santa Barbara,38,2022-09-04,568,568,568,0,7579,7579,7578,1,37,2,2,3,724,724,722,722
Santa Clara,38,2022-09-04,2138,2138,2138,0,38672,38683,38681,2,117,11,11,20,2524,2524,2513,2513
Santa Cruz,38,2022-09-04,364,364,364,0,14037,14041,14039,2,14,0,0,1,273,273,273,273
Shasta,38,2022-09-04,135,135,135,0,2463,2464,2463,1,16,1,1,0,608,608,607,607
Siskiyou,38,2022-09-04,33,33,33,0,242,243,242,1,0,0,0,0,90,90,90,90
Solano,38,2022-09-04,446,446,446,0,7222,7222,7221,1,34,2,2,9,459,459,457,457
Sonoma,38,2022-09-04,425,425,425,0,7087,7087,7086,1,34,0,0,2,519,519,519,519
Stanislaus,38,2022-09-04,642,642,642,0,7461,7462,7460,2,66,8,8,5,1777,1777,1769,1769
Sutter,38,2022-09-04,130,130,130,0,1626,1627,1626,1,0,0,0,0,232,232,232,232
Tehama,38,2022-09-04,62,62,62,0,725,726,725,1,3,1,1,0,215,215,214,214
Trinity,38,2022-09-04,4,4,4,0,56,57,56,1,0,0,0,0,21,21,21,21
Tulare,38,2022-09-04,497,497,497,0,6524,6525,6523,2,33,2,2,1,1539,1539,1537,1537
Tuolumne,38,2022-09-04,60,60,60,0,819,820,819,1,2,0,0,0,199,199,199,199
Ventura,38,2022-09-04,972,972,972,0,14131,14136,14135,1,42,8,8,2,1586,1586,1578,1578
Yolo,38,2022-09-04,181,181,181,0,3360,3361,3360,1,4,3,3,0,397,397,394,394
Yuba,38,2022-09-04,103,103,103,0,1134,1135,1134,1,17,1,1,1,131,131,130,130
Alameda,39,2022-09-11,1506,1506,1506,0,28723,28735,28732,3,85,1,1,18,1996,1996,1995,1995
Amador,39,2022-09-11,29,29,29,0,785,786,785,1,3,0,0,2,90,90,90,90
Butte,39,2022-09-11,183,183,183,0,2250,2251,2250,1,15,3,3,1,463,463,460,460
Calaveras,39,2022-09-11,13,13,13,0,456,457,456,1,0,0,0,0,133,133,133,133
Colusa,39,2022-09-11,17,17,17,0,301,302,301,1,2,0,0,0,22,22,22,22
Contra Costa,39,2022-09-11,918,918,918,0,15659,15665,15663,2,45,6,6,12,1446,1446,1440,1440
Del Norte,39,2022-09-11,31,31,31,0,523,524,523,1,2,0,0,1,55,55,55,55
El Dorado,39,2022-09-11,105,105,105,0,1730,1731,1730,1,2,1,1,1,234,234,233,233
Fresno,39,2022-09-11,900,900,900,0,13341,13346,13344,2,143,4,4,13,2867,2867,2863,2863
Glenn,39,2022-09-11,13,13,13,0,196,197,196,1,1,0,0,0,56,56,56,56
Humboldt,39,2022-09-11,105,105,105,0,1407,1408,1407,1,7,1,1,5,159,159,158,158
Imperial,39,2022-09-11,243,243,243,0,2917,2918,2917,1,17,0,0,0,961,961,961,961
Inyo,39,2022-09-11,16,16,16,0,186,187,186,1,1,0,0,0,59,59,59,59
Kern,39,2022-09-11,625,625,625,0,11445,11449,11448,1,44,5,5,10,2418,2418,2413,2413
Kings,39,2022-09-11,206,206,206,0,2829,2830,2829,1,5,1,1,0,462,462,461,461
Lake,39,2022-09-11,41,41,41,0,749,750,749,1,5,0,0,0,148,148,148,148
Lassen,39,2022-09-11,17,17,17,0,776,777,776,1,0,0,0,0,64,64,64,64
Los Angeles,39,2022-09-11,10233,10237,10237,0,260785,260894,260885,9,626,92,92,87,33452,33452,33360,33360
Madera,39,2022-09-11,224,224,224,0,2677,2678,2677,1,8,0,0,3,374,374,374,374
Marin,39,2022-09-11,174,174,174,0,3627,3627,3626,1,12,2,2,0,258,258,256,256
Mariposa,39,2022-09-11,14,14,14,0,179,180,179,1,0,0,0,0,29,29,29,29
Mendocino,39,2022-09-11,52,52,52,0,838,839,838,1,3,0,0,1,136,136,136,136
Merced,39,2022-09-11,226,226,226,0,2851,2852,2851,1,9,3,3,1,863,863,860,860
Modoc,39,2022-09-11,2,2,2,0,19,20,19,1,0,0,0,0,11,11,11,11
Mono,39,2022-09-11,4,4,4,0,65,66,65,1,0,0,0,0,7,7,7,7
Monterey,39,2022-09-11,231,231,231,0,4568,4569,4568,1,23,2,2,1,773,773,771,771
Napa,39,2022-09-11,109,109,109,0,1863,1864,1863,1,9,0,0,0,162,162,162,162
Nevada,39,2022-09-11,61,61,61,0,994,995,994,1,3,1,1,0,136,136,135,135
Orange,39,2022-09-11,2070,2070,2070,0,33573,33587,33584,3,155,25,25,24,7502,7502,7477,7477
Placer,39,2022-09-11,241,241,241,0,3731,3731,3730,1,40,0,0,7,658,658,658,658
Plumas,39,2022-09-11,18,18,18,0,153,154,153,1,0,0,0,0,13,13,13,13
Riverside,39,2022-09-11,2175,2175,2175,0,29101,29114,29111,3,117,5,5,10,6630,6630,6625,6625
Sacramento,39,2022-09-11,1200,1200,1200,0,20927,20936,20933,3,125,13,13,15,3323,3323,3310,3310
San Benito,39,2022-09-11,92,92,92,0,1249,1250,1249,1,2,0,0,1,102,102,102,102
San Bernardino,39,2022-09-11,1782,1782,1782,0,34737,34752,34749,3,98,15,15,21,8088,8088,8073,8073
San Diego,39,2022-09-11,2724,2724,2724,0,49827,49849,49847,2,174,8,8,26,5554,5554,5546,5546
San Francisco,39,2022-09-11,739,739,739,0,15640,15646,15642,4,59,7,7,13,1052,1052,1045,1045
San Joaquin,39,2022-09-11,663,663,663,0,12718,12723,12721,2,31,6,6,11,2333,2333,2327,2327
San Luis Obispo,39,2022-09-11,165,165,165,0,2821,2822,2821,1,9,0,0,1,526,526,526,526
San Mateo,39,2022-09-11,622,622,622,0,12805,12809,12808,1,19,1,1,1,743,743,742,742
Santa Barbara,39,2022-09-11,339,339,339,0,6660,6662,6661,1,27,3,3,2,727,727,724,724
Santa Clara,39,2022-09-11,1832,1832,1832,0,34724,34738,34737,1,144,8,8,27,2532,2532,2524,2524
Santa Cruz,39,2022-09-11,255,255,255,0,10389,10393,10392,1,11,0,0,1,273,273,273,273
Shasta,39,2022-09-11,158,158,158,0,2272,2273,2272,1,21,0,0,1,608,608,608,608
Siskiyou,39,2022-09-11,28,28,28,0,263,264,263,1,2,0,0,1,90,90,90,90
Solano,39,2022-09-11,351,351,351,0,5733,5734,5733,1,26,0,0,6,459,459,459,459
Sonoma,39,2022-09-11,359,359,359,0,6059,6060,6059,1,41,2,2,1,521,521,519,519
Stanislaus,39,2022-09-11,440,440,440,0,6888,6890,6889,1,69,1,1,5,1778,1778,1777,1777
Sutter,39,2022-09-11,111,111,111,0,1427,1428,1427,1,0,0,0,0,232,232,232,232
Tehama,39,2022-09-11,41,41,41,0,592,593,592,1,2,0,0,0,215,215,215,215
Trinity,39,2022-09-11,2,2,2,0,60,61,60,1,0,0,0,0,21,21,21,21
Tulare,39,2022-09-11,360,360,360,0,5924,5925,5924,1,40,3,3,0,1542,1542,1539,1539
Tuolumne,39,2022-09-11,64,64,64,0,764,765,764,1,2,0,0,1,199,199,199,199
Ventura,39,2022-09-11,792,792,792,0,13074,13078,13077,1,48,1,1,5,1587,1587,1586,1586
Yolo,39,2022-09-11,125,125,125,0,2877,2878,2877,1,3,2,2,2,399,399,397,397
Yuba,39,2022-09-11,88,88,88,0,1032,1033,1032,1,6,0,0,0,131,131,131,131
Alameda,40,2022-09-18,1303,1303,1303,0,29390,29405,29403,2,78,4,4,7,2000,2000,1996,1996
Amador,40,2022-09-18,34,34,34,0,789,790,789,1,1,3,3,1,93,93,90,90
Butte,40,2022-09-18,139,139,139,0,2155,2156,2155,1,14,0,0,1,463,463,463,463
Calaveras,40,2022-09-18,25,25,25,0,489,490,489,1,0,0,0,0,133,133,133,133
Colusa,40,2022-09-18,14,14,14,0,313,314,313,1,2,0,0,0,22,22,22,22
Contra Costa,40,2022-09-18,841,841,841,0,16708,16716,16714,2,56,7,7,6,1453,1453,1446,1446
Del Norte,40,2022-09-18,21,21,21,0,506,507,506,1,1,0,0,0,55,55,55,55
El Dorado,40,2022-09-18,81,81,81,0,1657,1658,1657,1,3,0,0,0,234,234,234,234
Fresno,40,2022-09-18,617,617,617,0,13620,13627,13625,2,111,10,10,13,2877,2877,2867,2867
Glenn,40,2022-09-18,13,13,13,0,207,208,207,1,1,0,0,0,56,56,56,56
Humboldt,40,2022-09-18,113,113,113,0,1536,1537,1536,1,7,0,0,2,159,159,159,159
Imperial,40,2022-09-18,174,174,174,0,2965,2966,2965,1,12,0,0,0,961,961,961,961
Inyo,40,2022-09-18,7,7,7,0,172,173,172,1,0,1,1,0,60,60,59,59
Kern,40,2022-09-18,475,475,475,0,11994,11999,11998,1,33,5,5,8,2423,2423,2418,2418
Kings,40,2022-09-18,156,156,156,0,2778,2779,2778,1,5,2,2,0,464,464,462,462
Lake,40,2022-09-18,45,45,45,0,889,890,889,1,0,1,1,0,149,149,148,148
Lassen,40,2022-09-18,9,9,9,0,743,744,743,1,0,0,0,0,64,64,64,64
Los Angeles,40,2022-09-18,8754,8759,8759,0,257763,257897,257890,7,529,64,64,78,33516,33516,33452,33452
Madera,40,2022-09-18,117,117,117,0,2740,2741,2740,1,10,1,1,2,375,375,374,374
Marin,40,2022-09-18,141,141,141,0,3705,3706,3705,1,8,0,0,0,258,258,258,258
Mariposa,40,2022-09-18,14,14,14,0,163,164,163,1,0,0,0,0,29,29,29,29
Mendocino,40,2022-09-18,48,48,48,0,939,940,939,1,2,0,0,2,136,136,136,136
Merced,40,2022-09-18,180,180,180,0,2908,2909,2908,1,5,2,2,1,865,865,863,863
Modoc,40,2022-09-18,1,1,1,0,17,18,17,1,0,0,0,0,11,11,11,11
Mono,40,2022-09-18,7,7,7,0,72,73,72,1,0,0,0,0,7,7,7,7
Monterey,40,2022-09-18,163,163,163,0,4438,4438,4437,1,16,0,0,2,773,773,773,773
Napa,40,2022-09-18,107,107,107,0,1868,1869,1868,1,6,0,0,1,162,162,162,162
Nevada,40,2022-09-18,63,63,63,0,1095,1096,1095,1,1,1,1,0,137,137,136,136
Orange,40,2022-09-18,1826,1826,1826,0,34762,34779,34777,2,137,20,20,20,7522,7522,7502,7502
Placer,40,2022-09-18,220,220,220,0,3963,3964,3963,1,56,1,1,4,659,659,658,658
Plumas,40,2022-09-18,22,22,22,0,188,189,188,1,1,0,0,0,13,13,13,13
Riverside,40,2022-09-18,1477,1477,1477,0,29939,29955,29952,3,84,5,5,13,6635,6635,6630,6630
Sacramento,40,2022-09-18,1059,1059,1059,0,22101,22113,22111,2,113,10,10,16,3333,3333,3323,3323
San Benito,40,2022-09-18,57,57,57,0,1220,1221,1220,1,0,0,0,0,102,102,102,102
San Bernardino,40,2022-09-18,1567,1567,1567,0,33968,33987,33985,2,80,7,7,25,8095,8095,8088,8088
San Diego,40,2022-09-18,2608,2608,2608,0,56101,56131,56129,2,179,9,9,21,5563,5563,5554,5554
San Francisco,40,2022-09-18,708,708,708,0,16775,16784,16781,3,45,9,9,8,1061,1061,1052,1052
San Joaquin,40,2022-09-18,485,485,485,0,13330,13335,13334,1,32,4,4,4,2337,2337,2333,2333
San Luis Obispo,40,2022-09-18,167,167,167,0,2858,2859,2858,1,7,0,0,1,526,526,526,526
San Mateo,40,2022-09-18,612,612,612,0,13605,13611,13610,1,14,0,0,0,743,743,743,743
Santa Barbara,40,2022-09-18,264,264,264,0,6869,6873,6872,1,29,2,2,0,729,729,727,727
Santa Clara,40,2022-09-18,1496,1496,1496,0,36870,36889,36888,1,139,6,6,20,2538,2538,2532,2532
Santa Cruz,40,2022-09-18,154,154,154,0,12136,12142,12141,1,7,0,0,0,273,273,273,273
Shasta,40,2022-09-18,114,114,114,0,2120,2121,2120,1,20,2,2,3,610,610,608,608
Siskiyou,40,2022-09-18,20,20,20,0,240,241,240,1,1,1,1,1,91,91,90,90
Solano,40,2022-09-18,300,300,300,0,6244,6248,6247,1,24,2,2,4,461,461,459,459
Sonoma,40,2022-09-18,329,329,329,0,6458,6462,6461,1,27,1,1,3,522,522,521,521
Stanislaus,40,2022-09-18,347,347,347,0,6553,6557,6556,1,59,5,5,7,1783,1783,1778,1778
Sutter,40,2022-09-18,82,82,82,0,1404,1405,1404,1,0,0,0,0,232,232,232,232
Tehama,40,2022-09-18,39,39,39,0,594,595,594,1,2,1,1,0,216,216,215,215
Trinity,40,2022-09-18,3,3,3,0,63,64,63,1,0,0,0,0,21,21,21,21
Tulare,40,2022-09-18,237,237,237,0,5911,5914,5913,1,30,2,2,1,1544,1544,1542,1542
Tuolumne,40,2022-09-18,56,56,56,0,721,722,721,1,0,0,0,0,199,199,199,199
Ventura,40,2022-09-18,646,646,646,0,13675,13681,13680,1,41,2,2,7,1589,1589,1587,1587
Yolo,40,2022-09-18,98,98,98,0,3771,3772,3771,1,3,1,1,1,400,400,399,399
Yuba,40,2022-09-18,59,59,59,0,1057,1058,1057,1,4,1,1,1,132,132,131,131
Alameda,41,2022-09-25,1136,1136,1136,0,28073,28090,28088,2,76,2,2,5,2002,2002,2000,2000
Amador,41,2022-09-25,29,29,29,0,730,731,730,1,1,0,0,1,93,93,93,93
Butte,41,2022-09-25,86,86,86,0,1810,1811,1810,1,28,0,0,1,463,463,463,463
Calaveras,41,2022-09-25,22,22,22,0,387,388,387,1,2,1,1,1,134,134,133,133
Colusa,41,2022-09-25,6,6,6,0,286,287,286,1,1,0,0,0,22,22,22,22
Contra Costa,41,2022-09-25,776,776,776,0,16432,16444,16442,2,45,5,5,9,1458,1458,1453,1453
Del Norte,41,2022-09-25,23,23,23,0,467,468,467,1,1,0,0,0,55,55,55,55
El Dorado,41,2022-09-25,86,86,86,0,1526,1527,1526,1,6,0,0,0,234,234,234,234
Fresno,41,2022-09-25,508,508,508,0,11866,11873,11872,1,90,3,3,11,2880,2880,2877,2877
Glenn,41,2022-09-25,12,12,12,0,176,177,176,1,1,0,0,0,56,56,56,56
Humboldt,41,2022-09-25,101,101,101,0,1317,1318,1317,1,8,1,1,0,160,160,159,159
Imperial,41,2022-09-25,114,114,114,0,2669,2670,2669,1,6,1,1,0,962,962,961,961
Inyo,41,2022-09-25,4,4,4,0,168,169,168,1,0,0,0,0,60,60,60,60
Kern,41,2022-09-25,368,368,368,0,11056,11061,11060,1,33,3,3,8,2426,2426,2423,2423
Kings,41,2022-09-25,106,106,106,0,2591,2592,2591,1,2,0,0,0,464,464,464,464
Lake,41,2022-09-25,27,27,27,0,809,810,809,1,0,0,0,0,149,149,149,149
Lassen,41,2022-09-25,16,16,16,0,573,574,573,1,0,0,0,0,64,64,64,64
Los Angeles,41,2022-09-25,7804,7809,7809,0,244895,245041,245036,5,439,60,60,60,33576,33576,33516,33516
Madera,41,2022-09-25,94,94,94,0,2272,2273,2272,1,9,0,0,2,375,375,375,375
Marin,41,2022-09-25,155,155,155,0,3611,3612,3611,1,7,0,0,0,258,258,258,258
Mariposa,41,2022-09-25,5,5,5,0,158,159,158,1,0,1,1,0,30,30,29,29
Mendocino,41,2022-09-25,35,35,35,0,835,836,835,1,2,0,0,0,136,136,136,136
Merced,41,2022-09-25,131,131,131,0,2822,2823,2822,1,8,2,2,0,867,867,865,865
Modoc,41,2022-09-25,1,1,1,0,15,16,15,1,0,0,0,0,11,11,11,11
Mono,41,2022-09-25,1,1,1,0,64,65,64,1,0,0,0,0,7,7,7,7
Monterey,41,2022-09-25,141,141,141,0,4023,4023,4022,1,16,2,2,2,775,775,773,773
Napa,41,2022-09-25,86,86,86,0,1930,1931,1930,1,3,1,1,1,163,163,162,162
Nevada,41,2022-09-25,49,49,49,0,1108,1109,1108,1,3,0,0,0,137,137,137,137
Orange,41,2022-09-25,1746,1746,1746,0,31946,31964,31962,2,116,16,16,21,7538,7538,7522,7522
Placer,41,2022-09-25,200,200,200,0,3600,3601,3600,1,46,0,0,4,659,659,659,659
Plumas,41,2022-09-25,21,21,21,0,154,155,154,1,1,0,0,0,13,13,13,13
Riverside,41,2022-09-25,1305,1305,1305,0,26300,26316,26314,2,58,9,9,15,6644,6644,6635,6635
Sacramento,41,2022-09-25,960,960,960,0,19529,19541,19540,1,108,11,11,20,3344,3344,3333,3333
San Benito,41,2022-09-25,42,42,42,0,1174,1175,1174,1,0,1,1,2,103,103,102,102
San Bernardino,41,2022-09-25,1243,1243,1243,0,28759,28775,28773,2,71,6,6,15,8101,8101,8095,8095
San Diego,41,2022-09-25,2507,2507,2507,0,51968,51998,51997,1,192,7,7,22,5570,5570,5563,5563
San Francisco,41,2022-09-25,690,690,690,0,16372,16383,16380,3,42,4,4,7,1065,1065,1061,1061
San Joaquin,41,2022-09-25,402,402,402,0,11218,11224,11223,1,38,2,2,2,2339,2339,2337,2337
San Luis Obispo,41,2022-09-25,117,117,117,0,2479,2480,2479,1,6,1,1,1,527,527,526,526
San Mateo,41,2022-09-25,594,594,594,0,13304,13313,13312,1,29,0,0,0,743,743,743,743
Santa Barbara,41,2022-09-25,251,251,251,0,6391,6396,6395,1,23,2,2,0,731,731,729,729
Santa Clara,41,2022-09-25,1402,1402,1402,0,36560,36581,36580,1,115,9,9,17,2547,2547,2538,2538
Santa Cruz,41,2022-09-25,206,206,206,0,12844,12850,12849,1,11,0,0,1,273,273,273,273
Shasta,41,2022-09-25,81,81,81,0,1818,1819,1818,1,15,2,2,5,612,612,610,610
Siskiyou,41,2022-09-25,19,19,19,0,195,196,195,1,1,2,2,2,93,93,91,91
Solano,41,2022-09-25,299,299,299,0,5699,5704,5703,1,25,1,1,2,462,462,461,461
Sonoma,41,2022-09-25,291,291,291,0,6318,6324,6323,1,25,2,2,3,524,524,522,522
Stanislaus,41,2022-09-25,262,262,262,0,5793,5797,5796,1,42,2,2,6,1785,1785,1783,1783
Sutter,41,2022-09-25,65,65,65,0,1158,1159,1158,1,0,0,0,0,232,232,232,232
Tehama,41,2022-09-25,39,39,39,0,588,589,588,1,1,2,2,0,218,218,216,216
Trinity,41,2022-09-25,3,3,3,0,41,42,41,1,0,0,0,0,21,21,21,21
Tulare,41,2022-09-25,187,187,187,0,5174,5177,5176,1,17,2,2,2,1546,1546,1544,1544
Tuolumne,41,2022-09-25,47,47,47,0,674,675,674,1,1,0,0,0,199,199,199,199
Ventura,41,2022-09-25,564,564,564,0,12047,12052,12051,1,33,5,5,3,1594,1594,1589,1589
Yolo,41,2022-09-25,116,116,116,0,3915,3916,3915,1,2,5,5,2,405,405,400,400
Yuba,41,2022-09-25,47,47,47,0,931,932,931,1,6,0,0,0,132,132,132,132
Alameda,42,2022-10-02,1156,1156,1156,0,26831,26849,26848,1,49,2,2,4,2004,2004,2002,2002
Amador,42,2022-10-02,18,18,18,0,695,696,695,1,0,0,0,0,93,93,93,93
Butte,42,2022-10-02,77,77,77,0,1832,1833,1832,1,11,2,2,3,465,465,463,463
Calaveras,42,2022-10-02,19,19,19,0,361,362,361,1,1,0,0,0,134,134,134,134
Colusa,42,2022-10-02,7,7,7,0,277,278,277,1,0,0,0,0,22,22,22,22
Contra Costa,42,2022-10-02,776,776,776,0,15808,15820,15819,1,32,4,4,9,1462,1462,1458,1458
Del Norte,42,2022-10-02,14,14,14,0,404,405,404,1,1,0,0,1,55,55,55,55
El Dorado,42,2022-10-02,83,83,83,0,1512,1513,1512,1,5,0,0,1,234,234,234,234
Fresno,42,2022-10-02,492,492,492,0,11828,11836,11835,1,79,2,2,10,2882,2882,2880,2880
Glenn,42,2022-10-02,4,4,4,0,166,167,166,1,0,0,0,0,56,56,56,56
Humboldt,42,2022-10-02,72,72,72,0,1196,1197,1196,1,6,1,1,0,161,161,160,160
Imperial,42,2022-10-02,126,126,126,0,2523,2524,2523,1,7,0,0,0,962,962,962,962
Inyo,42,2022-10-02,8,8,8,0,150,151,150,1,0,0,0,1,60,60,60,60
Kern,42,2022-10-02,308,308,308,0,10348,10354,10353,1,27,3,3,7,2429,2429,2426,2426
Kings,42,2022-10-02,91,91,91,0,2501,2502,2501,1,2,0,0,0,464,464,464,464
Lake,42,2022-10-02,34,34,34,0,793,794,793,1,2,1,1,0,150,150,149,149
Lassen,42,2022-10-02,7,7,7,0,620,621,620,1,0,0,0,0,64,64,64,64
Los Angeles,42,2022-10-02,7342,7348,7348,0,224142,224296,224292,4,436,56,56,68,33632,33632,33576,33576
Madera,42,2022-10-02,71,71,71,0,1635,1636,1635,1,7,0,0,2,375,375,375,375
Marin,42,2022-10-02,198,198,198,0,3608,3610,3609,1,5,0,0,2,258,258,258,258
Mariposa,42,2022-10-02,5,5,5,0,139,140,139,1,0,0,0,0,30,30,30,30
Mendocino,42,2022-10-02,51,51,51,0,806,807,806,1,2,0,0,0,136,136,136,136
Merced,42,2022-10-02,106,106,106,0,2856,2857,2856,1,5,3,3,0,870,870,867,867
Modoc,42,2022-10-02,2,2,2,0,10,11,10,1,0,0,0,0,11,11,11,11
Mono,42,2022-10-02,4,4,4,0,61,62,61,1,0,0,0,0,7,7,7,7
Monterey,42,2022-10-02,118,118,118,0,3918,3922,3921,1,9,0,0,1,775,775,775,775
Napa,42,2022-10-02,96,96,96,0,1758,1759,1758,1,6,0,0,2,163,163,163,163
Nevada,42,2022-10-02,58,58,58,0,992,993,992,1,1,0,0,4,137,137,137,137
Orange,42,2022-10-02,1634,1634,1634,0,28848,28868,28867,1,132,22,22,19,7560,7560,7538,7538
Placer,42,2022-10-02,226,226,226,0,3416,3417,3416,1,43,3,3,3,662,662,659,659
Plumas,42,2022-10-02,14,14,14,0,122,123,122,1,2,0,0,0,13,13,13,13
Riverside,42,2022-10-02,1175,1175,1175,0,22906,22921,22920,1,56,6,6,10,6650,6650,6644,6644
Sacramento,42,2022-10-02,904,904,904,0,18630,18643,18642,1,87,12,12,19,3356,3356,3344,3344
San Benito,42,2022-10-02,41,41,41,0,1126,1127,1126,1,0,0,0,0,103,103,103,103
San Bernardino,42,2022-10-02,1245,1245,1245,0,25675,25692,25691,1,70,3,3,11,8104,8104,8101,8101
San Diego,42,2022-10-02,2175,2175,2175,0,46652,46684,46683,1,151,10,10,19,5580,5580,5570,5570
San Francisco,42,2022-10-02,655,655,655,0,15614,15626,15624,2,43,3,3,10,1068,1068,1065,1065
San Joaquin,42,2022-10-02,353,353,353,0,10052,10059,10058,1,30,4,4,3,2343,2343,2339,2339
San Luis Obispo,42,2022-10-02,147,147,147,0,2425,2426,2425,1,2,1,1,2,528,528,527,527
San Mateo,42,2022-10-02,570,570,570,0,12562,12571,12570,1,26,0,0,2,743,743,743,743
Santa Barbara,42,2022-10-02,260,260,260,0,6245,6251,6250,1,12,0,0,3,731,731,731,731
Santa Clara,42,2022-10-02,1460,1460,1460,0,33225,33250,33249,1,105,8,8,18,2555,2555,2547,2547
Santa Cruz,42,2022-10-02,236,236,236,0,11310,11318,11317,1,12,0,0,2,273,273,273,273
Shasta,42,2022-10-02,54,54,54,0,1523,1524,1523,1,12,1,1,2,613,613,612,612
Siskiyou,42,2022-10-02,12,12,12,0,198,199,198,1,1,0,0,1,93,93,93,93
Solano,42,2022-10-02,255,255,255,0,5396,5402,5401,1,19,0,0,2,462,462,462,462
Sonoma,42,2022-10-02,329,329,329,0,6106,6112,6111,1,21,0,0,2,524,524,524,524
Stanislaus,42,2022-10-02,218,218,218,0,5543,5548,5547,1,54,1,1,3,1786,1786,1785,1785
Sutter,42,2022-10-02,61,61,61,0,1144,1145,1144,1,0,2,2,0,234,234,232,232
Tehama,42,2022-10-02,22,22,22,0,541,542,541,1,0,0,0,1,218,218,218,218
Trinity,42,2022-10-02,1,1,1,0,46,47,46,1,0,0,0,0,21,21,21,21
Tulare,42,2022-10-02,170,170,170,0,4964,4970,4969,1,20,5,5,2,1551,1551,1546,1546
Tuolumne,42,2022-10-02,27,27,27,0,674,675,674,1,1,1,1,0,200,200,199,199
Ventura,42,2022-10-02,501,501,501,0,10374,10382,10381,1,33,1,1,4,1595,1595,1594,1594
Yolo,42,2022-10-02,137,137,137,0,3265,3267,3266,1,4,2,2,1,407,407,405,405
Yuba,42,2022-10-02,33,33,33,0,846,847,846,1,6,0,0,0,132,132,132,132
Alameda,43,2022-10-09,1048,1048,1048,0,24527,24545,24544,1,42,3,3,13,2007,2007,2004,2004
Amador,43,2022-10-09,11,11,11,0,673,674,673,1,0,0,0,2,93,93,93,93
Butte,43,2022-10-09,61,61,61,0,1683,1684,1683,1,11,1,1,1,466,466,465,465
Calaveras,43,2022-10-09,13,13,13,0,313,314,313,1,0,1,1,0,135,135,134,134
Colusa,43,2022-10-09,3,3,3,0,104,105,104,1,0,0,0,0,22,22,22,22
Contra Costa,43,2022-10-09,665,665,665,0,14929,14941,14940,1,31,5,5,6,1467,1467,1462,1462
Del Norte,43,2022-10-09,11,11,11,0,386,387,386,1,0,0,0,1,55,55,55,55
El Dorado,43,2022-10-09,68,68,68,0,1401,1402,1401,1,5,0,0,1,234,234,234,234
Fresno,43,2022-10-09,377,377,377,0,10861,10868,10867,1,57,3,3,7,2885,2885,2882,2882
Glenn,43,2022-10-09,7,7,7,0,139,140,139,1,0,0,0,0,56,56,56,56
Humboldt,43,2022-10-09,89,89,89,0,1223,1224,1223,1,8,1,1,0,162,162,161,161
Imperial,43,2022-10-09,174,174,174,0,2592,2593,2592,1,7,0,0,0,962,962,962,962
Inyo,43,2022-10-09,4,4,4,0,115,116,115,1,0,0,0,0,60,60,60,60
Kern,43,2022-10-09,315,315,315,0,10305,10313,10312,1,24,3,3,2,2432,2432,2429,2429
Kings,43,2022-10-09,83,83,83,0,2383,2384,2383,1,0,1,1,1,465,465,464,464
Lake,43,2022-10-09,25,25,25,0,726,727,726,1,1,0,0,0,150,150,150,150
Lassen,43,2022-10-09,4,4,4,0,461,462,461,1,1,0,0,0,64,64,64,64
Los Angeles,43,2022-10-09,5928,5933,5933,0,193804,193952,193949,3,433,60,60,48,33692,33692,33632,33632
Madera,43,2022-10-09,56,56,56,0,1512,1513,1512,1,6,1,1,2,376,376,375,375
Marin,43,2022-10-09,174,174,174,0,3211,3212,3211,1,5,0,0,0,258,258,258,258
Mariposa,43,2022-10-09,5,5,5,0,118,119,118,1,0,0,0,0,30,30,30,30
Mendocino,43,2022-10-09,29,29,29,0,819,820,819,1,2,0,0,2,136,136,136,136
Merced,43,2022-10-09,103,103,103,0,2321,2322,2321,1,8,1,1,1,871,871,870,870
Modoc,43,2022-10-09,5,5,5,0,17,18,17,1,0,0,0,0,11,11,11,11
Mono,43,2022-10-09,1,1,1,0,58,59,58,1,0,0,0,0,7,7,7,7
Monterey,43,2022-10-09,92,92,92,0,3717,3721,3720,1,9,1,1,1,776,776,775,775
Napa,43,2022-10-09,61,61,61,0,1585,1586,1585,1,2,0,0,1,163,163,163,163
Nevada,43,2022-10-09,34,34,34,0,898,899,898,1,1,0,0,1,137,137,137,137
Orange,43,2022-10-09,1343,1343,1343,0,26542,26562,26561,1,125,13,13,17,7573,7573,7560,7560
Placer,43,2022-10-09,179,179,179,0,3264,3265,3264,1,25,0,0,6,662,662,662,662
Plumas,43,2022-10-09,20,20,20,0,96,97,96,1,0,0,0,0,13,13,13,13
Riverside,43,2022-10-09,991,991,991,0,21034,21050,21049,1,58,6,6,7,6656,6656,6650,6650
Sacramento,43,2022-10-09,815,815,815,0,17367,17380,17379,1,73,6,6,16,3362,3362,3356,3356
San Benito,43,2022-10-09,36,36,36,0,1048,1049,1048,1,3,0,0,0,103,103,103,103
San Bernardino,43,2022-10-09,1036,1036,1036,0,23913,23932,23931,1,63,1,1,11,8105,8105,8104,8104
San Diego,43,2022-10-09,1794,1794,1794,0,45342,45376,45375,1,122,3,3,20,5583,5583,5580,5580
San Francisco,43,2022-10-09,626,626,626,0,14595,14607,14606,1,47,2,2,7,1070,1070,1068,1068
San Joaquin,43,2022-10-09,350,350,350,0,9959,9968,9967,1,19,2,2,6,2345,2345,2343,2343
San Luis Obispo,43,2022-10-09,111,111,111,0,2257,2258,2257,1,4,2,2,0,530,530,528,528
San Mateo,43,2022-10-09,565,565,565,0,11780,11790,11789,1,22,0,0,0,743,743,743,743
Santa Barbara,43,2022-10-09,222,222,222,0,6628,6634,6633,1,19,1,1,2,732,732,731,731
Santa Clara,43,2022-10-09,1247,1247,1247,0,28809,28832,28831,1,110,5,5,17,2560,2560,2555,2555
Santa Cruz,43,2022-10-09,248,248,248,0,10793,10803,10802,1,9,0,0,1,273,273,273,273
Shasta,43,2022-10-09,66,66,66,0,1175,1176,1175,1,18,3,3,1,616,616,613,613
Siskiyou,43,2022-10-09,9,9,9,0,180,181,180,1,1,1,1,1,94,94,93,93
Solano,43,2022-10-09,286,286,286,0,5278,5284,5283,1,23,0,0,4,462,462,462,462
Sonoma,43,2022-10-09,245,245,245,0,5619,5625,5624,1,18,1,1,1,525,525,524,524
Stanislaus,43,2022-10-09,190,190,190,0,5179,5185,5184,1,54,3,3,7,1789,1789,1786,1786
Sutter,43,2022-10-09,46,46,46,0,977,978,977,1,0,1,1,0,235,235,234,234
Tehama,43,2022-10-09,22,22,22,0,471,472,471,1,0,0,0,0,218,218,218,218
Trinity,43,2022-10-09,1,1,1,0,48,49,48,1,0,0,0,0,21,21,21,21
Tulare,43,2022-10-09,143,143,143,0,4516,4521,4520,1,10,1,1,2,1552,1552,1551,1551
Tuolumne,43,2022-10-09,27,27,27,0,566,567,566,1,1,1,1,0,201,201,200,200
Ventura,43,2022-10-09,422,422,422,0,9945,9954,9953,1,36,3,3,3,1598,1598,1595,1595
Yolo,43,2022-10-09,92,92,92,0,2813,2814,2813,1,2,2,2,0,409,409,407,407
Yuba,43,2022-10-09,23,23,23,0,786,787,786,1,0,0,0,1,132,132,132,132
Alameda,44,2022-10-16,1092,1092,1092,0,28303,28326,28325,1,57,3,3,12,2010,2010,2007,2007
Amador,44,2022-10-16,17,17,17,0,734,735,734,1,1,0,0,0,93,93,93,93
Butte,44,2022-10-16,72,72,72,0,1559,1560,1559,1,13,2,2,0,467,467,465,465
Calaveras,44,2022-10-16,24,24,24,0,350,351,350,1,0,0,0,0,135,135,135,135
Colusa,44,2022-10-16,3,3,3,0,92,93,92,1,1,0,0,0,22,22,22,22
Contra Costa,44,2022-10-16,772,772,772,0,16634,16648,16647,1,25,7,7,5,1472,1472,1465,1465
Del Norte,44,2022-10-16,12,12,12,0,483,484,483,1,1,0,0,0,55,55,55,55
El Dorado,44,2022-10-16,98,98,98,0,1745,1746,1745,1,1,0,0,1,234,234,234,234
Fresno,44,2022-10-16,442,442,442,0,11827,11835,11834,1,58,2,2,13,2887,2887,2885,2885
Glenn,44,2022-10-16,11,11,11,0,227,228,227,1,1,0,0,0,56,56,56,56
Humboldt,44,2022-10-16,77,77,77,0,1296,1297,1296,1,1,0,0,0,162,162,162,162
Imperial,44,2022-10-16,148,148,148,0,2734,2735,2734,1,5,0,0,0,962,962,962,962
Inyo,44,2022-10-16,5,5,5,0,137,138,137,1,1,0,0,0,60,60,60,60
Kern,44,2022-10-16,263,263,263,0,11295,11305,11304,1,27,0,0,3,2432,2432,2432,2432
Kings,44,2022-10-16,91,91,91,0,2707,2708,2707,1,1,1,1,1,466,466,465,465
Lake,44,2022-10-16,35,35,35,0,936,937,936,1,1,0,0,0,150,150,150,150
Lassen,44,2022-10-16,6,6,6,0,582,583,582,1,1,0,0,0,64,64,64,64
Los Angeles,44,2022-10-16,6145,6151,6151,0,225833,226022,226019,3,355,54,54,55,33738,33738,33684,33684
Madera,44,2022-10-16,65,65,65,0,1659,1660,1659,1,3,0,0,2,376,376,376,376
Marin,44,2022-10-16,176,176,176,0,3615,3618,3617,1,6,0,0,1,258,258,258,258
Mariposa,44,2022-10-16,9,9,9,0,133,134,133,1,0,0,0,0,30,30,30,30
Mendocino,44,2022-10-16,51,51,51,0,879,880,879,1,2,0,0,1,136,136,136,136
Merced,44,2022-10-16,145,145,145,0,2839,2840,2839,1,11,0,0,3,871,871,871,871
Modoc,44,2022-10-16,1,1,1,0,7,8,7,1,0,0,0,0,11,11,11,11
Mono,44,2022-10-16,5,5,5,0,48,49,48,1,0,0,0,0,7,7,7,7
Monterey,44,2022-10-16,128,128,128,0,4207,4212,4211,1,18,1,1,1,777,777,776,776
Napa,44,2022-10-16,79,79,79,0,1642,1643,1642,1,2,0,0,1,163,163,163,163
Nevada,44,2022-10-16,59,59,59,0,936,937,936,1,4,0,0,0,137,137,137,137
Orange,44,2022-10-16,1388,1388,1388,0,29569,29595,29594,1,101,21,21,20,7592,7592,7571,7571
Placer,44,2022-10-16,160,160,160,0,3522,3523,3522,1,39,0,0,3,662,662,662,662
Plumas,44,2022-10-16,11,11,11,0,112,113,112,1,0,0,0,0,13,13,13,13
Riverside,44,2022-10-16,1121,1121,1121,0,23822,23842,23841,1,57,2,2,6,6658,6658,6656,6656
Sacramento,44,2022-10-16,1012,1012,1012,0,19746,19763,19762,1,72,10,10,16,3372,3372,3362,3362
San Benito,44,2022-10-16,27,27,27,0,1175,1176,1175,1,0,1,1,0,104,104,103,103
San Bernardino,44,2022-10-16,987,987,987,0,27460,27482,27481,1,70,0,0,8,8105,8105,8105,8105
San Diego,44,2022-10-16,1888,1888,1888,0,51891,51935,51934,1,129,12,12,20,5593,5593,5581,5581
San Francisco,44,2022-10-16,651,651,651,0,16093,16107,16106,1,39,2,2,10,1072,1072,1070,1070
San Joaquin,44,2022-10-16,435,435,435,0,11142,11153,11152,1,13,2,2,5,2347,2347,2345,2345
San Luis Obispo,44,2022-10-16,98,98,98,0,2487,2488,2487,1,6,1,1,0,531,531,530,530
San Mateo,44,2022-10-16,671,671,671,0,13599,13612,13611,1,21,0,0,1,743,743,743,743
Santa Barbara,44,2022-10-16,221,221,221,0,6895,6902,6901,1,16,0,0,3,732,732,732,732
Santa Clara,44,2022-10-16,1402,1402,1402,0,34902,34932,34931,1,100,5,5,14,2565,2565,2560,2560
Santa Cruz,44,2022-10-16,328,328,328,0,11524,11534,11533,1,7,1,1,1,274,274,273,273
Shasta,44,2022-10-16,114,114,114,0,1368,1369,1368,1,9,0,0,3,616,616,616,616
Siskiyou,44,2022-10-16,9,9,9,0,254,255,254,1,3,1,1,1,95,95,94,94
Solano,44,2022-10-16,327,327,327,0,5909,5916,5915,1,24,1,1,3,463,463,462,462
Sonoma,44,2022-10-16,286,286,286,0,6583,6590,6589,1,21,1,1,1,526,526,525,525
Stanislaus,44,2022-10-16,244,244,244,0,6107,6114,6113,1,47,5,5,6,1792,1792,1787,1787
Sutter,44,2022-10-16,56,56,56,0,1026,1027,1026,1,0,0,0,0,235,235,235,235
Tehama,44,2022-10-16,20,20,20,0,522,523,522,1,0,0,0,0,218,218,218,218
Trinity,44,2022-10-16,0,0,0,0,39,40,39,1,0,0,0,0,21,21,21,21
Tulare,44,2022-10-16,159,159,159,0,4935,4941,4940,1,11,1,1,1,1553,1553,1552,1552
Tuolumne,44,2022-10-16,45,45,45,0,713,714,713,1,1,0,0,0,201,201,201,201
Ventura,44,2022-10-16,404,404,404,0,10814,10823,10822,1,37,4,4,2,1601,1601,1597,1597
Yolo,44,2022-10-16,132,132,132,0,2600,2601,2600,1,3,2,2,3,411,411,409,409
Yuba,44,2022-10-16,45,45,45,0,892,893,892,1,1,0,0,0,132,132,132,132
Alameda,45,2022-10-23,922,922,922,0,23197,23219,23218,1,47,4,4,10,2014,2014,2010,2010
Amador,45,2022-10-23,19,19,19,0,626,627,626,1,1,0,0,0,93,93,93,93
Butte,45,2022-10-23,76,76,76,0,1391,1392,1391,1,7,1,1,1,468,468,467,467
Calaveras,45,2022-10-23,16,16,16,0,338,339,338,1,0,0,0,0,135,135,135,135
Colusa,45,2022-10-23,4,4,4,0,98,99,98,1,0,0,0,0,22,22,22,22
Contra Costa,45,2022-10-23,642,642,642,0,14005,14017,14016,1,25,6,6,7,1478,1478,1472,1472
Del Norte,45,2022-10-23,6,6,6,0,362,363,362,1,0,0,0,0,55,55,55,55
El Dorado,45,2022-10-23,93,93,93,0,1509,1510,1509,1,1,0,0,1,234,234,234,234
Fresno,45,2022-10-23,404,404,404,0,9918,9928,9927,1,62,0,0,3,2887,2887,2887,2887
Glenn,45,2022-10-23,8,8,8,0,146,147,146,1,0,0,0,0,56,56,56,56
Humboldt,45,2022-10-23,80,80,80,0,1190,1191,1190,1,8,0,0,2,162,162,162,162
Imperial,45,2022-10-23,116,116,116,0,2311,2313,2312,1,4,1,1,0,963,963,962,962
Inyo,45,2022-10-23,7,7,7,0,186,187,186,1,0,0,0,0,60,60,60,60
Kern,45,2022-10-23,275,275,275,0,9579,9589,9588,1,23,1,1,4,2433,2433,2432,2432
Kings,45,2022-10-23,80,80,80,0,2264,2266,2265,1,6,0,0,0,466,466,466,466
Lake,45,2022-10-23,25,25,25,0,708,709,708,1,1,1,1,1,151,151,150,150
Lassen,45,2022-10-23,14,14,14,0,510,511,510,1,0,0,0,0,64,64,64,64
Los Angeles,45,2022-10-23,5292,5299,5299,0,186719,186896,186894,2,354,51,51,49,33789,33789,33738,33738
Madera,45,2022-10-23,63,63,63,0,1387,1388,1387,1,1,0,0,2,376,376,376,376
Marin,45,2022-10-23,145,145,145,0,3227,3231,3230,1,8,1,1,3,259,259,258,258
Mariposa,45,2022-10-23,10,10,10,0,124,125,124,1,0,0,0,0,30,30,30,30
Mendocino,45,2022-10-23,44,44,44,0,775,776,775,1,2,0,0,0,136,136,136,136
Merced,45,2022-10-23,100,100,100,0,2369,2370,2369,1,8,3,3,2,874,874,871,871
Modoc,45,2022-10-23,1,1,1,0,14,15,14,1,0,0,0,0,11,11,11,11
Mono,45,2022-10-23,4,4,4,0,49,50,49,1,0,1,1,0,8,8,7,7
Monterey,45,2022-10-23,138,138,138,0,3782,3787,3786,1,14,0,0,0,777,777,777,777
Napa,45,2022-10-23,42,42,42,0,1461,1462,1461,1,0,0,0,0,163,163,163,163
Nevada,45,2022-10-23,30,30,30,0,726,727,726,1,3,0,0,0,137,137,137,137
Orange,45,2022-10-23,1138,1138,1138,0,25787,25812,25811,1,88,14,14,12,7606,7606,7592,7592
Placer,45,2022-10-23,187,187,187,0,3032,3034,3033,1,47,0,0,4,662,662,662,662
Plumas,45,2022-10-23,15,15,15,0,91,92,91,1,1,0,0,0,13,13,13,13
Riverside,45,2022-10-23,923,923,923,0,20170,20190,20189,1,49,0,0,7,6658,6658,6658,6658
Sacramento,45,2022-10-23,849,849,849,0,15504,15519,15518,1,74,5,5,19,3377,3377,3372,3372
San Benito,45,2022-10-23,37,37,37,0,904,905,904,1,0,0,0,0,104,104,104,104
San Bernardino,45,2022-10-23,829,829,829,0,21729,21750,21749,1,49,4,4,14,8109,8109,8105,8105
San Diego,45,2022-10-23,1652,1652,1652,0,42614,42655,42654,1,97,5,5,24,5598,5598,5593,5593
San Francisco,45,2022-10-23,513,513,513,0,14067,14081,14080,1,40,2,2,6,1074,1074,1072,1072
San Joaquin,45,2022-10-23,287,287,287,0,8599,8608,8607,1,21,2,2,4,2349,2349,2347,2347
San Luis Obispo,45,2022-10-23,100,100,100,0,2077,2078,2077,1,4,0,0,1,531,531,531,531
San Mateo,45,2022-10-23,488,488,488,0,11002,11014,11013,1,22,0,0,2,743,743,743,743
Santa Barbara,45,2022-10-23,153,153,153,0,5719,5725,5724,1,21,1,1,4,733,733,732,732
Santa Clara,45,2022-10-23,1188,1188,1188,0,28826,28855,28854,1,91,2,2,16,2567,2567,2565,2565
Santa Cruz,45,2022-10-23,272,272,272,0,11275,11286,11285,1,12,1,1,0,275,275,274,274
Shasta,45,2022-10-23,79,79,79,0,954,955,954,1,7,1,1,2,617,617,616,616
Siskiyou,45,2022-10-23,13,13,13,0,162,163,162,1,1,0,0,1,95,95,95,95
Solano,45,2022-10-23,235,235,235,0,5031,5037,5036,1,19,0,0,1,463,463,463,463
Sonoma,45,2022-10-23,237,237,237,0,5335,5342,5341,1,23,0,0,1,526,526,526,526
Stanislaus,45,2022-10-23,187,187,187,0,4900,4906,4905,1,43,3,3,3,1795,1795,1792,1792
Sutter,45,2022-10-23,28,28,28,0,881,882,881,1,0,0,0,0,235,235,235,235
Tehama,45,2022-10-23,35,35,35,0,399,400,399,1,1,0,0,0,218,218,218,218
Trinity,45,2022-10-23,1,1,1,0,36,37,36,1,0,0,0,0,21,21,21,21
Tulare,45,2022-10-23,104,104,104,0,4306,4312,4311,1,16,0,0,1,1553,1553,1553,1553
Tuolumne,45,2022-10-23,32,32,32,0,607,608,607,1,0,1,1,0,202,202,201,201
Ventura,45,2022-10-23,313,313,313,0,9039,9049,9048,1,34,4,4,3,1605,1605,1601,1601
Yolo,45,2022-10-23,88,88,88,0,2068,2069,2068,1,6,1,1,0,412,412,411,411
Yuba,45,2022-10-23,50,50,50,0,793,794,793,1,6,0,0,1,132,132,132,132
Alameda,46,2022-10-30,1033,1033,1033,0,23839,23865,23864,1,50,4,4,5,2018,2018,2014,2014
Amador,46,2022-10-30,15,15,15,0,597,598,597,1,1,1,1,0,94,94,93,93
Butte,46,2022-10-30,73,73,73,0,1468,1469,1468,1,12,0,0,0,468,468,468,468
Calaveras,46,2022-10-30,16,16,16,0,257,258,257,1,0,0,0,0,135,135,135,135
Colusa,46,2022-10-30,10,10,10,0,105,106,105,1,0,0,0,0,22,22,22,22
Contra Costa,46,2022-10-30,695,695,695,0,13948,13962,13961,1,33,6,6,8,1484,1484,1478,1478
Del Norte,46,2022-10-30,14,14,14,0,365,366,365,1,1,0,0,0,55,55,55,55
El Dorado,46,2022-10-30,104,104,104,0,1428,1429,1428,1,2,0,0,0,234,234,234,234
Fresno,46,2022-10-30,403,403,403,0,10586,10599,10598,1,62,5,5,8,2892,2892,2887,2887
Glenn,46,2022-10-30,10,10,10,0,155,156,155,1,1,0,0,0,56,56,56,56
Humboldt,46,2022-10-30,46,46,46,0,1070,1071,1070,1,5,0,0,2,162,162,162,162
Imperial,46,2022-10-30,115,115,115,0,2632,2634,2633,1,11,0,0,0,963,963,963,963
Inyo,46,2022-10-30,9,9,9,0,323,324,323,1,0,0,0,0,60,60,60,60
Kern,46,2022-10-30,321,321,321,0,10032,10044,10043,1,18,3,3,3,2436,2436,2433,2433
Kings,46,2022-10-30,126,126,126,0,2533,2535,2534,1,3,0,0,1,466,466,466,466
Lake,46,2022-10-30,23,23,23,0,736,737,736,1,1,0,0,1,151,151,151,151
Lassen,46,2022-10-30,17,17,17,0,522,523,522,1,1,0,0,0,64,64,64,64
Los Angeles,46,2022-10-30,5927,5934,5934,0,193430,193632,193630,2,350,39,39,42,33828,33828,33789,33789
Madera,46,2022-10-30,57,57,57,0,1474,1475,1474,1,3,0,0,2,376,376,376,376
Marin,46,2022-10-30,133,133,133,0,3381,3386,3385,1,11,1,1,0,260,260,259,259
Mariposa,46,2022-10-30,11,11,11,0,129,130,129,1,0,0,0,0,30,30,30,30
Mendocino,46,2022-10-30,27,27,27,0,723,724,723,1,3,0,0,1,136,136,136,136
Merced,46,2022-10-30,89,89,89,0,2190,2191,2190,1,5,1,1,0,875,875,874,874
Modoc,46,2022-10-30,1,1,1,0,13,14,13,1,0,0,0,0,11,11,11,11
Mono,46,2022-10-30,0,0,0,0,91,92,91,1,0,0,0,1,8,8,8,8
Monterey,46,2022-10-30,138,138,138,0,3638,3643,3642,1,20,2,2,0,779,779,777,777
Napa,46,2022-10-30,57,57,57,0,1508,1509,1508,1,2,0,0,0,163,163,163,163
Nevada,46,2022-10-30,43,43,43,0,820,821,820,1,8,0,0,0,137,137,137,137
Orange,46,2022-10-30,1190,1190,1190,0,27282,27311,27310,1,97,16,16,16,7622,7622,7606,7606
Placer,46,2022-10-30,161,161,161,0,2905,2908,2907,1,38,0,0,7,662,662,662,662
Plumas,46,2022-10-30,5,5,5,0,91,92,91,1,0,0,0,0,13,13,13,13
Riverside,46,2022-10-30,1007,1007,1007,0,20161,20183,20182,1,57,4,4,9,6662,6662,6658,6658
Sacramento,46,2022-10-30,769,769,769,0,14596,14610,14609,1,72,9,9,13,3386,3386,3377,3377
San Benito,46,2022-10-30,34,34,34,0,805,806,805,1,1,0,0,1,104,104,104,104
San Bernardino,46,2022-10-30,990,990,990,0,22579,22602,22601,1,56,2,2,16,8111,8111,8109,8109
San Diego,46,2022-10-30,1764,1764,1764,0,42494,42538,42537,1,115,5,5,19,5603,5603,5598,5598
San Francisco,46,2022-10-30,604,604,604,0,14710,14725,14724,1,42,2,2,4,1076,1076,1074,1074
San Joaquin,46,2022-10-30,324,324,324,0,8634,8644,8643,1,17,2,2,4,2351,2351,2349,2349
San Luis Obispo,46,2022-10-30,82,82,82,0,2023,2024,2023,1,4,1,1,0,532,532,531,531
San Mateo,46,2022-10-30,516,516,516,0,11533,11547,11546,1,31,0,0,0,743,743,743,743
Santa Barbara,46,2022-10-30,195,195,195,0,6022,6028,6027,1,25,1,1,7,734,734,733,733
Santa Clara,46,2022-10-30,1275,1275,1275,0,31313,31346,31345,1,95,4,4,16,2571,2571,2567,2567
Santa Cruz,46,2022-10-30,188,188,188,0,9787,9797,9796,1,10,0,0,0,275,275,275,275
Shasta,46,2022-10-30,65,65,65,0,901,902,901,1,5,2,2,0,619,619,617,617
Siskiyou,46,2022-10-30,17,17,17,0,215,216,215,1,1,1,1,1,96,96,95,95
Solano,46,2022-10-30,301,301,301,0,5284,5291,5290,1,21,0,0,3,463,463,463,463
Sonoma,46,2022-10-30,226,226,226,0,5904,5911,5910,1,25,0,0,3,526,526,526,526
Stanislaus,46,2022-10-30,236,236,236,0,5025,5032,5031,1,50,0,0,6,1795,1795,1795,1795
Sutter,46,2022-10-30,51,51,51,0,970,971,970,1,0,0,0,0,235,235,235,235
Tehama,46,2022-10-30,22,22,22,0,399,400,399,1,1,0,0,0,218,218,218,218
Trinity,46,2022-10-30,18,18,18,0,73,74,73,1,4,0,0,0,21,21,21,21
Tulare,46,2022-10-30,151,151,151,0,3906,3911,3910,1,11,1,1,1,1554,1554,1553,1553
Tuolumne,46,2022-10-30,24,24,24,0,562,563,562,1,3,0,0,0,202,202,202,202
Ventura,46,2022-10-30,358,358,358,0,9528,9540,9539,1,34,1,1,2,1606,1606,1605,1605
Yolo,46,2022-10-30,77,77,77,0,1915,1916,1915,1,3,0,0,1,412,412,412,412
Yuba,46,2022-10-30,44,44,44,0,809,810,809,1,2,1,1,0,133,133,132,132
Alameda,47,2022-11-06,1327,1327,1327,0,24131,24158,24157,1,55,5,5,9,2023,2023,2018,2018
Amador,47,2022-11-06,31,31,31,0,678,679,678,1,3,0,0,0,94,94,94,94
Butte,47,2022-11-06,107,107,107,0,1377,1378,1377,1,10,0,0,0,468,468,468,468
Calaveras,47,2022-11-06,14,14,14,0,321,322,321,1,0,0,0,0,135,135,135,135
Colusa,47,2022-11-06,3,3,3,0,102,103,102,1,0,0,0,0,22,22,22,22
Contra Costa,47,2022-11-06,881,881,881,0,15430,15447,15446,1,39,2,2,6,1486,1486,1484,1484
Del Norte,47,2022-11-06,6,6,6,0,365,366,365,1,0,0,0,0,55,55,55,55
El Dorado,47,2022-11-06,103,103,103,0,1531,1532,1531,1,3,2,2,0,236,236,234,234
Fresno,47,2022-11-06,555,555,555,0,10405,10418,10417,1,58,3,3,6,2895,2895,2892,2892
Glenn,47,2022-11-06,20,20,20,0,145,146,145,1,0,0,0,0,56,56,56,56
Humboldt,47,2022-11-06,78,78,78,0,1024,1025,1024,1,7,0,0,3,162,162,162,162
Imperial,47,2022-11-06,184,184,184,0,3600,3606,3605,1,11,0,0,0,963,963,963,963
Inyo,47,2022-11-06,17,17,17,0,245,246,245,1,0,0,0,0,60,60,60,60
Kern,47,2022-11-06,446,446,446,0,10341,10355,10354,1,30,1,1,4,2437,2437,2436,2436
Kings,47,2022-11-06,113,113,113,0,2350,2352,2351,1,8,1,1,2,467,467,466,466
Lake,47,2022-11-06,46,46,46,0,762,763,762,1,2,0,0,2,151,151,151,151
Lassen,47,2022-11-06,14,14,14,0,418,419,418,1,0,0,0,0,64,64,64,64
Los Angeles,47,2022-11-06,7739,7746,7746,0,192788,193002,193000,2,397,54,54,51,33882,33882,33828,33828
Madera,47,2022-11-06,75,75,75,0,1555,1556,1555,1,3,0,0,5,376,376,376,376
Marin,47,2022-11-06,140,140,140,0,3490,3496,3495,1,7,0,0,0,260,260,260,260
Mariposa,47,2022-11-06,13,13,13,0,122,123,122,1,0,0,0,0,30,30,30,30
Mendocino,47,2022-11-06,33,33,33,0,809,810,809,1,4,0,0,0,136,136,136,136
Merced,47,2022-11-06,148,148,148,0,2467,2469,2468,1,6,4,4,0,879,879,875,875
Modoc,47,2022-11-06,2,2,2,0,5,6,5,1,0,0,0,0,11,11,11,11
Mono,47,2022-11-06,4,4,4,0,89,90,89,1,0,0,0,0,8,8,8,8
Monterey,47,2022-11-06,199,199,199,0,3783,3789,3788,1,16,1,1,0,780,780,779,779
Napa,47,2022-11-06,70,70,70,0,1728,1729,1728,1,3,0,0,0,163,163,163,163
Nevada,47,2022-11-06,52,52,52,0,726,727,726,1,2,0,0,1,137,137,137,137
Orange,47,2022-11-06,1248,1248,1248,0,28655,28688,28687,1,86,8,8,17,7630,7630,7622,7622
Placer,47,2022-11-06,199,199,199,0,3083,3088,3087,1,50,2,2,6,664,664,662,662
Plumas,47,2022-11-06,6,6,6,0,70,71,70,1,1,0,0,0,13,13,13,13
Riverside,47,2022-11-06,1421,1421,1421,0,20988,21011,21010,1,65,3,3,7,6665,6665,6662,6662
Sacramento,47,2022-11-06,1031,1031,1031,0,15552,15571,15570,1,88,8,8,10,3394,3394,3386,3386
San Benito,47,2022-11-06,40,40,40,0,867,868,867,1,1,0,0,0,104,104,104,104
San Bernardino,47,2022-11-06,1374,1374,1374,0,23822,23848,23847,1,67,3,3,17,8114,8114,8111,8111
San Diego,47,2022-11-06,2002,2002,2002,0,44480,44529,44528,1,123,7,7,23,5610,5610,5603,5603
San Francisco,47,2022-11-06,706,706,706,0,14709,14725,14724,1,45,2,2,7,1078,1078,1076,1076
San Joaquin,47,2022-11-06,463,463,463,0,8739,8750,8749,1,19,5,5,3,2356,2356,2351,2351
San Luis Obispo,47,2022-11-06,125,125,125,0,2197,2198,2197,1,5,0,0,2,532,532,532,532
San Mateo,47,2022-11-06,573,573,573,0,12188,12203,12202,1,25,0,0,3,743,743,743,743
Santa Barbara,47,2022-11-06,195,195,195,0,6685,6693,6692,1,17,2,2,2,736,736,734,734
Santa Clara,47,2022-11-06,1618,1618,1618,0,31152,31188,31187,1,79,7,7,15,2578,2578,2571,2571
Santa Cruz,47,2022-11-06,265,265,265,0,10549,10562,10561,1,7,0,0,1,275,275,275,275
Shasta,47,2022-11-06,89,89,89,0,937,938,937,1,11,1,1,3,620,620,619,619
Siskiyou,47,2022-11-06,17,17,17,0,282,283,282,1,2,0,0,1,96,96,96,96
Solano,47,2022-11-06,346,346,346,0,5542,5549,5548,1,26,2,2,3,465,465,463,463
Sonoma,47,2022-11-06,222,222,222,0,5922,5930,5929,1,13,1,1,2,527,527,526,526
Stanislaus,47,2022-11-06,288,288,288,0,4831,4838,4837,1,41,4,4,6,1799,1799,1795,1795
Sutter,47,2022-11-06,76,76,76,0,934,935,934,1,0,0,0,0,235,235,235,235
Tehama,47,2022-11-06,50,50,50,0,460,461,460,1,2,0,0,0,218,218,218,218
Trinity,47,2022-11-06,2,2,2,0,34,35,34,1,0,0,0,0,21,21,21,21
Tulare,47,2022-11-06,159,159,159,0,4159,4165,4164,1,12,0,0,0,1554,1554,1554,1554
Tuolumne,47,2022-11-06,78,78,78,0,628,629,628,1,2,0,0,0,202,202,202,202
Ventura,47,2022-11-06,432,432,432,0,9930,9943,9942,1,43,3,3,1,1609,1609,1606,1606
Yolo,47,2022-11-06,182,182,182,0,2216,2218,2217,1,3,3,3,0,415,415,412,412
Yuba,47,2022-11-06,47,47,47,0,859,860,859,1,4,0,0,0,133,133,133,133
Alameda,48,2022-11-13,1419,1419,1419,0,24027,24055,24054,1,76,2,2,8,2025,2025,2023,2023
Amador,48,2022-11-13,22,22,22,0,636,637,636,1,2,0,0,0,94,94,94,94
Butte,48,2022-11-13,123,123,123,0,1328,1329,1328,1,15,0,0,0,468,468,468,468
Calaveras,48,2022-11-13,31,31,31,0,335,336,335,1,0,0,0,0,135,135,135,135
Colusa,48,2022-11-13,9,9,9,0,99,100,99,1,1,0,0,0,22,22,22,22
Contra Costa,48,2022-11-13,931,931,931,0,15780,15799,15798,1,51,2,2,6,1488,1488,1486,1486
Del Norte,48,2022-11-13,23,23,23,0,422,423,422,1,1,0,0,0,55,55,55,55
El Dorado,48,2022-11-13,133,133,133,0,1595,1596,1595,1,8,0,0,1,236,236,236,236
Fresno,48,2022-11-13,721,721,721,0,10991,11003,11002,1,73,7,7,12,2902,2902,2895,2895
Glenn,48,2022-11-13,29,29,29,0,142,143,142,1,0,0,0,0,56,56,56,56
Humboldt,48,2022-11-13,79,79,79,0,1084,1085,1084,1,5,0,0,1,162,162,162,162
Imperial,48,2022-11-13,238,238,238,0,3283,3288,3287,1,4,0,0,1,963,963,963,963
Inyo,48,2022-11-13,8,8,8,0,451,452,451,1,0,0,0,0,60,60,60,60
Kern,48,2022-11-13,460,460,460,0,10965,10980,10979,1,29,1,1,5,2438,2438,2437,2437
Kings,48,2022-11-13,202,202,202,0,2584,2588,2587,1,7,2,2,0,469,469,467,467
Lake,48,2022-11-13,46,46,46,0,801,802,801,1,0,0,0,0,151,151,151,151
Lassen,48,2022-11-13,20,20,20,0,524,525,524,1,0,1,1,0,65,65,64,64
Los Angeles,48,2022-11-13,9121,9133,9133,0,195109,195337,195335,2,508,45,45,72,33927,33927,33882,33882
Madera,48,2022-11-13,89,89,89,0,1665,1666,1665,1,5,0,0,2,376,376,376,376
Marin,48,2022-11-13,173,173,173,0,3433,3439,3438,1,11,0,0,0,260,260,260,260
Mariposa,48,2022-11-13,16,16,16,0,123,124,123,1,0,0,0,0,30,30,30,30
Mendocino,48,2022-11-13,36,36,36,0,852,853,852,1,2,1,1,1,137,137,136,136
Merced,48,2022-11-13,174,174,174,0,2562,2564,2563,1,7,0,0,1,879,879,879,879
Modoc,48,2022-11-13,3,3,3,0,12,13,12,1,1,0,0,0,11,11,11,11
Mono,48,2022-11-13,10,10,10,0,112,113,112,1,0,0,0,0,8,8,8,8
Monterey,48,2022-11-13,201,201,201,0,4071,4076,4075,1,23,0,0,1,780,780,780,780
Napa,48,2022-11-13,109,109,109,0,1859,1860,1859,1,5,0,0,0,163,163,163,163
Nevada,48,2022-11-13,58,58,58,0,761,762,761,1,2,0,0,2,137,137,137,137
Orange,48,2022-11-13,1542,1542,1542,0,26982,27014,27013,1,106,10,10,21,7640,7640,7630,7630
Placer,48,2022-11-13,304,304,304,0,3734,3741,3740,1,59,1,1,6,665,665,664,664
Plumas,48,2022-11-13,3,3,3,0,83,84,83,1,1,0,0,0,13,13,13,13
Riverside,48,2022-11-13,1582,1582,1582,0,22204,22228,22227,1,85,4,4,11,6669,6669,6665,6665
Sacramento,48,2022-11-13,1188,1188,1188,0,16674,16693,16692,1,86,7,7,13,3401,3401,3394,3394
San Benito,48,2022-11-13,40,40,40,0,925,926,925,1,1,0,0,0,104,104,104,104
San Bernardino,48,2022-11-13,1727,1727,1727,0,24055,24082,24081,1,80,0,0,16,8114,8114,8114,8114
San Diego,48,2022-11-13,2386,2387,2387,0,43880,43931,43930,1,132,7,7,26,5617,5617,5610,5610
San Francisco,48,2022-11-13,709,709,709,0,13686,13702,13701,1,46,7,7,8,1085,1085,1078,1078
San Joaquin,48,2022-11-13,549,549,549,0,9014,9026,9025,1,13,1,1,5,2357,2357,2356,2356
San Luis Obispo,48,2022-11-13,118,118,118,0,2201,2203,2202,1,3,0,0,1,532,532,532,532
San Mateo,48,2022-11-13,636,636,636,0,11440,11455,11454,1,23,0,0,1,743,743,743,743
Santa Barbara,48,2022-11-13,186,186,186,0,5813,5821,5820,1,16,1,1,1,737,737,736,736
Santa Clara,48,2022-11-13,1690,1690,1690,0,30760,30796,30795,1,118,3,3,17,2581,2581,2578,2578
Santa Cruz,48,2022-11-13,256,256,256,0,9803,9816,9815,1,12,1,1,0,276,276,275,275
Shasta,48,2022-11-13,105,105,105,0,1080,1081,1080,1,9,1,1,2,621,621,620,620
Siskiyou,48,2022-11-13,20,20,20,0,350,351,350,1,2,0,0,1,96,96,96,96
Solano,48,2022-11-13,439,439,439,0,5432,5439,5438,1,30,0,0,1,465,465,465,465
Sonoma,48,2022-11-13,283,283,283,0,6239,6247,6246,1,14,0,0,1,527,527,527,527
Stanislaus,48,2022-11-13,321,321,321,0,5145,5153,5152,1,44,0,0,8,1799,1799,1799,1799
Sutter,48,2022-11-13,102,102,102,0,1129,1130,1129,1,0,0,0,0,235,235,235,235
Tehama,48,2022-11-13,38,38,38,0,518,519,518,1,2,0,0,0,218,218,218,218
Trinity,48,2022-11-13,10,10,10,0,52,53,52,1,0,3,3,0,24,24,21,21
Tulare,48,2022-11-13,276,276,276,0,4386,4391,4390,1,14,0,0,1,1554,1554,1554,1554
Tuolumne,48,2022-11-13,75,75,75,0,688,689,688,1,4,0,0,0,202,202,202,202
Ventura,48,2022-11-13,544,544,544,0,10570,10584,10583,1,35,1,1,2,1610,1610,1609,1609
Yolo,48,2022-11-13,140,140,140,0,2136,2138,2137,1,0,5,5,0,420,420,415,415
Yuba,48,2022-11-13,54,54,54,0,981,982,981,1,5,0,0,1,133,133,133,133
Alameda,49,2022-11-20,1717,1717,1717,0,26315,26347,26346,1,81,9,9,16,2034,2034,2025,2025
Amador,49,2022-11-20,28,28,28,0,809,810,809,1,2,0,0,0,94,94,94,94
Butte,49,2022-11-20,141,141,141,0,1350,1351,1350,1,23,0,0,1,468,468,468,468
Calaveras,49,2022-11-20,35,35,35,0,420,421,420,1,1,0,0,0,135,135,135,135
Colusa,49,2022-11-20,9,9,9,0,105,106,105,1,0,0,0,0,22,22,22,22
Contra Costa,49,2022-11-20,1011,1011,1011,0,16770,16792,16791,1,43,3,3,8,1491,1491,1488,1488
Del Norte,49,2022-11-20,15,15,15,0,503,504,503,1,4,0,0,0,55,55,55,55
El Dorado,49,2022-11-20,158,158,158,0,1791,1792,1791,1,11,0,0,1,236,236,236,236
Fresno,49,2022-11-20,1042,1042,1042,0,12324,12339,12338,1,105,6,6,11,2908,2908,2902,2902
Glenn,49,2022-11-20,24,24,24,0,193,194,193,1,0,0,0,0,56,56,56,56
Humboldt,49,2022-11-20,120,120,120,0,1129,1130,1129,1,3,1,1,1,163,163,162,162
Imperial,49,2022-11-20,276,276,276,0,3304,3310,3309,1,5,1,1,1,964,964,963,963
Inyo,49,2022-11-20,27,27,27,0,461,462,461,1,0,1,1,0,61,61,60,60
Kern,49,2022-11-20,513,513,513,0,10714,10728,10727,1,55,3,3,9,2441,2441,2438,2438
Kings,49,2022-11-20,285,285,285,0,2872,2877,2876,1,4,2,2,0,471,471,469,469
Lake,49,2022-11-20,65,65,65,0,977,978,977,1,0,1,1,1,152,152,151,151
Lassen,49,2022-11-20,49,49,49,0,594,595,594,1,0,0,0,0,65,65,65,65
Los Angeles,49,2022-11-20,12314,12328,12328,0,204184,204432,204430,2,673,71,71,87,33998,33998,33927,33927
Madera,49,2022-11-20,165,165,165,0,1914,1915,1914,1,14,0,0,0,376,376,376,376
Marin,49,2022-11-20,182,182,182,0,3580,3586,3585,1,8,0,0,0,260,260,260,260
Mariposa,49,2022-11-20,18,18,18,0,173,174,173,1,0,0,0,0,30,30,30,30
Mendocino,49,2022-11-20,44,44,44,0,981,982,981,1,4,0,0,0,137,137,137,137
Merced,49,2022-11-20,231,231,231,0,3011,3017,3016,1,6,1,1,3,880,880,879,879
Modoc,49,2022-11-20,4,4,4,0,8,9,8,1,1,0,0,0,11,11,11,11
Mono,49,2022-11-20,1,1,1,0,115,116,115,1,0,0,0,0,8,8,8,8
Monterey,49,2022-11-20,231,231,231,0,4504,4510,4509,1,12,2,2,1,782,782,780,780
Napa,49,2022-11-20,141,141,141,0,2120,2123,2122,1,4,0,0,0,163,163,163,163
Nevada,49,2022-11-20,86,86,86,0,973,974,973,1,2,0,0,2,137,137,137,137
Orange,49,2022-11-20,2131,2131,2131,0,28994,29029,29028,1,156,13,13,29,7653,7653,7640,7640
Placer,49,2022-11-20,369,369,369,0,4279,4286,4285,1,50,0,0,7,665,665,665,665
Plumas,49,2022-11-20,7,7,7,0,99,100,99,1,1,0,0,0,13,13,13,13
Riverside,49,2022-11-20,2149,2149,2149,0,24691,24721,24720,1,97,5,5,12,6674,6674,6669,6669
Sacramento,49,2022-11-20,1518,1518,1518,0,19498,19522,19521,1,95,4,4,17,3405,3405,3401,3401
San Benito,49,2022-11-20,54,54,54,0,1078,1079,1078,1,0,0,0,0,104,104,104,104
San Bernardino,49,2022-11-20,2248,2248,2248,0,26911,26943,26942,1,81,1,1,22,8115,8115,8114,8114
San Diego,49,2022-11-20,3069,3073,3073,0,46408,46464,46463,1,176,5,5,24,5622,5622,5617,5617
San Francisco,49,2022-11-20,887,887,887,0,15404,15424,15423,1,53,6,6,8,1091,1091,1085,1085
San Joaquin,49,2022-11-20,789,789,789,0,11075,11089,11088,1,34,1,1,5,2358,2358,2357,2357
San Luis Obispo,49,2022-11-20,158,158,158,0,2317,2321,2320,1,9,0,0,1,532,532,532,532
San Mateo,49,2022-11-20,740,740,740,0,12372,12387,12386,1,27,0,0,1,743,743,743,743
Santa Barbara,49,2022-11-20,319,319,319,0,6224,6232,6231,1,18,3,3,6,740,740,737,737
Santa Clara,49,2022-11-20,2182,2182,2182,0,35108,35151,35150,1,111,9,9,23,2590,2590,2581,2581
Santa Cruz,49,2022-11-20,280,280,280,0,10615,10629,10628,1,13,0,0,3,276,276,276,276
Shasta,49,2022-11-20,102,102,102,0,1077,1078,1077,1,11,2,2,2,623,623,621,621
Siskiyou,49,2022-11-20,29,29,29,0,397,398,397,1,1,0,0,1,96,96,96,96
Solano,49,2022-11-20,476,476,476,0,5784,5791,5790,1,30,1,1,5,466,466,465,465
Sonoma,49,2022-11-20,322,322,322,0,6095,6103,6102,1,18,0,0,4,527,527,527,527
Stanislaus,49,2022-11-20,417,417,417,0,5942,5950,5949,1,53,1,1,9,1800,1800,1799,1799
Sutter,49,2022-11-20,87,87,87,0,1156,1157,1156,1,0,0,0,0,235,235,235,235
Tehama,49,2022-11-20,80,80,80,0,694,695,694,1,1,0,0,2,218,218,218,218
Trinity,49,2022-11-20,6,6,6,0,49,50,49,1,0,0,0,0,24,24,24,24
Tulare,49,2022-11-20,430,430,430,0,5377,5383,5382,1,22,0,0,0,1554,1554,1554,1554
Tuolumne,49,2022-11-20,97,97,97,0,789,790,789,1,1,1,1,0,203,203,202,202
Ventura,49,2022-11-20,714,714,714,0,11106,11120,11119,1,34,1,1,1,1611,1611,1610,1610
Yolo,49,2022-11-20,132,132,132,0,2277,2280,2279,1,7,4,4,2,424,424,420,420
Yuba,49,2022-11-20,79,79,79,0,1059,1060,1059,1,7,0,0,1,133,133,133,133
Alameda,50,2022-11-27,2035,2035,2035,0,21035,21062,21061,1,93,4,4,15,2038,2038,2034,2034
Amador,50,2022-11-27,32,32,32,0,760,761,760,1,5,1,1,1,95,95,94,94
Butte,50,2022-11-27,190,190,190,0,1365,1366,1365,1,40,0,0,1,468,468,468,468
Calaveras,50,2022-11-27,34,34,34,0,385,386,385,1,3,0,0,0,135,135,135,135
Colusa,50,2022-11-27,13,13,13,0,119,120,119,1,0,0,0,0,22,22,22,22
Contra Costa,50,2022-11-27,1326,1326,1326,0,14756,14774,14773,1,62,3,3,7,1494,1494,1491,1491
Del Norte,50,2022-11-27,27,27,27,0,435,436,435,1,1,1,1,0,56,56,55,55
El Dorado,50,2022-11-27,196,196,196,0,1428,1429,1428,1,9,1,1,1,237,237,236,236
Fresno,50,2022-11-27,1196,1196,1196,0,10969,10985,10984,1,124,5,5,21,2913,2913,2908,2908
Glenn,50,2022-11-27,21,21,21,0,207,208,207,1,2,0,0,0,56,56,56,56
Humboldt,50,2022-11-27,117,117,117,0,1038,1039,1038,1,8,0,0,0,163,163,163,163
Imperial,50,2022-11-27,355,355,355,0,2457,2461,2460,1,6,1,1,3,965,965,964,964
Inyo,50,2022-11-27,34,34,34,0,366,367,366,1,1,0,0,0,61,61,61,61
Kern,50,2022-11-27,549,549,549,0,8804,8817,8816,1,56,4,4,7,2445,2445,2441,2441
Kings,50,2022-11-27,221,221,221,0,2419,2423,2422,1,10,0,0,0,471,471,471,471
Lake,50,2022-11-27,47,47,47,0,818,819,818,1,1,0,0,0,152,152,152,152
Lassen,50,2022-11-27,21,21,21,0,484,485,484,1,0,0,0,0,65,65,65,65
Los Angeles,50,2022-11-27,16730,16750,16750,0,172318,172534,172532,2,897,83,83,110,34081,34081,33998,33998
Madera,50,2022-11-27,133,133,133,0,1488,1489,1488,1,11,0,0,2,376,376,376,376
Marin,50,2022-11-27,269,269,269,0,2804,2809,2808,1,14,0,0,1,260,260,260,260
Mariposa,50,2022-11-27,23,23,23,0,132,133,132,1,0,0,0,0,30,30,30,30
Mendocino,50,2022-11-27,40,40,40,0,691,692,691,1,4,0,0,2,137,137,137,137
Merced,50,2022-11-27,321,321,321,0,2358,2361,2360,1,11,5,5,1,885,885,880,880
Modoc,50,2022-11-27,7,7,7,0,14,15,14,1,1,0,0,0,11,11,11,11
Mono,50,2022-11-27,6,6,6,0,99,100,99,1,0,0,0,0,8,8,8,8
Monterey,50,2022-11-27,265,265,265,0,3775,3782,3781,1,26,0,0,0,782,782,782,782
Napa,50,2022-11-27,127,127,127,0,1774,1776,1775,1,3,0,0,2,163,163,163,163
Nevada,50,2022-11-27,119,119,119,0,927,928,927,1,8,0,0,0,137,137,137,137
Orange,50,2022-11-27,2820,2826,2826,0,24985,25016,25015,1,214,15,15,34,7668,7668,7653,7653
Placer,50,2022-11-27,358,358,358,0,3508,3514,3513,1,65,3,3,5,668,668,665,665
Plumas,50,2022-11-27,5,5,5,0,127,128,127,1,0,0,0,0,13,13,13,13
Riverside,50,2022-11-27,2801,2806,2806,0,22044,22072,22071,1,151,12,12,21,6686,6686,6674,6674
Sacramento,50,2022-11-27,1649,1649,1649,0,17235,17255,17254,1,126,8,8,10,3413,3413,3405,3405
San Benito,50,2022-11-27,107,107,107,0,1175,1176,1175,1,1,0,0,0,104,104,104,104
San Bernardino,50,2022-11-27,2990,2996,2996,0,24849,24881,24880,1,129,1,1,26,8116,8116,8115,8115
San Diego,50,2022-11-27,3557,3563,3563,0,29471,29510,29509,1,219,9,9,25,5631,5631,5622,5622
San Francisco,50,2022-11-27,1074,1074,1074,0,12091,12106,12105,1,64,6,6,9,1097,1097,1091,1091
San Joaquin,50,2022-11-27,852,852,852,0,10368,10381,10380,1,49,3,3,11,2361,2361,2358,2358
San Luis Obispo,50,2022-11-27,142,142,142,0,2147,2150,2149,1,7,4,4,0,536,536,532,532
San Mateo,50,2022-11-27,948,948,948,0,10401,10416,10415,1,46,1,1,2,744,744,743,743
Santa Barbara,50,2022-11-27,426,426,426,0,4969,4976,4975,1,23,2,2,6,742,742,740,740
Santa Clara,50,2022-11-27,2654,2657,2657,0,26570,26605,26604,1,141,9,9,23,2599,2599,2590,2590
Santa Cruz,50,2022-11-27,293,293,293,0,5036,5042,5041,1,19,0,0,2,276,276,276,276
Shasta,50,2022-11-27,98,98,98,0,972,973,972,1,14,3,3,3,626,626,623,623
Siskiyou,50,2022-11-27,24,24,24,0,249,250,249,1,1,0,0,1,96,96,96,96
Solano,50,2022-11-27,561,561,561,0,4995,5002,5001,1,31,1,1,6,467,467,466,466
Sonoma,50,2022-11-27,423,423,423,0,4888,4895,4894,1,48,1,1,3,528,528,527,527
Stanislaus,50,2022-11-27,504,504,504,0,5324,5332,5331,1,73,3,3,8,1803,1803,1800,1800
Sutter,50,2022-11-27,81,81,81,0,1068,1069,1068,1,0,0,0,0,235,235,235,235
Tehama,50,2022-11-27,61,61,61,0,550,551,550,1,5,0,0,3,218,218,218,218
Trinity,50,2022-11-27,2,2,2,0,47,48,47,1,0,0,0,0,24,24,24,24
Tulare,50,2022-11-27,438,438,438,0,4640,4645,4644,1,34,0,0,0,1554,1554,1554,1554
Tuolumne,50,2022-11-27,81,81,81,0,621,622,621,1,3,0,0,0,203,203,203,203
Ventura,50,2022-11-27,865,865,865,0,9938,9952,9951,1,43,2,2,2,1613,1613,1611,1611
Yolo,50,2022-11-27,157,157,157,0,1941,1943,1942,1,3,4,4,2,428,428,424,424
Yuba,50,2022-11-27,77,77,77,0,869,870,869,1,9,0,0,0,133,133,133,133
Alameda,51,2022-12-04,2880,2885,2885,0,29764,29803,29802,1,111,7,7,18,2045,2045,2038,2038
Amador,51,2022-12-04,43,43,43,0,825,826,825,1,3,0,0,1,95,95,95,95
Butte,51,2022-12-04,223,223,223,0,1822,1824,1823,1,36,6,6,2,474,474,468,468
Calaveras,51,2022-12-04,40,40,40,0,483,484,483,1,0,0,0,1,135,135,135,135
Colusa,51,2022-12-04,15,15,15,0,261,262,261,1,4,0,0,0,22,22,22,22
Contra Costa,51,2022-12-04,1789,1789,1789,0,19143,19169,19168,1,87,1,1,11,1495,1495,1494,1494
Del Norte,51,2022-12-04,46,46,46,0,571,572,571,1,2,0,0,1,56,56,56,56
El Dorado,51,2022-12-04,204,204,204,0,1793,1795,1794,1,10,1,1,0,238,238,237,237
Fresno,51,2022-12-04,1593,1593,1593,0,14543,14564,14563,1,175,7,7,17,2920,2920,2913,2913
Glenn,51,2022-12-04,20,20,20,0,219,220,219,1,2,0,0,0,56,56,56,56
Humboldt,51,2022-12-04,136,136,136,0,1119,1120,1119,1,13,0,0,2,163,163,163,163
Imperial,51,2022-12-04,594,594,594,0,3677,3683,3682,1,23,1,1,2,966,966,965,965
Inyo,51,2022-12-04,36,36,36,0,347,348,347,1,0,1,1,0,62,62,61,61
Kern,51,2022-12-04,836,836,836,0,11366,11381,11380,1,53,2,2,8,2447,2447,2445,2445
Kings,51,2022-12-04,311,311,311,0,3069,3075,3074,1,8,0,0,0,471,471,471,471
Lake,51,2022-12-04,65,65,65,0,854,855,854,1,2,0,0,0,152,152,152,152
Lassen,51,2022-12-04,18,18,18,0,485,486,485,1,0,0,0,0,65,65,65,65
Los Angeles,51,2022-12-04,23797,23830,23830,0,251306,251632,251629,3,1104,104,104,135,34185,34185,34081,34081
Madera,51,2022-12-04,228,228,228,0,2097,2100,2099,1,11,0,0,3,376,376,376,376
Marin,51,2022-12-04,307,307,307,0,3563,3569,3568,1,13,0,0,1,260,260,260,260
Mariposa,51,2022-12-04,23,23,23,0,170,171,170,1,0,0,0,0,30,30,30,30
Mendocino,51,2022-12-04,56,56,56,0,812,813,812,1,6,1,1,4,138,138,137,137
Merced,51,2022-12-04,417,417,417,0,3276,3282,3281,1,22,3,3,3,888,888,885,885
Modoc,51,2022-12-04,12,12,12,0,11,12,11,1,1,0,0,0,11,11,11,11
Mono,51,2022-12-04,8,8,8,0,98,99,98,1,0,0,0,0,8,8,8,8
Monterey,51,2022-12-04,290,290,290,0,4523,4530,4529,1,26,2,2,1,784,784,782,782
Napa,51,2022-12-04,174,174,174,0,2279,2282,2281,1,4,0,0,0,163,163,163,163
Nevada,51,2022-12-04,123,123,123,0,1171,1172,1171,1,0,0,0,2,137,137,137,137
Orange,51,2022-12-04,4545,4551,4551,0,35313,35359,35358,1,295,22,22,48,7690,7690,7668,7668
Placer,51,2022-12-04,421,421,421,0,4186,4193,4192,1,70,1,1,4,669,669,668,668
Plumas,51,2022-12-04,21,21,21,0,158,159,158,1,0,0,0,0,13,13,13,13
Riverside,51,2022-12-04,4210,4217,4217,0,28783,28820,28819,1,174,13,13,22,6699,6699,6686,6686
Sacramento,51,2022-12-04,2260,2263,2263,0,21562,21590,21589,1,123,9,9,26,3422,3422,3413,3413
San Benito,51,2022-12-04,239,239,239,0,1543,1544,1543,1,6,1,1,2,105,105,104,104
San Bernardino,51,2022-12-04,4245,4251,4251,0,29516,29555,29554,1,145,1,1,33,8117,8117,8116,8116
San Diego,51,2022-12-04,5943,5951,5951,0,45383,45442,45441,1,279,13,13,28,5644,5644,5631,5631
San Francisco,51,2022-12-04,1498,1498,1498,0,16201,16221,16220,1,73,6,6,9,1103,1103,1097,1097
San Joaquin,51,2022-12-04,1203,1203,1203,0,12615,12631,12630,1,68,9,9,12,2370,2370,2361,2361
San Luis Obispo,51,2022-12-04,246,246,246,0,2725,2730,2729,1,16,3,3,1,539,539,536,536
San Mateo,51,2022-12-04,1372,1372,1372,0,13840,13860,13859,1,54,1,1,2,745,745,744,744
Santa Barbara,51,2022-12-04,535,535,535,0,6892,6903,6902,1,29,1,1,11,743,743,742,742
Santa Clara,51,2022-12-04,3575,3580,3580,0,36132,36181,36180,1,189,10,10,25,2609,2609,2599,2599
Santa Cruz,51,2022-12-04,555,555,555,0,12135,12153,12152,1,24,0,0,2,276,276,276,276
Shasta,51,2022-12-04,134,134,134,0,1121,1122,1121,1,27,1,1,5,627,627,626,626
Siskiyou,51,2022-12-04,22,22,22,0,341,342,341,1,2,0,0,1,96,96,96,96
Solano,51,2022-12-04,641,641,641,0,6475,6484,6483,1,30,0,0,5,467,467,467,467
Sonoma,51,2022-12-04,519,519,519,0,5965,5973,5972,1,36,6,6,1,534,534,528,528
Stanislaus,51,2022-12-04,637,637,637,0,6568,6577,6576,1,77,0,0,11,1803,1803,1803,1803
Sutter,51,2022-12-04,97,97,97,0,1229,1230,1229,1,0,1,1,0,236,236,235,235
Tehama,51,2022-12-04,101,101,101,0,838,839,838,1,7,2,2,0,220,220,218,218
Trinity,51,2022-12-04,4,4,4,0,56,57,56,1,0,0,0,0,24,24,24,24
Tulare,51,2022-12-04,565,565,565,0,5956,5964,5963,1,38,0,0,1,1554,1554,1554,1554
Tuolumne,51,2022-12-04,92,92,92,0,862,863,862,1,4,0,0,0,203,203,203,203
Ventura,51,2022-12-04,1183,1183,1183,0,12506,12523,12522,1,69,2,2,4,1615,1615,1613,1613
Yolo,51,2022-12-04,205,205,205,0,2613,2618,2617,1,3,2,2,3,430,430,428,428
Yuba,51,2022-12-04,92,92,92,0,1057,1058,1057,1,13,0,0,0,133,133,133,133
Alameda,52,2022-12-11,2823,2828,2828,0,29691,29730,29729,1,138,7,7,17,2052,2052,2045,2045
Amador,52,2022-12-11,34,34,34,0,793,794,793,1,1,0,0,0,95,95,95,95
Butte,52,2022-12-11,217,217,217,0,1955,1958,1957,1,43,3,3,3,477,477,474,474
Calaveras,52,2022-12-11,42,42,42,0,463,464,463,1,1,0,0,1,135,135,135,135
Colusa,52,2022-12-11,13,13,13,0,231,232,231,1,0,0,0,0,22,22,22,22
Contra Costa,52,2022-12-11,1744,1744,1744,0,18567,18593,18592,1,83,9,9,5,1504,1504,1495,1495
Del Norte,52,2022-12-11,32,32,32,0,538,539,538,1,2,0,0,0,56,56,56,56
El Dorado,52,2022-12-11,145,145,145,0,1351,1352,1351,1,9,1,1,3,239,239,238,238
Fresno,52,2022-12-11,1542,1542,1542,0,14134,14154,14153,1,178,10,10,15,2930,2930,2920,2920
Glenn,52,2022-12-11,20,20,20,0,251,252,251,1,6,0,0,0,56,56,56,56
Humboldt,52,2022-12-11,127,127,127,0,1061,1062,1061,1,12,2,2,2,165,165,163,163
Imperial,52,2022-12-11,463,463,463,0,2995,3001,3000,1,24,4,4,4,970,970,966,966
Inyo,52,2022-12-11,23,23,23,0,296,297,296,1,1,0,0,0,62,62,62,62
Kern,52,2022-12-11,882,882,882,0,10956,10970,10969,1,57,2,2,5,2449,2449,2447,2447
Kings,52,2022-12-11,280,280,280,0,2904,2910,2909,1,7,2,2,1,473,473,471,471
Lake,52,2022-12-11,63,63,63,0,803,804,803,1,2,0,0,1,152,152,152,152
Lassen,52,2022-12-11,15,15,15,0,401,402,401,1,0,0,0,0,65,65,65,65
Los Angeles,52,2022-12-11,18248,18272,18272,0,228526,228832,228829,3,1087,157,157,139,34342,34342,34185,34185
Madera,52,2022-12-11,198,198,198,0,2034,2037,2036,1,15,0,0,2,376,376,376,376
Marin,52,2022-12-11,320,320,320,0,3651,3657,3656,1,18,0,0,1,260,260,260,260
Mariposa,52,2022-12-11,20,20,20,0,121,122,121,1,0,0,0,0,30,30,30,30
Mendocino,52,2022-12-11,50,50,50,0,690,691,690,1,6,1,1,1,139,139,138,138
Merced,52,2022-12-11,307,307,307,0,3343,3349,3348,1,13,0,0,1,888,888,888,888
Modoc,52,2022-12-11,7,7,7,0,9,10,9,1,0,0,0,0,11,11,11,11
Mono,52,2022-12-11,9,9,9,0,112,113,112,1,0,0,0,0,8,8,8,8
Monterey,52,2022-12-11,242,242,242,0,4260,4267,4266,1,22,3,3,2,787,787,784,784
Napa,52,2022-12-11,147,147,147,0,2335,2339,2338,1,8,0,0,0,163,163,163,163
Nevada,52,2022-12-11,99,99,99,0,984,985,984,1,5,0,0,2,137,137,137,137
Orange,52,2022-12-11,3545,3550,3550,0,31589,31633,31632,1,278,32,32,46,7722,7722,7690,7690
Placer,52,2022-12-11,349,349,349,0,3893,3900,3899,1,65,4,4,9,673,673,669,669
Plumas,52,2022-12-11,8,8,8,0,210,211,210,1,1,0,0,0,13,13,13,13
Riverside,52,2022-12-11,3478,3483,3483,0,24988,25022,25021,1,196,19,19,22,6718,6718,6699,6699
Sacramento,52,2022-12-11,1842,1842,1842,0,20312,20339,20338,1,163,6,6,28,3428,3428,3422,3422
San Benito,52,2022-12-11,129,129,129,0,1339,1340,1339,1,3,2,2,1,107,107,105,105
San Bernardino,52,2022-12-11,3766,3771,3771,0,27688,27726,27725,1,218,4,4,35,8121,8121,8117,8117
San Diego,52,2022-12-11,5033,5039,5039,0,41641,41696,41695,1,300,15,15,43,5659,5659,5644,5644
San Francisco,52,2022-12-11,1451,1451,1451,0,16494,16518,16517,1,105,8,8,11,1111,1111,1103,1103
San Joaquin,52,2022-12-11,996,996,996,0,12553,12569,12568,1,68,6,6,16,2376,2376,2370,2370
San Luis Obispo,52,2022-12-11,215,215,215,0,2670,2676,2675,1,9,1,1,0,540,540,539,539
San Mateo,52,2022-12-11,1176,1176,1176,0,13197,13216,13215,1,61,1,1,4,746,746,745,745
Santa Barbara,52,2022-12-11,500,500,500,0,5975,5984,5983,1,32,2,2,7,745,745,743,743
Santa Clara,52,2022-12-11,3285,3290,3290,0,35400,35448,35447,1,177,20,20,34,2629,2629,2609,2609
Santa Cruz,52,2022-12-11,524,524,524,0,13598,13617,13616,1,27,0,0,1,276,276,276,276
Shasta,52,2022-12-11,109,109,109,0,1180,1181,1180,1,24,0,0,5,627,627,627,627
Siskiyou,52,2022-12-11,16,16,16,0,228,229,228,1,2,0,0,1,96,96,96,96
Solano,52,2022-12-11,652,652,652,0,6431,6440,6439,1,41,1,1,8,468,468,467,467
Sonoma,52,2022-12-11,528,528,528,0,5629,5636,5635,1,34,2,2,5,536,536,534,534
Stanislaus,52,2022-12-11,605,605,605,0,6382,6392,6391,1,104,7,7,11,1810,1810,1803,1803
Sutter,52,2022-12-11,116,116,116,0,1191,1192,1191,1,0,0,0,0,236,236,236,236
Tehama,52,2022-12-11,79,79,79,0,815,816,815,1,6,1,1,0,221,221,220,220
Trinity,52,2022-12-11,2,2,2,0,40,41,40,1,0,0,0,0,24,24,24,24
Tulare,52,2022-12-11,453,453,453,0,5932,5941,5940,1,20,2,2,2,1556,1556,1554,1554
Tuolumne,52,2022-12-11,140,140,140,0,941,942,941,1,5,0,0,1,203,203,203,203
Ventura,52,2022-12-11,923,923,923,0,10964,10979,10978,1,66,4,4,8,1619,1619,1615,1615
Yolo,52,2022-12-11,232,232,232,0,2444,2448,2447,1,8,3,3,1,433,433,430,430
Yuba,52,2022-12-11,67,67,67,0,981,982,981,1,12,0,0,0,133,133,133,133
Alameda,53,2022-12-18,2371,2374,2374,0,27922,27961,27960,1,152,10,10,18,2062,2062,2052,2052
Amador,53,2022-12-18,38,38,38,0,811,812,811,1,5,0,0,0,95,95,95,95
Butte,53,2022-12-18,137,137,137,0,1706,1708,1707,1,35,2,2,3,479,479,477,477
Calaveras,53,2022-12-18,34,34,34,0,458,459,458,1,1,1,1,1,136,136,135,135
Colusa,53,2022-12-18,12,12,12,0,213,214,213,1,1,0,0,0,22,22,22,22
Contra Costa,53,2022-12-18,1749,1749,1749,0,18047,18072,18071,1,83,8,8,9,1512,1512,1504,1504
Del Norte,53,2022-12-18,38,38,38,0,560,561,560,1,4,0,0,0,56,56,56,56
El Dorado,53,2022-12-18,157,157,157,0,1651,1653,1652,1,7,2,2,3,241,241,239,239
Fresno,53,2022-12-18,1217,1217,1217,0,12832,12850,12849,1,192,7,7,17,2937,2937,2930,2930
Glenn,53,2022-12-18,21,21,21,0,205,206,205,1,2,0,0,0,56,56,56,56
Humboldt,53,2022-12-18,116,116,116,0,947,948,947,1,10,0,0,1,165,165,165,165
Imperial,53,2022-12-18,285,285,285,0,2556,2561,2560,1,14,1,1,2,971,971,970,970
Inyo,53,2022-12-18,10,10,10,0,338,339,338,1,1,0,0,0,62,62,62,62
Kern,53,2022-12-18,986,986,986,0,10479,10494,10493,1,56,3,3,6,2452,2452,2449,2449
Kings,53,2022-12-18,213,213,213,0,2768,2773,2772,1,8,3,3,1,476,476,473,473
Lake,53,2022-12-18,61,61,61,0,774,775,774,1,5,0,0,0,152,152,152,152
Lassen,53,2022-12-18,9,9,9,0,453,454,453,1,0,0,0,0,65,65,65,65
Los Angeles,53,2022-12-18,15795,15817,15817,0,215129,215425,215423,2,1098,143,143,132,34485,34485,34342,34342
Madera,53,2022-12-18,196,196,196,0,1979,1982,1981,1,10,0,0,1,376,376,376,376
Marin,53,2022-12-18,286,286,286,0,3394,3400,3399,1,16,0,0,1,260,260,260,260
Mariposa,53,2022-12-18,24,24,24,0,142,143,142,1,0,0,0,0,30,30,30,30
Mendocino,53,2022-12-18,61,61,61,0,701,702,701,1,5,0,0,0,139,139,139,139
Merced,53,2022-12-18,284,284,284,0,2946,2952,2951,1,14,2,2,1,890,890,888,888
Modoc,53,2022-12-18,8,8,8,0,21,22,21,1,0,0,0,0,11,11,11,11
Mono,53,2022-12-18,7,7,7,0,118,119,118,1,1,0,0,0,8,8,8,8
Monterey,53,2022-12-18,247,247,247,0,4072,4079,4078,1,18,0,0,1,787,787,787,787
Napa,53,2022-12-18,168,168,168,0,2006,2008,2007,1,6,1,1,0,164,164,163,163
Nevada,53,2022-12-18,70,70,70,0,933,934,933,1,5,0,0,2,137,137,137,137
Orange,53,2022-12-18,3376,3381,3381,0,31235,31278,31277,1,314,33,33,44,7755,7755,7722,7722
Placer,53,2022-12-18,354,354,354,0,3916,3923,3922,1,80,3,3,11,676,676,673,673
Plumas,53,2022-12-18,7,7,7,0,199,200,199,1,0,0,0,0,13,13,13,13
Riverside,53,2022-12-18,3149,3155,3155,0,23320,23351,23350,1,156,20,20,22,6738,6738,6718,6718
Sacramento,53,2022-12-18,1760,1760,1760,0,19302,19328,19327,1,179,13,13,26,3441,3441,3428,3428
San Benito,53,2022-12-18,101,101,101,0,1164,1165,1164,1,2,3,3,1,110,110,107,107
San Bernardino,53,2022-12-18,3275,3280,3280,0,26158,26194,26193,1,212,4,4,34,8125,8125,8121,8121
San Diego,53,2022-12-18,4841,4848,4848,0,40277,40333,40332,1,342,16,16,40,5675,5675,5659,5659
San Francisco,53,2022-12-18,1238,1238,1238,0,16458,16482,16481,1,110,9,9,13,1120,1120,1111,1111
San Joaquin,53,2022-12-18,879,879,879,0,13305,13322,13321,1,62,9,9,15,2385,2385,2376,2376
San Luis Obispo,53,2022-12-18,252,252,252,0,2463,2469,2468,1,15,1,1,0,541,541,540,540
San Mateo,53,2022-12-18,975,975,975,0,11889,11906,11905,1,64,1,1,9,747,747,746,746
Santa Barbara,53,2022-12-18,481,481,481,0,5390,5398,5397,1,32,3,3,5,748,748,745,745
Santa Clara,53,2022-12-18,2937,2942,2942,0,33794,33841,33840,1,186,16,16,36,2645,2645,2629,2629
Santa Cruz,53,2022-12-18,343,343,343,0,12362,12380,12379,1,30,0,0,1,276,276,276,276
Shasta,53,2022-12-18,115,115,115,0,1124,1125,1124,1,26,2,2,4,629,629,627,627
Siskiyou,53,2022-12-18,14,14,14,0,270,271,270,1,2,0,0,0,96,96,96,96
Solano,53,2022-12-18,626,626,626,0,6157,6167,6166,1,40,0,0,8,468,468,468,468
Sonoma,53,2022-12-18,530,530,530,0,5487,5494,5493,1,46,1,1,1,537,537,536,536
Stanislaus,53,2022-12-18,494,494,494,0,6210,6220,6219,1,99,2,2,13,1812,1812,1810,1810
Sutter,53,2022-12-18,86,86,86,0,1085,1086,1085,1,0,0,0,0,236,236,236,236
Tehama,53,2022-12-18,71,71,71,0,677,678,677,1,6,0,0,0,221,221,221,221
Trinity,53,2022-12-18,3,3,3,0,35,36,35,1,0,0,0,0,24,24,24,24
Tulare,53,2022-12-18,457,457,457,0,5286,5293,5292,1,53,5,5,1,1561,1561,1556,1556
Tuolumne,53,2022-12-18,91,91,91,0,861,862,861,1,3,1,1,0,204,204,203,203
Ventura,53,2022-12-18,919,919,919,0,10563,10578,10577,1,76,4,4,6,1623,1623,1619,1619
Yolo,53,2022-12-18,169,169,169,0,1947,1950,1949,1,7,3,3,0,436,436,433,433
Yuba,53,2022-12-18,76,76,76,0,915,916,915,1,8,1,1,0,134,134,133,133
Alameda,54,2022-12-25,2093,2096,2096,0,23253,23286,23285,1,133,10,10,23,2072,2072,2062,2062
Amador,54,2022-12-25,44,44,44,0,795,796,795,1,5,1,1,0,96,96,95,95
Butte,54,2022-12-25,99,99,99,0,1399,1400,1399,1,37,1,1,1,480,480,479,479
Calaveras,54,2022-12-25,25,25,25,0,382,383,382,1,1,1,1,0,137,137,136,136
Colusa,54,2022-12-25,14,14,14,0,204,205,204,1,0,0,0,0,22,22,22,22
Contra Costa,54,2022-12-25,1524,1524,1524,0,15164,15185,15184,1,74,9,9,11,1521,1521,1512,1512
Del Norte,54,2022-12-25,37,37,37,0,453,454,453,1,3,0,0,0,56,56,56,56
El Dorado,54,2022-12-25,162,162,162,0,1384,1385,1384,1,6,1,1,0,242,242,241,241
Fresno,54,2022-12-25,1158,1158,1158,0,11687,11703,11702,1,186,11,11,33,2948,2948,2937,2937
Glenn,54,2022-12-25,14,14,14,0,197,198,197,1,0,0,0,0,56,56,56,56
Humboldt,54,2022-12-25,89,89,89,0,729,730,729,1,5,2,2,2,167,167,165,165
Imperial,54,2022-12-25,251,251,251,0,2455,2459,2458,1,5,2,2,0,973,973,971,971
Inyo,54,2022-12-25,14,14,14,0,204,205,204,1,0,0,0,0,62,62,62,62
Kern,54,2022-12-25,777,777,777,0,9893,9909,9908,1,55,9,9,11,2461,2461,2452,2452
Kings,54,2022-12-25,208,208,208,0,2525,2530,2529,1,5,1,1,0,477,477,476,476
Lake,54,2022-12-25,71,71,71,0,700,701,700,1,3,1,1,1,153,153,152,152
Lassen,54,2022-12-25,27,27,27,0,523,524,523,1,0,0,0,0,65,65,65,65
Los Angeles,54,2022-12-25,14038,14058,14058,0,154254,154479,154477,2,1016,159,159,142,34644,34644,34485,34485
Madera,54,2022-12-25,181,181,181,0,1715,1717,1716,1,7,0,0,1,376,376,376,376
Marin,54,2022-12-25,225,225,225,0,2770,2776,2775,1,33,0,0,3,260,260,260,260
Mariposa,54,2022-12-25,24,24,24,0,117,118,117,1,0,0,0,0,30,30,30,30
Mendocino,54,2022-12-25,77,77,77,0,717,718,717,1,8,0,0,1,139,139,139,139
Merced,54,2022-12-25,215,215,215,0,2219,2224,2223,1,17,4,4,2,894,894,890,890
Modoc,54,2022-12-25,3,3,3,0,13,14,13,1,0,0,0,0,11,11,11,11
Mono,54,2022-12-25,10,10,10,0,95,96,95,1,0,0,0,0,8,8,8,8
Monterey,54,2022-12-25,204,204,204,0,3255,3261,3260,1,18,5,5,1,792,792,787,787
Napa,54,2022-12-25,176,176,176,0,1988,1992,1991,1,9,1,1,0,165,165,164,164
Nevada,54,2022-12-25,75,75,75,0,785,786,785,1,7,0,0,0,137,137,137,137
Orange,54,2022-12-25,3329,3334,3334,0,27215,27255,27254,1,276,41,41,34,7796,7796,7755,7755
Placer,54,2022-12-25,323,323,323,0,3369,3375,3374,1,87,2,2,10,678,678,676,676
Plumas,54,2022-12-25,12,12,12,0,135,136,135,1,0,0,0,0,13,13,13,13
Riverside,54,2022-12-25,2999,3004,3004,0,20383,20411,20410,1,179,15,15,17,6753,6753,6738,6738
Sacramento,54,2022-12-25,1524,1524,1524,0,16861,16886,16885,1,168,16,16,28,3457,3457,3441,3441
San Benito,54,2022-12-25,109,109,109,0,1002,1003,1002,1,1,1,1,1,111,111,110,110
San Bernardino,54,2022-12-25,3068,3073,3073,0,23441,23474,23473,1,201,6,6,32,8131,8131,8125,8125
San Diego,54,2022-12-25,4854,4860,4860,0,31863,31912,31911,1,350,25,25,48,5700,5700,5675,5675
San Francisco,54,2022-12-25,1124,1124,1124,0,13193,13211,13210,1,84,20,20,18,1140,1140,1120,1120
San Joaquin,54,2022-12-25,802,802,802,0,11458,11476,11475,1,63,8,8,11,2393,2393,2385,2385
San Luis Obispo,54,2022-12-25,235,235,235,0,2269,2274,2273,1,17,3,3,0,544,544,541,541
San Mateo,54,2022-12-25,915,915,915,0,10203,10218,10217,1,51,0,0,7,747,747,747,747
Santa Barbara,54,2022-12-25,524,524,524,0,4398,4405,4404,1,39,1,1,8,749,749,748,748
Santa Clara,54,2022-12-25,2529,2534,2534,0,27834,27875,27874,1,149,12,12,28,2657,2657,2645,2645
Santa Cruz,54,2022-12-25,195,195,195,0,6692,6702,6701,1,26,0,0,1,276,276,276,276
Shasta,54,2022-12-25,98,98,98,0,1061,1062,1061,1,22,1,1,1,630,630,629,629
Siskiyou,54,2022-12-25,21,21,21,0,272,273,272,1,1,0,0,0,96,96,96,96
Solano,54,2022-12-25,698,698,698,0,5737,5746,5745,1,59,1,1,6,469,469,468,468
Sonoma,54,2022-12-25,470,470,470,0,4576,4583,4582,1,33,1,1,4,538,538,537,537
Stanislaus,54,2022-12-25,476,476,476,0,5340,5348,5347,1,96,10,10,5,1822,1822,1812,1812
Sutter,54,2022-12-25,125,125,125,0,952,953,952,1,0,2,2,0,238,238,236,236
Tehama,54,2022-12-25,51,51,51,0,688,689,688,1,2,4,4,1,225,225,221,221
Trinity,54,2022-12-25,3,3,3,0,39,40,39,1,0,0,0,0,24,24,24,24
Tulare,54,2022-12-25,468,468,468,0,4711,4718,4717,1,40,6,6,1,1567,1567,1561,1561
Tuolumne,54,2022-12-25,84,84,84,0,797,798,797,1,5,1,1,2,205,205,204,204
Ventura,54,2022-12-25,929,929,929,0,8524,8539,8538,1,67,13,13,9,1636,1636,1623,1623
Yolo,54,2022-12-25,149,149,149,0,1801,1804,1803,1,6,3,3,1,439,439,436,436
Yuba,54,2022-12-25,105,105,105,0,788,789,788,1,15,0,0,0,134,134,134,134
Alameda,55,2023-01-01,1934,1937,1937,0,20389,20421,20420,1,158,14,14,21,2086,2086,2072,2072
Amador,55,2023-01-01,38,38,38,0,690,691,690,1,3,1,1,0,97,97,96,96
Butte,55,2023-01-01,101,101,101,0,1310,1312,1311,1,31,3,3,2,483,483,480,480
Calaveras,55,2023-01-01,35,35,35,0,390,391,390,1,0,2,2,0,139,139,137,137
Colusa,55,2023-01-01,5,5,5,0,98,99,98,1,0,0,0,0,22,22,22,22
Contra Costa,55,2023-01-01,1451,1451,1451,0,14273,14296,14295,1,89,6,6,12,1527,1527,1521,1521
Del Norte,55,2023-01-01,35,35,35,0,430,431,430,1,4,0,0,1,56,56,56,56
El Dorado,55,2023-01-01,138,138,138,0,1442,1443,1442,1,5,2,2,2,244,244,242,242
Fresno,55,2023-01-01,1073,1073,1073,0,11397,11414,11413,1,195,14,14,30,2962,2962,2948,2948
Glenn,55,2023-01-01,9,9,9,0,191,192,191,1,0,0,0,0,56,56,56,56
Humboldt,55,2023-01-01,49,49,49,0,632,633,632,1,7,0,0,2,167,167,167,167
Imperial,55,2023-01-01,222,222,222,0,2053,2056,2055,1,11,0,0,1,973,973,973,973
Inyo,55,2023-01-01,16,16,16,0,222,223,222,1,1,0,0,1,62,62,62,62
Kern,55,2023-01-01,917,917,917,0,9893,9909,9908,1,62,3,3,9,2464,2464,2461,2461
Kings,55,2023-01-01,202,202,202,0,2163,2167,2166,1,4,1,1,1,478,478,477,477
Lake,55,2023-01-01,41,41,41,0,582,583,582,1,4,1,1,0,154,154,153,153
Lassen,55,2023-01-01,14,14,14,0,500,501,500,1,0,0,0,0,65,65,65,65
Los Angeles,55,2023-01-01,13933,13953,13953,0,139850,140063,140061,2,1061,150,150,146,34794,34794,34644,34644
Madera,55,2023-01-01,158,158,158,0,1683,1686,1685,1,4,0,0,0,376,376,376,376
Marin,55,2023-01-01,229,229,229,0,2407,2413,2412,1,22,2,2,3,262,262,260,260
Mariposa,55,2023-01-01,13,13,13,0,96,97,96,1,0,0,0,0,30,30,30,30
Mendocino,55,2023-01-01,65,65,65,0,703,704,703,1,6,1,1,3,140,140,139,139
Merced,55,2023-01-01,202,202,202,0,2134,2139,2138,1,9,3,3,5,897,897,894,894
Modoc,55,2023-01-01,10,10,10,0,19,20,19,1,0,0,0,0,11,11,11,11
Mono,55,2023-01-01,14,14,14,0,67,68,67,1,0,0,0,0,8,8,8,8
Monterey,55,2023-01-01,219,219,219,0,3042,3048,3047,1,26,1,1,1,793,793,792,792
Napa,55,2023-01-01,131,131,131,0,1684,1687,1686,1,6,1,1,1,166,166,165,165
Nevada,55,2023-01-01,58,58,58,0,742,743,742,1,9,0,0,2,137,137,137,137
Orange,55,2023-01-01,3449,3454,3454,0,25779,25819,25818,1,318,39,39,24,7835,7835,7796,7796
Placer,55,2023-01-01,310,310,310,0,3244,3250,3249,1,105,1,1,9,679,679,678,678
Plumas,55,2023-01-01,10,10,10,0,147,148,147,1,0,0,0,0,13,13,13,13
Riverside,55,2023-01-01,3230,3235,3235,0,20525,20557,20556,1,226,10,10,25,6763,6763,6753,6753
Sacramento,55,2023-01-01,1539,1540,1540,0,15541,15565,15564,1,187,17,17,21,3474,3474,3457,3457
San Benito,55,2023-01-01,64,64,64,0,813,814,813,1,1,0,0,1,111,111,111,111
San Bernardino,55,2023-01-01,3042,3047,3047,0,22474,22508,22507,1,192,3,3,30,8134,8134,8131,8131
San Diego,55,2023-01-01,4768,4775,4775,0,29362,29407,29406,1,382,29,29,40,5729,5729,5700,5700
San Francisco,55,2023-01-01,937,937,937,0,10426,10441,10440,1,87,13,13,8,1153,1153,1140,1140
San Joaquin,55,2023-01-01,789,789,789,0,10921,10939,10938,1,64,9,9,11,2402,2402,2393,2393
San Luis Obispo,55,2023-01-01,216,216,216,0,2027,2031,2030,1,15,5,5,0,549,549,544,544
San Mateo,55,2023-01-01,775,775,775,0,8158,8172,8171,1,53,0,0,5,747,747,747,747
Santa Barbara,55,2023-01-01,421,421,421,0,3990,3998,3997,1,41,1,1,6,750,750,749,749
Santa Clara,55,2023-01-01,2605,2610,2610,0,27506,27549,27548,1,197,14,14,30,2671,2671,2657,2657
Santa Cruz,55,2023-01-01,218,218,218,0,2980,2985,2984,1,27,1,1,0,277,277,276,276
Shasta,55,2023-01-01,104,104,104,0,981,982,981,1,22,2,2,2,632,632,630,630
Siskiyou,55,2023-01-01,14,14,14,0,274,275,274,1,1,0,0,0,96,96,96,96
Solano,55,2023-01-01,663,663,663,0,5360,5369,5368,1,63,2,2,11,471,471,469,469
Sonoma,55,2023-01-01,445,445,445,0,4309,4316,4315,1,56,1,1,2,539,539,538,538
Stanislaus,55,2023-01-01,487,487,487,0,5261,5270,5269,1,93,7,7,9,1829,1829,1822,1822
Sutter,55,2023-01-01,103,103,103,0,904,905,904,1,0,0,0,0,238,238,238,238
Tehama,55,2023-01-01,55,55,55,0,605,606,605,1,2,4,4,0,229,229,225,225
Trinity,55,2023-01-01,4,4,4,0,44,45,44,1,0,0,0,0,24,24,24,24
Tulare,55,2023-01-01,510,510,510,0,4805,4813,4812,1,57,4,4,3,1571,1571,1567,1567
Tuolumne,55,2023-01-01,85,85,85,0,702,703,702,1,5,2,2,0,207,207,205,205
Ventura,55,2023-01-01,940,940,940,0,7480,7494,7493,1,88,14,14,11,1650,1650,1636,1636
Yolo,55,2023-01-01,140,140,140,0,1559,1560,1559,1,3,4,4,1,443,443,439,439
Yuba,55,2023-01-01,87,87,87,0,744,745,744,1,17,1,1,1,135,135,134,134
Alameda,56,2023-01-08,1489,1490,1490,0,21689,21723,21722,1,155,10,10,10,2096,2096,2086,2086
Amador,56,2023-01-08,24,24,24,0,703,704,703,1,3,0,0,0,97,97,97,97
Butte,56,2023-01-08,86,86,86,0,1169,1171,1170,1,33,4,4,5,487,487,483,483
Calaveras,56,2023-01-08,16,16,16,0,320,321,320,1,0,0,0,1,139,139,139,139
Colusa,56,2023-01-08,9,9,9,0,96,97,96,1,0,0,0,0,22,22,22,22
Contra Costa,56,2023-01-08,1106,1106,1106,0,14542,14565,14564,1,88,10,10,14,1537,1537,1527,1527
Del Norte,56,2023-01-08,16,16,16,0,342,343,342,1,4,0,0,1,56,56,56,56
El Dorado,56,2023-01-08,105,105,105,0,1383,1384,1383,1,2,2,2,1,246,246,244,244
Fresno,56,2023-01-08,830,830,830,0,11049,11065,11064,1,171,8,8,21,2970,2970,2962,2962
Glenn,56,2023-01-08,10,10,10,0,186,187,186,1,0,0,0,0,56,56,56,56
Humboldt,56,2023-01-08,62,62,62,0,683,684,683,1,5,1,1,4,168,168,167,167
Imperial,56,2023-01-08,156,156,156,0,2280,2285,2284,1,12,1,1,1,974,974,973,973
Inyo,56,2023-01-08,10,10,10,0,213,214,213,1,0,0,0,0,62,62,62,62
Kern,56,2023-01-08,606,606,606,0,9896,9913,9912,1,72,7,7,8,2471,2471,2464,2464
Kings,56,2023-01-08,184,184,184,0,2191,2195,2194,1,8,1,1,0,479,479,478,478
Lake,56,2023-01-08,47,47,47,0,620,621,620,1,2,1,1,1,155,155,154,154
Lassen,56,2023-01-08,18,18,18,0,494,495,494,1,3,0,0,0,65,65,65,65
Los Angeles,56,2023-01-08,10673,10689,10689,0,189785,190081,190079,2,973,103,103,142,34897,34897,34794,34794
Madera,56,2023-01-08,92,92,92,0,1565,1567,1566,1,2,0,0,1,376,376,376,376
Marin,56,2023-01-08,151,151,151,0,2483,2488,2487,1,17,2,2,4,264,264,262,262
Mariposa,56,2023-01-08,11,11,11,0,89,90,89,1,0,1,1,0,31,31,30,30
Mendocino,56,2023-01-08,37,37,37,0,595,596,595,1,11,3,3,3,143,143,140,140
Merced,56,2023-01-08,189,189,189,0,2280,2285,2284,1,12,1,1,3,898,898,897,897
Modoc,56,2023-01-08,9,9,9,0,25,26,25,1,0,0,0,0,11,11,11,11
Mono,56,2023-01-08,10,10,10,0,86,87,86,1,0,0,0,0,8,8,8,8
Monterey,56,2023-01-08,173,173,173,0,3096,3102,3101,1,19,3,3,4,796,796,793,793
Napa,56,2023-01-08,119,119,119,0,1701,1703,1702,1,7,2,2,3,168,168,166,166
Nevada,56,2023-01-08,38,38,38,0,720,721,720,1,7,0,0,0,137,137,137,137
Orange,56,2023-01-08,2570,2575,2575,0,27256,27299,27298,1,264,21,21,26,7856,7856,7835,7835
Placer,56,2023-01-08,249,249,249,0,3301,3308,3307,1,91,2,2,5,681,681,679,679
Plumas,56,2023-01-08,7,7,7,0,90,91,90,1,1,1,1,0,14,14,13,13
Riverside,56,2023-01-08,2140,2143,2143,0,21488,21521,21520,1,172,34,34,26,6797,6797,6763,6763
Sacramento,56,2023-01-08,1048,1048,1048,0,14949,14972,14971,1,177,14,14,25,3488,3488,3474,3474
San Benito,56,2023-01-08,50,50,50,0,686,687,686,1,3,3,3,2,114,114,111,111
San Bernardino,56,2023-01-08,1846,1848,1848,0,22549,22583,22582,1,186,20,20,35,8154,8154,8134,8134
San Diego,56,2023-01-08,3558,3564,3564,0,32869,32920,32919,1,384,45,45,34,5774,5774,5729,5729
San Francisco,56,2023-01-08,785,785,785,0,12254,12272,12271,1,79,4,4,14,1157,1157,1153,1153
San Joaquin,56,2023-01-08,586,586,586,0,10554,10572,10571,1,55,13,13,12,2415,2415,2402,2402
San Luis Obispo,56,2023-01-08,190,190,190,0,2086,2091,2090,1,11,3,3,0,552,552,549,549
San Mateo,56,2023-01-08,610,610,610,0,8934,8950,8949,1,54,2,2,4,749,749,747,747
Santa Barbara,56,2023-01-08,408,408,408,0,4558,4566,4565,1,37,3,3,1,753,753,750,750
Santa Clara,56,2023-01-08,2022,2024,2024,0,32407,32459,32458,1,188,23,23,34,2694,2694,2671,2671
Santa Cruz,56,2023-01-08,147,147,147,0,3345,3352,3351,1,27,1,1,1,278,278,277,277
Shasta,56,2023-01-08,62,62,62,0,836,837,836,1,17,2,2,2,634,634,632,632
Siskiyou,56,2023-01-08,18,18,18,0,239,240,239,1,1,0,0,0,96,96,96,96
Solano,56,2023-01-08,392,392,392,0,4905,4913,4912,1,48,6,6,6,477,477,471,471
Sonoma,56,2023-01-08,275,275,275,0,4508,4515,4514,1,39,5,5,4,544,544,539,539
Stanislaus,56,2023-01-08,321,321,321,0,5253,5262,5261,1,80,8,8,9,1837,1837,1829,1829
Sutter,56,2023-01-08,61,61,61,0,879,880,879,1,0,0,0,0,238,238,238,238
Tehama,56,2023-01-08,31,31,31,0,502,503,502,1,1,0,0,0,229,229,229,229
Trinity,56,2023-01-08,3,3,3,0,27,28,27,1,0,0,0,0,24,24,24,24
Tulare,56,2023-01-08,337,337,337,0,4527,4535,4534,1,54,5,5,2,1576,1576,1571,1571
Tuolumne,56,2023-01-08,70,70,70,0,639,640,639,1,1,0,0,0,207,207,207,207
Ventura,56,2023-01-08,674,674,674,0,8940,8954,8953,1,72,5,5,15,1655,1655,1650,1650
Yolo,56,2023-01-08,102,102,102,0,1627,1629,1628,1,3,1,1,0,444,444,443,443
Yuba,56,2023-01-08,54,54,54,0,743,744,743,1,19,1,1,1,136,136,135,135
Alameda,57,2023-01-15,970,970,970,0,22341,22377,22376,1,105,7,7,10,2103,2103,2096,2096
Amador,57,2023-01-15,24,24,24,0,620,621,620,1,2,0,0,0,97,97,97,97
Butte,57,2023-01-15,67,67,67,0,1193,1194,1193,1,25,4,4,0,491,491,487,487
Calaveras,57,2023-01-15,15,15,15,0,325,326,325,1,1,0,0,0,139,139,139,139
Colusa,57,2023-01-15,6,6,6,0,83,84,83,1,1,0,0,0,22,22,22,22
Contra Costa,57,2023-01-15,678,678,678,0,13530,13553,13552,1,54,8,8,18,1545,1545,1537,1537
Del Norte,57,2023-01-15,11,11,11,0,332,333,332,1,3,1,1,0,57,57,56,56
El Dorado,57,2023-01-15,59,59,59,0,1140,1141,1140,1,3,3,3,0,249,249,246,246
Fresno,57,2023-01-15,518,518,518,0,10114,10132,10131,1,163,6,6,12,2976,2976,2970,2970
Glenn,57,2023-01-15,3,3,3,0,167,168,167,1,0,1,1,0,57,57,56,56
Humboldt,57,2023-01-15,44,44,44,0,535,536,535,1,8,0,0,3,168,168,168,168
Imperial,57,2023-01-15,135,135,135,0,2188,2193,2192,1,12,2,2,3,976,976,974,974
Inyo,57,2023-01-15,12,12,12,0,202,203,202,1,1,0,0,0,62,62,62,62
Kern,57,2023-01-15,404,404,404,0,9177,9192,9191,1,60,6,6,11,2477,2477,2471,2471
Kings,57,2023-01-15,135,135,135,0,2102,2106,2105,1,5,2,2,0,481,481,479,479
Lake,57,2023-01-15,27,27,27,0,585,586,585,1,3,1,1,0,156,156,155,155
Lassen,57,2023-01-15,7,7,7,0,450,451,450,1,0,0,0,0,65,65,65,65
Los Angeles,57,2023-01-15,6755,6766,6766,0,170851,171127,171125,2,853,85,85,122,34982,34982,34897,34897
Madera,57,2023-01-15,80,80,80,0,1423,1424,1423,1,4,1,1,2,377,377,376,376
Marin,57,2023-01-15,121,121,121,0,2287,2293,2292,1,19,0,0,2,264,264,264,264
Mariposa,57,2023-01-15,10,10,10,0,106,107,106,1,0,0,0,0,31,31,31,31
Mendocino,57,2023-01-15,33,33,33,0,550,551,550,1,6,0,0,0,143,143,143,143
Merced,57,2023-01-15,135,135,135,0,2210,2214,2213,1,11,3,3,4,901,901,898,898
Modoc,57,2023-01-15,1,1,1,0,12,13,12,1,0,0,0,0,11,11,11,11
Mono,57,2023-01-15,8,8,8,0,69,70,69,1,1,0,0,0,8,8,8,8
Monterey,57,2023-01-15,119,119,119,0,2744,2750,2749,1,20,1,1,2,797,797,796,796
Napa,57,2023-01-15,79,79,79,0,1683,1685,1684,1,6,0,0,0,168,168,168,168
Nevada,57,2023-01-15,28,28,28,0,629,630,629,1,5,1,1,0,138,138,137,137
Orange,57,2023-01-15,1586,1587,1587,0,26103,26145,26144,1,232,28,28,30,7884,7884,7856,7856
Placer,57,2023-01-15,182,182,182,0,2872,2879,2878,1,74,3,3,7,684,684,681,681
Plumas,57,2023-01-15,1,1,1,0,71,72,71,1,0,0,0,0,14,14,14,14
Riverside,57,2023-01-15,1324,1324,1324,0,19597,19628,19627,1,149,24,24,30,6821,6821,6797,6797
Sacramento,57,2023-01-15,643,643,643,0,13722,13744,13743,1,140,27,27,24,3515,3515,3488,3488
San Benito,57,2023-01-15,30,30,30,0,622,623,622,1,0,1,1,0,115,115,114,114
San Bernardino,57,2023-01-15,1109,1109,1109,0,20458,20490,20489,1,144,28,28,36,8182,8182,8154,8154
San Diego,57,2023-01-15,2366,2370,2370,0,31977,32031,32030,1,312,27,27,35,5801,5801,5774,5774
San Francisco,57,2023-01-15,499,499,499,0,11765,11783,11782,1,81,1,1,11,1158,1158,1157,1157
San Joaquin,57,2023-01-15,394,394,394,0,10294,10311,10310,1,45,12,12,12,2427,2427,2415,2415
San Luis Obispo,57,2023-01-15,109,109,109,0,1808,1811,1810,1,15,1,1,2,553,553,552,552
San Mateo,57,2023-01-15,451,451,451,0,8947,8962,8961,1,37,10,10,2,759,759,749,749
Santa Barbara,57,2023-01-15,237,237,237,0,3961,3969,3968,1,31,3,3,2,756,756,753,753
Santa Clara,57,2023-01-15,1305,1305,1305,0,30634,30685,30684,1,126,15,15,21,2709,2709,2694,2694
Santa Cruz,57,2023-01-15,160,160,160,0,7083,7096,7095,1,24,1,1,1,279,279,278,278
Shasta,57,2023-01-15,44,44,44,0,754,755,754,1,15,3,3,2,637,637,634,634
Siskiyou,57,2023-01-15,9,9,9,0,213,214,213,1,1,0,0,0,96,96,96,96
Solano,57,2023-01-15,275,275,275,0,4244,4252,4251,1,49,2,2,7,479,479,477,477
Sonoma,57,2023-01-15,209,209,209,0,4139,4147,4146,1,32,5,5,2,549,549,544,544
Stanislaus,57,2023-01-15,216,216,216,0,4846,4854,4853,1,72,5,5,5,1842,1842,1837,1837
Sutter,57,2023-01-15,50,50,50,0,723,724,723,1,0,0,0,0,238,238,238,238
Tehama,57,2023-01-15,19,19,19,0,385,386,385,1,3,0,0,0,229,229,229,229
Trinity,57,2023-01-15,3,3,3,0,25,26,25,1,0,1,1,0,25,25,24,24
Tulare,57,2023-01-15,255,255,255,0,4388,4396,4395,1,39,8,8,4,1584,1584,1576,1576
Tuolumne,57,2023-01-15,46,46,46,0,564,565,564,1,1,4,4,0,211,211,207,207
Ventura,57,2023-01-15,456,456,456,0,8367,8382,8381,1,50,6,6,21,1661,1661,1655,1655
Yolo,57,2023-01-15,84,84,84,0,1390,1392,1391,1,3,2,2,0,446,446,444,444
Yuba,57,2023-01-15,38,38,38,0,619,620,619,1,9,1,1,2,137,137,136,136
Alameda,58,2023-01-22,790,790,790,0,20531,20565,20564,1,89,12,12,10,2115,2115,2103,2103
Amador,58,2023-01-22,35,35,35,0,572,573,572,1,1,0,0,0,97,97,97,97
Butte,58,2023-01-22,41,41,41,0,1084,1085,1084,1,12,1,1,0,492,492,491,491
Calaveras,58,2023-01-22,12,12,12,0,279,280,279,1,0,0,0,0,139,139,139,139
Colusa,58,2023-01-22,10,10,10,0,74,75,74,1,0,0,0,0,22,22,22,22
Contra Costa,58,2023-01-22,506,506,506,0,12343,12362,12361,1,53,7,7,10,1552,1552,1545,1545
Del Norte,58,2023-01-22,20,20,20,0,334,335,334,1,1,1,1,0,58,58,57,57
El Dorado,58,2023-01-22,46,46,46,0,980,981,980,1,2,0,0,0,249,249,249,249
Fresno,58,2023-01-22,415,415,415,0,9933,9951,9950,1,114,7,7,22,2983,2983,2976,2976
Glenn,58,2023-01-22,3,3,3,0,149,150,149,1,0,0,0,0,57,57,57,57
Humboldt,58,2023-01-22,34,34,34,0,524,525,524,1,8,4,4,4,172,172,168,168
Imperial,58,2023-01-22,81,81,81,0,2117,2122,2121,1,11,2,2,1,978,978,976,976
Inyo,58,2023-01-22,6,6,6,0,166,167,166,1,0,1,1,0,63,63,62,62
Kern,58,2023-01-22,330,330,330,0,9085,9101,9100,1,36,5,5,9,2482,2482,2477,2477
Kings,58,2023-01-22,94,94,94,0,1867,1870,1869,1,4,0,0,0,481,481,481,481
Lake,58,2023-01-22,25,25,25,0,580,581,580,1,2,3,3,2,159,159,156,156
Lassen,58,2023-01-22,5,5,5,0,452,453,452,1,0,1,1,0,66,66,65,65
Los Angeles,58,2023-01-22,5467,5475,5475,0,172399,172686,172684,2,700,64,64,93,35046,35046,34982,34982
Madera,58,2023-01-22,48,48,48,0,1454,1455,1454,1,6,1,1,2,378,378,377,377
Marin,58,2023-01-22,122,122,122,0,2277,2283,2282,1,18,1,1,3,265,265,264,264
Mariposa,58,2023-01-22,8,8,8,0,98,99,98,1,0,0,0,0,31,31,31,31
Mendocino,58,2023-01-22,17,17,17,0,512,513,512,1,2,0,0,2,143,143,143,143
Merced,58,2023-01-22,111,111,111,0,2245,2252,2251,1,12,2,2,4,903,903,901,901
Modoc,58,2023-01-22,2,2,2,0,10,11,10,1,1,0,0,0,11,11,11,11
Mono,58,2023-01-22,5,5,5,0,73,74,73,1,0,0,0,0,8,8,8,8
Monterey,58,2023-01-22,100,100,100,0,2669,2675,2674,1,16,1,1,1,798,798,797,797
Napa,58,2023-01-22,75,75,75,0,1388,1389,1388,1,2,1,1,1,169,169,168,168
Nevada,58,2023-01-22,23,23,23,0,600,601,600,1,4,0,0,0,138,138,138,138
Orange,58,2023-01-22,1224,1224,1224,0,24033,24072,24071,1,188,9,9,26,7893,7893,7884,7884
Placer,58,2023-01-22,140,140,140,0,2642,2649,2648,1,48,2,2,5,686,686,684,684
Plumas,58,2023-01-22,6,6,6,0,93,94,93,1,0,0,0,0,14,14,14,14
Riverside,58,2023-01-22,1008,1008,1008,0,16740,16768,16767,1,123,22,22,19,6843,6843,6821,6821
Sacramento,58,2023-01-22,557,557,557,0,13089,13111,13110,1,119,10,10,21,3525,3525,3515,3515
San Benito,58,2023-01-22,25,25,25,0,527,528,527,1,0,0,0,0,115,115,115,115
San Bernardino,58,2023-01-22,990,990,990,0,20560,20593,20592,1,135,10,10,26,8192,8192,8182,8182
San Diego,58,2023-01-22,1928,1931,1931,0,30182,30233,30232,1,247,19,19,40,5820,5820,5801,5801
San Francisco,58,2023-01-22,447,447,447,0,10777,10795,10794,1,59,6,6,7,1164,1164,1158,1158
San Joaquin,58,2023-01-22,251,251,251,0,9455,9471,9470,1,35,7,7,8,2434,2434,2427,2427
San Luis Obispo,58,2023-01-22,105,105,105,0,1867,1871,1870,1,8,1,1,1,554,554,553,553
San Mateo,58,2023-01-22,327,327,327,0,8083,8098,8097,1,23,3,3,0,762,762,759,759
Santa Barbara,58,2023-01-22,203,203,203,0,4073,4081,4080,1,30,3,3,3,759,759,756,756
Santa Clara,58,2023-01-22,1007,1007,1007,0,26241,26285,26284,1,145,11,11,16,2720,2720,2709,2709
Santa Cruz,58,2023-01-22,125,125,125,0,7468,7481,7480,1,18,1,1,0,280,280,279,279
Shasta,58,2023-01-22,23,23,23,0,730,731,730,1,6,2,2,1,639,639,637,637
Siskiyou,58,2023-01-22,6,6,6,0,183,184,183,1,1,0,0,0,96,96,96,96
Solano,58,2023-01-22,212,212,212,0,3920,3927,3926,1,29,2,2,3,481,481,479,479
Sonoma,58,2023-01-22,200,200,200,0,4082,4089,4088,1,24,3,3,3,552,552,549,549
Stanislaus,58,2023-01-22,183,183,183,0,4453,4462,4461,1,51,2,2,6,1844,1844,1842,1842
Sutter,58,2023-01-22,44,44,44,0,750,751,750,1,0,2,2,0,240,240,238,238
Tehama,58,2023-01-22,10,10,10,0,312,313,312,1,1,1,1,0,230,230,229,229
Trinity,58,2023-01-22,2,2,2,0,28,29,28,1,0,0,0,0,25,25,25,25
Tulare,58,2023-01-22,242,242,242,0,4047,4055,4054,1,29,2,2,6,1586,1586,1584,1584
Tuolumne,58,2023-01-22,36,36,36,0,509,510,509,1,1,1,1,0,212,212,211,211
Ventura,58,2023-01-22,358,358,358,0,8224,8238,8237,1,56,6,6,8,1667,1667,1661,1661
Yolo,58,2023-01-22,81,81,81,0,1329,1331,1330,1,2,3,3,0,449,449,446,446
Yuba,58,2023-01-22,28,28,28,0,673,674,673,1,5,0,0,0,137,137,137,137
Alameda,59,2023-01-29,827,827,827,0,18840,18871,18870,1,78,7,7,8,2122,2122,2115,2115
Amador,59,2023-01-29,21,21,21,0,619,620,619,1,2,1,1,0,98,98,97,97
Butte,59,2023-01-29,56,56,56,0,1124,1125,1124,1,11,4,4,2,496,496,492,492
Calaveras,59,2023-01-29,16,16,16,0,322,323,322,1,0,0,0,0,139,139,139,139
Colusa,59,2023-01-29,5,5,5,0,188,189,188,1,0,0,0,0,22,22,22,22
Contra Costa,59,2023-01-29,621,621,621,0,12576,12598,12597,1,38,9,9,6,1561,1561,1552,1552
Del Norte,59,2023-01-29,25,25,25,0,382,383,382,1,0,0,0,0,58,58,58,58
El Dorado,59,2023-01-29,55,55,55,0,1233,1234,1233,1,4,3,3,0,252,252,249,249
Fresno,59,2023-01-29,465,465,465,0,9944,9962,9961,1,117,8,8,12,2991,2991,2983,2983
Glenn,59,2023-01-29,4,4,4,0,162,163,162,1,0,0,0,0,57,57,57,57
Humboldt,59,2023-01-29,28,28,28,0,558,559,558,1,6,0,0,1,172,172,172,172
Imperial,59,2023-01-29,100,100,100,0,2076,2081,2080,1,5,0,0,1,978,978,978,978
Inyo,59,2023-01-29,8,8,8,0,189,190,189,1,1,0,0,0,63,63,63,63
Kern,59,2023-01-29,288,288,288,0,9222,9239,9238,1,36,2,2,8,2484,2484,2482,2482
Kings,59,2023-01-29,138,138,138,0,2214,2219,2218,1,3,0,0,0,481,481,481,481
Lake,59,2023-01-29,27,27,27,0,592,593,592,1,4,0,0,0,159,159,159,159
Lassen,59,2023-01-29,5,5,5,0,473,474,473,1,0,0,0,0,66,66,66,66
Los Angeles,59,2023-01-29,5671,5680,5680,0,160180,160452,160450,2,599,56,56,75,35102,35102,35046,35046
Madera,59,2023-01-29,53,53,53,0,1504,1506,1505,1,6,1,1,0,379,379,378,378
Marin,59,2023-01-29,96,96,96,0,2190,2196,2195,1,17,0,0,2,265,265,265,265
Mariposa,59,2023-01-29,4,4,4,0,109,110,109,1,0,0,0,0,31,31,31,31
Mendocino,59,2023-01-29,25,25,25,0,527,528,527,1,2,2,2,2,145,145,143,143
Merced,59,2023-01-29,142,142,142,0,2100,2104,2103,1,9,1,1,2,904,904,903,903
Modoc,59,2023-01-29,0,0,0,0,10,11,10,1,1,0,0,0,11,11,11,11
Mono,59,2023-01-29,2,2,2,0,66,67,66,1,0,0,0,0,8,8,8,8
Monterey,59,2023-01-29,153,153,153,0,2858,2864,2863,1,7,1,1,0,799,799,798,798
Napa,59,2023-01-29,65,65,65,0,1366,1368,1367,1,4,4,4,1,173,173,169,169
Nevada,59,2023-01-29,28,28,28,0,583,584,583,1,1,0,0,2,138,138,138,138
Orange,59,2023-01-29,1167,1167,1167,0,23226,23266,23265,1,139,20,20,25,7913,7913,7893,7893
Placer,59,2023-01-29,162,162,162,0,2710,2717,2716,1,55,3,3,7,689,689,686,686
Plumas,59,2023-01-29,3,3,3,0,75,76,75,1,0,0,0,0,14,14,14,14
Riverside,59,2023-01-29,1044,1044,1044,0,16611,16639,16638,1,100,24,24,15,6867,6867,6843,6843
Sacramento,59,2023-01-29,675,675,675,0,13962,13985,13984,1,121,10,10,14,3535,3535,3525,3525
San Benito,59,2023-01-29,29,29,29,0,568,569,568,1,0,0,0,0,115,115,115,115
San Bernardino,59,2023-01-29,942,942,942,0,18343,18375,18374,1,145,11,11,19,8203,8203,8192,8192
San Diego,59,2023-01-29,1862,1866,1866,0,31653,31707,31706,1,234,26,26,36,5846,5846,5820,5820
San Francisco,59,2023-01-29,454,454,454,0,11162,11179,11178,1,55,2,2,4,1166,1166,1164,1164
San Joaquin,59,2023-01-29,287,287,287,0,9198,9215,9214,1,25,6,6,4,2440,2440,2434,2434
San Luis Obispo,59,2023-01-29,130,130,130,0,1876,1880,1879,1,12,6,6,1,560,560,554,554
San Mateo,59,2023-01-29,431,431,431,0,8857,8873,8872,1,24,4,4,6,766,766,762,762
Santa Barbara,59,2023-01-29,232,232,232,0,4264,4272,4271,1,25,2,2,2,761,761,759,759
Santa Clara,59,2023-01-29,1153,1153,1153,0,29240,29292,29291,1,147,7,7,19,2727,2727,2720,2720
Santa Cruz,59,2023-01-29,130,130,130,0,9158,9174,9173,1,12,1,1,0,281,281,280,280
Shasta,59,2023-01-29,19,19,19,0,689,690,689,1,8,1,1,0,640,640,639,639
Siskiyou,59,2023-01-29,4,4,4,0,194,195,194,1,1,0,0,0,96,96,96,96
Solano,59,2023-01-29,231,231,231,0,4110,4117,4116,1,44,3,3,3,484,484,481,481
Sonoma,59,2023-01-29,170,170,170,0,3756,3763,3762,1,25,3,3,0,555,555,552,552
Stanislaus,59,2023-01-29,219,219,219,0,4482,4490,4489,1,49,3,3,5,1847,1847,1844,1844
Sutter,59,2023-01-29,30,30,30,0,632,633,632,1,0,1,1,0,241,241,240,240
Tehama,59,2023-01-29,11,11,11,0,334,335,334,1,0,1,1,1,231,231,230,230
Trinity,59,2023-01-29,2,2,2,0,28,29,28,1,0,1,1,0,26,26,25,25
Tulare,59,2023-01-29,247,247,247,0,4022,4030,4029,1,26,4,4,5,1590,1590,1586,1586
Tuolumne,59,2023-01-29,46,46,46,0,562,563,562,1,3,0,0,0,212,212,212,212
Ventura,59,2023-01-29,358,358,358,0,8293,8308,8307,1,50,6,6,10,1673,1673,1667,1667
Yolo,59,2023-01-29,83,83,83,0,1296,1297,1296,1,2,1,1,1,450,450,449,449
Yuba,59,2023-01-29,33,33,33,0,683,684,683,1,6,1,1,1,138,138,137,137
Alameda,60,2023-02-05,1040,1040,1040,0,19044,19078,19077,1,83,7,7,7,2129,2129,2122,2122
Amador,60,2023-02-05,32,32,32,0,672,673,672,1,0,0,0,0,98,98,98,98
Butte,60,2023-02-05,72,72,72,0,1180,1181,1180,1,16,1,1,2,497,497,496,496
Calaveras,60,2023-02-05,15,15,15,0,333,334,333,1,0,0,0,0,139,139,139,139
Colusa,60,2023-02-05,6,6,6,0,173,174,173,1,0,0,0,0,22,22,22,22
Contra Costa,60,2023-02-05,696,696,696,0,11981,12002,12001,1,52,6,6,8,1567,1567,1561,1561
Del Norte,60,2023-02-05,47,47,47,0,384,385,384,1,0,0,0,0,58,58,58,58
El Dorado,60,2023-02-05,58,58,58,0,1097,1098,1097,1,3,1,1,0,253,253,252,252
Fresno,60,2023-02-05,480,480,480,0,9236,9253,9252,1,95,3,3,6,2994,2994,2991,2991
Glenn,60,2023-02-05,9,9,9,0,161,162,161,1,0,0,0,0,57,57,57,57
Humboldt,60,2023-02-05,53,53,53,0,565,566,565,1,6,0,0,0,172,172,172,172
Imperial,60,2023-02-05,123,123,123,0,2174,2179,2178,1,7,1,1,0,979,979,978,978
Inyo,60,2023-02-05,10,10,10,0,204,205,204,1,0,0,0,0,63,63,63,63
Kern,60,2023-02-05,326,326,326,0,9003,9020,9019,1,35,3,3,5,2487,2487,2484,2484
Kings,60,2023-02-05,129,129,129,0,2083,2087,2086,1,4,0,0,1,481,481,481,481
Lake,60,2023-02-05,20,20,20,0,554,555,554,1,5,2,2,0,161,161,159,159
Lassen,60,2023-02-05,4,4,4,0,483,484,483,1,0,0,0,0,66,66,66,66
Los Angeles,60,2023-02-05,6043,6054,6054,0,155148,155421,155419,2,606,47,47,78,35149,35149,35102,35102
Madera,60,2023-02-05,53,53,53,0,1336,1337,1336,1,5,2,2,0,381,381,379,379
Marin,60,2023-02-05,136,136,136,0,2174,2179,2178,1,15,0,0,3,265,265,265,265
Mariposa,60,2023-02-05,3,3,3,0,110,111,110,1,0,0,0,0,31,31,31,31
Mendocino,60,2023-02-05,32,32,32,0,490,491,490,1,1,0,0,1,145,145,145,145
Merced,60,2023-02-05,167,167,167,0,2235,2241,2240,1,12,1,1,1,905,905,904,904
Modoc,60,2023-02-05,1,1,1,0,5,6,5,1,0,0,0,0,11,11,11,11
Mono,60,2023-02-05,5,5,5,0,90,91,90,1,0,0,0,0,8,8,8,8
Monterey,60,2023-02-05,217,217,217,0,3010,3016,3015,1,18,2,2,0,801,801,799,799
Napa,60,2023-02-05,99,99,99,0,1333,1335,1334,1,6,1,1,2,174,174,173,173
Nevada,60,2023-02-05,29,29,29,0,579,580,579,1,5,1,1,0,139,139,138,138
Orange,60,2023-02-05,1313,1313,1313,0,22974,23014,23013,1,161,8,8,17,7921,7921,7913,7913
Placer,60,2023-02-05,165,165,165,0,2675,2682,2681,1,45,3,3,4,692,692,689,689
Plumas,60,2023-02-05,2,2,2,0,75,76,75,1,0,1,1,0,15,15,14,14
Riverside,60,2023-02-05,1137,1137,1137,0,16154,16183,16182,1,84,9,9,16,6876,6876,6867,6867
Sacramento,60,2023-02-05,686,686,686,0,13393,13417,13416,1,107,6,6,19,3541,3541,3535,3535
San Benito,60,2023-02-05,48,48,48,0,555,556,555,1,0,0,0,0,115,115,115,115
San Bernardino,60,2023-02-05,1075,1075,1075,0,18941,18975,18974,1,137,9,9,20,8212,8212,8203,8203
San Diego,60,2023-02-05,1840,1843,1843,0,29432,29486,29485,1,251,20,20,26,5866,5866,5846,5846
San Francisco,60,2023-02-05,603,603,603,0,12004,12025,12024,1,57,2,2,2,1168,1168,1166,1166
San Joaquin,60,2023-02-05,410,410,410,0,9084,9101,9100,1,31,2,2,3,2442,2442,2440,2440
San Luis Obispo,60,2023-02-05,148,148,148,0,1901,1906,1905,1,8,2,2,0,562,562,560,560
San Mateo,60,2023-02-05,509,509,509,0,8548,8564,8563,1,36,5,5,2,771,771,766,766
Santa Barbara,60,2023-02-05,236,236,236,0,4339,4347,4346,1,20,3,3,0,764,764,761,761
Santa Clara,60,2023-02-05,1314,1314,1314,0,28498,28549,28548,1,134,10,10,24,2737,2737,2727,2727
Santa Cruz,60,2023-02-05,219,219,219,0,10314,10333,10332,1,9,2,2,0,283,283,281,281
Shasta,60,2023-02-05,25,25,25,0,663,664,663,1,8,1,1,0,641,641,640,640
Siskiyou,60,2023-02-05,13,13,13,0,212,213,212,1,1,0,0,0,96,96,96,96
Solano,60,2023-02-05,260,260,260,0,3873,3879,3878,1,36,4,4,5,488,488,484,484
Sonoma,60,2023-02-05,244,244,244,0,3552,3559,3558,1,20,3,3,1,558,558,555,555
Stanislaus,60,2023-02-05,271,271,271,0,4488,4496,4495,1,54,3,3,6,1850,1850,1847,1847
Sutter,60,2023-02-05,46,46,46,0,703,704,703,1,0,1,1,0,242,242,241,241
Tehama,60,2023-02-05,14,14,14,0,344,345,344,1,2,0,0,0,231,231,231,231
Trinity,60,2023-02-05,8,8,8,0,24,25,24,1,0,0,0,0,26,26,26,26
Tulare,60,2023-02-05,266,266,266,0,4288,4296,4295,1,23,3,3,1,1593,1593,1590,1590
Tuolumne,60,2023-02-05,46,46,46,0,598,599,598,1,1,0,0,1,212,212,212,212
Ventura,60,2023-02-05,326,326,326,0,7090,7103,7102,1,41,4,4,8,1677,1677,1673,1673
Yolo,60,2023-02-05,77,77,77,0,1284,1285,1284,1,3,0,0,2,450,450,450,450
Yuba,60,2023-02-05,18,18,18,0,606,607,606,1,1,0,0,1,138,138,138,138
Alameda,61,2023-02-12,1161,1161,1161,0,18515,18549,18548,1,78,6,6,7,2135,2135,2129,2129
Amador,61,2023-02-12,18,18,18,0,506,507,506,1,0,0,0,0,98,98,98,98
Butte,61,2023-02-12,98,98,98,0,1285,1287,1286,1,27,1,1,1,498,498,497,497
Calaveras,61,2023-02-12,16,16,16,0,319,320,319,1,0,1,1,0,140,140,139,139
Colusa,61,2023-02-12,11,11,11,0,188,189,188,1,0,0,0,0,22,22,22,22
Contra Costa,61,2023-02-12,730,730,730,0,11607,11629,11628,1,43,3,3,7,1570,1570,1567,1567
Del Norte,61,2023-02-12,37,37,37,0,316,317,316,1,2,0,0,0,58,58,58,58
El Dorado,61,2023-02-12,63,63,63,0,1110,1111,1110,1,2,1,1,0,254,254,253,253
Fresno,61,2023-02-12,494,494,494,0,8867,8884,8883,1,107,4,4,6,2998,2998,2994,2994
Glenn,61,2023-02-12,11,11,11,0,177,178,177,1,5,0,0,0,57,57,57,57
Humboldt,61,2023-02-12,42,42,42,0,576,577,576,1,7,1,1,1,173,173,172,172
Imperial,61,2023-02-12,138,138,138,0,1885,1889,1888,1,3,1,1,5,980,980,979,979
Inyo,61,2023-02-12,8,8,8,0,209,210,209,1,0,0,0,0,63,63,63,63
Kern,61,2023-02-12,321,321,321,0,8603,8620,8619,1,37,2,2,7,2489,2489,2487,2487
Kings,61,2023-02-12,102,102,102,0,1933,1938,1937,1,5,1,1,1,482,482,481,481
Lake,61,2023-02-12,24,24,24,0,600,601,600,1,2,0,0,0,161,161,161,161
Lassen,61,2023-02-12,7,7,7,0,381,382,381,1,0,0,0,0,66,66,66,66
Los Angeles,61,2023-02-12,6133,6145,6145,0,143074,143331,143329,2,622,39,39,63,35188,35188,35149,35149
Madera,61,2023-02-12,63,63,63,0,1281,1282,1281,1,9,1,1,1,382,382,381,381
Marin,61,2023-02-12,150,150,150,0,1921,1926,1925,1,18,0,0,3,265,265,265,265
Mariposa,61,2023-02-12,3,3,3,0,99,100,99,1,0,0,0,0,31,31,31,31
Mendocino,61,2023-02-12,28,28,28,0,550,551,550,1,3,2,2,1,147,147,145,145
Merced,61,2023-02-12,167,167,167,0,2527,2533,2532,1,8,1,1,0,906,906,905,905
Modoc,61,2023-02-12,1,1,1,0,3,4,3,1,0,0,0,0,11,11,11,11
Mono,61,2023-02-12,1,1,1,0,70,71,70,1,0,0,0,0,8,8,8,8
Monterey,61,2023-02-12,215,215,215,0,2768,2774,2773,1,18,4,4,0,805,805,801,801
Napa,61,2023-02-12,106,106,106,0,1501,1503,1502,1,5,0,0,0,174,174,174,174
Nevada,61,2023-02-12,41,41,41,0,606,607,606,1,5,0,0,0,139,139,139,139
Orange,61,2023-02-12,1418,1418,1418,0,21808,21848,21847,1,141,11,11,21,7932,7932,7921,7921
Placer,61,2023-02-12,166,166,166,0,2646,2653,2652,1,37,3,3,6,695,695,692,692
Plumas,61,2023-02-12,2,2,2,0,82,83,82,1,1,0,0,0,15,15,15,15
Riverside,61,2023-02-12,1090,1090,1090,0,16804,16834,16833,1,84,12,12,13,6888,6888,6876,6876
Sacramento,61,2023-02-12,846,846,846,0,13565,13590,13589,1,103,6,6,17,3547,3547,3541,3541
San Benito,61,2023-02-12,49,49,49,0,587,588,587,1,2,0,0,0,115,115,115,115
San Bernardino,61,2023-02-12,1033,1033,1033,0,18270,18305,18304,1,130,13,13,18,8225,8225,8212,8212
San Diego,61,2023-02-12,2016,2021,2021,0,30782,30838,30837,1,243,13,13,25,5879,5879,5866,5866
San Francisco,61,2023-02-12,590,590,590,0,10980,11000,10999,1,61,4,4,3,1172,1172,1168,1168
San Joaquin,61,2023-02-12,522,522,522,0,8530,8546,8545,1,30,2,2,4,2444,2444,2442,2442
San Luis Obispo,61,2023-02-12,139,139,139,0,1784,1787,1786,1,5,1,1,0,563,563,562,562
San Mateo,61,2023-02-12,518,518,518,0,8283,8299,8298,1,32,0,0,4,771,771,771,771
Santa Barbara,61,2023-02-12,200,200,200,0,4032,4040,4039,1,15,3,3,3,767,767,764,764
Santa Clara,61,2023-02-12,1451,1451,1451,0,25936,25984,25983,1,116,15,15,21,2752,2752,2737,2737
Santa Cruz,61,2023-02-12,227,227,227,0,10315,10335,10334,1,16,3,3,0,286,286,283,283
Shasta,61,2023-02-12,29,29,29,0,673,674,673,1,7,0,0,0,641,641,641,641
Siskiyou,61,2023-02-12,12,12,12,0,224,225,224,1,1,0,0,0,96,96,96,96
Solano,61,2023-02-12,295,295,295,0,3893,3901,3900,1,32,2,2,3,490,490,488,488
Sonoma,61,2023-02-12,219,219,219,0,3458,3466,3465,1,21,2,2,2,560,560,558,558
Stanislaus,61,2023-02-12,280,280,280,0,4070,4078,4077,1,52,9,9,7,1859,1859,1850,1850
Sutter,61,2023-02-12,51,51,51,0,687,688,687,1,0,1,1,0,243,243,242,242
Tehama,61,2023-02-12,18,18,18,0,368,369,368,1,1,1,1,0,232,232,231,231
Trinity,61,2023-02-12,1,1,1,0,24,25,24,1,0,0,0,0,26,26,26,26
Tulare,61,2023-02-12,263,263,263,0,4257,4265,4264,1,29,3,3,1,1596,1596,1593,1593
Tuolumne,61,2023-02-12,38,38,38,0,484,485,484,1,2,0,0,0,212,212,212,212
Ventura,61,2023-02-12,337,337,337,0,6755,6768,6767,1,28,5,5,6,1682,1682,1677,1677
Yolo,61,2023-02-12,86,86,86,0,1290,1292,1291,1,2,1,1,1,451,451,450,450
Yuba,61,2023-02-12,32,32,32,0,662,663,662,1,7,0,0,0,138,138,138,138
Alameda,62,2023-02-19,1060,1060,1060,0,17728,17761,17760,1,83,4,4,6,2139,2139,2135,2135
Amador,62,2023-02-19,25,25,25,0,551,552,551,1,1,0,0,1,98,98,98,98
Butte,62,2023-02-19,53,53,53,0,1122,1123,1122,1,22,2,2,1,500,500,498,498
Calaveras,62,2023-02-19,17,17,17,0,325,326,325,1,1,0,0,0,140,140,140,140
Colusa,62,2023-02-19,7,7,7,0,95,96,95,1,0,1,1,0,23,23,22,22
Contra Costa,62,2023-02-19,704,704,704,0,11266,11287,11286,1,51,4,4,5,1574,1574,1570,1570
Del Norte,62,2023-02-19,14,14,14,0,286,287,286,1,3,0,0,0,58,58,58,58
El Dorado,62,2023-02-19,61,61,61,0,1074,1075,1074,1,3,0,0,1,254,254,254,254
Fresno,62,2023-02-19,481,481,481,0,8837,8855,8854,1,83,4,4,11,3002,3002,2998,2998
Glenn,62,2023-02-19,6,6,6,0,167,168,167,1,4,1,1,0,58,58,57,57
Humboldt,62,2023-02-19,37,37,37,0,625,626,625,1,9,0,0,1,173,173,173,173
Imperial,62,2023-02-19,128,128,128,0,1815,1820,1819,1,0,1,1,8,981,981,980,980
Inyo,62,2023-02-19,6,6,6,0,175,176,175,1,0,0,0,0,63,63,63,63
Kern,62,2023-02-19,416,416,416,0,8262,8278,8277,1,28,9,9,5,2498,2498,2489,2489
Kings,62,2023-02-19,74,74,74,0,1754,1758,1757,1,4,1,1,0,483,483,482,482
Lake,62,2023-02-19,21,21,21,0,541,542,541,1,2,1,1,1,162,162,161,161
Lassen,62,2023-02-19,1,1,1,0,366,367,366,1,0,0,0,0,66,66,66,66
Los Angeles,62,2023-02-19,5826,5838,5838,0,134936,135191,135189,2,578,50,50,72,35238,35238,35188,35188
Madera,62,2023-02-19,57,57,57,0,1167,1168,1167,1,4,0,0,2,382,382,382,382
Marin,62,2023-02-19,158,158,158,0,2000,2006,2005,1,10,1,1,2,266,266,265,265
Mariposa,62,2023-02-19,6,6,6,0,127,128,127,1,0,0,0,0,31,31,31,31
Mendocino,62,2023-02-19,20,20,20,0,523,524,523,1,4,1,1,0,148,148,147,147
Merced,62,2023-02-19,140,140,140,0,2303,2309,2308,1,16,0,0,1,906,906,906,906
Modoc,62,2023-02-19,1,1,1,0,14,15,14,1,0,0,0,0,11,11,11,11
Mono,62,2023-02-19,2,2,2,0,74,75,74,1,0,0,0,0,8,8,8,8
Monterey,62,2023-02-19,167,167,167,0,2579,2585,2584,1,21,1,1,1,806,806,805,805
Napa,62,2023-02-19,77,77,77,0,1189,1190,1189,1,3,2,2,0,176,176,174,174
Nevada,62,2023-02-19,28,28,28,0,620,621,620,1,4,2,2,2,141,141,139,139
Orange,62,2023-02-19,1347,1347,1347,0,20939,20980,20979,1,145,16,16,17,7948,7948,7932,7932
Placer,62,2023-02-19,167,167,167,0,2606,2613,2612,1,41,0,0,4,695,695,695,695
Plumas,62,2023-02-19,8,8,8,0,79,80,79,1,0,0,0,0,15,15,15,15
Riverside,62,2023-02-19,1052,1052,1052,0,16733,16765,16764,1,91,8,8,10,6896,6896,6888,6888
Sacramento,62,2023-02-19,764,764,764,0,13036,13061,13060,1,109,14,14,15,3561,3561,3547,3547
San Benito,62,2023-02-19,31,31,31,0,547,548,547,1,1,1,1,0,116,116,115,115
San Bernardino,62,2023-02-19,981,981,981,0,17378,17411,17410,1,120,9,9,27,8234,8234,8225,8225
San Diego,62,2023-02-19,1900,1904,1904,0,27212,27264,27263,1,224,16,16,28,5895,5895,5879,5879
San Francisco,62,2023-02-19,630,630,630,0,11349,11370,11369,1,77,0,0,7,1172,1172,1172,1172
San Joaquin,62,2023-02-19,469,469,469,0,10081,10101,10100,1,32,3,3,5,2447,2447,2444,2444
San Luis Obispo,62,2023-02-19,115,115,115,0,1620,1623,1622,1,10,0,0,0,563,563,563,563
San Mateo,62,2023-02-19,520,520,520,0,8576,8592,8591,1,40,4,4,4,775,775,771,771
Santa Barbara,62,2023-02-19,203,203,203,0,3775,3783,3782,1,15,1,1,5,768,768,767,767
Santa Clara,62,2023-02-19,1409,1409,1409,0,28030,28084,28083,1,102,15,15,22,2767,2767,2752,2752
Santa Cruz,62,2023-02-19,135,135,135,0,8124,8140,8139,1,15,0,0,0,286,286,286,286
Shasta,62,2023-02-19,21,21,21,0,730,731,730,1,2,0,0,0,641,641,641,641
Siskiyou,62,2023-02-19,12,12,12,0,202,203,202,1,1,0,0,0,96,96,96,96
Solano,62,2023-02-19,253,253,253,0,3759,3767,3766,1,30,3,3,3,493,493,490,490
Sonoma,62,2023-02-19,269,269,269,0,3394,3402,3401,1,23,2,2,3,562,562,560,560
Stanislaus,62,2023-02-19,263,263,263,0,4541,4550,4549,1,51,1,1,7,1860,1860,1859,1859
Sutter,62,2023-02-19,41,41,41,0,547,548,547,1,0,1,1,0,244,244,243,243
Tehama,62,2023-02-19,13,13,13,0,276,277,276,1,1,2,2,0,234,234,232,232
Trinity,62,2023-02-19,0,0,0,0,27,28,27,1,0,0,0,0,26,26,26,26
Tulare,62,2023-02-19,205,205,205,0,4232,4240,4239,1,19,2,2,1,1598,1598,1596,1596
Tuolumne,62,2023-02-19,29,29,29,0,504,505,504,1,0,0,0,0,212,212,212,212
Ventura,62,2023-02-19,284,284,284,0,5991,6003,6002,1,36,6,6,4,1688,1688,1682,1682
Yolo,62,2023-02-19,79,79,79,0,1264,1265,1264,1,1,1,1,1,452,452,451,451
Yuba,62,2023-02-19,29,29,29,0,544,545,544,1,5,0,0,0,138,138,138,138
Alameda,63,2023-02-26,1098,1098,1098,0,17635,17670,17669,1,106,4,4,9,2143,2143,2139,2139
Amador,63,2023-02-26,17,17,17,0,519,520,519,1,1,0,0,0,98,98,98,98
Butte,63,2023-02-26,50,50,50,0,971,973,972,1,8,2,2,1,502,502,500,500
Calaveras,63,2023-02-26,14,14,14,0,321,322,321,1,1,0,0,0,140,140,140,140
Colusa,63,2023-02-26,16,16,16,0,87,88,87,1,0,0,0,0,23,23,23,23
Contra Costa,63,2023-02-26,703,703,703,0,10741,10762,10761,1,67,9,9,7,1583,1583,1574,1574
Del Norte,63,2023-02-26,6,6,6,0,262,263,262,1,0,0,0,0,58,58,58,58
El Dorado,63,2023-02-26,53,53,53,0,1023,1024,1023,1,3,2,2,0,256,256,254,254
Fresno,63,2023-02-26,471,471,471,0,8600,8619,8618,1,83,2,2,12,3004,3004,3002,3002
Glenn,63,2023-02-26,3,3,3,0,143,144,143,1,1,0,0,0,58,58,58,58
Humboldt,63,2023-02-26,29,29,29,0,483,484,483,1,4,1,1,1,174,174,173,173
Imperial,63,2023-02-26,164,164,164,0,1863,1868,1867,1,11,0,0,0,981,981,981,981
Inyo,63,2023-02-26,4,4,4,0,161,162,161,1,0,0,0,0,63,63,63,63
Kern,63,2023-02-26,381,381,381,0,7908,7925,7924,1,45,3,3,8,2501,2501,2498,2498
Kings,63,2023-02-26,64,64,64,0,1662,1665,1664,1,4,1,1,0,484,484,483,483
Lake,63,2023-02-26,21,21,21,0,452,453,452,1,3,1,1,0,163,163,162,162
Lassen,63,2023-02-26,2,2,2,0,346,347,346,1,0,0,0,0,66,66,66,66
Los Angeles,63,2023-02-26,5457,5468,5468,0,136124,136394,136392,2,563,38,38,70,35276,35276,35238,35238
Madera,63,2023-02-26,61,61,61,0,1172,1173,1172,1,6,0,0,1,382,382,382,382
Marin,63,2023-02-26,146,146,146,0,1850,1855,1854,1,22,0,0,1,266,266,266,266
Mariposa,63,2023-02-26,7,7,7,0,93,94,93,1,0,0,0,0,31,31,31,31
Mendocino,63,2023-02-26,30,30,30,0,514,515,514,1,5,0,0,1,148,148,148,148
Merced,63,2023-02-26,124,124,124,0,2166,2172,2171,1,20,1,1,2,907,907,906,906
Modoc,63,2023-02-26,1,1,1,0,9,10,9,1,0,0,0,0,11,11,11,11
Mono,63,2023-02-26,5,5,5,0,53,54,53,1,0,0,0,0,8,8,8,8
Monterey,63,2023-02-26,195,195,195,0,2580,2587,2586,1,26,3,3,1,809,809,806,806
Napa,63,2023-02-26,81,81,81,0,1224,1227,1226,1,4,2,2,3,178,178,176,176
Nevada,63,2023-02-26,26,26,26,0,601,602,601,1,3,2,2,0,143,143,141,141
Orange,63,2023-02-26,1282,1282,1282,0,19425,19464,19463,1,153,12,12,21,7960,7960,7948,7948
Placer,63,2023-02-26,174,174,174,0,2461,2468,2467,1,40,0,0,7,695,695,695,695
Plumas,63,2023-02-26,4,4,4,0,90,91,90,1,0,0,0,0,15,15,15,15
Riverside,63,2023-02-26,911,911,911,0,15517,15547,15546,1,73,10,10,14,6906,6906,6896,6896
Sacramento,63,2023-02-26,874,874,874,0,12675,12701,12700,1,112,9,9,22,3570,3570,3561,3561
San Benito,63,2023-02-26,26,26,26,0,478,479,478,1,1,1,1,0,117,117,116,116
San Bernardino,63,2023-02-26,858,858,858,0,16370,16402,16401,1,150,19,19,19,8253,8253,8234,8234
San Diego,63,2023-02-26,1770,1775,1775,0,26951,27006,27005,1,233,15,15,24,5910,5910,5895,5895
San Francisco,63,2023-02-26,650,650,650,0,12304,12329,12328,1,78,5,5,7,1177,1177,1172,1172
San Joaquin,63,2023-02-26,391,391,391,0,9801,9823,9822,1,41,3,3,3,2450,2450,2447,2447
San Luis Obispo,63,2023-02-26,70,70,70,0,1526,1529,1528,1,13,3,3,0,566,566,563,563
San Mateo,63,2023-02-26,456,456,456,0,7288,7303,7302,1,36,5,5,5,780,780,775,775
Santa Barbara,63,2023-02-26,183,183,183,0,3429,3437,3436,1,17,1,1,7,769,769,768,768
Santa Clara,63,2023-02-26,1364,1366,1366,0,27333,27388,27387,1,120,13,13,25,2780,2780,2767,2767
Santa Cruz,63,2023-02-26,163,163,163,0,6945,6960,6959,1,11,1,1,1,287,287,286,286
Shasta,63,2023-02-26,33,33,33,0,639,640,639,1,8,0,0,1,641,641,641,641
Siskiyou,63,2023-02-26,13,13,13,0,235,236,235,1,0,0,0,0,96,96,96,96
Solano,63,2023-02-26,260,260,260,0,3349,3357,3356,1,30,2,2,7,495,495,493,493
Sonoma,63,2023-02-26,234,234,234,0,3306,3314,3313,1,28,2,2,3,564,564,562,562
Stanislaus,63,2023-02-26,258,258,258,0,4451,4462,4461,1,62,2,2,5,1862,1862,1860,1860
Sutter,63,2023-02-26,43,43,43,0,503,504,503,1,0,0,0,0,244,244,244,244
Tehama,63,2023-02-26,14,14,14,0,258,259,258,1,2,0,0,1,234,234,234,234
Trinity,63,2023-02-26,0,0,0,0,23,24,23,1,0,0,0,0,26,26,26,26
Tulare,63,2023-02-26,228,228,228,0,3712,3720,3719,1,18,3,3,1,1601,1601,1598,1598
Tuolumne,63,2023-02-26,46,46,46,0,499,500,499,1,1,0,0,1,212,212,212,212
Ventura,63,2023-02-26,279,279,279,0,5793,5806,5805,1,36,3,3,4,1691,1691,1688,1688
Yolo,63,2023-02-26,88,88,88,0,1367,1370,1369,1,3,2,2,0,454,454,452,452
Yuba,63,2023-02-26,31,31,31,0,501,502,501,1,1,0,0,0,138,138,138,138
Alameda,64,2023-03-05,962,962,962,0,17693,17729,17728,1,102,8,8,11,2151,2151,2143,2143
Amador,64,2023-03-05,11,11,11,0,470,471,470,1,0,0,0,0,98,98,98,98
Butte,64,2023-03-05,37,37,37,0,584,585,584,1,11,1,1,0,503,503,502,502
Calaveras,64,2023-03-05,17,17,17,0,293,294,293,1,0,1,1,0,141,141,140,140
Colusa,64,2023-03-05,10,10,10,0,121,122,121,1,0,1,1,0,24,24,23,23
Contra Costa,64,2023-03-05,674,674,674,0,10420,10443,10442,1,64,7,7,10,1590,1590,1583,1583
Del Norte,64,2023-03-05,7,7,7,0,263,264,263,1,1,0,0,1,58,58,58,58
El Dorado,64,2023-03-05,51,51,51,0,969,970,969,1,2,2,2,1,258,258,256,256
Fresno,64,2023-03-05,385,385,385,0,8435,8453,8452,1,73,3,3,12,3007,3007,3004,3004
Glenn,64,2023-03-05,3,3,3,0,160,161,160,1,0,3,3,0,61,61,58,58
Humboldt,64,2023-03-05,21,21,21,0,480,481,480,1,4,1,1,1,175,175,174,174
Imperial,64,2023-03-05,156,156,156,0,1674,1679,1678,1,10,0,0,1,981,981,981,981
Inyo,64,2023-03-05,3,3,3,0,133,134,133,1,2,0,0,0,63,63,63,63
Kern,64,2023-03-05,348,348,348,0,8221,8239,8238,1,33,4,4,5,2505,2505,2501,2501
Kings,64,2023-03-05,60,60,60,0,1542,1545,1544,1,1,0,0,0,484,484,484,484
Lake,64,2023-03-05,20,20,20,0,507,508,507,1,1,0,0,0,163,163,163,163
Lassen,64,2023-03-05,4,4,4,0,329,330,329,1,0,0,0,0,66,66,66,66
Los Angeles,64,2023-03-05,4794,4804,4804,0,127294,127559,127558,1,562,42,42,67,35318,35318,35276,35276
Madera,64,2023-03-05,84,84,84,0,1171,1172,1171,1,5,0,0,0,382,382,382,382
Marin,64,2023-03-05,128,128,128,0,1803,1809,1808,1,18,1,1,3,267,267,266,266
Mariposa,64,2023-03-05,0,0,0,0,72,73,72,1,0,0,0,0,31,31,31,31
Mendocino,64,2023-03-05,25,25,25,0,436,437,436,1,7,1,1,0,149,149,148,148
Merced,64,2023-03-05,156,156,156,0,2231,2237,2236,1,17,2,2,2,909,909,907,907
Modoc,64,2023-03-05,1,1,1,0,9,10,9,1,0,0,0,0,11,11,11,11
Mono,64,2023-03-05,4,4,4,0,57,58,57,1,0,0,0,0,8,8,8,8
Monterey,64,2023-03-05,137,137,137,0,2303,2309,2308,1,25,2,2,5,811,811,809,809
Napa,64,2023-03-05,54,54,54,0,1103,1104,1103,1,9,1,1,2,179,179,178,178
Nevada,64,2023-03-05,16,16,16,0,467,468,467,1,1,0,0,0,143,143,143,143
Orange,64,2023-03-05,1012,1012,1012,0,18959,18998,18997,1,123,13,13,26,7973,7973,7960,7960
Placer,64,2023-03-05,162,162,162,0,2462,2469,2468,1,63,1,1,6,696,696,695,695
Plumas,64,2023-03-05,1,1,1,0,73,74,73,1,0,0,0,0,15,15,15,15
Riverside,64,2023-03-05,891,891,891,0,14929,14961,14960,1,81,8,8,11,6914,6914,6906,6906
Sacramento,64,2023-03-05,877,877,877,0,12195,12221,12220,1,104,6,6,8,3576,3576,3570,3570
San Benito,64,2023-03-05,18,18,18,0,504,505,504,1,1,0,0,0,117,117,117,117
San Bernardino,64,2023-03-05,786,786,786,0,16112,16146,16145,1,126,11,11,20,8264,8264,8253,8253
San Diego,64,2023-03-05,1455,1457,1457,0,25580,25633,25632,1,205,16,16,16,5926,5926,5910,5910
San Francisco,64,2023-03-05,607,607,607,0,11508,11533,11532,1,76,6,6,11,1183,1183,1177,1177
San Joaquin,64,2023-03-05,403,403,403,0,8822,8842,8841,1,37,3,3,9,2453,2453,2450,2450
San Luis Obispo,64,2023-03-05,90,90,90,0,1390,1392,1391,1,10,4,4,0,570,570,566,566
San Mateo,64,2023-03-05,433,433,433,0,7778,7795,7794,1,27,5,5,3,785,785,780,780
Santa Barbara,64,2023-03-05,143,143,143,0,3747,3755,3754,1,16,4,4,1,773,773,769,769
Santa Clara,64,2023-03-05,1156,1156,1156,0,24554,24606,24605,1,135,12,12,30,2792,2792,2780,2780
Santa Cruz,64,2023-03-05,118,118,118,0,6437,6451,6450,1,19,4,4,1,291,291,287,287
Shasta,64,2023-03-05,24,24,24,0,670,671,670,1,2,1,1,2,642,642,641,641
Siskiyou,64,2023-03-05,5,5,5,0,218,219,218,1,1,1,1,0,97,97,96,96
Solano,64,2023-03-05,259,259,259,0,3446,3454,3453,1,37,5,5,4,500,500,495,495
Sonoma,64,2023-03-05,209,209,209,0,3265,3273,3272,1,34,3,3,2,567,567,564,564
Stanislaus,64,2023-03-05,265,265,265,0,3906,3915,3914,1,67,5,5,8,1867,1867,1862,1862
Sutter,64,2023-03-05,42,42,42,0,609,610,609,1,0,0,0,0,244,244,244,244
Tehama,64,2023-03-05,14,14,14,0,271,272,271,1,4,0,0,1,234,234,234,234
Trinity,64,2023-03-05,2,2,2,0,22,23,22,1,0,0,0,0,26,26,26,26
Tulare,64,2023-03-05,208,208,208,0,3600,3608,3607,1,31,2,2,1,1603,1603,1601,1601
Tuolumne,64,2023-03-05,38,38,38,0,408,409,408,1,1,1,1,0,213,213,212,212
Ventura,64,2023-03-05,250,250,250,0,5111,5123,5122,1,41,2,2,4,1693,1693,1691,1691
Yolo,64,2023-03-05,76,76,76,0,1362,1365,1364,1,4,1,1,0,455,455,454,454
Yuba,64,2023-03-05,42,42,42,0,512,513,512,1,7,2,2,0,140,140,138,138
Alameda,65,2023-03-12,859,859,859,0,16400,16438,16437,1,71,5,5,12,2156,2156,2151,2151
Amador,65,2023-03-12,19,19,19,0,448,449,448,1,4,0,0,0,98,98,98,98
Butte,65,2023-03-12,41,41,41,0,632,633,632,1,8,3,3,1,506,506,503,503
Calaveras,65,2023-03-12,17,17,17,0,259,260,259,1,0,1,1,0,142,142,141,141
Colusa,65,2023-03-12,8,8,8,0,152,153,152,1,0,1,1,0,25,25,24,24
Contra Costa,65,2023-03-12,615,615,615,0,10128,10153,10152,1,54,2,2,9,1592,1592,1590,1590
Del Norte,65,2023-03-12,7,7,7,0,254,255,254,1,0,1,1,0,59,59,58,58
El Dorado,65,2023-03-12,56,56,56,0,901,902,901,1,1,0,0,0,258,258,258,258
Fresno,65,2023-03-12,391,391,391,0,8061,8081,8080,1,83,1,1,8,3008,3008,3007,3007
Glenn,65,2023-03-12,12,12,12,0,148,149,148,1,0,0,0,0,61,61,61,61
Humboldt,65,2023-03-12,27,27,27,0,493,494,493,1,4,1,1,2,176,176,175,175
Imperial,65,2023-03-12,233,233,233,0,2178,2184,2183,1,10,0,0,0,981,981,981,981
Inyo,65,2023-03-12,1,1,1,0,262,263,262,1,0,1,1,0,64,64,63,63
Kern,65,2023-03-12,330,330,330,0,7655,7672,7671,1,43,5,5,9,2510,2510,2505,2505
Kings,65,2023-03-12,69,69,69,0,1514,1518,1517,1,1,0,0,1,484,484,484,484
Lake,65,2023-03-12,12,12,12,0,407,408,407,1,1,0,0,0,163,163,163,163
Lassen,65,2023-03-12,5,5,5,0,351,352,351,1,0,0,0,0,66,66,66,66
Los Angeles,65,2023-03-12,4255,4264,4264,0,129430,129712,129711,1,438,45,45,53,35363,35363,35318,35318
Madera,65,2023-03-12,49,49,49,0,1203,1205,1204,1,6,0,0,0,382,382,382,382
Marin,65,2023-03-12,108,108,108,0,1702,1707,1706,1,24,1,1,1,268,268,267,267
Mariposa,65,2023-03-12,4,4,4,0,82,83,82,1,0,0,0,0,31,31,31,31
Mendocino,65,2023-03-12,18,18,18,0,473,474,473,1,4,0,0,1,149,149,149,149
Merced,65,2023-03-12,116,116,116,0,2133,2140,2139,1,10,3,3,2,912,912,909,909
Modoc,65,2023-03-12,1,1,1,0,12,13,12,1,0,0,0,0,11,11,11,11
Mono,65,2023-03-12,2,2,2,0,52,53,52,1,0,0,0,0,8,8,8,8
Monterey,65,2023-03-12,87,87,87,0,2048,2054,2053,1,25,2,2,1,813,813,811,811
Napa,65,2023-03-12,58,58,58,0,969,970,969,1,3,1,1,2,180,180,179,179
Nevada,65,2023-03-12,18,18,18,0,467,468,467,1,4,1,1,0,144,144,143,143
Orange,65,2023-03-12,930,930,930,0,19143,19185,19184,1,129,16,16,22,7989,7989,7973,7973
Placer,65,2023-03-12,170,170,170,0,2221,2228,2227,1,65,1,1,6,697,697,696,696
Plumas,65,2023-03-12,5,5,5,0,70,71,70,1,0,0,0,0,15,15,15,15
Riverside,65,2023-03-12,880,880,880,0,15437,15472,15471,1,75,9,9,15,6923,6923,6914,6914
Sacramento,65,2023-03-12,732,732,732,0,11649,11676,11675,1,108,9,9,12,3585,3585,3576,3576
San Benito,65,2023-03-12,11,11,11,0,453,454,453,1,0,0,0,0,117,117,117,117
San Bernardino,65,2023-03-12,685,685,685,0,15974,16010,16009,1,129,7,7,17,8271,8271,8264,8264
San Diego,65,2023-03-12,1359,1361,1361,0,24939,24994,24993,1,183,23,23,15,5949,5949,5926,5926
San Francisco,65,2023-03-12,549,549,549,0,10998,11023,11022,1,77,5,5,11,1188,1188,1183,1183
San Joaquin,65,2023-03-12,428,428,428,0,9784,9806,9805,1,38,4,4,4,2457,2457,2453,2453
San Luis Obispo,65,2023-03-12,93,93,93,0,1349,1351,1350,1,8,0,0,0,570,570,570,570
San Mateo,65,2023-03-12,386,386,386,0,7121,7138,7137,1,27,3,3,3,788,788,785,785
Santa Barbara,65,2023-03-12,158,158,158,0,3459,3467,3466,1,11,2,2,2,775,775,773,773
Santa Clara,65,2023-03-12,1114,1114,1114,0,28682,28747,28746,1,126,15,15,16,2807,2807,2792,2792
Santa Cruz,65,2023-03-12,116,116,116,0,3414,3424,3423,1,19,3,3,0,294,294,291,291
Shasta,65,2023-03-12,32,32,32,0,608,609,608,1,2,0,0,3,642,642,642,642
Siskiyou,65,2023-03-12,7,7,7,0,160,161,160,1,0,0,0,0,97,97,97,97
Solano,65,2023-03-12,227,227,227,0,3183,3189,3188,1,24,5,5,4,505,505,500,500
Sonoma,65,2023-03-12,190,190,190,0,2893,2900,2899,1,33,6,6,5,573,573,567,567
Stanislaus,65,2023-03-12,232,232,232,0,4432,4442,4441,1,52,3,3,6,1870,1870,1867,1867
Sutter,65,2023-03-12,24,24,24,0,531,532,531,1,0,0,0,0,244,244,244,244
Tehama,65,2023-03-12,14,14,14,0,231,232,231,1,3,0,0,0,234,234,234,234
Trinity,65,2023-03-12,0,0,0,0,23,24,23,1,0,0,0,0,26,26,26,26
Tulare,65,2023-03-12,171,171,171,0,3193,3201,3200,1,28,4,4,3,1607,1607,1603,1603
Tuolumne,65,2023-03-12,16,16,16,0,365,366,365,1,2,1,1,0,214,214,213,213
Ventura,65,2023-03-12,245,245,245,0,4451,4462,4461,1,30,6,6,2,1699,1699,1693,1693
Yolo,65,2023-03-12,69,69,69,0,1153,1155,1154,1,3,0,0,0,455,455,455,455
Yuba,65,2023-03-12,30,30,30,0,474,475,474,1,5,0,0,0,140,140,140,140
Alameda,66,2023-03-19,798,798,798,0,15918,15955,15954,1,66,4,4,10,2160,2160,2156,2156
Amador,66,2023-03-19,12,12,12,0,400,401,400,1,2,0,0,0,98,98,98,98
Butte,66,2023-03-19,40,40,40,0,524,525,524,1,4,0,0,3,506,506,506,506
Calaveras,66,2023-03-19,7,7,7,0,272,273,272,1,0,0,0,0,142,142,142,142
Colusa,66,2023-03-19,3,3,3,0,162,163,162,1,1,0,0,0,25,25,25,25
Contra Costa,66,2023-03-19,452,452,452,0,9855,9879,9878,1,32,7,7,2,1599,1599,1592,1592
Del Norte,66,2023-03-19,3,3,3,0,224,225,224,1,0,1,1,1,60,60,59,59
El Dorado,66,2023-03-19,38,38,38,0,891,892,891,1,0,0,0,0,258,258,258,258
Fresno,66,2023-03-19,388,388,388,0,7889,7909,7908,1,69,3,3,13,3011,3011,3008,3008
Glenn,66,2023-03-19,4,4,4,0,131,132,131,1,0,0,0,0,61,61,61,61
Humboldt,66,2023-03-19,28,28,28,0,500,501,500,1,4,0,0,2,176,176,176,176
Imperial,66,2023-03-19,177,177,177,0,1790,1796,1795,1,7,0,0,1,981,981,981,981
Inyo,66,2023-03-19,5,5,5,0,210,211,210,1,0,0,0,0,64,64,64,64
Kern,66,2023-03-19,234,234,234,0,8228,8248,8247,1,33,4,4,6,2514,2514,2510,2510
Kings,66,2023-03-19,48,48,48,0,1467,1470,1469,1,1,1,1,0,485,485,484,484
Lake,66,2023-03-19,12,12,12,0,426,427,426,1,1,0,0,1,163,163,163,163
Lassen,66,2023-03-19,6,6,6,0,339,340,339,1,0,0,0,0,66,66,66,66
Los Angeles,66,2023-03-19,3437,3445,3445,0,119756,120029,120028,1,399,38,38,48,35401,35401,35363,35363
Madera,66,2023-03-19,58,58,58,0,1141,1143,1142,1,5,1,1,0,383,383,382,382
Marin,66,2023-03-19,95,95,95,0,1633,1638,1637,1,22,1,1,2,269,269,268,268
Mariposa,66,2023-03-19,2,2,2,0,93,94,93,1,0,0,0,0,31,31,31,31
Mendocino,66,2023-03-19,9,9,9,0,417,418,417,1,3,0,0,0,149,149,149,149
Merced,66,2023-03-19,96,96,96,0,2183,2189,2188,1,4,0,0,1,912,912,912,912
Modoc,66,2023-03-19,0,0,0,0,8,9,8,1,0,0,0,0,11,11,11,11
Mono,66,2023-03-19,4,4,4,0,50,51,50,1,0,0,0,0,8,8,8,8
Monterey,66,2023-03-19,66,66,66,0,1562,1566,1565,1,18,1,1,1,814,814,813,813
Napa,66,2023-03-19,33,33,33,0,930,932,931,1,4,4,4,1,184,184,180,180
Nevada,66,2023-03-19,18,18,18,0,463,464,463,1,4,0,0,0,144,144,144,144
Orange,66,2023-03-19,797,797,797,0,17391,17432,17431,1,115,11,11,22,8000,8000,7989,7989
Placer,66,2023-03-19,131,131,131,0,2193,2199,2198,1,51,1,1,8,698,698,697,697
Plumas,66,2023-03-19,2,2,2,0,51,52,51,1,0,0,0,0,15,15,15,15
Riverside,66,2023-03-19,674,674,674,0,13607,13639,13638,1,63,9,9,9,6932,6932,6923,6923
Sacramento,66,2023-03-19,568,568,568,0,10827,10852,10851,1,90,4,4,16,3589,3589,3585,3585
San Benito,66,2023-03-19,23,23,23,0,491,492,491,1,0,1,1,0,118,118,117,117
San Bernardino,66,2023-03-19,595,595,595,0,15725,15761,15760,1,80,4,4,10,8275,8275,8271,8271
San Diego,66,2023-03-19,1156,1156,1156,0,24161,24217,24216,1,155,19,19,11,5968,5968,5949,5949
San Francisco,66,2023-03-19,451,451,451,0,10656,10680,10679,1,61,2,2,11,1190,1190,1188,1188
San Joaquin,66,2023-03-19,333,333,333,0,9126,9149,9148,1,29,8,8,3,2465,2465,2457,2457
San Luis Obispo,66,2023-03-19,48,48,48,0,1211,1213,1212,1,9,0,0,0,570,570,570,570
San Mateo,66,2023-03-19,322,322,322,0,6802,6818,6817,1,26,2,2,0,790,790,788,788
Santa Barbara,66,2023-03-19,116,116,116,0,3144,3152,3151,1,15,1,1,3,776,776,775,775
Santa Clara,66,2023-03-19,924,924,924,0,25730,25790,25789,1,136,12,12,25,2819,2819,2807,2807
Santa Cruz,66,2023-03-19,120,120,120,0,3119,3127,3126,1,9,4,4,1,298,298,294,294
Shasta,66,2023-03-19,18,18,18,0,629,630,629,1,3,1,1,2,643,643,642,642
Siskiyou,66,2023-03-19,7,7,7,0,172,173,172,1,0,0,0,0,97,97,97,97
Solano,66,2023-03-19,203,203,203,0,2998,3006,3005,1,30,2,2,5,507,507,505,505
Sonoma,66,2023-03-19,189,189,189,0,2812,2819,2818,1,34,2,2,3,575,575,573,573
Stanislaus,66,2023-03-19,192,192,192,0,4031,4041,4040,1,46,2,2,6,1872,1872,1870,1870
Sutter,66,2023-03-19,36,36,36,0,492,493,492,1,0,0,0,0,244,244,244,244
Tehama,66,2023-03-19,16,16,16,0,208,209,208,1,2,1,1,0,235,235,234,234
Trinity,66,2023-03-19,0,0,0,0,20,21,20,1,0,0,0,0,26,26,26,26
Tulare,66,2023-03-19,132,132,132,0,2817,2824,2823,1,22,1,1,1,1608,1608,1607,1607
Tuolumne,66,2023-03-19,17,17,17,0,410,411,410,1,0,0,0,0,214,214,214,214
Ventura,66,2023-03-19,179,179,179,0,4275,4286,4285,1,33,5,5,5,1704,1704,1699,1699
Yolo,66,2023-03-19,60,60,60,0,1172,1174,1173,1,4,0,0,0,455,455,455,455
Yuba,66,2023-03-19,23,23,23,0,479,480,479,1,6,0,0,0,140,140,140,140
Alameda,67,2023-03-26,617,617,617,0,14594,14630,14629,1,79,7,7,10,2167,2167,2160,2160
Amador,67,2023-03-26,14,14,14,0,401,402,401,1,1,0,0,0,98,98,98,98
Butte,67,2023-03-26,35,35,35,0,525,526,525,1,5,1,1,0,507,507,506,506
Calaveras,67,2023-03-26,10,10,10,0,267,268,267,1,0,1,1,0,143,143,142,142
Colusa,67,2023-03-26,5,5,5,0,163,164,163,1,0,0,0,0,25,25,25,25
Contra Costa,67,2023-03-26,407,407,407,0,9307,9331,9330,1,39,4,4,7,1603,1603,1599,1599
Del Norte,67,2023-03-26,5,5,5,0,218,219,218,1,0,0,0,0,60,60,60,60
El Dorado,67,2023-03-26,34,34,34,0,804,805,804,1,2,1,1,0,259,259,258,258
Fresno,67,2023-03-26,297,297,297,0,7579,7600,7599,1,60,2,2,6,3013,3013,3011,3011
Glenn,67,2023-03-26,5,5,5,0,135,136,135,1,0,0,0,0,61,61,61,61
Humboldt,67,2023-03-26,11,11,11,0,490,491,490,1,4,1,1,2,177,177,176,176
Imperial,67,2023-03-26,198,198,198,0,1892,1898,1897,1,13,1,1,2,982,982,981,981
Inyo,67,2023-03-26,15,15,15,0,301,302,301,1,0,1,1,0,65,65,64,64
Kern,67,2023-03-26,199,199,199,0,7781,7801,7800,1,30,2,2,3,2516,2516,2514,2514
Kings,67,2023-03-26,32,32,32,0,1380,1383,1382,1,1,0,0,0,485,485,485,485
Lake,67,2023-03-26,13,13,13,0,366,367,366,1,0,1,1,0,164,164,163,163
Lassen,67,2023-03-26,6,6,6,0,362,363,362,1,0,0,0,0,66,66,66,66
Los Angeles,67,2023-03-26,2580,2587,2587,0,109850,110115,110114,1,350,20,20,42,35421,35421,35401,35401
Madera,67,2023-03-26,41,41,41,0,1039,1040,1039,1,4,0,0,0,383,383,383,383
Marin,67,2023-03-26,80,80,80,0,1393,1399,1398,1,15,0,0,1,269,269,269,269
Mariposa,67,2023-03-26,1,1,1,0,79,80,79,1,0,1,1,0,32,32,31,31
Mendocino,67,2023-03-26,15,15,15,0,424,425,424,1,1,0,0,1,149,149,149,149
Merced,67,2023-03-26,113,113,113,0,2201,2208,2207,1,4,0,0,1,912,912,912,912
Modoc,67,2023-03-26,1,1,1,0,7,8,7,1,0,0,0,0,11,11,11,11
Mono,67,2023-03-26,1,1,1,0,51,52,51,1,0,0,0,0,8,8,8,8
Monterey,67,2023-03-26,46,46,46,0,1840,1846,1845,1,18,2,2,1,816,816,814,814
Napa,67,2023-03-26,38,38,38,0,883,885,884,1,3,0,0,1,184,184,184,184
Nevada,67,2023-03-26,22,22,22,0,480,481,480,1,3,0,0,0,144,144,144,144
Orange,67,2023-03-26,649,649,649,0,16251,16291,16290,1,104,6,6,17,8006,8006,8000,8000
Placer,67,2023-03-26,113,113,113,0,2011,2017,2016,1,35,3,3,6,701,701,698,698
Plumas,67,2023-03-26,1,1,1,0,63,64,63,1,0,0,0,0,15,15,15,15
Riverside,67,2023-03-26,569,569,569,0,11877,11906,11905,1,45,11,11,7,6943,6943,6932,6932
Sacramento,67,2023-03-26,439,439,439,0,10299,10323,10322,1,91,12,12,11,3601,3601,3589,3589
San Benito,67,2023-03-26,39,39,39,0,760,761,760,1,1,0,0,0,118,118,118,118
San Bernardino,67,2023-03-26,428,428,428,0,13887,13920,13919,1,81,8,8,10,8283,8283,8275,8275
San Diego,67,2023-03-26,918,918,918,0,21280,21333,21332,1,144,15,15,12,5983,5983,5968,5968
San Francisco,67,2023-03-26,398,398,398,0,11162,11189,11188,1,51,5,5,5,1195,1195,1190,1190
San Joaquin,67,2023-03-26,255,255,255,0,9255,9279,9278,1,22,5,5,9,2470,2470,2465,2465
San Luis Obispo,67,2023-03-26,45,45,45,0,1195,1197,1196,1,3,0,0,0,570,570,570,570
San Mateo,67,2023-03-26,271,271,271,0,6280,6296,6295,1,30,3,3,2,793,793,790,790
Santa Barbara,67,2023-03-26,84,84,84,0,3301,3309,3308,1,12,0,0,2,776,776,776,776
Santa Clara,67,2023-03-26,706,706,706,0,26776,26841,26840,1,109,11,11,17,2830,2830,2819,2819
Santa Cruz,67,2023-03-26,133,133,133,0,3154,3162,3161,1,8,3,3,1,301,301,298,298
Shasta,67,2023-03-26,16,16,16,0,517,518,517,1,3,1,1,2,644,644,643,643
Siskiyou,67,2023-03-26,2,2,2,0,159,160,159,1,0,0,0,0,97,97,97,97
Solano,67,2023-03-26,175,175,175,0,2802,2808,2807,1,20,3,3,3,510,510,507,507
Sonoma,67,2023-03-26,159,159,159,0,2388,2394,2393,1,34,2,2,1,577,577,575,575
Stanislaus,67,2023-03-26,153,153,153,0,3642,3651,3650,1,35,3,3,4,1875,1875,1872,1872
Sutter,67,2023-03-26,33,33,33,0,424,425,424,1,0,0,0,0,244,244,244,244
Tehama,67,2023-03-26,5,5,5,0,212,213,212,1,2,1,1,0,236,236,235,235
Trinity,67,2023-03-26,0,0,0,0,23,24,23,1,0,0,0,0,26,26,26,26
Tulare,67,2023-03-26,105,105,105,0,2804,2812,2811,1,24,0,0,1,1608,1608,1608,1608
Tuolumne,67,2023-03-26,8,8,8,0,347,348,347,1,0,0,0,0,214,214,214,214
Ventura,67,2023-03-26,142,142,142,0,4077,4088,4087,1,27,2,2,4,1706,1706,1704,1704
Yolo,67,2023-03-26,65,65,65,0,1193,1196,1195,1,4,1,1,0,456,456,455,455
Yuba,67,2023-03-26,15,15,15,0,446,447,446,1,0,0,0,0,140,140,140,140
Alameda,68,2023-04-02,567,567,567,0,13696,13732,13731,1,56,7,7,8,2174,2174,2167,2167
Amador,68,2023-04-02,16,16,16,0,321,322,321,1,1,0,0,0,98,98,98,98
Butte,68,2023-04-02,21,21,21,0,418,419,418,1,3,1,1,0,508,508,507,507
Calaveras,68,2023-04-02,9,9,9,0,251,252,251,1,0,0,0,0,143,143,143,143
Colusa,68,2023-04-02,8,8,8,0,172,173,172,1,2,0,0,0,25,25,25,25
Contra Costa,68,2023-04-02,381,381,381,0,8941,8965,8964,1,36,3,3,7,1606,1606,1603,1603
Del Norte,68,2023-04-02,5,5,5,0,209,210,209,1,0,0,0,0,60,60,60,60
El Dorado,68,2023-04-02,63,63,63,0,803,804,803,1,3,0,0,0,259,259,259,259
Fresno,68,2023-04-02,270,270,270,0,7326,7346,7345,1,53,5,5,12,3018,3018,3013,3013
Glenn,68,2023-04-02,4,4,4,0,125,126,125,1,0,0,0,0,61,61,61,61
Humboldt,68,2023-04-02,19,19,19,0,453,454,453,1,5,1,1,0,178,178,177,177
Imperial,68,2023-04-02,216,216,216,0,1719,1724,1723,1,15,0,0,2,982,982,982,982
Inyo,68,2023-04-02,1,1,1,0,145,146,145,1,0,0,0,0,65,65,65,65
Kern,68,2023-04-02,152,152,152,0,6190,6207,6206,1,26,5,5,2,2521,2521,2516,2516
Kings,68,2023-04-02,34,34,34,0,1129,1133,1132,1,5,1,1,0,486,486,485,485
Lake,68,2023-04-02,15,15,15,0,374,375,374,1,0,0,0,0,164,164,164,164
Lassen,68,2023-04-02,4,4,4,0,234,235,234,1,0,0,0,0,66,66,66,66
Los Angeles,68,2023-04-02,2456,2463,2463,0,100163,100418,100417,1,339,25,25,39,35446,35446,35421,35421
Madera,68,2023-04-02,36,36,36,0,911,912,911,1,1,1,1,0,384,384,383,383
Marin,68,2023-04-02,90,90,90,0,1312,1316,1315,1,16,0,0,0,269,269,269,269
Mariposa,68,2023-04-02,6,6,6,0,76,77,76,1,0,0,0,0,32,32,32,32
Mendocino,68,2023-04-02,17,17,17,0,372,373,372,1,0,1,1,1,150,150,149,149
Merced,68,2023-04-02,77,77,77,0,1855,1862,1861,1,4,1,1,0,913,913,912,912
Modoc,68,2023-04-02,4,4,4,0,9,10,9,1,0,0,0,0,11,11,11,11
Mono,68,2023-04-02,2,2,2,0,41,42,41,1,0,0,0,0,8,8,8,8
Monterey,68,2023-04-02,65,65,65,0,1684,1691,1690,1,15,3,3,1,819,819,816,816
Napa,68,2023-04-02,45,45,45,0,872,873,872,1,6,0,0,2,184,184,184,184
Nevada,68,2023-04-02,48,48,48,0,473,474,473,1,6,0,0,0,144,144,144,144
Orange,68,2023-04-02,651,651,651,0,15686,15727,15726,1,94,9,9,13,8015,8015,8006,8006
Placer,68,2023-04-02,105,105,105,0,1922,1928,1927,1,38,3,3,4,704,704,701,701
Plumas,68,2023-04-02,2,2,2,0,64,65,64,1,0,0,0,0,15,15,15,15
Riverside,68,2023-04-02,456,456,456,0,11263,11292,11291,1,57,6,6,7,6949,6949,6943,6943
Sacramento,68,2023-04-02,511,511,511,0,9784,9809,9808,1,66,2,2,17,3603,3603,3601,3601
San Benito,68,2023-04-02,28,28,28,0,705,708,707,1,0,0,0,0,118,118,118,118
San Bernardino,68,2023-04-02,463,463,463,0,12944,12978,12977,1,62,6,6,11,8289,8289,8283,8283
San Diego,68,2023-04-02,780,780,780,0,20052,20105,20104,1,137,11,11,13,5994,5994,5983,5983
San Francisco,68,2023-04-02,355,355,355,0,10121,10146,10145,1,35,4,4,10,1199,1199,1195,1195
San Joaquin,68,2023-04-02,241,241,241,0,8894,8917,8916,1,30,5,5,9,2475,2475,2470,2470
San Luis Obispo,68,2023-04-02,41,41,41,0,1048,1050,1049,1,3,2,2,0,572,572,570,570
San Mateo,68,2023-04-02,272,272,272,0,6030,6047,6046,1,26,2,2,0,795,795,793,793
Santa Barbara,68,2023-04-02,99,99,99,0,2733,2741,2740,1,14,1,1,1,777,777,776,776
Santa Clara,68,2023-04-02,722,722,722,0,26443,26511,26510,1,76,4,4,12,2834,2834,2830,2830
Santa Cruz,68,2023-04-02,130,130,130,0,2681,2687,2686,1,15,2,2,0,303,303,301,301
Shasta,68,2023-04-02,16,16,16,0,517,518,517,1,2,2,2,1,646,646,644,644
Siskiyou,68,2023-04-02,0,0,0,0,94,95,94,1,0,0,0,0,97,97,97,97
Solano,68,2023-04-02,148,148,148,0,2594,2600,2599,1,21,1,1,2,511,511,510,510
Sonoma,68,2023-04-02,138,138,138,0,2211,2217,2216,1,25,3,3,2,580,580,577,577
Stanislaus,68,2023-04-02,131,131,131,0,3442,3451,3450,1,35,1,1,3,1876,1876,1875,1875
Sutter,68,2023-04-02,35,35,35,0,396,397,396,1,0,0,0,0,244,244,244,244
Tehama,68,2023-04-02,11,11,11,0,191,192,191,1,0,0,0,0,236,236,236,236
Trinity,68,2023-04-02,0,0,0,0,17,18,17,1,0,0,0,0,26,26,26,26
Tulare,68,2023-04-02,104,104,104,0,2771,2779,2778,1,21,0,0,0,1608,1608,1608,1608
Tuolumne,68,2023-04-02,7,7,7,0,285,286,285,1,1,0,0,0,214,214,214,214
Ventura,68,2023-04-02,145,145,145,0,3693,3704,3703,1,26,6,6,1,1712,1712,1706,1706
Yolo,68,2023-04-02,41,41,41,0,1033,1035,1034,1,4,1,1,1,457,457,456,456
Yuba,68,2023-04-02,19,19,19,0,407,408,407,1,1,0,0,0,140,140,140,140
Alameda,69,2023-04-09,552,552,552,0,11946,11980,11979,1,56,8,8,10,2182,2182,2174,2174
Amador,69,2023-04-09,8,8,8,0,241,242,241,1,1,0,0,0,98,98,98,98
Butte,69,2023-04-09,18,18,18,0,459,460,459,1,5,2,2,0,510,510,508,508
Calaveras,69,2023-04-09,10,10,10,0,232,233,232,1,0,0,0,0,143,143,143,143
Colusa,69,2023-04-09,2,2,2,0,154,155,154,1,1,0,0,0,25,25,25,25
Contra Costa,69,2023-04-09,405,405,405,0,8512,8536,8535,1,34,4,4,6,1610,1610,1606,1606
Del Norte,69,2023-04-09,3,3,3,0,133,134,133,1,0,1,1,0,61,61,60,60
El Dorado,69,2023-04-09,44,44,44,0,676,677,676,1,3,1,1,0,260,260,259,259
Fresno,69,2023-04-09,267,267,267,0,6373,6392,6391,1,59,2,2,3,3020,3020,3018,3018
Glenn,69,2023-04-09,5,5,5,0,133,134,133,1,1,0,0,0,61,61,61,61
Humboldt,69,2023-04-09,17,17,17,0,431,432,431,1,4,1,1,0,179,179,178,178
Imperial,69,2023-04-09,174,174,174,0,1445,1450,1449,1,6,1,1,0,983,983,982,982
Inyo,69,2023-04-09,6,6,6,0,173,174,173,1,0,0,0,0,65,65,65,65
Kern,69,2023-04-09,147,147,147,0,5560,5576,5575,1,23,1,1,3,2522,2522,2521,2521
Kings,69,2023-04-09,38,38,38,0,897,899,898,1,3,0,0,1,486,486,486,486
Lake,69,2023-04-09,13,13,13,0,308,309,308,1,0,0,0,0,164,164,164,164
Lassen,69,2023-04-09,0,0,0,0,150,151,150,1,0,1,1,0,67,67,66,66
Los Angeles,69,2023-04-09,2300,2307,2307,0,89020,89261,89260,1,318,21,21,39,35467,35467,35446,35446
Madera,69,2023-04-09,70,70,70,0,882,883,882,1,0,1,1,0,385,385,384,384
Marin,69,2023-04-09,103,103,103,0,1179,1183,1182,1,14,0,0,2,269,269,269,269
Mariposa,69,2023-04-09,3,3,3,0,57,58,57,1,0,0,0,0,32,32,32,32
Mendocino,69,2023-04-09,12,12,12,0,355,356,355,1,2,1,1,1,151,151,150,150
Merced,69,2023-04-09,59,59,59,0,2167,2175,2174,1,4,1,1,1,914,914,913,913
Modoc,69,2023-04-09,1,1,1,0,9,10,9,1,0,0,0,0,11,11,11,11
Mono,69,2023-04-09,1,1,1,0,41,42,41,1,0,0,0,0,8,8,8,8
Monterey,69,2023-04-09,50,50,50,0,1678,1683,1682,1,11,1,1,1,820,820,819,819
Napa,69,2023-04-09,27,27,27,0,669,670,669,1,3,0,0,0,184,184,184,184
Nevada,69,2023-04-09,49,49,49,0,359,360,359,1,2,1,1,0,145,145,144,144
Orange,69,2023-04-09,573,573,573,0,15653,15697,15696,1,74,12,12,14,8027,8027,8015,8015
Placer,69,2023-04-09,97,97,97,0,1627,1633,1632,1,34,2,2,5,706,706,704,704
Plumas,69,2023-04-09,3,3,3,0,40,41,40,1,0,0,0,0,15,15,15,15
Riverside,69,2023-04-09,421,421,421,0,11602,11635,11634,1,56,2,2,5,6951,6951,6949,6949
Sacramento,69,2023-04-09,459,459,459,0,8811,8836,8835,1,84,5,5,13,3608,3608,3603,3603
San Benito,69,2023-04-09,25,25,25,0,491,492,491,1,2,0,0,0,118,118,118,118
San Bernardino,69,2023-04-09,485,485,485,0,12996,13031,13030,1,72,7,7,11,8296,8296,8289,8289
San Diego,69,2023-04-09,823,823,823,0,21024,21081,21080,1,127,16,16,21,6010,6010,5994,5994
San Francisco,69,2023-04-09,290,290,290,0,9111,9137,9136,1,38,6,6,6,1205,1205,1199,1199
San Joaquin,69,2023-04-09,209,209,209,0,8127,8151,8150,1,20,5,5,7,2480,2480,2475,2475
San Luis Obispo,69,2023-04-09,58,58,58,0,965,966,965,1,3,2,2,1,574,574,572,572
San Mateo,69,2023-04-09,228,228,228,0,5560,5575,5574,1,13,0,0,2,795,795,795,795
Santa Barbara,69,2023-04-09,94,94,94,0,2818,2826,2825,1,17,1,1,3,778,778,777,777
Santa Clara,69,2023-04-09,689,689,689,0,24295,24360,24359,1,85,10,10,14,2844,2844,2834,2834
Santa Cruz,69,2023-04-09,104,104,104,0,1750,1755,1754,1,17,2,2,1,305,305,303,303
Shasta,69,2023-04-09,23,23,23,0,510,511,510,1,5,0,0,1,646,646,646,646
Siskiyou,69,2023-04-09,9,9,9,0,114,115,114,1,0,0,0,0,97,97,97,97
Solano,69,2023-04-09,120,120,120,0,2116,2122,2121,1,17,1,1,3,512,512,511,511
Sonoma,69,2023-04-09,125,125,125,0,2049,2055,2054,1,17,6,6,1,586,586,580,580
Stanislaus,69,2023-04-09,133,133,133,0,3124,3133,3132,1,25,1,1,2,1877,1877,1876,1876
Sutter,69,2023-04-09,34,34,34,0,428,429,428,1,0,0,0,0,244,244,244,244
Tehama,69,2023-04-09,5,5,5,0,169,170,169,1,1,0,0,0,236,236,236,236
Trinity,69,2023-04-09,2,2,2,0,13,14,13,1,0,0,0,0,26,26,26,26
Tulare,69,2023-04-09,80,80,80,0,2436,2444,2443,1,12,0,0,1,1608,1608,1608,1608
Tuolumne,69,2023-04-09,4,4,4,0,232,233,232,1,0,0,0,0,214,214,214,214
Ventura,69,2023-04-09,149,149,149,0,3335,3346,3345,1,29,0,0,1,1712,1712,1712,1712
Yolo,69,2023-04-09,59,59,59,0,1030,1032,1031,1,3,0,0,0,457,457,457,457
Yuba,69,2023-04-09,24,24,24,0,402,403,402,1,4,0,0,0,140,140,140,140
Alameda,70,2023-04-16,580,580,580,0,11720,11756,11755,1,62,7,7,8,2189,2189,2182,2182
Amador,70,2023-04-16,18,18,18,0,222,223,222,1,0,0,0,0,98,98,98,98
Butte,70,2023-04-16,33,33,33,0,478,479,478,1,7,2,2,0,512,512,510,510
Calaveras,70,2023-04-16,8,8,8,0,198,199,198,1,0,0,0,0,143,143,143,143
Colusa,70,2023-04-16,1,1,1,0,47,48,47,1,0,1,1,0,26,26,25,25
Contra Costa,70,2023-04-16,398,398,398,0,8016,8040,8039,1,34,5,5,3,1615,1615,1610,1610
Del Norte,70,2023-04-16,1,1,1,0,112,113,112,1,0,0,0,0,61,61,61,61
El Dorado,70,2023-04-16,44,44,44,0,655,656,655,1,1,0,0,0,260,260,260,260
Fresno,70,2023-04-16,254,254,254,0,6371,6391,6390,1,55,2,2,5,3022,3022,3020,3020
Glenn,70,2023-04-16,7,7,7,0,123,124,123,1,0,0,0,0,61,61,61,61
Humboldt,70,2023-04-16,9,9,9,0,388,389,388,1,3,0,0,0,179,179,179,179
Imperial,70,2023-04-16,211,211,211,0,1314,1320,1319,1,9,1,1,0,984,984,983,983
Inyo,70,2023-04-16,4,4,4,0,156,157,156,1,0,0,0,0,65,65,65,65
Kern,70,2023-04-16,151,151,151,0,4365,4379,4378,1,18,1,1,6,2523,2523,2522,2522
Kings,70,2023-04-16,55,55,55,0,860,862,861,1,1,1,1,0,487,487,486,486
Lake,70,2023-04-16,18,18,18,0,294,295,294,1,1,0,0,0,164,164,164,164
Lassen,70,2023-04-16,2,2,2,0,103,104,103,1,0,0,0,0,67,67,67,67
Los Angeles,70,2023-04-16,2417,2425,2425,0,98712,99000,98999,1,280,29,29,28,35496,35496,35467,35467
Madera,70,2023-04-16,72,72,72,0,929,930,929,1,0,0,0,0,385,385,385,385
Marin,70,2023-04-16,72,72,72,0,1012,1015,1014,1,15,2,2,3,271,271,269,269
Mariposa,70,2023-04-16,2,2,2,0,58,59,58,1,0,0,0,0,32,32,32,32
Mendocino,70,2023-04-16,23,23,23,0,322,323,322,1,1,0,0,1,151,151,151,151
Merced,70,2023-04-16,55,55,55,0,1500,1506,1505,1,8,0,0,0,914,914,914,914
Modoc,70,2023-04-16,1,1,1,0,4,5,4,1,0,0,0,0,11,11,11,11
Mono,70,2023-04-16,1,1,1,0,43,44,43,1,0,0,0,0,8,8,8,8
Monterey,70,2023-04-16,43,43,43,0,1510,1517,1516,1,15,0,0,0,820,820,820,820
Napa,70,2023-04-16,36,36,36,0,752,753,752,1,4,1,1,1,185,185,184,184
Nevada,70,2023-04-16,29,29,29,0,341,342,341,1,5,0,0,0,145,145,145,145
Orange,70,2023-04-16,536,536,536,0,15694,15741,15740,1,81,12,12,11,8039,8039,8027,8027
Placer,70,2023-04-16,94,94,94,0,1597,1603,1602,1,40,2,2,4,708,708,706,706
Plumas,70,2023-04-16,4,4,4,0,49,50,49,1,0,0,0,0,15,15,15,15
Riverside,70,2023-04-16,401,401,401,0,11576,11610,11609,1,56,5,5,4,6956,6956,6951,6951
Sacramento,70,2023-04-16,500,500,500,0,8292,8317,8316,1,74,2,2,10,3610,3610,3608,3608
San Benito,70,2023-04-16,13,13,13,0,501,502,501,1,0,0,0,0,118,118,118,118
San Bernardino,70,2023-04-16,463,463,463,0,12173,12210,12209,1,58,5,5,10,8301,8301,8296,8296
San Diego,70,2023-04-16,844,844,844,0,20325,20385,20384,1,131,9,9,18,6019,6019,6010,6010
San Francisco,70,2023-04-16,330,330,330,0,10096,10126,10125,1,43,4,4,7,1209,1209,1205,1205
San Joaquin,70,2023-04-16,159,159,159,0,8141,8167,8166,1,18,1,1,5,2481,2481,2480,2480
San Luis Obispo,70,2023-04-16,63,63,63,0,921,922,921,1,9,0,0,0,574,574,574,574
San Mateo,70,2023-04-16,198,198,198,0,5694,5710,5709,1,20,2,2,4,797,797,795,795
Santa Barbara,70,2023-04-16,117,117,117,0,2738,2747,2746,1,16,3,3,3,781,781,778,778
Santa Clara,70,2023-04-16,652,652,652,0,23983,24054,24053,1,85,6,6,15,2850,2850,2844,2844
Santa Cruz,70,2023-04-16,99,99,99,0,2388,2394,2393,1,20,2,2,0,307,307,305,305
Shasta,70,2023-04-16,30,30,30,0,533,534,533,1,5,0,0,1,646,646,646,646
Siskiyou,70,2023-04-16,7,7,7,0,82,83,82,1,0,0,0,1,97,97,97,97
Solano,70,2023-04-16,166,166,166,0,2008,2014,2013,1,33,1,1,2,513,513,512,512
Sonoma,70,2023-04-16,150,150,150,0,2128,2135,2134,1,31,4,4,5,590,590,586,586
Stanislaus,70,2023-04-16,119,119,119,0,2840,2848,2847,1,25,2,2,3,1879,1879,1877,1877
Sutter,70,2023-04-16,18,18,18,0,319,320,319,1,0,0,0,0,244,244,244,244
Tehama,70,2023-04-16,13,13,13,0,176,177,176,1,2,0,0,0,236,236,236,236
Trinity,70,2023-04-16,0,0,0,0,15,16,15,1,0,0,0,0,26,26,26,26
Tulare,70,2023-04-16,105,105,105,0,2387,2395,2394,1,13,1,1,1,1609,1609,1608,1608
Tuolumne,70,2023-04-16,6,6,6,0,225,226,225,1,0,0,0,0,214,214,214,214
Ventura,70,2023-04-16,114,114,114,0,3396,3407,3406,1,26,2,2,2,1714,1714,1712,1712
Yolo,70,2023-04-16,62,62,62,0,811,812,811,1,2,1,1,0,458,458,457,457
Yuba,70,2023-04-16,15,15,15,0,308,309,308,1,5,0,0,1,140,140,140,140
Alameda,71,2023-04-23,556,556,556,0,11024,11060,11059,1,68,3,3,5,2192,2192,2189,2189
Amador,71,2023-04-23,16,16,16,0,206,207,206,1,1,0,0,0,98,98,98,98
Butte,71,2023-04-23,35,35,35,0,477,478,477,1,11,4,4,1,516,516,512,512
Calaveras,71,2023-04-23,6,6,6,0,208,209,208,1,0,0,0,0,143,143,143,143
Colusa,71,2023-04-23,1,1,1,0,38,39,38,1,0,0,0,0,26,26,26,26
Contra Costa,71,2023-04-23,373,373,373,0,7611,7636,7635,1,42,7,7,6,1622,1622,1615,1615
Del Norte,71,2023-04-23,3,3,3,0,94,95,94,1,0,0,0,0,61,61,61,61
El Dorado,71,2023-04-23,45,45,45,0,652,654,653,1,3,1,1,0,261,261,260,260
Fresno,71,2023-04-23,230,230,230,0,6119,6139,6138,1,58,4,4,7,3026,3026,3022,3022
Glenn,71,2023-04-23,3,3,3,0,108,109,108,1,0,0,0,0,61,61,61,61
Humboldt,71,2023-04-23,7,7,7,0,270,271,270,1,0,0,0,0,179,179,179,179
Imperial,71,2023-04-23,154,154,154,0,1264,1270,1269,1,4,1,1,0,985,985,984,984
Inyo,71,2023-04-23,4,4,4,0,152,153,152,1,0,0,0,0,65,65,65,65
Kern,71,2023-04-23,92,92,92,0,3744,3757,3756,1,15,1,1,4,2524,2524,2523,2523
Kings,71,2023-04-23,25,25,25,0,756,758,757,1,1,0,0,0,487,487,487,487
Lake,71,2023-04-23,12,12,12,0,319,320,319,1,0,0,0,2,164,164,164,164
Lassen,71,2023-04-23,1,1,1,0,105,106,105,1,0,0,0,0,67,67,67,67
Los Angeles,71,2023-04-23,1942,1949,1949,0,95195,95493,95492,1,241,21,21,26,35517,35517,35496,35496
Madera,71,2023-04-23,29,29,29,0,768,769,768,1,2,0,0,0,385,385,385,385
Marin,71,2023-04-23,68,68,68,0,962,965,964,1,15,1,1,1,272,272,271,271
Mariposa,71,2023-04-23,4,4,4,0,52,53,52,1,0,0,0,0,32,32,32,32
Mendocino,71,2023-04-23,10,10,10,0,272,273,272,1,2,1,1,0,152,152,151,151
Merced,71,2023-04-23,59,59,59,0,1470,1476,1475,1,7,0,0,0,914,914,914,914
Modoc,71,2023-04-23,2,2,2,0,8,9,8,1,0,0,0,0,11,11,11,11
Mono,71,2023-04-23,1,1,1,0,43,44,43,1,0,0,0,0,8,8,8,8
Monterey,71,2023-04-23,58,58,58,0,1631,1638,1637,1,16,0,0,2,820,820,820,820
Napa,71,2023-04-23,27,27,27,0,717,719,718,1,2,0,0,1,185,185,185,185
Nevada,71,2023-04-23,28,28,28,0,337,338,337,1,2,0,0,0,145,145,145,145
Orange,71,2023-04-23,528,528,528,0,14406,14452,14451,1,81,7,7,12,8046,8046,8039,8039
Placer,71,2023-04-23,110,110,110,0,1451,1458,1457,1,35,4,4,3,712,712,708,708
Plumas,71,2023-04-23,2,2,2,0,74,75,74,1,1,0,0,0,15,15,15,15
Riverside,71,2023-04-23,327,327,327,0,11648,11686,11685,1,54,7,7,6,6963,6963,6956,6956
Sacramento,71,2023-04-23,487,487,487,0,8206,8231,8230,1,64,5,5,7,3615,3615,3610,3610
San Benito,71,2023-04-23,9,9,9,0,432,433,432,1,1,0,0,0,118,118,118,118
San Bernardino,71,2023-04-23,414,414,414,0,11312,11348,11347,1,130,2,2,14,8303,8303,8301,8301
San Diego,71,2023-04-23,726,727,727,0,19187,19247,19246,1,114,9,9,16,6028,6028,6019,6019
San Francisco,71,2023-04-23,324,324,324,0,8325,8351,8350,1,52,4,4,7,1213,1213,1209,1209
San Joaquin,71,2023-04-23,170,170,170,0,8815,8843,8842,1,23,2,2,1,2483,2483,2481,2481
San Luis Obispo,71,2023-04-23,38,38,38,0,832,833,832,1,8,1,1,0,575,575,574,574
San Mateo,71,2023-04-23,189,189,189,0,5043,5060,5059,1,18,2,2,4,799,799,797,797
Santa Barbara,71,2023-04-23,109,109,109,0,2855,2865,2864,1,13,7,7,3,788,788,781,781
Santa Clara,71,2023-04-23,565,565,565,0,20251,20314,20313,1,86,9,9,17,2859,2859,2850,2850
Santa Cruz,71,2023-04-23,66,66,66,0,1776,1782,1781,1,23,3,3,2,310,310,307,307
Shasta,71,2023-04-23,19,19,19,0,423,424,423,1,3,0,0,0,646,646,646,646
Siskiyou,71,2023-04-23,6,6,6,0,95,96,95,1,2,0,0,0,97,97,97,97
Solano,71,2023-04-23,142,142,142,0,2096,2104,2103,1,18,1,1,4,514,514,513,513
Sonoma,71,2023-04-23,176,176,176,0,2139,2147,2146,1,28,3,3,1,593,593,590,590
Stanislaus,71,2023-04-23,104,104,104,0,2898,2908,2907,1,19,9,9,3,1888,1888,1879,1879
Sutter,71,2023-04-23,28,28,28,0,278,279,278,1,0,1,1,0,245,245,244,244
Tehama,71,2023-04-23,7,7,7,0,156,157,156,1,0,2,2,0,238,238,236,236
Trinity,71,2023-04-23,2,2,2,0,16,17,16,1,0,0,0,0,26,26,26,26
Tulare,71,2023-04-23,74,74,74,0,2150,2158,2157,1,15,2,2,0,1611,1611,1609,1609
Tuolumne,71,2023-04-23,4,4,4,0,185,186,185,1,0,1,1,0,215,215,214,214
Ventura,71,2023-04-23,132,132,132,0,3204,3216,3215,1,25,0,0,1,1714,1714,1714,1714
Yolo,71,2023-04-23,38,38,38,0,894,897,896,1,2,1,1,0,459,459,458,458
Yuba,71,2023-04-23,17,17,17,0,275,276,275,1,5,0,0,0,140,140,140,140
Alameda,72,2023-04-30,478,478,478,0,10164,10200,10199,1,69,4,4,5,2196,2196,2192,2192
Amador,72,2023-04-30,7,7,7,0,155,156,155,1,1,0,0,0,98,98,98,98
Butte,72,2023-04-30,28,28,28,0,421,423,422,1,20,1,1,0,517,517,516,516
Calaveras,72,2023-04-30,4,4,4,0,176,177,176,1,1,0,0,0,143,143,143,143
Colusa,72,2023-04-30,4,4,4,0,50,51,50,1,0,0,0,0,26,26,26,26
Contra Costa,72,2023-04-30,364,364,364,0,7332,7358,7357,1,40,6,6,4,1628,1628,1622,1622
Del Norte,72,2023-04-30,3,3,3,0,102,103,102,1,0,0,0,0,61,61,61,61
El Dorado,72,2023-04-30,40,40,40,0,625,626,625,1,2,0,0,1,261,261,261,261
Fresno,72,2023-04-30,278,278,278,0,6025,6046,6045,1,59,3,3,9,3029,3029,3026,3026
Glenn,72,2023-04-30,4,4,4,0,114,115,114,1,0,0,0,0,61,61,61,61
Humboldt,72,2023-04-30,11,11,11,0,260,261,260,1,0,0,0,0,179,179,179,179
Imperial,72,2023-04-30,106,106,106,0,1174,1180,1179,1,11,0,0,0,985,985,985,985
Inyo,72,2023-04-30,10,10,10,0,163,164,163,1,0,0,0,0,65,65,65,65
Kern,72,2023-04-30,81,81,81,0,4052,4069,4068,1,13,1,1,2,2525,2525,2524,2524
Kings,72,2023-04-30,36,36,36,0,720,722,721,1,0,0,0,0,487,487,487,487
Lake,72,2023-04-30,10,10,10,0,302,303,302,1,1,0,0,0,164,164,164,164
Lassen,72,2023-04-30,2,2,2,0,106,107,106,1,0,0,0,0,67,67,67,67
Los Angeles,72,2023-04-30,1924,1931,1931,0,93048,93371,93370,1,239,16,16,30,35533,35533,35517,35517
Madera,72,2023-04-30,53,53,53,0,829,831,830,1,1,0,0,0,385,385,385,385
Marin,72,2023-04-30,65,65,65,0,881,885,884,1,9,4,4,1,276,276,272,272
Mariposa,72,2023-04-30,2,2,2,0,65,66,65,1,0,0,0,0,32,32,32,32
Mendocino,72,2023-04-30,11,11,11,0,233,234,233,1,0,0,0,0,152,152,152,152
Merced,72,2023-04-30,46,46,46,0,818,820,819,1,1,0,0,1,914,914,914,914
Modoc,72,2023-04-30,5,5,5,0,9,10,9,1,0,0,0,0,11,11,11,11
Mono,72,2023-04-30,2,2,2,0,35,36,35,1,0,0,0,0,8,8,8,8
Monterey,72,2023-04-30,65,65,65,0,1756,1764,1763,1,16,0,0,1,820,820,820,820
Napa,72,2023-04-30,33,33,33,0,650,651,650,1,2,1,1,0,186,186,185,185
Nevada,72,2023-04-30,31,31,31,0,242,243,242,1,5,1,1,0,146,146,145,145
Orange,72,2023-04-30,440,440,440,0,14361,14413,14412,1,63,2,2,13,8048,8048,8046,8046
Placer,72,2023-04-30,101,101,101,0,1499,1506,1505,1,39,0,0,1,712,712,712,712
Plumas,72,2023-04-30,8,8,8,0,50,51,50,1,0,0,0,0,15,15,15,15
Riverside,72,2023-04-30,295,295,295,0,10887,10926,10925,1,48,5,5,8,6968,6968,6963,6963
Sacramento,72,2023-04-30,529,529,529,0,7915,7944,7943,1,63,6,6,7,3621,3621,3615,3615
San Benito,72,2023-04-30,15,15,15,0,356,357,356,1,0,0,0,0,118,118,118,118
San Bernardino,72,2023-04-30,364,364,364,0,11323,11363,11362,1,53,4,4,10,8307,8307,8303,8303
San Diego,72,2023-04-30,631,631,631,0,18153,18217,18216,1,112,2,2,9,6030,6030,6028,6028
San Francisco,72,2023-04-30,280,280,280,0,7901,7929,7928,1,42,5,5,4,1218,1218,1213,1213
San Joaquin,72,2023-04-30,158,158,158,0,8135,8164,8163,1,22,1,1,2,2484,2484,2483,2483
San Luis Obispo,72,2023-04-30,41,41,41,0,784,786,785,1,4,1,1,0,576,576,575,575
San Mateo,72,2023-04-30,201,201,201,0,4967,4985,4984,1,19,0,0,1,799,799,799,799
Santa Barbara,72,2023-04-30,79,79,79,0,2479,2489,2488,1,14,1,1,2,789,789,788,788
Santa Clara,72,2023-04-30,612,612,612,0,18667,18731,18730,1,92,7,7,18,2866,2866,2859,2859
Santa Cruz,72,2023-04-30,53,53,53,0,1674,1680,1679,1,13,3,3,1,313,313,310,310
Shasta,72,2023-04-30,10,10,10,0,386,387,386,1,3,1,1,1,647,647,646,646
Siskiyou,72,2023-04-30,10,10,10,0,101,102,101,1,2,1,1,0,98,98,97,97
Solano,72,2023-04-30,103,103,103,0,1908,1916,1915,1,18,4,4,4,518,518,514,514
Sonoma,72,2023-04-30,109,109,109,0,1936,1944,1943,1,13,5,5,1,598,598,593,593
Stanislaus,72,2023-04-30,95,95,95,0,2351,2360,2359,1,23,5,5,4,1893,1893,1888,1888
Sutter,72,2023-04-30,13,13,13,0,242,243,242,1,0,0,0,0,245,245,245,245
Tehama,72,2023-04-30,9,9,9,0,143,144,143,1,0,0,0,0,238,238,238,238
Trinity,72,2023-04-30,2,2,2,0,10,11,10,1,0,0,0,0,26,26,26,26
Tulare,72,2023-04-30,78,78,78,0,2026,2033,2032,1,10,3,3,0,1614,1614,1611,1611
Tuolumne,72,2023-04-30,9,9,9,0,188,189,188,1,0,0,0,0,215,215,215,215
Ventura,72,2023-04-30,130,130,130,0,2757,2768,2767,1,23,0,0,1,1714,1714,1714,1714
Yolo,72,2023-04-30,47,47,47,0,923,926,925,1,4,0,0,1,459,459,459,459
Yuba,72,2023-04-30,20,20,20,0,267,268,267,1,3,0,0,0,140,140,140,140
Alameda,73,2023-05-07,439,439,439,0,9292,9330,9329,1,55,2,2,7,2198,2198,2196,2196
Amador,73,2023-05-07,7,7,7,0,163,164,163,1,1,0,0,0,98,98,98,98
Butte,73,2023-05-07,24,24,24,0,493,495,494,1,8,1,1,0,518,518,517,517
Calaveras,73,2023-05-07,5,5,5,0,193,194,193,1,1,0,0,0,143,143,143,143
Colusa,73,2023-05-07,2,2,2,0,32,33,32,1,1,0,0,0,26,26,26,26
Contra Costa,73,2023-05-07,246,246,246,0,6320,6347,6346,1,34,5,5,7,1633,1633,1628,1628
Del Norte,73,2023-05-07,6,6,6,0,91,92,91,1,0,0,0,0,61,61,61,61
El Dorado,73,2023-05-07,28,28,28,0,523,525,524,1,0,3,3,0,264,264,261,261
Fresno,73,2023-05-07,202,202,202,0,5415,5437,5436,1,54,5,5,6,3034,3034,3029,3029
Glenn,73,2023-05-07,7,7,7,0,115,116,115,1,1,0,0,0,61,61,61,61
Humboldt,73,2023-05-07,13,13,13,0,228,229,228,1,0,1,1,0,180,180,179,179
Imperial,73,2023-05-07,84,84,84,0,1025,1031,1030,1,2,1,1,1,986,986,985,985
Inyo,73,2023-05-07,4,4,4,0,156,157,156,1,0,0,0,0,65,65,65,65
Kern,73,2023-05-07,93,93,93,0,4034,4050,4049,1,10,2,2,4,2527,2527,2525,2525
Kings,73,2023-05-07,29,29,29,0,669,671,670,1,1,0,0,0,487,487,487,487
Lake,73,2023-05-07,7,7,7,0,281,282,281,1,1,0,0,0,164,164,164,164
Lassen,73,2023-05-07,8,8,8,0,109,110,109,1,0,0,0,0,67,67,67,67
Los Angeles,73,2023-05-07,1877,1884,1884,0,81477,81796,81795,1,220,19,19,21,35552,35552,35533,35533
Madera,73,2023-05-07,35,35,35,0,691,692,691,1,0,0,0,0,385,385,385,385
Marin,73,2023-05-07,58,58,58,0,817,820,819,1,9,1,1,2,277,277,276,276
Mariposa,73,2023-05-07,0,0,0,0,53,54,53,1,0,0,0,0,32,32,32,32
Mendocino,73,2023-05-07,7,7,7,0,248,249,248,1,0,1,1,0,153,153,152,152
Merced,73,2023-05-07,37,37,37,0,1467,1474,1473,1,4,0,0,0,914,914,914,914
Modoc,73,2023-05-07,10,10,10,0,11,12,11,1,0,1,1,0,12,12,11,11
Mono,73,2023-05-07,0,0,0,0,40,41,40,1,0,0,0,0,8,8,8,8
Monterey,73,2023-05-07,44,44,44,0,1632,1640,1639,1,13,2,2,0,822,822,820,820
Napa,73,2023-05-07,45,45,45,0,701,704,703,1,1,0,0,0,186,186,186,186
Nevada,73,2023-05-07,24,24,24,0,241,242,241,1,5,1,1,1,147,147,146,146
Orange,73,2023-05-07,435,435,435,0,13941,13997,13996,1,67,1,1,7,8049,8049,8048,8048
Placer,73,2023-05-07,112,112,112,0,1380,1387,1386,1,33,3,3,1,715,715,712,712
Plumas,73,2023-05-07,6,6,6,0,49,50,49,1,1,0,0,0,15,15,15,15
Riverside,73,2023-05-07,280,280,280,0,10638,10680,10679,1,44,7,7,3,6975,6975,6968,6968
Sacramento,73,2023-05-07,373,373,373,0,7120,7149,7148,1,60,1,1,8,3622,3622,3621,3621
San Benito,73,2023-05-07,9,9,9,0,330,331,330,1,1,1,1,0,119,119,118,118
San Bernardino,73,2023-05-07,291,291,291,0,10881,10924,10923,1,60,2,2,10,8309,8309,8307,8307
San Diego,73,2023-05-07,549,549,549,0,17152,17222,17221,1,101,7,7,14,6037,6037,6030,6030
San Francisco,73,2023-05-07,223,223,223,0,7525,7554,7553,1,37,2,2,6,1220,1220,1218,1218
San Joaquin,73,2023-05-07,176,176,176,0,8764,8800,8799,1,17,0,0,2,2484,2484,2484,2484
San Luis Obispo,73,2023-05-07,41,41,41,0,787,790,789,1,6,2,2,0,578,578,576,576
San Mateo,73,2023-05-07,222,222,222,0,4279,4297,4296,1,24,2,2,1,801,801,799,799
Santa Barbara,73,2023-05-07,75,75,75,0,1685,1691,1690,1,9,6,6,2,795,795,789,789
Santa Clara,73,2023-05-07,514,514,514,0,18134,18206,18205,1,95,3,3,19,2869,2869,2866,2866
Santa Cruz,73,2023-05-07,67,67,67,0,1560,1566,1565,1,11,1,1,0,314,314,313,313
Shasta,73,2023-05-07,14,14,14,0,404,405,404,1,2,0,0,1,647,647,647,647
Siskiyou,73,2023-05-07,8,8,8,0,103,104,103,1,1,2,2,0,100,100,98,98
Solano,73,2023-05-07,82,82,82,0,1593,1600,1599,1,12,1,1,2,519,519,518,518
Sonoma,73,2023-05-07,91,91,91,0,1706,1713,1712,1,17,0,0,2,598,598,598,598
Stanislaus,73,2023-05-07,82,82,82,0,2692,2703,2702,1,32,1,1,1,1894,1894,1893,1893
Sutter,73,2023-05-07,12,12,12,0,289,290,289,1,0,0,0,0,245,245,245,245
Tehama,73,2023-05-07,12,12,12,0,152,153,152,1,2,0,0,0,238,238,238,238
Trinity,73,2023-05-07,0,0,0,0,6,7,6,1,0,0,0,0,26,26,26,26
Tulare,73,2023-05-07,55,55,55,0,1810,1818,1817,1,8,1,1,0,1615,1615,1614,1614
Tuolumne,73,2023-05-07,16,16,16,0,227,228,227,1,0,0,0,0,215,215,215,215
Ventura,73,2023-05-07,90,90,90,0,2737,2749,2748,1,21,2,2,1,1716,1716,1714,1714
Yolo,73,2023-05-07,34,34,34,0,703,706,705,1,3,2,2,0,461,461,459,459
Yuba,73,2023-05-07,13,13,13,0,252,253,252,1,1,0,0,2,140,140,140,140
Alameda,74,2023-05-14,462,462,462,0,8313,8350,8349,1,48,4,4,5,2202,2202,2198,2198
Amador,74,2023-05-14,2,2,2,0,151,152,151,1,0,0,0,0,98,98,98,98
Butte,74,2023-05-14,69,69,69,0,614,617,616,1,6,1,1,0,519,519,518,518
Calaveras,74,2023-05-14,6,6,6,0,166,167,166,1,0,0,0,0,143,143,143,143
Colusa,74,2023-05-14,4,4,4,0,53,54,53,1,0,0,0,0,26,26,26,26
Contra Costa,74,2023-05-14,297,297,297,0,5987,6013,6012,1,28,3,3,3,1636,1636,1633,1633
Del Norte,74,2023-05-14,6,6,6,0,88,89,88,1,0,0,0,0,61,61,61,61
El Dorado,74,2023-05-14,36,36,36,0,583,586,585,1,1,2,2,1,266,266,264,264
Fresno,74,2023-05-14,175,175,175,0,5256,5278,5277,1,49,0,0,3,3034,3034,3034,3034
Glenn,74,2023-05-14,3,3,3,0,120,121,120,1,0,0,0,0,61,61,61,61
Humboldt,74,2023-05-14,14,14,14,0,294,295,294,1,1,1,1,0,181,181,180,180
Imperial,74,2023-05-14,80,80,80,0,1066,1072,1071,1,6,1,1,1,987,987,986,986
Inyo,74,2023-05-14,5,5,5,0,137,138,137,1,0,0,0,0,65,65,65,65
Kern,74,2023-05-14,120,120,120,0,3699,3715,3714,1,8,1,1,0,2528,2528,2527,2527
Kings,74,2023-05-14,37,37,37,0,602,603,602,1,1,0,0,0,487,487,487,487
Lake,74,2023-05-14,15,15,15,0,276,277,276,1,2,0,0,0,164,164,164,164
Lassen,74,2023-05-14,4,4,4,0,106,107,106,1,1,0,0,0,67,67,67,67
Los Angeles,74,2023-05-14,1795,1802,1802,0,76887,77218,77217,1,226,20,20,26,35572,35572,35552,35552
Madera,74,2023-05-14,24,24,24,0,692,696,695,1,0,0,0,0,385,385,385,385
Marin,74,2023-05-14,68,68,68,0,794,798,797,1,10,0,0,1,277,277,277,277
Mariposa,74,2023-05-14,1,1,1,0,41,42,41,1,0,0,0,0,32,32,32,32
Mendocino,74,2023-05-14,4,4,4,0,229,230,229,1,2,0,0,0,153,153,153,153
Merced,74,2023-05-14,47,47,47,0,1555,1563,1562,1,7,1,1,0,915,915,914,914
Modoc,74,2023-05-14,3,3,3,0,4,5,4,1,0,0,0,0,12,12,12,12
Mono,74,2023-05-14,0,0,0,0,32,33,32,1,0,0,0,0,8,8,8,8
Monterey,74,2023-05-14,39,39,39,0,1709,1718,1717,1,15,3,3,1,825,825,822,822
Napa,74,2023-05-14,27,27,27,0,674,677,676,1,1,2,2,0,188,188,186,186
Nevada,74,2023-05-14,17,17,17,0,269,270,269,1,4,2,2,0,149,149,147,147
Orange,74,2023-05-14,457,457,457,0,12455,12509,12508,1,63,6,6,10,8055,8055,8049,8049
Placer,74,2023-05-14,83,83,83,0,1297,1304,1303,1,43,1,1,3,716,716,715,715
Plumas,74,2023-05-14,2,2,2,0,39,40,39,1,0,0,0,0,15,15,15,15
Riverside,74,2023-05-14,287,287,287,0,9452,9493,9492,1,40,2,2,4,6977,6977,6975,6975
Sacramento,74,2023-05-14,413,413,413,0,6835,6865,6864,1,62,3,3,4,3625,3625,3622,3622
San Benito,74,2023-05-14,14,14,14,0,370,371,370,1,1,0,0,0,119,119,119,119
San Bernardino,74,2023-05-14,301,301,301,0,10772,10819,10818,1,36,4,4,6,8313,8313,8309,8309
San Diego,74,2023-05-14,548,548,548,0,16818,16892,16891,1,58,4,4,4,6041,6041,6037,6037
San Francisco,74,2023-05-14,211,211,211,0,7851,7885,7884,1,35,2,2,5,1222,1222,1220,1220
San Joaquin,74,2023-05-14,178,178,178,0,8187,8225,8224,1,12,2,2,0,2486,2486,2484,2484
San Luis Obispo,74,2023-05-14,46,46,46,0,786,791,790,1,4,2,2,0,580,580,578,578
San Mateo,74,2023-05-14,174,174,174,0,3877,3895,3894,1,18,4,4,1,805,805,801,801
Santa Barbara,74,2023-05-14,84,84,84,0,1291,1299,1298,1,7,0,0,0,795,795,795,795
Santa Clara,74,2023-05-14,513,513,513,0,18346,18427,18426,1,78,4,4,9,2873,2873,2869,2869
Santa Cruz,74,2023-05-14,55,55,55,0,1386,1393,1392,1,6,0,0,0,314,314,314,314
Shasta,74,2023-05-14,21,21,21,0,468,469,468,1,5,1,1,1,648,648,647,647
Siskiyou,74,2023-05-14,9,9,9,0,92,93,92,1,0,0,0,0,100,100,100,100
Solano,74,2023-05-14,77,77,77,0,1457,1465,1464,1,10,1,1,3,520,520,519,519
Sonoma,74,2023-05-14,95,95,95,0,1646,1655,1654,1,11,1,1,1,599,599,598,598
Stanislaus,74,2023-05-14,105,105,105,0,2776,2789,2788,1,19,2,2,2,1896,1896,1894,1894
Sutter,74,2023-05-14,28,28,28,0,295,296,295,1,0,1,1,0,246,246,245,245
Tehama,74,2023-05-14,14,14,14,0,160,161,160,1,3,0,0,0,238,238,238,238
Trinity,74,2023-05-14,1,1,1,0,12,13,12,1,0,0,0,0,26,26,26,26
Tulare,74,2023-05-14,39,39,39,0,1500,1507,1506,1,3,0,0,0,1615,1615,1615,1615
Tuolumne,74,2023-05-14,7,7,7,0,185,186,185,1,0,0,0,0,215,215,215,215
Ventura,74,2023-05-14,118,118,118,0,2507,2519,2518,1,15,1,1,1,1717,1717,1716,1716
Yolo,74,2023-05-14,37,37,37,0,583,584,583,1,3,0,0,0,461,461,461,461
Yuba,74,2023-05-14,18,18,18,0,221,222,221,1,3,0,0,0,140,140,140,140
Alameda,75,2023-05-21,417,417,417,0,7380,7417,7416,1,47,5,5,9,2207,2207,2202,2202
Amador,75,2023-05-21,5,5,5,0,139,140,139,1,0,0,0,0,98,98,98,98
Butte,75,2023-05-21,41,41,41,0,596,599,598,1,11,0,0,0,519,519,519,519
Calaveras,75,2023-05-21,4,4,4,0,143,144,143,1,0,0,0,0,143,143,143,143
Colusa,75,2023-05-21,2,2,2,0,39,40,39,1,1,0,0,0,26,26,26,26
Contra Costa,75,2023-05-21,268,268,268,0,5445,5472,5471,1,34,3,3,4,1639,1639,1636,1636
Del Norte,75,2023-05-21,7,7,7,0,89,90,89,1,0,0,0,0,61,61,61,61
El Dorado,75,2023-05-21,26,26,26,0,396,397,396,1,2,1,1,2,267,267,266,266
Fresno,75,2023-05-21,173,173,173,0,4379,4401,4400,1,38,0,0,6,3034,3034,3034,3034
Glenn,75,2023-05-21,6,6,6,0,112,113,112,1,0,1,1,0,62,62,61,61
Humboldt,75,2023-05-21,11,11,11,0,275,276,275,1,3,0,0,0,181,181,181,181
Imperial,75,2023-05-21,69,69,69,0,922,928,927,1,4,1,1,2,988,988,987,987
Inyo,75,2023-05-21,0,0,0,0,78,79,78,1,0,0,0,0,65,65,65,65
Kern,75,2023-05-21,68,68,68,0,2730,2745,2744,1,5,2,2,2,2530,2530,2528,2528
Kings,75,2023-05-21,31,31,31,0,520,521,520,1,2,0,0,0,487,487,487,487
Lake,75,2023-05-21,7,7,7,0,247,248,247,1,2,1,1,0,165,165,164,164
Lassen,75,2023-05-21,9,9,9,0,103,104,103,1,1,0,0,0,67,67,67,67
Los Angeles,75,2023-05-21,1560,1567,1567,0,59401,59689,59688,1,238,13,13,23,35585,35585,35572,35572
Madera,75,2023-05-21,20,20,20,0,626,630,629,1,1,0,0,0,385,385,385,385
Marin,75,2023-05-21,63,63,63,0,705,709,708,1,17,0,0,1,277,277,277,277
Mariposa,75,2023-05-21,4,4,4,0,40,41,40,1,0,0,0,0,32,32,32,32
Mendocino,75,2023-05-21,6,6,6,0,214,215,214,1,1,0,0,0,153,153,153,153
Merced,75,2023-05-21,44,44,44,0,1865,1875,1874,1,4,0,0,0,915,915,915,915
Modoc,75,2023-05-21,0,0,0,0,3,4,3,1,0,0,0,0,12,12,12,12
Mono,75,2023-05-21,0,0,0,0,33,34,33,1,0,0,0,0,8,8,8,8
Monterey,75,2023-05-21,33,33,33,0,1487,1496,1495,1,10,1,1,1,826,826,825,825
Napa,75,2023-05-21,31,31,31,0,525,526,525,1,0,0,0,0,188,188,188,188
Nevada,75,2023-05-21,10,10,10,0,224,225,224,1,3,0,0,1,149,149,149,149
Orange,75,2023-05-21,415,415,415,0,9318,9365,9364,1,60,3,3,11,8058,8058,8055,8055
Placer,75,2023-05-21,90,90,90,0,1153,1161,1160,1,47,1,1,2,717,717,716,716
Plumas,75,2023-05-21,0,0,0,0,34,35,34,1,0,0,0,0,15,15,15,15
Riverside,75,2023-05-21,202,202,202,0,5945,5975,5974,1,24,7,7,10,6984,6984,6977,6977
Sacramento,75,2023-05-21,326,326,326,0,6095,6126,6125,1,55,3,3,6,3628,3628,3625,3625
San Benito,75,2023-05-21,9,9,9,0,344,345,344,1,0,0,0,0,119,119,119,119
San Bernardino,75,2023-05-21,252,252,252,0,7528,7566,7565,1,33,5,5,5,8318,8318,8313,8313
San Diego,75,2023-05-21,494,494,494,0,12816,12879,12878,1,74,5,5,3,6046,6046,6041,6041
San Francisco,75,2023-05-21,202,202,202,0,7113,7148,7147,1,25,2,2,5,1224,1224,1222,1222
San Joaquin,75,2023-05-21,136,136,136,0,7789,7829,7828,1,11,1,1,4,2487,2487,2486,2486
San Luis Obispo,75,2023-05-21,51,51,51,0,743,748,747,1,6,2,2,0,582,582,580,580
San Mateo,75,2023-05-21,161,161,161,0,2875,2890,2889,1,13,1,1,1,806,806,805,805
Santa Barbara,75,2023-05-21,88,88,88,0,1147,1154,1153,1,14,2,2,0,797,797,795,795
Santa Clara,75,2023-05-21,541,541,541,0,17556,17641,17640,1,67,6,6,13,2879,2879,2873,2873
Santa Cruz,75,2023-05-21,64,64,64,0,1494,1503,1502,1,5,0,0,0,314,314,314,314
Shasta,75,2023-05-21,16,16,16,0,260,261,260,1,5,1,1,1,649,649,648,648
Siskiyou,75,2023-05-21,1,1,1,0,70,71,70,1,0,0,0,0,100,100,100,100
Solano,75,2023-05-21,84,84,84,0,1365,1373,1372,1,11,2,2,1,522,522,520,520
Sonoma,75,2023-05-21,93,93,93,0,1375,1383,1382,1,18,2,2,1,601,601,599,599
Stanislaus,75,2023-05-21,97,97,97,0,2518,2531,2530,1,16,1,1,3,1897,1897,1896,1896
Sutter,75,2023-05-21,26,26,26,0,248,249,248,1,0,0,0,0,246,246,246,246
Tehama,75,2023-05-21,11,11,11,0,113,114,113,1,1,1,1,0,239,239,238,238
Trinity,75,2023-05-21,0,0,0,0,13,14,13,1,0,0,0,0,26,26,26,26
Tulare,75,2023-05-21,42,42,42,0,561,564,563,1,4,0,0,1,1615,1615,1615,1615
Tuolumne,75,2023-05-21,7,7,7,0,167,168,167,1,1,1,1,0,216,216,215,215
Ventura,75,2023-05-21,125,125,125,0,2402,2415,2414,1,17,4,4,2,1721,1721,1717,1717
Yolo,75,2023-05-21,30,30,30,0,518,519,518,1,2,0,0,0,461,461,461,461
Yuba,75,2023-05-21,16,16,16,0,234,235,234,1,2,1,1,0,141,141,140,140
Alameda,76,2023-05-28,390,391,391,0,7102,7140,7139,1,49,6,6,2,2213,2213,2207,2207
Amador,76,2023-05-28,6,6,6,0,123,124,123,1,0,0,0,1,98,98,98,98
Butte,76,2023-05-28,22,22,22,0,486,488,487,1,6,2,2,1,521,521,519,519
Calaveras,76,2023-05-28,4,4,4,0,149,150,149,1,0,0,0,0,143,143,143,143
Colusa,76,2023-05-28,1,1,1,0,34,35,34,1,0,0,0,0,26,26,26,26
Contra Costa,76,2023-05-28,240,240,240,0,4938,4965,4964,1,38,2,2,4,1641,1641,1639,1639
Del Norte,76,2023-05-28,2,2,2,0,70,71,70,1,1,0,0,0,61,61,61,61
El Dorado,76,2023-05-28,22,22,22,0,315,316,315,1,5,0,0,0,267,267,267,267
Fresno,76,2023-05-28,146,146,146,0,3675,3694,3693,1,45,0,0,5,3034,3034,3034,3034
Glenn,76,2023-05-28,3,3,3,0,121,122,121,1,0,0,0,0,62,62,62,62
Humboldt,76,2023-05-28,8,8,8,0,208,209,208,1,2,0,0,0,181,181,181,181
Imperial,76,2023-05-28,47,47,47,0,910,916,915,1,3,0,0,1,988,988,988,988
Inyo,76,2023-05-28,2,2,2,0,45,46,45,1,0,0,0,0,65,65,65,65
Kern,76,2023-05-28,79,79,79,0,2482,2497,2496,1,4,0,0,2,2530,2530,2530,2530
Kings,76,2023-05-28,17,17,17,0,424,425,424,1,0,0,0,0,487,487,487,487
Lake,76,2023-05-28,8,8,8,0,220,221,220,1,2,0,0,0,165,165,165,165
Lassen,76,2023-05-28,1,1,1,0,96,97,96,1,1,1,1,0,68,68,67,67
Los Angeles,76,2023-05-28,1390,1397,1397,0,52140,52414,52413,1,212,23,23,29,35608,35608,35585,35585
Madera,76,2023-05-28,24,24,24,0,571,573,572,1,0,0,0,0,385,385,385,385
Marin,76,2023-05-28,61,61,61,0,699,705,704,1,11,0,0,3,277,277,277,277
Mariposa,76,2023-05-28,1,1,1,0,26,27,26,1,0,0,0,0,32,32,32,32
Mendocino,76,2023-05-28,9,9,9,0,176,177,176,1,1,0,0,1,153,153,153,153
Merced,76,2023-05-28,28,28,28,0,1636,1646,1645,1,1,1,1,0,916,916,915,915
Modoc,76,2023-05-28,0,0,0,0,3,4,3,1,0,0,0,0,12,12,12,12
Mono,76,2023-05-28,0,0,0,0,28,29,28,1,0,0,0,0,8,8,8,8
Monterey,76,2023-05-28,43,43,43,0,1407,1416,1415,1,8,1,1,0,827,827,826,826
Napa,76,2023-05-28,23,23,23,0,576,579,578,1,2,1,1,1,189,189,188,188
Nevada,76,2023-05-28,11,11,11,0,163,164,163,1,1,0,0,2,149,149,149,149
Orange,76,2023-05-28,420,420,420,0,8432,8478,8477,1,63,5,5,9,8063,8063,8058,8058
Placer,76,2023-05-28,71,71,71,0,1057,1064,1063,1,29,1,1,2,718,718,717,717
Plumas,76,2023-05-28,5,5,5,0,36,37,36,1,0,0,0,0,15,15,15,15
Riverside,76,2023-05-28,164,164,164,0,5074,5101,5100,1,27,2,2,4,6986,6986,6984,6984
Sacramento,76,2023-05-28,273,273,273,0,5916,5948,5947,1,48,1,1,10,3629,3629,3628,3628
San Benito,76,2023-05-28,11,11,11,0,321,322,321,1,0,0,0,0,119,119,119,119
San Bernardino,76,2023-05-28,182,182,182,0,6127,6160,6159,1,27,3,3,6,8321,8321,8318,8318
San Diego,76,2023-05-28,418,418,418,0,11801,11865,11864,1,60,5,5,9,6051,6051,6046,6046
San Francisco,76,2023-05-28,231,231,231,0,6445,6480,6479,1,35,6,6,6,1230,1230,1224,1224
San Joaquin,76,2023-05-28,183,183,183,0,6891,6928,6927,1,10,1,1,2,2488,2488,2487,2487
San Luis Obispo,76,2023-05-28,30,30,30,0,636,639,638,1,3,0,0,0,582,582,582,582
San Mateo,76,2023-05-28,131,131,131,0,2791,2807,2806,1,14,2,2,2,808,808,806,806
Santa Barbara,76,2023-05-28,54,54,54,0,1041,1048,1047,1,9,1,1,0,798,798,797,797
Santa Clara,76,2023-05-28,387,387,387,0,16619,16709,16708,1,63,7,7,10,2886,2886,2879,2879
Santa Cruz,76,2023-05-28,58,58,58,0,1035,1042,1041,1,4,0,0,2,314,314,314,314
Shasta,76,2023-05-28,11,11,11,0,211,212,211,1,2,0,0,3,649,649,649,649
Siskiyou,76,2023-05-28,2,2,2,0,50,51,50,1,1,0,0,0,100,100,100,100
Solano,76,2023-05-28,87,87,87,0,1426,1434,1433,1,13,0,0,2,522,522,522,522
Sonoma,76,2023-05-28,79,79,79,0,1324,1332,1331,1,15,0,0,1,601,601,601,601
Stanislaus,76,2023-05-28,81,81,81,0,2215,2227,2226,1,11,3,3,3,1900,1900,1897,1897
Sutter,76,2023-05-28,12,12,12,0,189,190,189,1,0,0,0,0,246,246,246,246
Tehama,76,2023-05-28,8,8,8,0,81,82,81,1,1,1,1,0,240,240,239,239
Trinity,76,2023-05-28,0,0,0,0,10,11,10,1,0,0,0,0,26,26,26,26
Tulare,76,2023-05-28,23,23,23,0,512,514,513,1,4,4,4,0,1619,1619,1615,1615
Tuolumne,76,2023-05-28,6,6,6,0,166,167,166,1,1,0,0,0,216,216,216,216
Ventura,76,2023-05-28,104,104,104,0,2186,2199,2198,1,15,1,1,0,1722,1722,1721,1721
Yolo,76,2023-05-28,18,18,18,0,516,518,517,1,0,1,1,0,462,462,461,461
Yuba,76,2023-05-28,18,18,18,0,206,207,206,1,2,0,0,1,141,141,141,141
Alameda,77,2023-06-04,319,319,319,0,6505,6545,6544,1,45,4,4,2,2217,2217,2213,2213
Amador,77,2023-06-04,2,2,2,0,112,113,112,1,0,0,0,0,98,98,98,98
Butte,77,2023-06-04,11,11,11,0,448,450,449,1,3,0,0,0,521,521,521,521
Calaveras,77,2023-06-04,6,6,6,0,147,148,147,1,0,0,0,0,143,143,143,143
Colusa,77,2023-06-04,1,1,1,0,24,25,24,1,0,0,0,0,26,26,26,26
Contra Costa,77,2023-06-04,225,225,225,0,4876,4907,4906,1,39,5,5,1,1646,1646,1641,1641
Del Norte,77,2023-06-04,1,1,1,0,79,80,79,1,1,0,0,0,61,61,61,61
El Dorado,77,2023-06-04,8,8,8,0,285,286,285,1,0,0,0,0,267,267,267,267
Fresno,77,2023-06-04,162,162,162,0,3690,3715,3714,1,46,4,4,1,3038,3038,3034,3034
Glenn,77,2023-06-04,0,0,0,0,111,112,111,1,0,0,0,0,62,62,62,62
Humboldt,77,2023-06-04,9,9,9,0,229,230,229,1,2,0,0,0,181,181,181,181
Imperial,77,2023-06-04,31,31,31,0,928,934,933,1,4,2,2,0,990,990,988,988
Inyo,77,2023-06-04,2,2,2,0,44,45,44,1,0,1,1,0,66,66,65,65
Kern,77,2023-06-04,94,94,94,0,2462,2477,2476,1,8,0,0,1,2530,2530,2530,2530
Kings,77,2023-06-04,17,17,17,0,430,432,431,1,1,0,0,0,487,487,487,487
Lake,77,2023-06-04,6,6,6,0,193,194,193,1,1,0,0,0,165,165,165,165
Lassen,77,2023-06-04,1,1,1,0,105,106,105,1,0,0,0,0,68,68,68,68
Los Angeles,77,2023-06-04,1288,1296,1296,0,46396,46675,46674,1,171,18,18,24,35626,35626,35608,35608
Madera,77,2023-06-04,21,21,21,0,537,540,539,1,0,0,0,0,385,385,385,385
Marin,77,2023-06-04,44,44,44,0,634,638,637,1,10,0,0,1,277,277,277,277
Mariposa,77,2023-06-04,0,0,0,0,22,23,22,1,0,1,1,0,33,33,32,32
Mendocino,77,2023-06-04,3,3,3,0,177,178,177,1,0,0,0,0,153,153,153,153
Merced,77,2023-06-04,30,30,30,0,2072,2086,2085,1,0,0,0,1,916,916,916,916
Modoc,77,2023-06-04,0,0,0,0,4,5,4,1,0,0,0,0,12,12,12,12
Mono,77,2023-06-04,0,0,0,0,14,15,14,1,0,0,0,0,8,8,8,8
Monterey,77,2023-06-04,34,34,34,0,1148,1156,1155,1,2,0,0,0,827,827,827,827
Napa,77,2023-06-04,24,24,24,0,662,668,667,1,2,0,0,0,189,189,189,189
Nevada,77,2023-06-04,10,10,10,0,163,164,163,1,4,1,1,0,150,150,149,149
Orange,77,2023-06-04,410,411,411,0,8063,8112,8111,1,49,8,8,16,8071,8071,8063,8063
Placer,77,2023-06-04,49,49,49,0,978,986,985,1,29,0,0,1,718,718,718,718
Plumas,77,2023-06-04,0,0,0,0,31,32,31,1,0,0,0,0,15,15,15,15
Riverside,77,2023-06-04,177,177,177,0,4530,4558,4557,1,18,5,5,2,6991,6991,6986,6986
Sacramento,77,2023-06-04,273,273,273,0,5714,5750,5749,1,64,5,5,11,3634,3634,3629,3629
San Benito,77,2023-06-04,15,15,15,0,336,337,336,1,1,0,0,0,119,119,119,119
San Bernardino,77,2023-06-04,213,213,213,0,5313,5346,5345,1,32,5,5,2,8326,8326,8321,8321
San Diego,77,2023-06-04,463,464,464,0,9899,9960,9959,1,68,5,5,4,6056,6056,6051,6051
San Francisco,77,2023-06-04,192,192,192,0,6674,6714,6713,1,39,1,1,6,1231,1231,1230,1230
San Joaquin,77,2023-06-04,105,105,105,0,8141,8192,8191,1,11,3,3,3,2491,2491,2488,2488
San Luis Obispo,77,2023-06-04,31,31,31,0,583,588,587,1,6,0,0,0,582,582,582,582
San Mateo,77,2023-06-04,133,133,133,0,2730,2749,2748,1,10,0,0,1,808,808,808,808
Santa Barbara,77,2023-06-04,49,49,49,0,1207,1216,1215,1,11,2,2,0,800,800,798,798
Santa Clara,77,2023-06-04,426,427,427,0,17542,17649,17648,1,78,1,1,12,2887,2887,2886,2886
Santa Cruz,77,2023-06-04,49,49,49,0,980,987,986,1,7,0,0,1,314,314,314,314
Shasta,77,2023-06-04,12,12,12,0,202,203,202,1,2,1,1,3,650,650,649,649
Siskiyou,77,2023-06-04,5,5,5,0,69,70,69,1,0,0,0,0,100,100,100,100
Solano,77,2023-06-04,86,86,86,0,1331,1339,1338,1,20,1,1,4,523,523,522,522
Sonoma,77,2023-06-04,73,73,73,0,1297,1306,1305,1,16,3,3,0,604,604,601,601
Stanislaus,77,2023-06-04,77,77,77,0,2252,2266,2265,1,11,2,2,4,1902,1902,1900,1900
Sutter,77,2023-06-04,23,23,23,0,208,209,208,1,0,0,0,0,246,246,246,246
Tehama,77,2023-06-04,9,9,9,0,90,91,90,1,0,0,0,0,240,240,240,240
Trinity,77,2023-06-04,0,0,0,0,2,3,2,1,0,0,0,0,26,26,26,26
Tulare,77,2023-06-04,29,29,29,0,638,642,641,1,3,2,2,0,1621,1621,1619,1619
Tuolumne,77,2023-06-04,6,6,6,0,159,160,159,1,0,1,1,0,217,217,216,216
Ventura,77,2023-06-04,111,111,111,0,2314,2328,2327,1,20,3,3,2,1725,1725,1722,1722
Yolo,77,2023-06-04,25,25,25,0,464,467,466,1,1,1,1,0,463,463,462,462
Yuba,77,2023-06-04,9,9,9,0,198,199,198,1,1,0,0,0,141,141,141,141
Alameda,78,2023-06-11,339,340,340,0,6318,6363,6362,1,45,4,4,4,2221,2221,2217,2217
Amador,78,2023-06-11,7,7,7,0,129,130,129,1,0,0,0,0,98,98,98,98
Butte,78,2023-06-11,13,13,13,0,353,355,354,1,1,1,1,1,522,522,521,521
Calaveras,78,2023-06-11,8,8,8,0,155,156,155,1,0,0,0,0,143,143,143,143
Colusa,78,2023-06-11,2,2,2,0,27,28,27,1,0,0,0,0,26,26,26,26
Contra Costa,78,2023-06-11,207,207,207,0,4621,4655,4654,1,28,2,2,1,1648,1648,1646,1646
Del Norte,78,2023-06-11,4,4,4,0,46,47,46,1,0,0,0,0,61,61,61,61
El Dorado,78,2023-06-11,15,15,15,0,331,332,331,1,1,0,0,0,267,267,267,267
Fresno,78,2023-06-11,148,148,148,0,3694,3722,3721,1,48,0,0,4,3038,3038,3038,3038
Glenn,78,2023-06-11,2,2,2,0,109,110,109,1,0,0,0,0,62,62,62,62
Humboldt,78,2023-06-11,14,14,14,0,212,213,212,1,0,1,1,0,182,182,181,181
Imperial,78,2023-06-11,25,25,25,0,798,804,803,1,3,0,0,0,990,990,990,990
Inyo,78,2023-06-11,4,4,4,0,51,52,51,1,0,0,0,0,66,66,66,66
Kern,78,2023-06-11,73,73,73,0,2655,2674,2673,1,8,1,1,1,2531,2531,2530,2530
Kings,78,2023-06-11,25,25,25,0,401,404,403,1,1,0,0,0,487,487,487,487
Lake,78,2023-06-11,7,7,7,0,180,181,180,1,0,0,0,0,165,165,165,165
Lassen,78,2023-06-11,1,1,1,0,85,86,85,1,0,0,0,0,68,68,68,68
Los Angeles,78,2023-06-11,1340,1350,1350,0,38201,38473,38472,1,200,9,9,25,35635,35635,35626,35626
Madera,78,2023-06-11,18,18,18,0,532,537,536,1,0,1,1,0,386,386,385,385
Marin,78,2023-06-11,49,49,49,0,540,546,545,1,10,1,1,1,278,278,277,277
Mariposa,78,2023-06-11,0,0,0,0,23,24,23,1,0,0,0,0,33,33,33,33
Mendocino,78,2023-06-11,4,4,4,0,145,146,145,1,0,0,0,0,153,153,153,153
Merced,78,2023-06-11,21,21,21,0,1774,1787,1786,1,2,1,1,0,917,917,916,916
Modoc,78,2023-06-11,0,0,0,0,1,2,1,1,0,0,0,0,12,12,12,12
Mono,78,2023-06-11,3,3,3,0,32,33,32,1,0,0,0,0,8,8,8,8
Monterey,78,2023-06-11,34,34,34,0,1088,1097,1096,1,3,1,1,1,828,828,827,827
Napa,78,2023-06-11,10,10,10,0,433,436,435,1,1,1,1,0,190,190,189,189
Nevada,78,2023-06-11,7,7,7,0,188,189,188,1,2,0,0,0,150,150,150,150
Orange,78,2023-06-11,359,360,360,0,7192,7244,7243,1,45,4,4,11,8075,8075,8071,8071
Placer,78,2023-06-11,48,48,48,0,908,916,915,1,29,0,0,0,718,718,718,718
Plumas,78,2023-06-11,1,1,1,0,29,30,29,1,1,0,0,0,15,15,15,15
Riverside,78,2023-06-11,146,146,146,0,4661,4695,4694,1,17,1,1,1,6992,6992,6991,6991
Sacramento,78,2023-06-11,226,226,226,0,5374,5413,5412,1,46,5,5,13,3639,3639,3634,3634
San Benito,78,2023-06-11,12,12,12,0,297,298,297,1,0,0,0,0,119,119,119,119
San Bernardino,78,2023-06-11,212,212,212,0,5354,5393,5392,1,20,7,7,7,8333,8333,8326,8326
San Diego,78,2023-06-11,432,433,433,0,7683,7739,7738,1,72,6,6,2,6062,6062,6056,6056
San Francisco,78,2023-06-11,200,200,200,0,6978,7027,7026,1,36,2,2,6,1233,1233,1231,1231
San Joaquin,78,2023-06-11,96,96,96,0,7171,7223,7222,1,17,1,1,2,2492,2492,2491,2491
San Luis Obispo,78,2023-06-11,25,25,25,0,488,493,492,1,7,0,0,0,582,582,582,582
San Mateo,78,2023-06-11,140,140,140,0,2688,2708,2707,1,13,0,0,1,808,808,808,808
Santa Barbara,78,2023-06-11,58,58,58,0,1321,1332,1331,1,12,2,2,0,802,802,800,800
Santa Clara,78,2023-06-11,363,363,363,0,16335,16453,16452,1,62,5,5,6,2892,2892,2887,2887
Santa Cruz,78,2023-06-11,42,42,42,0,824,831,830,1,4,2,2,0,316,316,314,314
Shasta,78,2023-06-11,20,20,20,0,217,218,217,1,5,2,2,2,652,652,650,650
Siskiyou,78,2023-06-11,1,1,1,0,45,46,45,1,0,0,0,0,100,100,100,100
Solano,78,2023-06-11,75,75,75,0,1345,1357,1356,1,20,0,0,3,523,523,523,523
Sonoma,78,2023-06-11,56,56,56,0,1171,1181,1180,1,17,3,3,2,607,607,604,604
Stanislaus,78,2023-06-11,58,58,58,0,1910,1925,1924,1,12,0,0,2,1902,1902,1902,1902
Sutter,78,2023-06-11,12,12,12,0,166,167,166,1,0,0,0,0,246,246,246,246
Tehama,78,2023-06-11,8,8,8,0,98,99,98,1,0,0,0,0,240,240,240,240
Trinity,78,2023-06-11,2,2,2,0,8,9,8,1,0,0,0,0,26,26,26,26
Tulare,78,2023-06-11,38,38,38,0,463,468,467,1,5,0,0,0,1621,1621,1621,1621
Tuolumne,78,2023-06-11,5,5,5,0,148,149,148,1,0,0,0,0,217,217,217,217
Ventura,78,2023-06-11,78,78,78,0,1932,1946,1945,1,15,3,3,2,1728,1728,1725,1725
Yolo,78,2023-06-11,19,19,19,0,452,455,454,1,0,0,0,1,463,463,463,463
Yuba,78,2023-06-11,9,9,9,0,168,169,168,1,2,0,0,0,141,141,141,141
Alameda,79,2023-06-18,279,279,279,0,6262,6314,6313,1,43,2,2,3,2223,2223,2221,2221
Amador,79,2023-06-18,4,4,4,0,125,126,125,1,0,0,0,0,98,98,98,98
Butte,79,2023-06-18,4,4,4,0,363,366,365,1,1,1,1,1,523,523,522,522
Calaveras,79,2023-06-18,9,9,9,0,155,156,155,1,0,0,0,0,143,143,143,143
Colusa,79,2023-06-18,1,1,1,0,23,24,23,1,0,0,0,0,26,26,26,26
Contra Costa,79,2023-06-18,199,199,199,0,4708,4749,4748,1,23,2,2,2,1650,1650,1648,1648
Del Norte,79,2023-06-18,1,1,1,0,46,47,46,1,0,0,0,0,61,61,61,61
El Dorado,79,2023-06-18,11,11,11,0,306,308,307,1,1,0,0,0,267,267,267,267
Fresno,79,2023-06-18,161,161,161,0,3803,3836,3835,1,44,1,1,2,3039,3039,3038,3038
Glenn,79,2023-06-18,2,2,2,0,93,94,93,1,0,0,0,0,62,62,62,62
Humboldt,79,2023-06-18,18,18,18,0,219,220,219,1,4,2,2,0,184,184,182,182
Imperial,79,2023-06-18,12,12,12,0,676,683,682,1,2,0,0,0,990,990,990,990
Inyo,79,2023-06-18,2,2,2,0,62,63,62,1,0,0,0,0,66,66,66,66
Kern,79,2023-06-18,55,55,55,0,2055,2072,2071,1,1,0,0,1,2531,2531,2531,2531
Kings,79,2023-06-18,34,34,34,0,412,417,416,1,1,0,0,1,487,487,487,487
Lake,79,2023-06-18,7,7,7,0,248,249,248,1,0,0,0,0,165,165,165,165
Lassen,79,2023-06-18,1,1,1,0,89,90,89,1,0,0,0,0,68,68,68,68
Los Angeles,79,2023-06-18,1410,1422,1422,0,36156,36455,36454,1,213,14,14,28,35649,35649,35635,35635
Madera,79,2023-06-18,16,16,16,0,500,507,506,1,2,0,0,0,386,386,386,386
Marin,79,2023-06-18,39,39,39,0,590,598,597,1,13,0,0,0,278,278,278,278
Mariposa,79,2023-06-18,1,1,1,0,33,34,33,1,0,0,0,0,33,33,33,33
Mendocino,79,2023-06-18,6,6,6,0,152,153,152,1,2,0,0,0,153,153,153,153
Merced,79,2023-06-18,21,21,21,0,2015,2033,2032,1,1,1,1,0,918,918,917,917
Modoc,79,2023-06-18,0,0,0,0,3,4,3,1,0,0,0,0,12,12,12,12
Mono,79,2023-06-18,4,4,4,0,26,27,26,1,0,0,0,0,8,8,8,8
Monterey,79,2023-06-18,35,35,35,0,990,1000,999,1,1,0,0,5,828,828,828,828
Napa,79,2023-06-18,15,15,15,0,367,370,369,1,4,0,0,1,190,190,190,190
Nevada,79,2023-06-18,8,8,8,0,157,158,157,1,2,0,0,0,150,150,150,150
Orange,79,2023-06-18,356,358,358,0,6774,6831,6830,1,49,6,6,7,8081,8081,8075,8075
Placer,79,2023-06-18,36,36,36,0,860,868,867,1,20,2,2,0,720,720,718,718
Plumas,79,2023-06-18,1,1,1,0,26,27,26,1,0,0,0,0,15,15,15,15
Riverside,79,2023-06-18,168,168,168,0,4188,4224,4223,1,34,2,2,2,6994,6994,6992,6992
Sacramento,79,2023-06-18,218,218,218,0,4930,4973,4972,1,47,3,3,6,3642,3642,3639,3639
San Benito,79,2023-06-18,6,6,6,0,267,268,267,1,0,0,0,0,119,119,119,119
San Bernardino,79,2023-06-18,192,192,192,0,4542,4580,4579,1,29,0,0,6,8333,8333,8333,8333
San Diego,79,2023-06-18,398,400,400,0,7085,7143,7142,1,51,5,5,7,6067,6067,6062,6062
San Francisco,79,2023-06-18,212,212,212,0,6933,6992,6991,1,31,3,3,3,1236,1236,1233,1233
San Joaquin,79,2023-06-18,99,99,99,0,7529,7593,7592,1,10,0,0,6,2492,2492,2492,2492
San Luis Obispo,79,2023-06-18,21,21,21,0,446,451,450,1,6,3,3,0,585,585,582,582
San Mateo,79,2023-06-18,137,137,137,0,2768,2792,2791,1,13,3,3,2,811,811,808,808
Santa Barbara,79,2023-06-18,60,60,60,0,925,934,933,1,7,0,0,0,802,802,802,802
Santa Clara,79,2023-06-18,331,331,331,0,16141,16276,16275,1,48,3,3,7,2895,2895,2892,2892
Santa Cruz,79,2023-06-18,33,33,33,0,806,813,812,1,7,1,1,0,317,317,316,316
Shasta,79,2023-06-18,8,8,8,0,174,175,174,1,6,1,1,0,653,653,652,652
Siskiyou,79,2023-06-18,2,2,2,0,44,45,44,1,0,0,0,0,100,100,100,100
Solano,79,2023-06-18,73,73,73,0,1275,1287,1286,1,20,1,1,1,524,524,523,523
Sonoma,79,2023-06-18,56,56,56,0,1252,1263,1262,1,12,2,2,1,609,609,607,607
Stanislaus,79,2023-06-18,59,59,59,0,1993,2011,2010,1,12,2,2,1,1904,1904,1902,1902
Sutter,79,2023-06-18,8,8,8,0,160,161,160,1,0,0,0,0,246,246,246,246
Tehama,79,2023-06-18,6,6,6,0,77,78,77,1,0,0,0,0,240,240,240,240
Trinity,79,2023-06-18,2,2,2,0,6,7,6,1,0,0,0,0,26,26,26,26
Tulare,79,2023-06-18,24,24,24,0,443,447,446,1,3,0,0,0,1621,1621,1621,1621
Tuolumne,79,2023-06-18,7,7,7,0,160,161,160,1,2,0,0,0,217,217,217,217
Ventura,79,2023-06-18,108,108,108,0,1946,1963,1962,1,19,0,0,4,1728,1728,1728,1728
Yolo,79,2023-06-18,24,24,24,0,450,456,455,1,2,0,0,1,463,463,463,463
Yuba,79,2023-06-18,12,12,12,0,181,182,181,1,2,1,1,0,142,142,141,141
Alameda,80,2023-06-25,294,294,294,0,6339,6400,6399,1,47,1,1,4,2224,2224,2223,2223
Amador,80,2023-06-25,1,1,1,0,114,115,114,1,0,1,1,0,99,99,98,98
Butte,80,2023-06-25,5,5,5,0,223,225,224,1,2,1,1,0,524,524,523,523
Calaveras,80,2023-06-25,4,4,4,0,128,129,128,1,0,1,1,1,144,144,143,143
Colusa,80,2023-06-25,0,0,0,0,23,24,23,1,1,1,1,0,27,27,26,26
Contra Costa,80,2023-06-25,199,199,199,0,4499,4542,4541,1,28,0,0,0,1650,1650,1650,1650
Del Norte,80,2023-06-25,6,6,6,0,56,57,56,1,0,0,0,0,61,61,61,61
El Dorado,80,2023-06-25,9,9,9,0,291,293,292,1,0,0,0,0,267,267,267,267
Fresno,80,2023-06-25,131,131,131,0,3594,3630,3629,1,36,0,0,4,3039,3039,3039,3039
Glenn,80,2023-06-25,3,3,3,0,94,96,95,1,0,0,0,0,62,62,62,62
Humboldt,80,2023-06-25,9,9,9,0,219,220,219,1,3,0,0,0,184,184,184,184
Imperial,80,2023-06-25,16,16,16,0,570,576,575,1,2,0,0,0,990,990,990,990
Inyo,80,2023-06-25,1,1,1,0,43,44,43,1,0,0,0,0,66,66,66,66
Kern,80,2023-06-25,76,76,76,0,2126,2147,2146,1,4,0,0,0,2531,2531,2531,2531
Kings,80,2023-06-25,25,25,25,0,324,327,326,1,1,0,0,0,487,487,487,487
Lake,80,2023-06-25,17,17,17,0,195,196,195,1,0,0,0,0,165,165,165,165
Lassen,80,2023-06-25,0,0,0,0,72,73,72,1,0,0,0,0,68,68,68,68
Los Angeles,80,2023-06-25,1410,1422,1422,0,37109,37471,37470,1,177,14,14,14,35663,35663,35649,35649
Madera,80,2023-06-25,22,22,22,0,512,519,518,1,1,0,0,0,386,386,386,386
Marin,80,2023-06-25,50,50,50,0,636,644,643,1,6,1,1,2,279,279,278,278
Mariposa,80,2023-06-25,0,0,0,0,23,24,23,1,0,0,0,0,33,33,33,33
Mendocino,80,2023-06-25,6,6,6,0,152,153,152,1,0,0,0,0,153,153,153,153
Merced,80,2023-06-25,26,26,26,0,1883,1903,1902,1,0,0,0,0,918,918,918,918
Modoc,80,2023-06-25,0,0,0,0,2,3,2,1,0,0,0,0,12,12,12,12
Mono,80,2023-06-25,1,1,1,0,17,18,17,1,0,0,0,0,8,8,8,8
Monterey,80,2023-06-25,25,25,25,0,1006,1017,1016,1,2,2,2,2,830,830,828,828
Napa,80,2023-06-25,20,20,20,0,367,370,369,1,4,2,2,1,192,192,190,190
Nevada,80,2023-06-25,5,5,5,0,139,140,139,1,1,0,0,0,150,150,150,150
Orange,80,2023-06-25,345,347,347,0,6484,6549,6548,1,34,2,2,6,8083,8083,8081,8081
Placer,80,2023-06-25,38,38,38,0,827,835,834,1,18,1,1,0,721,721,720,720
Plumas,80,2023-06-25,0,0,0,0,18,19,18,1,0,0,0,0,15,15,15,15
Riverside,80,2023-06-25,153,153,153,0,4607,4653,4652,1,16,2,2,1,6996,6996,6994,6994
Sacramento,80,2023-06-25,204,204,204,0,5079,5129,5128,1,39,3,3,4,3645,3645,3642,3642
San Benito,80,2023-06-25,5,5,5,0,251,252,251,1,0,1,1,0,120,120,119,119
San Bernardino,80,2023-06-25,192,192,192,0,4915,4963,4962,1,16,4,4,4,8337,8337,8333,8333
San Diego,80,2023-06-25,373,378,378,0,6802,6868,6867,1,40,10,10,3,6077,6077,6067,6067
San Francisco,80,2023-06-25,181,181,181,0,6714,6780,6779,1,29,3,3,5,1239,1239,1236,1236
San Joaquin,80,2023-06-25,129,129,129,0,8020,8099,8098,1,11,4,4,2,2496,2496,2492,2492
San Luis Obispo,80,2023-06-25,35,35,35,0,537,545,544,1,2,1,1,0,586,586,585,585
San Mateo,80,2023-06-25,139,139,139,0,2396,2419,2418,1,9,2,2,2,813,813,811,811
Santa Barbara,80,2023-06-25,57,57,57,0,819,828,827,1,7,2,2,0,804,804,802,802
Santa Clara,80,2023-06-25,369,374,374,0,16869,17035,17034,1,63,3,3,5,2898,2898,2895,2895
Santa Cruz,80,2023-06-25,35,35,35,0,722,730,729,1,7,1,1,0,318,318,317,317
Shasta,80,2023-06-25,6,6,6,0,170,171,170,1,0,3,3,0,656,656,653,653
Siskiyou,80,2023-06-25,3,3,3,0,58,59,58,1,0,1,1,0,101,101,100,100
Solano,80,2023-06-25,67,67,67,0,1228,1241,1240,1,16,2,2,1,526,526,524,524
Sonoma,80,2023-06-25,76,76,76,0,1214,1227,1226,1,13,1,1,1,610,610,609,609
Stanislaus,80,2023-06-25,64,64,64,0,2130,2152,2151,1,6,0,0,0,1904,1904,1904,1904
Sutter,80,2023-06-25,10,10,10,0,154,155,154,1,0,0,0,0,246,246,246,246
Tehama,80,2023-06-25,6,6,6,0,60,61,60,1,0,0,0,0,240,240,240,240
Trinity,80,2023-06-25,1,1,1,0,9,10,9,1,0,0,0,0,26,26,26,26
Tulare,80,2023-06-25,38,38,38,0,401,406,405,1,1,0,0,0,1621,1621,1621,1621
Tuolumne,80,2023-06-25,10,10,10,0,156,157,156,1,0,0,0,0,217,217,217,217
Ventura,80,2023-06-25,80,80,80,0,1628,1644,1643,1,18,1,1,1,1729,1729,1728,1728
Yolo,80,2023-06-25,23,23,23,0,427,433,432,1,1,1,1,1,464,464,463,463
Yuba,80,2023-06-25,11,11,11,0,147,148,147,1,3,1,1,0,143,143,142,142
Alameda,81,2023-07-02,357,362,362,0,6539,6614,6613,1,48,2,2,5,2226,2226,2224,2224
Amador,81,2023-07-02,2,2,2,0,115,116,115,1,1,0,0,0,99,99,99,99
Butte,81,2023-07-02,8,8,8,0,307,310,309,1,0,0,0,1,524,524,524,524
Calaveras,81,2023-07-01,4,4,4,0,123,124,123,1,0,0,0,0,144,144,144,144
Colusa,81,2023-07-01,1,1,1,0,33,34,33,1,0,0,0,0,27,27,27,27
Contra Costa,81,2023-07-02,228,228,228,0,4424,4474,4473,1,30,3,3,1,1653,1653,1650,1650
Del Norte,81,2023-07-02,5,5,5,0,59,60,59,1,0,0,0,0,61,61,61,61
El Dorado,81,2023-07-02,13,13,13,0,314,318,317,1,0,0,0,0,267,267,267,267
Fresno,81,2023-07-02,173,173,173,0,3656,3698,3697,1,15,1,1,1,3040,3040,3039,3039
Glenn,81,2023-07-01,10,10,10,0,86,88,87,1,0,0,0,0,62,62,62,62
Humboldt,81,2023-07-02,14,14,14,0,197,198,197,1,5,0,0,0,184,184,184,184
Imperial,81,2023-07-02,17,17,17,0,746,754,753,1,0,0,0,0,990,990,990,990
Inyo,81,2023-07-02,0,0,0,0,58,59,58,1,0,0,0,0,66,66,66,66
Kern,81,2023-07-02,73,73,73,0,1892,1913,1912,1,2,0,0,1,2531,2531,2531,2531
Kings,81,2023-07-01,29,29,29,0,293,298,297,1,2,0,0,0,487,487,487,487
Lake,81,2023-07-02,7,7,7,0,209,210,209,1,0,0,0,0,165,165,165,165
Lassen,81,2023-07-02,0,0,0,0,69,70,69,1,0,0,0,0,68,68,68,68
Los Angeles,81,2023-07-02,1359,1374,1374,0,34729,35118,35117,1,131,14,14,17,35677,35677,35663,35663
Madera,81,2023-07-02,17,17,17,0,473,479,478,1,1,1,1,0,387,387,386,386
Marin,81,2023-07-02,46,46,46,0,554,561,560,1,8,2,2,1,281,281,279,279
Mariposa,81,2023-07-02,5,5,5,0,36,37,36,1,0,0,0,0,33,33,33,33
Mendocino,81,2023-07-01,12,12,12,0,165,166,165,1,2,1,1,0,154,154,153,153
Merced,81,2023-07-02,95,95,95,0,2379,2408,2407,1,1,1,1,0,919,919,918,918
Modoc,81,2023-07-02,1,1,1,0,2,3,2,1,0,0,0,0,12,12,12,12
Mono,81,2023-07-02,0,0,0,0,21,22,21,1,0,0,0,0,8,8,8,8
Monterey,81,2023-07-02,33,33,33,0,1030,1043,1042,1,3,0,0,0,830,830,830,830
Napa,81,2023-07-02,30,30,30,0,437,443,442,1,3,0,0,1,192,192,192,192
Nevada,81,2023-07-02,3,3,3,0,131,132,131,1,1,0,0,0,150,150,150,150
Orange,81,2023-07-02,339,344,344,0,6186,6255,6254,1,33,1,1,4,8084,8084,8083,8083
Placer,81,2023-07-02,41,41,41,0,819,828,827,1,21,1,1,1,722,722,721,721
Plumas,81,2023-07-02,1,1,1,0,34,35,34,1,0,0,0,0,15,15,15,15
Riverside,81,2023-07-02,186,186,186,0,4348,4397,4396,1,13,1,1,1,6997,6997,6996,6996
Sacramento,81,2023-07-02,213,213,213,0,4625,4679,4678,1,31,4,4,1,3649,3649,3645,3645
San Benito,81,2023-07-02,12,12,12,0,255,257,256,1,0,0,0,0,120,120,120,120
San Bernardino,81,2023-07-02,249,250,250,0,4773,4828,4827,1,7,3,3,2,8340,8340,8337,8337
San Diego,81,2023-07-02,373,378,378,0,6565,6639,6638,1,19,4,4,2,6081,6081,6077,6077
San Francisco,81,2023-07-02,193,193,193,0,7298,7380,7379,1,24,4,4,5,1243,1243,1239,1239
San Joaquin,81,2023-07-02,121,121,121,0,8219,8312,8311,1,10,3,3,2,2499,2499,2496,2496
San Luis Obispo,81,2023-07-02,35,35,35,0,522,530,529,1,4,2,2,0,588,588,586,586
San Mateo,81,2023-07-02,171,171,171,0,2476,2504,2503,1,11,1,1,0,814,814,813,813
Santa Barbara,81,2023-07-02,70,70,70,0,989,1001,1000,1,7,1,1,0,805,805,804,804
Santa Clara,81,2023-07-02,462,467,467,0,18603,18812,18811,1,43,2,2,4,2900,2900,2898,2898
Santa Cruz,81,2023-07-02,36,36,36,0,704,712,711,1,0,0,0,0,318,318,318,318
Shasta,81,2023-07-02,11,11,11,0,170,171,170,1,7,0,0,1,656,656,656,656
Siskiyou,81,2023-07-02,5,5,5,0,57,58,57,1,0,0,0,0,101,101,101,101
Solano,81,2023-07-02,60,60,60,0,1143,1156,1155,1,15,2,2,1,528,528,526,526
Sonoma,81,2023-07-02,61,61,61,0,1185,1199,1198,1,11,0,0,0,610,610,610,610
Stanislaus,81,2023-07-02,73,73,73,0,2143,2167,2166,1,7,1,1,1,1905,1905,1904,1904
Sutter,81,2023-07-02,9,9,9,0,148,149,148,1,0,0,0,0,246,246,246,246
Tehama,81,2023-07-02,3,3,3,0,56,57,56,1,0,0,0,0,240,240,240,240
Trinity,81,2023-07-02,1,1,1,0,6,7,6,1,0,0,0,0,26,26,26,26
Tulare,81,2023-07-02,27,27,27,0,410,416,415,1,1,2,2,0,1623,1623,1621,1621
Tuolumne,81,2023-07-01,11,11,11,0,151,152,151,1,1,1,1,0,218,218,217,217
Ventura,81,2023-07-02,83,83,83,0,1501,1519,1518,1,7,2,2,0,1731,1731,1729,1729
Yolo,81,2023-07-02,20,20,20,0,421,428,427,1,3,1,1,0,465,465,464,464
Yuba,81,2023-07-01,7,7,7,0,138,139,138,1,1,0,0,0,143,143,143,143
Alameda,82,2023-07-09,360,366,366,0,5810,5883,5882,1,50,6,6,9,2232,2232,2226,2226
Amador,82,2023-07-09,2,2,2,0,107,108,107,1,0,0,0,0,99,99,99,99
Butte,82,2023-07-09,10,10,10,0,204,207,206,1,4,0,0,0,524,524,524,524
Calaveras,82,2023-07-09,4,4,4,0,130,131,130,1,0,1,1,2,145,145,144,144
Colusa,82,2023-07-09,1,1,1,0,13,14,13,1,0,0,0,0,27,27,27,27
Contra Costa,82,2023-07-09,264,266,266,0,4111,4164,4163,1,24,5,5,3,1658,1658,1653,1653
Del Norte,82,2023-07-09,3,3,3,0,62,63,62,1,1,0,0,0,61,61,61,61
El Dorado,82,2023-07-09,16,16,16,0,258,262,261,1,0,0,0,1,267,267,267,267
Fresno,82,2023-07-09,155,155,155,0,2973,3011,3010,1,30,0,0,1,3040,3040,3040,3040
Glenn,82,2023-07-09,0,0,0,0,23,24,23,1,0,0,0,0,62,62,62,62
Humboldt,82,2023-07-09,27,27,27,0,211,213,212,1,6,0,0,0,184,184,184,184
Imperial,82,2023-07-09,17,17,17,0,590,597,596,1,1,0,0,0,990,990,990,990
Inyo,82,2023-07-09,3,3,3,0,59,60,59,1,1,0,0,0,66,66,66,66
Kern,82,2023-07-09,86,86,86,0,1589,1609,1608,1,3,1,1,1,2532,2532,2531,2531
Kings,82,2023-07-09,40,40,40,0,269,274,273,1,6,0,0,0,487,487,487,487
Lake,82,2023-07-09,20,20,20,0,186,188,187,1,1,1,1,0,166,166,165,165
Lassen,82,2023-07-09,2,2,2,0,73,74,73,1,0,0,0,0,68,68,68,68
Los Angeles,82,2023-07-09,1383,1401,1401,0,32355,32764,32763,1,186,5,5,23,35682,35682,35677,35677
Madera,82,2023-07-09,27,27,27,0,444,452,451,1,0,3,3,0,390,390,387,387
Marin,82,2023-07-09,49,49,49,0,542,551,550,1,11,1,1,1,282,282,281,281
Mariposa,82,2023-07-09,2,2,2,0,30,31,30,1,0,0,0,0,33,33,33,33
Mendocino,82,2023-07-09,7,7,7,0,139,140,139,1,0,0,0,1,154,154,154,154
Merced,82,2023-07-09,20,20,20,0,1744,1768,1767,1,0,1,1,0,920,920,919,919
Modoc,82,2023-07-09,0,0,0,0,3,4,3,1,0,0,0,0,12,12,12,12
Mono,82,2023-07-09,2,2,2,0,26,27,26,1,0,0,0,0,8,8,8,8
Monterey,82,2023-07-09,59,59,59,0,999,1012,1011,1,8,1,1,0,831,831,830,830
Napa,82,2023-07-09,20,20,20,0,485,492,491,1,4,0,0,1,192,192,192,192
Nevada,82,2023-07-09,3,3,3,0,107,108,107,1,0,0,0,0,150,150,150,150
Orange,82,2023-07-09,421,428,428,0,5701,5775,5774,1,59,1,1,8,8085,8085,8084,8084
Placer,82,2023-07-09,69,69,69,0,773,784,783,1,21,1,1,1,723,723,722,722
Plumas,82,2023-07-09,1,1,1,0,24,25,24,1,0,0,0,0,15,15,15,15
Riverside,82,2023-07-09,207,207,207,0,3887,3937,3936,1,26,3,3,3,7000,7000,6997,6997
Sacramento,82,2023-07-09,235,239,239,0,4692,4752,4751,1,32,3,3,2,3652,3652,3649,3649
San Benito,82,2023-07-09,14,14,14,0,272,276,275,1,0,0,0,0,120,120,120,120
San Bernardino,82,2023-07-09,248,250,250,0,4483,4540,4539,1,18,1,1,5,8341,8341,8340,8340
San Diego,82,2023-07-09,392,398,398,0,5960,6036,6035,1,56,2,2,6,6083,6083,6081,6081
San Francisco,82,2023-07-09,186,186,186,0,6576,6660,6659,1,29,4,4,3,1247,1247,1243,1243
San Joaquin,82,2023-07-09,128,128,128,0,6628,6713,6712,1,6,1,1,3,2500,2500,2499,2499
San Luis Obispo,82,2023-07-09,31,31,31,0,465,473,472,1,5,1,1,0,589,589,588,588
San Mateo,82,2023-07-09,146,146,146,0,2096,2123,2122,1,19,0,0,3,814,814,814,814
Santa Barbara,82,2023-07-09,72,72,72,0,920,932,931,1,4,1,1,0,806,806,805,805
Santa Clara,82,2023-07-09,443,449,449,0,16683,16895,16894,1,72,3,3,4,2903,2903,2900,2900
Santa Cruz,82,2023-07-09,36,36,36,0,616,625,624,1,6,0,0,0,318,318,318,318
Shasta,82,2023-07-09,8,8,8,0,158,159,158,1,4,1,1,1,657,657,656,656
Siskiyou,82,2023-07-09,3,3,3,0,54,55,54,1,1,0,0,0,101,101,101,101
Solano,82,2023-07-09,73,73,73,0,1202,1219,1218,1,17,0,0,1,528,528,528,528
Sonoma,82,2023-07-09,81,81,81,0,1096,1111,1110,1,15,2,2,1,612,612,610,610
Stanislaus,82,2023-07-09,79,79,79,0,2054,2079,2078,1,13,1,1,1,1906,1906,1905,1905
Sutter,82,2023-07-09,15,15,15,0,145,146,145,1,0,0,0,0,246,246,246,246
Tehama,82,2023-07-09,3,3,3,0,79,80,79,1,0,0,0,0,240,240,240,240
Trinity,82,2023-07-09,0,0,0,0,6,7,6,1,0,0,0,0,26,26,26,26
Tulare,82,2023-07-09,28,28,28,0,429,436,435,1,4,0,0,1,1623,1623,1623,1623
Tuolumne,82,2023-07-09,7,7,7,0,132,133,132,1,0,0,0,1,218,218,218,218
Ventura,82,2023-07-09,125,125,125,0,1479,1500,1499,1,17,1,1,1,1732,1732,1731,1731
Yolo,82,2023-07-09,36,36,36,0,418,424,423,1,1,1,1,0,466,466,465,465
Yuba,82,2023-07-09,7,7,7,0,126,127,126,1,2,0,0,0,143,143,143,143
Alameda,83,2023-07-16,406,413,413,0,5803,5886,5885,1,50,3,3,7,2235,2235,2232,2232
Amador,83,2023-07-16,3,3,3,0,103,104,103,1,0,0,0,0,99,99,99,99
Butte,83,2023-07-16,18,18,18,0,244,246,245,1,2,0,0,0,524,524,524,524
Calaveras,83,2023-07-16,7,7,7,0,88,89,88,1,1,0,0,1,145,145,145,145
Colusa,83,2023-07-16,2,2,2,0,18,19,18,1,0,0,0,0,27,27,27,27
Contra Costa,83,2023-07-16,277,282,282,0,4084,4143,4142,1,34,2,2,4,1660,1660,1658,1658
Del Norte,83,2023-07-16,0,0,0,0,45,46,45,1,1,0,0,0,61,61,61,61
El Dorado,83,2023-07-16,21,21,21,0,240,246,245,1,2,0,0,0,267,267,267,267
Fresno,83,2023-07-16,201,203,203,0,2828,2870,2869,1,40,0,0,1,3040,3040,3040,3040
Glenn,83,2023-07-16,3,3,3,0,81,83,82,1,0,0,0,0,62,62,62,62
Humboldt,83,2023-07-16,17,17,17,0,196,198,197,1,3,0,0,0,184,184,184,184
Imperial,83,2023-07-16,18,18,18,0,552,560,559,1,0,0,0,0,990,990,990,990
Inyo,83,2023-07-16,0,0,0,0,50,51,50,1,0,0,0,0,66,66,66,66
Kern,83,2023-07-16,130,130,130,0,2037,2066,2065,1,6,0,0,0,2532,2532,2532,2532
Kings,83,2023-07-16,41,41,41,0,336,343,342,1,1,1,1,0,488,488,487,487
Lake,83,2023-07-16,17,17,17,0,188,189,188,1,0,2,2,0,168,168,166,166
Lassen,83,2023-07-16,2,2,2,0,71,72,71,1,0,0,0,0,68,68,68,68
Los Angeles,83,2023-07-16,1737,1762,1762,0,33053,33525,33524,1,206,14,14,29,35696,35696,35682,35682
Madera,83,2023-07-16,35,35,35,0,456,463,462,1,0,0,0,0,390,390,390,390
Marin,83,2023-07-16,67,67,67,0,565,574,573,1,9,0,0,1,282,282,282,282
Mariposa,83,2023-07-16,0,0,0,0,18,19,18,1,1,0,0,0,33,33,33,33
Mendocino,83,2023-07-16,11,11,11,0,155,156,155,1,0,1,1,0,155,155,154,154
Merced,83,2023-07-16,20,20,20,0,1787,1813,1812,1,2,2,2,0,922,922,920,920
Modoc,83,2023-07-16,0,0,0,0,3,4,3,1,0,0,0,0,12,12,12,12
Mono,83,2023-07-16,0,0,0,0,20,21,20,1,0,0,0,0,8,8,8,8
Monterey,83,2023-07-16,37,37,37,0,896,910,909,1,10,0,0,0,831,831,831,831
Napa,83,2023-07-16,23,23,23,0,401,408,407,1,0,0,0,0,192,192,192,192
Nevada,83,2023-07-16,7,7,7,0,98,99,98,1,0,0,0,0,150,150,150,150
Orange,83,2023-07-16,437,444,444,0,5729,5812,5811,1,45,4,4,5,8089,8089,8085,8085
Placer,83,2023-07-16,59,59,59,0,747,760,759,1,15,0,0,2,723,723,723,723
Plumas,83,2023-07-16,0,0,0,0,26,27,26,1,0,0,0,0,15,15,15,15
Riverside,83,2023-07-16,242,246,246,0,3584,3636,3635,1,20,3,3,1,7003,7003,7000,7000
Sacramento,83,2023-07-16,244,248,248,0,4340,4402,4401,1,45,3,3,2,3655,3655,3652,3652
San Benito,83,2023-07-16,11,11,11,0,217,220,219,1,1,0,0,0,120,120,120,120
San Bernardino,83,2023-07-16,307,312,312,0,4468,4531,4530,1,32,6,6,6,8347,8347,8341,8341
San Diego,83,2023-07-16,483,490,490,0,6730,6828,6827,1,52,5,5,10,6088,6088,6083,6083
San Francisco,83,2023-07-16,209,211,211,0,6975,7075,7074,1,35,3,3,4,1250,1250,1247,1247
San Joaquin,83,2023-07-16,137,137,137,0,5215,5290,5289,1,10,1,1,1,2501,2501,2500,2500
San Luis Obispo,83,2023-07-16,37,37,37,0,437,444,443,1,3,0,0,0,589,589,589,589
San Mateo,83,2023-07-16,177,178,178,0,2391,2427,2426,1,14,2,2,0,816,816,814,814
Santa Barbara,83,2023-07-16,54,54,54,0,778,790,789,1,6,1,1,2,807,807,806,806
Santa Clara,83,2023-07-16,507,515,515,0,17249,17498,17497,1,81,1,1,7,2904,2904,2903,2903
Santa Cruz,83,2023-07-16,53,53,53,0,615,626,625,1,0,2,2,0,320,320,318,318
Shasta,83,2023-07-16,8,8,8,0,158,160,159,1,7,0,0,1,657,657,657,657
Siskiyou,83,2023-07-16,4,4,4,0,41,42,41,1,0,0,0,0,101,101,101,101
Solano,83,2023-07-16,100,100,100,0,1117,1133,1132,1,17,0,0,0,528,528,528,528
Sonoma,83,2023-07-16,101,101,101,0,1196,1214,1213,1,12,1,1,1,613,613,612,612
Stanislaus,83,2023-07-16,94,94,94,0,1626,1650,1649,1,11,2,2,0,1908,1908,1906,1906
Sutter,83,2023-07-16,17,17,17,0,144,145,144,1,0,0,0,0,246,246,246,246
Tehama,83,2023-07-16,7,7,7,0,68,69,68,1,0,0,0,0,240,240,240,240
Trinity,83,2023-07-16,0,0,0,0,5,6,5,1,0,0,0,0,26,26,26,26
Tulare,83,2023-07-16,34,34,34,0,336,342,341,1,5,0,0,0,1623,1623,1623,1623
Tuolumne,83,2023-07-16,12,12,12,0,148,149,148,1,1,0,0,0,218,218,218,218
Ventura,83,2023-07-16,102,102,102,0,1435,1456,1455,1,12,1,1,3,1733,1733,1732,1732
Yolo,83,2023-07-16,37,37,37,0,408,416,415,1,1,0,0,0,466,466,466,466
Yuba,83,2023-07-16,13,13,13,0,146,147,146,1,2,0,0,0,143,143,143,143
Alameda,84,2023-07-23,434,441,441,0,5971,6071,6070,1,56,5,5,1,2240,2240,2235,2235
Amador,84,2023-07-23,4,4,4,0,105,106,105,1,0,0,0,0,99,99,99,99
Butte,84,2023-07-23,25,25,25,0,285,291,290,1,4,0,0,0,524,524,524,524
Calaveras,84,2023-07-23,6,6,6,0,143,144,143,1,0,0,0,2,145,145,145,145
Colusa,84,2023-07-23,1,1,1,0,28,29,28,1,0,0,0,0,27,27,27,27
Contra Costa,84,2023-07-23,328,335,335,0,4414,4488,4487,1,25,3,3,4,1663,1663,1660,1660
Del Norte,84,2023-07-23,2,2,2,0,48,49,48,1,1,0,0,0,61,61,61,61
El Dorado,84,2023-07-23,22,22,22,0,269,275,274,1,2,0,0,0,267,267,267,267
Fresno,84,2023-07-23,176,176,176,0,2482,2524,2523,1,41,1,1,1,3041,3041,3040,3040
Glenn,84,2023-07-23,3,3,3,0,95,97,96,1,0,0,0,0,62,62,62,62
Humboldt,84,2023-07-23,9,9,9,0,201,204,203,1,1,1,1,1,185,185,184,184
Imperial,84,2023-07-23,20,20,20,0,570,580,579,1,1,0,0,0,990,990,990,990
Inyo,84,2023-07-23,0,0,0,0,46,47,46,1,0,0,0,0,66,66,66,66
Kern,84,2023-07-23,143,143,143,0,2169,2205,2204,1,5,0,0,0,2532,2532,2532,2532
Kings,84,2023-07-23,63,63,63,0,367,375,374,1,3,0,0,0,488,488,488,488
Lake,84,2023-07-23,21,21,21,0,162,163,162,1,0,0,0,0,168,168,168,168
Lassen,84,2023-07-23,13,13,13,0,101,102,101,1,0,0,0,0,68,68,68,68
Los Angeles,84,2023-07-23,1875,1906,1906,0,31964,32491,32490,1,212,9,10,18,35705,35706,35696,35696
Madera,84,2023-07-23,19,19,19,0,386,394,393,1,3,0,0,0,390,390,390,390
Marin,84,2023-07-23,63,63,63,0,598,609,608,1,8,0,0,1,282,282,282,282
Mariposa,84,2023-07-23,0,0,0,0,18,19,18,1,1,0,0,0,33,33,33,33
Mendocino,84,2023-07-23,17,17,17,0,171,174,173,1,0,0,0,1,155,155,155,155
Merced,84,2023-07-23,28,28,28,0,1451,1475,1474,1,2,0,0,0,922,922,922,922
Modoc,84,2023-07-23,0,0,0,0,1,2,1,1,0,0,0,0,12,12,12,12
Mono,84,2023-07-23,4,4,4,0,21,22,21,1,0,0,0,0,8,8,8,8
Monterey,84,2023-07-23,42,42,42,0,996,1013,1012,1,7,0,0,0,831,831,831,831
Napa,84,2023-07-23,18,18,18,0,498,508,507,1,1,0,0,0,192,192,192,192
Nevada,84,2023-07-23,6,6,6,0,96,97,96,1,0,0,0,0,150,150,150,150
Orange,84,2023-07-23,527,535,535,0,6080,6181,6180,1,52,5,6,6,8094,8095,8089,8089
Placer,84,2023-07-23,98,98,98,0,831,846,845,1,26,0,0,3,723,723,723,723
Plumas,84,2023-07-23,1,1,1,0,21,22,21,1,0,0,0,0,15,15,15,15
Riverside,84,2023-07-23,277,283,283,0,3645,3707,3706,1,25,4,4,4,7007,7007,7003,7003
Sacramento,84,2023-07-23,298,304,304,0,5011,5094,5093,1,42,2,2,3,3657,3657,3655,3655
San Benito,84,2023-07-23,15,15,15,0,220,224,223,1,0,0,0,0,120,120,120,120
San Bernardino,84,2023-07-23,319,325,325,0,4437,4512,4511,1,28,5,5,3,8352,8352,8347,8347
San Diego,84,2023-07-23,593,603,603,0,6652,6762,6761,1,63,10,10,9,6098,6098,6088,6088
San Francisco,84,2023-07-23,248,254,254,0,6700,6810,6809,1,38,0,0,3,1250,1250,1250,1250
San Joaquin,84,2023-07-23,163,163,163,0,7619,7745,7744,1,11,2,2,2,2503,2503,2501,2501
San Luis Obispo,84,2023-07-23,30,30,30,0,412,420,419,1,0,1,1,0,590,590,589,589
San Mateo,84,2023-07-23,169,170,170,0,2422,2462,2461,1,12,1,1,0,817,817,816,816
Santa Barbara,84,2023-07-23,67,67,67,0,631,642,641,1,5,1,1,2,808,808,807,807
Santa Clara,84,2023-07-23,538,545,545,0,16609,16886,16885,1,73,4,4,5,2908,2908,2904,2904
Santa Cruz,84,2023-07-23,49,49,49,0,610,621,620,1,3,2,2,0,322,322,320,320
Shasta,84,2023-07-23,4,4,4,0,171,173,172,1,4,1,1,0,658,658,657,657
Siskiyou,84,2023-07-23,7,7,7,0,49,50,49,1,0,0,0,0,101,101,101,101
Solano,84,2023-07-23,82,82,82,0,1224,1244,1243,1,22,2,2,2,530,530,528,528
Sonoma,84,2023-07-23,116,117,117,0,1157,1178,1177,1,11,2,2,0,615,615,613,613
Stanislaus,84,2023-07-23,122,122,122,0,1778,1808,1807,1,6,0,0,1,1908,1908,1908,1908
Sutter,84,2023-07-23,13,13,13,0,151,152,151,1,0,0,0,0,246,246,246,246
Tehama,84,2023-07-23,5,5,5,0,73,74,73,1,1,0,0,0,240,240,240,240
Trinity,84,2023-07-23,0,0,0,0,3,4,3,1,0,0,0,0,26,26,26,26
Tulare,84,2023-07-23,28,28,28,0,300,306,305,1,4,0,0,0,1623,1623,1623,1623
Tuolumne,84,2023-07-23,9,9,9,0,174,177,176,1,0,1,1,0,219,219,218,218
Ventura,84,2023-07-23,138,138,138,0,1408,1433,1432,1,20,1,1,2,1734,1734,1733,1733
Yolo,84,2023-07-23,31,31,31,0,513,522,521,1,1,0,0,1,466,466,466,466
Yuba,84,2023-07-23,13,13,13,0,142,144,143,1,0,0,0,0,143,143,143,143
Alameda,85,2023-07-30,520,530,530,0,5721,5833,5832,1,71,6,6,6,2246,2246,2240,2240
Amador,85,2023-07-30,3,3,3,0,98,99,98,1,1,0,0,1,99,99,99,99
Butte,85,2023-07-30,17,17,17,0,244,250,249,1,4,1,1,0,525,525,524,524
Calaveras,85,2023-07-30,10,10,10,0,113,114,113,1,0,0,0,0,145,145,145,145
Colusa,85,2023-07-30,0,0,0,0,21,22,21,1,0,0,0,0,27,27,27,27
Contra Costa,85,2023-07-30,338,345,345,0,4269,4354,4353,1,31,8,9,5,1671,1672,1663,1663
Del Norte,85,2023-07-30,4,4,4,0,48,49,48,1,1,0,0,0,61,61,61,61
El Dorado,85,2023-07-30,31,31,31,0,241,249,248,1,3,0,0,0,267,267,267,267
Fresno,85,2023-07-30,233,239,239,0,2512,2562,2561,1,52,3,3,6,3044,3044,3041,3041
Glenn,85,2023-07-30,0,0,0,0,99,101,100,1,0,0,0,0,62,62,62,62
Humboldt,85,2023-07-30,16,16,16,0,185,189,188,1,2,0,0,1,185,185,185,185
Imperial,85,2023-07-30,26,26,26,0,414,423,422,1,0,0,0,0,990,990,990,990
Inyo,85,2023-07-30,3,3,3,0,58,59,58,1,0,0,0,0,66,66,66,66
Kern,85,2023-07-30,175,179,179,0,2418,2468,2467,1,5,1,1,0,2533,2533,2532,2532
Kings,85,2023-07-30,49,49,49,0,298,306,305,1,2,0,0,0,488,488,488,488
Lake,85,2023-07-30,32,32,32,0,231,238,237,1,0,0,0,1,168,168,168,168
Lassen,85,2023-07-30,5,5,5,0,77,78,77,1,0,0,0,0,68,68,68,68
Los Angeles,85,2023-07-30,2383,2430,2430,0,31295,31912,31911,1,256,17,20,19,35722,35726,35705,35706
Madera,85,2023-07-30,30,30,30,0,363,371,370,1,1,0,0,0,390,390,390,390
Marin,85,2023-07-30,75,75,75,0,587,599,598,1,7,1,1,2,283,283,282,282
Mariposa,85,2023-07-30,2,2,2,0,22,23,22,1,0,0,0,0,33,33,33,33
Mendocino,85,2023-07-30,15,15,15,0,144,147,146,1,2,1,1,1,156,156,155,155
Merced,85,2023-07-30,46,46,46,0,1742,1777,1776,1,0,0,0,1,922,922,922,922
Modoc,85,2023-07-30,0,0,0,0,5,6,5,1,0,0,0,0,12,12,12,12
Mono,85,2023-07-30,3,3,3,0,24,25,24,1,0,0,0,0,8,8,8,8
Monterey,85,2023-07-30,56,56,56,0,1152,1175,1174,1,11,5,5,0,836,836,831,831
Napa,85,2023-07-30,27,27,27,0,412,421,420,1,0,0,0,0,192,192,192,192
Nevada,85,2023-07-30,16,16,16,0,119,120,119,1,0,0,0,0,150,150,150,150
Orange,85,2023-07-30,623,636,636,0,5923,6041,6040,1,58,6,8,2,8100,8103,8094,8095
Placer,85,2023-07-30,78,78,78,0,804,821,820,1,24,1,1,4,724,724,723,723
Plumas,85,2023-07-30,4,4,4,0,22,23,22,1,0,0,0,0,15,15,15,15
Riverside,85,2023-07-30,341,348,348,0,3690,3763,3762,1,26,2,2,6,7009,7009,7007,7007
Sacramento,85,2023-07-30,338,345,345,0,4465,4555,4554,1,41,4,6,5,3661,3663,3657,3657
San Benito,85,2023-07-30,10,10,10,0,177,180,179,1,0,1,1,0,121,121,120,120
San Bernardino,85,2023-07-30,350,357,357,0,4337,4422,4421,1,26,8,9,4,8360,8361,8352,8352
San Diego,85,2023-07-30,867,885,885,0,9143,9324,9323,1,77,4,5,8,6102,6103,6098,6098
San Francisco,85,2023-07-30,271,277,277,0,6496,6625,6624,1,37,0,0,2,1250,1250,1250,1250
San Joaquin,85,2023-07-30,172,173,173,0,5579,5690,5689,1,6,3,3,2,2506,2506,2503,2503
San Luis Obispo,85,2023-07-30,41,41,41,0,468,477,476,1,1,1,1,0,591,591,590,590
San Mateo,85,2023-07-30,229,235,235,0,2577,2628,2627,1,24,3,3,1,820,820,817,817
Santa Barbara,85,2023-07-30,81,81,81,0,627,642,641,1,10,1,1,1,809,809,808,808
Santa Clara,85,2023-07-30,576,588,588,0,15452,15757,15756,1,78,3,3,4,2911,2911,2908,2908
Santa Cruz,85,2023-07-30,58,58,58,0,633,647,646,1,3,1,1,0,323,323,322,322
Shasta,85,2023-07-30,21,21,21,0,167,171,170,1,3,0,0,0,658,658,658,658
Siskiyou,85,2023-07-30,9,9,9,0,64,65,64,1,0,1,1,1,102,102,101,101
Solano,85,2023-07-30,126,126,126,0,1190,1214,1213,1,20,0,0,1,530,530,530,530
Sonoma,85,2023-07-30,125,125,125,0,1237,1261,1260,1,18,0,0,0,615,615,615,615
Stanislaus,85,2023-07-30,143,143,143,0,1546,1578,1577,1,6,0,0,3,1908,1908,1908,1908
Sutter,85,2023-07-30,30,30,30,0,194,199,198,1,0,0,0,0,246,246,246,246
Tehama,85,2023-07-30,9,9,9,0,70,71,70,1,0,0,0,0,240,240,240,240
Trinity,85,2023-07-30,2,2,2,0,5,6,5,1,0,0,0,0,26,26,26,26
Tulare,85,2023-07-30,31,31,31,0,338,346,345,1,8,0,0,0,1623,1623,1623,1623
Tuolumne,85,2023-07-30,11,11,11,0,122,123,122,1,0,0,0,0,219,219,219,219
Ventura,85,2023-07-30,137,138,138,0,1329,1355,1354,1,15,3,3,0,1737,1737,1734,1734
Yolo,85,2023-07-30,43,43,43,0,435,444,443,1,0,0,0,0,466,466,466,466
Yuba,85,2023-07-30,13,13,13,0,139,140,139,1,2,0,0,0,143,143,143,143
Alameda,86,2023-08-06,601,616,616,0,5819,5966,5965,1,55,2,2,5,2248,2248,2246,2246
Amador,86,2023-08-06,11,11,11,0,91,92,91,1,1,0,0,0,99,99,99,99
Butte,86,2023-08-06,38,38,38,0,274,283,282,1,9,0,0,0,525,525,525,525
Calaveras,86,2023-08-06,6,6,6,0,107,109,108,1,0,0,0,0,145,145,145,145
Colusa,86,2023-08-06,1,1,1,0,21,22,21,1,0,0,0,0,27,27,27,27
Contra Costa,86,2023-08-06,456,468,468,0,4580,4695,4694,1,41,4,5,7,1675,1677,1671,1672
Del Norte,86,2023-08-06,16,16,16,0,70,71,70,1,1,0,0,1,61,61,61,61
El Dorado,86,2023-08-06,29,29,29,0,228,236,235,1,1,2,2,1,269,269,267,267
Fresno,86,2023-08-06,318,325,325,0,2889,2962,2961,1,45,4,6,4,3048,3050,3044,3044
Glenn,86,2023-08-06,3,3,3,0,70,72,71,1,0,0,0,0,62,62,62,62
Humboldt,86,2023-08-06,7,7,7,0,170,177,176,1,1,1,1,0,186,186,185,185
Imperial,86,2023-08-06,39,39,39,0,422,433,432,1,0,0,0,0,990,990,990,990
Inyo,86,2023-08-06,6,6,6,0,55,56,55,1,2,0,0,0,66,66,66,66
Kern,86,2023-08-06,236,243,243,0,2472,2534,2533,1,6,1,1,3,2534,2534,2533,2533
Kings,86,2023-08-06,74,74,74,0,367,376,375,1,1,0,0,1,488,488,488,488
Lake,86,2023-08-06,32,32,32,0,213,219,218,1,0,0,0,0,168,168,168,168
Lassen,86,2023-08-06,9,9,9,0,92,93,92,1,1,0,0,0,68,68,68,68
Los Angeles,86,2023-08-06,2924,2997,2997,0,32185,32991,32990,1,301,12,17,24,35734,35743,35722,35726
Madera,86,2023-08-06,31,31,31,0,401,412,411,1,2,0,0,0,390,390,390,390
Marin,86,2023-08-06,73,73,73,0,587,602,601,1,11,0,0,0,283,283,283,283
Mariposa,86,2023-08-06,3,3,3,0,31,32,31,1,0,0,0,0,33,33,33,33
Mendocino,86,2023-08-06,23,23,23,0,171,178,177,1,1,0,0,0,156,156,156,156
Merced,86,2023-08-06,44,44,44,0,1167,1196,1195,1,5,0,0,0,922,922,922,922
Modoc,86,2023-08-06,0,0,0,0,4,5,4,1,0,0,0,0,12,12,12,12
Mono,86,2023-08-06,1,1,1,0,19,20,19,1,0,0,0,0,8,8,8,8
Monterey,86,2023-08-06,65,65,65,0,948,972,971,1,4,1,1,0,837,837,836,836
Napa,86,2023-08-06,35,35,35,0,386,396,395,1,2,0,0,0,192,192,192,192
Nevada,86,2023-08-06,15,15,15,0,124,127,126,1,2,0,0,0,150,150,150,150
Orange,86,2023-08-06,789,809,809,0,6121,6275,6274,1,75,3,4,5,8103,8107,8100,8103
Placer,86,2023-08-06,111,112,112,0,823,846,845,1,27,0,0,6,724,724,724,724
Plumas,86,2023-08-06,9,9,9,0,30,31,30,1,0,0,0,0,15,15,15,15
Riverside,86,2023-08-06,476,489,489,0,3667,3761,3760,1,34,4,5,6,7013,7014,7009,7009
Sacramento,86,2023-08-06,402,413,413,0,4104,4207,4206,1,45,3,5,5,3664,3668,3661,3663
San Benito,86,2023-08-06,25,25,25,0,217,225,224,1,1,0,0,0,121,121,121,121
San Bernardino,86,2023-08-06,478,491,491,0,4494,4606,4605,1,26,2,3,6,8362,8364,8360,8361
San Diego,86,2023-08-06,1052,1077,1077,0,7839,8036,8035,1,99,2,3,5,6104,6106,6102,6103
San Francisco,86,2023-08-06,381,389,389,0,7535,7729,7728,1,34,1,1,6,1251,1251,1250,1250
San Joaquin,86,2023-08-06,206,212,212,0,5185,5316,5315,1,14,0,0,3,2506,2506,2506,2506
San Luis Obispo,86,2023-08-06,74,74,74,0,472,486,485,1,2,0,0,0,591,591,591,591
San Mateo,86,2023-08-06,277,284,284,0,2518,2582,2581,1,26,2,2,4,822,822,820,820
Santa Barbara,86,2023-08-06,122,124,124,0,749,769,768,1,16,3,4,0,812,813,809,809
Santa Clara,86,2023-08-06,714,733,733,0,16248,16657,16656,1,80,4,6,12,2915,2917,2911,2911
Santa Cruz,86,2023-08-06,67,67,67,0,666,685,684,1,8,2,2,0,325,325,323,323
Shasta,86,2023-08-06,27,27,27,0,127,132,131,1,1,0,0,1,658,658,658,658
Siskiyou,86,2023-08-06,6,6,6,0,44,45,44,1,0,0,0,1,102,102,102,102
Solano,86,2023-08-06,150,154,154,0,1194,1223,1222,1,18,3,5,0,533,535,530,530
Sonoma,86,2023-08-06,133,136,136,0,1321,1355,1354,1,16,1,2,0,616,617,615,615
Stanislaus,86,2023-08-06,211,218,218,0,1586,1627,1626,1,11,1,1,3,1909,1909,1908,1908
Sutter,86,2023-08-06,43,43,43,0,204,212,211,1,0,1,1,0,247,247,246,246
Tehama,86,2023-08-06,4,4,4,0,56,57,56,1,0,0,0,0,240,240,240,240
Trinity,86,2023-08-06,0,0,0,0,1,2,1,1,0,0,0,0,26,26,26,26
Tulare,86,2023-08-06,82,82,82,0,380,391,390,1,5,0,0,0,1623,1623,1623,1623
Tuolumne,86,2023-08-06,24,24,24,0,160,166,165,1,2,0,0,0,219,219,219,219
Ventura,86,2023-08-06,196,202,202,0,1496,1534,1533,1,19,1,1,4,1738,1738,1737,1737
Yolo,86,2023-08-06,45,45,45,0,408,418,417,1,0,0,0,1,466,466,466,466
Yuba,86,2023-08-06,17,17,17,0,162,167,166,1,0,0,0,1,143,143,143,143
Alameda,87,2023-08-13,616,637,637,0,5889,6094,6093,1,69,0,0,5,2248,2248,2248,2248
Amador,87,2023-08-13,6,6,6,0,85,87,86,1,0,0,0,0,99,99,99,99
Butte,87,2023-08-13,36,36,36,0,310,321,320,1,7,2,4,1,527,529,525,525
Calaveras,87,2023-08-13,17,17,17,0,154,162,161,1,0,0,0,0,145,145,145,145
Colusa,87,2023-08-13,1,1,1,0,18,19,18,1,0,0,0,0,27,27,27,27
Contra Costa,87,2023-08-13,514,532,532,0,4733,4898,4897,1,44,2,4,5,1677,1681,1675,1677
Del Norte,87,2023-08-13,18,18,18,0,98,102,101,1,1,0,0,1,61,61,61,61
El Dorado,87,2023-08-13,43,43,43,0,278,288,287,1,3,0,0,1,269,269,269,269
Fresno,87,2023-08-13,380,394,394,0,3137,3247,3246,1,49,2,4,6,3050,3054,3048,3050
Glenn,87,2023-08-13,5,5,5,0,92,95,94,1,0,0,0,0,62,62,62,62
Humboldt,87,2023-08-13,9,9,9,0,186,194,193,1,3,3,6,0,189,192,186,186
Imperial,87,2023-08-13,85,87,87,0,545,565,564,1,2,0,0,0,990,990,990,990
Inyo,87,2023-08-13,5,5,5,0,64,65,64,1,0,0,0,0,66,66,66,66
Kern,87,2023-08-13,322,333,333,0,3143,3250,3249,1,20,5,11,1,2539,2545,2534,2534
Kings,87,2023-08-13,94,97,97,0,382,396,395,1,4,0,0,2,488,488,488,488
Lake,87,2023-08-13,42,42,42,0,245,254,253,1,1,0,0,0,168,168,168,168
Lassen,87,2023-08-13,4,4,4,0,83,86,85,1,0,0,0,0,68,68,68,68
Los Angeles,87,2023-08-13,3668,3797,3797,0,32944,34099,34098,1,345,10,21,34,35744,35764,35734,35743
Madera,87,2023-08-13,51,51,51,0,468,485,484,1,2,0,0,0,390,390,390,390
Marin,87,2023-08-13,96,99,99,0,614,637,636,1,12,0,0,1,283,283,283,283
Mariposa,87,2023-08-13,5,5,5,0,28,29,28,1,0,0,0,0,33,33,33,33
Mendocino,87,2023-08-13,24,24,24,0,194,202,201,1,5,0,0,0,156,156,156,156
Merced,87,2023-08-13,89,92,92,0,618,641,640,1,4,1,2,0,923,924,922,922
Modoc,87,2023-08-13,1,1,1,0,5,6,5,1,0,0,0,0,12,12,12,12
Mono,87,2023-08-13,4,4,4,0,23,24,23,1,0,0,0,0,8,8,8,8
Monterey,87,2023-08-13,114,119,119,0,1117,1156,1155,1,9,0,0,0,837,837,837,837
Napa,87,2023-08-13,34,34,34,0,446,463,462,1,1,1,2,1,193,194,192,192
Nevada,87,2023-08-13,11,11,11,0,136,143,142,1,4,0,0,0,150,150,150,150
Orange,87,2023-08-13,932,965,965,0,6549,6778,6777,1,48,8,15,10,8111,8122,8103,8107
Placer,87,2023-08-13,119,123,123,0,808,836,835,1,41,0,0,2,724,724,724,724
Plumas,87,2023-08-13,8,8,8,0,41,42,41,1,0,0,0,0,15,15,15,15
Riverside,87,2023-08-13,553,572,572,0,4635,4797,4796,1,33,7,13,8,7020,7027,7013,7014
Sacramento,87,2023-08-13,470,486,486,0,4450,4606,4605,1,54,2,5,6,3666,3673,3664,3668
San Benito,87,2023-08-13,23,23,23,0,235,244,243,1,1,0,0,0,121,121,121,121
San Bernardino,87,2023-08-13,652,674,674,0,4977,5149,5148,1,46,1,3,5,8363,8367,8362,8364
San Diego,87,2023-08-13,1153,1194,1194,0,8817,9126,9125,1,96,8,19,8,6112,6125,6104,6106
San Francisco,87,2023-08-13,406,420,420,0,7412,7674,7673,1,42,1,2,8,1252,1253,1251,1251
San Joaquin,87,2023-08-13,337,350,350,0,4661,4826,4825,1,18,0,0,3,2506,2506,2506,2506
San Luis Obispo,87,2023-08-13,58,58,58,0,436,452,451,1,7,0,0,1,591,591,591,591
San Mateo,87,2023-08-13,300,310,310,0,2536,2624,2623,1,26,2,4,1,824,826,822,822
Santa Barbara,87,2023-08-13,142,148,148,0,787,817,816,1,12,1,2,2,813,815,812,813
Santa Clara,87,2023-08-13,856,885,885,0,17448,18061,18060,1,114,5,12,10,2920,2929,2915,2917
Santa Cruz,87,2023-08-13,84,85,85,0,629,653,652,1,8,1,2,0,326,327,325,325
Shasta,87,2023-08-13,23,23,23,0,154,159,158,1,1,1,3,3,659,661,658,658
Siskiyou,87,2023-08-13,1,1,1,0,47,48,47,1,0,0,0,0,102,102,102,102
Solano,87,2023-08-13,208,214,214,0,1348,1395,1394,1,26,1,2,1,534,537,533,535
Sonoma,87,2023-08-13,175,182,182,0,1412,1462,1461,1,17,0,0,1,616,617,616,617
Stanislaus,87,2023-08-13,223,230,230,0,2141,2219,2218,1,13,1,2,4,1910,1911,1909,1909
Sutter,87,2023-08-13,66,67,67,0,224,233,232,1,0,0,0,0,247,247,247,247
Tehama,87,2023-08-13,12,12,12,0,80,82,81,1,1,0,0,0,240,240,240,240
Trinity,87,2023-08-13,0,0,0,0,3,4,3,1,0,0,0,0,26,26,26,26
Tulare,87,2023-08-13,108,112,112,0,438,455,454,1,5,0,0,0,1623,1623,1623,1623
Tuolumne,87,2023-08-13,13,13,13,0,148,156,155,1,2,0,0,0,219,219,219,219
Ventura,87,2023-08-13,255,263,263,0,1605,1663,1662,1,23,1,3,1,1739,1741,1738,1738
Yolo,87,2023-08-13,50,50,50,0,439,455,454,1,1,0,0,0,466,466,466,466
Yuba,87,2023-08-13,50,50,50,0,222,231,230,1,1,0,0,0,143,143,143,143
Alameda,88,2023-08-20,746,796,796,0,6256,6652,6651,1,66,4,15,8,2252,2263,2248,2248
Amador,88,2023-08-20,8,8,8,0,110,117,116,1,1,0,0,0,99,99,99,99
Butte,88,2023-08-20,40,41,41,0,239,254,253,1,10,3,19,1,530,548,527,529
Calaveras,88,2023-08-20,7,7,7,0,131,141,140,1,0,0,0,0,145,145,145,145
Colusa,88,2023-08-20,2,2,2,0,20,21,20,1,0,0,0,0,27,27,27,27
Contra Costa,88,2023-08-20,567,603,603,0,4870,5181,5180,1,52,3,19,6,1680,1700,1677,1681
Del Norte,88,2023-08-20,35,36,36,0,88,96,95,1,0,0,0,1,61,61,61,61
El Dorado,88,2023-08-20,50,54,54,0,314,335,334,1,1,1,3,0,270,272,269,269
Fresno,88,2023-08-20,439,468,468,0,3686,3925,3924,1,71,1,3,5,3051,3057,3050,3054
Glenn,88,2023-08-20,3,3,3,0,86,90,89,1,0,0,0,0,62,62,62,62
Humboldt,88,2023-08-20,28,29,29,0,166,177,176,1,1,1,4,0,190,196,189,192
Imperial,88,2023-08-20,97,104,104,0,573,609,608,1,3,0,0,0,990,990,990,990
Inyo,88,2023-08-20,5,5,5,0,67,73,72,1,0,0,0,0,66,66,66,66
Kern,88,2023-08-20,379,404,404,0,3090,3282,3281,1,16,1,4,1,2540,2549,2539,2545
Kings,88,2023-08-20,103,111,111,0,426,455,454,1,5,0,0,2,488,488,488,488
Lake,88,2023-08-20,61,65,65,0,237,252,251,1,0,0,0,1,168,168,168,168
Lassen,88,2023-08-20,4,4,4,0,79,85,84,1,0,0,0,0,68,68,68,68
Los Angeles,88,2023-08-20,4342,4614,4614,0,31649,33564,33563,1,451,20,91,44,35764,35855,35744,35764
Madera,88,2023-08-20,62,67,67,0,582,619,618,1,2,0,0,0,390,390,390,390
Marin,88,2023-08-20,109,116,116,0,634,676,675,1,18,1,3,0,284,286,283,283
Mariposa,88,2023-08-20,10,10,10,0,31,33,32,1,0,0,0,0,33,33,33,33
Mendocino,88,2023-08-20,27,27,27,0,191,205,204,1,1,0,0,1,156,156,156,156
Merced,88,2023-08-20,117,124,124,0,670,713,712,1,5,2,8,0,925,932,923,924
Modoc,88,2023-08-20,0,0,0,0,3,4,3,1,0,0,0,0,12,12,12,12
Mono,88,2023-08-20,1,1,1,0,23,24,23,1,0,0,0,0,8,8,8,8
Monterey,88,2023-08-20,104,113,113,0,1087,1159,1158,1,6,0,0,11,837,837,837,837
Napa,88,2023-08-20,50,53,53,0,444,473,472,1,2,2,9,3,195,203,193,194
Nevada,88,2023-08-20,17,17,17,0,147,157,156,1,2,0,0,0,150,150,150,150
Orange,88,2023-08-20,1173,1249,1249,0,7300,7760,7759,1,49,5,18,9,8116,8140,8111,8122
Placer,88,2023-08-20,140,149,149,0,958,1022,1021,1,37,1,3,5,725,727,724,724
Plumas,88,2023-08-20,5,5,5,0,33,35,34,1,0,0,0,0,15,15,15,15
Riverside,88,2023-08-20,736,784,784,0,5132,5450,5449,1,38,3,15,7,7023,7042,7020,7027
Sacramento,88,2023-08-20,600,637,637,0,4791,5094,5093,1,65,3,10,6,3669,3683,3666,3673
San Benito,88,2023-08-20,29,29,29,0,227,243,242,1,0,0,0,0,121,121,121,121
San Bernardino,88,2023-08-20,800,850,850,0,5570,5915,5914,1,55,3,16,4,8366,8383,8363,8367
San Diego,88,2023-08-20,1340,1423,1423,0,9630,10233,10232,1,140,3,15,9,6115,6140,6112,6125
San Francisco,88,2023-08-20,444,472,472,0,7965,8490,8489,1,35,3,14,2,1255,1267,1252,1253
San Joaquin,88,2023-08-20,369,394,394,0,4989,5307,5306,1,13,1,3,4,2507,2509,2506,2506
San Luis Obispo,88,2023-08-20,75,80,80,0,509,542,541,1,1,1,3,0,592,594,591,591
San Mateo,88,2023-08-20,339,361,361,0,2723,2898,2897,1,22,3,9,3,827,835,824,826
Santa Barbara,88,2023-08-20,164,174,174,0,855,910,909,1,12,0,0,1,813,815,813,815
Santa Clara,88,2023-08-20,974,1037,1037,0,18631,19848,19847,1,109,4,17,11,2924,2946,2920,2929
Santa Cruz,88,2023-08-20,93,99,99,0,836,893,892,1,7,2,8,0,328,335,326,327
Shasta,88,2023-08-20,12,12,12,0,138,148,147,1,1,1,4,1,660,665,659,661
Siskiyou,88,2023-08-20,15,15,15,0,63,70,69,1,0,0,0,0,102,102,102,102
Solano,88,2023-08-20,208,221,221,0,1367,1455,1454,1,28,3,12,4,537,549,534,537
Sonoma,88,2023-08-20,200,213,213,0,1348,1434,1433,1,15,1,5,1,617,622,616,617
Stanislaus,88,2023-08-20,279,297,297,0,2034,2170,2169,1,17,4,17,4,1914,1928,1910,1911
Sutter,88,2023-08-20,74,81,81,0,291,312,311,1,0,1,4,0,248,251,247,247
Tehama,88,2023-08-20,10,10,10,0,78,84,83,1,1,0,0,0,240,240,240,240
Trinity,88,2023-08-20,2,2,2,0,6,7,6,1,0,0,0,0,26,26,26,26
Tulare,88,2023-08-20,170,181,181,0,660,702,701,1,11,2,11,0,1625,1634,1623,1623
Tuolumne,88,2023-08-20,29,30,30,0,164,176,175,1,0,0,0,0,219,219,219,219
Ventura,88,2023-08-20,246,262,262,0,1534,1634,1633,1,18,4,19,3,1743,1760,1739,1741
Yolo,88,2023-08-20,71,77,77,0,458,488,487,1,1,0,0,4,466,466,466,466
Yuba,88,2023-08-20,40,41,41,0,257,273,272,1,4,0,0,1,143,143,143,143
Alameda,89,2023-08-26,731,1099,1099,0,5840,9096,9095,1,56,3,45,4,2255,2308,2252,2263
Amador,89,2023-08-26,10,17,17,0,120,195,194,1,2,0,0,1,99,99,99,99
Butte,89,2023-08-26,50,66,66,0,282,412,411,1,11,0,0,2,530,548,530,548
Calaveras,89,2023-08-26,9,15,15,0,121,193,192,1,1,0,0,0,145,145,145,145
Colusa,89,2023-08-26,6,9,9,0,27,43,42,1,0,0,0,0,27,27,27,27
Contra Costa,89,2023-08-26,478,742,742,0,4707,7403,7402,1,35,2,51,5,1682,1751,1680,1700
Del Norte,89,2023-08-26,17,43,43,0,64,120,119,1,0,0,0,0,61,61,61,61
El Dorado,89,2023-08-26,40,67,67,0,248,395,394,1,1,1,9,1,271,281,270,272
Fresno,89,2023-08-26,512,779,779,0,3514,5406,5405,1,66,4,50,10,3055,3107,3051,3057
Glenn,89,2023-08-26,5,7,7,0,90,113,112,1,0,0,0,0,62,62,62,62
Humboldt,89,2023-08-26,25,49,49,0,110,185,184,1,0,0,0,1,190,196,190,196
Imperial,89,2023-08-26,73,122,122,0,477,723,722,1,3,1,9,1,991,999,990,990
Inyo,89,2023-08-26,10,17,17,0,67,121,120,1,0,1,18,0,67,84,66,66
Kern,89,2023-08-26,288,422,422,0,2511,3433,3432,1,21,0,0,3,2540,2549,2540,2549
Kings,89,2023-08-26,110,173,173,0,440,716,715,1,5,0,0,1,488,488,488,488
Lake,89,2023-08-26,56,82,82,0,241,383,382,1,2,0,0,2,168,168,168,168
Lassen,89,2023-08-26,8,13,13,0,70,109,108,1,0,0,0,0,68,68,68,68
Los Angeles,89,2023-08-26,3184,5004,5004,0,2802,4216,4215,1,484,7,131,44,35771,35986,35764,35855
Madera,89,2023-08-26,43,66,66,0,416,650,649,1,3,0,0,0,390,390,390,390
Marin,89,2023-08-26,104,150,150,0,625,1005,1004,1,20,0,0,0,284,286,284,286
Mariposa,89,2023-08-24,4,4,4,0,28,38,37,1,0,0,0,0,33,33,33,33
Mendocino,89,2023-08-26,20,34,34,0,135,218,217,1,2,0,0,0,156,156,156,156
Merced,89,2023-08-26,88,145,145,0,623,942,941,1,5,0,0,0,925,932,925,932
Modoc,89,2023-08-26,2,2,2,0,6,9,8,1,0,0,0,0,12,12,12,12
Mono,89,2023-08-26,3,4,4,0,23,40,39,1,1,0,0,0,8,8,8,8
Monterey,89,2023-08-26,109,173,173,0,918,1375,1374,1,19,0,0,1,837,837,837,837
Napa,89,2023-08-26,46,71,71,0,305,471,470,1,1,0,0,1,195,203,195,203
Nevada,89,2023-08-26,16,20,20,0,126,186,185,1,0,0,0,0,150,150,150,150
Orange,89,2023-08-26,1111,1788,1788,0,6685,10829,10828,1,69,1,18,10,8117,8158,8116,8140
Placer,89,2023-08-26,106,167,167,0,834,1367,1366,1,41,0,0,5,725,727,725,727
Plumas,89,2023-08-26,2,2,2,0,26,45,44,1,0,0,0,0,15,15,15,15
Riverside,89,2023-08-26,674,1050,1050,0,4835,7432,7431,1,62,0,0,9,7023,7042,7023,7042
Sacramento,89,2023-08-26,610,977,977,0,4176,6483,6482,1,54,0,0,6,3669,3683,3669,3683
San Benito,89,2023-08-26,38,54,54,0,226,340,339,1,0,0,0,0,121,121,121,121
San Bernardino,89,2023-08-26,628,922,922,0,5193,7681,7680,1,66,2,51,8,8368,8434,8366,8383
San Diego,89,2023-08-26,1207,1928,1928,0,8906,13231,13230,1,139,2,46,11,6117,6186,6115,6140
San Francisco,89,2023-08-26,356,539,539,0,6465,9323,9322,1,48,0,0,3,1255,1267,1255,1267
San Joaquin,89,2023-08-26,368,568,568,0,4477,6477,6476,1,17,2,20,4,2509,2529,2507,2509
San Luis Obispo,89,2023-08-26,58,96,96,0,489,803,802,1,7,0,0,0,592,594,592,594
San Mateo,89,2023-08-26,313,498,498,0,2429,3779,3778,1,22,0,0,3,827,835,827,835
Santa Barbara,89,2023-08-26,180,299,299,0,864,1423,1422,1,8,0,0,2,813,815,813,815
Santa Clara,89,2023-08-26,882,1364,1364,0,14410,20422,20421,1,110,0,0,13,2924,2946,2924,2946
Santa Cruz,89,2023-08-26,101,142,142,0,806,1174,1173,1,1,1,14,0,329,349,328,335
Shasta,89,2023-08-26,12,17,17,0,103,138,137,1,1,0,0,0,660,665,660,665
Siskiyou,89,2023-08-26,5,9,9,0,57,98,97,1,0,0,0,0,102,102,102,102
Solano,89,2023-08-26,199,317,317,0,1345,2106,2105,1,33,1,11,2,538,560,537,549
Sonoma,89,2023-08-26,159,248,248,0,1177,1917,1916,1,21,1,14,0,618,636,617,622
Stanislaus,89,2023-08-26,222,343,343,0,1962,3038,3037,1,22,0,0,1,1914,1928,1914,1928
Sutter,89,2023-08-26,86,159,159,0,300,522,521,1,0,0,0,0,248,251,248,251
Tehama,89,2023-08-26,5,6,6,0,58,81,80,1,1,0,0,0,240,240,240,240
Trinity,89,2023-08-22,0,0,0,0,0,1,0,1,0,0,0,0,26,26,26,26
Tulare,89,2023-08-26,157,214,214,0,633,901,900,1,15,2,27,1,1627,1661,1625,1634
Tuolumne,89,2023-08-26,14,22,22,0,163,257,256,1,0,0,0,0,219,219,219,219
Ventura,89,2023-08-26,232,362,362,0,1449,2301,2300,1,22,0,0,2,1743,1760,1743,1760
Yolo,89,2023-08-26,55,88,88,0,493,764,763,1,3,0,0,4,466,466,466,466
Yuba,89,2023-08-26,56,105,105,0,259,422,421,1,7,0,0,0,143,143,143,143
California,1,2021-12-19,44422,44422,20577,23845,1175451,1175451,544641,630810,2016,393,393,766,49888,49888,49495,49495
California,2,2021-12-26,113936,113936,60960,52976,1158290,1158290,603157,555133,2254,375,375,781,50263,50263,49888,49888
California,3,2022-01-02,302814,302814,179758,123056,1689763,1689763,982292,707471,3807,429,429,988,50692,50692,50263,50263
California,4,2022-01-09,533343,533343,341557,191786,2723094,2723096,1734497,988599,6348,637,637,1228,51329,51329,50692,50692
California,5,2022-01-16,478351,478351,327027,151324,2578155,2578155,1768056,810099,8081,902,902,1564,52231,52231,51329,51329
California,6,2022-01-23,369852,369852,269737,100115,2232914,2232914,1638444,594470,8823,1164,1164,1808,53395,53395,52231,52231
California,7,2022-01-30,217201,217201,167051,50150,1908248,1908248,1481616,426632,7930,1244,1244,1785,54639,54639,53395,53395
California,8,2022-02-06,123440,123440,99687,23753,1567506,1567506,1279500,288006,6313,1177,1177,1509,55816,55816,54639,54639
California,9,2022-02-13,71653,71653,60359,11294,1329237,1329237,1130519,198718,4943,981,981,1192,56797,56797,55816,55816
California,10,2022-02-20,41664,41664,36319,5345,1149343,1149343,1010188,139155,3651,717,717,860,57514,57514,56797,56797
California,11,2022-02-27,24495,24495,21999,2496,940002,940002,847515,92487,2682,516,516,635,58030,58030,57514,57514
California,12,2022-03-06,18347,18347,16862,1485,961243,961243,886863,74380,1918,347,347,490,58377,58377,58030,58030
California,13,2022-03-13,13656,13656,12780,876,897526,897526,842379,55147,1454,254,254,345,58631,58631,58377,58377
California,14,2022-03-20,10781,10781,10234,547,841920,841920,800948,40972,1189,177,177,240,58808,58808,58631,58631
California,15,2022-03-27,10811,10811,10379,432,761008,761008,731681,29327,940,143,143,201,58951,58951,58808,58808
California,16,2022-04-03,11688,11688,11327,361,738824,738824,716422,22402,663,102,102,180,59053,59053,58951,58951
California,17,2022-04-10,14254,14254,13908,346,663278,663278,647384,15894,636,78,78,114,59131,59131,59053,59053
California,18,2022-04-17,17384,17384,17049,335,662492,662492,649980,12512,628,76,76,114,59207,59207,59131,59131
California,19,2022-04-24,24695,24695,24324,371,717690,717690,707050,10640,644,65,65,92,59272,59272,59207,59207
California,20,2022-05-01,32251,32251,31879,372,782473,782473,773458,9015,703,64,64,124,59336,59336,59272,59272
California,21,2022-05-08,43033,43033,42642,391,835655,835656,828187,7469,802,54,54,146,59390,59390,59336,59336
California,22,2022-05-15,55447,55447,55052,395,892676,892681,886456,6225,950,84,84,147,59474,59474,59390,59390
California,23,2022-05-22,69355,69355,68973,382,921322,921336,916301,5035,1224,86,86,186,59560,59560,59474,59474
California,24,2022-05-29,71726,71726,71418,308,885843,885861,882062,3799,1479,101,101,199,59661,59661,59560,59560
California,25,2022-06-05,76993,76993,76737,256,795160,795177,792533,2644,1719,92,92,212,59753,59753,59661,59661
California,26,2022-06-12,76748,76748,76544,204,764656,764671,762647,2024,1888,134,134,235,59887,59887,59753,59753
California,27,2022-06-19,74204,74204,74056,148,698017,698032,696577,1455,1876,145,145,234,60032,60032,59887,59887
California,28,2022-06-26,80270,80270,80145,125,666639,666659,665577,1082,2223,148,148,249,60180,60180,60032,60032
California,29,2022-07-03,84889,84889,84785,104,643389,643425,642606,819,2343,175,175,307,60355,60355,60180,60180
California,30,2022-07-10,88166,88166,88086,80,611607,611642,611043,599,2688,211,211,359,60566,60566,60355,60355
California,31,2022-07-17,89199,89199,89134,65,644338,644379,643879,500,2873,179,179,382,60745,60745,60566,60566
California,32,2022-07-24,81941,81941,81898,43,622280,622325,621944,381,3034,224,224,373,60969,60969,60745,60745
California,33,2022-07-31,71065,71065,71034,31,576866,576918,576639,279,2950,248,248,389,61217,61217,60969,60969
California,34,2022-08-07,60065,60065,60047,18,536825,536881,536670,211,2718,211,211,351,61428,61428,61217,61217
California,35,2022-08-14,49873,49873,49863,10,507502,507568,507405,163,2447,202,202,316,61630,61630,61428,61428
California,36,2022-08-21,43684,43684,43679,5,499712,499814,499683,131,2186,165,165,310,61795,61795,61630,61630
California,37,2022-08-28,37806,37806,37804,2,498062,498193,498085,108,1911,138,138,253,61933,61933,61795,61795
California,38,2022-09-04,30057,30057,30057,0,474919,475071,474979,92,1783,157,157,257,62090,62090,61933,61933
California,39,2022-09-11,23901,23901,23901,0,417974,418151,418079,72,1715,130,130,251,62220,62220,62090,62090
California,40,2022-09-18,19960,19960,19960,0,438352,438585,438519,66,1506,128,128,206,62348,62348,62220,62220
California,41,2022-09-25,17824,17824,17824,0,404723,404971,404909,62,1372,113,113,193,62461,62461,62348,62348
California,42,2022-10-02,16916,16916,16916,0,373056,373335,373279,56,1199,103,103,186,62564,62564,62461,62461
California,43,2022-10-09,14673,14673,14673,0,348057,348344,348289,55,1082,78,78,172,62642,62642,62564,62564
California,44,2022-10-16,16127,16127,16127,0,393307,393653,393598,55,1068,88,88,171,62720,62720,62632,62632
California,45,2022-10-23,13397,13397,13397,0,328159,328496,328441,55,993,65,65,162,62785,62785,62720,62720
California,46,2022-10-30,14280,14280,14280,0,334989,335359,335304,55,1073,75,75,161,62860,62860,62785,62785
California,47,2022-11-06,17935,17935,17935,0,348469,348887,348832,55,1104,80,80,167,62940,62940,62860,62860
California,48,2022-11-13,20686,20687,20687,0,350457,350886,350831,55,1268,68,68,184,63008,63008,62940,62940
California,49,2022-11-20,26489,26493,26493,0,384885,385374,385319,55,1494,87,87,240,63095,63095,63008,63008
California,50,2022-11-27,31772,31798,31798,0,312985,313403,313348,55,2017,112,112,266,63207,63207,63095,63095
California,51,2022-12-04,45647,45687,45687,0,420912,421488,421433,55,2463,136,136,333,63343,63343,63207,63207
California,52,2022-12-11,40083,40114,40114,0,399634,400198,400143,55,2676,184,184,365,63527,63527,63343,63343
California,53,2022-12-18,36424,36455,36455,0,380881,381427,381372,55,2801,190,190,357,63717,63717,63527,63527
California,54,2022-12-25,34016,34045,34045,0,321223,321710,321655,55,2654,251,251,363,63968,63968,63717,63717
California,55,2023-01-01,33389,33420,33420,0,296153,296633,296578,55,2958,238,238,347,64206,64206,63968,63968
California,56,2023-01-08,24219,24238,24238,0,311447,311955,311900,55,2697,279,279,343,64485,64485,64206,64206
California,57,2023-01-15,15829,15834,15834,0,297368,297875,297820,55,2202,265,265,323,64750,64750,64485,64485
California,58,2023-01-22,12732,12735,12735,0,277466,277952,277897,55,1777,178,178,270,64928,64928,64750,64750
California,59,2023-01-29,13411,13415,13415,0,282011,282514,282459,55,1660,190,190,225,65118,65118,64928,64928
California,60,2023-02-05,15181,15184,15184,0,277301,277812,277757,55,1638,132,132,194,65250,65250,65118,65118
California,61,2023-02-12,15984,15989,15989,0,269652,270168,270113,55,1582,139,139,195,65389,65389,65250,65250
California,62,2023-02-19,14996,15000,15000,0,261681,262197,262142,55,1547,140,140,211,65529,65529,65389,65389
California,63,2023-02-26,14475,14482,14482,0,250668,251199,251144,55,1690,144,144,225,65673,65673,65529,65529
California,64,2023-03-05,12960,12962,12962,0,240396,240921,240866,55,1638,154,154,218,65827,65827,65673,65673
California,65,2023-03-12,12036,12038,12038,0,235774,236325,236270,55,1533,151,151,195,65978,65978,65827,65827
California,66,2023-03-19,9968,9968,9968,0,222455,222991,222936,55,1299,119,119,185,66097,66097,65978,65978
California,67,2023-03-26,8187,8187,8187,0,211547,212082,212027,55,1167,120,120,149,66217,66217,66097,66097
California,68,2023-04-02,7826,7826,7826,0,198132,198664,198609,55,1042,100,100,142,66317,66317,66217,66217
California,69,2023-04-09,7409,7409,7409,0,186047,186577,186522,55,987,105,105,140,66422,66422,66317,66317
California,70,2023-04-16,7406,7406,7406,0,181289,181843,181788,55,1032,87,87,134,66509,66509,66422,66422
California,71,2023-04-23,6662,6663,6663,0,168829,169388,169333,55,1069,105,105,130,66614,66614,66509,66509
California,72,2023-04-30,6221,6221,6221,0,159848,160433,160378,55,934,77,77,112,66691,66691,66614,66614
California,73,2023-05-07,5346,5346,5346,0,151939,152564,152509,55,866,73,73,110,66764,66764,66691,66691
California,74,2023-05-14,5500,5500,5500,0,145174,145833,145778,55,725,62,62,69,66826,66826,66764,66764
California,75,2023-05-21,4934,4934,4934,0,121109,121731,121676,55,697,66,66,97,66892,66892,66826,66826
California,76,2023-05-28,4265,4266,4266,0,109997,110608,110553,55,637,58,58,95,66950,66950,66892,66892
California,77,2023-06-04,4111,4114,4114,0,108046,108731,108676,55,665,67,67,79,67017,67017,66950,66950
California,78,2023-06-11,3781,3784,3784,0,100347,101093,101038,55,610,57,57,74,67074,67074,67017,67017
California,79,2023-06-18,3602,3606,3606,0,96859,97699,97644,55,575,47,47,70,67121,67121,67074,67074
California,80,2023-06-25,3601,3613,3613,0,96489,97453,97398,55,487,59,59,50,67180,67180,67121,67121
California,81,2023-07-01,74,74,74,0,989,1001,994,7,6,2,2,0,1235,1235,1233,1233
California,81,2023-07-02,3982,4003,4003,0,97304,98418,98370,48,392,45,45,36,65992,65992,65947,65947
California,82,2023-07-09,4293,4326,4326,0,88341,89489,89434,55,577,47,47,65,67274,67274,67227,67227
California,83,2023-07-16,4849,4901,4901,0,87692,88973,88918,55,589,46,46,59,67320,67320,67274,67274
California,84,2023-07-23,5427,5492,5492,0,90735,92262,92207,55,608,54,55,57,67374,67375,67320,67320
California,85,2023-07-30,6471,6576,6576,0,88846,90626,90571,55,676,68,75,68,67442,67450,67374,67375
California,86,2023-08-06,8293,8479,8479,0,89585,91876,91821,55,750,48,63,91,67490,67513,67442,67450
California,87,2023-08-13,9903,10224,10224,0,95773,99156,99101,55,876,56,120,98,67546,67633,67490,67513
California,88,2023-08-20,11708,12453,12453,0,102797,109401,109346,55,941,67,290,119,67613,67923,67546,67633
California,89,2023-08-22,0,0,0,0,0,1,0,1,0,0,0,0,26,26,26,26
California,89,2023-08-24,4,4,4,0,28,38,37,1,0,0,0,0,33,33,33,33
California,89,2023-08-26,10695,16671,16671,0,90926,137296,137243,53,1023,24,383,117,67578,68247,67554,67864
