county,time,date,cases,est_cases,est_omicron_cases,est_other_cases,tests,est_tests,est_omicron_tests,est_other_tests,hospitalizations,deaths,est_deaths,icu,cum_deaths,cum_est_deaths,prev_cum_deaths,prev_cum_est_deaths
Alameda,1,2021-12-20,2981,2981,1418,1563,89791,89791,41928,47863,47,9,9,14,1540,1540,1531,1531
Amador,1,2021-12-20,49,49,18,31,1719,1719,603,1116,2,0,0,3,70,70,70,70
Butte,1,2021-12-20,193,193,101,92,4385,4385,2285,2100,24,5,5,1,359,359,354,354
Calaveras,1,2021-12-20,59,59,23,36,1521,1521,583,938,1,2,2,0,92,92,90,90
Colusa,1,2021-12-20,11,11,5,6,397,397,170,227,1,0,0,0,21,21,21,21
Contra Costa,1,2021-12-20,1688,1688,591,1097,43231,43231,14849,28382,27,4,4,7,1080,1080,1076,1076
Del Norte,1,2021-12-20,19,19,8,11,1378,1378,570,808,0,0,0,0,42,42,42,42
El Dorado,1,2021-12-20,238,238,93,145,4466,4466,1729,2737,4,4,4,3,179,179,175,175
Fresno,1,2021-12-20,1057,1057,380,677,24967,24967,8886,16081,131,19,19,45,2420,2420,2401,2401
Glenn,1,2021-12-20,20,20,8,12,462,462,185,277,0,0,0,0,41,41,41,41
Humboldt,1,2021-12-20,164,164,67,97,3772,3772,1529,2243,11,1,1,2,121,121,120,120
Imperial,1,2021-12-20,584,584,225,359,5522,5522,2104,3418,40,9,9,27,817,817,808,808
Inyo,1,2021-12-20,31,31,14,17,358,358,154,204,1,1,1,0,49,49,48,48
Kern,1,2021-12-20,927,927,401,526,26097,26097,11162,14935,84,24,24,27,2023,2023,1999,1999
Kings,1,2021-12-20,244,244,94,150,6922,6922,2642,4280,15,6,6,3,389,389,383,383
Lake,1,2021-12-20,37,37,13,24,1317,1317,464,853,0,0,0,0,116,116,116,116
Lassen,1,2021-12-20,11,11,5,6,2389,2389,1094,1295,0,0,0,0,54,54,54,54
Los Angeles,1,2021-12-20,31637,31637,22015,9622,985582,985592,676238,309354,574,107,107,174,27372,27372,27265,27265
Madera,1,2021-12-20,159,159,56,103,6019,6019,2124,3895,9,3,3,5,334,334,331,331
Marin,1,2021-12-20,566,566,210,356,11814,11814,4296,7518,5,1,1,1,200,200,199,199
Mariposa,1,2021-12-20,21,21,7,14,448,448,154,294,0,0,0,0,21,21,21,21
Mendocino,1,2021-12-20,91,91,27,64,2687,2687,789,1898,3,2,2,4,103,103,101,101
Merced,1,2021-12-20,323,323,138,185,5620,5620,2368,3252,11,6,6,12,693,693,687,687
Modoc,1,2021-12-20,5,5,2,3,67,67,30,37,2,0,0,0,6,6,6,6
Mono,1,2021-12-20,37,37,10,27,313,313,81,232,1,0,0,0,4,4,4,4
Monterey,1,2021-12-20,481,481,126,355,13262,13262,3421,9841,23,3,3,8,642,642,639,639
Napa,1,2021-12-20,229,229,106,123,5390,5390,2432,2958,2,1,1,2,108,108,107,107
Nevada,1,2021-12-20,161,161,58,103,2764,2764,999,1765,4,1,1,2,110,110,109,109
Orange,1,2021-12-20,4869,4869,2406,2463,99405,99405,48418,50987,132,34,34,56,6024,6024,5990,5990
Placer,1,2021-12-20,555,555,190,365,11155,11155,3769,7386,53,6,6,24,501,501,495,495
Plumas,1,2021-12-20,16,16,6,10,513,513,195,318,0,0,0,0,12,12,12,12
Riverside,1,2021-12-20,5608,5608,2351,3257,78336,78336,32450,45886,238,40,40,82,5582,5582,5542,5542
Sacramento,1,2021-12-20,2148,2148,857,1291,53584,53584,21171,32413,101,21,21,41,2490,2490,2469,2469
San Benito,1,2021-12-20,91,91,41,50,1928,1928,860,1068,2,3,3,2,81,81,78,78
San Bernardino,1,2021-12-20,5013,5013,2370,2643,79713,79713,37188,42525,299,66,66,112,6514,6514,6448,6448
San Diego,1,2021-12-20,8653,8653,5914,2739,149647,149647,101549,48098,249,29,29,94,4477,4477,4448,4448
San Francisco,1,2021-12-20,2990,2990,741,2249,57027,57027,13812,43215,28,3,3,10,693,693,690,690
San Joaquin,1,2021-12-20,952,952,359,593,25328,25328,9394,15934,48,13,13,27,1973,1973,1960,1960
San Luis Obispo,1,2021-12-20,426,426,187,239,9994,9994,4350,5644,11,3,3,6,371,371,368,368
San Mateo,1,2021-12-20,1560,1560,771,789,50637,50637,24532,26105,9,0,0,5,601,601,601,601
Santa Barbara,1,2021-12-20,789,789,326,463,15821,15821,6436,9385,18,8,8,12,570,570,562,562
Santa Clara,1,2021-12-20,2949,2949,1982,967,118972,118972,78847,40125,85,8,8,38,1979,1979,1971,1971
Santa Cruz,1,2021-12-20,404,404,182,222,19820,19820,8762,11058,11,2,2,5,230,230,228,228
Shasta,1,2021-12-20,163,163,65,98,6035,6035,2392,3643,28,8,8,8,448,448,440,440
Siskiyou,1,2021-12-20,20,20,9,11,449,449,207,242,2,2,2,2,63,63,61,61
Solano,1,2021-12-20,495,495,206,289,14746,14746,6067,8679,21,4,4,5,389,389,385,385
Sonoma,1,2021-12-20,754,754,320,434,20782,20782,8669,12113,22,1,1,6,420,420,419,419
Stanislaus,1,2021-12-20,669,669,209,460,13023,13023,4036,8987,90,13,13,22,1432,1432,1419,1419
Sutter,1,2021-12-20,123,123,51,72,2315,2315,947,1368,0,2,2,0,193,193,191,191
Tehama,1,2021-12-20,52,52,17,35,1324,1324,425,899,4,0,0,3,165,165,165,165
Trinity,1,2021-12-20,1,1,0,1,98,98,31,67,0,1,1,0,19,19,18,18
Tulare,1,2021-12-20,404,404,125,279,12361,12361,3802,8559,36,19,19,13,1309,1309,1290,1290
Tuolumne,1,2021-12-20,97,97,35,62,1942,1942,694,1248,7,0,0,0,150,150,150,150
Ventura,1,2021-12-20,2046,2046,1052,994,39241,39241,19903,19338,62,9,9,14,1216,1216,1207,1207
Yolo,1,2021-12-20,329,329,146,183,24702,24702,10822,13880,4,0,0,1,295,295,295,295
Yuba,1,2021-12-20,100,100,43,57,1874,1874,799,1075,3,0,0,4,102,102,102,102
Alameda,2,2021-12-27,7515,7515,4027,3488,87426,87426,46211,41215,89,12,12,19,1552,1552,1540,1540
Amador,2,2021-12-27,92,92,38,54,1447,1447,591,856,2,0,0,3,70,70,70,70
Butte,2,2021-12-27,540,540,318,222,4553,4553,2663,1890,37,3,3,3,362,362,359,359
Calaveras,2,2021-12-27,100,100,45,55,989,989,442,547,1,1,1,1,93,93,92,92
Colusa,2,2021-12-27,27,27,14,13,243,243,119,124,4,0,0,0,21,21,21,21
Contra Costa,2,2021-12-27,5142,5142,2106,3036,46344,46344,18599,27745,44,3,3,16,1083,1083,1080,1080
Del Norte,2,2021-12-27,25,25,12,13,1423,1423,679,744,0,0,0,1,42,42,42,42
El Dorado,2,2021-12-27,511,511,231,280,4083,4083,1815,2268,7,0,0,4,179,179,179,179
Fresno,2,2021-12-27,2211,2211,935,1276,23827,23827,9917,13910,122,16,16,41,2436,2436,2420,2420
Glenn,2,2021-12-27,53,53,24,29,451,451,207,244,0,1,1,0,42,42,41,41
Humboldt,2,2021-12-27,500,500,237,263,3457,3457,1618,1839,10,1,1,0,122,122,121,121
Imperial,2,2021-12-27,885,885,398,487,5893,5893,2609,3284,35,10,10,26,827,827,817,817
Inyo,2,2021-12-27,109,109,54,55,447,447,219,228,0,1,1,0,50,50,49,49
Kern,2,2021-12-27,1986,1986,995,991,22595,22595,11167,11428,79,18,18,36,2041,2041,2023,2023
Kings,2,2021-12-27,507,507,230,277,5489,5489,2436,3053,17,1,1,3,390,390,389,389
Lake,2,2021-12-27,67,67,28,39,1203,1203,495,708,0,1,1,0,117,117,116,116
Lassen,2,2021-12-27,21,21,11,10,2244,2244,1161,1083,0,0,0,0,54,54,54,54
Los Angeles,2,2021-12-27,96150,96150,71610,24540,717733,717741,530967,186774,862,115,115,207,27487,27487,27372,27372
Madera,2,2021-12-27,342,342,145,197,4217,4217,1751,2466,9,2,2,4,336,336,334,334
Marin,2,2021-12-27,1606,1606,687,919,16776,16776,7085,9691,3,0,0,1,200,200,200,200
Mariposa,2,2021-12-27,36,36,15,21,493,493,195,298,0,0,0,0,21,21,21,21
Mendocino,2,2021-12-27,152,152,55,97,2496,2496,862,1634,5,0,0,2,103,103,103,103
Merced,2,2021-12-27,653,653,322,331,5105,5105,2474,2631,11,7,7,10,700,700,693,693
Modoc,2,2021-12-27,3,3,1,2,38,38,19,19,1,0,0,0,6,6,6,6
Mono,2,2021-12-27,123,123,38,85,366,366,110,256,1,0,0,0,4,4,4,4
Monterey,2,2021-12-27,1007,1007,318,689,12885,12885,3972,8913,21,3,3,11,645,645,642,642
Napa,2,2021-12-27,814,814,424,390,6694,6694,3461,3233,6,0,0,1,108,108,108,108
Nevada,2,2021-12-27,236,236,100,136,1985,1985,815,1170,6,1,1,1,111,111,110,110
Orange,2,2021-12-27,18072,18072,10081,7991,130371,130371,71895,58476,256,31,31,66,6055,6055,6024,6024
Placer,2,2021-12-27,1256,1256,504,752,10770,10770,4262,6508,63,2,2,27,503,503,501,501
Plumas,2,2021-12-27,18,18,8,10,299,299,129,170,0,0,0,0,12,12,12,12
Riverside,2,2021-12-27,13693,13693,6605,7088,87512,87512,41719,45793,306,53,53,81,5635,5635,5582,5582
Sacramento,2,2021-12-27,5199,5199,2414,2785,52491,52491,24008,28483,135,22,22,44,2512,2512,2490,2490
San Benito,2,2021-12-27,317,317,163,154,2307,2307,1173,1134,1,3,3,3,84,84,81,81
San Bernardino,2,2021-12-27,14406,14406,7740,6666,87908,87908,46463,41445,341,69,69,141,6583,6583,6514,6514
San Diego,2,2021-12-27,27040,27040,19873,7167,177616,177616,129654,47962,315,34,34,96,4511,4511,4477,4477
San Francisco,2,2021-12-27,6859,6859,2010,4849,65951,65951,19049,46902,31,1,1,14,694,694,693,693
San Joaquin,2,2021-12-27,2351,2351,1037,1314,22773,22773,9883,12890,61,15,15,25,1988,1988,1973,1973
San Luis Obispo,2,2021-12-27,1153,1153,583,570,11189,11189,5566,5623,11,1,1,8,372,372,371,371
San Mateo,2,2021-12-27,5282,5282,2932,2350,55547,55547,30398,25149,19,2,2,5,603,603,601,601
Santa Barbara,2,2021-12-27,2143,2143,1022,1121,15282,15282,7174,8108,33,5,5,10,575,575,570,570
Santa Clara,2,2021-12-27,9051,9051,6550,2501,107077,107077,76820,30257,95,10,10,38,1989,1989,1979,1979
Santa Cruz,2,2021-12-27,946,946,489,457,12423,12423,6305,6118,11,0,0,2,230,230,230,230
Shasta,2,2021-12-27,263,263,123,140,4624,4624,2123,2501,32,5,5,12,453,453,448,448
Siskiyou,2,2021-12-27,21,21,11,10,361,361,190,171,0,0,0,0,63,63,63,63
Solano,2,2021-12-27,1301,1301,627,674,17044,17044,8086,8958,25,5,5,5,394,394,389,389
Sonoma,2,2021-12-27,1914,1914,934,980,21670,21670,10427,11243,19,1,1,5,421,421,420,420
Stanislaus,2,2021-12-27,1249,1249,468,781,11157,11157,4117,7040,94,17,17,18,1449,1449,1432,1432
Sutter,2,2021-12-27,226,226,108,118,2131,2131,1006,1125,0,2,2,0,195,195,193,193
Tehama,2,2021-12-27,102,102,40,62,1106,1106,419,687,6,2,2,3,167,167,165,165
Trinity,2,2021-12-27,4,4,2,2,101,101,37,64,0,0,0,0,19,19,19,19
Tulare,2,2021-12-27,815,815,301,514,11126,11126,4060,7066,36,10,10,9,1319,1319,1309,1309
Tuolumne,2,2021-12-27,171,171,72,99,1674,1674,693,981,5,0,0,1,150,150,150,150
Ventura,2,2021-12-27,5720,5720,3307,2413,39333,39333,22503,16830,66,8,8,19,1224,1224,1216,1216
Yolo,2,2021-12-27,818,818,417,401,22119,22119,11081,11038,7,1,1,4,296,296,295,295
Yuba,2,2021-12-27,164,164,81,83,1534,1534,749,785,8,1,1,4,103,103,102,102
Alameda,3,2022-01-03,17672,17672,10489,7183,117303,117303,69479,47824,156,5,5,31,1557,1557,1552,1552
Amador,3,2022-01-03,220,220,105,115,2182,2182,1031,1151,5,1,1,2,71,71,70,70
Butte,3,2022-01-03,1203,1203,779,424,6871,6871,4430,2441,32,0,0,4,362,362,362,362
Calaveras,3,2022-01-03,232,232,120,112,1305,1305,666,639,0,1,1,1,94,94,93,93
Colusa,3,2022-01-03,48,48,26,22,393,393,217,176,5,0,0,0,21,21,21,21
Contra Costa,3,2022-01-03,13518,13518,6288,7230,69131,69131,32072,37059,76,10,10,21,1093,1093,1083,1083
Del Norte,3,2022-01-03,86,86,47,39,2132,2132,1143,989,0,0,0,0,42,42,42,42
El Dorado,3,2022-01-03,1292,1292,661,631,6062,6062,3079,2983,7,4,4,6,183,183,179,179
Fresno,3,2022-01-03,6611,6611,3178,3433,38555,38555,18405,20150,175,14,14,44,2450,2450,2436,2436
Glenn,3,2022-01-03,78,78,40,38,610,610,318,292,0,1,1,0,43,43,42,42
Humboldt,3,2022-01-03,881,881,471,410,5295,5295,2810,2485,9,1,1,3,123,123,122,122
Imperial,3,2022-01-03,1881,1881,957,924,9131,9131,4610,4521,35,14,14,29,841,841,827,827
Inyo,3,2022-01-03,265,265,147,118,713,713,394,319,3,0,0,0,50,50,50,50
Kern,3,2022-01-03,5835,5835,3271,2564,35879,35879,20000,15879,100,16,16,32,2057,2057,2041,2041
Kings,3,2022-01-03,1100,1100,563,537,8524,8524,4316,4208,13,3,3,5,393,393,390,390
Lake,3,2022-01-03,222,222,107,115,1777,1777,847,930,1,0,0,1,117,117,117,117
Lassen,3,2022-01-03,61,61,35,26,3119,3119,1806,1313,2,0,0,0,54,54,54,54
Los Angeles,3,2022-01-03,204178,204179,160579,43600,1088041,1088055,856018,232037,1937,149,149,303,27636,27636,27487,27487
Madera,3,2022-01-03,831,831,398,433,6371,6371,3028,3343,17,3,3,6,339,339,336,336
Marin,3,2022-01-03,2366,2366,1149,1217,17675,17675,8532,9143,15,1,1,3,201,201,200,200
Mariposa,3,2022-01-03,103,103,48,55,657,657,304,353,0,0,0,0,21,21,21,21
Mendocino,3,2022-01-03,453,453,187,266,3572,3572,1454,2118,7,1,1,2,104,104,103,103
Merced,3,2022-01-03,1607,1607,884,723,8551,8551,4668,3883,3,9,9,4,709,709,700,700
Modoc,3,2022-01-03,15,15,8,7,59,59,33,26,0,0,0,0,6,6,6,6
Mono,3,2022-01-03,180,180,65,115,435,435,156,279,2,0,0,0,4,4,4,4
Monterey,3,2022-01-03,2461,2461,906,1555,20644,20644,7549,13095,30,4,4,10,649,649,645,645
Napa,3,2022-01-03,1859,1859,1077,782,11772,11772,6799,4973,9,1,1,3,109,109,108,108
Nevada,3,2022-01-03,647,647,314,333,3071,3071,1485,1586,7,1,1,3,112,112,111,111
Orange,3,2022-01-03,45625,45625,27880,17745,220369,220372,134452,85920,504,34,34,110,6089,6089,6055,6055
Placer,3,2022-01-03,2913,2913,1336,1577,15073,15073,6863,8210,113,15,15,24,518,518,503,503
Plumas,3,2022-01-03,55,55,28,27,496,496,248,248,1,0,0,0,12,12,12,12
Riverside,3,2022-01-03,32071,32071,17323,14748,138460,138460,74452,64008,564,54,54,94,5689,5689,5635,5635
Sacramento,3,2022-01-03,14148,14148,7388,6760,80523,80523,41847,38676,219,25,25,57,2537,2537,2512,2512
San Benito,3,2022-01-03,739,739,422,317,3464,3464,1976,1488,3,1,1,2,85,85,84,84
San Bernardino,3,2022-01-03,33874,33874,20036,13838,135068,135068,79611,55457,571,94,94,136,6677,6677,6583,6583
San Diego,3,2022-01-03,60751,60751,47192,13559,253665,253668,196963,56705,561,35,35,121,4546,4546,4511,4511
San Francisco,3,2022-01-03,11449,11449,3977,7472,85547,85547,29518,56029,78,5,5,22,699,699,694,694
San Joaquin,3,2022-01-03,6979,6979,3480,3499,36115,36115,17893,18222,80,13,13,27,2001,2001,1988,1988
San Luis Obispo,3,2022-01-03,2472,2472,1386,1086,15977,15977,8925,7052,24,5,5,7,377,377,372,372
San Mateo,3,2022-01-03,10627,10627,6506,4121,81979,81979,50095,31884,37,4,4,7,607,607,603,603
Santa Barbara,3,2022-01-03,5328,5328,2852,2476,28196,28196,15054,13142,53,5,5,7,580,580,575,575
Santa Clara,3,2022-01-03,23034,23034,17708,5326,170187,170188,130649,39539,186,10,10,58,1999,1999,1989,1989
Santa Cruz,3,2022-01-03,2409,2409,1387,1022,21662,21662,12485,9177,15,5,5,3,235,235,230,230
Shasta,3,2022-01-03,601,601,318,283,6173,6173,3228,2945,33,2,2,13,455,455,453,453
Siskiyou,3,2022-01-03,74,74,43,31,590,590,348,242,0,0,0,0,63,63,63,63
Solano,3,2022-01-03,4069,4069,2179,1890,26133,26133,13981,12152,54,3,3,9,397,397,394,394
Sonoma,3,2022-01-03,4541,4541,2480,2061,32187,32187,17529,14658,25,7,7,4,428,428,421,421
Stanislaus,3,2022-01-03,3332,3332,1435,1897,17993,17993,7692,10301,129,9,9,20,1458,1458,1449,1449
Sutter,3,2022-01-03,547,547,296,251,2980,2980,1594,1386,0,2,2,0,197,197,195,195
Tehama,3,2022-01-03,215,215,96,119,1474,1474,652,822,4,1,1,2,168,168,167,167
Trinity,3,2022-01-03,14,14,6,8,107,107,46,61,0,0,0,0,19,19,19,19
Tulare,3,2022-01-03,2142,2142,917,1225,16018,16018,6780,9238,57,5,5,7,1324,1324,1319,1319
Tuolumne,3,2022-01-03,383,383,186,197,2549,2549,1229,1320,7,3,3,0,153,153,150,150
Ventura,3,2022-01-03,12671,12671,7986,4685,59675,59675,37563,22112,136,11,11,28,1235,1235,1224,1224
Yolo,3,2022-01-03,2327,2327,1327,1000,31707,31707,17935,13772,8,4,4,3,300,300,296,296
Yuba,3,2022-01-03,473,473,262,211,2331,2331,1284,1047,17,1,1,6,104,104,103,103
Alameda,4,2022-01-10,31196,31196,20210,10986,193861,193862,125724,68138,277,14,14,46,1571,1571,1557,1557
Amador,4,2022-01-10,387,387,207,180,2728,2728,1448,1280,4,0,0,4,71,71,71,71
Butte,4,2022-01-10,2000,2000,1395,605,10456,10456,7285,3171,55,2,2,4,364,364,362,362
Calaveras,4,2022-01-10,522,522,299,223,2606,2606,1478,1128,0,1,1,2,95,95,94,94
Colusa,4,2022-01-10,105,105,65,40,756,756,462,294,5,0,0,0,21,21,21,21
Contra Costa,4,2022-01-10,19733,19733,10335,9398,102270,102270,53553,48717,152,12,12,24,1105,1105,1093,1093
Del Norte,4,2022-01-10,177,177,106,71,3958,3958,2363,1595,2,0,0,0,42,42,42,42
El Dorado,4,2022-01-10,2214,2214,1260,954,9363,9363,5325,4038,14,6,6,2,189,189,183,183
Fresno,4,2022-01-10,14421,14421,7793,6628,59863,59863,32280,27583,301,14,14,47,2464,2464,2450,2450
Glenn,4,2022-01-10,219,219,127,92,938,938,544,394,2,0,0,0,43,43,43,43
Humboldt,4,2022-01-10,1401,1401,827,574,8355,8355,4924,3431,18,5,5,2,128,128,123,123
Imperial,4,2022-01-10,3624,3624,2048,1576,13821,13821,7793,6028,58,11,11,25,852,852,841,841
Inyo,4,2022-01-10,407,407,248,159,1356,1356,826,530,4,2,2,0,52,52,50,50
Kern,4,2022-01-10,11945,11945,7345,4600,57116,57116,35082,22034,181,26,26,35,2083,2083,2057,2057
Kings,4,2022-01-10,2405,2405,1376,1029,13028,13028,7410,5618,33,1,1,4,394,394,393,393
Lake,4,2022-01-10,496,496,266,230,2761,2761,1477,1284,0,3,3,1,120,120,117,117
Lassen,4,2022-01-10,196,196,126,70,3438,3438,2185,1253,1,0,0,0,54,54,54,54
Los Angeles,4,2022-01-10,329122,329127,270894,58233,1915123,1915149,1576832,338317,3253,270,270,513,27906,27906,27636,27636
Madera,4,2022-01-10,1912,1912,1028,884,10391,10391,5553,4838,19,1,1,6,340,340,339,339
Marin,4,2022-01-10,2942,2942,1602,1340,21014,21014,11439,9575,18,3,3,5,204,204,201,201
Mariposa,4,2022-01-10,199,199,105,94,1158,1158,607,551,0,1,1,0,22,22,21,21
Mendocino,4,2022-01-10,874,874,410,464,5538,5538,2581,2957,8,2,2,2,106,106,104,104
Merced,4,2022-01-10,3930,3930,2379,1551,14519,14519,8777,5742,33,10,10,11,719,719,709,709
Modoc,4,2022-01-10,13,13,8,5,109,109,67,42,0,0,0,0,6,6,6,6
Mono,4,2022-01-10,253,253,106,147,863,863,360,503,1,1,1,0,5,5,4,4
Monterey,4,2022-01-10,4977,4977,2116,2861,33239,33239,14054,19185,44,5,5,12,654,654,649,649
Napa,4,2022-01-10,2657,2657,1686,971,14407,14407,9137,5270,14,1,1,4,110,110,109,109
Nevada,4,2022-01-10,1193,1193,648,545,5233,5233,2839,2394,10,2,2,3,114,114,112,112
Orange,4,2022-01-10,60263,60263,40111,20152,317875,317880,211651,106229,854,100,100,159,6189,6189,6089,6089
Placer,4,2022-01-10,5202,5202,2695,2507,22555,22555,11665,10890,179,6,6,29,524,524,518,518
Plumas,4,2022-01-10,141,141,79,62,804,804,447,357,5,0,0,0,12,12,12,12
Riverside,4,2022-01-10,48248,48248,28845,19403,187774,187774,112225,75549,762,83,83,139,5772,5772,5689,5689
Sacramento,4,2022-01-10,27531,27531,15931,11600,121802,121802,70489,51313,375,37,37,89,2574,2574,2537,2537
San Benito,4,2022-01-10,1039,1039,655,384,4617,4617,2910,1707,3,1,1,2,86,86,85,85
San Bernardino,4,2022-01-10,50607,50607,32783,17824,192770,192770,124819,67951,784,113,113,187,6790,6790,6677,6677
San Diego,4,2022-01-10,81841,81841,66684,15157,330089,330094,269006,61088,895,66,66,166,4612,4612,4546,4546
San Francisco,4,2022-01-10,15102,15102,6037,9065,117291,117291,46957,70334,158,12,12,35,711,711,699,699
San Joaquin,4,2022-01-10,14507,14507,8083,6424,66828,66828,37176,29652,151,15,15,45,2016,2016,2001,2001
San Luis Obispo,4,2022-01-10,4337,4337,2676,1661,21634,21634,13364,8270,30,2,2,7,379,379,377,377
San Mateo,4,2022-01-10,15026,15026,10008,5018,113109,113109,75331,37778,95,5,5,16,612,612,607,607
Santa Barbara,4,2022-01-10,8537,8537,5053,3484,47384,47384,28052,19332,84,9,9,10,589,589,580,580
Santa Clara,4,2022-01-10,36500,36500,29455,7045,271174,271179,218792,52387,350,27,27,68,2026,2026,1999,1999
Santa Cruz,4,2022-01-10,4541,4541,2860,1681,42815,42815,26980,15835,25,2,2,2,237,237,235,235
Shasta,4,2022-01-10,1060,1060,619,441,8406,8406,4894,3512,37,7,7,12,462,462,455,455
Siskiyou,4,2022-01-10,120,120,77,43,919,919,591,328,3,1,1,1,64,64,63,63
Solano,4,2022-01-10,6927,6927,4128,2799,37137,37137,22139,14998,94,6,6,15,403,403,397,397
Sonoma,4,2022-01-10,8870,8870,5344,3526,47201,47201,28455,18746,72,9,9,8,437,437,428,428
Stanislaus,4,2022-01-10,6752,6752,3307,3445,29327,29327,14328,14999,173,13,13,19,1471,1471,1458,1458
Sutter,4,2022-01-10,1246,1246,743,503,5063,5063,3006,2057,0,2,2,0,199,199,197,197
Tehama,4,2022-01-10,509,509,255,254,2482,2482,1241,1241,13,1,1,1,169,169,168,168
Trinity,4,2022-01-10,38,38,19,19,275,275,135,140,0,0,0,0,19,19,19,19
Tulare,4,2022-01-10,5218,5218,2543,2675,24098,24098,11682,12416,66,9,9,8,1333,1333,1324,1324
Tuolumne,4,2022-01-10,806,806,436,370,4181,4181,2258,1923,13,1,1,1,154,154,153,153
Ventura,4,2022-01-10,17511,17511,11975,5536,88217,88217,60304,27913,227,23,23,34,1258,1258,1235,1235
Yolo,4,2022-01-10,3755,3755,2337,1418,48235,48235,29998,18237,6,4,4,1,304,304,300,300
Yuba,4,2022-01-10,1018,1018,622,396,4108,4108,2504,1604,41,0,0,7,104,104,104,104
Alameda,5,2022-01-17,24694,24694,17322,7372,170490,170490,119528,50962,366,33,33,62,1604,1604,1571,1571
Amador,5,2022-01-17,474,474,281,193,3561,3561,2083,1478,10,2,2,3,73,73,71,71
Butte,5,2022-01-17,2063,2063,1538,525,9327,9327,6949,2378,58,6,6,6,370,370,364,364
Calaveras,5,2022-01-17,564,564,353,211,2473,2473,1543,930,3,2,2,3,97,97,95,95
Colusa,5,2022-01-17,161,161,107,54,719,719,476,243,3,0,0,0,21,21,21,21
Contra Costa,5,2022-01-17,16219,16219,9470,6749,88049,88049,51326,36723,198,22,22,41,1127,1127,1105,1105
Del Norte,5,2022-01-17,199,199,130,69,3758,3758,2429,1329,2,0,0,1,42,42,42,42
El Dorado,5,2022-01-17,1964,1964,1228,736,8062,8062,5041,3021,9,4,4,2,193,193,189,189
Fresno,5,2022-01-17,18275,18275,10945,7330,65984,65984,39483,26501,386,27,27,61,2491,2491,2464,2464
Glenn,5,2022-01-17,306,306,194,112,1076,1076,683,393,3,2,2,0,45,45,43,43
Humboldt,5,2022-01-17,1144,1144,739,405,8323,8323,5365,2958,10,1,1,4,129,129,128,128
Imperial,5,2022-01-17,3416,3416,2124,1292,13215,13215,8215,5000,69,12,12,29,864,864,852,852
Inyo,5,2022-01-17,327,327,216,111,1040,1040,688,352,4,0,0,0,52,52,52,52
Kern,5,2022-01-17,11692,11692,7803,3889,51814,51814,34534,17280,242,29,29,44,2112,2112,2083,2083
Kings,5,2022-01-17,3200,3200,1999,1201,14878,14878,9266,5612,40,4,4,1,398,398,394,394
Lake,5,2022-01-17,582,582,347,235,3245,3245,1935,1310,2,1,1,2,121,121,120,120
Lassen,5,2022-01-17,284,284,196,88,3322,3322,2278,1044,0,0,0,0,54,54,54,54
Los Angeles,5,2022-01-17,218499,218502,186923,31579,1610438,1610460,1376769,233691,4034,505,505,680,28411,28411,27906,27906
Madera,5,2022-01-17,2402,2402,1433,969,10619,10619,6306,4313,32,5,5,10,345,345,340,340
Marin,5,2022-01-17,2418,2418,1459,959,17704,17704,10679,7025,38,4,4,6,208,208,204,204
Mariposa,5,2022-01-17,163,163,95,68,1115,1115,648,467,0,0,0,0,22,22,22,22
Mendocino,5,2022-01-17,922,922,487,435,5015,5015,2630,2385,18,3,3,2,109,109,106,106
Merced,5,2022-01-17,4193,4193,2764,1429,13648,13648,8995,4653,41,18,18,11,737,737,719,719
Modoc,5,2022-01-17,13,13,9,4,102,102,68,34,0,1,1,0,7,7,6,6
Mono,5,2022-01-17,198,198,94,104,809,809,386,423,2,0,0,0,5,5,5,5
Monterey,5,2022-01-17,5903,5903,2860,3043,28336,28336,13714,14622,69,6,6,14,660,660,654,654
Napa,5,2022-01-17,1940,1940,1335,605,11943,11943,8197,3746,21,2,2,5,112,112,110,110
Nevada,5,2022-01-17,1248,1248,750,498,5429,5429,3261,2168,19,1,1,1,115,115,114,114
Orange,5,2022-01-17,41399,41399,29696,11703,251613,251618,180318,71300,998,111,111,199,6300,6300,6189,6189
Placer,5,2022-01-17,4311,4311,2489,1822,19462,19462,11217,8245,178,14,14,36,538,538,524,524
Plumas,5,2022-01-17,193,193,119,74,852,852,524,328,3,0,0,0,12,12,12,12
Riverside,5,2022-01-17,41259,41259,26972,14287,168068,168068,109886,58182,920,97,97,158,5869,5869,5772,5772
Sacramento,5,2022-01-17,21468,21468,13662,7806,101468,101468,64496,36972,473,64,64,97,2638,2638,2574,2574
San Benito,5,2022-01-17,905,905,620,285,4273,4273,2922,1351,4,1,1,4,87,87,86,86
San Bernardino,5,2022-01-17,38409,38409,26868,11541,164345,164345,114961,49384,936,146,146,227,6936,6936,6790,6790
San Diego,5,2022-01-17,59803,59803,50763,9040,265931,265936,225762,40174,1067,103,103,193,4715,4715,4612,4612
San Francisco,5,2022-01-17,11256,11256,5198,6058,94022,94022,43310,50712,212,14,14,44,725,725,711,711
San Joaquin,5,2022-01-17,12716,12716,7802,4914,58099,58099,35651,22448,201,20,20,57,2036,2036,2016,2016
San Luis Obispo,5,2022-01-17,3934,3934,2647,1287,21033,21033,14133,6900,46,12,12,10,391,391,379,379
San Mateo,5,2022-01-17,12484,12484,8946,3538,95950,95950,68670,27280,92,10,10,30,622,622,612,612
Santa Barbara,5,2022-01-17,6854,6854,4446,2408,40488,40488,26232,14256,123,12,12,12,601,601,589,589
Santa Clara,5,2022-01-17,29563,29563,24874,4689,235967,235970,198419,37551,451,24,24,84,2050,2050,2026,2026
Santa Cruz,5,2022-01-17,4182,4182,2866,1316,42205,42205,28863,13342,23,3,3,3,240,240,237,237
Shasta,5,2022-01-17,1347,1347,863,484,9163,9163,5844,3319,55,7,7,14,469,469,462,462
Siskiyou,5,2022-01-17,158,158,110,48,927,927,640,287,3,1,1,2,65,65,64,64
Solano,5,2022-01-17,6431,6431,4198,2233,35205,35205,22974,12231,121,6,6,22,409,409,403,403
Sonoma,5,2022-01-17,7624,7624,5023,2601,42779,42779,28133,14646,73,7,7,15,444,444,437,437
Stanislaus,5,2022-01-17,7320,7320,4015,3305,29064,29064,15919,13145,206,10,10,31,1481,1481,1471,1471
Sutter,5,2022-01-17,1246,1246,810,436,4864,4864,3161,1703,0,4,4,0,203,203,199,199
Tehama,5,2022-01-17,615,615,344,271,2420,2420,1349,1071,15,5,5,2,174,174,169,169
Trinity,5,2022-01-17,41,41,23,18,255,255,140,115,0,1,1,0,20,20,19,19
Tulare,5,2022-01-17,7475,7475,4069,3406,27103,27103,14732,12371,97,16,16,16,1349,1349,1333,1333
Tuolumne,5,2022-01-17,887,887,532,355,3838,3838,2288,1550,10,8,8,1,162,162,154,154
Ventura,5,2022-01-17,11976,11976,8781,3195,66933,66933,49017,17916,300,41,41,56,1299,1299,1258,1258
Yolo,5,2022-01-17,2804,2804,1898,906,39491,39491,26701,12790,15,4,4,4,308,308,304,304
Yuba,5,2022-01-17,1063,1063,706,357,3747,3747,2489,1258,42,3,3,6,107,107,104,104
Alameda,6,2022-01-24,19725,19725,14809,4916,171779,171781,129136,42645,373,39,39,68,1643,1643,1604,1604
Amador,6,2022-01-24,542,542,351,191,4668,4668,3020,1648,8,0,0,5,73,73,73,73
Butte,6,2022-01-24,1907,1907,1504,403,9606,9606,7589,2017,82,10,10,9,380,380,370,370
Calaveras,6,2022-01-24,556,556,378,178,2508,2508,1706,802,6,2,2,2,99,99,97,97
Colusa,6,2022-01-24,177,177,127,50,951,951,680,271,6,0,0,0,21,21,21,21
Contra Costa,6,2022-01-24,13593,13593,8736,4857,85324,85324,54893,30431,217,25,25,64,1152,1152,1127,1127
Del Norte,6,2022-01-24,347,347,245,102,4326,4326,3042,1284,3,0,0,3,42,42,42,42
El Dorado,6,2022-01-24,1400,1400,954,446,7330,7330,5001,2329,17,2,2,6,195,195,193,193
Fresno,6,2022-01-24,17750,17750,11630,6120,68683,68683,45085,23598,491,43,43,83,2534,2534,2491,2491
Glenn,6,2022-01-24,250,250,172,78,971,971,670,301,0,0,0,0,45,45,45,45
Humboldt,6,2022-01-24,912,912,639,273,7714,7714,5409,2305,25,3,3,3,132,132,129,129
Imperial,6,2022-01-24,3629,3629,2463,1166,13165,13165,8953,4212,70,14,14,27,878,878,864,864
Inyo,6,2022-01-24,142,142,102,40,625,625,449,176,1,1,1,0,53,53,52,52
Kern,6,2022-01-24,10554,10554,7599,2955,53950,53950,38892,15058,267,47,47,51,2159,2159,2112,2112
Kings,6,2022-01-24,4306,4306,2925,1381,19081,19081,12988,6093,40,4,4,4,402,402,398,398
Lake,6,2022-01-24,745,745,487,258,3417,3417,2234,1183,6,2,2,3,123,123,121,121
Lassen,6,2022-01-24,418,418,307,111,3983,3983,2933,1050,6,0,0,0,54,54,54,54
Los Angeles,6,2022-01-24,164923,164925,145686,19239,1659202,1659229,1466707,192522,3769,611,611,785,29022,29022,28411,28411
Madera,6,2022-01-24,2716,2716,1771,945,12179,12179,7943,4236,49,8,8,10,353,353,345,345
Marin,6,2022-01-24,1855,1855,1226,629,17549,17549,11609,5940,38,4,4,10,212,212,208,208
Mariposa,6,2022-01-24,133,133,85,48,945,945,605,340,0,0,0,0,22,22,22,22
Mendocino,6,2022-01-24,917,917,538,379,4873,4873,2854,2019,23,2,2,3,111,111,109,109
Merced,6,2022-01-24,3445,3445,2458,987,12908,12908,9215,3693,55,9,9,12,746,746,737,737
Modoc,6,2022-01-24,14,14,10,4,114,114,82,32,2,0,0,0,7,7,7,7
Mono,6,2022-01-24,97,97,52,45,422,422,227,195,1,0,0,0,5,5,5,5
Monterey,6,2022-01-24,5089,5089,2775,2314,31803,31803,17338,14465,80,9,9,17,669,669,660,660
Napa,6,2022-01-24,1679,1679,1241,438,12490,12490,9224,3266,23,5,5,4,117,117,112,112
Nevada,6,2022-01-24,1001,1001,659,342,4806,4806,3170,1636,29,1,1,6,116,116,115,115
Orange,6,2022-01-24,26739,26739,20434,6305,230980,230985,176765,54220,923,177,177,191,6477,6477,6300,6300
Placer,6,2022-01-24,3660,3660,2330,1330,18646,18646,11868,6778,215,8,8,43,546,546,538,538
Plumas,6,2022-01-24,214,214,143,71,836,836,559,277,5,0,0,0,12,12,12,12
Riverside,6,2022-01-24,31906,31906,22575,9331,158787,158789,112471,46318,901,122,122,168,5991,5991,5869,5869
Sacramento,6,2022-01-24,17480,17480,12095,5385,98850,98850,68434,30416,542,64,64,105,2702,2702,2638,2638
San Benito,6,2022-01-24,776,776,570,206,3929,3929,2889,1040,7,1,1,3,88,88,87,87
San Bernardino,6,2022-01-24,28061,28061,21029,7032,153575,153576,115204,38372,975,171,171,223,7107,7107,6936,6936
San Diego,6,2022-01-24,50427,50427,44257,6170,252121,252126,221534,30592,1056,131,131,232,4846,4846,4715,4715
San Francisco,6,2022-01-24,8094,8094,4231,3863,88918,88918,46539,42379,232,19,19,37,744,744,725,725
San Joaquin,6,2022-01-24,11054,11054,7403,3651,59078,59078,39647,19431,241,34,34,71,2070,2070,2036,2036
San Luis Obispo,6,2022-01-24,3561,3561,2582,979,21529,21529,15612,5917,42,10,10,12,401,401,391,391
San Mateo,6,2022-01-24,8510,8510,6501,2009,95135,95135,72738,22397,139,20,20,28,642,642,622,622
Santa Barbara,6,2022-01-24,6483,6483,4558,1925,43832,43832,30826,13006,127,12,12,19,613,613,601,601
Santa Clara,6,2022-01-24,22788,22788,19874,2914,233312,233317,203465,29852,412,48,48,88,2098,2098,2050,2050
Santa Cruz,6,2022-01-24,5042,5042,3708,1334,45622,45622,33576,12046,31,1,1,2,241,241,240,240
Shasta,6,2022-01-24,1486,1486,1032,454,10135,10135,7033,3102,78,7,7,9,476,476,469,469
Siskiyou,6,2022-01-24,158,158,117,41,857,857,635,222,6,3,3,1,68,68,65,65
Solano,6,2022-01-24,5131,5131,3629,1502,32626,32626,23092,9534,143,14,14,26,423,423,409,409
Sonoma,6,2022-01-24,6927,6927,4931,1996,42477,42477,30248,12229,94,7,7,18,451,451,444,444
Stanislaus,6,2022-01-24,6380,6380,3879,2501,28276,28276,17216,11060,277,27,27,44,1508,1508,1481,1481
Sutter,6,2022-01-24,1045,1045,735,310,5002,5002,3521,1481,0,2,2,0,205,205,203,203
Tehama,6,2022-01-24,573,573,355,218,2702,2702,1674,1028,19,4,4,5,178,178,174,174
Trinity,6,2022-01-24,63,63,38,25,322,322,196,126,0,0,0,0,20,20,20,20
Tulare,6,2022-01-24,7679,7679,4633,3046,29535,29535,17858,11677,138,11,11,14,1360,1360,1349,1349
Tuolumne,6,2022-01-24,954,954,628,326,3833,3833,2514,1319,17,2,2,3,164,164,162,162
Ventura,6,2022-01-24,9411,9411,7331,2080,68522,68522,53429,15093,269,28,28,68,1327,1327,1299,1299
Yolo,6,2022-01-24,2299,2299,1676,623,40465,40465,29503,10962,18,12,12,5,320,320,308,308
Yuba,6,2022-01-24,908,908,651,257,3777,3777,2709,1068,54,3,3,10,110,110,107,107
Alameda,7,2022-01-31,10990,10990,8735,2255,137318,137320,109270,28050,336,50,50,75,1693,1693,1643,1643
Amador,7,2022-01-31,348,348,245,103,3226,3226,2273,953,15,1,1,4,74,74,73,73
Butte,7,2022-01-31,1163,1163,963,200,7608,7608,6305,1303,80,6,6,7,386,386,380,380
Calaveras,7,2022-01-31,263,263,193,70,1941,1941,1425,516,3,5,5,2,104,104,99,99
Colusa,7,2022-01-31,106,106,81,25,704,704,540,164,9,0,0,0,21,21,21,21
Contra Costa,7,2022-01-31,7307,7307,5094,2213,68634,68634,47926,20708,207,39,39,54,1191,1191,1152,1152
Del Norte,7,2022-01-31,314,314,236,78,3957,3957,2977,980,6,2,2,2,44,44,42,42
El Dorado,7,2022-01-31,738,738,542,196,6020,6020,4421,1599,13,4,4,5,199,199,195,195
Fresno,7,2022-01-31,11008,11008,7806,3202,54827,54827,38935,15892,503,39,39,98,2573,2573,2534,2534
Glenn,7,2022-01-31,190,190,140,50,759,759,563,196,2,3,3,0,48,48,45,45
Humboldt,7,2022-01-31,583,583,438,145,5790,5790,4348,1442,18,3,3,3,135,135,132,132
Imperial,7,2022-01-31,2205,2205,1607,598,11274,11274,8242,3032,71,17,17,28,895,895,878,878
Inyo,7,2022-01-31,55,55,42,13,467,467,357,110,5,3,3,0,56,56,53,53
Kern,7,2022-01-31,5648,5648,4339,1309,42265,42265,32504,9761,264,47,47,54,2206,2206,2159,2159
Kings,7,2022-01-31,2391,2391,1749,642,13688,13688,10022,3666,55,5,5,4,407,407,402,402
Lake,7,2022-01-31,473,473,334,139,3193,3193,2258,935,4,4,4,4,127,127,123,123
Lassen,7,2022-01-31,311,311,243,68,3625,3625,2839,786,7,1,1,0,55,55,54,54
Los Angeles,7,2022-01-31,74579,74579,67646,6933,1302852,1302877,1182569,120308,2991,640,640,719,29662,29662,29022,29022
Madera,7,2022-01-31,1746,1746,1235,511,9642,9642,6823,2819,50,6,6,7,359,359,353,353
Marin,7,2022-01-31,1063,1063,759,304,13818,13818,9889,3929,26,5,5,9,217,217,212,212
Mariposa,7,2022-01-31,101,101,70,31,842,842,586,256,0,2,2,0,24,24,22,22
Mendocino,7,2022-01-31,464,464,299,165,3486,3486,2252,1234,12,3,3,4,114,114,111,111
Merced,7,2022-01-31,2242,2242,1706,536,10470,10470,7979,2491,54,12,12,14,758,758,746,746
Modoc,7,2022-01-31,12,12,9,3,89,89,68,21,1,1,1,0,8,8,7,7
Mono,7,2022-01-31,41,41,25,16,339,339,203,136,0,0,0,0,5,5,5,5
Monterey,7,2022-01-31,3556,3556,2152,1404,26745,26745,16230,10515,82,9,9,13,678,678,669,669
Napa,7,2022-01-31,998,998,783,215,9406,9406,7378,2028,17,7,7,10,124,124,117,117
Nevada,7,2022-01-31,568,568,404,164,3912,3912,2788,1124,26,3,3,5,119,119,116,116
Orange,7,2022-01-31,12001,12001,9681,2320,177065,177070,142963,34107,708,170,170,164,6647,6647,6477,6477
Placer,7,2022-01-31,2256,2256,1560,696,15375,15375,10647,4728,152,19,19,42,565,565,546,546
Plumas,7,2022-01-31,136,136,98,38,753,753,542,211,1,0,0,0,12,12,12,12
Riverside,7,2022-01-31,15943,15943,12049,3894,121047,121047,91695,29352,740,111,111,171,6102,6102,5991,5991
Sacramento,7,2022-01-31,10146,10146,7528,2618,77598,77598,57661,19937,501,93,93,106,2795,2795,2702,2702
San Benito,7,2022-01-31,474,474,370,104,3323,3323,2596,727,5,2,2,3,90,90,88,88
San Bernardino,7,2022-01-31,13238,13238,10505,2733,116546,116546,92600,23946,744,185,185,207,7292,7292,7107,7107
San Diego,7,2022-01-31,24237,24237,21867,2370,181387,181391,163800,17591,944,106,106,214,4952,4952,4846,4846
San Francisco,7,2022-01-31,4046,4046,2359,1687,69168,69168,40403,28765,208,24,24,45,768,768,744,744
San Joaquin,7,2022-01-31,5697,5697,4122,1575,43661,43661,31652,12009,210,36,36,75,2106,2106,2070,2070
San Luis Obispo,7,2022-01-31,1981,1981,1530,451,16245,16245,12548,3697,40,12,12,10,413,413,401,401
San Mateo,7,2022-01-31,4327,4327,3488,839,75104,75104,60568,14536,131,10,10,19,652,652,642,642
Santa Barbara,7,2022-01-31,3635,3635,2734,901,35029,35029,26387,8642,103,23,23,13,636,636,613,613
Santa Clara,7,2022-01-31,13837,13837,12416,1421,207120,207125,185908,21217,427,55,55,93,2153,2153,2098,2098
Santa Cruz,7,2022-01-31,3439,3439,2680,759,51420,51420,40150,11270,35,5,5,6,246,246,241,241
Shasta,7,2022-01-31,900,900,670,230,8419,8419,6269,2150,59,13,13,11,489,489,476,476
Siskiyou,7,2022-01-31,119,119,94,25,691,691,545,146,8,2,2,2,70,70,68,68
Solano,7,2022-01-31,3812,3812,2885,927,28704,28704,21721,6983,126,6,6,30,429,429,423,423
Sonoma,7,2022-01-31,3568,3568,2710,858,32148,32148,24453,7695,84,12,12,15,463,463,451,451
Stanislaus,7,2022-01-31,3693,3693,2462,1231,22315,22315,14903,7412,261,33,33,53,1541,1541,1508,1508
Sutter,7,2022-01-31,617,617,465,152,3764,3764,2837,927,0,4,4,0,209,209,205,205
Tehama,7,2022-01-31,377,377,256,121,2022,2022,1368,654,17,3,3,5,181,181,178,178
Trinity,7,2022-01-31,43,43,29,14,227,227,151,76,0,0,0,0,20,20,20,20
Tulare,7,2022-01-31,4689,4689,3100,1589,22914,22914,15182,7732,150,22,22,21,1382,1382,1360,1360
Tuolumne,7,2022-01-31,710,710,502,208,3268,3268,2317,951,12,2,2,4,166,166,164,164
Ventura,7,2022-01-31,4594,4594,3762,832,52326,52326,42902,9424,253,39,39,48,1366,1366,1327,1327
Yolo,7,2022-01-31,1353,1353,1049,304,37502,37502,29101,8401,19,5,5,5,325,325,320,320
Yuba,7,2022-01-31,522,522,400,122,2932,2932,2244,688,78,2,2,11,112,112,110,110
Alameda,8,2022-02-07,5967,5967,4968,999,115670,115670,96371,19299,254,44,44,62,1737,1737,1693,1693
Amador,8,2022-02-07,203,203,152,51,2909,2909,2187,722,14,4,4,5,78,78,74,74
Butte,8,2022-02-07,784,784,674,110,6392,6392,5504,888,74,8,8,12,394,394,386,386
Calaveras,8,2022-02-07,183,183,142,41,1427,1427,1112,315,2,2,2,1,106,106,104,104
Colusa,8,2022-02-07,71,71,57,14,555,555,449,106,0,0,0,0,21,21,21,21
Contra Costa,8,2022-02-07,4134,4134,3091,1043,54159,54159,40510,13649,149,32,32,52,1223,1223,1191,1191
Del Norte,8,2022-02-07,286,286,228,58,4003,4003,3184,819,5,0,0,0,44,44,44,44
El Dorado,8,2022-02-07,427,427,333,94,5034,5034,3927,1107,20,1,1,5,200,200,199,199
Fresno,8,2022-02-07,6395,6395,4844,1551,42476,42476,32216,10260,450,49,49,87,2622,2622,2573,2573
Glenn,8,2022-02-07,113,113,88,25,620,620,488,132,4,3,3,0,51,51,48,48
Humboldt,8,2022-02-07,467,467,371,96,4875,4875,3874,1001,15,1,1,2,136,136,135,135
Imperial,8,2022-02-07,1100,1100,854,246,7925,7925,6162,1763,46,12,12,26,907,907,895,895
Inyo,8,2022-02-07,38,38,30,8,447,447,361,86,5,0,0,0,56,56,56,56
Kern,8,2022-02-07,3474,3474,2813,661,34658,34658,28089,6569,190,33,33,43,2239,2239,2206,2206
Kings,8,2022-02-07,1353,1353,1052,301,10259,10259,7985,2274,52,14,14,5,421,421,407,407
Lake,8,2022-02-07,346,346,261,85,2624,2624,1985,639,11,1,1,5,128,128,127,127
Lassen,8,2022-02-07,140,140,115,25,3025,3025,2489,536,5,2,2,0,57,57,55,55
Los Angeles,8,2022-02-07,37352,37352,34595,2757,1151460,1151482,1066930,84552,2155,638,638,547,30300,30300,29662,29662
Madera,8,2022-02-07,1058,1058,800,258,8089,8089,6124,1965,38,4,4,9,363,363,359,359
Marin,8,2022-02-07,655,655,500,155,11292,11292,8617,2675,29,8,8,6,225,225,217,217
Mariposa,8,2022-02-07,51,51,38,13,581,581,432,149,0,0,0,0,24,24,24,24
Mendocino,8,2022-02-07,327,327,229,98,2817,2817,1974,843,12,2,2,5,116,116,114,114
Merced,8,2022-02-07,1267,1267,1019,248,8070,8070,6497,1573,53,13,13,12,771,771,758,758
Modoc,8,2022-02-07,25,25,20,5,219,219,179,40,3,0,0,0,8,8,8,8
Mono,8,2022-02-07,44,44,29,15,271,271,178,93,0,0,0,0,5,5,5,5
Monterey,8,2022-02-07,2223,2223,1475,748,22461,22461,14939,7522,68,11,11,14,689,689,678,678
Napa,8,2022-02-07,746,746,615,131,7782,7782,6409,1373,16,6,6,2,130,130,124,124
Nevada,8,2022-02-07,357,357,271,86,3187,3187,2429,758,24,3,3,1,122,122,119,119
Orange,8,2022-02-07,6409,6409,5403,1006,152316,152320,128468,23852,494,118,118,125,6765,6765,6647,6647
Placer,8,2022-02-07,1294,1294,960,334,11887,11887,8831,3056,148,22,22,34,587,587,565,565
Plumas,8,2022-02-07,79,79,60,19,521,521,399,122,1,1,1,0,13,13,12,12
Riverside,8,2022-02-07,8145,8145,6513,1632,93432,93432,74777,18655,548,107,107,116,6209,6209,6102,6102
Sacramento,8,2022-02-07,6078,6078,4786,1292,63994,63994,50432,13562,390,72,72,95,2867,2867,2795,2795
San Benito,8,2022-02-07,308,308,253,55,2660,2660,2184,476,3,0,0,4,90,90,90,90
San Bernardino,8,2022-02-07,7048,7048,5862,1186,90093,90093,74994,15099,528,141,141,156,7433,7433,7292,7292
San Diego,8,2022-02-07,13408,13408,12368,1040,151888,151891,140176,11715,773,116,116,169,5068,5068,4952,4952
San Francisco,8,2022-02-07,2406,2406,1551,855,55777,55777,35912,19865,171,25,25,40,793,793,768,768
San Joaquin,8,2022-02-07,3344,3344,2578,766,36524,36524,28205,8319,186,43,43,62,2149,2149,2106,2106
San Luis Obispo,8,2022-02-07,1204,1204,979,225,12349,12349,10048,2301,23,16,16,7,429,429,413,413
San Mateo,8,2022-02-07,2462,2462,2074,388,62132,62132,52353,9779,83,16,16,18,668,668,652,652
Santa Barbara,8,2022-02-07,2282,2282,1814,468,30728,30728,24436,6292,75,15,15,17,651,651,636,636
Santa Clara,8,2022-02-07,8031,8031,7374,657,175345,175349,161030,14319,377,32,32,74,2185,2185,2153,2153
Santa Cruz,8,2022-02-07,1901,1901,1560,341,38681,38681,31764,6917,28,4,4,5,250,250,246,246
Shasta,8,2022-02-07,673,673,531,142,6857,6857,5413,1444,64,16,16,10,505,505,489,489
Siskiyou,8,2022-02-07,89,89,74,15,720,720,595,125,10,2,2,0,72,72,70,70
Solano,8,2022-02-07,2237,2237,1783,454,24206,24206,19343,4863,91,5,5,28,434,434,429,429
Sonoma,8,2022-02-07,2086,2086,1676,410,27054,27054,21735,5319,57,7,7,11,470,470,463,463
Stanislaus,8,2022-02-07,2493,2493,1793,700,18746,18746,13507,5239,243,43,43,43,1584,1584,1541,1541
Sutter,8,2022-02-07,360,360,286,74,3305,3305,2631,674,0,5,5,0,214,214,209,209
Tehama,8,2022-02-07,278,278,202,76,1644,1644,1197,447,17,3,3,6,184,184,181,181
Trinity,8,2022-02-07,18,18,13,5,136,136,98,38,0,0,0,0,20,20,20,20
Tulare,8,2022-02-07,2706,2706,1934,772,17924,17924,12844,5080,130,27,27,21,1409,1409,1382,1382
Tuolumne,8,2022-02-07,348,348,263,85,2578,2578,1954,624,10,2,2,1,168,168,166,166
Ventura,8,2022-02-07,2691,2691,2297,394,42329,42329,36167,6162,207,40,40,45,1406,1406,1366,1366
Yolo,8,2022-02-07,863,863,705,158,30851,30851,25175,5676,12,11,11,6,336,336,325,325
Yuba,8,2022-02-07,333,333,269,64,2406,2406,1942,464,42,4,4,13,116,116,112,112
Alameda,9,2022-02-14,3395,3395,2935,460,98993,98993,85608,13385,190,39,39,48,1776,1776,1737,1737
Amador,9,2022-02-14,108,108,86,22,2345,2345,1866,479,8,3,3,3,81,81,78,78
Butte,9,2022-02-14,464,464,412,52,5317,5317,4721,596,64,10,10,9,404,404,394,394
Calaveras,9,2022-02-14,79,79,64,15,1163,1163,950,213,4,2,2,2,108,108,106,106
Colusa,9,2022-02-14,35,35,29,6,406,406,341,65,5,0,0,0,21,21,21,21
Contra Costa,9,2022-02-14,2399,2399,1900,499,44868,44868,35546,9322,123,23,23,31,1246,1246,1223,1223
Del Norte,9,2022-02-14,210,210,175,35,3338,3338,2775,563,6,0,0,3,44,44,44,44
El Dorado,9,2022-02-14,259,259,212,47,4433,4433,3631,802,21,4,4,3,204,204,200,200
Fresno,9,2022-02-14,3868,3868,3096,772,34840,34840,27901,6939,375,34,34,75,2656,2656,2622,2622
Glenn,9,2022-02-14,58,58,48,10,482,482,398,84,3,2,2,0,53,53,51,51
Humboldt,9,2022-02-14,328,328,273,55,4202,4202,3495,707,23,0,0,2,136,136,136,136
Imperial,9,2022-02-14,589,589,481,108,5945,5945,4857,1088,44,14,14,18,921,921,907,907
Inyo,9,2022-02-14,29,29,24,5,413,413,348,65,3,0,0,0,56,56,56,56
Kern,9,2022-02-14,2014,2014,1701,313,27235,27235,23014,4221,156,28,28,40,2267,2267,2239,2239
Kings,9,2022-02-14,774,774,633,141,8010,8010,6555,1455,43,8,8,5,429,429,421,421
Lake,9,2022-02-14,255,255,204,51,2307,2307,1842,465,6,2,2,5,130,130,128,128
Lassen,9,2022-02-14,155,155,133,22,2791,2791,2385,406,3,2,2,0,59,59,57,57
Los Angeles,9,2022-02-14,21444,21444,20191,1253,1052398,1052418,991074,61344,1572,489,489,423,30789,30789,30300,30300
Madera,9,2022-02-14,620,620,496,124,6469,6469,5170,1299,29,2,2,7,365,365,363,363
Marin,9,2022-02-14,382,382,308,74,10150,10150,8173,1977,23,5,5,4,230,230,225,225
Mariposa,9,2022-02-14,24,24,19,5,433,433,342,91,0,0,0,0,24,24,24,24
Mendocino,9,2022-02-14,207,207,155,52,2445,2445,1834,611,13,1,1,7,117,117,116,116
Merced,9,2022-02-14,753,753,634,119,6836,6836,5748,1088,37,13,13,8,784,784,771,771
Modoc,9,2022-02-14,17,17,14,3,124,124,104,20,0,0,0,0,8,8,8,8
Mono,9,2022-02-14,10,10,7,3,179,179,127,52,0,0,0,0,5,5,5,5
Monterey,9,2022-02-14,1227,1227,880,347,16950,16950,12154,4796,48,12,12,12,701,701,689,689
Napa,9,2022-02-14,400,400,343,57,6607,6607,5661,946,10,1,1,1,131,131,130,130
Nevada,9,2022-02-14,169,169,136,33,2568,2568,2066,502,19,3,3,5,125,125,122,122
Orange,9,2022-02-14,4006,4006,3500,506,132333,132336,115563,16773,354,115,115,77,6880,6880,6765,6765
Placer,9,2022-02-14,595,595,468,127,9967,9967,7844,2123,105,12,12,23,599,599,587,587
Plumas,9,2022-02-14,43,43,35,8,431,431,348,83,1,0,0,0,13,13,13,13
Riverside,9,2022-02-14,4611,4611,3858,753,74757,74757,62570,12187,400,85,85,86,6294,6294,6209,6209
Sacramento,9,2022-02-14,3418,3418,2824,594,53026,53026,43832,9194,349,60,60,66,2927,2927,2867,2867
San Benito,9,2022-02-14,158,158,135,23,2159,2159,1845,314,0,2,2,3,92,92,90,90
San Bernardino,9,2022-02-14,3708,3708,3203,505,72761,72761,62876,9885,338,117,117,128,7550,7550,7433,7433
San Diego,9,2022-02-14,7949,7949,7459,490,126085,126085,118373,7712,589,89,89,135,5157,5157,5068,5068
San Francisco,9,2022-02-14,1611,1611,1124,487,47606,47606,33266,14340,130,25,25,39,818,818,793,793
San Joaquin,9,2022-02-14,1984,1984,1611,373,30642,30642,24899,5743,123,37,37,53,2186,2186,2149,2149
San Luis Obispo,9,2022-02-14,798,798,677,121,10058,10058,8536,1522,24,9,9,7,438,438,429,429
San Mateo,9,2022-02-14,1344,1344,1174,170,55007,55007,48007,7000,63,17,17,11,685,685,668,668
Santa Barbara,9,2022-02-14,1054,1054,879,175,22483,22483,18754,3729,68,8,8,14,659,659,651,651
Santa Clara,9,2022-02-14,4636,4636,4335,301,155255,155259,145179,10080,296,27,27,59,2212,2212,2185,2185
Santa Cruz,9,2022-02-14,981,981,838,143,30369,30369,25920,4449,23,3,3,4,253,253,250,250
Shasta,9,2022-02-14,442,442,366,76,5851,5851,4841,1010,62,13,13,13,518,518,505,505
Siskiyou,9,2022-02-14,66,66,57,9,520,520,447,73,7,1,1,2,73,73,72,72
Solano,9,2022-02-14,1201,1201,1003,198,18983,18983,15871,3112,73,2,2,20,436,436,434,434
Sonoma,9,2022-02-14,1135,1135,953,182,21177,21177,17763,3414,55,8,8,7,478,478,470,470
Stanislaus,9,2022-02-14,1362,1362,1044,318,15085,15085,11575,3510,206,28,28,41,1612,1612,1584,1584
Sutter,9,2022-02-14,230,230,192,38,2861,2861,2385,476,0,3,3,0,217,217,214,214
Tehama,9,2022-02-14,179,179,138,41,1404,1404,1088,316,15,5,5,5,189,189,184,184
Trinity,9,2022-02-14,22,22,17,5,171,171,131,40,0,0,0,0,20,20,20,20
Tulare,9,2022-02-14,1479,1479,1127,352,15063,15063,11509,3554,116,27,27,19,1436,1436,1409,1409
Tuolumne,9,2022-02-14,192,192,154,38,2225,2225,1781,444,12,4,4,1,172,172,168,168
Ventura,9,2022-02-14,1510,1510,1332,178,35532,35532,31351,4181,141,36,36,26,1442,1442,1406,1406
Yolo,9,2022-02-14,479,479,407,72,26818,26818,22786,4032,10,7,7,3,343,343,336,336
Yuba,9,2022-02-14,215,215,181,34,2109,2109,1777,332,19,2,2,11,118,118,116,116
Alameda,10,2022-02-21,1920,1920,1711,209,77637,77637,69063,8574,138,28,28,26,1804,1804,1776,1776
Amador,10,2022-02-21,69,69,57,12,1921,1921,1598,323,7,3,3,3,84,84,81,81
Butte,10,2022-02-21,256,256,233,23,4424,4424,4025,399,63,12,12,4,416,416,404,404
Calaveras,10,2022-02-21,44,44,37,7,838,838,712,126,3,6,6,0,114,114,108,108
Colusa,10,2022-02-21,26,26,23,3,362,362,315,47,4,0,0,0,21,21,21,21
Contra Costa,10,2022-02-21,1304,1304,1081,223,34154,34154,28274,5880,66,18,18,30,1264,1264,1246,1246
Del Norte,10,2022-02-21,130,130,112,18,2704,2704,2329,375,8,0,0,1,44,44,44,44
El Dorado,10,2022-02-21,155,155,132,23,3612,3612,3078,534,8,2,2,5,206,206,204,204
Fresno,10,2022-02-21,2013,2013,1684,329,26834,26834,22448,4386,272,26,26,54,2682,2682,2656,2656
Glenn,10,2022-02-21,27,27,23,4,405,405,348,57,2,1,1,0,54,54,53,53
Humboldt,10,2022-02-21,192,192,166,26,3331,3331,2873,458,22,3,3,1,139,139,136,136
Imperial,10,2022-02-21,394,394,335,59,4741,4741,4034,707,31,6,6,10,927,927,921,921
Inyo,10,2022-02-21,10,10,9,1,326,326,284,42,1,0,0,0,56,56,56,56
Kern,10,2022-02-21,1285,1285,1123,162,24327,24327,21267,3060,95,23,23,25,2290,2290,2267,2267
Kings,10,2022-02-21,454,454,387,67,6552,6552,5584,968,32,4,4,5,433,433,429,429
Lake,10,2022-02-21,183,183,153,30,1935,1935,1614,321,7,2,2,1,132,132,130,130
Lassen,10,2022-02-21,111,111,98,13,2136,2136,1883,253,1,0,0,0,59,59,59,59
Los Angeles,10,2022-02-21,11810,11810,11263,547,832210,832229,793202,39027,997,323,323,279,31112,31112,30789,30789
Madera,10,2022-02-21,317,317,265,52,5184,5184,4322,862,27,2,2,7,367,367,365,365
Marin,10,2022-02-21,199,199,167,32,8846,8846,7426,1420,13,3,3,4,233,233,230,230
Mariposa,10,2022-02-21,23,23,19,4,374,374,309,65,0,1,1,0,25,25,24,24
Mendocino,10,2022-02-21,113,113,90,23,1942,1942,1539,403,9,2,2,3,119,119,117,117
Merced,10,2022-02-21,425,425,370,55,5162,5162,4491,671,26,10,10,7,794,794,784,784
Modoc,10,2022-02-21,9,9,8,1,65,65,57,8,2,0,0,0,8,8,8,8
Mono,10,2022-02-21,7,7,5,2,162,162,123,39,0,1,1,0,6,6,5,5
Monterey,10,2022-02-21,781,781,596,185,12980,12980,9896,3084,47,5,5,7,706,706,701,701
Napa,10,2022-02-21,229,229,202,27,4991,4991,4410,581,6,4,4,3,135,135,131,131
Nevada,10,2022-02-21,102,102,85,17,1985,1985,1665,320,16,2,2,5,127,127,125,125
Orange,10,2022-02-21,2468,2468,2217,251,110425,110426,99032,11394,256,79,79,69,6959,6959,6880,6880
Placer,10,2022-02-21,328,328,271,57,8679,8679,7157,1522,92,9,9,13,608,608,599,599
Plumas,10,2022-02-21,21,21,18,3,328,328,276,52,0,0,0,0,13,13,13,13
Riverside,10,2022-02-21,2437,2437,2113,324,61420,61420,53280,8140,262,53,53,61,6347,6347,6294,6294
Sacramento,10,2022-02-21,1965,1965,1686,279,42794,42794,36703,6091,249,33,33,47,2960,2960,2927,2927
San Benito,10,2022-02-21,104,104,92,12,1696,1696,1494,202,0,0,0,1,92,92,92,92
San Bernardino,10,2022-02-21,1902,1902,1694,208,60255,60255,53633,6622,251,82,82,78,7632,7632,7550,7550
San Diego,10,2022-02-21,4575,4575,4352,223,100593,100593,95692,4901,468,63,63,106,5220,5220,5157,5157
San Francisco,10,2022-02-21,975,975,730,245,40358,40358,30109,10249,98,11,11,24,829,829,818,818
San Joaquin,10,2022-02-21,1047,1047,886,161,23846,23846,20168,3678,91,25,25,31,2211,2211,2186,2186
San Luis Obispo,10,2022-02-21,441,441,386,55,7659,7659,6712,947,16,16,16,3,454,454,438,438
San Mateo,10,2022-02-21,695,695,624,71,42575,42575,38160,4415,47,8,8,8,693,693,685,685
Santa Barbara,10,2022-02-21,610,610,527,83,19196,19196,16578,2618,40,6,6,10,665,665,659,659
Santa Clara,10,2022-02-21,2515,2515,2385,130,120314,120316,114027,6289,224,26,26,53,2238,2238,2212,2212
Santa Cruz,10,2022-02-21,578,578,509,69,25013,25013,22014,2999,21,1,1,4,254,254,253,253
Shasta,10,2022-02-21,261,261,224,37,4976,4976,4276,700,46,9,9,10,527,527,518,518
Siskiyou,10,2022-02-21,47,47,42,5,450,450,398,52,6,4,4,1,77,77,73,73
Solano,10,2022-02-21,696,696,603,93,15111,15111,13094,2017,51,5,5,15,441,441,436,436
Sonoma,10,2022-02-21,628,628,546,82,16822,16822,14602,2220,36,2,2,8,480,480,478,478
Stanislaus,10,2022-02-21,731,731,590,141,11765,11765,9494,2271,168,29,29,30,1641,1641,1612,1612
Sutter,10,2022-02-21,121,121,105,16,2108,2108,1821,287,0,2,2,0,219,219,217,217
Tehama,10,2022-02-21,93,93,76,17,1219,1219,993,226,8,10,10,2,199,199,189,189
Trinity,10,2022-02-21,15,15,12,3,199,199,160,39,0,0,0,0,20,20,20,20
Tulare,10,2022-02-21,774,774,622,152,10933,10933,8790,2143,86,16,16,9,1452,1452,1436,1436
Tuolumne,10,2022-02-21,107,107,90,17,1786,1786,1493,293,2,6,6,2,178,178,172,172
Ventura,10,2022-02-21,884,884,800,84,27545,27545,24928,2617,107,22,22,22,1464,1464,1442,1442
Yolo,10,2022-02-21,282,282,248,34,20975,20975,18396,2579,7,6,6,3,349,349,343,343
Yuba,10,2022-02-21,131,131,114,17,1679,1679,1466,213,22,2,2,8,120,120,118,118
Alameda,11,2022-02-28,1475,1475,1348,127,78767,78767,71940,6827,113,15,15,23,1819,1819,1804,1804
Amador,11,2022-02-28,56,56,48,8,2077,2077,1796,281,7,0,0,2,84,84,84,84
Butte,11,2022-02-28,187,187,174,13,4476,4476,4157,319,45,6,6,4,422,422,416,416
Calaveras,11,2022-02-28,40,40,35,5,1254,1254,1105,149,0,3,3,0,117,117,114,114
Colusa,11,2022-02-28,10,10,9,1,406,406,364,42,5,0,0,0,21,21,21,21
Contra Costa,11,2022-02-28,934,934,805,129,35020,35020,30195,4825,56,15,15,19,1279,1279,1264,1264
Del Norte,11,2022-02-28,83,83,74,9,2876,2876,2557,319,5,3,3,2,47,47,44,44
El Dorado,11,2022-02-28,105,105,93,12,3686,3686,3252,434,5,2,2,3,208,208,206,206
Fresno,11,2022-02-28,1308,1308,1136,172,26293,26293,22843,3450,196,28,28,44,2710,2710,2682,2682
Glenn,11,2022-02-28,18,18,16,2,435,435,386,49,1,0,0,0,54,54,54,54
Humboldt,11,2022-02-28,156,156,139,17,2957,2957,2633,324,6,1,1,1,140,140,139,139
Imperial,11,2022-02-28,264,264,233,31,4766,4766,4195,571,13,6,6,10,933,933,927,927
Inyo,11,2022-02-28,10,10,9,1,379,379,341,38,0,0,0,0,56,56,56,56
Kern,11,2022-02-28,792,792,713,79,24605,24605,22152,2453,77,16,16,16,2306,2306,2290,2290
Kings,11,2022-02-28,246,246,216,30,6087,6087,5363,724,19,7,7,3,440,440,433,433
Lake,11,2022-02-28,110,110,95,15,1956,1956,1695,261,0,4,4,1,136,136,132,132
Lassen,11,2022-02-28,44,44,40,4,2100,2100,1902,198,1,2,2,0,61,61,59,59
Los Angeles,11,2022-02-28,8219,8219,7921,298,1057296,1057325,1018786,38539,753,221,221,174,31333,31333,31112,31112
Madera,11,2022-02-28,189,189,164,25,4632,4632,4020,612,20,2,2,6,369,369,367,367
Marin,11,2022-02-28,160,160,140,20,7664,7664,6681,983,13,3,3,3,236,236,233,233
Mariposa,11,2022-02-28,29,29,25,4,348,348,299,49,0,1,1,0,26,26,25,25
Mendocino,11,2022-02-28,84,84,70,14,1889,1889,1571,318,11,2,2,2,121,121,119,119
Merced,11,2022-02-28,284,284,255,29,5034,5034,4512,522,25,7,7,5,801,801,794,794
Modoc,11,2022-02-28,6,6,5,1,57,57,51,6,1,0,0,0,8,8,8,8
Mono,11,2022-02-28,5,5,4,1,169,169,136,33,0,0,0,0,6,6,6,6
Monterey,11,2022-02-28,355,355,286,69,14339,14339,11563,2776,28,9,9,5,715,715,706,706
Napa,11,2022-02-28,194,194,176,18,5599,5599,5084,515,8,3,3,2,138,138,135,135
Nevada,11,2022-02-28,71,71,62,9,2016,2016,1753,263,9,0,0,1,127,127,127,127
Orange,11,2022-02-28,1693,1693,1556,137,126376,126381,116117,10264,198,43,43,35,7002,7002,6959,6959
Placer,11,2022-02-28,248,248,213,35,8421,8421,7233,1188,65,4,4,13,612,612,608,608
Plumas,11,2022-02-28,23,23,20,3,370,370,323,47,0,0,0,0,13,13,13,13
Riverside,11,2022-02-28,1685,1685,1506,179,63270,63270,56573,6697,185,37,37,35,6384,6384,6347,6347
Sacramento,11,2022-02-28,1164,1164,1033,131,45702,45702,40520,5182,163,24,24,35,2984,2984,2960,2960
San Benito,11,2022-02-28,55,55,50,5,1809,1809,1638,171,0,0,0,1,92,92,92,92
San Bernardino,11,2022-02-28,1174,1174,1072,102,61096,61096,55776,5320,157,61,61,45,7693,7693,7632,7632
San Diego,11,2022-02-28,2991,2991,2877,114,100030,100031,96227,3804,341,38,38,83,5258,5258,5220,5220
San Francisco,11,2022-02-28,836,836,662,174,40068,40068,31744,8324,74,16,16,19,845,845,829,829
San Joaquin,11,2022-02-28,654,654,573,81,26088,26088,22866,3222,58,11,11,24,2222,2222,2211,2211
San Luis Obispo,11,2022-02-28,378,378,341,37,8513,8513,7680,833,9,5,5,2,459,459,454,454
San Mateo,11,2022-02-28,597,597,549,48,41440,41440,38086,3354,33,4,4,7,697,697,693,693
Santa Barbara,11,2022-02-28,368,368,328,40,21387,21387,19065,2322,36,5,5,10,670,670,665,665
Santa Clara,11,2022-02-28,1730,1730,1660,70,103093,103094,98974,4120,191,23,23,46,2261,2261,2238,2238
Santa Cruz,11,2022-02-28,460,460,416,44,27974,27974,25344,2630,20,2,2,4,256,256,254,254
Shasta,11,2022-02-28,167,167,148,19,4926,4926,4373,553,36,11,11,8,538,538,527,527
Siskiyou,11,2022-02-28,25,25,23,2,475,475,432,43,4,2,2,1,79,79,77,77
Solano,11,2022-02-28,475,475,425,50,15305,15305,13679,1626,47,3,3,17,444,444,441,441
Sonoma,11,2022-02-28,454,454,407,47,16950,16950,15185,1765,28,3,3,5,483,483,480,480
Stanislaus,11,2022-02-28,470,470,396,74,13370,13370,11283,2087,124,11,11,21,1652,1652,1641,1641
Sutter,11,2022-02-28,106,106,95,11,2333,2333,2079,254,0,2,2,0,221,221,219,219
Tehama,11,2022-02-28,58,58,49,9,1221,1221,1039,182,7,1,1,2,200,200,199,199
Trinity,11,2022-02-28,5,5,4,1,118,118,99,19,0,0,0,0,20,20,20,20
Tulare,11,2022-02-28,462,462,389,73,11881,11881,9994,1887,67,14,14,9,1466,1466,1452,1452
Tuolumne,11,2022-02-28,68,68,59,9,1489,1489,1294,195,6,3,3,1,181,181,178,178
Ventura,11,2022-02-28,547,547,506,41,29891,29891,27650,2241,75,10,10,11,1474,1474,1464,1464
Yolo,11,2022-02-28,207,207,187,20,26245,26245,23700,2545,4,5,5,6,354,354,349,349
Yuba,11,2022-02-28,69,69,62,7,1711,1711,1537,174,12,2,2,6,122,122,120,120
Alameda,12,2022-03-07,1090,1090,1015,75,72599,72600,67602,4998,77,11,11,16,1830,1830,1819,1819
Amador,12,2022-03-07,75,75,67,8,1428,1428,1274,154,6,2,2,1,86,86,84,84
Butte,12,2022-03-07,98,98,92,6,3638,3638,3434,204,33,4,4,3,426,426,422,422
Calaveras,12,2022-03-07,25,25,23,2,1048,1048,948,100,1,1,1,0,118,118,117,117
Colusa,12,2022-03-07,9,9,8,1,355,355,326,29,6,0,0,0,21,21,21,21
Contra Costa,12,2022-03-07,627,627,558,69,30973,30973,27548,3425,47,8,8,13,1287,1287,1279,1279
Del Norte,12,2022-03-07,50,50,46,4,1779,1779,1624,155,7,0,0,1,47,47,47,47
El Dorado,12,2022-03-07,77,77,70,7,3200,3200,2899,301,5,3,3,2,211,211,208,208
Fresno,12,2022-03-07,860,860,770,90,22201,22201,19876,2325,145,18,18,27,2728,2728,2710,2710
Glenn,12,2022-03-07,19,19,17,2,395,395,359,36,2,2,2,0,56,56,54,54
Humboldt,12,2022-03-07,80,80,73,7,3045,3045,2779,266,10,3,3,4,143,143,140,140
Imperial,12,2022-03-07,122,122,110,12,4465,4465,4039,426,16,5,5,10,938,938,933,933
Inyo,12,2022-03-07,10,10,9,1,269,269,247,22,0,0,0,0,56,56,56,56
Kern,12,2022-03-07,433,433,398,35,20836,20836,19187,1649,67,12,12,16,2318,2318,2306,2306
Kings,12,2022-03-07,201,201,182,19,4992,4992,4519,473,13,4,4,2,444,444,440,440
Lake,12,2022-03-07,62,62,55,7,1760,1760,1572,188,2,2,2,1,138,138,136,136
Lassen,12,2022-03-07,96,96,89,7,1891,1891,1749,142,0,1,1,0,62,62,61,61
Los Angeles,12,2022-03-07,5536,5536,5379,157,876056,876087,851163,24924,573,171,171,133,31504,31504,31333,31333
Madera,12,2022-03-07,133,133,119,14,3925,3925,3510,415,15,1,1,2,370,370,369,369
Marin,12,2022-03-07,154,154,138,16,7559,7559,6778,781,10,1,1,2,237,237,236,236
Mariposa,12,2022-03-07,11,11,10,1,298,298,264,34,0,1,1,0,27,27,26,26
Mendocino,12,2022-03-07,65,65,56,9,1643,1643,1418,225,6,0,0,2,121,121,121,121
Merced,12,2022-03-07,173,173,159,14,4539,4539,4164,375,17,7,7,5,808,808,801,801
Modoc,12,2022-03-07,0,0,0,0,54,54,50,4,0,0,0,0,8,8,8,8
Mono,12,2022-03-07,2,2,2,0,128,128,108,20,0,0,0,1,6,6,6,6
Monterey,12,2022-03-07,243,243,205,38,11056,11056,9327,1729,19,5,5,2,720,720,715,715
Napa,12,2022-03-07,200,200,185,15,4896,4896,4539,357,2,2,2,2,140,140,138,138
Nevada,12,2022-03-07,50,50,45,5,1751,1751,1569,182,0,2,2,0,129,129,127,127
Orange,12,2022-03-07,1257,1257,1176,81,107467,107472,100566,6906,138,29,29,28,7031,7031,7002,7002
Placer,12,2022-03-07,164,164,145,19,7797,7797,6916,881,54,3,3,11,615,615,612,612
Plumas,12,2022-03-07,7,7,6,1,266,266,239,27,0,0,0,0,13,13,13,13
Riverside,12,2022-03-07,980,980,898,82,53634,53634,49120,4514,125,26,26,30,6410,6410,6384,6384
Sacramento,12,2022-03-07,774,774,704,70,40208,40208,36587,3621,124,18,18,28,3002,3002,2984,2984
San Benito,12,2022-03-07,41,41,38,3,1525,1525,1411,114,0,2,2,1,94,94,92,92
San Bernardino,12,2022-03-07,793,793,738,55,54193,54193,50456,3737,95,43,43,38,7736,7736,7693,7693
San Diego,12,2022-03-07,2302,2302,2233,69,96671,96674,93790,2884,237,31,31,57,5289,5289,5258,5258
San Francisco,12,2022-03-07,699,699,581,118,37420,37420,31063,6357,62,5,5,11,850,850,845,845
San Joaquin,12,2022-03-07,439,439,396,43,21200,21200,19121,2079,33,9,9,19,2231,2231,2222,2222
San Luis Obispo,12,2022-03-07,245,245,226,19,7309,7309,6744,565,7,5,5,1,464,464,459,459
San Mateo,12,2022-03-07,529,529,495,34,40060,40060,37472,2588,30,2,2,3,699,699,697,697
Santa Barbara,12,2022-03-07,202,202,185,17,17716,17716,16188,1528,15,4,4,8,674,674,670,670
Santa Clara,12,2022-03-07,1466,1466,1420,46,112127,112132,108562,3570,128,13,13,38,2274,2274,2261,2261
Santa Cruz,12,2022-03-07,334,334,309,25,24974,24974,23115,1859,11,0,0,7,256,256,256,256
Shasta,12,2022-03-07,140,140,127,13,4940,4940,4498,442,24,8,8,3,546,546,538,538
Siskiyou,12,2022-03-07,12,12,11,1,399,399,370,29,2,1,1,0,80,80,79,79
Solano,12,2022-03-07,351,351,321,30,14066,14066,12875,1191,46,2,2,10,446,446,444,444
Sonoma,12,2022-03-07,323,323,296,27,14924,14924,13687,1237,26,3,3,6,486,486,483,483
Stanislaus,12,2022-03-07,276,276,241,35,10863,10863,9504,1359,94,10,10,13,1662,1662,1652,1652
Sutter,12,2022-03-07,81,81,74,7,1908,1908,1742,166,0,1,1,0,222,222,221,221
Tehama,12,2022-03-07,40,40,35,5,1115,1115,980,135,5,2,2,1,202,202,200,200
Trinity,12,2022-03-07,4,4,3,1,114,114,100,14,0,0,0,0,20,20,20,20
Tulare,12,2022-03-07,302,302,263,39,10287,10287,8978,1309,37,13,13,3,1479,1479,1466,1466
Tuolumne,12,2022-03-07,48,48,43,5,1254,1254,1123,131,2,0,0,1,181,181,181,181
Ventura,12,2022-03-07,417,417,392,25,26718,26718,25138,1580,45,4,4,11,1478,1478,1474,1474
Yolo,12,2022-03-07,160,160,148,12,22154,22154,20450,1704,3,2,2,2,356,356,354,354
Yuba,12,2022-03-07,59,59,54,5,1552,1552,1425,127,13,0,0,6,122,122,122,122
Alameda,13,2022-03-14,881,881,833,48,68953,68955,65204,3751,64,8,8,6,1838,1838,1830,1830
Amador,13,2022-03-14,31,31,28,3,1439,1439,1315,124,4,0,0,0,86,86,86,86
Butte,13,2022-03-14,82,82,78,4,3592,3592,3432,160,24,1,1,0,427,427,426,426
Calaveras,13,2022-03-14,17,17,16,1,990,990,914,76,1,1,1,1,119,119,118,118
Colusa,13,2022-03-14,4,4,4,0,257,257,240,17,4,0,0,0,21,21,21,21
Contra Costa,13,2022-03-14,566,566,516,50,29145,29145,26576,2569,19,5,5,9,1292,1292,1287,1287
Del Norte,13,2022-03-14,31,31,29,2,1415,1415,1317,98,1,2,2,1,49,49,47,47
El Dorado,13,2022-03-14,44,44,41,3,2980,2980,2757,223,4,1,1,0,212,212,211,211
Fresno,13,2022-03-14,526,526,482,44,21110,21110,19346,1764,120,10,10,20,2738,2738,2728,2728
Glenn,13,2022-03-14,11,11,10,1,342,342,318,24,1,0,0,0,56,56,56,56
Humboldt,13,2022-03-14,56,56,52,4,2651,2651,2466,185,3,1,1,2,144,144,143,143
Imperial,13,2022-03-14,75,75,69,6,4537,4537,4190,347,5,2,2,7,940,940,938,938
Inyo,13,2022-03-14,6,6,6,0,165,165,154,11,0,0,0,0,56,56,56,56
Kern,13,2022-03-14,301,301,282,19,20274,20274,19004,1270,42,14,14,12,2332,2332,2318,2318
Kings,13,2022-03-14,156,156,144,12,4703,4703,4349,354,17,1,1,2,445,445,444,444
Lake,13,2022-03-14,48,48,44,4,1570,1570,1436,134,1,1,1,0,139,139,138,138
Lassen,13,2022-03-14,5,5,5,0,1517,1517,1428,89,0,0,0,0,62,62,62,62
Los Angeles,13,2022-03-14,4061,4061,3971,90,845644,845676,826821,18855,412,115,115,91,31619,31619,31504,31504
Madera,13,2022-03-14,52,52,48,4,3583,3583,3280,303,12,0,0,2,370,370,370,370
Marin,13,2022-03-14,170,170,156,14,6532,6532,5997,535,7,1,1,0,238,238,237,237
Mariposa,13,2022-03-14,9,9,8,1,224,224,204,20,0,0,0,0,27,27,27,27
Mendocino,13,2022-03-14,35,35,31,4,1434,1434,1276,158,4,2,2,1,123,123,121,121
Merced,13,2022-03-14,134,134,125,9,4171,4171,3898,273,17,2,2,4,810,810,808,808
Modoc,13,2022-03-14,3,3,3,0,52,52,49,3,1,0,0,0,8,8,8,8
Mono,13,2022-03-14,2,2,2,0,118,118,103,15,0,0,0,0,6,6,6,6
Monterey,13,2022-03-14,157,157,137,20,10119,10119,8840,1279,14,4,4,2,724,724,720,720
Napa,13,2022-03-14,123,123,116,7,4114,4114,3876,238,6,1,1,3,141,141,140,140
Nevada,13,2022-03-14,50,50,46,4,1571,1571,1441,130,2,0,0,0,129,129,129,129
Orange,13,2022-03-14,827,827,785,42,101568,101573,96418,5155,109,32,32,31,7063,7063,7031,7031
Placer,13,2022-03-14,148,148,135,13,7319,7319,6658,661,45,3,3,5,618,618,615,615
Plumas,13,2022-03-14,4,4,4,0,317,317,291,26,0,0,0,0,13,13,13,13
Riverside,13,2022-03-14,741,741,692,49,52739,52739,49223,3516,87,15,15,16,6425,6425,6410,6410
Sacramento,13,2022-03-14,588,588,546,42,35141,35141,32618,2523,122,17,17,22,3019,3019,3002,3002
San Benito,13,2022-03-14,36,36,34,2,1462,1462,1375,87,0,0,0,1,94,94,94,94
San Bernardino,13,2022-03-14,572,572,541,31,51689,51689,48869,2820,68,26,26,32,7762,7762,7736,7736
San Diego,13,2022-03-14,1821,1821,1778,43,96066,96070,93815,2255,174,17,17,47,5306,5306,5289,5289
San Francisco,13,2022-03-14,608,608,525,83,34320,34320,29599,4721,28,7,7,7,857,857,850,850
San Joaquin,13,2022-03-14,268,268,247,21,18878,18878,17392,1486,28,7,7,11,2238,2238,2231,2231
San Luis Obispo,13,2022-03-14,162,162,152,10,6671,6671,6261,410,7,7,7,1,471,471,464,464
San Mateo,13,2022-03-14,440,440,418,22,35834,35834,34000,1834,27,0,0,3,699,699,699,699
Santa Barbara,13,2022-03-14,195,195,182,13,16861,16861,15702,1159,16,7,7,2,681,681,674,674
Santa Clara,13,2022-03-14,1177,1177,1148,29,99878,99883,97385,2498,108,13,13,28,2287,2287,2274,2274
Santa Cruz,13,2022-03-14,239,239,225,14,22176,22176,20869,1307,10,3,3,3,259,259,256,256
Shasta,13,2022-03-14,97,97,90,7,4838,4838,4492,346,16,5,5,2,551,551,546,546
Siskiyou,13,2022-03-14,9,9,8,1,370,370,349,21,0,3,3,0,83,83,80,80
Solano,13,2022-03-14,221,221,206,15,12301,12301,11473,828,34,1,1,6,447,447,446,446
Sonoma,13,2022-03-14,227,227,212,15,13399,13399,12514,885,14,1,1,4,487,487,486,486
Stanislaus,13,2022-03-14,216,216,194,22,9403,9403,8455,948,82,11,11,17,1673,1673,1662,1662
Sutter,13,2022-03-14,41,41,38,3,1815,1815,1689,126,0,0,0,0,222,222,222,222
Tehama,13,2022-03-14,16,16,14,2,981,981,886,95,2,3,3,0,205,205,202,202
Trinity,13,2022-03-14,3,3,3,0,96,96,86,10,0,0,0,0,20,20,20,20
Tulare,13,2022-03-14,174,174,156,18,9308,9308,8354,954,33,0,0,6,1479,1479,1479,1479
Tuolumne,13,2022-03-14,22,22,20,2,1250,1250,1145,105,1,0,0,0,181,181,181,181
Ventura,13,2022-03-14,326,326,311,15,24592,24592,23441,1151,37,6,6,7,1484,1484,1478,1478
Yolo,13,2022-03-14,118,118,111,7,21620,21620,20302,1318,1,3,3,2,359,359,356,356
Yuba,13,2022-03-14,35,35,33,2,1417,1417,1325,92,10,2,2,3,124,124,122,122
Alameda,14,2022-03-21,722,722,691,31,65828,65832,63000,2832,58,6,6,3,1844,1844,1838,1838
Amador,14,2022-03-21,29,29,27,2,1356,1356,1263,93,2,0,0,0,86,86,86,86
Butte,14,2022-03-21,81,81,78,3,3158,3158,3048,110,17,0,0,2,427,427,427,427
Calaveras,14,2022-03-21,8,8,8,0,657,657,618,39,0,0,0,0,119,119,119,119
Colusa,14,2022-03-21,3,3,3,0,231,231,219,12,2,0,0,0,21,21,21,21
Contra Costa,14,2022-03-21,467,467,434,33,26932,26932,25040,1892,27,7,7,9,1299,1299,1292,1292
Del Norte,14,2022-03-21,19,19,18,1,1192,1192,1127,65,0,0,0,0,49,49,49,49
El Dorado,14,2022-03-21,46,46,43,3,2813,2813,2647,166,1,2,2,0,214,214,212,212
Fresno,14,2022-03-21,346,346,323,23,19327,19327,18045,1282,97,11,11,12,2749,2749,2738,2738
Glenn,14,2022-03-21,7,7,7,0,366,366,345,21,1,0,0,0,56,56,56,56
Humboldt,14,2022-03-21,31,31,29,2,2456,2456,2322,134,5,1,1,2,145,145,144,144
Imperial,14,2022-03-21,58,58,54,4,3952,3952,3714,238,4,3,3,4,943,943,940,940
Inyo,14,2022-03-21,1,1,1,0,148,148,140,8,0,0,0,0,56,56,56,56
Kern,14,2022-03-21,206,206,196,10,19492,19492,18527,965,34,4,4,9,2336,2336,2332,2332
Kings,14,2022-03-21,79,79,74,5,4417,4417,4153,264,7,1,1,1,446,446,445,445
Lake,14,2022-03-21,17,17,16,1,1365,1365,1272,93,0,0,0,0,139,139,139,139
Lassen,14,2022-03-21,10,10,10,0,1390,1390,1325,65,0,0,0,0,62,62,62,62
Los Angeles,14,2022-03-21,4131,4131,4060,71,822852,822889,808516,14373,338,76,76,66,31695,31695,31619,31619
Madera,14,2022-03-21,40,40,37,3,3397,3397,3169,228,9,1,1,1,371,371,370,370
Marin,14,2022-03-21,133,133,124,9,6231,6231,5825,406,6,1,1,0,239,239,238,238
Mariposa,14,2022-03-21,7,7,6,1,238,238,221,17,0,0,0,0,27,27,27,27
Mendocino,14,2022-03-21,28,28,26,2,1508,1508,1376,132,4,0,0,1,123,123,123,123
Merced,14,2022-03-21,86,86,82,4,3775,3775,3580,195,13,5,5,1,815,815,810,810
Modoc,14,2022-03-21,2,2,2,0,60,60,57,3,0,0,0,0,8,8,8,8
Mono,14,2022-03-21,4,4,4,0,134,134,120,14,1,0,0,0,6,6,6,6
Monterey,14,2022-03-21,152,152,137,15,10090,10090,9065,1025,22,0,0,1,724,724,724,724
Napa,14,2022-03-21,55,55,52,3,3454,3454,3297,157,6,1,1,2,142,142,141,141
Nevada,14,2022-03-21,18,18,17,1,1528,1528,1428,100,2,0,0,0,129,129,129,129
Orange,14,2022-03-21,761,761,731,30,96141,96146,92293,3853,100,12,12,25,7075,7075,7063,7063
Placer,14,2022-03-21,112,112,104,8,6475,6475,6010,465,40,2,2,6,620,620,618,618
Plumas,14,2022-03-21,2,2,2,0,228,228,213,15,0,0,0,0,13,13,13,13
Riverside,14,2022-03-21,612,612,580,32,51898,51898,49141,2757,69,13,13,18,6438,6438,6425,6425
Sacramento,14,2022-03-21,464,464,438,26,32988,32988,31117,1871,89,13,13,13,3032,3032,3019,3019
San Benito,14,2022-03-21,19,19,18,1,1385,1385,1320,65,0,1,1,0,95,95,94,94
San Bernardino,14,2022-03-21,472,472,452,20,49320,49320,47189,2131,49,20,20,31,7782,7782,7762,7762
San Diego,14,2022-03-21,1356,1356,1331,25,84594,84599,83043,1556,146,15,15,39,5321,5321,5306,5306
San Francisco,14,2022-03-21,687,687,612,75,33568,33568,29856,3712,34,3,3,3,860,860,857,857
San Joaquin,14,2022-03-21,220,220,206,14,15673,15673,14702,971,23,6,6,6,2244,2244,2238,2238
San Luis Obispo,14,2022-03-21,107,107,102,5,6426,6426,6113,313,3,5,5,0,476,476,471,471
San Mateo,14,2022-03-21,368,368,353,15,34928,34928,33524,1404,30,1,1,1,700,700,699,699
Santa Barbara,14,2022-03-21,161,161,152,9,14301,14301,13512,789,17,5,5,4,686,686,681,681
Santa Clara,14,2022-03-21,1100,1100,1079,21,95233,95238,93372,1866,101,5,5,20,2292,2292,2287,2287
Santa Cruz,14,2022-03-21,184,184,175,9,20037,20037,19102,935,8,0,0,3,259,259,259,259
Shasta,14,2022-03-21,41,41,39,2,4136,4136,3902,234,10,6,6,2,557,557,551,551
Siskiyou,14,2022-03-21,9,9,9,0,370,370,353,17,1,0,0,0,83,83,83,83
Solano,14,2022-03-21,187,187,177,10,11750,11750,11125,625,17,1,1,5,448,448,447,447
Sonoma,14,2022-03-21,230,230,218,12,12380,12380,11728,652,15,2,2,2,489,489,487,487
Stanislaus,14,2022-03-21,142,142,131,11,8430,8430,7754,676,59,12,12,8,1685,1685,1673,1673
Sutter,14,2022-03-21,34,34,32,2,1478,1478,1398,80,0,1,1,0,223,223,222,222
Tehama,14,2022-03-21,10,10,9,1,926,926,854,72,2,0,0,0,205,205,205,205
Trinity,14,2022-03-21,0,0,0,0,111,111,102,9,0,0,0,0,20,20,20,20
Tulare,14,2022-03-21,108,108,99,9,8172,8172,7505,667,27,5,5,4,1484,1484,1479,1479
Tuolumne,14,2022-03-21,19,19,18,1,1133,1133,1057,76,2,0,0,0,181,181,181,181
Ventura,14,2022-03-21,284,284,274,10,23283,23283,22423,860,30,5,5,6,1489,1489,1484,1484
Yolo,14,2022-03-21,106,106,101,5,21432,21432,20394,1038,1,0,0,1,359,359,359,359
Yuba,14,2022-03-21,42,42,40,2,1318,1318,1251,67,8,0,0,2,124,124,124,124
Alameda,15,2022-03-28,926,926,895,31,59266,59268,57269,1999,35,4,4,5,1848,1848,1844,1844
Amador,15,2022-03-28,8,8,8,0,1376,1376,1301,75,3,0,0,0,86,86,86,86
Butte,15,2022-03-28,64,64,62,2,2853,2853,2775,78,11,0,0,1,427,427,427,427
Calaveras,15,2022-03-28,15,15,14,1,580,580,553,27,0,0,0,0,119,119,119,119
Colusa,15,2022-03-28,4,4,4,0,207,207,199,8,0,0,0,0,21,21,21,21
Contra Costa,15,2022-03-28,532,532,503,29,24911,24911,23530,1381,29,1,1,6,1300,1300,1299,1299
Del Norte,15,2022-03-28,16,16,15,1,1038,1038,993,45,1,0,0,0,49,49,49,49
El Dorado,15,2022-03-28,60,60,57,3,2810,2810,2679,131,0,0,0,0,214,214,214,214
Fresno,15,2022-03-28,275,275,261,14,17893,17893,16954,939,71,5,5,18,2754,2754,2749,2749
Glenn,15,2022-03-28,8,8,8,0,333,333,318,15,0,0,0,0,56,56,56,56
Humboldt,15,2022-03-28,27,27,26,1,2608,2608,2495,113,4,0,0,3,145,145,145,145
Imperial,15,2022-03-28,62,62,59,3,3529,3529,3361,168,4,1,1,3,944,944,943,943
Inyo,15,2022-03-28,4,4,4,0,186,186,178,8,1,0,0,0,56,56,56,56
Kern,15,2022-03-28,144,144,138,6,18181,18181,17471,710,17,4,4,8,2340,2340,2336,2336
Kings,15,2022-03-28,57,57,54,3,4281,4281,4079,202,6,2,2,0,448,448,446,446
Lake,15,2022-03-28,10,10,9,1,1068,1068,1010,58,0,0,0,0,139,139,139,139
Lassen,15,2022-03-28,4,4,4,0,1286,1286,1238,48,0,0,0,0,62,62,62,62
Los Angeles,15,2022-03-28,4475,4475,4414,61,703836,703867,694140,9727,264,53,53,57,31748,31748,31695,31695
Madera,15,2022-03-28,24,24,23,1,3460,3460,3277,183,4,0,0,2,371,371,371,371
Marin,15,2022-03-28,180,180,171,9,6000,6000,5692,308,3,0,0,0,239,239,239,239
Mariposa,15,2022-03-28,5,5,5,0,181,181,171,10,0,1,1,0,28,28,27,27
Mendocino,15,2022-03-28,31,31,29,2,1314,1314,1223,91,0,1,1,0,124,124,123,123
Merced,15,2022-03-28,64,64,61,3,3363,3363,3227,136,5,1,1,3,816,816,815,815
Modoc,15,2022-03-28,3,3,3,0,45,45,43,2,0,0,0,0,8,8,8,8
Mono,15,2022-03-28,1,1,1,0,134,134,123,11,0,0,0,0,6,6,6,6
Monterey,15,2022-03-28,148,148,136,12,8785,8785,8072,713,14,1,1,0,725,725,724,724
Napa,15,2022-03-28,70,70,68,2,3335,3335,3216,119,1,2,2,1,144,144,142,142
Nevada,15,2022-03-28,27,27,26,1,1431,1431,1357,74,1,1,1,0,130,130,129,129
Orange,15,2022-03-28,814,814,789,25,90220,90225,87388,2837,81,12,12,17,7087,7087,7075,7075
Placer,15,2022-03-28,108,108,102,6,6223,6223,5871,352,26,4,4,6,624,624,620,620
Plumas,15,2022-03-28,3,3,3,0,267,267,253,14,0,0,0,0,13,13,13,13
Riverside,15,2022-03-28,522,522,500,22,43927,43927,42096,1831,47,7,7,10,6445,6445,6438,6438
Sacramento,15,2022-03-28,454,454,434,20,32475,32475,31025,1450,68,6,6,19,3038,3038,3032,3032
San Benito,15,2022-03-28,14,14,13,1,1365,1365,1315,50,0,0,0,0,95,95,95,95
San Bernardino,15,2022-03-28,544,544,526,18,41309,41309,39912,1397,40,18,18,24,7800,7800,7782,7782
San Diego,15,2022-03-28,1315,1315,1296,19,72132,72135,71100,1035,114,9,9,26,5330,5330,5321,5321
San Francisco,15,2022-03-28,844,844,770,74,32805,32805,29910,2895,23,5,5,5,865,865,860,860
San Joaquin,15,2022-03-28,189,189,180,9,17490,17490,16636,854,20,4,4,4,2248,2248,2244,2244
San Luis Obispo,15,2022-03-28,96,96,92,4,5710,5710,5492,218,5,1,1,1,477,477,476,476
San Mateo,15,2022-03-28,582,582,564,18,33959,33959,32884,1075,26,5,5,3,705,705,700,700
Santa Barbara,15,2022-03-28,135,135,129,6,10226,10226,9795,431,15,1,1,4,687,687,686,686
Santa Clara,15,2022-03-28,1275,1275,1256,19,95196,95201,93749,1452,88,11,11,18,2303,2303,2292,2292
Santa Cruz,15,2022-03-28,145,145,140,5,19692,19692,18975,717,3,0,0,2,259,259,259,259
Shasta,15,2022-03-28,34,34,32,2,3879,3879,3706,173,7,2,2,3,559,559,557,557
Siskiyou,15,2022-03-28,5,5,5,0,292,292,282,10,0,0,0,0,83,83,83,83
Solano,15,2022-03-28,169,169,162,7,10932,10932,10475,457,18,0,0,6,448,448,448,448
Sonoma,15,2022-03-28,259,259,249,10,8556,8556,8209,347,13,0,0,1,489,489,489,489
Stanislaus,15,2022-03-28,118,118,110,8,8187,8187,7668,519,28,2,2,3,1687,1687,1685,1685
Sutter,15,2022-03-28,25,25,24,1,1489,1489,1425,64,0,1,1,0,224,224,223,223
Tehama,15,2022-03-28,13,13,12,1,798,798,749,49,3,1,1,0,206,206,205,205
Trinity,15,2022-03-28,0,0,0,0,79,79,74,5,0,0,0,0,20,20,20,20
Tulare,15,2022-03-28,81,81,76,5,7846,7846,7338,508,20,6,6,1,1490,1490,1484,1484
Tuolumne,15,2022-03-28,7,7,7,0,1085,1085,1028,57,3,1,1,0,182,182,181,181
Ventura,15,2022-03-28,335,335,325,10,21204,21204,20590,614,23,6,6,3,1495,1495,1489,1489
Yolo,15,2022-03-28,103,103,99,4,20514,20514,19751,763,3,2,2,0,361,361,359,359
Yuba,15,2022-03-28,26,26,25,1,1214,1214,1165,49,2,2,2,1,126,126,124,124
Alameda,16,2022-04-04,1057,1057,1030,27,56225,56228,54734,1494,40,3,3,3,1851,1851,1848,1848
Amador,16,2022-04-04,2,2,2,0,1107,1107,1060,47,1,0,0,0,86,86,86,86
Butte,16,2022-04-04,44,44,43,1,2582,2582,2526,56,8,2,2,1,429,429,427,427
Calaveras,16,2022-04-04,8,8,8,0,589,589,567,22,0,0,0,0,119,119,119,119
Colusa,16,2022-04-04,2,2,2,0,202,202,196,6,0,0,0,0,21,21,21,21
Contra Costa,16,2022-04-04,543,543,520,23,23559,23559,22524,1035,13,1,1,4,1301,1301,1300,1300
Del Norte,16,2022-04-04,8,8,8,0,1118,1118,1080,38,0,0,0,1,49,49,49,49
El Dorado,16,2022-04-04,50,50,48,2,2717,2717,2617,100,0,1,1,1,215,215,214,214
Fresno,16,2022-04-04,188,188,180,8,16789,16789,16096,693,62,4,4,12,2758,2758,2754,2754
Glenn,16,2022-04-04,3,3,3,0,287,287,277,10,0,0,0,0,56,56,56,56
Humboldt,16,2022-04-04,23,23,22,1,2385,2385,2303,82,5,0,0,2,145,145,145,145
Imperial,16,2022-04-04,39,39,37,2,3437,3437,3308,129,3,0,0,2,944,944,944,944
Inyo,16,2022-04-04,9,9,9,0,182,182,176,6,0,0,0,0,56,56,56,56
Kern,16,2022-04-04,152,152,147,5,16756,16756,16241,515,16,2,2,7,2342,2342,2340,2340
Kings,16,2022-04-04,47,47,45,2,4186,4186,4030,156,2,0,0,1,448,448,448,448
Lake,16,2022-04-04,14,14,13,1,973,973,931,42,0,0,0,0,139,139,139,139
Lassen,16,2022-04-04,5,5,5,0,1284,1284,1247,37,0,0,0,0,62,62,62,62
Los Angeles,16,2022-04-04,5460,5460,5403,57,803354,803392,794784,8608,255,47,47,42,31795,31795,31748,31748
Madera,16,2022-04-04,27,27,26,1,3199,3199,3065,134,3,0,0,1,371,371,371,371
Marin,16,2022-04-04,167,167,160,7,6347,6347,6089,258,3,0,0,1,239,239,239,239
Mariposa,16,2022-04-04,7,7,7,0,237,237,227,10,0,0,0,0,28,28,28,28
Mendocino,16,2022-04-04,25,25,24,1,1196,1196,1130,66,2,0,0,0,124,124,124,124
Merced,16,2022-04-04,58,58,56,2,3353,3353,3246,107,2,2,2,0,818,818,816,816
Modoc,16,2022-04-04,4,4,4,0,43,43,42,1,0,0,0,0,8,8,8,8
Mono,16,2022-04-04,1,1,1,0,142,142,133,9,0,0,0,0,6,6,6,6
Monterey,16,2022-04-04,128,128,120,8,7493,7493,7013,480,8,3,3,0,728,728,725,725
Napa,16,2022-04-04,76,76,74,2,3150,3150,3061,89,1,0,0,1,144,144,144,144
Nevada,16,2022-04-04,30,30,29,1,1447,1447,1388,59,1,1,1,0,131,131,130,130
Orange,16,2022-04-04,995,995,971,24,81538,81543,79511,2032,56,17,17,14,7104,7104,7087,7087
Placer,16,2022-04-04,128,128,122,6,6692,6692,6393,299,19,1,1,5,625,625,624,624
Plumas,16,2022-04-04,4,4,4,0,235,235,225,10,0,0,0,0,13,13,13,13
Riverside,16,2022-04-04,693,693,671,22,38909,38909,37636,1273,36,5,5,8,6450,6450,6445,6445
Sacramento,16,2022-04-04,432,432,417,15,32908,32908,31752,1156,50,8,8,11,3046,3046,3038,3038
San Benito,16,2022-04-04,13,13,13,0,1187,1187,1153,34,0,0,0,0,95,95,95,95
San Bernardino,16,2022-04-04,613,613,597,16,42056,42056,40938,1118,32,11,11,13,7811,7811,7800,7800
San Diego,16,2022-04-04,1527,1527,1510,17,66687,66690,65946,744,88,7,7,29,5337,5337,5330,5330
San Francisco,16,2022-04-04,1002,1002,933,69,28771,28771,26761,2010,20,1,1,3,866,866,865,865
San Joaquin,16,2022-04-04,225,225,216,9,15700,15700,15096,604,9,2,2,8,2250,2250,2248,2248
San Luis Obispo,16,2022-04-04,99,99,96,3,5388,5388,5226,162,2,1,1,1,478,478,477,477
San Mateo,16,2022-04-04,724,724,706,18,29370,29370,28644,726,14,3,3,1,708,708,705,705
Santa Barbara,16,2022-04-04,187,187,181,6,15280,15280,14763,517,7,2,2,1,689,689,687,687
Santa Clara,16,2022-04-04,1493,1493,1475,18,88302,88307,87248,1059,89,3,3,18,2306,2306,2303,2303
Santa Cruz,16,2022-04-04,210,210,204,6,16701,16701,16211,490,4,0,0,2,259,259,259,259
Shasta,16,2022-04-04,29,29,28,1,3320,3320,3203,117,4,2,2,2,561,561,559,559
Siskiyou,16,2022-04-04,2,2,2,0,294,294,286,8,0,0,0,0,83,83,83,83
Solano,16,2022-04-04,173,173,167,6,10221,10221,9885,336,21,1,1,4,449,449,448,448
Sonoma,16,2022-04-04,330,330,320,10,10655,10655,10311,344,9,1,1,1,490,490,489,489
Stanislaus,16,2022-04-04,113,113,107,6,7964,7964,7566,398,21,3,3,5,1690,1690,1687,1687
Sutter,16,2022-04-04,24,24,23,1,1324,1324,1280,44,0,0,0,0,224,224,224,224
Tehama,16,2022-04-04,6,6,6,0,765,765,728,37,0,1,1,0,207,207,206,206
Trinity,16,2022-04-04,1,1,1,0,87,87,83,4,0,0,0,0,20,20,20,20
Tulare,16,2022-04-04,48,48,46,2,7747,7747,7351,396,13,3,3,0,1493,1493,1490,1490
Tuolumne,16,2022-04-04,10,10,10,0,1037,1037,994,43,1,1,1,0,183,183,182,182
Ventura,16,2022-04-04,294,294,287,7,20331,20331,19867,464,19,5,5,5,1500,1500,1495,1495
Yolo,16,2022-04-04,104,104,101,3,26252,26252,25466,786,0,0,0,0,361,361,361,361
Yuba,16,2022-04-04,11,11,11,0,1071,1071,1037,34,4,0,0,1,126,126,126,126
Alameda,17,2022-04-11,1493,1493,1463,30,49842,49843,48814,1029,51,5,5,2,1856,1856,1851,1851
Amador,17,2022-04-11,9,9,9,0,1068,1068,1032,36,1,0,0,0,86,86,86,86
Butte,17,2022-04-11,33,33,32,1,2262,2262,2224,38,3,0,0,1,429,429,429,429
Calaveras,17,2022-04-11,14,14,14,0,651,651,632,19,0,0,0,0,119,119,119,119
Colusa,17,2022-04-11,6,6,6,0,203,203,198,5,0,0,0,0,21,21,21,21
Contra Costa,17,2022-04-11,714,714,690,24,20842,20842,20132,710,15,1,1,5,1302,1302,1301,1301
Del Norte,17,2022-04-11,9,9,9,0,1012,1012,985,27,0,0,0,0,49,49,49,49
El Dorado,17,2022-04-11,48,48,47,1,2508,2508,2436,72,1,0,0,0,215,215,215,215
Fresno,17,2022-04-11,196,196,190,6,15720,15720,15208,512,54,3,3,6,2761,2761,2758,2758
Glenn,17,2022-04-11,2,2,2,0,258,258,251,7,0,0,0,0,56,56,56,56
Humboldt,17,2022-04-11,46,46,45,1,2347,2347,2284,63,5,1,1,2,146,146,145,145
Imperial,17,2022-04-11,28,28,27,1,3439,3439,3338,101,2,1,1,1,945,945,944,944
Inyo,17,2022-04-11,4,4,4,0,188,188,183,5,0,0,0,0,56,56,56,56
Kern,17,2022-04-11,135,135,132,3,16370,16370,15972,398,20,2,2,6,2344,2344,2342,2342
Kings,17,2022-04-11,31,31,30,1,4168,4168,4046,122,3,0,0,0,448,448,448,448
Lake,17,2022-04-11,22,22,21,1,870,870,841,29,0,0,0,0,139,139,139,139
Lassen,17,2022-04-11,1,1,1,0,1292,1292,1263,29,1,0,0,0,62,62,62,62
Los Angeles,17,2022-04-11,6737,6737,6682,55,675666,675703,669997,5706,234,46,46,36,31841,31841,31795,31795
Madera,17,2022-04-11,29,29,28,1,3088,3088,2987,101,4,0,0,2,371,371,371,371
Marin,17,2022-04-11,214,214,207,7,5555,5555,5379,176,6,0,0,1,239,239,239,239
Mariposa,17,2022-04-11,7,7,7,0,248,248,239,9,0,0,0,0,28,28,28,28
Mendocino,17,2022-04-11,32,32,31,1,1158,1158,1108,50,0,0,0,0,124,124,124,124
Merced,17,2022-04-11,68,68,66,2,3226,3226,3145,81,6,2,2,0,820,820,818,818
Modoc,17,2022-04-11,0,0,0,0,40,40,39,1,0,0,0,0,8,8,8,8
Mono,17,2022-04-11,9,9,9,0,170,170,161,9,0,0,0,0,6,6,6,6
Monterey,17,2022-04-11,106,106,101,5,6892,6892,6542,350,9,2,2,0,730,730,728,728
Napa,17,2022-04-11,120,120,117,3,2805,2805,2743,62,1,0,0,0,144,144,144,144
Nevada,17,2022-04-11,45,45,44,1,1431,1431,1385,46,2,0,0,0,131,131,131,131
Orange,17,2022-04-11,1169,1169,1147,22,62014,62018,60839,1179,70,9,9,16,7113,7113,7104,7104
Placer,17,2022-04-11,126,126,122,4,5632,5632,5433,199,18,2,2,2,627,627,625,625
Plumas,17,2022-04-11,7,7,7,0,247,247,239,8,0,0,0,0,13,13,13,13
Riverside,17,2022-04-11,728,728,710,18,37779,37779,36809,970,35,5,5,9,6455,6455,6450,6450
Sacramento,17,2022-04-11,509,509,495,14,30146,30146,29313,833,47,11,11,5,3057,3057,3046,3046
San Benito,17,2022-04-11,16,16,16,0,1183,1183,1156,27,0,0,0,0,95,95,95,95
San Bernardino,17,2022-04-11,916,916,897,19,42013,42014,41139,875,33,5,5,7,7816,7816,7811,7811
San Diego,17,2022-04-11,1818,1818,1802,16,74106,74111,73463,648,91,4,4,22,5341,5341,5337,5337
San Francisco,17,2022-04-11,1180,1180,1115,65,29898,29898,28242,1656,19,6,6,4,872,872,866,866
San Joaquin,17,2022-04-11,221,221,214,7,15226,15226,14765,461,10,0,0,1,2250,2250,2250,2250
San Luis Obispo,17,2022-04-11,120,120,117,3,4912,4912,4796,116,2,1,1,0,479,479,478,478
San Mateo,17,2022-04-11,859,859,843,16,30382,30382,29791,591,8,2,2,1,710,710,708,708
Santa Barbara,17,2022-04-11,302,302,294,8,15122,15122,14720,402,6,2,2,1,691,691,689,689
Santa Clara,17,2022-04-11,1661,1661,1646,15,81519,81524,80764,760,61,4,4,13,2310,2310,2306,2306
Santa Cruz,17,2022-04-11,327,327,320,7,10999,10999,10758,241,7,1,1,0,260,260,259,259
Shasta,17,2022-04-11,18,18,18,0,3123,3123,3036,87,2,1,1,1,562,562,561,561
Siskiyou,17,2022-04-11,1,1,1,0,340,340,332,8,0,0,0,0,83,83,83,83
Solano,17,2022-04-11,249,249,243,6,9420,9420,9177,243,16,0,0,1,449,449,449,449
Sonoma,17,2022-04-11,416,416,406,10,10688,10688,10417,271,8,1,1,0,491,491,490,490
Stanislaus,17,2022-04-11,124,124,119,5,7644,7644,7343,301,22,1,1,1,1691,1691,1690,1690
Sutter,17,2022-04-11,20,20,19,1,1237,1237,1204,33,0,1,1,0,225,225,224,224
Tehama,17,2022-04-11,9,9,9,0,753,753,724,29,1,0,0,0,207,207,207,207
Trinity,17,2022-04-11,0,0,0,0,77,77,74,3,0,0,0,0,20,20,20,20
Tulare,17,2022-04-11,58,58,56,2,7849,7849,7532,317,11,3,3,0,1496,1496,1493,1493
Tuolumne,17,2022-04-11,22,22,21,1,1065,1065,1030,35,1,0,0,0,183,183,183,183
Ventura,17,2022-04-11,323,323,317,6,17588,17588,17275,313,16,2,2,2,1502,1502,1500,1500
Yolo,17,2022-04-11,130,130,127,3,18074,18074,17654,420,1,0,0,0,361,361,361,361
Yuba,17,2022-04-11,15,15,15,0,1019,1019,994,25,2,0,0,0,126,126,126,126
Alameda,18,2022-04-18,1782,1782,1753,29,54178,54183,53301,882,42,4,4,4,1860,1860,1856,1856
Amador,18,2022-04-18,12,12,12,0,1194,1194,1162,32,2,0,0,0,86,86,86,86
Butte,18,2022-04-18,47,47,46,1,2267,2267,2237,30,5,2,2,0,431,431,429,429
Calaveras,18,2022-04-18,16,16,16,0,580,580,567,13,0,1,1,0,120,120,119,119
Colusa,18,2022-04-18,3,3,3,0,157,157,154,3,0,0,0,0,21,21,21,21
Contra Costa,18,2022-04-18,1050,1050,1022,28,24758,24758,24089,669,26,1,1,5,1303,1303,1302,1302
Del Norte,18,2022-04-18,13,13,13,0,1010,1010,989,21,0,0,0,0,49,49,49,49
El Dorado,18,2022-04-18,66,66,65,1,2455,2455,2400,55,0,0,0,0,215,215,215,215
Fresno,18,2022-04-18,247,247,241,6,13865,13865,13514,351,42,4,4,5,2765,2765,2761,2761
Glenn,18,2022-04-18,4,4,4,0,278,278,272,6,0,0,0,0,56,56,56,56
Humboldt,18,2022-04-18,106,106,104,2,2052,2052,2009,43,4,1,1,2,147,147,146,146
Imperial,18,2022-04-18,48,48,47,1,3207,3207,3133,74,2,0,0,1,945,945,945,945
Inyo,18,2022-04-18,2,2,2,0,164,164,161,3,0,0,0,0,56,56,56,56
Kern,18,2022-04-18,150,150,147,3,13638,13638,13381,257,9,1,1,5,2345,2345,2344,2344
Kings,18,2022-04-18,44,44,43,1,3594,3594,3512,82,3,1,1,1,449,449,448,448
Lake,18,2022-04-18,16,16,16,0,782,782,762,20,2,1,1,1,140,140,139,139
Lassen,18,2022-04-18,1,1,1,0,1340,1340,1316,24,0,0,0,0,62,62,62,62
Los Angeles,18,2022-04-18,8319,8319,8266,53,469204,469238,466266,2972,200,37,37,26,31878,31878,31841,31841
Madera,18,2022-04-18,23,23,22,1,2531,2531,2466,65,2,0,0,2,371,371,371,371
Marin,18,2022-04-18,322,322,314,8,5992,5992,5842,150,6,0,0,0,239,239,239,239
Mariposa,18,2022-04-18,18,18,18,0,250,250,243,7,0,0,0,0,28,28,28,28
Mendocino,18,2022-04-18,53,53,51,2,1285,1285,1241,44,0,1,1,0,125,125,124,124
Merced,18,2022-04-18,64,64,63,1,3051,3051,2991,60,3,2,2,0,822,822,820,820
Modoc,18,2022-04-18,1,1,1,0,40,40,39,1,0,0,0,0,8,8,8,8
Mono,18,2022-04-18,9,9,9,0,122,122,117,5,0,0,0,0,6,6,6,6
Monterey,18,2022-04-18,157,157,151,6,6527,6527,6268,259,2,1,1,0,731,731,730,730
Napa,18,2022-04-18,164,164,161,3,2869,2869,2820,49,1,0,0,0,144,144,144,144
Nevada,18,2022-04-18,41,41,40,1,1260,1260,1228,32,1,0,0,0,131,131,131,131
Orange,18,2022-04-18,1450,1450,1428,22,79777,79782,78574,1208,50,6,6,10,7119,7119,7113,7113
Placer,18,2022-04-18,161,161,157,4,4800,4800,4668,132,30,0,0,3,627,627,627,627
Plumas,18,2022-04-18,6,6,6,0,225,225,219,6,0,0,0,0,13,13,13,13
Riverside,18,2022-04-18,937,937,918,19,36724,36725,35985,740,36,7,7,7,6462,6462,6455,6455
Sacramento,18,2022-04-18,716,716,701,15,27856,27856,27255,601,47,9,9,8,3066,3066,3057,3057
San Benito,18,2022-04-18,24,24,24,0,1170,1170,1149,21,0,0,0,0,95,95,95,95
San Bernardino,18,2022-04-18,1058,1058,1041,17,40086,40088,39434,654,35,7,7,8,7823,7823,7816,7816
San Diego,18,2022-04-18,2034,2034,2020,14,67092,67097,66639,458,78,9,9,17,5350,5350,5341,5341
San Francisco,18,2022-04-18,1439,1439,1377,62,30566,30566,29229,1337,27,2,2,2,874,874,872,872
San Joaquin,18,2022-04-18,249,249,243,6,14733,14733,14383,350,8,1,1,4,2251,2251,2250,2250
San Luis Obispo,18,2022-04-18,180,180,177,3,4960,4960,4868,92,2,2,2,0,481,481,479,479
San Mateo,18,2022-04-18,1154,1154,1137,17,30636,30637,30173,464,15,2,2,2,712,712,710,710
Santa Barbara,18,2022-04-18,300,300,294,6,14690,14690,14384,306,8,0,0,0,691,691,691,691
Santa Clara,18,2022-04-18,2238,2238,2222,16,71272,71277,70756,521,67,4,4,16,2314,2314,2310,2310
Santa Cruz,18,2022-04-18,438,438,430,8,12234,12234,12019,215,3,0,0,1,260,260,260,260
Shasta,18,2022-04-18,32,32,31,1,2849,2849,2787,62,2,1,1,2,563,563,562,562
Siskiyou,18,2022-04-18,8,8,8,0,318,318,312,6,0,0,0,0,83,83,83,83
Solano,18,2022-04-18,254,254,249,5,9328,9328,9139,189,6,1,1,1,450,450,449,449
Sonoma,18,2022-04-18,502,502,492,10,11185,11185,10962,223,16,1,1,4,492,492,491,491
Stanislaus,18,2022-04-18,162,162,157,5,7668,7668,7429,239,15,0,0,3,1691,1691,1691,1691
Sutter,18,2022-04-18,24,24,24,0,1172,1172,1148,24,0,0,0,0,225,225,225,225
Tehama,18,2022-04-18,7,7,7,0,685,685,664,21,1,0,0,0,207,207,207,207
Trinity,18,2022-04-18,1,1,1,0,72,72,70,2,0,0,0,0,20,20,20,20
Tulare,18,2022-04-18,79,79,77,2,6665,6665,6454,211,13,0,0,0,1496,1496,1496,1496
Tuolumne,18,2022-04-18,26,26,25,1,1026,1026,1000,26,1,0,0,0,183,183,183,183
Ventura,18,2022-04-18,367,367,362,5,16413,16413,16186,227,8,3,3,0,1505,1505,1502,1502
Yolo,18,2022-04-18,217,217,213,4,17915,17915,17586,329,2,1,1,0,362,362,361,361
Yuba,18,2022-04-18,27,27,26,1,996,996,977,19,1,0,0,1,126,126,126,126
Alameda,19,2022-04-25,2538,2538,2506,32,60892,60897,60130,767,44,6,6,4,1866,1866,1860,1860
Amador,19,2022-04-25,26,26,25,1,1317,1317,1290,27,0,0,0,0,86,86,86,86
Butte,19,2022-04-25,66,66,65,1,2596,2596,2569,27,5,1,1,1,432,432,431,431
Calaveras,19,2022-04-25,34,34,33,1,688,688,676,12,0,0,0,0,120,120,120,120
Colusa,19,2022-04-25,3,3,3,0,199,199,196,3,0,0,0,0,21,21,21,21
Contra Costa,19,2022-04-25,1510,1510,1478,32,27269,27269,26695,574,25,3,3,3,1306,1306,1303,1303
Del Norte,19,2022-04-25,25,25,25,0,1104,1104,1086,18,0,0,0,0,49,49,49,49
El Dorado,19,2022-04-25,103,103,101,2,2648,2648,2601,47,1,0,0,0,215,215,215,215
Fresno,19,2022-04-25,336,336,329,7,15808,15808,15493,315,34,3,3,2,2768,2768,2765,2765
Glenn,19,2022-04-25,4,4,4,0,287,287,282,5,0,0,0,0,56,56,56,56
Humboldt,19,2022-04-25,168,168,165,3,2853,2853,2806,47,2,0,0,2,147,147,147,147
Imperial,19,2022-04-25,65,65,64,1,3505,3505,3442,63,4,0,0,1,945,945,945,945
Inyo,19,2022-04-25,7,7,7,0,194,194,191,3,0,0,0,0,56,56,56,56
Kern,19,2022-04-25,251,251,247,4,18307,18307,18036,271,14,2,2,4,2347,2347,2345,2345
Kings,19,2022-04-25,54,54,53,1,4532,4532,4450,82,3,0,0,1,449,449,449,449
Lake,19,2022-04-25,21,21,21,0,888,888,870,18,0,0,0,0,140,140,140,140
Lassen,19,2022-04-25,1,1,1,0,1556,1556,1534,22,0,0,0,0,62,62,62,62
Los Angeles,19,2022-04-25,11372,11372,11315,57,884902,884972,880487,4485,207,30,30,25,31908,31908,31878,31878
Madera,19,2022-04-25,44,44,43,1,2925,2925,2866,59,2,0,0,0,371,371,371,371
Marin,19,2022-04-25,329,329,323,6,6440,6440,6314,126,7,0,0,0,239,239,239,239
Mariposa,19,2022-04-25,9,9,9,0,207,207,203,4,0,0,0,0,28,28,28,28
Mendocino,19,2022-04-25,55,55,54,1,1254,1254,1220,34,0,1,1,0,126,126,125,125
Merced,19,2022-04-25,100,100,98,2,3034,3034,2988,46,5,0,0,0,822,822,822,822
Modoc,19,2022-04-25,1,1,1,0,41,41,40,1,0,0,0,0,8,8,8,8
Mono,19,2022-04-25,4,4,4,0,94,94,91,3,0,0,0,0,6,6,6,6
Monterey,19,2022-04-25,323,323,313,10,8014,8014,7764,250,5,1,1,0,732,732,731,731
Napa,19,2022-04-25,208,208,205,3,3391,3391,3345,46,2,0,0,0,144,144,144,144
Nevada,19,2022-04-25,52,52,51,1,1399,1399,1371,28,1,0,0,1,131,131,131,131
Orange,19,2022-04-25,1983,1983,1960,23,86636,86641,85618,1023,53,7,7,13,7126,7126,7119,7119
Placer,19,2022-04-25,239,239,234,5,6091,6091,5959,132,18,0,0,4,627,627,627,627
Plumas,19,2022-04-25,2,2,2,0,228,228,223,5,0,0,0,0,13,13,13,13
Riverside,19,2022-04-25,1304,1304,1284,20,40563,40567,39927,640,33,4,4,5,6466,6466,6462,6462
Sacramento,19,2022-04-25,1026,1026,1009,17,31873,31874,31335,539,44,4,4,4,3070,3070,3066,3066
San Benito,19,2022-04-25,34,34,34,0,1118,1118,1102,16,0,0,0,0,95,95,95,95
San Bernardino,19,2022-04-25,1292,1292,1276,16,42981,42986,42438,548,21,10,10,7,7833,7833,7823,7823
San Diego,19,2022-04-25,2994,2994,2978,16,74328,74333,73937,396,86,5,5,10,5355,5355,5350,5350
San Francisco,19,2022-04-25,2001,2001,1933,68,32544,32545,31428,1117,23,1,1,3,875,875,874,874
San Joaquin,19,2022-04-25,388,388,381,7,15465,15465,15176,289,12,0,0,1,2251,2251,2251,2251
San Luis Obispo,19,2022-04-25,209,209,206,3,5037,5037,4964,73,6,0,0,0,481,481,481,481
San Mateo,19,2022-04-25,1541,1541,1523,18,32933,32934,32545,389,14,1,1,3,713,713,712,712
Santa Barbara,19,2022-04-25,370,370,364,6,15230,15230,14983,247,7,2,2,1,693,693,691,691
Santa Clara,19,2022-04-25,3142,3142,3124,18,77136,77142,76708,434,73,4,4,9,2318,2318,2314,2314
Santa Cruz,19,2022-04-25,474,474,468,6,20467,20467,20185,282,4,1,1,0,261,261,260,260
Shasta,19,2022-04-25,49,49,48,1,3318,3318,3262,56,3,0,0,1,563,563,563,563
Siskiyou,19,2022-04-25,7,7,7,0,322,322,318,4,0,0,0,0,83,83,83,83
Solano,19,2022-04-25,479,479,471,8,10651,10651,10483,168,11,0,0,2,450,450,450,450
Sonoma,19,2022-04-25,673,673,663,10,12067,12067,11879,188,19,0,0,2,492,492,492,492
Stanislaus,19,2022-04-25,241,241,235,6,7902,7902,7710,192,25,4,4,0,1695,1695,1691,1691
Sutter,19,2022-04-25,38,38,37,1,1399,1399,1376,23,0,1,1,0,226,226,225,225
Tehama,19,2022-04-25,17,17,17,0,711,711,694,17,1,0,0,0,207,207,207,207
Trinity,19,2022-04-25,1,1,1,0,72,72,70,2,0,0,0,0,20,20,20,20
Tulare,19,2022-04-25,99,99,97,2,6935,6935,6763,172,11,1,1,0,1497,1497,1496,1496
Tuolumne,19,2022-04-25,43,43,42,1,1126,1126,1103,23,2,0,0,0,183,183,183,183
Ventura,19,2022-04-25,604,604,597,7,18901,18901,18696,205,10,1,1,3,1506,1506,1505,1505
Yolo,19,2022-04-25,272,272,268,4,19383,19383,19105,278,1,0,0,0,362,362,362,362
Yuba,19,2022-04-25,31,31,31,0,1106,1106,1089,17,0,0,0,0,126,126,126,126
Alameda,20,2022-05-02,3378,3378,3345,33,68021,68026,67349,677,42,1,1,5,1867,1867,1866,1866
Amador,20,2022-05-02,19,19,19,0,1337,1337,1315,22,0,0,0,0,86,86,86,86
Butte,20,2022-05-02,91,91,90,1,2385,2385,2366,19,4,2,2,0,434,434,432,432
Calaveras,20,2022-05-02,23,23,23,0,727,727,717,10,0,0,0,0,120,120,120,120
Colusa,20,2022-05-02,2,2,2,0,203,203,201,2,0,0,0,0,21,21,21,21
Contra Costa,20,2022-05-02,1877,1877,1846,31,29269,29270,28787,483,40,2,2,5,1308,1308,1306,1306
Del Norte,20,2022-05-02,42,42,41,1,1202,1202,1187,15,1,0,0,0,49,49,49,49
El Dorado,20,2022-05-02,140,140,138,2,2756,2756,2718,38,1,1,1,0,216,216,215,215
Fresno,20,2022-05-02,503,503,495,8,16618,16618,16359,259,42,3,3,4,2771,2771,2768,2768
Glenn,20,2022-05-02,4,4,4,0,252,252,249,3,0,0,0,0,56,56,56,56
Humboldt,20,2022-05-02,268,268,265,3,2941,2941,2903,38,6,0,0,2,147,147,147,147
Imperial,20,2022-05-02,123,123,121,2,3631,3631,3580,51,1,0,0,1,945,945,945,945
Inyo,20,2022-05-02,2,2,2,0,179,179,177,2,0,0,0,0,56,56,56,56
Kern,20,2022-05-02,294,294,291,3,17935,17935,17728,207,10,0,0,5,2347,2347,2347,2347
Kings,20,2022-05-02,59,59,58,1,4862,4862,4794,68,3,0,0,1,449,449,449,449
Lake,20,2022-05-02,28,28,28,0,1003,1003,987,16,1,0,0,0,140,140,140,140
Lassen,20,2022-05-02,8,8,8,0,1608,1608,1590,18,0,0,0,0,62,62,62,62
Los Angeles,20,2022-05-02,14813,14813,14755,58,917600,917679,914037,3642,214,24,24,22,31932,31932,31908,31908
Madera,20,2022-05-02,76,76,75,1,3317,3317,3265,52,5,0,0,0,371,371,371,371
Marin,20,2022-05-02,427,427,421,6,6544,6544,6444,100,10,0,0,0,239,239,239,239
Mariposa,20,2022-05-02,7,7,7,0,246,246,242,4,0,0,0,0,28,28,28,28
Mendocino,20,2022-05-02,58,58,57,1,1222,1222,1196,26,0,0,0,0,126,126,126,126
Merced,20,2022-05-02,131,131,129,2,3285,3285,3246,39,8,4,4,0,826,826,822,822
Modoc,20,2022-05-02,0,0,0,0,36,37,36,1,0,0,0,0,8,8,8,8
Mono,20,2022-05-02,6,6,6,0,106,106,103,3,0,0,0,0,6,6,6,6
Monterey,20,2022-05-02,355,355,346,9,8393,8393,8187,206,8,1,1,0,733,733,732,732
Napa,20,2022-05-02,229,229,227,2,3553,3553,3515,38,4,0,0,0,144,144,144,144
Nevada,20,2022-05-02,80,80,79,1,1535,1535,1511,24,2,0,0,0,131,131,131,131
Orange,20,2022-05-02,2655,2655,2631,24,87515,87521,86712,809,61,5,5,13,7131,7131,7126,7126
Placer,20,2022-05-02,306,306,301,5,6373,6373,6265,108,20,0,0,4,627,627,627,627
Plumas,20,2022-05-02,9,9,9,0,256,256,252,4,0,0,0,0,13,13,13,13
Riverside,20,2022-05-02,2051,2051,2026,25,42960,42965,42436,529,37,3,3,5,6469,6469,6466,6466
Sacramento,20,2022-05-02,1396,1396,1378,18,33658,33659,33215,444,43,5,5,9,3075,3075,3070,3070
San Benito,20,2022-05-02,50,50,49,1,1285,1285,1271,14,0,0,0,0,95,95,95,95
San Bernardino,20,2022-05-02,1490,1490,1475,15,43536,43541,43108,433,30,7,7,6,7840,7840,7833,7833
San Diego,20,2022-05-02,4092,4092,4075,17,72932,72938,72636,302,79,3,3,13,5358,5358,5355,5355
San Francisco,20,2022-05-02,2424,2424,2359,65,35539,35542,34583,959,39,3,3,13,878,878,875,875
San Joaquin,20,2022-05-02,544,544,536,8,15211,15211,14989,222,14,1,1,1,2252,2252,2251,2251
San Luis Obispo,20,2022-05-02,249,249,246,3,5109,5109,5051,58,5,2,2,0,483,483,481,481
San Mateo,20,2022-05-02,1819,1819,1802,17,35991,35994,35660,334,22,2,2,5,715,715,713,713
Santa Barbara,20,2022-05-02,439,439,434,5,15311,15311,15116,195,10,0,0,2,693,693,693,693
Santa Clara,20,2022-05-02,4358,4358,4339,19,96570,96578,96150,428,88,5,5,15,2323,2323,2318,2318
Santa Cruz,20,2022-05-02,678,678,671,7,22027,22027,21789,238,2,1,1,0,262,262,261,261
Shasta,20,2022-05-02,68,68,67,1,3451,3451,3405,46,7,0,0,1,563,563,563,563
Siskiyou,20,2022-05-02,9,9,9,0,329,329,326,3,0,0,0,0,83,83,83,83
Solano,20,2022-05-02,624,624,616,8,11785,11785,11639,146,20,0,0,2,450,450,450,450
Sonoma,20,2022-05-02,898,898,887,11,12795,12795,12640,155,16,1,1,4,493,493,492,492
Stanislaus,20,2022-05-02,271,271,266,5,8084,8084,7930,154,22,0,0,3,1695,1695,1695,1695
Sutter,20,2022-05-02,45,45,44,1,1263,1263,1247,16,0,1,1,0,227,227,226,226
Tehama,20,2022-05-02,17,17,17,0,700,700,687,13,0,0,0,0,207,207,207,207
Trinity,20,2022-05-02,1,1,1,0,84,84,82,2,0,0,0,0,20,20,20,20
Tulare,20,2022-05-02,163,163,160,3,7299,7299,7157,142,10,3,3,0,1500,1500,1497,1497
Tuolumne,20,2022-05-02,94,94,93,1,1301,1301,1281,20,5,0,0,0,183,183,183,183
Ventura,20,2022-05-02,744,744,738,6,19920,19920,19751,169,15,4,4,1,1510,1510,1506,1506
Yolo,20,2022-05-02,352,352,348,4,18790,18790,18579,211,1,1,1,0,363,363,362,362
Yuba,20,2022-05-02,46,46,45,1,1052,1052,1040,12,2,0,0,1,126,126,126,126
Alameda,21,2022-05-09,4151,4151,4119,32,71488,71494,70940,554,44,5,5,6,1872,1872,1867,1867
Amador,21,2022-05-09,25,25,25,0,1520,1520,1501,19,0,0,0,0,86,86,86,86
Butte,21,2022-05-09,116,116,115,1,2412,2412,2397,15,5,0,0,0,434,434,434,434
Calaveras,21,2022-05-09,33,33,33,0,689,689,681,8,1,0,0,0,120,120,120,120
Colusa,21,2022-05-09,3,3,3,0,215,215,213,2,0,0,0,0,21,21,21,21
Contra Costa,21,2022-05-09,2515,2515,2483,32,30526,30530,30135,395,48,3,3,12,1311,1311,1308,1308
Del Norte,21,2022-05-09,49,49,49,0,1358,1358,1344,14,0,0,0,0,49,49,49,49
El Dorado,21,2022-05-09,178,178,176,2,2889,2889,2858,31,3,0,0,1,216,216,216,216
Fresno,21,2022-05-09,746,746,737,9,17767,17767,17550,217,29,1,1,1,2772,2772,2771,2771
Glenn,21,2022-05-09,8,8,8,0,228,228,226,2,0,0,0,0,56,56,56,56
Humboldt,21,2022-05-09,273,273,270,3,3149,3149,3117,32,5,0,0,2,147,147,147,147
Imperial,21,2022-05-09,131,131,130,1,3818,3818,3776,42,0,0,0,1,945,945,945,945
Inyo,21,2022-05-09,26,26,26,0,236,236,234,2,0,0,0,0,56,56,56,56
Kern,21,2022-05-09,467,467,463,4,18705,18705,18536,169,18,2,2,2,2349,2349,2347,2347
Kings,21,2022-05-09,91,91,90,1,4945,4945,4891,54,1,0,0,1,449,449,449,449
Lake,21,2022-05-09,29,29,29,0,1029,1029,1016,13,1,0,0,0,140,140,140,140
Lassen,21,2022-05-09,7,7,7,0,1689,1689,1675,14,0,0,0,0,62,62,62,62
Los Angeles,21,2022-05-09,18428,18428,18372,56,927019,927113,924248,2865,225,29,29,27,31961,31961,31932,31932
Madera,21,2022-05-09,132,132,130,2,3735,3735,3689,46,3,0,0,0,371,371,371,371
Marin,21,2022-05-09,711,711,703,8,7781,7781,7688,93,12,0,0,0,239,239,239,239
Mariposa,21,2022-05-09,32,32,32,0,289,289,285,4,0,0,0,0,28,28,28,28
Mendocino,21,2022-05-09,91,91,90,1,1264,1264,1243,21,0,1,1,0,127,127,126,126
Merced,21,2022-05-09,198,198,196,2,3436,3436,3404,32,4,1,1,0,827,827,826,826
Modoc,21,2022-05-09,2,2,2,0,41,42,41,1,0,0,0,0,8,8,8,8
Mono,21,2022-05-09,9,9,9,0,113,113,111,2,0,0,0,0,6,6,6,6
Monterey,21,2022-05-09,440,440,432,8,9383,9383,9202,181,11,0,0,0,733,733,733,733
Napa,21,2022-05-09,234,234,232,2,3126,3126,3100,26,2,0,0,0,144,144,144,144
Nevada,21,2022-05-09,102,102,101,1,1655,1655,1635,20,5,0,0,0,131,131,131,131
Orange,21,2022-05-09,3536,3536,3511,25,91811,91821,91158,663,84,8,8,17,7139,7139,7131,7131
Placer,21,2022-05-09,537,537,530,7,6753,6753,6663,90,25,0,0,2,627,627,627,627
Plumas,21,2022-05-09,13,13,13,0,274,274,271,3,0,0,0,0,13,13,13,13
Riverside,21,2022-05-09,2402,2402,2379,23,45141,45146,44711,435,42,4,4,8,6473,6473,6469,6469
Sacramento,21,2022-05-09,2258,2258,2235,23,36132,36137,35763,374,62,4,4,10,3079,3079,3075,3075
San Benito,21,2022-05-09,74,74,73,1,1433,1433,1421,12,0,0,0,0,95,95,95,95
San Bernardino,21,2022-05-09,1936,1936,1921,15,46593,46598,46236,362,31,5,5,4,7845,7845,7840,7840
San Diego,21,2022-05-09,5196,5196,5179,17,87129,87138,86855,283,98,2,2,11,5360,5360,5358,5358
San Francisco,21,2022-05-09,3049,3049,2985,64,38188,38193,37385,808,52,6,6,9,884,884,878,878
San Joaquin,21,2022-05-09,772,772,763,9,16051,16051,15868,183,11,1,1,3,2253,2253,2252,2252
San Luis Obispo,21,2022-05-09,290,290,287,3,5222,5222,5176,46,0,0,0,0,483,483,483,483
San Mateo,21,2022-05-09,2316,2316,2300,16,37695,37700,37427,273,26,3,3,1,718,718,715,715
Santa Barbara,21,2022-05-09,638,638,632,6,15590,15590,15435,155,10,0,0,3,693,693,693,693
Santa Clara,21,2022-05-09,5621,5621,5602,19,106179,106189,105821,368,87,3,3,23,2326,2326,2323,2323
Santa Cruz,21,2022-05-09,729,729,723,6,23980,23982,23780,202,2,0,0,0,262,262,262,262
Shasta,21,2022-05-09,107,107,106,1,3301,3301,3267,34,7,0,0,0,563,563,563,563
Siskiyou,21,2022-05-09,16,16,16,0,286,286,284,2,0,0,0,0,83,83,83,83
Solano,21,2022-05-09,920,920,911,9,12318,12318,12198,120,20,0,0,1,450,450,450,450
Sonoma,21,2022-05-09,1179,1179,1168,11,13979,13979,13846,133,18,1,1,2,494,494,493,493
Stanislaus,21,2022-05-09,459,459,452,7,8943,8943,8810,133,27,0,0,2,1695,1695,1695,1695
Sutter,21,2022-05-09,61,61,60,1,1565,1565,1549,16,0,0,0,0,227,227,227,227
Tehama,21,2022-05-09,28,28,28,0,692,692,682,10,1,0,0,0,207,207,207,207
Trinity,21,2022-05-09,4,4,4,0,69,69,68,1,0,0,0,0,20,20,20,20
Tulare,21,2022-05-09,187,187,184,3,7649,7649,7532,117,11,1,1,1,1501,1501,1500,1500
Tuolumne,21,2022-05-09,69,69,68,1,1431,1431,1414,17,1,2,2,0,185,185,183,183
Ventura,21,2022-05-09,1151,1151,1143,8,20949,20949,20810,139,15,1,1,2,1511,1511,1510,1510
Yolo,21,2022-05-09,493,493,489,4,19654,19654,19482,172,1,0,0,1,363,363,363,363
Yuba,21,2022-05-09,77,77,76,1,1241,1241,1229,12,2,0,0,0,126,126,126,126
Alameda,22,2022-05-16,4993,4993,4963,30,75033,75043,74589,454,73,7,7,6,1879,1879,1872,1872
Amador,22,2022-05-16,54,54,53,1,1672,1672,1655,17,0,0,0,0,86,86,86,86
Butte,22,2022-05-16,207,207,206,1,2664,2664,2651,13,7,2,2,0,436,436,434,434
Calaveras,22,2022-05-16,43,43,43,0,765,765,758,7,0,1,1,1,121,121,120,120
Colusa,22,2022-05-16,7,7,7,0,217,217,215,2,0,0,0,0,21,21,21,21
Contra Costa,22,2022-05-16,3489,3489,3454,35,33518,33523,33184,339,50,5,5,7,1316,1316,1311,1311
Del Norte,22,2022-05-16,175,175,174,1,1859,1859,1844,15,0,0,0,0,49,49,49,49
El Dorado,22,2022-05-16,266,266,264,2,3040,3040,3014,26,5,0,0,1,216,216,216,216
Fresno,22,2022-05-16,1139,1139,1128,11,18947,18948,18768,180,46,2,2,6,2774,2774,2772,2772
Glenn,22,2022-05-16,15,15,15,0,259,259,257,2,0,0,0,0,56,56,56,56
Humboldt,22,2022-05-16,274,274,272,2,3253,3253,3227,26,9,1,1,2,148,148,147,147
Imperial,22,2022-05-16,207,207,205,2,4261,4261,4224,37,1,0,0,1,945,945,945,945
Inyo,22,2022-05-16,19,19,19,0,228,228,226,2,1,0,0,0,56,56,56,56
Kern,22,2022-05-16,687,687,682,5,19985,19986,19845,141,22,3,3,3,2352,2352,2349,2349
Kings,22,2022-05-16,221,221,219,2,5431,5431,5384,47,0,1,1,0,450,450,449,449
Lake,22,2022-05-16,75,75,74,1,1118,1118,1107,11,2,0,0,0,140,140,140,140
Lassen,22,2022-05-16,21,21,21,0,1704,1704,1693,11,1,0,0,0,62,62,62,62
Los Angeles,22,2022-05-16,21421,21422,21371,51,938127,938239,935978,2261,283,38,38,44,31999,31999,31961,31961
Madera,22,2022-05-16,199,199,197,2,3645,3645,3610,35,2,0,0,0,371,371,371,371
Marin,22,2022-05-16,816,816,808,8,8391,8391,8313,78,12,0,0,0,239,239,239,239
Mariposa,22,2022-05-16,23,23,23,0,342,342,338,4,0,0,0,0,28,28,28,28
Mendocino,22,2022-05-16,98,98,97,1,1326,1326,1309,17,0,1,1,1,128,128,127,127
Merced,22,2022-05-16,314,314,312,2,4017,4017,3988,29,8,1,1,1,828,828,827,827
Modoc,22,2022-05-16,4,4,4,0,43,44,43,1,0,0,0,0,8,8,8,8
Mono,22,2022-05-16,11,11,11,0,112,112,110,2,0,0,0,0,6,6,6,6
Monterey,22,2022-05-16,510,510,502,8,9608,9608,9463,145,6,1,1,0,734,734,733,733
Napa,22,2022-05-16,299,299,297,2,3741,3741,3717,24,3,0,0,0,144,144,144,144
Nevada,22,2022-05-16,146,146,145,1,1834,1834,1817,17,2,0,0,0,131,131,131,131
Orange,22,2022-05-16,4573,4573,4548,25,94714,94725,94192,533,74,7,7,15,7146,7146,7139,7139
Placer,22,2022-05-16,742,742,734,8,7777,7777,7696,81,43,2,2,3,629,629,627,627
Plumas,22,2022-05-16,47,47,47,0,242,242,240,2,1,0,0,0,13,13,13,13
Riverside,22,2022-05-16,3348,3348,3323,25,47988,47993,47632,361,65,1,1,6,6474,6474,6473,6473
Sacramento,22,2022-05-16,3141,3141,3116,25,39846,39851,39529,322,89,8,8,12,3087,3087,3079,3079
San Benito,22,2022-05-16,110,110,109,1,1529,1529,1519,10,1,0,0,0,95,95,95,95
San Bernardino,22,2022-05-16,2470,2470,2455,15,49168,49173,48875,298,44,8,8,5,7853,7853,7845,7845
San Diego,22,2022-05-16,6636,6636,6619,17,94787,94800,94560,240,91,6,6,25,5366,5366,5360,5360
San Francisco,22,2022-05-16,3410,3410,3354,56,39358,39363,38710,653,68,5,5,8,889,889,884,884
San Joaquin,22,2022-05-16,1200,1200,1189,11,19000,19001,18832,169,16,1,1,1,2254,2254,2253,2253
San Luis Obispo,22,2022-05-16,426,426,423,3,6058,6058,6016,42,3,1,1,0,484,484,483,483
San Mateo,22,2022-05-16,2774,2774,2759,15,39916,39921,39696,225,39,1,1,1,719,719,718,718
Santa Barbara,22,2022-05-16,913,913,906,7,17045,17045,16913,132,13,0,0,2,693,693,693,693
Santa Clara,22,2022-05-16,7206,7206,7187,19,113216,113229,112924,305,111,10,10,15,2336,2336,2326,2326
Santa Cruz,22,2022-05-16,808,808,803,5,20748,20751,20611,140,5,0,0,0,262,262,262,262
Shasta,22,2022-05-16,126,126,125,1,3812,3812,3781,31,6,0,0,1,563,563,563,563
Siskiyou,22,2022-05-16,19,19,19,0,372,372,370,2,0,0,0,0,83,83,83,83
Solano,22,2022-05-16,1278,1278,1268,10,14198,14198,14091,107,29,0,0,2,450,450,450,450
Sonoma,22,2022-05-16,1573,1573,1562,11,15545,15545,15430,115,28,0,0,4,494,494,494,494
Stanislaus,22,2022-05-16,749,749,740,9,9953,9953,9837,116,33,2,2,5,1697,1697,1695,1695
Sutter,22,2022-05-16,107,107,106,1,1828,1828,1814,14,0,0,0,0,227,227,227,227
Tehama,22,2022-05-16,37,37,37,0,840,840,831,9,0,1,1,1,208,208,207,207
Trinity,22,2022-05-16,5,5,5,0,69,69,68,1,0,0,0,0,20,20,20,20
Tulare,22,2022-05-16,398,398,393,5,8330,8330,8231,99,14,1,1,0,1502,1502,1501,1501
Tuolumne,22,2022-05-16,139,139,138,1,1450,1450,1436,14,1,1,1,0,186,186,185,185
Ventura,22,2022-05-16,1552,1552,1544,8,23859,23861,23738,123,34,2,2,2,1513,1513,1511,1511
Yolo,22,2022-05-16,688,688,683,5,22152,22154,22002,152,0,0,0,1,363,363,363,363
Yuba,22,2022-05-16,119,119,118,1,1335,1335,1325,10,4,0,0,0,126,126,126,126
Alameda,23,2022-05-23,5604,5604,5578,26,77863,77874,77506,368,76,4,4,4,1883,1883,1879,1879
Amador,23,2022-05-23,80,80,79,1,1441,1441,1430,11,0,0,0,0,86,86,86,86
Butte,23,2022-05-23,284,284,283,1,2766,2766,2755,11,5,1,1,1,437,437,436,436
Calaveras,23,2022-05-23,52,52,52,0,744,744,739,5,0,1,1,0,122,122,121,121
Colusa,23,2022-05-23,7,7,7,0,232,232,231,1,0,0,0,0,21,21,21,21
Contra Costa,23,2022-05-23,3825,3825,3795,30,35378,35383,35104,279,71,10,10,7,1326,1326,1316,1316
Del Norte,23,2022-05-23,67,67,67,0,1346,1346,1338,8,0,1,1,0,50,50,49,49
El Dorado,23,2022-05-23,359,359,357,2,3421,3421,3398,23,6,2,2,0,218,218,216,216
Fresno,23,2022-05-23,1652,1652,1640,12,21279,21280,21122,158,63,2,2,8,2776,2776,2774,2774
Glenn,23,2022-05-23,26,26,26,0,273,273,271,2,0,0,0,0,56,56,56,56
Humboldt,23,2022-05-23,245,245,244,1,2911,2911,2893,18,14,1,1,3,149,149,148,148
Imperial,23,2022-05-23,343,343,341,2,4737,4737,4705,32,2,0,0,1,945,945,945,945
Inyo,23,2022-05-23,27,27,27,0,221,221,220,1,0,0,0,0,56,56,56,56
Kern,23,2022-05-23,1006,1006,1001,5,21281,21283,21166,117,34,0,0,7,2352,2352,2352,2352
Kings,23,2022-05-23,251,251,249,2,5656,5656,5618,38,1,0,0,0,450,450,450,450
Lake,23,2022-05-23,96,96,95,1,1238,1238,1228,10,1,0,0,1,140,140,140,140
Lassen,23,2022-05-23,41,41,41,0,1763,1763,1754,9,0,0,0,0,62,62,62,62
Los Angeles,23,2022-05-23,27748,27753,27701,52,946504,946629,944851,1778,366,31,31,53,32030,32030,31999,31999
Madera,23,2022-05-23,216,216,214,2,3773,3773,3744,29,1,0,0,2,371,371,371,371
Marin,23,2022-05-23,798,798,792,6,8785,8785,8721,64,15,0,0,1,239,239,239,239
Mariposa,23,2022-05-23,32,32,32,0,342,342,339,3,0,0,0,0,28,28,28,28
Mendocino,23,2022-05-23,150,150,149,1,1659,1659,1642,17,3,1,1,1,129,129,128,128
Merced,23,2022-05-23,409,409,407,2,4204,4204,4180,24,4,0,0,0,828,828,828,828
Modoc,23,2022-05-23,2,2,2,0,40,41,40,1,0,0,0,0,8,8,8,8
Mono,23,2022-05-23,14,14,14,0,163,163,161,2,0,0,0,0,6,6,6,6
Monterey,23,2022-05-23,701,701,693,8,9620,9620,9507,113,17,1,1,1,735,735,734,734
Napa,23,2022-05-23,339,339,337,2,3951,3951,3931,20,5,0,0,0,144,144,144,144
Nevada,23,2022-05-23,150,150,149,1,1904,1904,1890,14,2,0,0,0,131,131,131,131
Orange,23,2022-05-23,5645,5645,5621,24,94960,94972,94554,418,111,11,11,20,7157,7157,7146,7146
Placer,23,2022-05-23,888,888,881,7,7838,7838,7774,64,49,2,2,4,631,631,629,629
Plumas,23,2022-05-23,46,46,46,0,279,279,277,2,0,0,0,0,13,13,13,13
Riverside,23,2022-05-23,4456,4456,4430,26,52427,52433,52126,307,73,6,6,10,6480,6480,6474,6474
Sacramento,23,2022-05-23,3897,3897,3873,24,41058,41063,40803,260,122,7,7,10,3094,3094,3087,3087
San Benito,23,2022-05-23,168,168,167,1,1668,1668,1659,9,0,0,0,0,95,95,95,95
San Bernardino,23,2022-05-23,3321,3321,3305,16,50639,50644,50404,240,53,3,3,10,7856,7856,7853,7853
San Diego,23,2022-05-23,8787,8787,8770,17,103291,103304,103100,204,138,4,4,20,5370,5370,5366,5366
San Francisco,23,2022-05-23,3604,3604,3557,47,41636,41641,41101,540,85,6,6,9,895,895,889,889
San Joaquin,23,2022-05-23,1547,1547,1536,11,20956,20958,20812,146,20,3,3,7,2257,2257,2254,2254
San Luis Obispo,23,2022-05-23,669,669,665,4,7273,7273,7234,39,10,3,3,0,487,487,484,484
San Mateo,23,2022-05-23,3155,3155,3141,14,40830,40835,40655,180,35,0,0,0,719,719,719,719
Santa Barbara,23,2022-05-23,1065,1065,1059,6,17777,17777,17669,108,20,0,0,3,693,693,693,693
Santa Clara,23,2022-05-23,7829,7829,7813,16,111314,111329,111095,234,126,7,7,18,2343,2343,2336,2336
Santa Cruz,23,2022-05-23,505,505,502,3,7816,7816,7776,40,16,0,0,0,262,262,262,262
Shasta,23,2022-05-23,195,195,194,1,3606,3606,3583,23,4,1,1,3,564,564,563,563
Siskiyou,23,2022-05-23,29,29,29,0,364,364,362,2,1,0,0,0,83,83,83,83
Solano,23,2022-05-23,1513,1513,1504,9,14915,14915,14827,88,24,1,1,3,451,451,450,450
Sonoma,23,2022-05-23,1487,1487,1478,9,16338,16338,16243,95,34,2,2,3,496,496,494,494
Stanislaus,23,2022-05-23,873,873,865,8,10702,10702,10604,98,37,2,2,3,1699,1699,1697,1697
Sutter,23,2022-05-23,141,141,140,1,1912,1912,1901,11,0,1,1,0,228,228,227,227
Tehama,23,2022-05-23,50,50,50,0,812,812,805,7,1,0,0,1,208,208,208,208
Trinity,23,2022-05-23,3,3,3,0,90,90,89,1,0,0,0,0,20,20,20,20
Tulare,23,2022-05-23,561,561,556,5,9083,9083,8999,84,26,0,0,0,1502,1502,1502,1502
Tuolumne,23,2022-05-23,133,133,132,1,1578,1578,1566,12,0,1,1,0,187,187,186,186
Ventura,23,2022-05-23,1918,1918,1910,8,24023,24026,23929,97,36,1,1,1,1514,1514,1513,1513
Yolo,23,2022-05-23,731,731,727,4,22658,22661,22540,121,1,1,1,1,364,364,363,363
Yuba,23,2022-05-23,151,151,150,1,1453,1453,1445,8,6,0,0,1,126,126,126,126
Alameda,24,2022-05-30,4912,4912,4894,18,60796,60805,60576,229,95,4,4,7,1887,1887,1883,1883
Amador,24,2022-05-30,89,89,88,1,1191,1191,1184,7,0,1,1,0,87,87,86,86
Butte,24,2022-05-30,276,276,275,1,2708,2708,2700,8,20,0,0,1,437,437,437,437
Calaveras,24,2022-05-30,54,54,54,0,617,617,614,3,0,0,0,0,122,122,122,122
Colusa,24,2022-05-30,12,12,12,0,170,170,169,1,0,0,0,0,21,21,21,21
Contra Costa,24,2022-05-30,3319,3319,3298,21,28986,28990,28808,182,65,7,7,9,1333,1333,1326,1326
Del Norte,24,2022-05-30,36,36,36,0,975,975,970,5,2,1,1,0,51,51,50,50
El Dorado,24,2022-05-30,332,332,330,2,2940,2940,2924,16,6,2,2,2,220,220,218,218
Fresno,24,2022-05-30,1669,1669,1659,10,19453,19456,19341,115,71,6,6,7,2782,2782,2776,2776
Glenn,24,2022-05-30,27,27,27,0,290,290,289,1,2,0,0,0,56,56,56,56
Humboldt,24,2022-05-30,179,179,178,1,2296,2296,2285,11,10,0,0,5,149,149,149,149
Imperial,24,2022-05-30,332,332,330,2,4136,4136,4114,22,2,1,1,2,946,946,945,945
Inyo,24,2022-05-30,18,18,18,0,151,151,150,1,0,0,0,0,56,56,56,56
Kern,24,2022-05-30,1078,1078,1073,5,17991,17993,17914,79,36,0,0,6,2352,2352,2352,2352
Kings,24,2022-05-30,293,293,291,2,4676,4676,4651,25,2,0,0,1,450,450,450,450
Lake,24,2022-05-30,89,89,88,1,994,994,988,6,1,0,0,0,140,140,140,140
Lassen,24,2022-05-30,50,50,50,0,1615,1615,1608,7,1,0,0,0,62,62,62,62
Los Angeles,24,2022-05-30,26045,26049,26010,39,746793,746902,745776,1126,425,47,47,54,32077,32077,32030,32030
Madera,24,2022-05-30,235,235,234,1,3320,3320,3300,20,4,0,0,1,371,371,371,371
Marin,24,2022-05-30,651,651,647,4,7154,7154,7112,42,16,3,3,1,242,242,239,239
Mariposa,24,2022-05-30,39,39,39,0,305,305,303,2,0,0,0,0,28,28,28,28
Mendocino,24,2022-05-30,136,136,135,1,1264,1264,1254,10,4,0,0,1,129,129,129,129
Merced,24,2022-05-30,365,365,363,2,3411,3411,3395,16,6,0,0,2,828,828,828,828
Modoc,24,2022-05-30,4,4,4,0,38,39,38,1,0,0,0,0,8,8,8,8
Mono,24,2022-05-30,6,6,6,0,81,81,80,1,0,0,0,0,6,6,6,6
Monterey,24,2022-05-30,524,524,519,5,7155,7155,7088,67,19,1,1,1,736,736,735,735
Napa,24,2022-05-30,328,328,327,1,3207,3207,3194,13,4,0,0,0,144,144,144,144
Nevada,24,2022-05-30,181,181,180,1,1595,1595,1586,9,3,2,2,1,133,133,131,131
Orange,24,2022-05-30,5667,5667,5648,19,82311,82324,82036,288,122,12,12,18,7169,7169,7157,7157
Placer,24,2022-05-30,738,738,733,5,6136,6136,6096,40,52,0,0,8,631,631,631,631
Plumas,24,2022-05-30,35,35,35,0,200,200,199,1,1,0,0,0,13,13,13,13
Riverside,24,2022-05-30,3862,3862,3844,18,43870,43875,43670,205,82,3,3,10,6483,6483,6480,6480
Sacramento,24,2022-05-30,3845,3845,3826,19,33088,33092,32926,166,130,9,9,20,3103,3103,3094,3094
San Benito,24,2022-05-30,154,154,153,1,1276,1276,1271,5,0,0,0,0,95,95,95,95
San Bernardino,24,2022-05-30,3336,3336,3324,12,42870,42875,42714,161,49,5,5,10,7861,7861,7856,7856
San Diego,24,2022-05-30,8379,8379,8366,13,85860,85873,85738,135,153,10,10,26,5380,5380,5370,5370
San Francisco,24,2022-05-30,3136,3136,3104,32,33425,33430,33086,344,88,11,11,14,906,906,895,895
San Joaquin,24,2022-05-30,1399,1399,1391,8,17011,17012,16918,94,25,2,2,9,2259,2259,2257,2257
San Luis Obispo,24,2022-05-30,653,653,650,3,5439,5439,5416,23,12,1,1,0,488,488,487,487
San Mateo,24,2022-05-30,2757,2757,2747,10,31176,31180,31070,110,33,3,3,2,722,722,719,719
Santa Barbara,24,2022-05-30,1031,1031,1026,5,14451,14451,14381,70,23,2,2,5,695,695,693,693
Santa Clara,24,2022-05-30,7030,7030,7018,12,85319,85332,85189,143,154,10,10,22,2353,2353,2343,2343
Santa Cruz,24,2022-05-30,526,526,524,2,6255,6255,6229,26,7,1,1,1,263,263,262,262
Shasta,24,2022-05-30,133,133,132,1,2838,2838,2824,14,4,3,3,4,567,567,564,564
Siskiyou,24,2022-05-30,53,53,53,0,340,340,339,1,3,0,0,0,83,83,83,83
Solano,24,2022-05-30,1186,1186,1180,6,11558,11558,11503,55,28,0,0,7,451,451,451,451
Sonoma,24,2022-05-30,1200,1200,1195,5,13241,13242,13181,61,38,2,2,5,498,498,496,496
Stanislaus,24,2022-05-30,798,798,792,6,8587,8587,8525,62,55,2,2,3,1701,1701,1699,1699
Sutter,24,2022-05-30,157,157,156,1,1699,1699,1691,8,0,0,0,0,228,228,228,228
Tehama,24,2022-05-30,62,62,62,0,757,757,752,5,2,0,0,0,208,208,208,208
Trinity,24,2022-05-30,8,8,8,0,96,96,95,1,0,0,0,0,20,20,20,20
Tulare,24,2022-05-30,600,600,596,4,7505,7505,7449,56,19,0,0,0,1502,1502,1502,1502
Tuolumne,24,2022-05-30,121,121,120,1,1308,1308,1300,8,3,0,0,0,187,187,187,187
Ventura,24,2022-05-30,1681,1681,1676,5,19546,19550,19487,63,30,1,1,4,1515,1515,1514,1514
Yolo,24,2022-05-30,611,611,608,3,17632,17636,17561,75,4,0,0,1,364,364,364,364
Yuba,24,2022-05-30,144,144,143,1,1276,1276,1270,6,7,0,0,2,126,126,126,126
Alameda,25,2022-06-06,6494,6494,6475,19,73241,73255,73043,212,112,4,4,12,1891,1891,1887,1887
Amador,25,2022-06-06,114,114,113,1,1723,1723,1715,8,1,0,0,1,87,87,87,87
Butte,25,2022-06-06,452,452,451,1,3616,3616,3608,8,24,1,1,1,438,438,437,437
Calaveras,25,2022-06-06,73,73,73,0,737,737,734,3,0,2,2,0,124,124,122,122
Colusa,25,2022-06-06,22,22,22,0,275,275,274,1,3,0,0,0,21,21,21,21
Contra Costa,25,2022-06-06,4230,4230,4210,20,35711,35716,35543,173,107,9,9,7,1342,1342,1333,1333
Del Norte,25,2022-06-06,64,64,64,0,1134,1134,1130,4,2,0,0,0,51,51,51,51
El Dorado,25,2022-06-06,413,413,411,2,3637,3637,3622,15,5,0,0,5,220,220,220,220
Fresno,25,2022-06-06,2451,2451,2440,11,22608,22613,22510,103,94,2,2,6,2784,2784,2782,2782
Glenn,25,2022-06-06,41,41,41,0,325,325,324,1,3,0,0,0,56,56,56,56
Humboldt,25,2022-06-06,260,260,259,1,3054,3054,3043,11,14,1,1,3,150,150,149,149
Imperial,25,2022-06-06,466,466,464,2,4855,4855,4835,20,2,0,0,0,946,946,946,946
Inyo,25,2022-06-06,20,20,20,0,213,213,212,1,1,0,0,0,56,56,56,56
Kern,25,2022-06-06,1612,1612,1607,5,22980,22985,22908,77,35,1,1,6,2353,2353,2352,2352
Kings,25,2022-06-06,397,397,395,2,5513,5513,5490,23,10,0,0,1,450,450,450,450
Lake,25,2022-06-06,136,136,135,1,1180,1180,1174,6,5,0,0,2,140,140,140,140
Lassen,25,2022-06-06,71,71,71,0,2398,2398,2390,8,2,0,0,0,62,62,62,62
Los Angeles,25,2022-06-06,35104,35111,35071,40,1041711,1041916,1040714,1202,496,39,39,61,32116,32116,32077,32077
Madera,25,2022-06-06,354,354,352,2,4140,4140,4121,19,7,0,0,1,371,371,371,371
Marin,25,2022-06-06,739,739,736,3,7650,7650,7616,34,10,2,2,5,244,244,242,242
Mariposa,25,2022-06-06,57,57,57,0,404,404,402,2,0,0,0,0,28,28,28,28
Mendocino,25,2022-06-06,209,209,208,1,1711,1711,1700,11,9,1,1,2,130,130,129,129
Merced,25,2022-06-06,532,532,530,2,4533,4533,4517,16,16,0,0,0,828,828,828,828
Modoc,25,2022-06-06,11,11,11,0,37,38,37,1,0,0,0,0,8,8,8,8
Mono,25,2022-06-06,15,15,15,0,120,120,119,1,0,0,0,0,6,6,6,6
Monterey,25,2022-06-06,998,998,991,7,10247,10247,10172,75,17,2,2,1,738,738,736,736
Napa,25,2022-06-06,556,556,554,2,4267,4267,4254,13,8,1,1,0,145,145,144,144
Nevada,25,2022-06-06,245,245,244,1,2149,2149,2139,10,5,0,0,0,133,133,133,133
Orange,25,2022-06-06,7628,7628,7608,20,73831,73846,73648,198,140,12,12,18,7181,7181,7169,7169
Placer,25,2022-06-06,868,868,864,4,7605,7605,7567,38,65,0,0,11,631,631,631,631
Plumas,25,2022-06-06,40,40,40,0,321,321,320,1,0,0,0,0,13,13,13,13
Riverside,25,2022-06-06,5352,5352,5333,19,55978,55990,55789,201,88,6,6,10,6489,6489,6483,6483
Sacramento,25,2022-06-06,4951,4951,4932,19,42474,42482,42317,165,149,14,14,20,3117,3117,3103,3103
San Benito,25,2022-06-06,273,273,272,1,2016,2016,2010,6,0,0,0,1,95,95,95,95
San Bernardino,25,2022-06-06,5129,5129,5114,15,55844,55856,55694,162,77,7,7,14,7868,7868,7861,7861
San Diego,25,2022-06-06,10717,10717,10704,13,100465,100484,100362,122,185,8,8,22,5388,5388,5380,5380
San Francisco,25,2022-06-06,3520,3520,3492,28,38262,38268,37963,305,77,0,0,11,906,906,906,906
San Joaquin,25,2022-06-06,2134,2134,2125,9,22162,22167,22073,94,40,4,4,9,2263,2263,2259,2259
San Luis Obispo,25,2022-06-06,901,901,898,3,7532,7532,7507,25,16,1,1,1,489,489,488,488
San Mateo,25,2022-06-06,3214,3214,3205,9,37066,37072,36972,100,36,2,2,4,724,724,722,722
Santa Barbara,25,2022-06-06,1246,1246,1241,5,15076,15079,15023,56,22,1,1,5,696,696,695,695
Santa Clara,25,2022-06-06,8503,8503,8492,11,102647,102666,102534,132,176,7,7,22,2360,2360,2353,2353
Santa Cruz,25,2022-06-06,896,896,893,3,9720,9721,9691,30,24,1,1,3,264,264,263,263
Shasta,25,2022-06-06,210,210,209,1,4425,4425,4408,17,10,2,2,2,569,569,567,567
Siskiyou,25,2022-06-06,41,41,41,0,431,431,430,1,1,0,0,0,83,83,83,83
Solano,25,2022-06-06,1749,1749,1743,6,15183,15185,15130,55,29,2,2,1,453,453,451,451
Sonoma,25,2022-06-06,1635,1635,1629,6,13999,14001,13952,49,38,1,1,1,499,499,498,498
Stanislaus,25,2022-06-06,1181,1181,1174,7,10913,10913,10852,61,60,1,1,2,1702,1702,1701,1701
Sutter,25,2022-06-06,206,206,205,1,1941,1941,1934,7,0,0,0,0,228,228,228,228
Tehama,25,2022-06-06,83,83,83,0,1051,1051,1045,6,2,0,0,0,208,208,208,208
Trinity,25,2022-06-06,7,7,7,0,110,110,109,1,0,0,0,0,20,20,20,20
Tulare,25,2022-06-06,864,864,859,5,10816,10817,10755,62,24,0,0,0,1502,1502,1502,1502
Tuolumne,25,2022-06-06,120,120,119,1,1724,1724,1716,8,4,0,0,1,187,187,187,187
Ventura,25,2022-06-06,1972,1972,1967,5,24767,24772,24711,61,43,4,4,3,1519,1519,1515,1515
Yolo,25,2022-06-06,828,828,825,3,21439,21444,21374,70,2,1,1,0,365,365,364,364
Yuba,25,2022-06-06,187,187,186,1,1556,1556,1551,5,9,0,0,1,126,126,126,126
Alameda,26,2022-06-13,5078,5078,5067,11,55924,55938,55813,125,106,5,5,18,1896,1896,1891,1891
Amador,26,2022-06-13,129,129,129,0,1413,1413,1408,5,1,0,0,0,87,87,87,87
Butte,26,2022-06-13,394,394,393,1,3459,3459,3453,6,31,4,4,0,442,442,438,438
Calaveras,26,2022-06-13,69,69,69,0,658,658,656,2,0,0,0,0,124,124,124,124
Colusa,26,2022-06-13,12,12,12,0,328,328,327,1,17,0,0,0,21,21,21,21
Contra Costa,26,2022-06-13,3409,3409,3396,13,27986,27991,27885,106,89,8,8,12,1350,1350,1342,1342
Del Norte,26,2022-06-13,79,79,79,0,658,658,656,2,4,0,0,0,51,51,51,51
El Dorado,26,2022-06-13,324,324,323,1,3197,3197,3187,10,7,3,3,1,223,223,220,220
Fresno,26,2022-06-13,2399,2399,2391,8,20615,20620,20547,73,103,4,4,13,2788,2788,2784,2784
Glenn,26,2022-06-13,32,32,32,0,329,329,328,1,2,0,0,0,56,56,56,56
Humboldt,26,2022-06-13,262,262,261,1,2325,2325,2318,7,11,0,0,3,150,150,150,150
Imperial,26,2022-06-13,447,447,446,1,4520,4520,4506,14,6,1,1,0,947,947,946,946
Inyo,26,2022-06-13,13,13,13,0,189,189,188,1,0,0,0,0,56,56,56,56
Kern,26,2022-06-13,1565,1565,1561,4,21427,21432,21376,56,38,1,1,5,2354,2354,2353,2353
Kings,26,2022-06-13,357,357,356,1,5165,5165,5149,16,4,1,1,0,451,451,450,450
Lake,26,2022-06-13,136,136,136,0,1228,1228,1224,4,1,0,0,0,140,140,140,140
Lassen,26,2022-06-13,76,76,76,0,1994,1994,1989,5,2,0,0,0,62,62,62,62
Los Angeles,26,2022-06-13,29994,30001,29974,27,660501,660662,660064,598,519,54,54,60,32170,32170,32116,32116
Madera,26,2022-06-13,381,381,380,1,4244,4244,4229,15,7,0,0,2,371,371,371,371
Marin,26,2022-06-13,686,686,684,2,7039,7039,7014,25,16,2,2,2,246,246,244,244
Mariposa,26,2022-06-13,45,45,45,0,374,374,373,1,0,0,0,0,28,28,28,28
Mendocino,26,2022-06-13,161,161,160,1,1567,1567,1559,8,9,0,0,1,130,130,130,130
Merced,26,2022-06-13,561,561,559,2,4171,4171,4160,11,13,0,0,2,828,828,828,828
Modoc,26,2022-06-13,7,7,7,0,34,35,34,1,1,1,1,0,9,9,8,8
Mono,26,2022-06-13,19,19,19,0,92,92,91,1,0,0,0,0,6,6,6,6
Monterey,26,2022-06-13,832,832,827,5,8663,8664,8615,49,25,3,3,1,741,741,738,738
Napa,26,2022-06-13,445,445,444,1,3967,3967,3957,10,2,1,1,1,146,146,145,145
Nevada,26,2022-06-13,186,186,185,1,1874,1874,1867,7,8,0,0,0,133,133,133,133
Orange,26,2022-06-13,7049,7049,7034,15,65294,65310,65174,136,175,15,15,19,7196,7196,7181,7181
Placer,26,2022-06-13,790,790,787,3,6801,6801,6775,26,79,2,2,7,633,633,631,631
Plumas,26,2022-06-13,34,34,34,0,271,271,270,1,0,0,0,0,13,13,13,13
Riverside,26,2022-06-13,5045,5045,5031,14,47851,47864,47730,134,105,4,4,11,6493,6493,6489,6489
Sacramento,26,2022-06-13,4179,4179,4166,13,37542,37550,37437,113,190,13,13,20,3130,3130,3117,3117
San Benito,26,2022-06-13,199,199,199,0,1780,1780,1776,4,1,0,0,1,95,95,95,95
San Bernardino,26,2022-06-13,4673,4673,4663,10,48701,48714,48604,110,96,6,6,15,7874,7874,7868,7868
San Diego,26,2022-06-13,9569,9569,9560,9,84903,84924,84844,80,192,9,9,27,5397,5397,5388,5388
San Francisco,26,2022-06-13,3027,3027,3008,19,31122,31129,30936,193,72,11,11,13,917,917,906,906
San Joaquin,26,2022-06-13,1919,1919,1913,6,19010,19015,18952,63,32,5,5,3,2268,2268,2263,2263
San Luis Obispo,26,2022-06-13,661,661,659,2,6054,6054,6039,15,21,0,0,0,489,489,489,489
San Mateo,26,2022-06-13,2635,2635,2630,5,29175,29182,29121,61,44,3,3,3,727,727,724,724
Santa Barbara,26,2022-06-13,930,930,927,3,9477,9478,9451,27,15,1,1,5,697,697,696,696
Santa Clara,26,2022-06-13,7044,7044,7037,7,76836,76855,76778,77,182,13,13,23,2373,2373,2360,2360
Santa Cruz,26,2022-06-13,842,842,840,2,9962,9963,9939,24,23,0,0,1,264,264,264,264
Shasta,26,2022-06-13,220,220,219,1,3390,3390,3380,10,8,1,1,0,570,570,569,569
Siskiyou,26,2022-06-13,50,50,50,0,372,372,371,1,1,0,0,0,83,83,83,83
Solano,26,2022-06-13,1689,1689,1684,5,12901,12905,12869,36,33,0,0,2,453,453,453,453
Sonoma,26,2022-06-13,1336,1336,1332,4,11655,11658,11626,32,36,2,2,6,501,501,499,499
Stanislaus,26,2022-06-13,1131,1131,1126,5,9454,9455,9414,41,63,1,1,7,1703,1703,1702,1702
Sutter,26,2022-06-13,193,193,192,1,1721,1721,1716,5,0,0,0,0,228,228,228,228
Tehama,26,2022-06-13,86,86,86,0,967,967,963,4,3,0,0,0,208,208,208,208
Trinity,26,2022-06-13,11,11,11,0,84,85,84,1,0,0,0,0,20,20,20,20
Tulare,26,2022-06-13,832,832,828,4,9482,9483,9441,42,26,2,2,1,1504,1504,1502,1502
Tuolumne,26,2022-06-13,145,145,144,1,1446,1446,1441,5,2,0,0,0,187,187,187,187
Ventura,26,2022-06-13,1936,1936,1932,4,20985,20990,20950,40,38,3,3,5,1522,1522,1519,1519
Yolo,26,2022-06-13,767,767,765,2,14394,14398,14361,37,4,1,1,0,366,366,365,365
Yuba,26,2022-06-13,188,188,187,1,1419,1419,1415,4,8,0,0,1,126,126,126,126
Alameda,27,2022-06-20,4946,4946,4937,9,48647,48662,48577,85,105,11,11,14,1907,1907,1896,1896
Amador,27,2022-06-20,104,104,104,0,1247,1247,1243,4,2,0,0,0,87,87,87,87
Butte,27,2022-06-20,414,414,413,1,3562,3562,3557,5,28,4,4,1,446,446,442,442
Calaveras,27,2022-06-20,82,82,82,0,625,625,623,2,0,0,0,0,124,124,124,124
Colusa,27,2022-06-20,16,16,16,0,176,177,176,1,15,1,1,0,22,22,21,21
Contra Costa,27,2022-06-20,3349,3349,3339,10,26024,26032,25955,77,81,7,7,8,1357,1357,1350,1350
Del Norte,27,2022-06-20,82,82,82,0,611,611,610,1,3,1,1,1,52,52,51,51
El Dorado,27,2022-06-20,350,350,349,1,3074,3074,3066,8,5,2,2,1,225,225,223,223
Fresno,27,2022-06-20,2472,2472,2465,7,19409,19415,19361,54,100,2,2,16,2790,2790,2788,2788
Glenn,27,2022-06-20,41,41,41,0,314,314,313,1,3,0,0,0,56,56,56,56
Humboldt,27,2022-06-20,273,273,272,1,2274,2274,2269,5,11,0,0,3,150,150,150,150
Imperial,27,2022-06-20,602,602,601,1,3691,3691,3682,9,5,0,0,0,947,947,947,947
Inyo,27,2022-06-20,19,19,19,0,187,188,187,1,0,0,0,0,56,56,56,56
Kern,27,2022-06-20,1652,1652,1649,3,20141,20147,20106,41,39,5,5,9,2359,2359,2354,2354
Kings,27,2022-06-20,413,413,412,1,4875,4875,4863,12,6,1,1,0,452,452,451,451
Lake,27,2022-06-20,119,119,119,0,1237,1237,1233,4,1,0,0,2,140,140,140,140
Lassen,27,2022-06-20,43,43,43,0,1223,1223,1221,2,1,0,0,0,62,62,62,62
Los Angeles,27,2022-06-20,27529,27537,27518,19,351488,351600,351356,244,596,58,58,68,32228,32228,32170,32170
Madera,27,2022-06-20,341,341,340,1,4171,4171,4159,12,4,0,0,1,371,371,371,371
Marin,27,2022-06-20,693,693,691,2,6328,6328,6311,17,21,0,0,1,246,246,246,246
Mariposa,27,2022-06-20,53,53,53,0,338,338,337,1,0,0,0,0,28,28,28,28
Mendocino,27,2022-06-20,180,180,179,1,1580,1580,1574,6,3,0,0,0,130,130,130,130
Merced,27,2022-06-20,541,541,540,1,3959,3959,3951,8,7,3,3,1,831,831,828,828
Modoc,27,2022-06-20,5,5,5,0,37,38,37,1,0,0,0,0,9,9,9,9
Mono,27,2022-06-20,6,6,6,0,82,83,82,1,1,1,1,0,7,7,6,6
Monterey,27,2022-06-20,893,893,889,4,8910,8911,8872,39,38,1,1,2,742,742,741,741
Napa,27,2022-06-20,371,371,370,1,3150,3150,3144,6,3,1,1,0,147,147,146,146
Nevada,27,2022-06-20,170,170,170,0,1619,1619,1615,4,6,1,1,0,134,134,133,133
Orange,27,2022-06-20,7063,7063,7052,11,60498,60517,60419,98,152,10,10,23,7206,7206,7196,7196
Placer,27,2022-06-20,674,674,672,2,6053,6053,6035,18,69,1,1,7,634,634,633,633
Plumas,27,2022-06-20,38,38,38,0,239,239,238,1,0,0,0,0,13,13,13,13
Riverside,27,2022-06-20,4959,4959,4948,11,43309,43323,43229,94,112,5,5,14,6498,6498,6493,6493
Sacramento,27,2022-06-20,3932,3932,3923,9,34815,34827,34745,82,171,12,12,21,3142,3142,3130,3130
San Benito,27,2022-06-20,171,171,171,0,1598,1598,1595,3,0,1,1,2,96,96,95,95
San Bernardino,27,2022-06-20,4526,4526,4518,8,46254,46268,46187,81,105,12,12,17,7886,7886,7874,7874
San Diego,27,2022-06-20,9651,9654,9647,7,77523,77547,77490,57,203,9,9,17,5406,5406,5397,5397
San Francisco,27,2022-06-20,3059,3059,3044,15,28297,28307,28170,137,72,12,12,14,929,929,917,917
San Joaquin,27,2022-06-20,1670,1670,1666,4,17898,17903,17857,46,38,6,6,6,2274,2274,2268,2268
San Luis Obispo,27,2022-06-20,601,601,600,1,5814,5814,5802,12,27,10,10,0,499,499,489,489
San Mateo,27,2022-06-20,2623,2623,2619,4,25948,25956,25913,43,42,2,2,1,729,729,727,727
Santa Barbara,27,2022-06-20,934,934,932,2,8261,8262,8244,18,33,2,2,6,699,699,697,697
Santa Clara,27,2022-06-20,6808,6808,6803,5,63485,63505,63456,49,170,10,10,21,2383,2383,2373,2373
Santa Cruz,27,2022-06-20,818,818,816,2,9130,9131,9114,17,19,1,1,2,265,265,264,264
Shasta,27,2022-06-20,241,241,240,1,3374,3374,3366,8,9,1,1,1,571,571,570,570
Siskiyou,27,2022-06-20,61,61,61,0,394,394,393,1,5,1,1,0,84,84,83,83
Solano,27,2022-06-20,1419,1419,1416,3,11466,11471,11446,25,41,0,0,5,453,453,453,453
Sonoma,27,2022-06-20,1400,1400,1397,3,10799,10803,10780,23,28,1,1,3,502,502,501,501
Stanislaus,27,2022-06-20,1037,1037,1033,4,8834,8836,8806,30,70,5,5,7,1708,1708,1703,1703
Sutter,27,2022-06-20,194,194,194,0,1858,1858,1854,4,0,0,0,0,228,228,228,228
Tehama,27,2022-06-20,97,97,97,0,889,889,886,3,3,0,0,0,208,208,208,208
Trinity,27,2022-06-20,10,10,10,0,106,107,106,1,0,0,0,0,20,20,20,20
Tulare,27,2022-06-20,899,899,896,3,8755,8757,8727,30,32,8,8,0,1512,1512,1504,1504
Tuolumne,27,2022-06-20,140,140,140,0,1558,1558,1554,4,3,0,0,1,187,187,187,187
Ventura,27,2022-06-20,1835,1835,1832,3,18673,18678,18650,28,50,1,1,7,1523,1523,1522,1522
Yolo,27,2022-06-20,679,679,678,1,10849,10853,10831,22,1,2,2,2,368,368,366,366
Yuba,27,2022-06-20,149,149,149,0,1339,1339,1336,3,13,0,0,5,126,126,126,126
Alameda,28,2022-06-27,5476,5477,5470,7,48325,48346,48280,66,124,6,6,16,1913,1913,1907,1907
Amador,28,2022-06-27,88,88,88,0,1149,1149,1146,3,3,0,0,1,87,87,87,87
Butte,28,2022-06-27,410,410,410,0,3468,3468,3464,4,30,2,2,0,448,448,446,446
Calaveras,28,2022-06-27,69,69,69,0,571,571,570,1,1,2,2,0,126,126,124,124
Colusa,28,2022-06-27,28,28,28,0,282,283,282,1,6,0,0,0,22,22,22,22
Contra Costa,28,2022-06-27,3527,3527,3519,8,25915,25927,25868,59,82,12,12,7,1369,1369,1357,1357
Del Norte,28,2022-06-27,140,140,140,0,669,669,668,1,5,1,1,2,53,53,52,52
El Dorado,28,2022-06-27,427,427,426,1,3357,3357,3351,6,5,0,0,1,225,225,225,225
Fresno,28,2022-06-27,2827,2827,2821,6,19885,19894,19851,43,136,2,2,17,2792,2792,2790,2790
Glenn,28,2022-06-27,28,28,28,0,296,296,295,1,1,0,0,0,56,56,56,56
Humboldt,28,2022-06-27,261,261,261,0,2189,2189,2185,4,10,1,1,2,151,151,150,150
Imperial,28,2022-06-27,705,705,704,1,4018,4018,4010,8,7,0,0,4,947,947,947,947
Inyo,28,2022-06-27,32,32,32,0,311,311,310,1,1,0,0,0,56,56,56,56
Kern,28,2022-06-27,1818,1818,1815,3,17410,17416,17388,28,52,7,7,8,2366,2366,2359,2359
Kings,28,2022-06-27,470,470,469,1,3932,3932,3924,8,9,0,0,0,452,452,452,452
Lake,28,2022-06-27,122,122,122,0,1139,1139,1136,3,2,0,0,0,140,140,140,140
Lassen,28,2022-06-27,51,51,51,0,848,848,847,1,1,0,0,0,62,62,62,62
Los Angeles,28,2022-06-27,32765,32778,32761,17,364342,364497,364300,197,679,73,73,68,32301,32301,32228,32228
Madera,28,2022-06-27,414,414,413,1,4288,4289,4280,9,8,0,0,0,371,371,371,371
Marin,28,2022-06-27,659,659,658,1,6242,6242,6229,13,20,0,0,2,246,246,246,246
Mariposa,28,2022-06-27,55,55,55,0,311,311,310,1,0,0,0,0,28,28,28,28
Mendocino,28,2022-06-27,153,153,153,0,1447,1447,1443,4,5,1,1,1,131,131,130,130
Merced,28,2022-06-27,615,615,614,1,4040,4040,4033,7,14,2,2,0,833,833,831,831
Modoc,28,2022-06-27,7,7,7,0,32,33,32,1,0,0,0,0,9,9,9,9
Mono,28,2022-06-27,25,25,25,0,110,111,110,1,1,0,0,0,7,7,7,7
Monterey,28,2022-06-27,928,928,925,3,8279,8284,8256,28,44,2,2,3,744,744,742,742
Napa,28,2022-06-27,394,394,393,1,3322,3322,3317,5,3,2,2,1,149,149,147,147
Nevada,28,2022-06-27,189,189,189,0,1619,1619,1616,3,4,0,0,3,134,134,134,134
Orange,28,2022-06-27,7594,7596,7586,10,59409,59435,59360,75,183,16,16,26,7222,7222,7206,7206
Placer,28,2022-06-27,808,808,806,2,6185,6186,6171,15,79,6,6,6,640,640,634,634
Plumas,28,2022-06-27,49,49,49,0,257,257,256,1,1,0,0,0,13,13,13,13
Riverside,28,2022-06-27,6195,6196,6186,10,44972,44991,44915,76,141,11,11,17,6509,6509,6498,6498
Sacramento,28,2022-06-27,4165,4165,4157,8,35282,35297,35232,65,173,10,10,25,3152,3152,3142,3142
San Benito,28,2022-06-27,221,221,221,0,1655,1655,1653,2,0,0,0,1,96,96,96,96
San Bernardino,28,2022-06-27,5723,5724,5716,8,48827,48847,48780,67,130,12,12,24,7898,7898,7886,7886
San Diego,28,2022-06-27,10835,10840,10834,6,80655,80689,80643,46,264,9,9,28,5415,5415,5406,5406
San Francisco,28,2022-06-27,3270,3270,3258,12,29260,29273,29163,110,92,5,5,23,934,934,929,929
San Joaquin,28,2022-06-27,1893,1893,1889,4,17964,17971,17935,36,46,2,2,5,2276,2276,2274,2274
San Luis Obispo,28,2022-06-27,645,645,644,1,5645,5646,5637,9,25,3,3,0,502,502,499,499
San Mateo,28,2022-06-27,2890,2890,2886,4,26919,26931,26897,34,36,2,2,2,731,731,729,729
Santa Barbara,28,2022-06-27,1148,1148,1146,2,9814,9819,9802,17,26,2,2,2,701,701,699,699
Santa Clara,28,2022-06-27,7542,7543,7538,5,61418,61444,61407,37,213,11,11,19,2394,2394,2383,2383
Santa Cruz,28,2022-06-27,860,860,859,1,9188,9193,9179,14,26,2,2,1,267,267,265,265
Shasta,28,2022-06-27,339,339,338,1,3308,3308,3302,6,21,0,0,4,571,571,571,571
Siskiyou,28,2022-06-27,63,63,63,0,355,355,354,1,2,1,1,0,85,85,84,84
Solano,28,2022-06-27,1613,1613,1610,3,13044,13049,13027,22,47,0,0,4,453,453,453,453
Sonoma,28,2022-06-27,1368,1368,1366,2,10099,10104,10087,17,33,2,2,3,504,504,502,502
Stanislaus,28,2022-06-27,1211,1211,1208,3,8585,8590,8567,23,96,2,2,6,1710,1710,1708,1708
Sutter,28,2022-06-27,193,193,193,0,1842,1842,1839,3,0,0,0,0,228,228,228,228
Tehama,28,2022-06-27,93,93,93,0,888,888,886,2,3,0,0,0,208,208,208,208
Trinity,28,2022-06-27,24,24,24,0,142,143,142,1,1,0,0,0,20,20,20,20
Tulare,28,2022-06-27,911,911,909,2,7901,7904,7883,21,35,0,0,2,1512,1512,1512,1512
Tuolumne,28,2022-06-27,168,168,168,0,1406,1406,1403,3,1,4,4,1,191,191,187,187
Ventura,28,2022-06-27,2090,2090,2088,2,18544,18552,18530,22,61,3,3,1,1526,1526,1523,1523
Yolo,28,2022-06-27,794,794,793,1,11408,11413,11395,18,8,0,0,1,368,368,368,368
Yuba,28,2022-06-27,172,172,172,0,1435,1435,1433,2,10,3,3,2,129,129,126,126
Alameda,29,2022-07-04,4834,4834,4829,5,38882,38903,38861,42,128,10,10,10,1923,1923,1913,1913
Amador,29,2022-07-04,66,66,66,0,1534,1534,1531,3,3,0,0,1,87,87,87,87
Butte,29,2022-07-04,284,284,284,0,2489,2489,2487,2,28,2,2,1,450,450,448,448
Calaveras,29,2022-07-04,81,81,81,0,486,486,485,1,0,2,2,0,128,128,126,126
Colusa,29,2022-07-04,21,21,21,0,150,151,150,1,4,0,0,0,22,22,22,22
Contra Costa,29,2022-07-04,3315,3315,3309,6,20934,20945,20907,38,76,10,10,12,1379,1379,1369,1369
Del Norte,29,2022-07-04,140,140,140,0,587,587,586,1,3,0,0,0,53,53,53,53
El Dorado,29,2022-07-04,306,306,306,0,2394,2394,2390,4,10,1,1,0,226,226,225,225
Fresno,29,2022-07-04,2470,2470,2466,4,15665,15674,15647,27,158,6,6,17,2798,2798,2792,2792
Glenn,29,2022-07-04,24,24,24,0,157,158,157,1,1,0,0,0,56,56,56,56
Humboldt,29,2022-07-04,187,187,187,0,1584,1584,1582,2,12,2,2,3,153,153,151,151
Imperial,29,2022-07-04,695,695,694,1,3233,3233,3228,5,8,1,1,3,948,948,947,947
Inyo,29,2022-07-04,42,42,42,0,292,293,292,1,1,0,0,0,56,56,56,56
Kern,29,2022-07-04,1794,1794,1792,2,14291,14298,14280,18,63,4,4,9,2370,2370,2366,2366
Kings,29,2022-07-04,436,436,435,1,3446,3446,3441,5,5,0,0,0,452,452,452,452
Lake,29,2022-07-04,107,107,107,0,790,790,789,1,3,2,2,0,142,142,140,140
Lassen,29,2022-07-04,31,31,31,0,641,641,640,1,2,0,0,0,62,62,62,62
Los Angeles,29,2022-07-04,32265,32282,32268,14,285976,286125,286002,123,801,88,88,85,32389,32389,32301,32301
Madera,29,2022-07-04,341,341,340,1,3179,3179,3173,6,9,0,0,1,371,371,371,371
Marin,29,2022-07-04,608,608,607,1,5170,5171,5162,9,25,1,1,2,247,247,246,246
Mariposa,29,2022-07-04,36,36,36,0,222,223,222,1,0,0,0,0,28,28,28,28
Mendocino,29,2022-07-04,164,164,164,0,1119,1119,1116,3,6,2,2,1,133,133,131,131
Merced,29,2022-07-04,596,596,595,1,2921,2921,2917,4,14,2,2,1,835,835,833,833
Modoc,29,2022-07-04,10,10,10,0,31,32,31,1,0,0,0,0,9,9,9,9
Mono,29,2022-07-04,22,22,22,0,81,82,81,1,1,0,0,0,7,7,7,7
Monterey,29,2022-07-04,840,840,838,2,6323,6327,6310,17,39,2,2,4,746,746,744,744
Napa,29,2022-07-04,345,345,345,0,2564,2564,2561,3,13,0,0,1,149,149,149,149
Nevada,29,2022-07-04,177,177,177,0,1268,1268,1266,2,5,0,0,1,134,134,134,134
Orange,29,2022-07-04,7021,7025,7018,7,50773,50799,50748,51,203,25,25,34,7247,7247,7222,7222
Placer,29,2022-07-04,808,808,807,1,5049,5050,5041,9,72,3,3,6,643,643,640,640
Plumas,29,2022-07-04,32,32,32,0,172,173,172,1,0,0,0,0,13,13,13,13
Riverside,29,2022-07-04,6393,6397,6388,9,38526,38546,38494,52,137,5,5,8,6514,6514,6509,6509
Sacramento,29,2022-07-04,3579,3579,3574,5,26535,26549,26510,39,163,19,19,22,3171,3171,3152,3152
San Benito,29,2022-07-04,211,211,211,0,1274,1274,1272,2,3,0,0,0,96,96,96,96
San Bernardino,29,2022-07-04,6064,6068,6061,7,41598,41620,41575,45,147,12,12,26,7910,7910,7898,7898
San Diego,29,2022-07-04,9553,9558,9554,4,65500,65534,65504,30,262,10,10,43,5425,5425,5415,5415
San Francisco,29,2022-07-04,2891,2891,2882,9,24203,24215,24143,72,100,11,11,18,945,945,934,934
San Joaquin,29,2022-07-04,1682,1682,1679,3,14679,14686,14663,23,41,5,5,4,2281,2281,2276,2276
San Luis Obispo,29,2022-07-04,616,616,615,1,4166,4166,4161,5,24,0,0,0,502,502,502,502
San Mateo,29,2022-07-04,2599,2599,2596,3,21595,21607,21585,22,39,1,1,3,732,732,731,731
Santa Barbara,29,2022-07-04,1057,1057,1056,1,7666,7670,7659,11,26,4,4,4,705,705,701,701
Santa Clara,29,2022-07-04,6804,6808,6805,3,50747,50772,50748,24,191,16,16,34,2410,2410,2394,2394
Santa Cruz,29,2022-07-04,733,733,732,1,7159,7163,7154,9,22,0,0,0,267,267,267,267
Shasta,29,2022-07-04,280,280,280,0,2396,2396,2392,4,15,5,5,3,576,576,571,571
Siskiyou,29,2022-07-04,34,34,34,0,326,327,326,1,1,0,0,1,85,85,85,85
Solano,29,2022-07-04,1344,1344,1342,2,9841,9846,9833,13,50,0,0,5,453,453,453,453
Sonoma,29,2022-07-04,1088,1088,1087,1,8094,8098,8087,11,35,2,2,1,506,506,504,504
Stanislaus,29,2022-07-04,1165,1165,1163,2,6991,6995,6980,15,84,7,7,16,1717,1717,1710,1710
Sutter,29,2022-07-04,228,228,228,0,1671,1671,1669,2,0,0,0,0,228,228,228,228
Tehama,29,2022-07-04,131,131,131,0,821,821,819,2,3,2,2,0,210,210,208,208
Trinity,29,2022-07-04,17,17,17,0,143,144,143,1,2,0,0,0,20,20,20,20
Tulare,29,2022-07-04,947,947,945,2,6121,6124,6111,13,40,4,4,1,1516,1516,1512,1512
Tuolumne,29,2022-07-04,162,162,162,0,938,938,936,2,8,0,0,1,191,191,191,191
Ventura,29,2022-07-04,1948,1948,1946,2,15412,15421,15407,14,66,2,2,8,1528,1528,1526,1526
Yolo,29,2022-07-04,535,535,534,1,7258,7261,7252,9,6,3,3,2,371,371,368,368
Yuba,29,2022-07-04,167,167,167,0,1078,1078,1077,1,9,0,0,1,129,129,129,129
Alameda,30,2022-07-11,5802,5806,5801,5,48339,48368,48328,40,119,5,5,16,1928,1928,1923,1923
Amador,30,2022-07-11,92,92,92,0,1504,1504,1502,2,2,0,0,0,87,87,87,87
Butte,30,2022-07-11,497,497,497,0,3298,3298,3296,2,27,1,1,4,451,451,450,450
Calaveras,30,2022-07-11,78,78,78,0,566,566,565,1,0,1,1,1,129,129,128,128
Colusa,30,2022-07-11,26,26,26,0,483,484,483,1,0,0,0,0,22,22,22,22
Contra Costa,30,2022-07-11,3686,3686,3681,5,26541,26556,26519,37,91,11,11,11,1390,1390,1379,1379
Del Norte,30,2022-07-11,174,174,174,0,677,677,676,1,5,0,0,1,53,53,53,53
El Dorado,30,2022-07-11,384,384,384,0,3153,3153,3149,4,12,1,1,3,227,227,226,226
Fresno,30,2022-07-11,3659,3659,3654,5,21550,21563,21535,28,161,7,7,14,2805,2805,2798,2798
Glenn,30,2022-07-11,45,45,45,0,382,383,382,1,0,0,0,0,56,56,56,56
Humboldt,30,2022-07-11,290,290,290,0,2189,2189,2187,2,11,1,1,2,154,154,153,153
Imperial,30,2022-07-11,1117,1117,1116,1,4746,4748,4742,6,14,1,1,1,949,949,948,948
Inyo,30,2022-07-11,40,40,40,0,391,392,391,1,0,1,1,0,57,57,56,56
Kern,30,2022-07-11,2481,2481,2479,2,17069,17079,17062,17,77,2,2,9,2372,2372,2370,2370
Kings,30,2022-07-11,731,731,730,1,4341,4344,4339,5,11,4,4,0,456,456,452,452
Lake,30,2022-07-11,126,126,126,0,1115,1115,1113,2,0,0,0,0,142,142,142,142
Lassen,30,2022-07-11,59,59,59,0,821,821,820,1,2,1,1,0,63,63,62,62
Los Angeles,30,2022-07-11,43328,43355,43341,14,381205,381435,381310,125,1038,90,90,115,32479,32479,32389,32389
Madera,30,2022-07-11,531,531,530,1,4126,4127,4122,5,15,0,0,3,371,371,371,371
Marin,30,2022-07-11,603,603,602,1,5929,5934,5926,8,17,1,1,1,248,248,247,247
Mariposa,30,2022-07-11,52,52,52,0,283,284,283,1,0,0,0,0,28,28,28,28
Mendocino,30,2022-07-11,190,190,190,0,1387,1387,1385,2,4,0,0,0,133,133,133,133
Merced,30,2022-07-11,764,764,763,1,4273,4275,4271,4,16,5,5,1,840,840,835,835
Modoc,30,2022-07-11,28,28,28,0,57,58,57,1,0,1,1,0,10,10,9,9
Mono,30,2022-07-11,11,11,11,0,105,106,105,1,0,0,0,0,7,7,7,7
Monterey,30,2022-07-11,1091,1091,1089,2,7952,7957,7940,17,47,5,5,3,751,751,746,746
Napa,30,2022-07-11,372,372,372,0,3692,3692,3689,3,13,1,1,1,150,150,149,149
Nevada,30,2022-07-11,221,221,221,0,1826,1826,1824,2,7,0,0,1,134,134,134,134
Orange,30,2022-07-11,9819,9826,9818,8,64234,64274,64224,50,257,20,20,30,7267,7267,7247,7247
Placer,30,2022-07-11,784,784,783,1,5963,5968,5959,9,76,2,2,8,645,645,643,643
Plumas,30,2022-07-11,71,71,71,0,282,283,282,1,0,0,0,0,13,13,13,13
Riverside,30,2022-07-11,9213,9220,9211,9,52075,52106,52052,54,225,17,17,12,6531,6531,6514,6514
Sacramento,30,2022-07-11,4210,4210,4205,5,35517,35537,35497,40,184,22,22,24,3193,3193,3171,3171
San Benito,30,2022-07-11,235,235,235,0,1667,1667,1665,2,1,0,0,0,96,96,96,96
San Bernardino,30,2022-07-11,8431,8436,8429,7,57667,57700,57652,48,188,14,14,20,7924,7924,7910,7910
San Diego,30,2022-07-11,13596,13604,13599,5,85558,85609,85579,30,332,11,11,41,5436,5436,5425,5425
San Francisco,30,2022-07-11,2996,2996,2989,7,27845,27861,27797,64,105,11,11,23,956,956,945,945
San Joaquin,30,2022-07-11,2141,2141,2138,3,19356,19368,19344,24,55,7,7,11,2288,2288,2281,2281
San Luis Obispo,30,2022-07-11,754,754,753,1,5272,5275,5270,5,22,3,3,1,505,505,502,502
San Mateo,30,2022-07-11,2778,2778,2776,2,25663,25678,25658,20,42,6,6,4,738,738,732,732
Santa Barbara,30,2022-07-11,1326,1326,1325,1,9704,9709,9699,10,46,5,5,9,710,710,705,705
Santa Clara,30,2022-07-11,7402,7407,7404,3,59984,60021,59999,22,211,13,13,38,2423,2423,2410,2410
Santa Cruz,30,2022-07-11,1031,1031,1030,1,9513,9518,9509,9,16,0,0,0,267,267,267,267
Shasta,30,2022-07-11,328,328,328,0,3565,3567,3563,4,21,2,2,6,578,578,576,576
Siskiyou,30,2022-07-11,29,29,29,0,361,362,361,1,1,1,1,1,86,86,85,85
Solano,30,2022-07-11,1632,1632,1630,2,11658,11663,11651,12,40,1,1,6,454,454,453,453
Sonoma,30,2022-07-11,1300,1300,1299,1,9946,9952,9942,10,50,0,0,7,506,506,506,506
Stanislaus,30,2022-07-11,1494,1494,1492,2,8691,8696,8682,14,103,7,7,11,1724,1724,1717,1717
Sutter,30,2022-07-11,286,286,286,0,1777,1777,1775,2,0,0,0,0,228,228,228,228
Tehama,30,2022-07-11,133,133,133,0,925,925,924,1,5,0,0,1,210,210,210,210
Trinity,30,2022-07-11,35,35,35,0,120,121,120,1,0,0,0,0,20,20,20,20
Tulare,30,2022-07-11,1391,1391,1389,2,9608,9614,9598,16,47,4,4,2,1520,1520,1516,1516
Tuolumne,30,2022-07-11,252,252,252,0,1303,1303,1301,2,6,0,0,0,191,191,191,191
Ventura,30,2022-07-11,2552,2552,2550,2,19720,19732,19718,14,89,9,9,6,1537,1537,1528,1528
Yolo,30,2022-07-11,502,502,502,0,5418,5422,5417,5,4,3,3,4,374,374,371,371
Yuba,30,2022-07-11,217,217,217,0,1402,1402,1401,1,9,0,0,1,129,129,129,129
Alameda,31,2022-07-18,4940,4944,4941,3,42943,42972,42944,28,149,7,7,25,1935,1935,1928,1928
Amador,31,2022-07-18,85,85,85,0,1348,1348,1347,1,6,0,0,1,87,87,87,87
Butte,31,2022-07-18,335,335,335,0,2796,2796,2795,1,25,1,1,3,452,452,451,451
Calaveras,31,2022-07-18,78,78,78,0,545,546,545,1,0,0,0,0,129,129,129,129
Colusa,31,2022-07-18,23,23,23,0,349,350,349,1,2,0,0,0,22,22,22,22
Contra Costa,31,2022-07-18,3054,3054,3051,3,22722,22738,22713,25,88,4,4,16,1394,1394,1390,1390
Del Norte,31,2022-07-18,168,168,168,0,705,705,704,1,7,0,0,0,53,53,53,53
El Dorado,31,2022-07-18,279,279,279,0,2638,2638,2636,2,11,1,1,1,228,228,227,227
Fresno,31,2022-07-18,3704,3705,3701,4,21098,21112,21090,22,199,9,9,15,2814,2814,2805,2805
Glenn,31,2022-07-18,34,34,34,0,263,264,263,1,0,0,0,0,56,56,56,56
Humboldt,31,2022-07-18,293,293,293,0,2026,2026,2024,2,10,0,0,4,154,154,154,154
Imperial,31,2022-07-18,1023,1023,1022,1,4435,4439,4435,4,18,2,2,3,951,951,949,949
Inyo,31,2022-07-18,30,30,30,0,332,333,332,1,0,0,0,0,57,57,57,57
Kern,31,2022-07-18,2318,2318,2316,2,16584,16596,16584,12,72,10,10,14,2382,2382,2372,2372
Kings,31,2022-07-18,708,708,707,1,4154,4157,4153,4,16,1,1,0,457,457,456,456
Lake,31,2022-07-18,132,132,132,0,994,994,993,1,3,0,0,0,142,142,142,142
Lassen,31,2022-07-18,78,78,78,0,1239,1239,1238,1,1,0,0,0,63,63,63,63
Los Angeles,31,2022-07-18,41852,41881,41870,11,352180,352424,352334,90,1162,112,112,137,32591,32591,32479,32479
Madera,31,2022-07-18,530,530,529,1,3632,3633,3629,4,5,0,0,3,371,371,371,371
Marin,31,2022-07-18,516,516,515,1,5504,5509,5503,6,12,1,1,5,249,249,248,248
Mariposa,31,2022-07-18,42,42,42,0,242,243,242,1,0,1,1,0,29,29,28,28
Mendocino,31,2022-07-18,185,185,185,0,1491,1491,1489,2,6,0,0,2,133,133,133,133
Merced,31,2022-07-18,753,753,752,1,3982,3984,3981,3,15,1,1,1,841,841,840,840
Modoc,31,2022-07-18,13,13,13,0,34,35,34,1,1,0,0,0,10,10,10,10
Mono,31,2022-07-18,10,10,10,0,85,86,85,1,1,0,0,0,7,7,7,7
Monterey,31,2022-07-18,977,977,975,2,7189,7194,7182,12,46,6,6,4,757,757,751,751
Napa,31,2022-07-18,327,327,327,0,2974,2974,2972,2,10,2,2,2,152,152,150,150
Nevada,31,2022-07-18,135,135,135,0,1331,1331,1330,1,8,0,0,3,134,134,134,134
Orange,31,2022-07-18,8870,8877,8872,5,59858,59900,59864,36,253,24,24,45,7291,7291,7267,7267
Placer,31,2022-07-18,684,684,683,1,5240,5245,5239,6,89,1,1,5,646,646,645,645
Plumas,31,2022-07-18,60,60,60,0,279,280,279,1,0,0,0,0,13,13,13,13
Riverside,31,2022-07-18,8242,8249,8242,7,48076,48110,48071,39,222,16,16,17,6547,6547,6531,6531
Sacramento,31,2022-07-18,3543,3543,3540,3,30409,30429,30403,26,180,12,12,26,3205,3205,3193,3193
San Benito,31,2022-07-18,199,199,199,0,1588,1588,1587,1,1,2,2,0,98,98,96,96
San Bernardino,31,2022-07-18,8002,8009,8004,5,53747,53783,53748,35,214,13,13,35,7937,7937,7924,7924
San Diego,31,2022-07-18,13023,13033,13029,4,79861,79917,79895,22,402,18,18,52,5454,5454,5436,5436
San Francisco,31,2022-07-18,2487,2487,2483,4,25516,25534,25489,45,111,10,10,24,966,966,956,956
San Joaquin,31,2022-07-18,2054,2054,2052,2,18032,18046,18029,17,66,2,2,11,2290,2290,2288,2288
San Luis Obispo,31,2022-07-18,559,559,559,0,4627,4631,4628,3,17,3,3,1,508,508,505,505
San Mateo,31,2022-07-18,2291,2291,2290,1,23097,23112,23098,14,33,0,0,4,738,738,738,738
Santa Barbara,31,2022-07-18,1298,1298,1297,1,9272,9277,9269,8,47,1,1,6,711,711,710,710
Santa Clara,31,2022-07-18,6194,6199,6197,2,54689,54728,54712,16,199,12,12,30,2435,2435,2423,2423
Santa Cruz,31,2022-07-18,874,874,873,1,7449,7454,7449,5,24,1,1,2,268,268,267,267
Shasta,31,2022-07-18,321,321,321,0,3209,3210,3207,3,40,3,3,3,581,581,578,578
Siskiyou,31,2022-07-18,34,34,34,0,345,346,345,1,3,0,0,0,86,86,86,86
Solano,31,2022-07-18,1246,1246,1245,1,9543,9549,9541,8,49,1,1,6,455,455,454,454
Sonoma,31,2022-07-18,1055,1055,1054,1,8751,8757,8750,7,44,0,0,5,506,506,506,506
Stanislaus,31,2022-07-18,1394,1394,1392,2,8398,8403,8392,11,109,5,5,9,1729,1729,1724,1724
Sutter,31,2022-07-18,249,249,249,0,1673,1673,1672,1,0,0,0,0,228,228,228,228
Tehama,31,2022-07-18,109,109,109,0,896,896,895,1,7,2,2,0,212,212,210,210
Trinity,31,2022-07-18,20,20,20,0,111,112,111,1,1,0,0,0,20,20,20,20
Tulare,31,2022-07-18,1185,1185,1183,2,8115,8120,8110,10,45,0,0,0,1520,1520,1520,1520
Tuolumne,31,2022-07-18,238,238,238,0,1142,1142,1141,1,7,4,4,0,195,195,191,191
Ventura,31,2022-07-18,2324,2324,2323,1,19563,19576,19565,11,92,4,4,7,1541,1541,1537,1537
Yolo,31,2022-07-18,430,430,430,0,4653,4657,4654,3,2,3,3,1,377,377,374,374
Yuba,31,2022-07-18,213,213,213,0,1292,1292,1291,1,18,0,0,0,129,129,129,129
Alameda,32,2022-07-25,4390,4394,4392,2,40435,40467,40447,20,143,11,11,19,1946,1946,1935,1935
Amador,32,2022-07-25,90,90,90,0,1206,1206,1205,1,3,0,0,1,87,87,87,87
Butte,32,2022-07-25,359,359,359,0,2945,2945,2944,1,30,2,2,2,454,454,452,452
Calaveras,32,2022-07-25,82,82,82,0,558,559,558,1,0,2,2,1,131,131,129,129
Colusa,32,2022-07-25,26,26,26,0,373,374,373,1,1,0,0,0,22,22,22,22
Contra Costa,32,2022-07-25,2825,2825,2823,2,21986,22003,21984,19,102,7,7,18,1401,1401,1394,1394
Del Norte,32,2022-07-25,67,67,67,0,534,535,534,1,6,0,0,0,53,53,53,53
El Dorado,32,2022-07-25,270,270,270,0,2485,2485,2483,2,9,1,1,0,229,229,228,228
Fresno,32,2022-07-25,3359,3360,3357,3,20379,20394,20378,16,195,6,6,29,2820,2820,2814,2814
Glenn,32,2022-07-25,31,31,31,0,271,272,271,1,0,0,0,0,56,56,56,56
Humboldt,32,2022-07-25,230,230,230,0,1923,1923,1922,1,13,2,2,4,156,156,154,154
Imperial,32,2022-07-25,871,871,870,1,4339,4343,4340,3,18,1,1,6,952,952,951,951
Inyo,32,2022-07-25,18,18,18,0,284,285,284,1,2,1,1,0,58,58,57,57
Kern,32,2022-07-25,1930,1930,1929,1,15241,15253,15244,9,82,3,3,12,2385,2385,2382,2382
Kings,32,2022-07-25,571,571,571,0,3888,3891,3888,3,15,1,1,0,458,458,457,457
Lake,32,2022-07-25,128,128,128,0,1041,1041,1040,1,5,1,1,2,143,143,142,142
Lassen,32,2022-07-25,53,53,53,0,1071,1071,1070,1,1,0,0,0,63,63,63,63
Los Angeles,32,2022-07-25,37136,37164,37157,7,334179,334433,334366,67,1152,122,122,134,32713,32713,32591,32591
Madera,32,2022-07-25,539,539,539,0,3829,3831,3828,3,11,1,1,5,372,372,371,371
Marin,32,2022-07-25,489,489,489,0,5418,5423,5419,4,26,2,2,2,251,251,249,249
Mariposa,32,2022-07-25,40,40,40,0,232,233,232,1,0,0,0,0,29,29,29,29
Mendocino,32,2022-07-25,195,195,195,0,1426,1426,1424,2,6,0,0,0,133,133,133,133
Merced,32,2022-07-25,731,731,731,0,3917,3919,3917,2,22,2,2,2,843,843,841,841
Modoc,32,2022-07-25,5,5,5,0,28,29,28,1,0,1,1,0,11,11,10,10
Mono,32,2022-07-25,15,15,15,0,85,86,85,1,0,0,0,0,7,7,7,7
Monterey,32,2022-07-25,924,924,923,1,7146,7151,7142,9,39,1,1,3,758,758,757,757
Napa,32,2022-07-25,298,298,298,0,2946,2946,2944,2,6,3,3,0,155,155,152,152
Nevada,32,2022-07-25,116,116,116,0,1316,1316,1315,1,3,1,1,0,135,135,134,134
Orange,32,2022-07-25,8074,8081,8077,4,58197,58241,58214,27,306,38,38,35,7329,7329,7291,7291
Placer,32,2022-07-25,606,606,605,1,5086,5091,5087,4,77,5,5,11,651,651,646,646
Plumas,32,2022-07-25,25,25,25,0,188,189,188,1,0,0,0,0,13,13,13,13
Riverside,32,2022-07-25,7518,7525,7520,5,45942,45977,45948,29,259,16,16,27,6563,6563,6547,6547
Sacramento,32,2022-07-25,3633,3634,3632,2,29837,29859,29839,20,207,18,18,32,3223,3223,3205,3205
San Benito,32,2022-07-25,200,200,200,0,1836,1836,1835,1,0,1,1,0,99,99,98,98
San Bernardino,32,2022-07-25,7096,7101,7097,4,52146,52184,52158,26,214,30,30,23,7967,7967,7937,7937
San Diego,32,2022-07-25,11811,11821,11819,2,76182,76240,76224,16,393,19,19,41,5473,5473,5454,5454
San Francisco,32,2022-07-25,2294,2294,2291,3,24269,24287,24253,34,126,9,9,24,975,975,966,966
San Joaquin,32,2022-07-25,1838,1838,1837,1,16572,16585,16573,12,73,5,5,9,2295,2295,2290,2290
San Luis Obispo,32,2022-07-25,538,538,538,0,4381,4384,4381,3,16,4,4,1,512,512,508,508
San Mateo,32,2022-07-25,2029,2029,2028,1,21689,21706,21696,10,57,1,1,7,739,739,738,738
Santa Barbara,32,2022-07-25,1178,1178,1177,1,8771,8776,8770,6,37,4,4,3,715,715,711,711
Santa Clara,32,2022-07-25,5771,5777,5776,1,50882,50920,50909,11,238,16,16,26,2451,2451,2435,2435
Santa Cruz,32,2022-07-25,831,831,831,0,7664,7669,7665,4,23,0,0,0,268,268,268,268
Shasta,32,2022-07-25,306,306,306,0,3079,3080,3078,2,38,2,2,6,583,583,581,581
Siskiyou,32,2022-07-25,36,36,36,0,333,334,333,1,1,0,0,0,86,86,86,86
Solano,32,2022-07-25,1204,1204,1203,1,9486,9492,9486,6,56,0,0,5,455,455,455,455
Sonoma,32,2022-07-25,1066,1066,1065,1,8657,8663,8658,5,48,2,2,4,508,508,506,506
Stanislaus,32,2022-07-25,1377,1377,1376,1,8161,8166,8158,8,104,8,8,11,1737,1737,1729,1729
Sutter,32,2022-07-25,218,218,218,0,1723,1723,1722,1,0,0,0,0,228,228,228,228
Tehama,32,2022-07-25,104,104,104,0,920,920,919,1,5,2,2,0,214,214,212,212
Trinity,32,2022-07-25,12,12,12,0,102,103,102,1,0,0,0,0,20,20,20,20
Tulare,32,2022-07-25,1145,1145,1144,1,8045,8051,8043,8,42,2,2,2,1522,1522,1520,1520
Tuolumne,32,2022-07-25,199,199,199,0,1150,1150,1149,1,5,1,1,0,196,196,195,195
Ventura,32,2022-07-25,2153,2153,2152,1,18391,18405,18397,8,76,5,5,8,1546,1546,1541,1541
Yolo,32,2022-07-25,414,414,414,0,4390,4394,4392,2,4,3,3,1,380,380,377,377
Yuba,32,2022-07-25,175,175,175,0,1282,1282,1281,1,15,0,0,0,129,129,129,129
Alameda,33,2022-08-01,3817,3820,3819,1,37195,37226,37211,15,176,5,5,21,1951,1951,1946,1946
Amador,33,2022-08-01,53,53,53,0,1133,1133,1132,1,3,1,1,0,88,88,87,87
Butte,33,2022-08-01,368,368,368,0,2841,2843,2842,1,33,2,2,3,456,456,454,454
Calaveras,33,2022-08-01,68,68,68,0,573,574,573,1,2,1,1,2,132,132,131,131
Colusa,33,2022-08-01,26,26,26,0,362,363,362,1,7,0,0,0,22,22,22,22
Contra Costa,33,2022-08-01,2623,2623,2621,2,21024,21041,21027,14,86,13,13,15,1414,1414,1401,1401
Del Norte,33,2022-08-01,53,53,53,0,476,477,476,1,4,0,0,2,53,53,53,53
El Dorado,33,2022-08-01,232,232,232,0,2456,2456,2455,1,4,3,3,2,232,232,229,229
Fresno,33,2022-08-01,2998,2998,2996,2,18294,18309,18298,11,231,10,10,16,2830,2830,2820,2820
Glenn,33,2022-08-01,28,28,28,0,251,252,251,1,0,0,0,0,56,56,56,56
Humboldt,33,2022-08-01,224,224,224,0,1880,1880,1879,1,12,0,0,3,156,156,156,156
Imperial,33,2022-08-01,636,636,636,0,3526,3529,3527,2,22,5,5,3,957,957,952,952
Inyo,33,2022-08-01,20,20,20,0,280,281,280,1,2,0,0,0,58,58,58,58
Kern,33,2022-08-01,1729,1729,1728,1,15102,15116,15109,7,81,6,6,17,2391,2391,2385,2385
Kings,33,2022-08-01,624,624,624,0,4044,4048,4046,2,6,0,0,1,458,458,458,458
Lake,33,2022-08-01,125,125,125,0,994,994,993,1,7,0,0,2,143,143,143,143
Lassen,33,2022-08-01,103,103,103,0,947,948,947,1,0,0,0,0,63,63,63,63
Los Angeles,33,2022-08-01,30611,30637,30632,5,308971,309233,309185,48,1105,130,130,137,32843,32843,32713,32713
Madera,33,2022-08-01,463,463,463,0,3482,3485,3483,2,10,0,0,7,372,372,372,372
Marin,33,2022-08-01,411,411,411,0,5134,5139,5136,3,32,1,1,4,252,252,251,251
Mariposa,33,2022-08-01,22,22,22,0,225,226,225,1,0,0,0,0,29,29,29,29
Mendocino,33,2022-08-01,174,174,174,0,1257,1257,1256,1,6,1,1,1,134,134,133,133
Merced,33,2022-08-01,643,643,643,0,3568,3570,3568,2,22,6,6,2,849,849,843,843
Modoc,33,2022-08-01,16,16,16,0,31,32,31,1,0,0,0,0,11,11,11,11
Mono,33,2022-08-01,9,9,9,0,67,68,67,1,0,0,0,0,7,7,7,7
Monterey,33,2022-08-01,926,926,925,1,6433,6438,6432,6,33,2,2,1,760,760,758,758
Napa,33,2022-08-01,287,287,287,0,2853,2854,2853,1,8,0,0,2,155,155,155,155
Nevada,33,2022-08-01,125,125,125,0,1404,1404,1403,1,12,0,0,0,135,135,135,135
Orange,33,2022-08-01,6556,6562,6560,2,52472,52516,52497,19,246,34,34,49,7363,7363,7329,7329
Placer,33,2022-08-01,588,588,588,0,4744,4749,4746,3,71,1,1,11,652,652,651,651
Plumas,33,2022-08-01,23,23,23,0,162,163,162,1,0,0,0,0,13,13,13,13
Riverside,33,2022-08-01,6129,6134,6131,3,42292,42328,42307,21,200,5,5,23,6568,6568,6563,6563
Sacramento,33,2022-08-01,3097,3098,3096,2,27845,27868,27853,15,179,18,18,26,3241,3241,3223,3223
San Benito,33,2022-08-01,172,172,172,0,1562,1562,1561,1,2,1,1,0,100,100,99,99
San Bernardino,33,2022-08-01,6066,6071,6069,2,48920,48961,48942,19,184,26,26,23,7993,7993,7967,7967
San Diego,33,2022-08-01,9319,9326,9324,2,68652,68710,68699,11,396,16,16,46,5489,5489,5473,5473
San Francisco,33,2022-08-01,1814,1814,1812,2,21993,22011,21987,24,105,13,13,20,988,988,975,975
San Joaquin,33,2022-08-01,1735,1735,1734,1,16114,16128,16119,9,69,7,7,11,2302,2302,2295,2295
San Luis Obispo,33,2022-08-01,578,578,578,0,4141,4146,4144,2,14,3,3,0,515,515,512,512
San Mateo,33,2022-08-01,1774,1774,1773,1,20333,20348,20341,7,67,1,1,3,740,740,739,739
Santa Barbara,33,2022-08-01,1119,1119,1118,1,7779,7785,7781,4,40,1,1,3,716,716,715,715
Santa Clara,33,2022-08-01,4827,4832,4831,1,45490,45528,45520,8,230,19,19,36,2470,2470,2451,2451
Santa Cruz,33,2022-08-01,748,748,748,0,6877,6882,6879,3,20,1,1,3,269,269,268,268
Shasta,33,2022-08-01,247,247,247,0,2968,2969,2967,2,34,2,2,7,585,585,583,583
Siskiyou,33,2022-08-01,29,29,29,0,298,299,298,1,2,0,0,0,86,86,86,86
Solano,33,2022-08-01,1146,1146,1145,1,9147,9154,9149,5,53,0,0,4,455,455,455,455
Sonoma,33,2022-08-01,921,921,921,0,8187,8193,8189,4,46,3,3,3,511,511,508,508
Stanislaus,33,2022-08-01,1233,1233,1232,1,7721,7728,7722,6,115,6,6,8,1743,1743,1737,1737
Sutter,33,2022-08-01,226,226,226,0,1634,1634,1633,1,0,3,3,0,231,231,228,228
Tehama,33,2022-08-01,88,88,88,0,757,757,756,1,4,0,0,0,214,214,214,214
Trinity,33,2022-08-01,11,11,11,0,71,72,71,1,0,1,1,0,21,21,20,20
Tulare,33,2022-08-01,1033,1033,1032,1,7478,7484,7478,6,46,1,1,3,1523,1523,1522,1522
Tuolumne,33,2022-08-01,144,144,144,0,1111,1111,1110,1,4,0,0,1,196,196,196,196
Ventura,33,2022-08-01,1808,1808,1807,1,16971,16984,16978,6,75,10,10,10,1556,1556,1546,1546
Yolo,33,2022-08-01,332,332,332,0,4177,4180,4178,2,3,3,3,1,383,383,380,380
Yuba,33,2022-08-01,158,158,158,0,1215,1215,1214,1,10,0,0,3,129,129,129,129
Alameda,34,2022-08-08,3310,3313,3312,1,35425,35459,35448,11,133,11,11,20,1962,1962,1951,1951
Amador,34,2022-08-08,50,50,50,0,852,853,852,1,3,0,0,1,88,88,88,88
Butte,34,2022-08-08,333,333,333,0,2495,2496,2495,1,33,1,1,1,457,457,456,456
Calaveras,34,2022-08-08,57,57,57,0,559,560,559,1,1,1,1,0,133,133,132,132
Colusa,34,2022-08-08,15,15,15,0,362,363,362,1,0,0,0,0,22,22,22,22
Contra Costa,34,2022-08-08,2173,2173,2172,1,19801,19820,19810,10,102,4,4,14,1418,1418,1414,1414
Del Norte,34,2022-08-08,49,49,49,0,498,499,498,1,4,1,1,1,54,54,53,53
El Dorado,34,2022-08-08,191,191,191,0,2317,2318,2317,1,4,0,0,2,232,232,232,232
Fresno,34,2022-08-08,2420,2420,2419,1,17743,17760,17751,9,207,9,9,25,2839,2839,2830,2830
Glenn,34,2022-08-08,22,22,22,0,249,250,249,1,0,0,0,0,56,56,56,56
Humboldt,34,2022-08-08,208,208,208,0,1920,1920,1919,1,12,1,1,2,157,157,156,156
Imperial,34,2022-08-08,547,547,547,0,3279,3282,3281,1,16,2,2,2,959,959,957,957
Inyo,34,2022-08-08,8,8,8,0,276,277,276,1,1,0,0,1,58,58,58,58
Kern,34,2022-08-08,1339,1339,1339,0,13982,13996,13991,5,61,6,6,16,2397,2397,2391,2391
Kings,34,2022-08-08,467,467,467,0,3326,3329,3328,1,20,1,1,2,459,459,458,458
Lake,34,2022-08-08,106,106,106,0,893,894,893,1,4,0,0,1,143,143,143,143
Lassen,34,2022-08-08,132,132,132,0,1023,1024,1023,1,1,1,1,0,64,64,63,63
Los Angeles,34,2022-08-08,25796,25821,25818,3,293425,293705,293670,35,1030,130,130,121,32973,32973,32843,32843
Madera,34,2022-08-08,380,380,380,0,3175,3177,3175,2,16,0,0,3,372,372,372,372
Marin,34,2022-08-08,361,361,361,0,4485,4490,4488,2,26,2,2,2,254,254,252,252
Mariposa,34,2022-08-08,28,28,28,0,197,198,197,1,0,0,0,0,29,29,29,29
Mendocino,34,2022-08-08,131,131,131,0,1128,1128,1127,1,3,1,1,1,135,135,134,134
Merced,34,2022-08-08,538,538,538,0,3397,3401,3400,1,17,1,1,5,850,850,849,849
Modoc,34,2022-08-08,2,2,2,0,22,23,22,1,0,0,0,0,11,11,11,11
Mono,34,2022-08-08,10,10,10,0,85,86,85,1,0,0,0,0,7,7,7,7
Monterey,34,2022-08-08,731,731,730,1,5776,5781,5777,4,28,1,1,0,761,761,760,760
Napa,34,2022-08-08,263,263,263,0,2629,2630,2629,1,10,2,2,3,157,157,155,155
Nevada,34,2022-08-08,93,93,93,0,1290,1290,1289,1,4,0,0,0,135,135,135,135
Orange,34,2022-08-08,5478,5484,5482,2,49035,49080,49066,14,242,29,29,40,7392,7392,7363,7363
Placer,34,2022-08-08,513,513,513,0,4519,4524,4522,2,65,3,3,9,655,655,652,652
Plumas,34,2022-08-08,23,23,23,0,190,191,190,1,1,0,0,0,13,13,13,13
Riverside,34,2022-08-08,5567,5574,5572,2,40853,40892,40876,16,174,13,13,13,6581,6581,6568,6568
Sacramento,34,2022-08-08,2626,2626,2625,1,26973,26999,26988,11,156,17,17,20,3258,3258,3241,3241
San Benito,34,2022-08-08,185,185,185,0,1434,1435,1434,1,1,0,0,0,100,100,100,100
San Bernardino,34,2022-08-08,5111,5116,5114,2,46293,46337,46323,14,204,20,20,15,8013,8013,7993,7993
San Diego,34,2022-08-08,7238,7245,7244,1,64802,64864,64856,8,337,12,12,30,5501,5501,5489,5489
San Francisco,34,2022-08-08,1495,1495,1494,1,20638,20657,20640,17,94,11,11,21,999,999,988,988
San Joaquin,34,2022-08-08,1523,1523,1522,1,15717,15732,15725,7,55,7,7,12,2309,2309,2302,2302
San Luis Obispo,34,2022-08-08,509,509,509,0,3614,3619,3618,1,14,0,0,2,515,515,515,515
San Mateo,34,2022-08-08,1527,1527,1527,0,18587,18605,18600,5,60,0,0,5,740,740,740,740
Santa Barbara,34,2022-08-08,964,964,964,0,7525,7533,7530,3,46,3,3,4,719,719,716,716
Santa Clara,34,2022-08-08,4184,4188,4187,1,41197,41237,41231,6,203,18,18,40,2488,2488,2470,2470
Santa Cruz,34,2022-08-08,619,619,619,0,6061,6066,6064,2,28,1,1,0,270,270,269,269
Shasta,34,2022-08-08,198,198,198,0,2833,2835,2834,1,33,2,2,3,587,587,585,585
Siskiyou,34,2022-08-08,28,28,28,0,291,292,291,1,0,1,1,0,87,87,86,86
Solano,34,2022-08-08,883,883,883,0,7970,7977,7974,3,54,0,0,9,455,455,455,455
Sonoma,34,2022-08-08,840,840,840,0,7727,7734,7731,3,34,4,4,3,515,515,511,511
Stanislaus,34,2022-08-08,1035,1035,1034,1,7176,7183,7179,4,90,7,7,11,1750,1750,1743,1743
Sutter,34,2022-08-08,217,217,217,0,1552,1552,1551,1,0,0,0,0,231,231,231,231
Tehama,34,2022-08-08,78,78,78,0,681,682,681,1,0,0,0,1,214,214,214,214
Trinity,34,2022-08-08,5,5,5,0,71,72,71,1,0,0,0,0,21,21,21,21
Tulare,34,2022-08-08,886,886,885,1,7339,7345,7341,4,46,4,4,3,1527,1527,1523,1523
Tuolumne,34,2022-08-08,118,118,118,0,1054,1054,1053,1,4,2,2,0,198,198,196,196
Ventura,34,2022-08-08,1503,1503,1503,0,15935,15950,15946,4,67,7,7,7,1563,1563,1556,1556
Yolo,34,2022-08-08,287,287,287,0,3882,3886,3885,1,4,1,1,3,384,384,383,383
Yuba,34,2022-08-08,136,136,136,0,1086,1087,1086,1,6,1,1,0,130,130,129,129
Alameda,35,2022-08-15,2583,2584,2583,1,33885,33919,33911,8,105,9,9,22,1971,1971,1962,1962
Amador,35,2022-08-15,47,47,47,0,848,849,848,1,2,0,0,0,88,88,88,88
Butte,35,2022-08-15,262,262,262,0,2245,2246,2245,1,19,0,0,2,457,457,457,457
Calaveras,35,2022-08-15,46,46,46,0,528,529,528,1,0,0,0,0,133,133,133,133
Colusa,35,2022-08-15,16,16,16,0,359,360,359,1,1,0,0,0,22,22,22,22
Contra Costa,35,2022-08-15,1777,1777,1776,1,18971,18990,18982,8,72,7,7,9,1425,1425,1418,1418
Del Norte,35,2022-08-15,53,53,53,0,499,500,499,1,2,0,0,1,54,54,54,54
El Dorado,35,2022-08-15,178,178,178,0,2304,2305,2304,1,5,0,0,3,232,232,232,232
Fresno,35,2022-08-15,1871,1871,1870,1,16163,16180,16174,6,170,7,7,17,2846,2846,2839,2839
Glenn,35,2022-08-15,15,15,15,0,225,226,225,1,3,0,0,0,56,56,56,56
Humboldt,35,2022-08-15,178,178,178,0,1587,1588,1587,1,16,0,0,2,157,157,157,157
Imperial,35,2022-08-15,365,365,365,0,3101,3105,3104,1,11,0,0,2,959,959,959,959
Inyo,35,2022-08-15,14,14,14,0,238,239,238,1,2,1,1,0,59,59,58,58
Kern,35,2022-08-15,1238,1238,1238,0,13701,13716,13712,4,59,7,7,16,2404,2404,2397,2397
Kings,35,2022-08-15,332,332,332,0,3235,3239,3238,1,9,0,0,1,459,459,459,459
Lake,35,2022-08-15,104,104,104,0,1028,1029,1028,1,3,1,1,2,144,144,143,143
Lassen,35,2022-08-15,59,59,59,0,898,899,898,1,0,0,0,0,64,64,64,64
Los Angeles,35,2022-08-15,20955,20977,20975,2,289581,289884,289857,27,905,110,110,117,33083,33083,32973,32973
Madera,35,2022-08-15,305,305,305,0,2954,2957,2956,1,12,0,0,3,372,372,372,372
Marin,35,2022-08-15,295,295,295,0,4114,4119,4117,2,15,0,0,0,254,254,254,254
Mariposa,35,2022-08-15,15,15,15,0,192,193,192,1,0,0,0,0,29,29,29,29
Mendocino,35,2022-08-15,104,104,104,0,996,996,995,1,7,0,0,3,135,135,135,135
Merced,35,2022-08-15,453,453,453,0,3427,3432,3431,1,12,2,2,1,852,852,850,850
Modoc,35,2022-08-15,4,4,4,0,23,24,23,1,0,0,0,0,11,11,11,11
Mono,35,2022-08-15,4,4,4,0,61,62,61,1,0,0,0,0,7,7,7,7
Monterey,35,2022-08-15,661,661,661,0,5825,5830,5827,3,30,0,0,1,761,761,761,761
Napa,35,2022-08-15,212,212,212,0,2291,2291,2290,1,13,0,0,0,157,157,157,157
Nevada,35,2022-08-15,98,98,98,0,1209,1210,1209,1,7,0,0,0,135,135,135,135
Orange,35,2022-08-15,4687,4692,4691,1,43771,43817,43807,10,270,31,31,44,7423,7423,7392,7392
Placer,35,2022-08-15,411,411,411,0,4469,4474,4472,2,61,1,1,11,656,656,655,655
Plumas,35,2022-08-15,17,17,17,0,184,185,184,1,0,0,0,0,13,13,13,13
Riverside,35,2022-08-15,4600,4605,4604,1,38263,38304,38293,11,143,16,16,22,6597,6597,6581,6581
Sacramento,35,2022-08-15,2359,2360,2359,1,25434,25460,25452,8,149,12,12,22,3270,3270,3258,3258
San Benito,35,2022-08-15,137,137,137,0,1336,1337,1336,1,3,1,1,1,101,101,100,100
San Bernardino,35,2022-08-15,4741,4747,4746,1,44509,44555,44544,11,144,15,15,22,8028,8028,8013,8013
San Diego,35,2022-08-15,5481,5487,5486,1,59796,59858,59852,6,288,14,14,34,5515,5515,5501,5501
San Francisco,35,2022-08-15,1266,1266,1265,1,19590,19610,19597,13,103,15,15,11,1014,1014,999,999
San Joaquin,35,2022-08-15,1443,1443,1442,1,15217,15233,15228,5,64,8,8,8,2317,2317,2309,2309
San Luis Obispo,35,2022-08-15,325,325,325,0,3302,3306,3305,1,15,4,4,3,519,519,515,515
San Mateo,35,2022-08-15,1235,1235,1235,0,17463,17482,17478,4,56,1,1,5,741,741,740,740
Santa Barbara,35,2022-08-15,831,831,831,0,7130,7138,7136,2,44,1,1,4,720,720,719,719
Santa Clara,35,2022-08-15,3398,3402,3402,0,40109,40152,40148,4,200,9,9,24,2497,2497,2488,2488
Santa Cruz,35,2022-08-15,492,492,492,0,7545,7552,7550,2,23,3,3,1,273,273,270,270
Shasta,35,2022-08-15,194,194,194,0,2788,2791,2790,1,19,1,1,1,588,588,587,587
Siskiyou,35,2022-08-15,19,19,19,0,284,285,284,1,3,1,1,1,88,88,87,87
Solano,35,2022-08-15,662,662,662,0,7461,7468,7466,2,45,0,0,10,455,455,455,455
Sonoma,35,2022-08-15,632,632,632,0,7291,7299,7297,2,39,2,2,2,517,517,515,515
Stanislaus,35,2022-08-15,940,940,940,0,7659,7666,7662,4,99,9,9,11,1759,1759,1750,1750
Sutter,35,2022-08-15,194,194,194,0,1587,1589,1588,1,0,1,1,0,232,232,231,231
Tehama,35,2022-08-15,58,58,58,0,645,646,645,1,1,0,0,0,214,214,214,214
Trinity,35,2022-08-15,8,8,8,0,58,59,58,1,0,0,0,0,21,21,21,21
Tulare,35,2022-08-15,737,737,737,0,7348,7354,7351,3,32,3,3,1,1530,1530,1527,1527
Tuolumne,35,2022-08-15,110,110,110,0,991,992,991,1,1,0,0,0,198,198,198,198
Ventura,35,2022-08-15,1494,1494,1494,0,15265,15281,15278,3,70,6,6,7,1569,1569,1563,1563
Yolo,35,2022-08-15,264,264,264,0,3539,3542,3541,1,2,4,4,1,388,388,384,384
Yuba,35,2022-08-15,128,128,128,0,1080,1081,1080,1,9,0,0,0,130,130,130,130
Alameda,36,2022-08-22,2251,2251,2251,0,33318,33354,33348,6,117,7,7,21,1978,1978,1971,1971
Amador,36,2022-08-22,49,49,49,0,817,818,817,1,2,1,1,0,89,89,88,88
Butte,36,2022-08-22,222,222,222,0,2131,2133,2132,1,17,1,1,2,458,458,457,457
Calaveras,36,2022-08-22,43,43,43,0,572,573,572,1,1,0,0,0,133,133,133,133
Colusa,36,2022-08-22,16,16,16,0,394,395,394,1,0,0,0,0,22,22,22,22
Contra Costa,36,2022-08-22,1530,1530,1530,0,18846,18867,18861,6,56,5,5,9,1430,1430,1425,1425
Del Norte,36,2022-08-22,32,32,32,0,462,463,462,1,3,1,1,0,55,55,54,54
El Dorado,36,2022-08-22,152,152,152,0,2220,2222,2221,1,4,1,1,0,233,233,232,232
Fresno,36,2022-08-22,1597,1597,1597,0,15770,15787,15782,5,162,6,6,14,2852,2852,2846,2846
Glenn,36,2022-08-22,23,23,23,0,227,228,227,1,1,0,0,0,56,56,56,56
Humboldt,36,2022-08-22,151,151,151,0,1679,1680,1679,1,6,1,1,3,158,158,157,157
Imperial,36,2022-08-22,291,291,291,0,2844,2846,2845,1,15,0,0,0,959,959,959,959
Inyo,36,2022-08-22,8,8,8,0,214,215,214,1,0,0,0,0,59,59,59,59
Kern,36,2022-08-22,999,999,999,0,13976,13990,13987,3,69,6,6,10,2410,2410,2404,2404
Kings,36,2022-08-22,369,369,369,0,3636,3641,3640,1,10,2,2,0,461,461,459,459
Lake,36,2022-08-22,104,104,104,0,884,885,884,1,5,0,0,0,144,144,144,144
Lassen,36,2022-08-22,37,37,37,0,834,835,834,1,0,0,0,0,64,64,64,64
Los Angeles,36,2022-08-22,18498,18519,18518,1,276851,277156,277136,20,811,122,122,104,33205,33205,33083,33083
Madera,36,2022-08-22,300,300,300,0,2613,2616,2615,1,14,2,2,4,374,374,372,372
Marin,36,2022-08-22,250,250,250,0,3968,3973,3972,1,17,0,0,3,254,254,254,254
Mariposa,36,2022-08-22,14,14,14,0,172,173,172,1,0,0,0,0,29,29,29,29
Mendocino,36,2022-08-22,121,121,121,0,1145,1146,1145,1,3,0,0,2,135,135,135,135
Merced,36,2022-08-22,447,447,447,0,3660,3665,3664,1,12,4,4,1,856,856,852,852
Modoc,36,2022-08-22,6,6,6,0,27,28,27,1,0,0,0,0,11,11,11,11
Mono,36,2022-08-22,4,4,4,0,63,64,63,1,0,0,0,0,7,7,7,7
Monterey,36,2022-08-22,547,547,547,0,5929,5935,5932,3,27,1,1,2,762,762,761,761
Napa,36,2022-08-22,127,127,127,0,2010,2011,2010,1,5,2,2,1,159,159,157,157
Nevada,36,2022-08-22,84,84,84,0,1180,1181,1180,1,6,0,0,0,135,135,135,135
Orange,36,2022-08-22,3926,3931,3930,1,41465,41510,41503,7,224,21,21,35,7444,7444,7423,7423
Placer,36,2022-08-22,384,384,384,0,4307,4312,4311,1,61,1,1,14,657,657,656,656
Plumas,36,2022-08-22,20,20,20,0,175,176,175,1,1,0,0,0,13,13,13,13
Riverside,36,2022-08-22,4421,4426,4425,1,37725,37767,37758,9,142,14,14,19,6611,6611,6597,6597
Sacramento,36,2022-08-22,2089,2089,2088,1,25029,25057,25051,6,144,15,15,25,3285,3285,3270,3270
San Benito,36,2022-08-22,101,101,101,0,1268,1269,1268,1,1,1,1,1,102,102,101,101
San Bernardino,36,2022-08-22,4692,4698,4697,1,44669,44718,44710,8,160,18,18,22,8046,8046,8028,8028
San Diego,36,2022-08-22,4767,4773,4773,0,57817,57880,57876,4,287,6,6,28,5521,5521,5515,5515
San Francisco,36,2022-08-22,1097,1097,1096,1,18878,18899,18889,10,81,16,16,12,1030,1030,1014,1014
San Joaquin,36,2022-08-22,1194,1194,1194,0,15725,15742,15738,4,56,1,1,8,2318,2318,2317,2317
San Luis Obispo,36,2022-08-22,259,259,259,0,3090,3094,3093,1,16,1,1,0,520,520,519,519
San Mateo,36,2022-08-22,1028,1028,1028,0,17321,17340,17337,3,42,0,0,2,741,741,741,741
Santa Barbara,36,2022-08-22,736,736,736,0,7443,7451,7449,2,37,1,1,2,721,721,720,720
Santa Clara,36,2022-08-22,3079,3083,3083,0,40561,40605,40602,3,173,10,10,27,2507,2507,2497,2497
Santa Cruz,36,2022-08-22,502,502,502,0,11965,11979,11977,2,13,0,0,0,273,273,273,273
Shasta,36,2022-08-22,174,174,174,0,2760,2763,2762,1,10,2,2,2,590,590,588,588
Siskiyou,36,2022-08-22,25,25,25,0,249,250,249,1,4,1,1,2,89,89,88,88
Solano,36,2022-08-22,535,535,535,0,7222,7229,7227,2,35,0,0,12,455,455,455,455
Sonoma,36,2022-08-22,606,606,606,0,7374,7382,7380,2,42,2,2,1,519,519,517,517
Stanislaus,36,2022-08-22,894,894,894,0,7652,7660,7657,3,79,7,7,16,1766,1766,1759,1759
Sutter,36,2022-08-22,182,182,182,0,1657,1659,1658,1,0,0,0,0,232,232,232,232
Tehama,36,2022-08-22,51,51,51,0,629,630,629,1,1,0,0,0,214,214,214,214
Trinity,36,2022-08-22,10,10,10,0,63,64,63,1,0,0,0,0,21,21,21,21
Tulare,36,2022-08-22,730,730,730,0,6804,6810,6808,2,33,4,4,1,1534,1534,1530,1530
Tuolumne,36,2022-08-22,106,106,106,0,1018,1019,1018,1,0,1,1,0,199,199,198,198
Ventura,36,2022-08-22,1319,1319,1319,0,15002,15019,15017,2,59,4,4,9,1573,1573,1569,1569
Yolo,36,2022-08-22,200,200,200,0,3493,3497,3496,1,10,1,1,1,389,389,388,388
Yuba,36,2022-08-22,127,127,127,0,1106,1107,1106,1,13,0,0,3,130,130,130,130
Alameda,37,2022-08-29,1992,1992,1992,0,34351,34391,34386,5,99,10,10,20,1988,1988,1978,1978
Amador,37,2022-08-29,46,46,46,0,804,805,804,1,2,1,1,0,90,90,89,89
Butte,37,2022-08-29,236,236,236,0,2173,2175,2174,1,18,0,0,3,458,458,458,458
Calaveras,37,2022-08-29,59,59,59,0,593,594,593,1,1,0,0,0,133,133,133,133
Colusa,37,2022-08-29,11,11,11,0,329,330,329,1,3,0,0,0,22,22,22,22
Contra Costa,37,2022-08-29,1360,1360,1360,0,18810,18832,18827,5,44,5,5,7,1435,1435,1430,1430
Del Norte,37,2022-08-29,28,28,28,0,432,433,432,1,5,0,0,1,55,55,55,55
El Dorado,37,2022-08-29,142,142,142,0,1947,1949,1948,1,1,0,0,1,233,233,233,233
Fresno,37,2022-08-29,1419,1419,1419,0,15724,15743,15739,4,159,3,3,15,2855,2855,2852,2852
Glenn,37,2022-08-29,22,22,22,0,220,221,220,1,1,0,0,0,56,56,56,56
Humboldt,37,2022-08-29,122,122,122,0,1664,1665,1664,1,4,0,0,0,158,158,158,158
Imperial,37,2022-08-29,294,294,294,0,2936,2940,2939,1,14,1,1,2,960,960,959,959
Inyo,37,2022-08-29,8,8,8,0,176,177,176,1,0,0,0,0,59,59,59,59
Kern,37,2022-08-29,904,904,904,0,13447,13463,13461,2,50,0,0,8,2410,2410,2410,2410
Kings,37,2022-08-29,314,314,314,0,3491,3496,3495,1,8,0,0,0,461,461,461,461
Lake,37,2022-08-29,93,93,93,0,870,871,870,1,1,1,1,0,145,145,144,144
Lassen,37,2022-08-29,28,28,28,0,772,773,772,1,0,0,0,0,64,64,64,64
Los Angeles,37,2022-08-29,15576,15595,15594,1,273812,274133,274117,16,753,87,87,83,33292,33292,33205,33205
Madera,37,2022-08-29,302,302,302,0,3019,3023,3022,1,13,0,0,3,374,374,374,374
Marin,37,2022-08-29,215,215,215,0,3848,3853,3852,1,16,2,2,2,256,256,254,254
Mariposa,37,2022-08-29,25,25,25,0,186,187,186,1,0,0,0,0,29,29,29,29
Mendocino,37,2022-08-29,87,87,87,0,969,970,969,1,2,0,0,1,135,135,135,135
Merced,37,2022-08-29,393,393,393,0,3418,3423,3422,1,11,3,3,0,859,859,856,856
Modoc,37,2022-08-29,1,1,1,0,30,31,30,1,0,0,0,0,11,11,11,11
Mono,37,2022-08-29,2,2,2,0,45,46,45,1,0,0,0,0,7,7,7,7
Monterey,37,2022-08-29,394,394,394,0,5378,5383,5381,2,33,2,2,5,764,764,762,762
Napa,37,2022-08-29,130,130,130,0,2168,2170,2169,1,10,0,0,1,159,159,159,159
Nevada,37,2022-08-29,116,116,116,0,1206,1207,1206,1,6,0,0,0,135,135,135,135
Orange,37,2022-08-29,3064,3069,3069,0,39991,40037,40032,5,195,18,18,25,7462,7462,7444,7444
Placer,37,2022-08-29,370,370,370,0,4217,4222,4221,1,55,1,1,12,658,658,657,657
Plumas,37,2022-08-29,17,17,17,0,159,160,159,1,1,0,0,0,13,13,13,13
Riverside,37,2022-08-29,3677,3682,3681,1,37023,37066,37059,7,124,9,9,11,6620,6620,6611,6611
Sacramento,37,2022-08-29,1881,1881,1881,0,24822,24850,24845,5,137,11,11,20,3296,3296,3285,3285
San Benito,37,2022-08-29,120,120,120,0,1413,1414,1413,1,1,0,0,0,102,102,102,102
San Bernardino,37,2022-08-29,3687,3692,3691,1,42586,42636,42630,6,156,14,14,18,8060,8060,8046,8046
San Diego,37,2022-08-29,3916,3922,3922,0,56926,56994,56991,3,222,12,12,25,5533,5533,5521,5521
San Francisco,37,2022-08-29,872,872,872,0,19155,19179,19171,8,57,7,7,12,1037,1037,1030,1030
San Joaquin,37,2022-08-29,1005,1005,1005,0,14298,14315,14312,3,27,5,5,11,2323,2323,2318,2318
San Luis Obispo,37,2022-08-29,326,326,326,0,3217,3222,3221,1,17,3,3,0,523,523,520,520
San Mateo,37,2022-08-29,872,872,872,0,16902,16921,16919,2,26,0,0,5,741,741,741,741
Santa Barbara,37,2022-08-29,638,638,638,0,7627,7637,7636,1,24,1,1,3,722,722,721,721
Santa Clara,37,2022-08-29,2357,2358,2358,0,40002,40049,40046,3,135,5,5,24,2512,2512,2507,2507
Santa Cruz,37,2022-08-29,384,384,384,0,12687,12702,12700,2,16,0,0,1,273,273,273,273
Shasta,37,2022-08-29,132,132,132,0,2578,2581,2580,1,19,1,1,1,591,591,590,590
Siskiyou,37,2022-08-29,24,24,24,0,249,250,249,1,0,1,1,0,90,90,89,89
Solano,37,2022-08-29,550,550,550,0,7291,7299,7298,1,33,2,2,8,457,457,455,455
Sonoma,37,2022-08-29,487,487,487,0,7108,7116,7115,1,37,1,1,4,520,520,519,519
Stanislaus,37,2022-08-29,850,850,850,0,8085,8095,8093,2,79,7,7,6,1773,1773,1766,1766
Sutter,37,2022-08-29,166,166,166,0,1638,1640,1639,1,0,0,0,0,232,232,232,232
Tehama,37,2022-08-29,67,67,67,0,738,739,738,1,4,0,0,1,214,214,214,214
Trinity,37,2022-08-29,9,9,9,0,56,57,56,1,0,0,0,0,21,21,21,21
Tulare,37,2022-08-29,683,683,683,0,7395,7403,7401,2,42,0,0,1,1534,1534,1534,1534
Tuolumne,37,2022-08-29,89,89,89,0,856,857,856,1,1,0,0,0,199,199,199,199
Ventura,37,2022-08-29,1021,1021,1021,0,14607,14625,14623,2,71,6,6,7,1579,1579,1573,1573
Yolo,37,2022-08-29,204,204,204,0,3718,3723,3722,1,5,0,0,3,389,389,389,389
Yuba,37,2022-08-29,135,135,135,0,1176,1177,1176,1,14,0,0,1,130,130,130,130
Alameda,38,2022-09-05,1459,1459,1459,0,28345,28381,28378,3,89,3,3,16,1991,1991,1988,1988
Amador,38,2022-09-05,44,44,44,0,748,749,748,1,3,0,0,2,90,90,90,90
Butte,38,2022-09-05,193,193,193,0,2125,2128,2127,1,14,2,2,2,460,460,458,458
Calaveras,38,2022-09-05,22,22,22,0,452,453,452,1,0,0,0,0,133,133,133,133
Colusa,38,2022-09-05,8,8,8,0,197,198,197,1,2,0,0,0,22,22,22,22
Contra Costa,38,2022-09-05,954,954,954,0,15437,15455,15452,3,62,5,5,9,1440,1440,1435,1435
Del Norte,38,2022-09-05,9,9,9,0,347,348,347,1,1,0,0,1,55,55,55,55
El Dorado,38,2022-09-05,91,91,91,0,1524,1525,1524,1,3,1,1,3,234,234,233,233
Fresno,38,2022-09-05,1087,1087,1087,0,13046,13063,13061,2,162,10,10,16,2865,2865,2855,2855
Glenn,38,2022-09-05,11,11,11,0,188,189,188,1,1,0,0,0,56,56,56,56
Humboldt,38,2022-09-05,110,110,110,0,1295,1296,1295,1,9,1,1,2,159,159,158,158
Imperial,38,2022-09-05,235,235,235,0,2522,2526,2525,1,8,1,1,2,961,961,960,960
Inyo,38,2022-09-05,12,12,12,0,139,140,139,1,0,0,0,1,59,59,59,59
Kern,38,2022-09-05,739,739,739,0,11391,11404,11402,2,50,5,5,8,2415,2415,2410,2410
Kings,38,2022-09-05,229,229,229,0,2869,2873,2872,1,8,0,0,0,461,461,461,461
Lake,38,2022-09-05,62,62,62,0,655,656,655,1,1,3,3,1,148,148,145,145
Lassen,38,2022-09-05,19,19,19,0,633,634,633,1,0,0,0,0,64,64,64,64
Los Angeles,38,2022-09-05,10706,10719,10719,0,224285,224558,224548,10,695,97,97,91,33389,33389,33292,33292
Madera,38,2022-09-05,206,206,206,0,2506,2510,2509,1,12,0,0,4,374,374,374,374
Marin,38,2022-09-05,191,191,191,0,3557,3562,3561,1,12,0,0,1,256,256,256,256
Mariposa,38,2022-09-05,16,16,16,0,166,167,166,1,0,0,0,0,29,29,29,29
Mendocino,38,2022-09-05,57,57,57,0,828,829,828,1,2,1,1,1,136,136,135,135
Merced,38,2022-09-05,251,251,251,0,2640,2645,2644,1,12,2,2,1,861,861,859,859
Modoc,38,2022-09-05,3,3,3,0,17,18,17,1,0,0,0,0,11,11,11,11
Mono,38,2022-09-05,4,4,4,0,52,53,52,1,1,0,0,0,7,7,7,7
Monterey,38,2022-09-05,245,245,245,0,4377,4382,4381,1,24,4,4,0,768,768,764,764
Napa,38,2022-09-05,102,102,102,0,1727,1728,1727,1,6,1,1,2,160,160,159,159
Nevada,38,2022-09-05,81,81,81,0,899,900,899,1,3,0,0,0,135,135,135,135
Orange,38,2022-09-05,2261,2264,2264,0,32861,32902,32898,4,169,13,13,34,7475,7475,7462,7462
Placer,38,2022-09-05,238,238,238,0,3479,3484,3483,1,36,0,0,4,658,658,658,658
Plumas,38,2022-09-05,9,9,9,0,130,131,130,1,0,0,0,0,13,13,13,13
Riverside,38,2022-09-05,2432,2435,2435,0,28763,28798,28794,4,99,7,7,14,6627,6627,6620,6620
Sacramento,38,2022-09-05,1273,1273,1273,0,19822,19847,19844,3,139,12,12,22,3308,3308,3296,3296
San Benito,38,2022-09-05,65,65,65,0,1090,1091,1090,1,0,0,0,2,102,102,102,102
San Bernardino,38,2022-09-05,2359,2362,2362,0,34558,34601,34597,4,122,14,14,19,8074,8074,8060,8060
San Diego,38,2022-09-05,2794,2798,2798,0,48508,48567,48565,2,212,15,15,25,5548,5548,5533,5533
San Francisco,38,2022-09-05,680,680,680,0,15741,15761,15756,5,52,9,9,9,1046,1046,1037,1037
San Joaquin,38,2022-09-05,831,831,831,0,11954,11969,11967,2,43,4,4,10,2327,2327,2323,2323
San Luis Obispo,38,2022-09-05,176,176,176,0,2677,2681,2680,1,7,2,2,1,525,525,523,523
San Mateo,38,2022-09-05,632,632,632,0,13669,13685,13684,1,23,1,1,2,742,742,741,741
Santa Barbara,38,2022-09-05,485,485,485,0,6633,6643,6642,1,39,4,4,3,726,726,722,722
Santa Clara,38,2022-09-05,1930,1930,1930,0,33401,33442,33440,2,127,11,11,20,2523,2523,2512,2512
Santa Cruz,38,2022-09-05,282,282,282,0,10222,10234,10233,1,16,0,0,0,273,273,273,273
Shasta,38,2022-09-05,104,104,104,0,2023,2026,2025,1,15,0,0,0,591,591,591,591
Siskiyou,38,2022-09-05,30,30,30,0,216,217,216,1,0,0,0,0,90,90,90,90
Solano,38,2022-09-05,368,368,368,0,5960,5967,5966,1,34,1,1,11,458,458,457,457
Sonoma,38,2022-09-05,367,367,367,0,6007,6014,6013,1,40,0,0,2,520,520,520,520
Stanislaus,38,2022-09-05,548,548,548,0,6351,6359,6358,1,69,5,5,4,1778,1778,1773,1773
Sutter,38,2022-09-05,118,118,118,0,1482,1484,1483,1,0,0,0,0,232,232,232,232
Tehama,38,2022-09-05,50,50,50,0,581,582,581,1,2,1,1,0,215,215,214,214
Trinity,38,2022-09-05,4,4,4,0,51,52,51,1,0,0,0,0,21,21,21,21
Tulare,38,2022-09-05,429,429,429,0,5179,5185,5184,1,37,2,2,1,1536,1536,1534,1534
Tuolumne,38,2022-09-05,68,68,68,0,737,738,737,1,1,0,0,0,199,199,199,199
Ventura,38,2022-09-05,864,864,864,0,12316,12330,12329,1,48,8,8,1,1587,1587,1579,1579
Yolo,38,2022-09-05,139,139,139,0,2908,2913,2912,1,1,3,3,2,392,392,389,389
Yuba,38,2022-09-05,88,88,88,0,977,978,977,1,14,1,1,1,131,131,130,130
Alameda,39,2022-09-12,1627,1627,1627,0,32247,32287,32284,3,94,4,4,16,1995,1995,1991,1991
Amador,39,2022-09-12,32,32,32,0,874,875,874,1,3,0,0,2,90,90,90,90
Butte,39,2022-09-12,196,196,196,0,2469,2474,2473,1,15,3,3,2,463,463,460,460
Calaveras,39,2022-09-12,14,14,14,0,501,502,501,1,1,0,0,0,133,133,133,133
Colusa,39,2022-09-12,17,17,17,0,414,415,414,1,0,0,0,0,22,22,22,22
Contra Costa,39,2022-09-12,979,979,979,0,17346,17368,17365,3,59,6,6,12,1446,1446,1440,1440
Del Norte,39,2022-09-12,34,34,34,0,595,596,595,1,1,0,0,1,55,55,55,55
El Dorado,39,2022-09-12,104,104,104,0,1904,1906,1905,1,3,0,0,1,234,234,234,234
Fresno,39,2022-09-12,906,906,906,0,14660,14678,14676,2,155,6,6,15,2871,2871,2865,2865
Glenn,39,2022-09-12,15,15,15,0,208,209,208,1,0,0,0,0,56,56,56,56
Humboldt,39,2022-09-12,113,113,113,0,1653,1654,1653,1,6,0,0,5,159,159,159,159
Imperial,39,2022-09-12,259,259,259,0,3288,3294,3293,1,10,0,0,2,961,961,961,961
Inyo,39,2022-09-12,15,15,15,0,194,195,194,1,0,1,1,0,60,60,59,59
Kern,39,2022-09-12,646,646,646,0,12995,13012,13011,1,45,7,7,13,2422,2422,2415,2415
Kings,39,2022-09-12,229,229,229,0,3172,3177,3176,1,6,1,1,0,462,462,461,461
Lake,39,2022-09-12,48,48,48,0,882,883,882,1,3,0,0,1,148,148,148,148
Lassen,39,2022-09-12,20,20,20,0,917,918,917,1,0,0,0,0,64,64,64,64
Los Angeles,39,2022-09-12,11029,11042,11042,0,284805,285164,285154,10,652,84,84,83,33473,33473,33389,33389
Madera,39,2022-09-12,242,242,242,0,2923,2929,2928,1,8,0,0,3,374,374,374,374
Marin,39,2022-09-12,174,174,174,0,3915,3920,3919,1,12,2,2,2,258,258,256,256
Mariposa,39,2022-09-12,16,16,16,0,192,193,192,1,0,0,0,0,29,29,29,29
Mendocino,39,2022-09-12,58,58,58,0,952,953,952,1,2,0,0,1,136,136,136,136
Merced,39,2022-09-12,237,237,237,0,3317,3323,3322,1,6,2,2,1,863,863,861,861
Modoc,39,2022-09-12,2,2,2,0,22,23,22,1,0,0,0,0,11,11,11,11
Mono,39,2022-09-12,7,7,7,0,77,78,77,1,0,0,0,0,7,7,7,7
Monterey,39,2022-09-12,227,227,227,0,5128,5134,5133,1,22,1,1,1,769,769,768,768
Napa,39,2022-09-12,120,120,120,0,2257,2261,2260,1,10,0,0,1,160,160,160,160
Nevada,39,2022-09-12,61,61,61,0,1179,1180,1179,1,2,1,1,0,136,136,135,135
Orange,39,2022-09-12,2172,2173,2173,0,37315,37362,37359,3,159,28,28,22,7503,7503,7475,7475
Placer,39,2022-09-12,240,240,240,0,4091,4097,4096,1,38,0,0,5,658,658,658,658
Plumas,39,2022-09-12,22,22,22,0,194,195,194,1,1,0,0,0,13,13,13,13
Riverside,39,2022-09-12,2264,2266,2266,0,33156,33198,33194,4,124,5,5,12,6632,6632,6627,6627
Sacramento,39,2022-09-12,1301,1301,1301,0,23561,23591,23588,3,119,15,15,15,3323,3323,3308,3308
San Benito,39,2022-09-12,96,96,96,0,1508,1509,1508,1,1,0,0,1,102,102,102,102
San Bernardino,39,2022-09-12,1952,1953,1953,0,38930,38979,38976,3,92,14,14,26,8088,8088,8074,8074
San Diego,39,2022-09-12,3023,3027,3027,0,56060,56132,56130,2,194,7,7,24,5555,5555,5548,5548
San Francisco,39,2022-09-12,815,815,815,0,17436,17458,17454,4,58,8,8,15,1054,1054,1046,1046
San Joaquin,39,2022-09-12,645,645,645,0,14282,14300,14298,2,35,6,6,9,2333,2333,2327,2327
San Luis Obispo,39,2022-09-12,187,187,187,0,3219,3224,3223,1,10,0,0,1,525,525,525,525
San Mateo,39,2022-09-12,671,671,671,0,14330,14348,14347,1,20,1,1,2,743,743,742,742
Santa Barbara,39,2022-09-12,329,329,329,0,7232,7242,7241,1,27,1,1,2,727,727,726,726
Santa Clara,39,2022-09-12,1923,1923,1923,0,38437,38487,38485,2,144,8,8,28,2531,2531,2523,2523
Santa Cruz,39,2022-09-12,272,272,272,0,13349,13366,13365,1,15,0,0,0,273,273,273,273
Shasta,39,2022-09-12,182,182,182,0,2592,2596,2595,1,26,1,1,2,592,592,591,591
Siskiyou,39,2022-09-12,27,27,27,0,289,290,289,1,1,0,0,0,90,90,90,90
Solano,39,2022-09-12,414,414,414,0,6739,6747,6746,1,32,0,0,4,458,458,458,458
Sonoma,39,2022-09-12,400,400,400,0,7022,7030,7029,1,39,3,3,1,523,523,520,520
Stanislaus,39,2022-09-12,447,447,447,0,7744,7754,7753,1,73,1,1,4,1779,1779,1778,1778
Sutter,39,2022-09-12,118,118,118,0,1530,1532,1531,1,0,0,0,0,232,232,232,232
Tehama,39,2022-09-12,47,47,47,0,699,700,699,1,2,0,0,0,215,215,215,215
Trinity,39,2022-09-12,2,2,2,0,74,75,74,1,0,0,0,0,21,21,21,21
Tulare,39,2022-09-12,368,368,368,0,6908,6915,6914,1,39,4,4,0,1540,1540,1536,1536
Tuolumne,39,2022-09-12,59,59,59,0,810,811,810,1,2,0,0,1,199,199,199,199
Ventura,39,2022-09-12,842,842,842,0,14810,14829,14828,1,49,1,1,7,1588,1588,1587,1587
Yolo,39,2022-09-12,143,143,143,0,3457,3462,3461,1,1,2,2,3,394,394,392,392
Yuba,39,2022-09-12,93,93,93,0,1164,1165,1164,1,6,1,1,0,132,132,131,131
Alameda,40,2022-09-19,1240,1240,1240,0,29339,29379,29377,2,80,2,2,7,1997,1997,1995,1995
Amador,40,2022-09-19,33,33,33,0,760,761,760,1,1,3,3,1,93,93,90,90
Butte,40,2022-09-19,121,121,121,0,2122,2126,2125,1,18,0,0,1,463,463,463,463
Calaveras,40,2022-09-19,28,28,28,0,477,478,477,1,0,0,0,0,133,133,133,133
Colusa,40,2022-09-19,13,13,13,0,289,290,289,1,3,0,0,0,22,22,22,22
Contra Costa,40,2022-09-19,826,826,826,0,16788,16811,16809,2,52,8,8,8,1454,1454,1446,1446
Del Norte,40,2022-09-19,22,22,22,0,479,480,479,1,2,0,0,0,55,55,55,55
El Dorado,40,2022-09-19,79,79,79,0,1617,1618,1617,1,3,0,0,0,234,234,234,234
Fresno,40,2022-09-19,604,604,604,0,13290,13307,13306,1,110,7,7,14,2878,2878,2871,2871
Glenn,40,2022-09-19,15,15,15,0,201,202,201,1,2,0,0,0,56,56,56,56
Humboldt,40,2022-09-19,105,105,105,0,1458,1459,1458,1,8,0,0,3,159,159,159,159
Imperial,40,2022-09-19,150,150,150,0,2868,2874,2873,1,11,0,0,2,961,961,961,961
Inyo,40,2022-09-19,8,8,8,0,169,170,169,1,0,0,0,0,60,60,60,60
Kern,40,2022-09-19,444,444,444,0,11650,11665,11664,1,34,2,2,6,2424,2424,2422,2422
Kings,40,2022-09-19,137,137,137,0,2642,2646,2645,1,7,2,2,0,464,464,462,462
Lake,40,2022-09-19,37,37,37,0,903,904,903,1,0,1,1,0,149,149,148,148
Lassen,40,2022-09-19,7,7,7,0,704,705,704,1,0,0,0,0,64,64,64,64
Los Angeles,40,2022-09-19,8554,8566,8566,0,256871,257205,257198,7,564,66,66,69,33539,33539,33473,33473
Madera,40,2022-09-19,109,109,109,0,2692,2696,2695,1,9,1,1,2,375,375,374,374
Marin,40,2022-09-19,137,137,137,0,3703,3709,3708,1,6,0,0,0,258,258,258,258
Mariposa,40,2022-09-19,12,12,12,0,170,171,170,1,0,1,1,0,30,30,29,29
Mendocino,40,2022-09-19,43,43,43,0,928,929,928,1,0,0,0,1,136,136,136,136
Merced,40,2022-09-19,170,170,170,0,2914,2920,2919,1,8,3,3,1,866,866,863,863
Modoc,40,2022-09-19,2,2,2,0,17,18,17,1,0,0,0,0,11,11,11,11
Mono,40,2022-09-19,4,4,4,0,63,64,63,1,0,0,0,0,7,7,7,7
Monterey,40,2022-09-19,162,162,162,0,4272,4277,4276,1,14,1,1,2,770,770,769,769
Napa,40,2022-09-19,103,103,103,0,1779,1781,1780,1,4,0,0,0,160,160,160,160
Nevada,40,2022-09-19,66,66,66,0,1111,1112,1111,1,2,1,1,0,137,137,136,136
Orange,40,2022-09-19,1805,1805,1805,0,34587,34632,34630,2,129,16,16,19,7519,7519,7503,7503
Placer,40,2022-09-19,223,223,223,0,3845,3851,3850,1,51,1,1,4,659,659,658,658
Plumas,40,2022-09-19,22,22,22,0,183,184,183,1,1,0,0,0,13,13,13,13
Riverside,40,2022-09-19,1429,1429,1429,0,29210,29248,29246,2,68,4,4,19,6636,6636,6632,6632
Sacramento,40,2022-09-19,1041,1041,1041,0,21424,21451,21449,2,102,8,8,17,3331,3331,3323,3323
San Benito,40,2022-09-19,54,54,54,0,1232,1233,1232,1,0,0,0,0,102,102,102,102
San Bernardino,40,2022-09-19,1492,1492,1492,0,32840,32883,32881,2,83,7,7,19,8095,8095,8088,8088
San Diego,40,2022-09-19,2548,2551,2551,0,56233,56307,56305,2,175,9,9,19,5564,5564,5555,5555
San Francisco,40,2022-09-19,694,694,694,0,16847,16870,16867,3,43,9,9,11,1063,1063,1054,1054
San Joaquin,40,2022-09-19,460,460,460,0,12860,12876,12875,1,35,5,5,2,2338,2338,2333,2333
San Luis Obispo,40,2022-09-19,155,155,155,0,2766,2772,2771,1,8,0,0,0,525,525,525,525
San Mateo,40,2022-09-19,607,607,607,0,13735,13753,13752,1,20,0,0,2,743,743,743,743
Santa Barbara,40,2022-09-19,269,269,269,0,6792,6801,6800,1,34,2,2,0,729,729,727,727
Santa Clara,40,2022-09-19,1450,1450,1450,0,37368,37417,37416,1,137,7,7,21,2538,2538,2531,2531
Santa Cruz,40,2022-09-19,148,148,148,0,12323,12339,12338,1,5,0,0,1,273,273,273,273
Shasta,40,2022-09-19,102,102,102,0,2113,2117,2116,1,21,0,0,3,592,592,592,592
Siskiyou,40,2022-09-19,21,21,21,0,233,234,233,1,2,1,1,0,91,91,90,90
Solano,40,2022-09-19,274,274,274,0,6125,6132,6131,1,24,1,1,5,459,459,458,458
Sonoma,40,2022-09-19,317,317,317,0,6360,6369,6368,1,27,3,3,1,526,526,523,523
Stanislaus,40,2022-09-19,333,333,333,0,6290,6299,6298,1,57,4,4,4,1783,1783,1779,1779
Sutter,40,2022-09-19,73,73,73,0,1388,1390,1389,1,0,0,0,0,232,232,232,232
Tehama,40,2022-09-19,36,36,36,0,599,600,599,1,2,1,1,0,216,216,215,215
Trinity,40,2022-09-19,3,3,3,0,53,54,53,1,0,0,0,0,21,21,21,21
Tulare,40,2022-09-19,234,234,234,0,5732,5740,5739,1,32,1,1,0,1541,1541,1540,1540
Tuolumne,40,2022-09-19,57,57,57,0,717,718,717,1,0,0,0,0,199,199,199,199
Ventura,40,2022-09-19,616,616,616,0,13386,13403,13402,1,42,2,2,6,1590,1590,1588,1588
Yolo,40,2022-09-19,83,83,83,0,3743,3750,3749,1,2,3,3,2,397,397,394,394
Yuba,40,2022-09-19,60,60,60,0,1029,1030,1029,1,3,0,0,0,132,132,132,132
Alameda,41,2022-09-26,1151,1151,1151,0,27840,27878,27877,1,77,1,1,4,1998,1998,1997,1997
Amador,41,2022-09-26,27,27,27,0,721,722,721,1,1,0,0,1,93,93,93,93
Butte,41,2022-09-26,90,90,90,0,1798,1801,1800,1,23,0,0,1,463,463,463,463
Calaveras,41,2022-09-26,20,20,20,0,390,391,390,1,2,1,1,0,134,134,133,133
Colusa,41,2022-09-26,7,7,7,0,299,300,299,1,1,0,0,0,22,22,22,22
Contra Costa,41,2022-09-26,778,778,778,0,16351,16373,16372,1,48,5,5,7,1459,1459,1454,1454
Del Norte,41,2022-09-26,22,22,22,0,469,470,469,1,2,0,0,0,55,55,55,55
El Dorado,41,2022-09-26,86,86,86,0,1580,1581,1580,1,5,0,0,0,234,234,234,234
Fresno,41,2022-09-26,517,517,517,0,12130,12145,12144,1,84,3,3,13,2881,2881,2878,2878
Glenn,41,2022-09-26,7,7,7,0,176,177,176,1,2,0,0,0,56,56,56,56
Humboldt,41,2022-09-26,97,97,97,0,1312,1313,1312,1,10,2,2,0,161,161,159,159
Imperial,41,2022-09-26,115,115,115,0,2630,2635,2634,1,4,1,1,1,962,962,961,961
Inyo,41,2022-09-26,5,5,5,0,165,166,165,1,0,0,0,0,60,60,60,60
Kern,41,2022-09-26,357,357,357,0,10880,10894,10893,1,32,3,3,7,2427,2427,2424,2424
Kings,41,2022-09-26,107,107,107,0,2621,2625,2624,1,2,0,0,0,464,464,464,464
Lake,41,2022-09-26,26,26,26,0,815,816,815,1,0,0,0,0,149,149,149,149
Lassen,41,2022-09-26,13,13,13,0,533,534,533,1,0,0,0,0,64,64,64,64
Los Angeles,41,2022-09-26,7722,7733,7733,0,241363,241686,241681,5,443,63,63,53,33602,33602,33539,33539
Madera,41,2022-09-26,84,84,84,0,2231,2235,2234,1,8,0,0,2,375,375,375,375
Marin,41,2022-09-26,173,173,173,0,3659,3665,3664,1,10,0,0,0,258,258,258,258
Mariposa,41,2022-09-26,4,4,4,0,155,156,155,1,0,0,0,0,30,30,30,30
Mendocino,41,2022-09-26,41,41,41,0,852,853,852,1,1,0,0,0,136,136,136,136
Merced,41,2022-09-26,127,127,127,0,2855,2861,2860,1,10,1,1,0,867,867,866,866
Modoc,41,2022-09-26,0,0,0,0,13,14,13,1,0,0,0,0,11,11,11,11
Mono,41,2022-09-26,1,1,1,0,60,61,60,1,0,0,0,0,7,7,7,7
Monterey,41,2022-09-26,135,135,135,0,4055,4060,4059,1,14,0,0,2,770,770,770,770
Napa,41,2022-09-26,87,87,87,0,1966,1968,1967,1,5,1,1,1,161,161,160,160
Nevada,41,2022-09-26,49,49,49,0,1077,1078,1077,1,1,0,0,0,137,137,137,137
Orange,41,2022-09-26,1740,1740,1740,0,31563,31605,31603,2,117,19,19,23,7538,7538,7519,7519
Placer,41,2022-09-26,209,209,209,0,3611,3618,3617,1,42,1,1,4,660,660,659,659
Plumas,41,2022-09-26,21,21,21,0,151,152,151,1,1,0,0,0,13,13,13,13
Riverside,41,2022-09-26,1289,1289,1289,0,25897,25932,25930,2,55,8,8,15,6644,6644,6636,6636
Sacramento,41,2022-09-26,931,931,931,0,19275,19301,19300,1,106,11,11,20,3342,3342,3331,3331
San Benito,41,2022-09-26,50,50,50,0,1160,1161,1160,1,0,1,1,2,103,103,102,102
San Bernardino,41,2022-09-26,1241,1241,1241,0,28102,28138,28136,2,75,6,6,12,8101,8101,8095,8095
San Diego,41,2022-09-26,2475,2479,2479,0,51221,51288,51287,1,201,7,7,15,5571,5571,5564,5564
San Francisco,41,2022-09-26,677,677,677,0,16224,16246,16244,2,45,2,2,9,1065,1065,1063,1063
San Joaquin,41,2022-09-26,409,409,409,0,11086,11101,11100,1,35,1,1,3,2339,2339,2338,2338
San Luis Obispo,41,2022-09-26,131,131,131,0,2521,2526,2525,1,7,1,1,0,526,526,525,525
San Mateo,41,2022-09-26,617,617,617,0,13188,13205,13204,1,25,0,0,1,743,743,743,743
Santa Barbara,41,2022-09-26,259,259,259,0,6381,6392,6391,1,22,2,2,0,731,731,729,729
Santa Clara,41,2022-09-26,1401,1401,1401,0,36178,36226,36225,1,113,10,10,17,2548,2548,2538,2538
Santa Cruz,41,2022-09-26,225,225,225,0,12508,12524,12523,1,13,0,0,0,273,273,273,273
Shasta,41,2022-09-26,75,75,75,0,1740,1743,1742,1,14,1,1,3,593,593,592,592
Siskiyou,41,2022-09-26,18,18,18,0,183,184,183,1,1,2,2,0,93,93,91,91
Solano,41,2022-09-26,310,310,310,0,5725,5733,5732,1,23,1,1,2,460,460,459,459
Sonoma,41,2022-09-26,292,292,292,0,6334,6343,6342,1,31,1,1,2,527,527,526,526
Stanislaus,41,2022-09-26,261,261,261,0,5814,5822,5821,1,46,2,2,3,1785,1785,1783,1783
Sutter,41,2022-09-26,67,67,67,0,1146,1147,1146,1,0,0,0,0,232,232,232,232
Tehama,41,2022-09-26,35,35,35,0,550,551,550,1,1,2,2,0,218,218,216,216
Trinity,41,2022-09-26,3,3,3,0,44,45,44,1,0,0,0,0,21,21,21,21
Tulare,41,2022-09-26,168,168,168,0,5096,5102,5101,1,18,3,3,2,1544,1544,1541,1541
Tuolumne,41,2022-09-26,43,43,43,0,689,690,689,1,1,0,0,0,199,199,199,199
Ventura,41,2022-09-26,557,557,557,0,11602,11618,11617,1,33,4,4,1,1594,1594,1590,1590
Yolo,41,2022-09-26,130,130,130,0,3986,3992,3991,1,2,3,3,3,400,400,397,397
Yuba,41,2022-09-26,41,41,41,0,933,934,933,1,6,0,0,1,132,132,132,132
Alameda,42,2022-10-03,1141,1141,1141,0,26322,26358,26357,1,54,3,3,5,2001,2001,1998,1998
Amador,42,2022-10-03,14,14,14,0,691,692,691,1,0,0,0,1,93,93,93,93
Butte,42,2022-10-03,67,67,67,0,1754,1756,1755,1,11,2,2,2,465,465,463,463
Calaveras,42,2022-10-03,19,19,19,0,337,338,337,1,1,0,0,0,134,134,134,134
Colusa,42,2022-10-03,7,7,7,0,188,189,188,1,0,0,0,0,22,22,22,22
Contra Costa,42,2022-10-03,739,739,739,0,15787,15810,15809,1,34,3,3,6,1462,1462,1459,1459
Del Norte,42,2022-10-03,12,12,12,0,382,383,382,1,1,0,0,1,55,55,55,55
El Dorado,42,2022-10-03,80,80,80,0,1450,1451,1450,1,3,0,0,1,234,234,234,234
Fresno,42,2022-10-03,462,462,462,0,11229,11244,11243,1,77,2,2,11,2883,2883,2881,2881
Glenn,42,2022-10-03,7,7,7,0,155,156,155,1,0,0,0,0,56,56,56,56
Humboldt,42,2022-10-03,78,78,78,0,1159,1160,1159,1,6,0,0,1,161,161,161,161
Imperial,42,2022-10-03,141,141,141,0,2565,2570,2569,1,6,0,0,0,962,962,962,962
Inyo,42,2022-10-03,5,5,5,0,159,160,159,1,0,0,0,1,60,60,60,60
Kern,42,2022-10-03,295,295,295,0,10110,10125,10124,1,24,4,4,5,2431,2431,2427,2427
Kings,42,2022-10-03,87,87,87,0,2416,2421,2420,1,2,0,0,0,464,464,464,464
Lake,42,2022-10-03,35,35,35,0,759,760,759,1,3,1,1,0,150,150,149,149
Lassen,42,2022-10-03,7,7,7,0,530,531,530,1,2,0,0,0,64,64,64,64
Los Angeles,42,2022-10-03,7019,7030,7030,0,221743,222050,222046,4,439,49,49,69,33651,33651,33602,33602
Madera,42,2022-10-03,66,66,66,0,1566,1567,1566,1,6,0,0,2,375,375,375,375
Marin,42,2022-10-03,190,190,190,0,3475,3481,3480,1,6,0,0,2,258,258,258,258
Mariposa,42,2022-10-03,5,5,5,0,131,132,131,1,0,0,0,0,30,30,30,30
Mendocino,42,2022-10-03,50,50,50,0,778,779,778,1,4,0,0,0,136,136,136,136
Merced,42,2022-10-03,109,109,109,0,2610,2616,2615,1,5,3,3,1,870,870,867,867
Modoc,42,2022-10-03,2,2,2,0,14,15,14,1,0,0,0,0,11,11,11,11
Mono,42,2022-10-03,4,4,4,0,69,70,69,1,0,0,0,0,7,7,7,7
Monterey,42,2022-10-03,111,111,111,0,3795,3801,3800,1,11,1,1,1,771,771,770,770
Napa,42,2022-10-03,89,89,89,0,1701,1703,1702,1,4,0,0,2,161,161,161,161
Nevada,42,2022-10-03,51,51,51,0,954,955,954,1,1,0,0,4,137,137,137,137
Orange,42,2022-10-03,1579,1579,1579,0,28375,28415,28414,1,131,22,22,16,7560,7560,7538,7538
Placer,42,2022-10-03,208,208,208,0,3350,3356,3355,1,41,2,2,3,662,662,660,660
Plumas,42,2022-10-03,12,12,12,0,107,108,107,1,1,0,0,0,13,13,13,13
Riverside,42,2022-10-03,1147,1147,1147,0,22161,22191,22190,1,59,7,7,12,6651,6651,6644,6644
Sacramento,42,2022-10-03,924,924,924,0,18205,18231,18230,1,88,12,12,19,3354,3354,3342,3342
San Benito,42,2022-10-03,34,34,34,0,1105,1106,1105,1,0,0,0,0,103,103,103,103
San Bernardino,42,2022-10-03,1237,1237,1237,0,25066,25100,25099,1,77,4,4,7,8105,8105,8101,8101
San Diego,42,2022-10-03,2083,2086,2086,0,46927,46993,46992,1,162,9,9,18,5580,5580,5571,5571
San Francisco,42,2022-10-03,656,656,656,0,15385,15406,15404,2,44,3,3,9,1068,1068,1065,1065
San Joaquin,42,2022-10-03,342,342,342,0,9930,9943,9942,1,25,4,4,3,2343,2343,2339,2339
San Luis Obispo,42,2022-10-03,150,150,150,0,2383,2388,2387,1,2,1,1,1,527,527,526,526
San Mateo,42,2022-10-03,560,560,560,0,12421,12439,12438,1,22,0,0,2,743,743,743,743
Santa Barbara,42,2022-10-03,254,254,254,0,6290,6301,6300,1,15,0,0,2,731,731,731,731
Santa Clara,42,2022-10-03,1436,1436,1436,0,32450,32495,32494,1,109,6,6,20,2554,2554,2548,2548
Santa Cruz,42,2022-10-03,227,227,227,0,11231,11247,11246,1,10,0,0,1,273,273,273,273
Shasta,42,2022-10-03,56,56,56,0,1444,1445,1444,1,10,0,0,2,593,593,593,593
Siskiyou,42,2022-10-03,10,10,10,0,204,205,204,1,0,0,0,0,93,93,93,93
Solano,42,2022-10-03,251,251,251,0,5361,5369,5368,1,17,0,0,2,460,460,460,460
Sonoma,42,2022-10-03,322,322,322,0,5934,5943,5942,1,17,0,0,3,527,527,527,527
Stanislaus,42,2022-10-03,200,200,200,0,5355,5363,5362,1,49,1,1,6,1786,1786,1785,1785
Sutter,42,2022-10-03,56,56,56,0,1109,1110,1109,1,0,2,2,0,234,234,232,232
Tehama,42,2022-10-03,20,20,20,0,526,527,526,1,1,0,0,0,218,218,218,218
Trinity,42,2022-10-03,1,1,1,0,43,44,43,1,0,0,0,0,21,21,21,21
Tulare,42,2022-10-03,163,163,163,0,5054,5061,5060,1,19,4,4,1,1548,1548,1544,1544
Tuolumne,42,2022-10-03,26,26,26,0,622,623,622,1,0,1,1,0,200,200,199,199
Ventura,42,2022-10-03,479,479,479,0,10443,10457,10456,1,41,2,2,2,1596,1596,1594,1594
Yolo,42,2022-10-03,123,123,123,0,2988,2993,2992,1,3,2,2,2,402,402,400,400
Yuba,42,2022-10-03,35,35,35,0,802,803,802,1,4,0,0,1,132,132,132,132
Alameda,43,2022-10-10,1158,1158,1158,0,28033,28072,28071,1,45,2,2,7,2003,2003,2001,2001
Amador,43,2022-10-10,15,15,15,0,801,802,801,1,0,0,0,2,93,93,93,93
Butte,43,2022-10-10,65,65,65,0,1754,1756,1755,1,12,3,3,1,467,467,464,464
Calaveras,43,2022-10-10,15,15,15,0,374,375,374,1,0,1,1,0,135,135,134,134
Colusa,43,2022-10-10,1,1,1,0,120,121,120,1,1,0,0,0,22,22,22,22
Contra Costa,43,2022-10-10,774,774,774,0,16879,16906,16905,1,31,9,9,6,1469,1469,1460,1460
Del Norte,43,2022-10-10,10,10,10,0,492,493,492,1,1,0,0,1,55,55,55,55
El Dorado,43,2022-10-10,81,81,81,0,1751,1752,1751,1,7,0,0,4,234,234,234,234
Fresno,43,2022-10-10,482,482,482,0,12484,12503,12502,1,60,3,3,9,2886,2886,2883,2883
Glenn,43,2022-10-10,10,10,10,0,226,227,226,1,1,0,0,0,56,56,56,56
Humboldt,43,2022-10-10,98,98,98,0,1420,1421,1420,1,7,1,1,0,162,162,161,161
Imperial,43,2022-10-10,203,203,203,0,2962,2969,2968,1,7,0,0,0,962,962,962,962
Inyo,43,2022-10-10,4,4,4,0,124,125,124,1,0,0,0,0,60,60,60,60
Kern,43,2022-10-10,338,338,338,0,11848,11867,11866,1,24,2,2,2,2433,2433,2431,2431
Kings,43,2022-10-10,100,100,100,0,2751,2757,2756,1,1,1,1,0,465,465,464,464
Lake,43,2022-10-10,33,33,33,0,920,921,920,1,1,0,0,0,150,150,150,150
Lassen,43,2022-10-10,3,3,3,0,573,574,573,1,0,0,0,0,64,64,64,64
Los Angeles,43,2022-10-10,6755,6763,6763,0,228401,228735,228732,3,436,71,71,51,33714,33714,33643,33643
Madera,43,2022-10-10,68,68,68,0,1718,1719,1718,1,7,1,1,2,376,376,375,375
Marin,43,2022-10-10,207,207,207,0,3779,3786,3785,1,9,0,0,0,258,258,258,258
Mariposa,43,2022-10-10,9,9,9,0,128,129,128,1,0,0,0,0,30,30,30,30
Mendocino,43,2022-10-10,32,32,32,0,975,976,975,1,1,0,0,2,136,136,136,136
Merced,43,2022-10-10,111,111,111,0,2790,2796,2795,1,8,1,1,3,871,871,870,870
Modoc,43,2022-10-10,5,5,5,0,12,13,12,1,0,0,0,0,11,11,11,11
Mono,43,2022-10-10,1,1,1,0,55,56,55,1,0,0,0,0,7,7,7,7
Monterey,43,2022-10-10,108,108,108,0,4374,4381,4380,1,9,0,0,1,771,771,771,771
Napa,43,2022-10-10,78,78,78,0,1766,1767,1766,1,3,0,0,2,161,161,161,161
Nevada,43,2022-10-10,42,42,42,0,981,982,981,1,1,0,0,1,137,137,137,137
Orange,43,2022-10-10,1524,1524,1524,0,30120,30164,30163,1,129,14,14,19,7572,7572,7558,7558
Placer,43,2022-10-10,187,187,187,0,3823,3831,3830,1,24,0,0,7,662,662,662,662
Plumas,43,2022-10-10,20,20,20,0,106,107,106,1,0,0,0,0,13,13,13,13
Riverside,43,2022-10-10,1195,1195,1195,0,24022,24056,24055,1,56,5,5,4,6656,6656,6651,6651
Sacramento,43,2022-10-10,959,959,959,0,20477,20508,20507,1,81,5,5,16,3359,3359,3354,3354
San Benito,43,2022-10-10,35,35,35,0,1269,1270,1269,1,3,0,0,0,103,103,103,103
San Bernardino,43,2022-10-10,1111,1111,1111,0,27422,27461,27460,1,66,0,0,13,8105,8105,8105,8105
San Diego,43,2022-10-10,1983,1983,1983,0,51618,51693,51692,1,130,7,7,21,5585,5585,5578,5578
San Francisco,43,2022-10-10,691,691,691,0,16131,16154,16153,1,37,2,2,9,1070,1070,1068,1068
San Joaquin,43,2022-10-10,432,432,432,0,11586,11602,11601,1,17,2,2,8,2345,2345,2343,2343
San Luis Obispo,43,2022-10-10,88,88,88,0,2569,2574,2573,1,2,2,2,0,529,529,527,527
San Mateo,43,2022-10-10,668,668,668,0,13748,13768,13767,1,19,0,0,0,743,743,743,743
Santa Barbara,43,2022-10-10,242,242,242,0,7845,7859,7858,1,20,1,1,1,732,732,731,731
Santa Clara,43,2022-10-10,1456,1456,1456,0,34357,34408,34407,1,107,5,5,18,2559,2559,2554,2554
Santa Cruz,43,2022-10-10,338,338,338,0,12284,12302,12301,1,9,0,0,1,273,273,273,273
Shasta,43,2022-10-10,99,99,99,0,1294,1295,1294,1,13,3,3,1,596,596,593,593
Siskiyou,43,2022-10-10,9,9,9,0,244,245,244,1,0,1,1,0,94,94,93,93
Solano,43,2022-10-10,333,333,333,0,6279,6289,6288,1,23,0,0,4,460,460,460,460
Sonoma,43,2022-10-10,287,287,287,0,6773,6783,6782,1,15,1,1,3,528,528,527,527
Stanislaus,43,2022-10-10,208,208,208,0,5928,5936,5935,1,51,7,7,7,1791,1791,1784,1784
Sutter,43,2022-10-10,58,58,58,0,1127,1128,1127,1,0,1,1,0,235,235,234,234
Tehama,43,2022-10-10,21,21,21,0,567,568,567,1,1,0,0,0,218,218,218,218
Trinity,43,2022-10-10,1,1,1,0,53,54,53,1,0,0,0,0,21,21,21,21
Tulare,43,2022-10-10,165,165,165,0,4981,4988,4987,1,16,1,1,1,1549,1549,1548,1548
Tuolumne,43,2022-10-10,36,36,36,0,660,661,660,1,1,1,1,0,201,201,200,200
Ventura,43,2022-10-10,438,438,438,0,10998,11013,11012,1,41,4,4,1,1599,1599,1595,1595
Yolo,43,2022-10-10,126,126,126,0,3099,3105,3104,1,4,2,2,0,404,404,402,402
Yuba,43,2022-10-10,23,23,23,0,924,925,924,1,0,0,0,0,132,132,132,132
Alameda,44,2022-10-17,940,940,940,0,24697,24734,24733,1,60,3,3,8,2006,2006,2003,2003
Amador,44,2022-10-17,15,15,15,0,592,593,592,1,1,0,0,0,93,93,93,93
Butte,44,2022-10-17,76,76,76,0,1426,1427,1426,1,13,0,0,0,467,467,467,467
Calaveras,44,2022-10-17,19,19,19,0,306,307,306,1,0,0,0,0,135,135,135,135
Colusa,44,2022-10-17,4,4,4,0,80,81,80,1,0,0,0,0,22,22,22,22
Contra Costa,44,2022-10-17,675,675,675,0,14554,14578,14577,1,30,4,4,6,1473,1473,1469,1469
Del Norte,44,2022-10-17,11,11,11,0,381,382,381,1,1,0,0,0,55,55,55,55
El Dorado,44,2022-10-17,89,89,89,0,1381,1382,1381,1,2,0,0,1,234,234,234,234
Fresno,44,2022-10-17,350,350,350,0,10210,10225,10224,1,62,2,2,11,2888,2888,2886,2886
Glenn,44,2022-10-17,6,6,6,0,141,142,141,1,1,0,0,0,56,56,56,56
Humboldt,44,2022-10-17,70,70,70,0,1147,1148,1147,1,1,0,0,0,162,162,162,162
Imperial,44,2022-10-17,117,117,117,0,2322,2327,2326,1,5,0,0,0,962,962,962,962
Inyo,44,2022-10-17,6,6,6,0,123,124,123,1,1,0,0,0,60,60,60,60
Kern,44,2022-10-17,238,238,238,0,9714,9729,9728,1,32,0,0,1,2433,2433,2433,2433
Kings,44,2022-10-17,70,70,70,0,2320,2324,2323,1,2,1,1,0,466,466,465,465
Lake,44,2022-10-17,25,25,25,0,774,775,774,1,1,0,0,0,150,150,150,150
Lassen,44,2022-10-17,7,7,7,0,513,514,513,1,1,0,0,0,64,64,64,64
Los Angeles,44,2022-10-17,5088,5095,5095,0,189702,189990,189988,2,350,42,42,53,33756,33756,33714,33714
Madera,44,2022-10-17,59,59,59,0,1467,1468,1467,1,3,0,0,2,376,376,376,376
Marin,44,2022-10-17,132,132,132,0,3096,3102,3101,1,8,0,0,1,258,258,258,258
Mariposa,44,2022-10-17,6,6,6,0,119,120,119,1,0,0,0,0,30,30,30,30
Mendocino,44,2022-10-17,48,48,48,0,743,744,743,1,2,0,0,0,136,136,136,136
Merced,44,2022-10-17,129,129,129,0,2344,2350,2349,1,15,0,0,2,871,871,871,871
Modoc,44,2022-10-17,1,1,1,0,7,8,7,1,0,0,0,0,11,11,11,11
Mono,44,2022-10-17,6,6,6,0,42,43,42,1,1,0,0,0,7,7,7,7
Monterey,44,2022-10-17,123,123,123,0,3552,3558,3557,1,12,1,1,1,772,772,771,771
Napa,44,2022-10-17,60,60,60,0,1416,1418,1417,1,2,0,0,1,161,161,161,161
Nevada,44,2022-10-17,49,49,49,0,780,781,780,1,0,0,0,5,137,137,137,137
Orange,44,2022-10-17,1136,1136,1136,0,25139,25177,25176,1,91,21,21,18,7593,7593,7572,7572
Placer,44,2022-10-17,149,149,149,0,2932,2939,2938,1,32,0,0,3,662,662,662,662
Plumas,44,2022-10-17,11,11,11,0,98,99,98,1,0,0,0,0,13,13,13,13
Riverside,44,2022-10-17,898,898,898,0,20799,20831,20830,1,66,2,2,2,6658,6658,6656,6656
Sacramento,44,2022-10-17,871,871,871,0,16205,16230,16229,1,84,11,11,14,3370,3370,3359,3359
San Benito,44,2022-10-17,28,28,28,0,882,883,882,1,0,1,1,0,104,104,103,103
San Bernardino,44,2022-10-17,836,836,836,0,23470,23506,23505,1,63,1,1,9,8106,8106,8105,8105
San Diego,44,2022-10-17,1648,1648,1648,0,43738,43803,43802,1,117,8,8,24,5593,5593,5585,5585
San Francisco,44,2022-10-17,568,568,568,0,14501,14522,14521,1,34,3,3,13,1073,1073,1070,1070
San Joaquin,44,2022-10-17,352,352,352,0,9075,9089,9088,1,8,2,2,8,2347,2347,2345,2345
San Luis Obispo,44,2022-10-17,109,109,109,0,2131,2135,2134,1,4,1,1,0,530,530,529,529
San Mateo,44,2022-10-17,551,551,551,0,11333,11352,11351,1,21,0,0,1,743,743,743,743
Santa Barbara,44,2022-10-17,182,182,182,0,5626,5637,5636,1,18,0,0,2,732,732,732,732
Santa Clara,44,2022-10-17,1170,1170,1170,0,28717,28761,28760,1,93,5,5,16,2564,2564,2559,2559
Santa Cruz,44,2022-10-17,284,284,284,0,10291,10307,10306,1,7,1,1,0,274,274,273,273
Shasta,44,2022-10-17,82,82,82,0,1105,1106,1105,1,12,0,0,2,596,596,596,596
Siskiyou,44,2022-10-17,12,12,12,0,181,182,181,1,2,1,1,0,95,95,94,94
Solano,44,2022-10-17,266,266,266,0,4852,4860,4859,1,25,1,1,3,461,461,460,460
Sonoma,44,2022-10-17,246,246,246,0,5371,5380,5379,1,20,1,1,1,529,529,528,528
Stanislaus,44,2022-10-17,222,222,222,0,5295,5305,5304,1,45,1,1,5,1792,1792,1791,1791
Sutter,44,2022-10-17,40,40,40,0,910,911,910,1,0,0,0,0,235,235,235,235
Tehama,44,2022-10-17,21,21,21,0,397,398,397,1,0,0,0,0,218,218,218,218
Trinity,44,2022-10-17,0,0,0,0,34,35,34,1,0,0,0,0,21,21,21,21
Tulare,44,2022-10-17,137,137,137,0,4271,4278,4277,1,11,1,1,1,1550,1550,1549,1549
Tuolumne,44,2022-10-17,33,33,33,0,620,621,620,1,2,0,0,0,201,201,201,201
Ventura,44,2022-10-17,376,376,376,0,9350,9365,9364,1,32,3,3,1,1602,1602,1599,1599
Yolo,44,2022-10-17,102,102,102,0,2211,2216,2215,1,3,2,2,3,406,406,404,404
Yuba,44,2022-10-17,44,44,44,0,767,768,767,1,1,0,0,0,132,132,132,132
Alameda,45,2022-10-24,956,956,956,0,23427,23462,23461,1,46,5,5,10,2011,2011,2006,2006
Amador,45,2022-10-24,18,18,18,0,635,636,635,1,2,0,0,0,93,93,93,93
Butte,45,2022-10-24,68,68,68,0,1405,1407,1406,1,10,1,1,1,468,468,467,467
Calaveras,45,2022-10-24,20,20,20,0,322,323,322,1,0,0,0,0,135,135,135,135
Colusa,45,2022-10-24,3,3,3,0,95,96,95,1,0,0,0,0,22,22,22,22
Contra Costa,45,2022-10-24,624,624,624,0,13922,13945,13944,1,37,5,5,5,1478,1478,1473,1473
Del Norte,45,2022-10-24,6,6,6,0,361,362,361,1,0,0,0,1,55,55,55,55
El Dorado,45,2022-10-24,91,91,91,0,1520,1521,1520,1,1,0,0,0,234,234,234,234
Fresno,45,2022-10-24,380,380,380,0,9763,9779,9778,1,63,0,0,6,2888,2888,2888,2888
Glenn,45,2022-10-24,9,9,9,0,148,149,148,1,0,0,0,0,56,56,56,56
Humboldt,45,2022-10-24,69,69,69,0,1150,1151,1150,1,7,0,0,2,162,162,162,162
Imperial,45,2022-10-24,96,96,96,0,2344,2349,2348,1,8,1,1,0,963,963,962,962
Inyo,45,2022-10-24,8,8,8,0,273,274,273,1,0,0,0,0,60,60,60,60
Kern,45,2022-10-24,279,279,279,0,9715,9730,9729,1,24,2,2,2,2435,2435,2433,2433
Kings,45,2022-10-24,87,87,87,0,2341,2345,2344,1,8,0,0,0,466,466,466,466
Lake,45,2022-10-24,22,22,22,0,643,644,643,1,1,1,1,1,151,151,150,150
Lassen,45,2022-10-24,16,16,16,0,484,485,484,1,1,0,0,0,64,64,64,64
Los Angeles,45,2022-10-24,5335,5343,5343,0,187331,187623,187621,2,332,54,54,43,33810,33810,33756,33756
Madera,45,2022-10-24,61,61,61,0,1388,1389,1388,1,4,0,0,2,376,376,376,376
Marin,45,2022-10-24,138,138,138,0,3081,3087,3086,1,12,1,1,2,259,259,258,258
Mariposa,45,2022-10-24,12,12,12,0,121,122,121,1,0,0,0,0,30,30,30,30
Mendocino,45,2022-10-24,42,42,42,0,771,772,771,1,2,0,0,0,136,136,136,136
Merced,45,2022-10-24,88,88,88,0,2410,2416,2415,1,7,3,3,3,874,874,871,871
Modoc,45,2022-10-24,1,1,1,0,13,14,13,1,0,0,0,0,11,11,11,11
Mono,45,2022-10-24,3,3,3,0,64,65,64,1,0,1,1,0,8,8,7,7
Monterey,45,2022-10-24,130,130,130,0,3720,3726,3725,1,18,0,0,0,772,772,772,772
Napa,45,2022-10-24,51,51,51,0,1467,1469,1468,1,3,0,0,0,161,161,161,161
Nevada,45,2022-10-24,38,38,38,0,784,785,784,1,6,0,0,0,137,137,137,137
Orange,45,2022-10-24,1160,1160,1160,0,26001,26042,26041,1,84,12,12,14,7605,7605,7593,7593
Placer,45,2022-10-24,192,192,192,0,3034,3041,3040,1,39,0,0,6,662,662,662,662
Plumas,45,2022-10-24,12,12,12,0,91,92,91,1,0,0,0,0,13,13,13,13
Riverside,45,2022-10-24,932,932,932,0,20178,20209,20208,1,53,0,0,6,6658,6658,6658,6658
Sacramento,45,2022-10-24,816,816,816,0,15315,15339,15338,1,84,5,5,19,3375,3375,3370,3370
San Benito,45,2022-10-24,41,41,41,0,845,846,845,1,0,0,0,1,104,104,104,104
San Bernardino,45,2022-10-24,806,806,806,0,21613,21647,21646,1,39,3,3,10,8109,8109,8106,8106
San Diego,45,2022-10-24,1680,1681,1681,0,42144,42210,42209,1,83,5,5,18,5598,5598,5593,5593
San Francisco,45,2022-10-24,511,511,511,0,13947,13969,13968,1,35,1,1,5,1074,1074,1073,1073
San Joaquin,45,2022-10-24,273,273,273,0,8498,8512,8511,1,13,2,2,3,2349,2349,2347,2347
San Luis Obispo,45,2022-10-24,89,89,89,0,2055,2059,2058,1,2,0,0,0,530,530,530,530
San Mateo,45,2022-10-24,472,472,472,0,11148,11167,11166,1,19,0,0,2,743,743,743,743
Santa Barbara,45,2022-10-24,164,164,164,0,5730,5741,5740,1,19,2,2,4,734,734,732,732
Santa Clara,45,2022-10-24,1209,1209,1209,0,29387,29435,29434,1,92,3,3,9,2567,2567,2564,2564
Santa Cruz,45,2022-10-24,240,240,240,0,10204,10221,10220,1,14,1,1,0,275,275,274,274
Shasta,45,2022-10-24,76,76,76,0,984,985,984,1,5,0,0,2,596,596,596,596
Siskiyou,45,2022-10-24,12,12,12,0,171,172,171,1,0,0,0,0,95,95,95,95
Solano,45,2022-10-24,239,239,239,0,5029,5037,5036,1,20,0,0,1,461,461,461,461
Sonoma,45,2022-10-24,242,242,242,0,5438,5446,5445,1,23,0,0,1,529,529,529,529
Stanislaus,45,2022-10-24,199,199,199,0,4852,4861,4860,1,40,3,3,3,1795,1795,1792,1792
Sutter,45,2022-10-24,28,28,28,0,881,882,881,1,0,0,0,0,235,235,235,235
Tehama,45,2022-10-24,36,36,36,0,406,407,406,1,1,0,0,0,218,218,218,218
Trinity,45,2022-10-24,1,1,1,0,35,36,35,1,0,0,0,0,21,21,21,21
Tulare,45,2022-10-24,110,110,110,0,4345,4352,4351,1,16,1,1,1,1551,1551,1550,1550
Tuolumne,45,2022-10-24,33,33,33,0,625,626,625,1,1,1,1,0,202,202,201,201
Ventura,45,2022-10-24,294,294,294,0,9025,9040,9039,1,40,3,3,6,1605,1605,1602,1602
Yolo,45,2022-10-24,91,91,91,0,2048,2051,2050,1,5,1,1,0,407,407,406,406
Yuba,45,2022-10-24,51,51,51,0,799,800,799,1,5,0,0,1,132,132,132,132
Alameda,46,2022-10-31,1057,1057,1057,0,23015,23052,23051,1,57,4,4,4,2015,2015,2011,2011
Amador,46,2022-10-31,18,18,18,0,578,579,578,1,2,1,1,0,94,94,93,93
Butte,46,2022-10-31,82,82,82,0,1458,1460,1459,1,11,0,0,3,468,468,468,468
Calaveras,46,2022-10-31,13,13,13,0,257,258,257,1,0,0,0,0,135,135,135,135
Colusa,46,2022-10-31,11,11,11,0,95,96,95,1,0,0,0,0,22,22,22,22
Contra Costa,46,2022-10-31,747,747,747,0,13905,13928,13927,1,37,6,6,7,1484,1484,1478,1478
Del Norte,46,2022-10-31,16,16,16,0,357,358,357,1,1,0,0,0,55,55,55,55
El Dorado,46,2022-10-31,100,100,100,0,1406,1407,1406,1,2,0,0,0,234,234,234,234
Fresno,46,2022-10-31,427,427,427,0,10498,10517,10516,1,57,5,5,8,2893,2893,2888,2888
Glenn,46,2022-10-31,16,16,16,0,156,157,156,1,1,0,0,0,56,56,56,56
Humboldt,46,2022-10-31,44,44,44,0,1021,1022,1021,1,6,0,0,2,162,162,162,162
Imperial,46,2022-10-31,126,126,126,0,2784,2790,2789,1,7,0,0,0,963,963,963,963
Inyo,46,2022-10-31,7,7,7,0,242,243,242,1,0,0,0,0,60,60,60,60
Kern,46,2022-10-31,341,341,341,0,9873,9889,9888,1,20,2,2,2,2437,2437,2435,2435
Kings,46,2022-10-31,118,118,118,0,2461,2467,2466,1,3,0,0,1,466,466,466,466
Lake,46,2022-10-31,30,30,30,0,752,753,752,1,1,0,0,1,151,151,151,151
Lassen,46,2022-10-31,19,19,19,0,522,523,522,1,1,0,0,0,64,64,64,64
Los Angeles,46,2022-10-31,6227,6236,6236,0,192573,192884,192882,2,344,38,38,44,33848,33848,33810,33810
Madera,46,2022-10-31,54,54,54,0,1433,1435,1434,1,3,0,0,2,376,376,376,376
Marin,46,2022-10-31,137,137,137,0,3509,3515,3514,1,10,1,1,1,260,260,259,259
Mariposa,46,2022-10-31,8,8,8,0,126,127,126,1,0,0,0,0,30,30,30,30
Mendocino,46,2022-10-31,23,23,23,0,709,710,709,1,1,0,0,2,136,136,136,136
Merced,46,2022-10-31,114,114,114,0,2140,2146,2145,1,5,1,1,0,875,875,874,874
Modoc,46,2022-10-31,1,1,1,0,13,14,13,1,0,0,0,0,11,11,11,11
Mono,46,2022-10-31,1,1,1,0,85,86,85,1,1,0,0,0,8,8,8,8
Monterey,46,2022-10-31,149,149,149,0,3695,3702,3701,1,18,2,2,0,774,774,772,772
Napa,46,2022-10-31,54,54,54,0,1505,1507,1506,1,2,0,0,0,161,161,161,161
Nevada,46,2022-10-31,38,38,38,0,775,776,775,1,6,0,0,0,137,137,137,137
Orange,46,2022-10-31,1189,1189,1189,0,27140,27183,27182,1,91,14,14,14,7619,7619,7605,7605
Placer,46,2022-10-31,151,151,151,0,2755,2762,2761,1,40,0,0,5,662,662,662,662
Plumas,46,2022-10-31,5,5,5,0,87,88,87,1,0,0,0,0,13,13,13,13
Riverside,46,2022-10-31,1049,1049,1049,0,19559,19590,19589,1,64,5,5,5,6663,6663,6658,6658
Sacramento,46,2022-10-31,754,754,754,0,14141,14164,14163,1,80,8,8,16,3383,3383,3375,3375
San Benito,46,2022-10-31,33,33,33,0,745,746,745,1,1,0,0,1,104,104,104,104
San Bernardino,46,2022-10-31,1049,1049,1049,0,22481,22517,22516,1,64,2,2,11,8111,8111,8109,8109
San Diego,46,2022-10-31,1769,1770,1770,0,42851,42921,42920,1,109,5,5,13,5603,5603,5598,5598
San Francisco,46,2022-10-31,622,622,622,0,14643,14668,14667,1,45,3,3,3,1077,1077,1074,1074
San Joaquin,46,2022-10-31,332,332,332,0,8598,8612,8611,1,21,6,6,3,2355,2355,2349,2349
San Luis Obispo,46,2022-10-31,81,81,81,0,2014,2019,2018,1,1,1,1,0,531,531,530,530
San Mateo,46,2022-10-31,521,521,521,0,11581,11601,11600,1,30,0,0,2,743,743,743,743
Santa Barbara,46,2022-10-31,181,181,181,0,6037,6048,6047,1,20,1,1,6,735,735,734,734
Santa Clara,46,2022-10-31,1288,1288,1288,0,30978,31028,31027,1,85,3,3,16,2570,2570,2567,2567
Santa Cruz,46,2022-10-31,188,188,188,0,9957,9974,9973,1,7,0,0,0,275,275,275,275
Shasta,46,2022-10-31,66,66,66,0,830,831,830,1,6,2,2,1,598,598,596,596
Siskiyou,46,2022-10-31,17,17,17,0,216,217,216,1,1,1,1,0,96,96,95,95
Solano,46,2022-10-31,310,310,310,0,5255,5264,5263,1,16,0,0,4,461,461,461,461
Sonoma,46,2022-10-31,206,206,206,0,5598,5608,5607,1,24,0,0,3,529,529,529,529
Stanislaus,46,2022-10-31,236,236,236,0,4831,4839,4838,1,49,1,1,8,1796,1796,1795,1795
Sutter,46,2022-10-31,55,55,55,0,901,902,901,1,0,0,0,0,235,235,235,235
Tehama,46,2022-10-31,25,25,25,0,395,396,395,1,1,0,0,0,218,218,218,218
Trinity,46,2022-10-31,18,18,18,0,73,74,73,1,5,0,0,0,21,21,21,21
Tulare,46,2022-10-31,153,153,153,0,3679,3686,3685,1,12,0,0,0,1551,1551,1551,1551
Tuolumne,46,2022-10-31,27,27,27,0,518,519,518,1,3,0,0,0,202,202,202,202
Ventura,46,2022-10-31,378,378,378,0,9551,9568,9567,1,24,2,2,2,1607,1607,1605,1605
Yolo,46,2022-10-31,82,82,82,0,1832,1835,1834,1,3,0,0,1,407,407,407,407
Yuba,46,2022-10-31,46,46,46,0,776,777,776,1,3,1,1,0,133,133,132,132
Alameda,47,2022-11-07,1339,1339,1339,0,24522,24563,24562,1,58,4,4,11,2019,2019,2015,2015
Amador,47,2022-11-07,32,32,32,0,685,686,685,1,3,0,0,0,94,94,94,94
Butte,47,2022-11-07,118,118,118,0,1370,1371,1370,1,11,0,0,2,468,468,468,468
Calaveras,47,2022-11-07,16,16,16,0,334,335,334,1,0,0,0,0,135,135,135,135
Colusa,47,2022-11-07,2,2,2,0,102,103,102,1,0,0,0,0,22,22,22,22
Contra Costa,47,2022-11-07,879,879,879,0,15679,15705,15704,1,43,3,3,4,1487,1487,1484,1484
Del Norte,47,2022-11-07,10,10,10,0,400,401,400,1,0,0,0,0,55,55,55,55
El Dorado,47,2022-11-07,108,108,108,0,1598,1601,1600,1,7,2,2,0,236,236,234,234
Fresno,47,2022-11-07,599,599,599,0,10716,10735,10734,1,61,3,3,9,2896,2896,2893,2893
Glenn,47,2022-11-07,29,29,29,0,131,132,131,1,0,0,0,0,56,56,56,56
Humboldt,47,2022-11-07,85,85,85,0,1025,1026,1025,1,9,0,0,2,162,162,162,162
Imperial,47,2022-11-07,210,210,210,0,3708,3714,3713,1,7,0,0,0,963,963,963,963
Inyo,47,2022-11-07,19,19,19,0,267,268,267,1,0,0,0,0,60,60,60,60
Kern,47,2022-11-07,478,478,478,0,10745,10764,10763,1,29,1,1,5,2438,2438,2437,2437
Kings,47,2022-11-07,146,146,146,0,2457,2463,2462,1,7,1,1,0,467,467,466,466
Lake,47,2022-11-07,51,51,51,0,795,796,795,1,3,0,0,1,151,151,151,151
Lassen,47,2022-11-07,10,10,10,0,451,452,451,1,0,0,0,0,64,64,64,64
Los Angeles,47,2022-11-07,8114,8127,8127,0,192450,192769,192767,2,387,55,55,53,33903,33903,33848,33848
Madera,47,2022-11-07,78,78,78,0,1612,1613,1612,1,3,0,0,4,376,376,376,376
Marin,47,2022-11-07,152,152,152,0,3369,3375,3374,1,9,0,0,0,260,260,260,260
Mariposa,47,2022-11-07,14,14,14,0,121,122,121,1,0,0,0,0,30,30,30,30
Mendocino,47,2022-11-07,37,37,37,0,819,820,819,1,4,1,1,0,137,137,136,136
Merced,47,2022-11-07,142,142,142,0,2592,2598,2597,1,9,4,4,0,879,879,875,875
Modoc,47,2022-11-07,2,2,2,0,6,7,6,1,0,0,0,0,11,11,11,11
Mono,47,2022-11-07,3,3,3,0,96,97,96,1,0,0,0,0,8,8,8,8
Monterey,47,2022-11-07,217,217,217,0,3932,3941,3940,1,18,1,1,0,775,775,774,774
Napa,47,2022-11-07,77,77,77,0,1757,1761,1760,1,6,0,0,0,161,161,161,161
Nevada,47,2022-11-07,60,60,60,0,744,745,744,1,3,0,0,1,137,137,137,137
Orange,47,2022-11-07,1286,1286,1286,0,28967,29015,29014,1,94,11,11,20,7630,7630,7619,7619
Placer,47,2022-11-07,231,231,231,0,3353,3360,3359,1,53,2,2,7,664,664,662,662
Plumas,47,2022-11-07,5,5,5,0,69,70,69,1,0,0,0,0,13,13,13,13
Riverside,47,2022-11-07,1508,1509,1509,0,21694,21730,21729,1,71,2,2,5,6665,6665,6663,6663
Sacramento,47,2022-11-07,1122,1122,1122,0,16054,16080,16079,1,90,8,8,9,3391,3391,3383,3383
San Benito,47,2022-11-07,43,43,43,0,924,925,924,1,1,0,0,0,104,104,104,104
San Bernardino,47,2022-11-07,1463,1464,1464,0,24064,24105,24104,1,76,3,3,17,8114,8114,8111,8111
San Diego,47,2022-11-07,2153,2157,2157,0,45689,45765,45764,1,117,8,8,24,5611,5611,5603,5603
San Francisco,47,2022-11-07,716,716,716,0,14906,14932,14931,1,42,2,2,8,1079,1079,1077,1077
San Joaquin,47,2022-11-07,481,481,481,0,8814,8828,8827,1,24,2,2,3,2357,2357,2355,2355
San Luis Obispo,47,2022-11-07,131,131,131,0,2272,2278,2277,1,4,0,0,2,531,531,531,531
San Mateo,47,2022-11-07,582,582,582,0,12353,12374,12373,1,27,0,0,3,743,743,743,743
Santa Barbara,47,2022-11-07,225,225,225,0,6672,6685,6684,1,18,1,1,2,736,736,735,735
Santa Clara,47,2022-11-07,1675,1675,1675,0,31527,31581,31580,1,76,7,7,19,2577,2577,2570,2570
Santa Cruz,47,2022-11-07,282,282,282,0,11333,11352,11351,1,8,0,0,0,275,275,275,275
Shasta,47,2022-11-07,97,97,97,0,1058,1059,1058,1,11,1,1,3,599,599,598,598
Siskiyou,47,2022-11-07,15,15,15,0,295,296,295,1,1,0,0,0,96,96,96,96
Solano,47,2022-11-07,384,384,384,0,5513,5523,5522,1,22,2,2,3,463,463,461,461
Sonoma,47,2022-11-07,249,249,249,0,5934,5945,5944,1,11,2,2,2,531,531,529,529
Stanislaus,47,2022-11-07,300,300,300,0,4932,4941,4940,1,42,2,2,9,1798,1798,1796,1796
Sutter,47,2022-11-07,86,86,86,0,958,959,958,1,0,0,0,0,235,235,235,235
Tehama,47,2022-11-07,47,47,47,0,472,473,472,1,2,0,0,0,218,218,218,218
Trinity,47,2022-11-07,2,2,2,0,34,35,34,1,0,0,0,0,21,21,21,21
Tulare,47,2022-11-07,160,160,160,0,4366,4374,4373,1,14,0,0,0,1551,1551,1551,1551
Tuolumne,47,2022-11-07,83,83,83,0,682,683,682,1,2,0,0,0,202,202,202,202
Ventura,47,2022-11-07,448,448,448,0,10374,10392,10391,1,36,2,2,1,1609,1609,1607,1607
Yolo,47,2022-11-07,173,173,173,0,2238,2243,2242,1,3,3,3,0,410,410,407,407
Yuba,47,2022-11-07,47,47,47,0,902,903,902,1,3,0,0,2,133,133,133,133
Alameda,48,2022-11-14,1508,1509,1509,0,24309,24351,24350,1,77,3,3,9,2022,2022,2019,2019
Amador,48,2022-11-14,20,20,20,0,656,657,656,1,2,0,0,0,94,94,94,94
Butte,48,2022-11-14,120,120,120,0,1380,1381,1380,1,20,0,0,1,468,468,468,468
Calaveras,48,2022-11-14,30,30,30,0,341,342,341,1,0,0,0,0,135,135,135,135
Colusa,48,2022-11-14,11,11,11,0,100,101,100,1,1,0,0,0,22,22,22,22
Contra Costa,48,2022-11-14,967,967,967,0,15967,15993,15992,1,56,1,1,5,1488,1488,1487,1487
Del Norte,48,2022-11-14,20,20,20,0,429,430,429,1,1,0,0,0,55,55,55,55
El Dorado,48,2022-11-14,143,143,143,0,1591,1594,1593,1,7,0,0,1,236,236,236,236
Fresno,48,2022-11-14,772,772,772,0,11276,11295,11294,1,72,8,8,13,2904,2904,2896,2896
Glenn,48,2022-11-14,20,20,20,0,160,161,160,1,0,0,0,0,56,56,56,56
Humboldt,48,2022-11-14,84,84,84,0,1105,1106,1105,1,6,0,0,0,162,162,162,162
Imperial,48,2022-11-14,251,251,251,0,3221,3227,3226,1,4,0,0,1,963,963,963,963
Inyo,48,2022-11-14,11,11,11,0,543,544,543,1,0,0,0,0,60,60,60,60
Kern,48,2022-11-14,470,470,470,0,10704,10723,10722,1,26,1,1,6,2439,2439,2438,2438
Kings,48,2022-11-14,200,200,200,0,2624,2629,2628,1,6,2,2,0,469,469,467,467
Lake,48,2022-11-14,54,54,54,0,803,804,803,1,2,0,0,1,151,151,151,151
Lassen,48,2022-11-14,35,35,35,0,544,545,544,1,0,1,1,0,65,65,64,64
Los Angeles,48,2022-11-14,9435,9451,9451,0,197414,197751,197749,2,477,49,49,75,33952,33952,33903,33903
Madera,48,2022-11-14,95,95,95,0,1714,1717,1716,1,4,0,0,3,376,376,376,376
Marin,48,2022-11-14,175,175,175,0,3569,3576,3575,1,8,0,0,2,260,260,260,260
Mariposa,48,2022-11-14,18,18,18,0,137,138,137,1,0,0,0,0,30,30,30,30
Mendocino,48,2022-11-14,39,39,39,0,908,909,908,1,3,0,0,1,137,137,137,137
Merced,48,2022-11-14,186,186,186,0,2639,2645,2644,1,6,0,0,0,879,879,879,879
Modoc,48,2022-11-14,3,3,3,0,11,12,11,1,0,0,0,0,11,11,11,11
Mono,48,2022-11-14,10,10,10,0,122,123,122,1,0,0,0,0,8,8,8,8
Monterey,48,2022-11-14,198,198,198,0,4156,4165,4164,1,20,1,1,1,776,776,775,775
Napa,48,2022-11-14,105,105,105,0,1919,1923,1922,1,5,0,0,0,161,161,161,161
Nevada,48,2022-11-14,65,65,65,0,797,798,797,1,3,0,0,2,137,137,137,137
Orange,48,2022-11-14,1620,1621,1621,0,27194,27240,27239,1,118,8,8,21,7638,7638,7630,7630
Placer,48,2022-11-14,320,320,320,0,3855,3862,3861,1,54,1,1,5,665,665,664,664
Plumas,48,2022-11-14,4,4,4,0,80,81,80,1,0,0,0,0,13,13,13,13
Riverside,48,2022-11-14,1662,1663,1663,0,22496,22533,22532,1,95,4,4,10,6669,6669,6665,6665
Sacramento,48,2022-11-14,1214,1214,1214,0,16983,17013,17012,1,82,7,7,18,3398,3398,3391,3391
San Benito,48,2022-11-14,42,42,42,0,980,981,980,1,1,0,0,0,104,104,104,104
San Bernardino,48,2022-11-14,1816,1817,1817,0,24234,24275,24274,1,83,0,0,14,8114,8114,8114,8114
San Diego,48,2022-11-14,2454,2458,2458,0,43913,43988,43987,1,124,8,8,21,5619,5619,5611,5611
San Francisco,48,2022-11-14,717,717,717,0,13762,13786,13785,1,52,7,7,5,1086,1086,1079,1079
San Joaquin,48,2022-11-14,609,609,609,0,9500,9518,9517,1,20,0,0,5,2357,2357,2357,2357
San Luis Obispo,48,2022-11-14,120,120,120,0,2201,2206,2205,1,6,0,0,1,531,531,531,531
San Mateo,48,2022-11-14,662,662,662,0,11419,11438,11437,1,27,0,0,2,743,743,743,743
Santa Barbara,48,2022-11-14,192,192,192,0,5891,5902,5901,1,15,1,1,2,737,737,736,736
Santa Clara,48,2022-11-14,1773,1774,1774,0,30789,30842,30841,1,117,3,3,14,2580,2580,2577,2577
Santa Cruz,48,2022-11-14,249,249,249,0,9607,9624,9623,1,11,1,1,0,276,276,275,275
Shasta,48,2022-11-14,106,106,106,0,1073,1074,1073,1,10,1,1,2,600,600,599,599
Siskiyou,48,2022-11-14,27,27,27,0,397,398,397,1,2,0,0,0,96,96,96,96
Solano,48,2022-11-14,438,438,438,0,5428,5439,5438,1,26,0,0,3,463,463,463,463
Sonoma,48,2022-11-14,270,270,270,0,6037,6049,6048,1,23,1,1,0,532,532,531,531
Stanislaus,48,2022-11-14,330,330,330,0,5224,5233,5232,1,48,0,0,10,1798,1798,1798,1798
Sutter,48,2022-11-14,95,95,95,0,1182,1183,1182,1,0,0,0,0,235,235,235,235
Tehama,48,2022-11-14,49,49,49,0,574,575,574,1,1,0,0,0,218,218,218,218
Trinity,48,2022-11-14,11,11,11,0,52,53,52,1,0,3,3,0,24,24,21,21
Tulare,48,2022-11-14,311,311,311,0,4283,4291,4290,1,16,0,0,1,1551,1551,1551,1551
Tuolumne,48,2022-11-14,76,76,76,0,695,696,695,1,2,0,0,0,202,202,202,202
Ventura,48,2022-11-14,572,572,572,0,10640,10660,10659,1,28,1,1,4,1610,1610,1609,1609
Yolo,48,2022-11-14,152,152,152,0,2164,2169,2168,1,2,6,6,0,416,416,410,410
Yuba,48,2022-11-14,60,60,60,0,987,988,987,1,6,0,0,1,133,133,133,133
Alameda,49,2022-11-21,1741,1742,1742,0,25497,25542,25541,1,82,8,8,16,2030,2030,2022,2022
Amador,49,2022-11-21,28,28,28,0,833,834,833,1,2,0,0,0,94,94,94,94
Butte,49,2022-11-21,143,143,143,0,1329,1330,1329,1,21,0,0,1,468,468,468,468
Calaveras,49,2022-11-21,40,40,40,0,421,422,421,1,2,0,0,0,135,135,135,135
Colusa,49,2022-11-21,9,9,9,0,110,111,110,1,0,0,0,0,22,22,22,22
Contra Costa,49,2022-11-21,1029,1029,1029,0,16524,16552,16551,1,52,3,3,8,1491,1491,1488,1488
Del Norte,49,2022-11-21,18,18,18,0,489,490,489,1,4,0,0,0,55,55,55,55
El Dorado,49,2022-11-21,186,186,186,0,1830,1834,1833,1,10,0,0,1,236,236,236,236
Fresno,49,2022-11-21,1070,1070,1070,0,12149,12171,12170,1,114,5,5,9,2909,2909,2904,2904
Glenn,49,2022-11-21,21,21,21,0,214,215,214,1,0,0,0,0,56,56,56,56
Humboldt,49,2022-11-21,126,126,126,0,1174,1175,1174,1,4,1,1,1,163,163,162,162
Imperial,49,2022-11-21,280,280,280,0,3122,3128,3127,1,3,1,1,1,964,964,963,963
Inyo,49,2022-11-21,29,29,29,0,405,406,405,1,0,1,1,0,61,61,60,60
Kern,49,2022-11-21,506,506,506,0,10333,10352,10351,1,54,3,3,10,2442,2442,2439,2439
Kings,49,2022-11-21,293,293,293,0,2780,2786,2785,1,4,2,2,1,471,471,469,469
Lake,49,2022-11-21,55,55,55,0,929,930,929,1,0,1,1,1,152,152,151,151
Lassen,49,2022-11-21,34,34,34,0,541,542,541,1,0,0,0,0,65,65,65,65
Los Angeles,49,2022-11-21,13238,13260,13260,0,200607,200959,200957,2,648,69,69,93,34021,34021,33952,33952
Madera,49,2022-11-21,168,168,168,0,1861,1864,1863,1,11,0,0,1,376,376,376,376
Marin,49,2022-11-21,178,178,178,0,3353,3360,3359,1,8,0,0,0,260,260,260,260
Mariposa,49,2022-11-21,19,19,19,0,170,171,170,1,0,0,0,0,30,30,30,30
Mendocino,49,2022-11-21,39,39,39,0,890,891,890,1,4,0,0,1,137,137,137,137
Merced,49,2022-11-21,269,269,269,0,2931,2937,2936,1,9,2,2,4,881,881,879,879
Modoc,49,2022-11-21,8,8,8,0,13,14,13,1,0,0,0,0,11,11,11,11
Mono,49,2022-11-21,3,3,3,0,107,108,107,1,0,0,0,0,8,8,8,8
Monterey,49,2022-11-21,225,225,225,0,4445,4454,4453,1,17,1,1,0,777,777,776,776
Napa,49,2022-11-21,145,145,145,0,2040,2045,2044,1,4,0,0,1,161,161,161,161
Nevada,49,2022-11-21,92,92,92,0,935,936,935,1,2,0,0,2,137,137,137,137
Orange,49,2022-11-21,2240,2245,2245,0,28654,28703,28702,1,170,14,14,32,7652,7652,7638,7638
Placer,49,2022-11-21,362,362,362,0,4079,4087,4086,1,53,0,0,6,665,665,665,665
Plumas,49,2022-11-21,7,7,7,0,104,105,104,1,1,0,0,0,13,13,13,13
Riverside,49,2022-11-21,2181,2186,2186,0,24563,24606,24605,1,110,7,7,9,6676,6676,6669,6669
Sacramento,49,2022-11-21,1553,1554,1554,0,19058,19092,19091,1,105,3,3,18,3401,3401,3398,3398
San Benito,49,2022-11-21,64,64,64,0,1157,1159,1158,1,2,0,0,0,104,104,104,104
San Bernardino,49,2022-11-21,2391,2395,2395,0,26916,26964,26963,1,89,1,1,19,8115,8115,8114,8114
San Diego,49,2022-11-21,3171,3177,3177,0,44135,44213,44212,1,198,3,3,26,5622,5622,5619,5619
San Francisco,49,2022-11-21,958,958,958,0,15162,15188,15187,1,54,5,5,7,1091,1091,1086,1086
San Joaquin,49,2022-11-21,764,764,764,0,11080,11101,11100,1,36,1,1,5,2358,2358,2357,2357
San Luis Obispo,49,2022-11-21,170,170,170,0,2352,2358,2357,1,4,1,1,0,532,532,531,531
San Mateo,49,2022-11-21,759,759,759,0,12399,12420,12419,1,36,0,0,1,743,743,743,743
Santa Barbara,49,2022-11-21,321,321,321,0,6109,6121,6120,1,15,3,3,3,740,740,737,737
Santa Clara,49,2022-11-21,2209,2214,2214,0,34651,34714,34713,1,119,10,10,23,2590,2590,2580,2580
Santa Cruz,49,2022-11-21,286,286,286,0,9527,9545,9544,1,12,0,0,2,276,276,276,276
Shasta,49,2022-11-21,98,98,98,0,1056,1057,1056,1,14,2,2,1,602,602,600,600
Siskiyou,49,2022-11-21,24,24,24,0,342,343,342,1,1,0,0,0,96,96,96,96
Solano,49,2022-11-21,490,490,490,0,5667,5679,5678,1,32,1,1,5,464,464,463,463
Sonoma,49,2022-11-21,326,326,326,0,5783,5796,5795,1,22,0,0,4,532,532,532,532
Stanislaus,49,2022-11-21,444,444,444,0,5972,5984,5983,1,51,0,0,10,1798,1798,1798,1798
Sutter,49,2022-11-21,91,91,91,0,1142,1143,1142,1,0,0,0,0,235,235,235,235
Tehama,49,2022-11-21,74,74,74,0,673,674,673,1,3,0,0,2,218,218,218,218
Trinity,49,2022-11-21,5,5,5,0,51,52,51,1,0,0,0,0,24,24,24,24
Tulare,49,2022-11-21,431,431,431,0,5505,5516,5515,1,23,0,0,1,1551,1551,1551,1551
Tuolumne,49,2022-11-21,96,96,96,0,766,767,766,1,3,1,1,0,203,203,202,202
Ventura,49,2022-11-21,728,728,728,0,10731,10752,10751,1,43,1,1,2,1611,1611,1610,1610
Yolo,49,2022-11-21,132,132,132,0,2247,2252,2251,1,7,4,4,2,420,420,416,416
Yuba,49,2022-11-21,70,70,70,0,1027,1028,1027,1,10,0,0,1,133,133,133,133
Alameda,50,2022-11-28,2272,2277,2277,0,22324,22364,22363,1,103,5,5,13,2035,2035,2030,2030
Amador,50,2022-11-28,32,32,32,0,757,758,757,1,5,1,1,1,95,95,94,94
Butte,50,2022-11-28,204,204,204,0,1476,1478,1477,1,41,0,0,1,468,468,468,468
Calaveras,50,2022-11-28,32,32,32,0,402,403,402,1,3,0,0,0,135,135,135,135
Colusa,50,2022-11-28,14,14,14,0,184,185,184,1,0,0,0,0,22,22,22,22
Contra Costa,50,2022-11-28,1470,1471,1471,0,15544,15572,15571,1,67,4,4,8,1495,1495,1491,1491
Del Norte,50,2022-11-28,33,33,33,0,458,459,458,1,1,1,1,0,56,56,55,55
El Dorado,50,2022-11-28,185,185,185,0,1549,1551,1550,1,13,1,1,1,237,237,236,236
Fresno,50,2022-11-28,1322,1323,1323,0,11709,11731,11730,1,136,6,6,19,2915,2915,2909,2909
Glenn,50,2022-11-28,17,17,17,0,194,195,194,1,3,0,0,0,56,56,56,56
Humboldt,50,2022-11-28,118,118,118,0,1045,1046,1045,1,10,0,0,0,163,163,163,163
Imperial,50,2022-11-28,379,379,379,0,2792,2798,2797,1,6,1,1,1,965,965,964,964
Inyo,50,2022-11-28,34,34,34,0,376,377,376,1,2,0,0,0,61,61,61,61
Kern,50,2022-11-28,600,600,600,0,9541,9558,9557,1,60,5,5,6,2447,2447,2442,2442
Kings,50,2022-11-28,246,246,246,0,2545,2550,2549,1,10,0,0,0,471,471,471,471
Lake,50,2022-11-28,49,49,49,0,848,849,848,1,1,0,0,0,152,152,152,152
Lassen,50,2022-11-28,27,27,27,0,493,494,493,1,0,0,0,0,65,65,65,65
Los Angeles,50,2022-11-28,18974,19009,19009,0,185227,185561,185559,2,918,90,90,122,34111,34111,34021,34021
Madera,50,2022-11-28,162,162,162,0,1627,1630,1629,1,13,0,0,2,376,376,376,376
Marin,50,2022-11-28,298,298,298,0,3071,3078,3077,1,19,0,0,1,260,260,260,260
Mariposa,50,2022-11-28,23,23,23,0,136,137,136,1,0,0,0,0,30,30,30,30
Mendocino,50,2022-11-28,49,49,49,0,726,727,726,1,5,0,0,2,137,137,137,137
Merced,50,2022-11-28,349,349,349,0,2552,2557,2556,1,18,5,5,2,886,886,881,881
Modoc,50,2022-11-28,5,5,5,0,10,11,10,1,0,0,0,0,11,11,11,11
Mono,50,2022-11-28,4,4,4,0,94,95,94,1,0,0,0,0,8,8,8,8
Monterey,50,2022-11-28,283,283,283,0,3893,3901,3900,1,26,1,1,0,778,778,777,777
Napa,50,2022-11-28,140,140,140,0,1882,1886,1885,1,6,0,0,3,161,161,161,161
Nevada,50,2022-11-28,118,118,118,0,1008,1010,1009,1,9,0,0,0,137,137,137,137
Orange,50,2022-11-28,3190,3197,3197,0,26616,26665,26664,1,221,17,17,34,7669,7669,7652,7652
Placer,50,2022-11-28,391,391,391,0,3786,3794,3793,1,69,3,3,5,668,668,665,665
Plumas,50,2022-11-28,6,6,6,0,143,144,143,1,0,0,0,0,13,13,13,13
Riverside,50,2022-11-28,3236,3243,3243,0,23436,23478,23477,1,188,12,12,22,6688,6688,6676,6676
Sacramento,50,2022-11-28,1816,1818,1818,0,18077,18109,18108,1,126,9,9,14,3410,3410,3401,3401
San Benito,50,2022-11-28,130,130,130,0,1223,1226,1225,1,1,0,0,0,104,104,104,104
San Bernardino,50,2022-11-28,3369,3376,3376,0,26028,26074,26073,1,146,1,1,20,8116,8116,8115,8115
San Diego,50,2022-11-28,4099,4106,4106,0,32004,32063,32062,1,259,9,9,27,5631,5631,5622,5622
San Francisco,50,2022-11-28,1170,1171,1171,0,12783,12805,12804,1,67,6,6,8,1097,1097,1091,1091
San Joaquin,50,2022-11-28,993,993,993,0,10948,10968,10967,1,50,3,3,11,2361,2361,2358,2358
San Luis Obispo,50,2022-11-28,179,179,179,0,2249,2253,2252,1,9,3,3,1,535,535,532,532
San Mateo,50,2022-11-28,1116,1117,1117,0,11095,11116,11115,1,42,1,1,3,744,744,743,743
Santa Barbara,50,2022-11-28,466,466,466,0,5212,5222,5221,1,27,2,2,5,742,742,740,740
Santa Clara,50,2022-11-28,2940,2946,2946,0,28323,28375,28374,1,159,9,9,22,2599,2599,2590,2590
Santa Cruz,50,2022-11-28,371,371,371,0,6668,6680,6679,1,20,0,0,2,276,276,276,276
Shasta,50,2022-11-28,99,99,99,0,1010,1012,1011,1,16,2,2,3,604,604,602,602
Siskiyou,50,2022-11-28,27,27,27,0,277,278,277,1,2,0,0,0,96,96,96,96
Solano,50,2022-11-28,592,592,592,0,5187,5197,5196,1,34,2,2,7,466,466,464,464
Sonoma,50,2022-11-28,453,453,453,0,5012,5022,5021,1,48,2,2,3,534,534,532,532
Stanislaus,50,2022-11-28,523,523,523,0,5363,5374,5373,1,77,3,3,4,1801,1801,1798,1798
Sutter,50,2022-11-28,83,83,83,0,1120,1121,1120,1,0,0,0,0,235,235,235,235
Tehama,50,2022-11-28,70,70,70,0,632,633,632,1,6,0,0,3,218,218,218,218
Trinity,50,2022-11-28,3,3,3,0,60,61,60,1,0,0,0,0,24,24,24,24
Tulare,50,2022-11-28,512,512,512,0,4932,4943,4942,1,34,0,0,0,1551,1551,1551,1551
Tuolumne,50,2022-11-28,71,71,71,0,676,677,676,1,4,0,0,0,203,203,203,203
Ventura,50,2022-11-28,966,966,966,0,10619,10639,10638,1,58,2,2,2,1613,1613,1611,1611
Yolo,50,2022-11-28,169,169,169,0,2034,2038,2037,1,3,4,4,1,424,424,420,420
Yuba,50,2022-11-28,92,92,92,0,927,928,927,1,12,0,0,0,133,133,133,133
Alameda,51,2022-12-05,2835,2841,2841,0,29281,29336,29335,1,126,7,7,13,2042,2042,2035,2035
Amador,51,2022-12-05,41,41,41,0,812,813,812,1,3,0,0,2,95,95,95,95
Butte,51,2022-12-05,240,240,240,0,1888,1892,1891,1,38,7,7,5,475,475,468,468
Calaveras,51,2022-12-05,45,45,45,0,485,486,485,1,0,0,0,0,135,135,135,135
Colusa,51,2022-12-05,13,13,13,0,206,207,206,1,4,0,0,0,22,22,22,22
Contra Costa,51,2022-12-05,1779,1781,1781,0,19310,19346,19345,1,78,0,0,11,1495,1495,1495,1495
Del Norte,51,2022-12-05,39,39,39,0,566,567,566,1,2,0,0,0,56,56,56,56
El Dorado,51,2022-12-05,182,182,182,0,1577,1580,1579,1,14,1,1,0,238,238,237,237
Fresno,51,2022-12-05,1549,1551,1551,0,14300,14327,14326,1,177,6,6,17,2921,2921,2915,2915
Glenn,51,2022-12-05,24,24,24,0,232,233,232,1,2,0,0,0,56,56,56,56
Humboldt,51,2022-12-05,141,141,141,0,1086,1087,1086,1,17,1,1,2,164,164,163,163
Imperial,51,2022-12-05,587,587,587,0,3398,3405,3404,1,18,2,2,5,967,967,965,965
Inyo,51,2022-12-05,26,26,26,0,333,334,333,1,1,1,1,0,62,62,61,61
Kern,51,2022-12-05,819,819,819,0,10833,10854,10853,1,55,1,1,10,2448,2448,2447,2447
Kings,51,2022-12-05,294,294,294,0,3048,3054,3053,1,8,0,0,0,471,471,471,471
Lake,51,2022-12-05,64,64,64,0,831,832,831,1,2,0,0,0,152,152,152,152
Lassen,51,2022-12-05,14,14,14,0,444,445,444,1,0,0,0,0,65,65,65,65
Los Angeles,51,2022-12-05,22488,22530,22530,0,245261,245722,245719,3,1119,111,111,151,34222,34222,34111,34111
Madera,51,2022-12-05,205,205,205,0,1983,1989,1988,1,12,0,0,3,376,376,376,376
Marin,51,2022-12-05,312,312,312,0,3509,3516,3515,1,14,0,0,2,260,260,260,260
Mariposa,51,2022-12-05,19,19,19,0,174,175,174,1,0,0,0,0,30,30,30,30
Mendocino,51,2022-12-05,47,47,47,0,797,798,797,1,6,1,1,2,138,138,137,137
Merced,51,2022-12-05,352,352,352,0,3212,3219,3218,1,23,2,2,2,888,888,886,886
Modoc,51,2022-12-05,12,12,12,0,13,14,13,1,0,0,0,0,11,11,11,11
Mono,51,2022-12-05,9,9,9,0,91,92,91,1,0,0,0,0,8,8,8,8
Monterey,51,2022-12-05,270,270,270,0,4388,4397,4396,1,34,1,1,0,779,779,778,778
Napa,51,2022-12-05,161,161,161,0,2342,2348,2347,1,7,0,0,0,161,161,161,161
Nevada,51,2022-12-05,115,115,115,0,1126,1127,1126,1,8,0,0,2,137,137,137,137
Orange,51,2022-12-05,4357,4365,4365,0,34731,34797,34796,1,301,22,22,48,7691,7691,7669,7669
Placer,51,2022-12-05,396,396,396,0,4059,4068,4067,1,72,1,1,4,669,669,668,668
Plumas,51,2022-12-05,22,22,22,0,185,186,185,1,1,0,0,0,13,13,13,13
Riverside,51,2022-12-05,4047,4054,4054,0,27545,27597,27596,1,186,13,13,25,6701,6701,6688,6688
Sacramento,51,2022-12-05,2156,2161,2161,0,21272,21312,21311,1,128,9,9,28,3419,3419,3410,3410
San Benito,51,2022-12-05,217,217,217,0,1484,1487,1486,1,6,1,1,3,105,105,104,104
San Bernardino,51,2022-12-05,4125,4133,4133,0,28695,28750,28749,1,167,0,0,34,8116,8116,8116,8116
San Diego,51,2022-12-05,5693,5705,5705,0,44793,44877,44876,1,302,14,14,30,5645,5645,5631,5631
San Francisco,51,2022-12-05,1493,1494,1494,0,16004,16033,16032,1,77,7,7,7,1104,1104,1097,1097
San Joaquin,51,2022-12-05,1122,1122,1122,0,12640,12663,12662,1,70,9,9,16,2370,2370,2361,2361
San Luis Obispo,51,2022-12-05,206,206,206,0,2662,2668,2667,1,15,3,3,1,538,538,535,535
San Mateo,51,2022-12-05,1259,1259,1259,0,13631,13659,13658,1,56,1,1,1,745,745,744,744
Santa Barbara,51,2022-12-05,521,521,521,0,6765,6779,6778,1,38,1,1,9,743,743,742,742
Santa Clara,51,2022-12-05,3530,3537,3537,0,35820,35889,35888,1,207,12,12,26,2611,2611,2599,2599
Santa Cruz,51,2022-12-05,471,471,471,0,12742,12767,12766,1,22,0,0,3,276,276,276,276
Shasta,51,2022-12-05,132,132,132,0,1108,1110,1109,1,23,0,0,5,604,604,604,604
Siskiyou,51,2022-12-05,22,22,22,0,309,310,309,1,2,0,0,0,96,96,96,96
Solano,51,2022-12-05,645,645,645,0,6617,6631,6630,1,33,1,1,7,467,467,466,466
Sonoma,51,2022-12-05,510,510,510,0,5883,5896,5895,1,35,5,5,1,539,539,534,534
Stanislaus,51,2022-12-05,640,640,640,0,6731,6744,6743,1,76,1,1,7,1802,1802,1801,1801
Sutter,51,2022-12-05,96,96,96,0,1173,1175,1174,1,0,1,1,0,236,236,235,235
Tehama,51,2022-12-05,93,93,93,0,817,818,817,1,9,2,2,0,220,220,218,218
Trinity,51,2022-12-05,3,3,3,0,39,40,39,1,0,0,0,0,24,24,24,24
Tulare,51,2022-12-05,528,528,528,0,5951,5964,5963,1,35,0,0,1,1551,1551,1551,1551
Tuolumne,51,2022-12-05,107,107,107,0,852,853,852,1,2,0,0,0,203,203,203,203
Ventura,51,2022-12-05,1102,1102,1102,0,12193,12218,12217,1,71,2,2,6,1615,1615,1613,1613
Yolo,51,2022-12-05,215,215,215,0,2651,2657,2656,1,2,1,1,3,425,425,424,424
Yuba,51,2022-12-05,82,82,82,0,1038,1039,1038,1,11,0,0,1,133,133,133,133
Alameda,52,2022-12-12,2691,2698,2698,0,29595,29654,29653,1,147,10,10,20,2052,2052,2042,2042
Amador,52,2022-12-12,32,32,32,0,790,791,790,1,3,0,0,0,95,95,95,95
Butte,52,2022-12-12,182,182,182,0,1836,1841,1840,1,39,2,2,2,477,477,475,475
Calaveras,52,2022-12-12,41,41,41,0,454,455,454,1,1,0,0,0,135,135,135,135
Colusa,52,2022-12-12,12,12,12,0,272,273,272,1,1,0,0,0,22,22,22,22
Contra Costa,52,2022-12-12,1733,1736,1736,0,18444,18481,18480,1,78,11,11,4,1506,1506,1495,1495
Del Norte,52,2022-12-12,34,34,34,0,534,535,534,1,3,0,0,0,56,56,56,56
El Dorado,52,2022-12-12,146,146,146,0,1410,1412,1411,1,8,1,1,3,239,239,238,238
Fresno,52,2022-12-12,1485,1488,1488,0,13859,13887,13886,1,186,12,12,18,2933,2933,2921,2921
Glenn,52,2022-12-12,17,17,17,0,230,231,230,1,6,0,0,0,56,56,56,56
Humboldt,52,2022-12-12,110,110,110,0,1014,1015,1014,1,13,1,1,2,165,165,164,164
Imperial,52,2022-12-12,455,455,455,0,2942,2948,2947,1,27,3,3,3,970,970,967,967
Inyo,52,2022-12-12,22,22,22,0,303,304,303,1,1,0,0,0,62,62,62,62
Kern,52,2022-12-12,955,955,955,0,11016,11040,11039,1,55,3,3,4,2451,2451,2448,2448
Kings,52,2022-12-12,256,256,256,0,2855,2861,2860,1,8,2,2,0,473,473,471,471
Lake,52,2022-12-12,56,56,56,0,761,762,761,1,3,0,0,1,152,152,152,152
Lassen,52,2022-12-12,15,15,15,0,423,424,423,1,0,0,0,0,65,65,65,65
Los Angeles,52,2022-12-12,17603,17638,17638,0,227810,228263,228260,3,1113,158,158,154,34380,34380,34222,34222
Madera,52,2022-12-12,212,212,212,0,2174,2180,2179,1,15,0,0,2,376,376,376,376
Marin,52,2022-12-12,316,316,316,0,3620,3627,3626,1,24,0,0,2,260,260,260,260
Mariposa,52,2022-12-12,18,18,18,0,123,124,123,1,0,0,0,0,30,30,30,30
Mendocino,52,2022-12-12,53,53,53,0,657,658,657,1,7,1,1,0,139,139,138,138
Merced,52,2022-12-12,318,318,318,0,3325,3331,3330,1,14,0,0,2,888,888,888,888
Modoc,52,2022-12-12,5,5,5,0,10,11,10,1,0,0,0,0,11,11,11,11
Mono,52,2022-12-12,9,9,9,0,122,123,122,1,0,0,0,0,8,8,8,8
Monterey,52,2022-12-12,263,263,263,0,4259,4268,4267,1,25,3,3,2,782,782,779,779
Napa,52,2022-12-12,162,162,162,0,2173,2179,2178,1,9,1,1,0,162,162,161,161
Nevada,52,2022-12-12,90,90,90,0,969,970,969,1,5,0,0,2,137,137,137,137
Orange,52,2022-12-12,3497,3504,3504,0,31468,31532,31531,1,300,35,35,48,7726,7726,7691,7691
Placer,52,2022-12-12,332,332,332,0,3892,3901,3900,1,73,5,5,6,674,674,669,669
Plumas,52,2022-12-12,7,7,7,0,186,187,186,1,2,0,0,0,13,13,13,13
Riverside,52,2022-12-12,3340,3347,3347,0,24681,24729,24728,1,204,19,19,25,6720,6720,6701,6701
Sacramento,52,2022-12-12,1824,1828,1828,0,20160,20200,20199,1,173,7,7,31,3426,3426,3419,3419
San Benito,52,2022-12-12,125,125,125,0,1329,1332,1331,1,2,2,2,2,107,107,105,105
San Bernardino,52,2022-12-12,3604,3611,3611,0,26990,27044,27043,1,226,4,4,36,8120,8120,8116,8116
San Diego,52,2022-12-12,4848,4859,4859,0,40661,40742,40741,1,331,16,16,45,5661,5661,5645,5645
San Francisco,52,2022-12-12,1425,1426,1426,0,16806,16838,16837,1,103,7,7,12,1111,1111,1104,1104
San Joaquin,52,2022-12-12,1000,1000,1000,0,12713,12739,12738,1,68,6,6,19,2376,2376,2370,2370
San Luis Obispo,52,2022-12-12,231,231,231,0,2650,2656,2655,1,10,1,1,0,539,539,538,538
San Mateo,52,2022-12-12,1171,1171,1171,0,12499,12526,12525,1,59,1,1,3,746,746,745,745
Santa Barbara,52,2022-12-12,512,512,512,0,5768,5781,5780,1,36,2,2,6,745,745,743,743
Santa Clara,52,2022-12-12,3260,3267,3267,0,35165,35236,35235,1,198,19,19,30,2630,2630,2611,2611
Santa Cruz,52,2022-12-12,578,578,578,0,12943,12969,12968,1,29,0,0,1,276,276,276,276
Shasta,52,2022-12-12,106,106,106,0,1154,1156,1155,1,22,0,0,5,604,604,604,604
Siskiyou,52,2022-12-12,15,15,15,0,245,246,245,1,2,0,0,0,96,96,96,96
Solano,52,2022-12-12,636,636,636,0,6179,6192,6191,1,42,2,2,7,469,469,467,467
Sonoma,52,2022-12-12,556,556,556,0,5592,5605,5604,1,41,2,2,7,541,541,539,539
Stanislaus,52,2022-12-12,593,593,593,0,6385,6399,6398,1,104,8,8,12,1810,1810,1802,1802
Sutter,52,2022-12-12,113,113,113,0,1156,1158,1157,1,0,0,0,0,236,236,236,236
Tehama,52,2022-12-12,78,78,78,0,774,775,774,1,6,1,1,0,221,221,220,220
Trinity,52,2022-12-12,3,3,3,0,45,46,45,1,0,0,0,0,24,24,24,24
Tulare,52,2022-12-12,442,442,442,0,5892,5905,5904,1,27,2,2,2,1553,1553,1551,1551
Tuolumne,52,2022-12-12,133,133,133,0,936,937,936,1,5,0,0,0,203,203,203,203
Ventura,52,2022-12-12,915,915,915,0,10661,10685,10684,1,72,4,4,7,1619,1619,1615,1615
Yolo,52,2022-12-12,210,210,210,0,2300,2306,2305,1,5,2,2,2,427,427,425,425
Yuba,52,2022-12-12,75,75,75,0,948,949,948,1,13,0,0,0,133,133,133,133
Alameda,53,2022-12-19,2342,2347,2347,0,27043,27100,27099,1,144,8,8,19,2060,2060,2052,2052
Amador,53,2022-12-19,42,42,42,0,807,808,807,1,6,0,0,0,95,95,95,95
Butte,53,2022-12-19,128,128,128,0,1639,1643,1642,1,34,3,3,2,480,480,477,477
Calaveras,53,2022-12-19,29,29,29,0,441,442,441,1,1,1,1,0,136,136,135,135
Colusa,53,2022-12-19,12,12,12,0,214,215,214,1,1,0,0,0,22,22,22,22
Contra Costa,53,2022-12-19,1715,1719,1719,0,17364,17402,17401,1,95,6,6,7,1512,1512,1506,1506
Del Norte,53,2022-12-19,39,39,39,0,553,554,553,1,3,0,0,0,56,56,56,56
El Dorado,53,2022-12-19,160,160,160,0,1632,1637,1636,1,9,1,1,2,240,240,239,239
Fresno,53,2022-12-19,1180,1180,1180,0,12896,12923,12922,1,212,7,7,22,2940,2940,2933,2933
Glenn,53,2022-12-19,21,21,21,0,205,206,205,1,6,0,0,0,56,56,56,56
Humboldt,53,2022-12-19,118,118,118,0,945,946,945,1,9,0,0,1,165,165,165,165
Imperial,53,2022-12-19,262,262,262,0,2546,2552,2551,1,16,1,1,0,971,971,970,970
Inyo,53,2022-12-19,12,12,12,0,324,325,324,1,1,0,0,0,62,62,62,62
Kern,53,2022-12-19,940,940,940,0,10707,10731,10730,1,60,3,3,5,2454,2454,2451,2451
Kings,53,2022-12-19,229,229,229,0,2770,2776,2775,1,6,4,4,1,477,477,473,473
Lake,53,2022-12-19,70,70,70,0,794,795,794,1,4,1,1,0,153,153,152,152
Lassen,53,2022-12-19,8,8,8,0,466,467,466,1,0,0,0,0,65,65,65,65
Los Angeles,53,2022-12-19,15305,15337,15337,0,204327,204752,204750,2,1096,129,129,155,34509,34509,34380,34380
Madera,53,2022-12-19,186,186,186,0,1891,1897,1896,1,10,0,0,1,376,376,376,376
Marin,53,2022-12-19,267,267,267,0,3234,3241,3240,1,17,0,0,0,260,260,260,260
Mariposa,53,2022-12-19,25,25,25,0,133,134,133,1,0,0,0,0,30,30,30,30
Mendocino,53,2022-12-19,66,66,66,0,755,756,755,1,4,0,0,0,139,139,139,139
Merced,53,2022-12-19,262,262,262,0,2773,2779,2778,1,15,2,2,2,890,890,888,888
Modoc,53,2022-12-19,8,8,8,0,21,22,21,1,0,0,0,0,11,11,11,11
Mono,53,2022-12-19,11,11,11,0,121,122,121,1,1,0,0,0,8,8,8,8
Monterey,53,2022-12-19,231,231,231,0,3880,3889,3888,1,13,1,1,1,783,783,782,782
Napa,53,2022-12-19,181,181,181,0,2094,2100,2099,1,8,0,0,0,162,162,162,162
Nevada,53,2022-12-19,72,72,72,0,883,884,883,1,5,0,0,2,137,137,137,137
Orange,53,2022-12-19,3309,3316,3316,0,30251,30314,30313,1,296,34,34,51,7760,7760,7726,7726
Placer,53,2022-12-19,364,364,364,0,3845,3854,3853,1,90,2,2,10,676,676,674,674
Plumas,53,2022-12-19,7,7,7,0,188,189,188,1,0,0,0,0,13,13,13,13
Riverside,53,2022-12-19,3163,3170,3170,0,22874,22923,22922,1,177,21,21,22,6741,6741,6720,6720
Sacramento,53,2022-12-19,1739,1744,1744,0,19756,19798,19797,1,210,15,15,22,3441,3441,3426,3426
San Benito,53,2022-12-19,105,105,105,0,1136,1139,1138,1,0,4,4,1,111,111,107,107
San Bernardino,53,2022-12-19,3214,3221,3221,0,25080,25133,25132,1,200,4,4,38,8124,8124,8120,8120
San Diego,53,2022-12-19,4854,4865,4865,0,39403,39486,39485,1,381,16,16,45,5677,5677,5661,5661
San Francisco,53,2022-12-19,1225,1226,1226,0,15734,15766,15765,1,106,11,11,17,1122,1122,1111,1111
San Joaquin,53,2022-12-19,851,851,851,0,12996,13022,13021,1,58,11,11,19,2387,2387,2376,2376
San Luis Obispo,53,2022-12-19,242,242,242,0,2423,2429,2428,1,17,1,1,0,540,540,539,539
San Mateo,53,2022-12-19,958,958,958,0,11890,11916,11915,1,62,1,1,5,747,747,746,746
Santa Barbara,53,2022-12-19,470,470,470,0,5251,5263,5262,1,35,4,4,5,749,749,745,745
Santa Clara,53,2022-12-19,2837,2844,2844,0,32504,32572,32571,1,205,17,17,30,2647,2647,2630,2630
Santa Cruz,53,2022-12-19,260,260,260,0,11209,11233,11232,1,31,0,0,1,276,276,276,276
Shasta,53,2022-12-19,109,109,109,0,1126,1128,1127,1,24,2,2,4,606,606,604,604
Siskiyou,53,2022-12-19,15,15,15,0,258,259,258,1,2,0,0,0,96,96,96,96
Solano,53,2022-12-19,639,639,639,0,6177,6190,6189,1,41,0,0,6,469,469,469,469
Sonoma,53,2022-12-19,478,478,478,0,5425,5437,5436,1,38,1,1,4,542,542,541,541
Stanislaus,53,2022-12-19,476,476,476,0,6000,6013,6012,1,94,1,1,12,1811,1811,1810,1810
Sutter,53,2022-12-19,81,81,81,0,1074,1076,1075,1,0,1,1,0,237,237,236,236
Tehama,53,2022-12-19,68,68,68,0,676,677,676,1,6,1,1,0,222,222,221,221
Trinity,53,2022-12-19,2,2,2,0,31,32,31,1,0,0,0,0,24,24,24,24
Tulare,53,2022-12-19,466,466,466,0,5382,5394,5393,1,53,5,5,1,1558,1558,1553,1553
Tuolumne,53,2022-12-19,88,88,88,0,841,842,841,1,2,1,1,1,204,204,203,203
Ventura,53,2022-12-19,937,937,937,0,9971,9993,9992,1,81,4,4,9,1623,1623,1619,1619
Yolo,53,2022-12-19,172,172,172,0,1967,1971,1970,1,5,4,4,0,431,431,427,427
Yuba,53,2022-12-19,81,81,81,0,900,901,900,1,7,1,1,0,134,134,133,133
Alameda,54,2022-12-26,1971,1976,1976,0,20711,20757,20756,1,150,10,10,17,2070,2070,2060,2060
Amador,54,2022-12-26,44,44,44,0,759,761,760,1,5,1,1,0,96,96,95,95
Butte,54,2022-12-26,95,95,95,0,1296,1299,1298,1,33,0,0,1,480,480,480,480
Calaveras,54,2022-12-26,24,24,24,0,367,368,367,1,0,1,1,0,137,137,136,136
Colusa,54,2022-12-26,14,14,14,0,150,151,150,1,0,0,0,0,22,22,22,22
Contra Costa,54,2022-12-26,1453,1458,1458,0,13771,13801,13800,1,89,11,11,11,1523,1523,1512,1512
Del Norte,54,2022-12-26,33,33,33,0,420,421,420,1,3,0,0,0,56,56,56,56
El Dorado,54,2022-12-26,152,152,152,0,1317,1320,1319,1,7,1,1,0,241,241,240,240
Fresno,54,2022-12-26,1089,1089,1089,0,10692,10715,10714,1,186,10,10,33,2950,2950,2940,2940
Glenn,54,2022-12-26,12,12,12,0,196,197,196,1,0,0,0,0,56,56,56,56
Humboldt,54,2022-12-26,83,83,83,0,631,632,631,1,5,2,2,2,167,167,165,165
Imperial,54,2022-12-26,234,234,234,0,2165,2170,2169,1,67,2,2,0,973,973,971,971
Inyo,54,2022-12-26,13,13,13,0,158,159,158,1,1,0,0,0,62,62,62,62
Kern,54,2022-12-26,702,702,702,0,8864,8883,8882,1,51,9,9,8,2463,2463,2454,2454
Kings,54,2022-12-26,200,200,200,0,2296,2302,2301,1,5,0,0,2,477,477,477,477
Lake,54,2022-12-26,58,58,58,0,601,602,601,1,3,0,0,1,153,153,153,153
Lassen,54,2022-12-26,27,27,27,0,485,486,485,1,0,0,0,0,65,65,65,65
Los Angeles,54,2022-12-26,13511,13541,13541,0,134761,135053,135051,2,1032,170,170,164,34679,34679,34509,34509
Madera,54,2022-12-26,166,166,166,0,1565,1569,1568,1,6,0,0,1,376,376,376,376
Marin,54,2022-12-26,214,214,214,0,2555,2561,2560,1,29,0,0,2,260,260,260,260
Mariposa,54,2022-12-26,22,22,22,0,105,106,105,1,0,0,0,0,30,30,30,30
Mendocino,54,2022-12-26,75,75,75,0,646,647,646,1,10,0,0,0,139,139,139,139
Merced,54,2022-12-26,212,212,212,0,1971,1977,1976,1,17,5,5,3,895,895,890,890
Modoc,54,2022-12-26,4,4,4,0,11,12,11,1,0,0,0,0,11,11,11,11
Mono,54,2022-12-26,10,10,10,0,83,84,83,1,0,0,0,0,8,8,8,8
Monterey,54,2022-12-26,190,190,190,0,2966,2974,2973,1,21,5,5,0,788,788,783,783
Napa,54,2022-12-26,142,142,142,0,1720,1725,1724,1,12,0,0,0,162,162,162,162
Nevada,54,2022-12-26,66,66,66,0,751,752,751,1,9,0,0,1,137,137,137,137
Orange,54,2022-12-26,3286,3292,3292,0,25032,25087,25086,1,274,39,39,31,7799,7799,7760,7760
Placer,54,2022-12-26,291,291,291,0,3048,3055,3054,1,87,2,2,12,678,678,676,676
Plumas,54,2022-12-26,10,10,10,0,123,124,123,1,0,0,0,0,13,13,13,13
Riverside,54,2022-12-26,2934,2940,2940,0,18672,18713,18712,1,194,12,12,18,6753,6753,6741,6741
Sacramento,54,2022-12-26,1392,1396,1396,0,14560,14591,14590,1,179,14,14,25,3455,3455,3441,3441
San Benito,54,2022-12-26,106,106,106,0,810,812,811,1,1,0,0,1,111,111,111,111
San Bernardino,54,2022-12-26,2957,2963,2963,0,20248,20292,20291,1,210,7,7,26,8131,8131,8124,8124
San Diego,54,2022-12-26,4607,4618,4618,0,28935,28999,28998,1,395,26,26,45,5703,5703,5677,5677
San Francisco,54,2022-12-26,1033,1033,1033,0,11831,11856,11855,1,90,20,20,15,1142,1142,1122,1122
San Joaquin,54,2022-12-26,749,749,749,0,10081,10103,10102,1,60,8,8,10,2395,2395,2387,2387
San Luis Obispo,54,2022-12-26,212,212,212,0,1973,1978,1977,1,20,3,3,0,543,543,540,540
San Mateo,54,2022-12-26,848,848,848,0,8983,9005,9004,1,55,0,0,6,747,747,747,747
Santa Barbara,54,2022-12-26,485,485,485,0,4098,4109,4108,1,40,0,0,4,749,749,749,749
Santa Clara,54,2022-12-26,2339,2344,2344,0,24218,24272,24271,1,179,9,9,35,2656,2656,2647,2647
Santa Cruz,54,2022-12-26,221,221,221,0,4642,4652,4651,1,25,0,0,2,276,276,276,276
Shasta,54,2022-12-26,100,100,100,0,923,924,923,1,18,1,1,1,607,607,606,606
Siskiyou,54,2022-12-26,17,17,17,0,266,267,266,1,1,0,0,0,96,96,96,96
Solano,54,2022-12-26,648,648,648,0,5238,5251,5250,1,59,2,2,7,471,471,469,469
Sonoma,54,2022-12-26,455,455,455,0,4248,4258,4257,1,39,1,1,4,543,543,542,542
Stanislaus,54,2022-12-26,453,453,453,0,4900,4912,4911,1,96,10,10,5,1821,1821,1811,1811
Sutter,54,2022-12-26,128,128,128,0,928,930,929,1,0,1,1,0,238,238,237,237
Tehama,54,2022-12-26,47,47,47,0,607,608,607,1,2,3,3,0,225,225,222,222
Trinity,54,2022-12-26,3,3,3,0,39,40,39,1,0,0,0,0,24,24,24,24
Tulare,54,2022-12-26,445,445,445,0,3936,3945,3944,1,41,7,7,3,1565,1565,1558,1558
Tuolumne,54,2022-12-26,93,93,93,0,758,759,758,1,6,2,2,2,206,206,204,204
Ventura,54,2022-12-26,888,888,888,0,7869,7886,7885,1,71,16,16,11,1639,1639,1623,1623
Yolo,54,2022-12-26,142,142,142,0,1614,1619,1618,1,9,2,2,1,433,433,431,431
Yuba,54,2022-12-26,99,99,99,0,754,755,754,1,14,0,0,0,134,134,134,134
Alameda,55,2023-01-02,1848,1852,1852,0,20046,20090,20089,1,175,13,13,19,2083,2083,2070,2070
Amador,55,2023-01-02,34,34,34,0,677,678,677,1,3,1,1,0,97,97,96,96
Butte,55,2023-01-02,99,99,99,0,1326,1330,1329,1,35,3,3,2,483,483,480,480
Calaveras,55,2023-01-02,33,33,33,0,361,362,361,1,0,2,2,0,139,139,137,137
Colusa,55,2023-01-02,5,5,5,0,94,95,94,1,0,0,0,0,22,22,22,22
Contra Costa,55,2023-01-02,1388,1391,1391,0,14064,14096,14095,1,89,5,5,13,1528,1528,1523,1523
Del Norte,55,2023-01-02,32,32,32,0,408,409,408,1,3,0,0,2,56,56,56,56
El Dorado,55,2023-01-02,147,147,147,0,1408,1412,1411,1,7,1,1,2,242,242,241,241
Fresno,55,2023-01-02,1066,1068,1068,0,11368,11393,11392,1,195,16,16,28,2966,2966,2950,2950
Glenn,55,2023-01-02,12,12,12,0,190,191,190,1,0,0,0,0,56,56,56,56
Humboldt,55,2023-01-02,50,50,50,0,618,619,618,1,2,0,0,2,167,167,167,167
Imperial,55,2023-01-02,205,205,205,0,2031,2036,2035,1,11,0,0,1,973,973,973,973
Inyo,55,2023-01-02,16,16,16,0,226,227,226,1,1,0,0,0,62,62,62,62
Kern,55,2023-01-02,892,892,892,0,9786,9808,9807,1,66,3,3,8,2466,2466,2463,2463
Kings,55,2023-01-02,187,187,187,0,2165,2171,2170,1,4,2,2,1,479,479,477,477
Lake,55,2023-01-02,47,47,47,0,604,605,604,1,3,1,1,0,154,154,153,153
Lassen,55,2023-01-02,13,13,13,0,490,491,490,1,0,0,0,0,65,65,65,65
Los Angeles,55,2023-01-02,13402,13433,13433,0,138317,138633,138631,2,1091,145,145,154,34824,34824,34679,34679
Madera,55,2023-01-02,153,153,153,0,1654,1659,1658,1,7,0,0,0,376,376,376,376
Marin,55,2023-01-02,225,225,225,0,2407,2413,2412,1,24,0,0,2,260,260,260,260
Mariposa,55,2023-01-02,15,15,15,0,94,95,94,1,0,0,0,0,30,30,30,30
Mendocino,55,2023-01-02,59,59,59,0,687,688,687,1,6,1,1,3,140,140,139,139
Merced,55,2023-01-02,193,193,193,0,2014,2020,2019,1,8,2,2,4,897,897,895,895
Modoc,55,2023-01-02,9,9,9,0,14,15,14,1,0,0,0,0,11,11,11,11
Mono,55,2023-01-02,10,10,10,0,66,67,66,1,0,0,0,0,8,8,8,8
Monterey,55,2023-01-02,215,215,215,0,3046,3053,3052,1,27,0,0,0,788,788,788,788
Napa,55,2023-01-02,124,124,124,0,1677,1682,1681,1,8,1,1,1,163,163,162,162
Nevada,55,2023-01-02,54,54,54,0,722,723,722,1,8,0,0,2,137,137,137,137
Orange,55,2023-01-02,3293,3300,3300,0,25268,25324,25323,1,312,38,38,28,7837,7837,7799,7799
Placer,55,2023-01-02,304,304,304,0,3244,3252,3251,1,108,1,1,8,679,679,678,678
Plumas,55,2023-01-02,12,12,12,0,145,146,145,1,1,1,1,0,14,14,13,13
Riverside,55,2023-01-02,3120,3127,3127,0,20088,20133,20132,1,223,9,9,31,6762,6762,6753,6753
Sacramento,55,2023-01-02,1519,1523,1523,0,15310,15345,15344,1,201,19,19,26,3474,3474,3455,3455
San Benito,55,2023-01-02,58,58,58,0,793,794,793,1,1,0,0,1,111,111,111,111
San Bernardino,55,2023-01-02,2872,2878,2878,0,20968,21016,21015,1,183,3,3,31,8134,8134,8131,8131
San Diego,55,2023-01-02,4633,4643,4643,0,29623,29692,29691,1,401,25,25,43,5728,5728,5703,5703
San Francisco,55,2023-01-02,884,884,884,0,10186,10209,10208,1,77,11,11,15,1153,1153,1142,1142
San Joaquin,55,2023-01-02,754,754,754,0,10422,10447,10446,1,62,6,6,12,2401,2401,2395,2395
San Luis Obispo,55,2023-01-02,210,210,210,0,1995,2000,1999,1,17,6,6,0,549,549,543,543
San Mateo,55,2023-01-02,743,743,743,0,8038,8057,8056,1,50,0,0,9,747,747,747,747
Santa Barbara,55,2023-01-02,432,432,432,0,4044,4055,4054,1,47,1,1,5,750,750,749,749
Santa Clara,55,2023-01-02,2447,2452,2452,0,23437,23491,23490,1,200,17,17,32,2673,2673,2656,2656
Santa Cruz,55,2023-01-02,171,171,171,0,3009,3016,3015,1,27,0,0,0,276,276,276,276
Shasta,55,2023-01-02,100,100,100,0,947,949,948,1,20,1,1,1,608,608,607,607
Siskiyou,55,2023-01-02,15,15,15,0,268,269,268,1,1,0,0,0,96,96,96,96
Solano,55,2023-01-02,639,639,639,0,5301,5313,5312,1,60,3,3,11,474,474,471,471
Sonoma,55,2023-01-02,428,428,428,0,4260,4271,4270,1,56,0,0,2,543,543,543,543
Stanislaus,55,2023-01-02,476,476,476,0,5023,5036,5035,1,88,6,6,8,1827,1827,1821,1821
Sutter,55,2023-01-02,97,97,97,0,889,891,890,1,0,0,0,0,238,238,238,238
Tehama,55,2023-01-02,54,54,54,0,621,622,621,1,2,5,5,0,230,230,225,225
Trinity,55,2023-01-02,4,4,4,0,41,42,41,1,0,0,0,0,24,24,24,24
Tulare,55,2023-01-02,479,479,479,0,4719,4730,4729,1,52,3,3,6,1568,1568,1565,1565
Tuolumne,55,2023-01-02,66,66,66,0,662,663,662,1,5,1,1,0,207,207,206,206
Ventura,55,2023-01-02,902,903,903,0,7468,7486,7485,1,87,10,10,13,1649,1649,1639,1639
Yolo,55,2023-01-02,135,135,135,0,1526,1531,1530,1,4,3,3,1,436,436,433,433
Yuba,55,2023-01-02,79,79,79,0,730,731,730,1,19,0,0,1,134,134,134,134
Alameda,56,2023-01-09,1496,1501,1501,0,23525,23582,23581,1,149,11,11,11,2094,2094,2083,2083
Amador,56,2023-01-09,28,28,28,0,706,707,706,1,2,0,0,0,97,97,97,97
Butte,56,2023-01-09,88,88,88,0,1206,1209,1208,1,39,3,3,3,486,486,483,483
Calaveras,56,2023-01-09,19,19,19,0,342,343,342,1,0,0,0,1,139,139,139,139
Colusa,56,2023-01-09,8,8,8,0,92,93,92,1,0,0,0,0,22,22,22,22
Contra Costa,56,2023-01-09,1054,1055,1055,0,15393,15431,15430,1,85,6,6,11,1534,1534,1528,1528
Del Norte,56,2023-01-09,17,17,17,0,367,368,367,1,5,0,0,2,56,56,56,56
El Dorado,56,2023-01-09,87,87,87,0,1453,1458,1457,1,4,0,0,0,242,242,242,242
Fresno,56,2023-01-09,806,806,806,0,11482,11510,11509,1,171,7,7,23,2973,2973,2966,2966
Glenn,56,2023-01-09,8,8,8,0,185,186,185,1,0,0,0,0,56,56,56,56
Humboldt,56,2023-01-09,60,60,60,0,709,710,709,1,7,0,0,4,167,167,167,167
Imperial,56,2023-01-09,161,161,161,0,2439,2445,2444,1,12,2,2,2,975,975,973,973
Inyo,56,2023-01-09,10,10,10,0,205,206,205,1,0,0,0,0,62,62,62,62
Kern,56,2023-01-09,620,620,620,0,10590,10615,10614,1,73,4,4,8,2470,2470,2466,2466
Kings,56,2023-01-09,182,182,182,0,2315,2321,2320,1,9,0,0,0,479,479,479,479
Lake,56,2023-01-09,44,44,44,0,622,623,622,1,3,1,1,0,155,155,154,154
Lassen,56,2023-01-09,19,19,19,0,506,507,506,1,2,0,0,0,65,65,65,65
Los Angeles,56,2023-01-09,10178,10202,10202,0,190018,190475,190473,2,965,140,140,136,34964,34964,34824,34824
Madera,56,2023-01-09,100,100,100,0,1645,1651,1650,1,8,0,0,1,376,376,376,376
Marin,56,2023-01-09,145,145,145,0,2560,2567,2566,1,18,0,0,3,260,260,260,260
Mariposa,56,2023-01-09,9,9,9,0,106,107,106,1,0,1,1,0,31,31,30,30
Mendocino,56,2023-01-09,40,40,40,0,645,646,645,1,10,2,2,3,142,142,140,140
Merced,56,2023-01-09,185,185,185,0,2162,2168,2167,1,11,1,1,1,898,898,897,897
Modoc,56,2023-01-09,8,8,8,0,14,15,14,1,0,0,0,0,11,11,11,11
Mono,56,2023-01-09,12,12,12,0,78,79,78,1,0,0,0,0,8,8,8,8
Monterey,56,2023-01-09,169,169,169,0,3129,3137,3136,1,20,4,4,3,792,792,788,788
Napa,56,2023-01-09,132,132,132,0,1879,1885,1884,1,9,0,0,3,163,163,163,163
Nevada,56,2023-01-09,42,42,42,0,760,761,760,1,6,0,0,0,137,137,137,137
Orange,56,2023-01-09,2472,2478,2478,0,28031,28098,28097,1,267,39,39,34,7876,7876,7837,7837
Placer,56,2023-01-09,260,260,260,0,3405,3413,3412,1,89,0,0,6,679,679,679,679
Plumas,56,2023-01-09,5,5,5,0,89,90,89,1,1,0,0,0,14,14,14,14
Riverside,56,2023-01-09,2002,2007,2007,0,21237,21288,21287,1,186,18,18,26,6780,6780,6762,6762
Sacramento,56,2023-01-09,1023,1024,1024,0,15636,15673,15672,1,178,16,16,28,3490,3490,3474,3474
San Benito,56,2023-01-09,51,51,51,0,817,818,817,1,1,1,1,2,112,112,111,111
San Bernardino,56,2023-01-09,1758,1763,1763,0,20711,20761,20760,1,179,6,6,36,8140,8140,8134,8134
San Diego,56,2023-01-09,3594,3603,3603,0,35162,35247,35246,1,397,27,27,40,5755,5755,5728,5728
San Francisco,56,2023-01-09,790,790,790,0,12779,12810,12809,1,75,7,7,17,1160,1160,1153,1153
San Joaquin,56,2023-01-09,592,592,592,0,10968,10996,10995,1,51,10,10,12,2411,2411,2401,2401
San Luis Obispo,56,2023-01-09,186,186,186,0,2148,2154,2153,1,12,3,3,0,552,552,549,549
San Mateo,56,2023-01-09,614,614,614,0,9706,9730,9729,1,47,0,0,5,747,747,747,747
Santa Barbara,56,2023-01-09,367,367,367,0,4500,4511,4510,1,39,3,3,1,753,753,750,750
Santa Clara,56,2023-01-09,1977,1982,1982,0,28635,28706,28705,1,182,13,13,28,2686,2686,2673,2673
Santa Cruz,56,2023-01-09,152,152,152,0,4069,4080,4079,1,27,0,0,1,276,276,276,276
Shasta,56,2023-01-09,60,60,60,0,890,892,891,1,17,0,0,2,608,608,608,608
Siskiyou,56,2023-01-09,20,20,20,0,233,234,233,1,0,0,0,0,96,96,96,96
Solano,56,2023-01-09,402,402,402,0,5191,5204,5203,1,54,1,1,6,475,475,474,474
Sonoma,56,2023-01-09,283,283,283,0,4755,4767,4766,1,31,3,3,4,546,546,543,543
Stanislaus,56,2023-01-09,303,303,303,0,5231,5245,5244,1,87,6,6,8,1833,1833,1827,1827
Sutter,56,2023-01-09,62,62,62,0,872,874,873,1,0,0,0,0,238,238,238,238
Tehama,56,2023-01-09,28,28,28,0,492,493,492,1,1,2,2,0,232,232,230,230
Trinity,56,2023-01-09,3,3,3,0,30,31,30,1,0,0,0,0,24,24,24,24
Tulare,56,2023-01-09,330,330,330,0,5104,5118,5117,1,53,5,5,2,1573,1573,1568,1568
Tuolumne,56,2023-01-09,74,74,74,0,655,656,655,1,2,1,1,0,208,208,207,207
Ventura,56,2023-01-09,662,662,662,0,9384,9408,9407,1,65,5,5,12,1654,1654,1649,1649
Yolo,56,2023-01-09,108,108,108,0,1666,1672,1671,1,2,2,2,1,438,438,436,436
Yuba,56,2023-01-09,48,48,48,0,735,736,735,1,21,0,0,1,134,134,134,134
Alameda,57,2023-01-16,868,868,868,0,19186,19233,19232,1,105,4,4,11,2098,2098,2094,2094
Amador,57,2023-01-16,20,20,20,0,585,586,585,1,4,0,0,0,97,97,97,97
Butte,57,2023-01-16,59,59,59,0,1163,1166,1165,1,21,1,1,0,487,487,486,486
Calaveras,57,2023-01-16,10,10,10,0,311,312,311,1,2,0,0,1,139,139,139,139
Colusa,57,2023-01-16,7,7,7,0,86,87,86,1,1,0,0,0,22,22,22,22
Contra Costa,57,2023-01-16,614,614,614,0,12121,12152,12151,1,61,5,5,11,1539,1539,1534,1534
Del Norte,57,2023-01-16,10,10,10,0,303,304,303,1,3,2,2,1,58,58,56,56
El Dorado,57,2023-01-16,61,61,61,0,978,979,978,1,2,1,1,1,243,243,242,242
Fresno,57,2023-01-16,463,463,463,0,9744,9768,9767,1,162,7,7,13,2980,2980,2973,2973
Glenn,57,2023-01-16,3,3,3,0,163,164,163,1,0,0,0,0,56,56,56,56
Humboldt,57,2023-01-16,38,38,38,0,500,501,500,1,9,1,1,2,168,168,167,167
Imperial,57,2023-01-16,127,127,127,0,2067,2073,2072,1,10,2,2,2,977,977,975,975
Inyo,57,2023-01-16,11,11,11,0,199,200,199,1,0,0,0,0,62,62,62,62
Kern,57,2023-01-16,386,386,386,0,8285,8308,8307,1,55,4,4,13,2474,2474,2470,2470
Kings,57,2023-01-16,126,126,126,0,1982,1988,1987,1,5,2,2,0,481,481,479,479
Lake,57,2023-01-16,23,23,23,0,576,577,576,1,2,1,1,1,156,156,155,155
Lassen,57,2023-01-16,6,6,6,0,441,442,441,1,0,0,0,0,65,65,65,65
Los Angeles,57,2023-01-16,6126,6142,6142,0,148588,148964,148962,2,855,145,145,113,35109,35109,34964,34964
Madera,57,2023-01-16,67,67,67,0,1350,1353,1352,1,4,0,0,2,376,376,376,376
Marin,57,2023-01-16,125,125,125,0,2138,2145,2144,1,20,0,0,1,260,260,260,260
Mariposa,57,2023-01-16,11,11,11,0,97,98,97,1,0,0,0,0,31,31,31,31
Mendocino,57,2023-01-16,25,25,25,0,499,500,499,1,6,0,0,0,142,142,142,142
Merced,57,2023-01-16,120,120,120,0,1698,1704,1703,1,12,3,3,5,901,901,898,898
Modoc,57,2023-01-16,2,2,2,0,9,10,9,1,0,0,0,0,11,11,11,11
Mono,57,2023-01-16,6,6,6,0,68,69,68,1,0,0,0,0,8,8,8,8
Monterey,57,2023-01-16,111,111,111,0,2603,2612,2611,1,20,3,3,2,795,795,792,792
Napa,57,2023-01-16,63,63,63,0,1512,1517,1516,1,5,0,0,0,163,163,163,163
Nevada,57,2023-01-16,25,25,25,0,565,566,565,1,4,0,0,0,137,137,137,137
Orange,57,2023-01-16,1478,1483,1483,0,24166,24228,24227,1,245,39,39,32,7915,7915,7876,7876
Placer,57,2023-01-16,163,163,163,0,2641,2649,2648,1,68,0,0,6,679,679,679,679
Plumas,57,2023-01-16,2,2,2,0,74,75,74,1,1,0,0,0,14,14,14,14
Riverside,57,2023-01-16,1217,1219,1219,0,17177,17220,17219,1,169,14,14,36,6794,6794,6780,6780
Sacramento,57,2023-01-16,573,573,573,0,12430,12463,12462,1,149,19,19,23,3509,3509,3490,3490
San Benito,57,2023-01-16,28,28,28,0,468,469,468,1,0,1,1,0,113,113,112,112
San Bernardino,57,2023-01-16,993,993,993,0,16760,16802,16801,1,148,2,2,35,8142,8142,8140,8140
San Diego,57,2023-01-16,2065,2071,2071,0,28671,28745,28744,1,327,15,15,39,5770,5770,5755,5755
San Francisco,57,2023-01-16,440,440,440,0,10156,10181,10180,1,75,2,2,12,1162,1162,1160,1160
San Joaquin,57,2023-01-16,358,358,358,0,8799,8822,8821,1,42,8,8,11,2419,2419,2411,2411
San Luis Obispo,57,2023-01-16,108,108,108,0,1777,1783,1782,1,12,2,2,3,554,554,552,552
San Mateo,57,2023-01-16,401,401,401,0,7746,7766,7765,1,37,0,0,3,747,747,747,747
Santa Barbara,57,2023-01-16,242,242,242,0,3919,3929,3928,1,34,2,2,0,755,755,753,753
Santa Clara,57,2023-01-16,1101,1103,1103,0,24099,24161,24160,1,106,17,17,16,2703,2703,2686,2686
Santa Cruz,57,2023-01-16,171,171,171,0,6498,6515,6514,1,23,0,0,1,276,276,276,276
Shasta,57,2023-01-16,41,41,41,0,691,692,691,1,13,3,3,2,611,611,608,608
Siskiyou,57,2023-01-16,6,6,6,0,208,209,208,1,0,0,0,0,96,96,96,96
Solano,57,2023-01-16,222,222,222,0,3711,3721,3720,1,49,0,0,6,475,475,475,475
Sonoma,57,2023-01-16,189,189,189,0,3774,3785,3784,1,26,5,5,2,551,551,546,546
Stanislaus,57,2023-01-16,205,205,205,0,4384,4397,4396,1,72,3,3,3,1836,1836,1833,1833
Sutter,57,2023-01-16,47,47,47,0,717,719,718,1,0,0,0,0,238,238,238,238
Tehama,57,2023-01-16,16,16,16,0,370,371,370,1,1,0,0,0,232,232,232,232
Trinity,57,2023-01-16,3,3,3,0,23,24,23,1,0,0,0,0,24,24,24,24
Tulare,57,2023-01-16,264,264,264,0,4115,4125,4124,1,45,4,4,2,1577,1577,1573,1573
Tuolumne,57,2023-01-16,44,44,44,0,548,549,548,1,1,2,2,0,210,210,208,208
Ventura,57,2023-01-16,413,413,413,0,7845,7866,7865,1,53,4,4,12,1658,1658,1654,1654
Yolo,57,2023-01-16,73,73,73,0,1251,1254,1253,1,2,2,2,0,440,440,438,438
Yuba,57,2023-01-16,38,38,38,0,595,596,595,1,9,0,0,2,134,134,134,134
Alameda,58,2023-01-23,744,744,744,0,21296,21355,21354,1,100,10,10,9,2108,2108,2098,2098
Amador,58,2023-01-23,34,34,34,0,590,591,590,1,1,1,1,0,98,98,97,97
Butte,58,2023-01-23,44,44,44,0,1085,1088,1087,1,13,1,1,0,488,488,487,487
Calaveras,58,2023-01-23,15,15,15,0,280,281,280,1,0,0,0,0,139,139,139,139
Colusa,58,2023-01-23,10,10,10,0,142,143,142,1,0,0,0,0,22,22,22,22
Contra Costa,58,2023-01-23,516,516,516,0,13317,13353,13352,1,61,7,7,6,1546,1546,1539,1539
Del Norte,58,2023-01-23,22,22,22,0,359,360,359,1,1,0,0,0,58,58,58,58
El Dorado,58,2023-01-23,40,40,40,0,1082,1086,1085,1,2,0,0,0,243,243,243,243
Fresno,58,2023-01-23,450,450,450,0,10114,10143,10142,1,117,5,5,19,2985,2985,2980,2980
Glenn,58,2023-01-23,4,4,4,0,154,155,154,1,0,0,0,0,56,56,56,56
Humboldt,58,2023-01-23,35,35,35,0,556,557,556,1,9,1,1,4,169,169,168,168
Imperial,58,2023-01-23,85,85,85,0,2255,2261,2260,1,10,0,0,1,977,977,977,977
Inyo,58,2023-01-23,6,6,6,0,165,166,165,1,0,1,1,0,63,63,62,62
Kern,58,2023-01-23,313,313,313,0,9390,9417,9416,1,34,5,5,8,2479,2479,2474,2474
Kings,58,2023-01-23,107,107,107,0,1985,1991,1990,1,6,0,0,0,481,481,481,481
Lake,58,2023-01-23,29,29,29,0,581,582,581,1,2,3,3,2,159,159,156,156
Lassen,58,2023-01-23,5,5,5,0,465,466,465,1,0,0,0,0,65,65,65,65
Los Angeles,58,2023-01-23,5611,5626,5626,0,169969,170430,170428,2,665,110,110,96,35219,35219,35109,35109
Madera,58,2023-01-23,51,51,51,0,1433,1438,1437,1,6,0,0,2,376,376,376,376
Marin,58,2023-01-23,108,108,108,0,2351,2358,2357,1,18,0,0,3,260,260,260,260
Mariposa,58,2023-01-23,7,7,7,0,105,106,105,1,0,0,0,0,31,31,31,31
Mendocino,58,2023-01-23,21,21,21,0,546,547,546,1,4,0,0,0,142,142,142,142
Merced,58,2023-01-23,126,126,126,0,1925,1931,1930,1,9,2,2,3,903,903,901,901
Modoc,58,2023-01-23,1,1,1,0,11,12,11,1,1,0,0,0,11,11,11,11
Mono,58,2023-01-23,5,5,5,0,73,74,73,1,0,0,0,0,8,8,8,8
Monterey,58,2023-01-23,107,107,107,0,2757,2766,2765,1,15,1,1,2,796,796,795,795
Napa,58,2023-01-23,77,77,77,0,1505,1511,1510,1,4,0,0,1,163,163,163,163
Nevada,58,2023-01-23,20,20,20,0,600,601,600,1,3,0,0,2,137,137,137,137
Orange,58,2023-01-23,1176,1180,1180,0,24114,24180,24179,1,177,27,27,27,7942,7942,7915,7915
Placer,58,2023-01-23,139,139,139,0,2732,2740,2739,1,42,1,1,7,680,680,679,679
Plumas,58,2023-01-23,5,5,5,0,91,92,91,1,1,0,0,0,14,14,14,14
Riverside,58,2023-01-23,1013,1015,1015,0,16233,16277,16276,1,111,15,15,22,6809,6809,6794,6794
Sacramento,58,2023-01-23,598,598,598,0,13723,13761,13760,1,134,9,9,21,3518,3518,3509,3509
San Benito,58,2023-01-23,27,27,27,0,564,565,564,1,0,0,0,0,113,113,113,113
San Bernardino,58,2023-01-23,1030,1033,1033,0,19085,19136,19135,1,127,1,1,33,8143,8143,8142,8142
San Diego,58,2023-01-23,2031,2037,2037,0,33285,33377,33376,1,236,11,11,37,5781,5781,5770,5770
San Francisco,58,2023-01-23,449,449,449,0,11286,11317,11316,1,58,6,6,5,1168,1168,1162,1162
San Joaquin,58,2023-01-23,244,244,244,0,8422,8447,8446,1,29,4,4,8,2423,2423,2419,2419
San Luis Obispo,58,2023-01-23,110,110,110,0,1951,1957,1956,1,8,3,3,2,557,557,554,554
San Mateo,58,2023-01-23,352,352,352,0,8735,8758,8757,1,21,0,0,0,747,747,747,747
Santa Barbara,58,2023-01-23,209,209,209,0,4241,4254,4253,1,28,2,2,4,757,757,755,755
Santa Clara,58,2023-01-23,1018,1019,1019,0,24698,24766,24765,1,119,5,5,23,2708,2708,2703,2703
Santa Cruz,58,2023-01-23,122,122,122,0,9483,9509,9508,1,16,0,0,0,276,276,276,276
Shasta,58,2023-01-23,22,22,22,0,755,757,756,1,6,1,1,1,612,612,611,611
Siskiyou,58,2023-01-23,6,6,6,0,178,179,178,1,0,0,0,0,96,96,96,96
Solano,58,2023-01-23,228,228,228,0,4219,4232,4231,1,33,0,0,2,475,475,475,475
Sonoma,58,2023-01-23,199,199,199,0,4276,4288,4287,1,26,0,0,4,551,551,551,551
Stanislaus,58,2023-01-23,181,181,181,0,4333,4346,4345,1,57,2,2,6,1838,1838,1836,1836
Sutter,58,2023-01-23,41,41,41,0,780,782,781,1,0,1,1,0,239,239,238,238
Tehama,58,2023-01-23,15,15,15,0,341,342,341,1,1,0,0,0,232,232,232,232
Trinity,58,2023-01-23,4,4,4,0,31,32,31,1,0,1,1,0,25,25,24,24
Tulare,58,2023-01-23,221,221,221,0,4167,4178,4177,1,27,3,3,5,1580,1580,1577,1577
Tuolumne,58,2023-01-23,36,36,36,0,484,485,484,1,0,1,1,1,211,211,210,210
Ventura,58,2023-01-23,368,368,368,0,8589,8614,8613,1,57,5,5,3,1663,1663,1658,1658
Yolo,58,2023-01-23,85,85,85,0,1371,1376,1375,1,2,3,3,0,443,443,440,440
Yuba,58,2023-01-23,30,30,30,0,725,726,725,1,3,0,0,0,134,134,134,134
Alameda,59,2023-01-30,849,849,849,0,18462,18516,18515,1,85,3,3,4,2111,2111,2108,2108
Amador,59,2023-01-30,24,24,24,0,620,622,621,1,3,0,0,0,98,98,98,98
Butte,59,2023-01-30,57,57,57,0,1128,1132,1131,1,13,2,2,2,490,490,488,488
Calaveras,59,2023-01-30,16,16,16,0,318,319,318,1,0,1,1,0,140,140,139,139
Colusa,59,2023-01-30,7,7,7,0,169,170,169,1,0,0,0,0,22,22,22,22
Contra Costa,59,2023-01-30,664,664,664,0,12415,12452,12451,1,38,9,9,6,1555,1555,1546,1546
Del Norte,59,2023-01-30,31,31,31,0,382,383,382,1,1,1,1,0,59,59,58,58
El Dorado,59,2023-01-30,61,61,61,0,1190,1195,1194,1,4,2,2,0,245,245,243,243
Fresno,59,2023-01-30,449,449,449,0,9879,9909,9908,1,117,8,8,10,2993,2993,2985,2985
Glenn,59,2023-01-30,2,2,2,0,156,157,156,1,0,0,0,0,56,56,56,56
Humboldt,59,2023-01-30,29,29,29,0,565,566,565,1,6,0,0,1,169,169,169,169
Imperial,59,2023-01-30,104,104,104,0,2068,2074,2073,1,7,1,1,0,978,978,977,977
Inyo,59,2023-01-30,10,10,10,0,202,203,202,1,1,0,0,0,63,63,63,63
Kern,59,2023-01-30,294,294,294,0,8979,9007,9006,1,36,1,1,8,2480,2480,2479,2479
Kings,59,2023-01-30,136,136,136,0,2211,2218,2217,1,7,1,1,1,482,482,481,481
Lake,59,2023-01-30,25,25,25,0,555,556,555,1,5,1,1,1,160,160,159,159
Lassen,59,2023-01-30,4,4,4,0,490,491,490,1,0,0,0,0,65,65,65,65
Los Angeles,59,2023-01-30,5795,5811,5811,0,152337,152783,152781,2,633,109,109,72,35328,35328,35219,35219
Madera,59,2023-01-30,49,49,49,0,1480,1487,1486,1,7,0,0,0,376,376,376,376
Marin,59,2023-01-30,102,102,102,0,2159,2166,2165,1,19,0,0,1,260,260,260,260
Mariposa,59,2023-01-30,5,5,5,0,106,107,106,1,0,0,0,0,31,31,31,31
Mendocino,59,2023-01-30,24,24,24,0,518,519,518,1,2,0,0,1,142,142,142,142
Merced,59,2023-01-30,137,137,137,0,1803,1809,1808,1,11,0,0,3,903,903,903,903
Modoc,59,2023-01-30,0,0,0,0,8,9,8,1,1,0,0,0,11,11,11,11
Mono,59,2023-01-30,2,2,2,0,68,69,68,1,0,0,0,0,8,8,8,8
Monterey,59,2023-01-30,155,155,155,0,2846,2856,2855,1,8,1,1,1,797,797,796,796
Napa,59,2023-01-30,72,72,72,0,1370,1376,1375,1,4,0,0,0,163,163,163,163
Nevada,59,2023-01-30,29,29,29,0,591,592,591,1,2,0,0,1,137,137,137,137
Orange,59,2023-01-30,1203,1207,1207,0,22809,22875,22874,1,136,15,15,25,7957,7957,7942,7942
Placer,59,2023-01-30,170,170,170,0,2707,2715,2714,1,49,2,2,3,682,682,680,680
Plumas,59,2023-01-30,3,3,3,0,75,76,75,1,0,0,0,0,14,14,14,14
Riverside,59,2023-01-30,1072,1074,1074,0,16023,16070,16069,1,84,5,5,17,6814,6814,6809,6809
Sacramento,59,2023-01-30,667,667,667,0,13391,13431,13430,1,117,8,8,13,3526,3526,3518,3518
San Benito,59,2023-01-30,30,30,30,0,563,564,563,1,0,0,0,0,113,113,113,113
San Bernardino,59,2023-01-30,930,931,931,0,17220,17272,17271,1,140,0,0,19,8143,8143,8143,8143
San Diego,59,2023-01-30,1861,1867,1867,0,30199,30289,30288,1,202,12,12,32,5793,5793,5781,5781
San Francisco,59,2023-01-30,473,473,473,0,10902,10933,10932,1,51,2,2,4,1170,1170,1168,1168
San Joaquin,59,2023-01-30,306,306,306,0,7674,7698,7697,1,22,4,4,5,2427,2427,2423,2423
San Luis Obispo,59,2023-01-30,140,140,140,0,1912,1918,1917,1,13,5,5,0,562,562,557,557
San Mateo,59,2023-01-30,432,432,432,0,8646,8671,8670,1,25,0,0,3,747,747,747,747
Santa Barbara,59,2023-01-30,227,227,227,0,4267,4280,4279,1,25,1,1,2,758,758,757,757
Santa Clara,59,2023-01-30,1178,1182,1182,0,23655,23725,23724,1,132,6,6,14,2714,2714,2708,2708
Santa Cruz,59,2023-01-30,133,133,133,0,9330,9358,9357,1,12,0,0,0,276,276,276,276
Shasta,59,2023-01-30,18,18,18,0,665,667,666,1,7,0,0,0,612,612,612,612
Siskiyou,59,2023-01-30,6,6,6,0,195,196,195,1,0,0,0,0,96,96,96,96
Solano,59,2023-01-30,236,236,236,0,4173,4186,4185,1,40,0,0,1,475,475,475,475
Sonoma,59,2023-01-30,159,159,159,0,3597,3609,3608,1,23,1,1,1,552,552,551,551
Stanislaus,59,2023-01-30,230,230,230,0,4131,4144,4143,1,43,2,2,3,1840,1840,1838,1838
Sutter,59,2023-01-30,36,36,36,0,611,612,611,1,0,1,1,0,240,240,239,239
Tehama,59,2023-01-30,8,8,8,0,317,318,317,1,1,1,1,0,233,233,232,232
Trinity,59,2023-01-30,7,7,7,0,26,27,26,1,0,0,0,0,25,25,25,25
Tulare,59,2023-01-30,261,261,261,0,4019,4032,4031,1,28,3,3,3,1583,1583,1580,1580
Tuolumne,59,2023-01-30,44,44,44,0,599,600,599,1,3,0,0,0,211,211,211,211
Ventura,59,2023-01-30,363,363,363,0,8133,8158,8157,1,46,7,7,8,1670,1670,1663,1663
Yolo,59,2023-01-30,87,87,87,0,1298,1304,1303,1,2,1,1,0,444,444,443,443
Yuba,59,2023-01-30,32,32,32,0,656,657,656,1,3,0,0,1,134,134,134,134
Alameda,60,2023-02-06,1108,1111,1111,0,18267,18326,18325,1,86,4,4,9,2115,2115,2111,2111
Amador,60,2023-02-06,29,29,29,0,637,639,638,1,1,0,0,0,98,98,98,98
Butte,60,2023-02-06,84,84,84,0,1209,1215,1214,1,20,0,0,1,490,490,490,490
Calaveras,60,2023-02-06,14,14,14,0,323,324,323,1,0,0,0,0,140,140,140,140
Colusa,60,2023-02-06,6,6,6,0,184,185,184,1,0,0,0,0,22,22,22,22
Contra Costa,60,2023-02-06,713,713,713,0,11858,11897,11896,1,50,2,2,9,1557,1557,1555,1555
Del Norte,60,2023-02-06,58,58,58,0,394,395,394,1,0,0,0,0,59,59,59,59
El Dorado,60,2023-02-06,59,59,59,0,1133,1138,1137,1,3,0,0,0,245,245,245,245
Fresno,60,2023-02-06,514,514,514,0,9046,9075,9074,1,89,4,4,15,2997,2997,2993,2993
Glenn,60,2023-02-06,10,10,10,0,170,171,170,1,0,0,0,0,56,56,56,56
Humboldt,60,2023-02-06,56,56,56,0,566,567,566,1,6,1,1,0,170,170,169,169
Imperial,60,2023-02-06,124,124,124,0,2097,2104,2103,1,7,1,1,0,979,979,978,978
Inyo,60,2023-02-06,9,9,9,0,210,211,210,1,0,0,0,0,63,63,63,63
Kern,60,2023-02-06,325,325,325,0,8606,8636,8635,1,34,2,2,4,2482,2482,2480,2480
Kings,60,2023-02-06,127,127,127,0,2057,2065,2064,1,3,0,0,1,482,482,482,482
Lake,60,2023-02-06,25,25,25,0,561,562,561,1,5,1,1,0,161,161,160,160
Lassen,60,2023-02-06,6,6,6,0,445,446,445,1,0,0,0,0,65,65,65,65
Los Angeles,60,2023-02-06,5907,5926,5926,0,142530,142979,142977,2,609,91,91,83,35419,35419,35328,35328
Madera,60,2023-02-06,55,55,55,0,1308,1313,1312,1,4,1,1,0,377,377,376,376
Marin,60,2023-02-06,144,144,144,0,2133,2140,2139,1,13,0,0,3,260,260,260,260
Mariposa,60,2023-02-06,2,2,2,0,105,106,105,1,0,0,0,0,31,31,31,31
Mendocino,60,2023-02-06,31,31,31,0,513,514,513,1,4,0,0,2,142,142,142,142
Merced,60,2023-02-06,166,166,166,0,1892,1898,1897,1,12,0,0,0,903,903,903,903
Modoc,60,2023-02-06,2,2,2,0,6,7,6,1,0,0,0,0,11,11,11,11
Mono,60,2023-02-06,4,4,4,0,93,94,93,1,0,0,0,0,8,8,8,8
Monterey,60,2023-02-06,227,227,227,0,2944,2954,2953,1,22,3,3,1,800,800,797,797
Napa,60,2023-02-06,110,110,110,0,1404,1409,1408,1,4,0,0,3,163,163,163,163
Nevada,60,2023-02-06,32,32,32,0,572,573,572,1,4,0,0,0,137,137,137,137
Orange,60,2023-02-06,1316,1322,1322,0,22395,22466,22465,1,154,24,24,20,7981,7981,7957,7957
Placer,60,2023-02-06,164,164,164,0,2656,2665,2664,1,41,0,0,4,682,682,682,682
Plumas,60,2023-02-06,2,2,2,0,72,73,72,1,0,1,1,0,15,15,14,14
Riverside,60,2023-02-06,1128,1132,1132,0,15537,15586,15585,1,89,5,5,14,6819,6819,6814,6814
Sacramento,60,2023-02-06,732,733,733,0,13191,13233,13232,1,96,5,5,19,3531,3531,3526,3526
San Benito,60,2023-02-06,50,50,50,0,538,539,538,1,1,0,0,0,113,113,113,113
San Bernardino,60,2023-02-06,1081,1083,1083,0,17443,17497,17496,1,152,0,0,17,8143,8143,8143,8143
San Diego,60,2023-02-06,1877,1884,1884,0,30143,30239,30238,1,230,11,11,23,5804,5804,5793,5793
San Francisco,60,2023-02-06,573,573,573,0,10548,10582,10581,1,58,3,3,2,1173,1173,1170,1170
San Joaquin,60,2023-02-06,436,436,436,0,6945,6968,6967,1,32,1,1,3,2428,2428,2427,2427
San Luis Obispo,60,2023-02-06,150,150,150,0,1906,1912,1911,1,7,1,1,0,563,563,562,562
San Mateo,60,2023-02-06,530,530,530,0,8197,8225,8224,1,42,0,0,1,747,747,747,747
Santa Barbara,60,2023-02-06,239,239,239,0,4366,4380,4379,1,21,1,1,0,759,759,758,758
Santa Clara,60,2023-02-06,1304,1309,1309,0,23539,23614,23613,1,123,11,11,23,2725,2725,2714,2714
Santa Cruz,60,2023-02-06,232,232,232,0,10398,10433,10432,1,11,0,0,0,276,276,276,276
Shasta,60,2023-02-06,24,24,24,0,660,661,660,1,9,0,0,0,612,612,612,612
Siskiyou,60,2023-02-06,11,11,11,0,221,222,221,1,0,0,0,0,96,96,96,96
Solano,60,2023-02-06,288,288,288,0,3852,3866,3865,1,41,0,0,5,475,475,475,475
Sonoma,60,2023-02-06,268,268,268,0,3566,3579,3578,1,17,3,3,1,555,555,552,552
Stanislaus,60,2023-02-06,277,277,277,0,3929,3942,3941,1,54,1,1,6,1841,1841,1840,1840
Sutter,60,2023-02-06,50,50,50,0,706,708,707,1,0,0,0,0,240,240,240,240
Tehama,60,2023-02-06,17,17,17,0,344,345,344,1,2,0,0,0,233,233,233,233
Trinity,60,2023-02-06,1,1,1,0,19,20,19,1,0,0,0,0,25,25,25,25
Tulare,60,2023-02-06,270,270,270,0,4386,4401,4400,1,28,2,2,3,1585,1585,1583,1583
Tuolumne,60,2023-02-06,48,48,48,0,556,557,556,1,1,0,0,0,211,211,211,211
Ventura,60,2023-02-06,326,326,326,0,6938,6961,6960,1,39,1,1,5,1671,1671,1670,1670
Yolo,60,2023-02-06,79,79,79,0,1255,1261,1260,1,4,1,1,2,445,445,444,444
Yuba,60,2023-02-06,22,22,22,0,623,624,623,1,3,0,0,1,134,134,134,134
Alameda,61,2023-02-13,1121,1126,1126,0,17649,17710,17709,1,90,2,2,8,2117,2117,2115,2115
Amador,61,2023-02-13,19,19,19,0,497,498,497,1,0,0,0,0,98,98,98,98
Butte,61,2023-02-13,87,87,87,0,1252,1258,1257,1,25,1,1,2,491,491,490,490
Calaveras,61,2023-02-13,14,14,14,0,296,297,296,1,0,0,0,0,140,140,140,140
Colusa,61,2023-02-13,8,8,8,0,136,137,136,1,0,0,0,0,22,22,22,22
Contra Costa,61,2023-02-13,700,700,700,0,11540,11580,11579,1,44,2,2,10,1559,1559,1557,1557
Del Norte,61,2023-02-13,19,19,19,0,299,300,299,1,2,0,0,0,59,59,59,59
El Dorado,61,2023-02-13,65,65,65,0,1101,1106,1105,1,2,0,0,0,245,245,245,245
Fresno,61,2023-02-13,471,471,471,0,8746,8777,8776,1,106,4,4,7,3001,3001,2997,2997
Glenn,61,2023-02-13,11,11,11,0,175,176,175,1,5,0,0,0,56,56,56,56
Humboldt,61,2023-02-13,40,40,40,0,578,579,578,1,7,0,0,1,170,170,170,170
Imperial,61,2023-02-13,142,142,142,0,1855,1862,1861,1,3,1,1,5,980,980,979,979
Inyo,61,2023-02-13,5,5,5,0,200,201,200,1,0,0,0,0,63,63,63,63
Kern,61,2023-02-13,326,326,326,0,8271,8301,8300,1,37,2,2,6,2484,2484,2482,2482
Kings,61,2023-02-13,89,89,89,0,1902,1910,1909,1,6,1,1,0,483,483,482,482
Lake,61,2023-02-13,20,20,20,0,568,569,568,1,2,0,0,0,161,161,161,161
Lassen,61,2023-02-13,5,5,5,0,361,362,361,1,0,0,0,0,65,65,65,65
Los Angeles,61,2023-02-13,5915,5935,5935,0,130465,130920,130919,1,613,78,78,67,35497,35497,35419,35419
Madera,61,2023-02-13,60,60,60,0,1240,1247,1246,1,7,0,0,2,377,377,377,377
Marin,61,2023-02-13,143,143,143,0,1932,1939,1938,1,19,0,0,3,260,260,260,260
Mariposa,61,2023-02-13,3,3,3,0,102,103,102,1,0,0,0,0,31,31,31,31
Mendocino,61,2023-02-13,28,28,28,0,538,539,538,1,3,2,2,1,144,144,142,142
Merced,61,2023-02-13,167,167,167,0,1901,1908,1907,1,8,0,0,0,903,903,903,903
Modoc,61,2023-02-13,0,0,0,0,2,3,2,1,0,0,0,0,11,11,11,11
Mono,61,2023-02-13,1,1,1,0,66,67,66,1,0,0,0,0,8,8,8,8
Monterey,61,2023-02-13,224,224,224,0,2493,2503,2502,1,25,3,3,1,803,803,800,800
Napa,61,2023-02-13,92,92,92,0,1364,1370,1369,1,4,1,1,0,164,164,163,163
Nevada,61,2023-02-13,37,37,37,0,596,597,596,1,4,0,0,1,137,137,137,137
Orange,61,2023-02-13,1395,1401,1401,0,20636,20707,20706,1,161,13,13,21,7994,7994,7981,7981
Placer,61,2023-02-13,161,161,161,0,2613,2623,2622,1,35,0,0,6,682,682,682,682
Plumas,61,2023-02-13,3,3,3,0,80,81,80,1,1,0,0,0,15,15,15,15
Riverside,61,2023-02-13,1090,1095,1095,0,16110,16167,16166,1,93,7,7,16,6826,6826,6819,6819
Sacramento,61,2023-02-13,810,811,811,0,13052,13098,13097,1,113,5,5,19,3536,3536,3531,3531
San Benito,61,2023-02-13,43,43,43,0,566,567,566,1,1,0,0,0,113,113,113,113
San Bernardino,61,2023-02-13,1021,1024,1024,0,16941,17000,16999,1,134,0,0,18,8143,8143,8143,8143
San Diego,61,2023-02-13,2031,2038,2038,0,29306,29408,29407,1,218,5,5,25,5809,5809,5804,5804
San Francisco,61,2023-02-13,593,593,593,0,10695,10733,10732,1,59,3,3,5,1176,1176,1173,1173
San Joaquin,61,2023-02-13,458,458,458,0,6989,7015,7014,1,28,1,1,3,2429,2429,2428,2428
San Luis Obispo,61,2023-02-13,133,133,133,0,1683,1689,1688,1,4,1,1,4,564,564,563,563
San Mateo,61,2023-02-13,522,522,522,0,8200,8231,8230,1,29,0,0,5,747,747,747,747
Santa Barbara,61,2023-02-13,188,188,188,0,3937,3950,3949,1,16,1,1,5,760,760,759,759
Santa Clara,61,2023-02-13,1368,1373,1373,0,23162,23243,23242,1,114,10,10,25,2735,2735,2725,2725
Santa Cruz,61,2023-02-13,206,206,206,0,9624,9658,9657,1,19,0,0,0,276,276,276,276
Shasta,61,2023-02-13,33,33,33,0,675,677,676,1,7,0,0,0,612,612,612,612
Siskiyou,61,2023-02-13,11,11,11,0,199,200,199,1,0,0,0,0,96,96,96,96
Solano,61,2023-02-13,260,260,260,0,3774,3788,3787,1,28,0,0,3,475,475,475,475
Sonoma,61,2023-02-13,230,230,230,0,3423,3436,3435,1,32,1,1,1,556,556,555,555
Stanislaus,61,2023-02-13,268,268,268,0,3861,3875,3874,1,47,1,1,9,1842,1842,1841,1841
Sutter,61,2023-02-13,46,46,46,0,658,660,659,1,0,1,1,0,241,241,240,240
Tehama,61,2023-02-13,16,16,16,0,346,347,346,1,1,2,2,0,235,235,233,233
Trinity,61,2023-02-13,1,1,1,0,26,27,26,1,0,0,0,0,25,25,25,25
Tulare,61,2023-02-13,247,247,247,0,4117,4133,4132,1,29,3,3,1,1588,1588,1585,1585
Tuolumne,61,2023-02-13,37,37,37,0,508,509,508,1,2,0,0,0,211,211,211,211
Ventura,61,2023-02-13,316,316,316,0,6668,6693,6692,1,29,5,5,6,1676,1676,1671,1671
Yolo,61,2023-02-13,75,75,75,0,1249,1254,1253,1,3,0,0,1,445,445,445,445
Yuba,61,2023-02-13,31,31,31,0,643,644,643,1,8,0,0,0,134,134,134,134
Alameda,62,2023-02-20,1021,1026,1026,0,15465,15526,15525,1,79,3,3,5,2120,2120,2117,2117
Amador,62,2023-02-20,25,25,25,0,497,498,497,1,1,0,0,1,98,98,98,98
Butte,62,2023-02-20,43,43,43,0,1051,1057,1056,1,7,2,2,1,493,493,491,491
Calaveras,62,2023-02-20,17,17,17,0,290,291,290,1,0,0,0,1,140,140,140,140
Colusa,62,2023-02-20,12,12,12,0,92,93,92,1,0,0,0,0,22,22,22,22
Contra Costa,62,2023-02-20,664,664,664,0,10002,10043,10042,1,57,5,5,6,1564,1564,1559,1559
Del Norte,62,2023-02-20,11,11,11,0,258,259,258,1,2,0,0,0,59,59,59,59
El Dorado,62,2023-02-20,51,51,51,0,976,982,981,1,2,1,1,1,246,246,245,245
Fresno,62,2023-02-20,455,455,455,0,8236,8268,8267,1,84,5,5,17,3006,3006,3001,3001
Glenn,62,2023-02-20,5,5,5,0,146,147,146,1,5,0,0,0,56,56,56,56
Humboldt,62,2023-02-20,35,35,35,0,576,577,576,1,7,0,0,1,170,170,170,170
Imperial,62,2023-02-20,122,122,122,0,1780,1788,1787,1,8,0,0,0,980,980,980,980
Inyo,62,2023-02-20,6,6,6,0,162,163,162,1,0,0,0,0,63,63,63,63
Kern,62,2023-02-20,400,400,400,0,7482,7512,7511,1,29,3,3,5,2487,2487,2484,2484
Kings,62,2023-02-20,77,77,77,0,1641,1648,1647,1,5,1,1,0,484,484,483,483
Lake,62,2023-02-20,19,19,19,0,483,484,483,1,2,1,1,1,162,162,161,161
Lassen,62,2023-02-20,1,1,1,0,328,329,328,1,0,0,0,0,65,65,65,65
Los Angeles,62,2023-02-20,5659,5681,5681,0,118522,118991,118990,1,601,82,82,76,35579,35579,35497,35497
Madera,62,2023-02-20,61,61,61,0,1092,1098,1097,1,3,0,0,2,377,377,377,377
Marin,62,2023-02-20,153,153,153,0,1858,1866,1865,1,13,0,0,2,260,260,260,260
Mariposa,62,2023-02-20,6,6,6,0,121,122,121,1,0,0,0,0,31,31,31,31
Mendocino,62,2023-02-20,25,25,25,0,489,490,489,1,3,0,0,0,144,144,144,144
Merced,62,2023-02-20,122,122,122,0,1762,1770,1769,1,19,0,0,1,903,903,903,903
Modoc,62,2023-02-20,1,1,1,0,15,16,15,1,0,0,0,0,11,11,11,11
Mono,62,2023-02-20,2,2,2,0,67,68,67,1,0,0,0,0,8,8,8,8
Monterey,62,2023-02-20,157,157,157,0,2322,2332,2331,1,22,0,0,0,803,803,803,803
Napa,62,2023-02-20,78,78,78,0,1085,1091,1090,1,3,1,1,1,165,165,164,164
Nevada,62,2023-02-20,28,28,28,0,611,612,611,1,7,1,1,1,138,138,137,137
Orange,62,2023-02-20,1348,1354,1354,0,19441,19518,19517,1,158,20,20,21,8014,8014,7994,7994
Placer,62,2023-02-20,162,162,162,0,2423,2433,2432,1,48,1,1,3,683,683,682,682
Plumas,62,2023-02-20,8,8,8,0,75,76,75,1,0,0,0,0,15,15,15,15
Riverside,62,2023-02-20,991,996,996,0,15229,15288,15287,1,92,7,7,9,6833,6833,6826,6826
Sacramento,62,2023-02-20,731,732,732,0,11566,11612,11611,1,103,13,13,16,3549,3549,3536,3536
San Benito,62,2023-02-20,28,28,28,0,477,478,477,1,1,2,2,0,115,115,113,113
San Bernardino,62,2023-02-20,903,907,907,0,15188,15251,15250,1,117,0,0,27,8143,8143,8143,8143
San Diego,62,2023-02-20,1764,1771,1771,0,25420,25522,25521,1,201,7,7,25,5816,5816,5809,5809
San Francisco,62,2023-02-20,591,591,591,0,9956,9994,9993,1,79,0,0,7,1176,1176,1176,1176
San Joaquin,62,2023-02-20,414,414,414,0,7393,7424,7423,1,30,1,1,7,2430,2430,2429,2429
San Luis Obispo,62,2023-02-20,96,96,96,0,1435,1442,1441,1,11,0,0,0,564,564,564,564
San Mateo,62,2023-02-20,467,467,467,0,7437,7468,7467,1,44,0,0,3,747,747,747,747
Santa Barbara,62,2023-02-20,206,206,206,0,3630,3646,3645,1,18,0,0,5,760,760,760,760
Santa Clara,62,2023-02-20,1216,1223,1223,0,19608,19686,19685,1,111,13,13,26,2748,2748,2735,2735
Santa Cruz,62,2023-02-20,136,136,136,0,6263,6289,6288,1,20,0,0,2,276,276,276,276
Shasta,62,2023-02-20,18,18,18,0,729,733,732,1,2,0,0,0,612,612,612,612
Siskiyou,62,2023-02-20,14,14,14,0,198,199,198,1,0,0,0,0,96,96,96,96
Solano,62,2023-02-20,229,229,229,0,3265,3277,3276,1,26,0,0,3,475,475,475,475
Sonoma,62,2023-02-20,265,265,265,0,3201,3214,3213,1,24,1,1,4,557,557,556,556
Stanislaus,62,2023-02-20,271,271,271,0,3890,3906,3905,1,55,0,0,4,1842,1842,1842,1842
Sutter,62,2023-02-20,38,38,38,0,540,541,540,1,0,1,1,0,242,242,241,241
Tehama,62,2023-02-20,13,13,13,0,279,280,279,1,0,0,0,0,235,235,235,235
Trinity,62,2023-02-20,0,0,0,0,30,31,30,1,0,0,0,0,25,25,25,25
Tulare,62,2023-02-20,214,214,214,0,3795,3811,3810,1,23,0,0,0,1588,1588,1588,1588
Tuolumne,62,2023-02-20,32,32,32,0,446,447,446,1,0,0,0,0,211,211,211,211
Ventura,62,2023-02-20,283,283,283,0,5627,5650,5649,1,30,4,4,7,1680,1680,1676,1676
Yolo,62,2023-02-20,87,87,87,0,1282,1289,1288,1,1,2,2,1,447,447,445,445
Yuba,62,2023-02-20,25,25,25,0,509,510,509,1,6,0,0,0,134,134,134,134
Alameda,63,2023-02-27,1128,1134,1134,0,18655,18736,18735,1,96,5,5,9,2125,2125,2120,2120
Amador,63,2023-02-27,19,19,19,0,521,522,521,1,1,0,0,1,98,98,98,98
Butte,63,2023-02-27,56,56,56,0,949,954,953,1,8,1,1,1,494,494,493,493
Calaveras,63,2023-02-27,15,15,15,0,306,307,306,1,1,0,0,0,140,140,140,140
Colusa,63,2023-02-27,12,12,12,0,85,86,85,1,0,0,0,0,22,22,22,22
Contra Costa,63,2023-02-27,721,723,723,0,11456,11506,11505,1,63,4,4,11,1568,1568,1564,1564
Del Norte,63,2023-02-27,7,7,7,0,288,289,288,1,0,0,0,0,59,59,59,59
El Dorado,63,2023-02-27,61,61,61,0,1039,1045,1044,1,2,1,1,0,247,247,246,246
Fresno,63,2023-02-27,470,470,470,0,9009,9049,9048,1,93,2,2,7,3008,3008,3006,3006
Glenn,63,2023-02-27,4,4,4,0,144,145,144,1,1,0,0,0,56,56,56,56
Humboldt,63,2023-02-27,29,29,29,0,490,491,490,1,4,0,0,1,170,170,170,170
Imperial,63,2023-02-27,174,174,174,0,1831,1839,1838,1,13,0,0,0,980,980,980,980
Inyo,63,2023-02-27,4,4,4,0,156,157,156,1,0,0,0,0,63,63,63,63
Kern,63,2023-02-27,399,399,399,0,8257,8294,8293,1,42,3,3,7,2490,2490,2487,2487
Kings,63,2023-02-27,61,61,61,0,1687,1696,1695,1,4,1,1,0,485,485,484,484
Lake,63,2023-02-27,21,21,21,0,465,466,465,1,2,1,1,1,163,163,162,162
Lassen,63,2023-02-27,3,3,3,0,353,354,353,1,0,0,0,0,65,65,65,65
Los Angeles,63,2023-02-27,5366,5389,5389,0,134917,135506,135504,2,573,72,72,75,35651,35651,35579,35579
Madera,63,2023-02-27,62,62,62,0,1187,1195,1194,1,7,0,0,1,377,377,377,377
Marin,63,2023-02-27,145,145,145,0,1966,1976,1975,1,16,0,0,3,260,260,260,260
Mariposa,63,2023-02-27,7,7,7,0,97,98,97,1,0,0,0,0,31,31,31,31
Mendocino,63,2023-02-27,21,21,21,0,492,493,492,1,5,1,1,1,145,145,144,144
Merced,63,2023-02-27,126,126,126,0,1920,1930,1929,1,19,0,0,1,903,903,903,903
Modoc,63,2023-02-27,1,1,1,0,8,9,8,1,0,0,0,0,11,11,11,11
Mono,63,2023-02-27,5,5,5,0,52,53,52,1,0,0,0,0,8,8,8,8
Monterey,63,2023-02-27,182,182,182,0,2581,2593,2592,1,30,2,2,1,805,805,803,803
Napa,63,2023-02-27,79,79,79,0,1317,1323,1322,1,7,2,2,4,167,167,165,165
Nevada,63,2023-02-27,25,25,25,0,566,568,567,1,2,0,0,0,138,138,138,138
Orange,63,2023-02-27,1208,1213,1213,0,19661,19746,19745,1,161,21,21,21,8035,8035,8014,8014
Placer,63,2023-02-27,178,178,178,0,2568,2581,2580,1,44,0,0,7,683,683,683,683
Plumas,63,2023-02-27,3,3,3,0,88,89,88,1,0,0,0,0,15,15,15,15
Riverside,63,2023-02-27,914,918,918,0,15489,15556,15555,1,76,7,7,15,6840,6840,6833,6833
Sacramento,63,2023-02-27,928,933,933,0,12788,12845,12844,1,121,6,6,19,3555,3555,3549,3549
San Benito,63,2023-02-27,29,29,29,0,473,474,473,1,2,0,0,0,115,115,115,115
San Bernardino,63,2023-02-27,868,873,873,0,16336,16409,16408,1,111,0,0,24,8143,8143,8143,8143
San Diego,63,2023-02-27,1811,1819,1819,0,27632,27755,27754,1,210,8,8,21,5824,5824,5816,5816
San Francisco,63,2023-02-27,654,655,655,0,11677,11727,11726,1,76,6,6,8,1182,1182,1176,1176
San Joaquin,63,2023-02-27,419,419,419,0,7555,7589,7588,1,33,3,3,3,2433,2433,2430,2430
San Luis Obispo,63,2023-02-27,83,83,83,0,1670,1679,1678,1,11,2,2,0,566,566,564,564
San Mateo,63,2023-02-27,480,480,480,0,7514,7549,7548,1,43,0,0,4,747,747,747,747
Santa Barbara,63,2023-02-27,176,176,176,0,3562,3579,3578,1,18,2,2,8,762,762,760,760
Santa Clara,63,2023-02-27,1332,1339,1339,0,21668,21763,21762,1,126,12,12,26,2760,2760,2748,2748
Santa Cruz,63,2023-02-27,160,160,160,0,8755,8793,8792,1,7,0,0,1,276,276,276,276
Shasta,63,2023-02-27,37,37,37,0,656,659,658,1,9,0,0,1,612,612,612,612
Siskiyou,63,2023-02-27,11,11,11,0,235,236,235,1,0,0,0,0,96,96,96,96
Solano,63,2023-02-27,297,297,297,0,3683,3699,3698,1,30,0,0,8,475,475,475,475
Sonoma,63,2023-02-27,213,213,213,0,3410,3425,3424,1,33,1,1,5,558,558,557,557
Stanislaus,63,2023-02-27,244,244,244,0,3866,3882,3881,1,58,0,0,3,1842,1842,1842,1842
Sutter,63,2023-02-27,46,46,46,0,503,504,503,1,0,0,0,0,242,242,242,242
Tehama,63,2023-02-27,14,14,14,0,267,268,267,1,2,0,0,1,235,235,235,235
Trinity,63,2023-02-27,0,0,0,0,20,21,20,1,0,0,0,0,25,25,25,25
Tulare,63,2023-02-27,215,215,215,0,4010,4030,4029,1,22,3,3,2,1591,1591,1588,1588
Tuolumne,63,2023-02-27,40,40,40,0,472,474,473,1,0,0,0,1,211,211,211,211
Ventura,63,2023-02-27,275,275,275,0,5920,5946,5945,1,35,2,2,7,1682,1682,1680,1680
Yolo,63,2023-02-27,91,91,91,0,1370,1379,1378,1,3,2,2,1,449,449,447,447
Yuba,63,2023-02-27,36,36,36,0,508,509,508,1,0,0,0,0,134,134,134,134
Alameda,64,2023-03-06,930,935,935,0,16830,16913,16912,1,96,4,4,12,2129,2129,2125,2125
Amador,64,2023-03-06,14,14,14,0,474,476,475,1,0,0,0,0,98,98,98,98
Butte,64,2023-03-06,36,36,36,0,595,598,597,1,5,1,1,0,495,495,494,494
Calaveras,64,2023-03-06,19,19,19,0,281,282,281,1,0,2,2,0,142,142,140,140
Colusa,64,2023-03-06,13,13,13,0,162,163,162,1,0,0,0,0,22,22,22,22
Contra Costa,64,2023-03-06,691,694,694,0,10361,10412,10411,1,64,3,3,8,1571,1571,1568,1568
Del Norte,64,2023-03-06,6,6,6,0,253,254,253,1,1,2,2,1,61,61,59,59
El Dorado,64,2023-03-06,52,52,52,0,963,969,968,1,2,0,0,0,247,247,247,247
Fresno,64,2023-03-06,391,391,391,0,8041,8080,8079,1,77,5,5,16,3013,3013,3008,3008
Glenn,64,2023-03-06,4,4,4,0,165,166,165,1,0,0,0,0,56,56,56,56
Humboldt,64,2023-03-06,23,23,23,0,491,493,492,1,1,0,0,1,170,170,170,170
Imperial,64,2023-03-06,168,168,168,0,1625,1634,1633,1,9,0,0,0,980,980,980,980
Inyo,64,2023-03-06,4,4,4,0,136,137,136,1,1,0,0,0,63,63,63,63
Kern,64,2023-03-06,329,329,329,0,8008,8048,8047,1,35,3,3,4,2493,2493,2490,2490
Kings,64,2023-03-06,65,65,65,0,1573,1583,1582,1,1,0,0,0,485,485,485,485
Lake,64,2023-03-06,19,19,19,0,490,491,490,1,1,0,0,0,163,163,163,163
Lassen,64,2023-03-06,4,4,4,0,317,318,317,1,1,0,0,0,65,65,65,65
Los Angeles,64,2023-03-06,4691,4713,4713,0,127257,127878,127877,1,509,68,68,60,35719,35719,35651,35651
Madera,64,2023-03-06,82,82,82,0,1162,1169,1168,1,5,0,0,0,377,377,377,377
Marin,64,2023-03-06,140,140,140,0,1781,1791,1790,1,21,0,0,2,260,260,260,260
Mariposa,64,2023-03-06,0,0,0,0,69,70,69,1,0,0,0,0,31,31,31,31
Mendocino,64,2023-03-06,26,26,26,0,452,454,453,1,7,0,0,1,145,145,145,145
Merced,64,2023-03-06,159,159,159,0,2188,2200,2199,1,14,0,0,2,903,903,903,903
Modoc,64,2023-03-06,1,1,1,0,9,10,9,1,0,0,0,0,11,11,11,11
Mono,64,2023-03-06,5,5,5,0,57,58,57,1,0,0,0,0,8,8,8,8
Monterey,64,2023-03-06,145,145,145,0,2185,2196,2195,1,29,4,4,3,809,809,805,805
Napa,64,2023-03-06,52,52,52,0,1058,1064,1063,1,9,1,1,2,168,168,167,167
Nevada,64,2023-03-06,18,18,18,0,487,489,488,1,2,0,0,0,138,138,138,138
Orange,64,2023-03-06,1001,1006,1006,0,19199,19292,19291,1,111,18,18,18,8053,8053,8035,8035
Placer,64,2023-03-06,172,172,172,0,2472,2485,2484,1,62,0,0,5,683,683,683,683
Plumas,64,2023-03-06,1,1,1,0,70,71,70,1,0,0,0,0,15,15,15,15
Riverside,64,2023-03-06,883,888,888,0,14570,14640,14639,1,78,3,3,8,6843,6843,6840,6840
Sacramento,64,2023-03-06,864,869,869,0,12164,12225,12224,1,113,6,6,6,3561,3561,3555,3555
San Benito,64,2023-03-06,16,16,16,0,473,474,473,1,1,0,0,0,115,115,115,115
San Bernardino,64,2023-03-06,748,752,752,0,15465,15541,15540,1,99,0,0,18,8143,8143,8143,8143
San Diego,64,2023-03-06,1409,1416,1416,0,25630,25756,25755,1,179,12,12,13,5836,5836,5824,5824
San Francisco,64,2023-03-06,600,601,601,0,10827,10879,10878,1,73,5,5,11,1187,1187,1182,1182
San Joaquin,64,2023-03-06,385,385,385,0,8557,8599,8598,1,42,1,1,8,2434,2434,2433,2433
San Luis Obispo,64,2023-03-06,92,92,92,0,1318,1326,1325,1,9,4,4,0,570,570,566,566
San Mateo,64,2023-03-06,425,425,425,0,7312,7348,7347,1,28,0,0,3,747,747,747,747
Santa Barbara,64,2023-03-06,149,149,149,0,3686,3705,3704,1,18,2,2,1,764,764,762,762
Santa Clara,64,2023-03-06,1080,1086,1086,0,21458,21563,21562,1,133,9,9,32,2769,2769,2760,2760
Santa Cruz,64,2023-03-06,133,133,133,0,5135,5162,5161,1,20,0,0,0,276,276,276,276
Shasta,64,2023-03-06,24,24,24,0,646,649,648,1,5,0,0,2,612,612,612,612
Siskiyou,64,2023-03-06,6,6,6,0,225,226,225,1,1,0,0,0,96,96,96,96
Solano,64,2023-03-06,256,256,256,0,3368,3386,3385,1,34,0,0,5,475,475,475,475
Sonoma,64,2023-03-06,210,210,210,0,3234,3250,3249,1,23,0,0,2,558,558,558,558
Stanislaus,64,2023-03-06,260,260,260,0,3795,3815,3814,1,67,0,0,9,1842,1842,1842,1842
Sutter,64,2023-03-06,35,35,35,0,596,598,597,1,0,0,0,0,242,242,242,242
Tehama,64,2023-03-06,12,12,12,0,252,253,252,1,5,0,0,1,235,235,235,235
Trinity,64,2023-03-06,2,2,2,0,18,19,18,1,0,0,0,0,25,25,25,25
Tulare,64,2023-03-06,209,209,209,0,3276,3294,3293,1,29,0,0,3,1591,1591,1591,1591
Tuolumne,64,2023-03-06,37,37,37,0,409,410,409,1,1,0,0,0,211,211,211,211
Ventura,64,2023-03-06,252,252,252,0,4992,5016,5015,1,42,2,2,5,1684,1684,1682,1682
Yolo,64,2023-03-06,64,64,64,0,1309,1317,1316,1,4,1,1,0,450,450,449,449
Yuba,64,2023-03-06,38,38,38,0,511,512,511,1,7,0,0,0,134,134,134,134
Alameda,65,2023-03-13,860,866,866,0,15721,15805,15804,1,76,2,2,18,2131,2131,2129,2129
Amador,65,2023-03-13,13,13,13,0,402,403,402,1,5,0,0,1,98,98,98,98
Butte,65,2023-03-13,38,38,38,0,615,619,618,1,9,1,1,1,496,496,495,495
Calaveras,65,2023-03-13,14,14,14,0,263,264,263,1,0,0,0,0,142,142,142,142
Colusa,65,2023-03-13,4,4,4,0,161,162,161,1,0,1,1,0,23,23,22,22
Contra Costa,65,2023-03-13,582,584,584,0,10048,10101,10100,1,44,2,2,7,1573,1573,1571,1571
Del Norte,65,2023-03-13,8,8,8,0,256,257,256,1,1,0,0,0,61,61,61,61
El Dorado,65,2023-03-13,47,47,47,0,908,914,913,1,1,0,0,0,247,247,247,247
Fresno,65,2023-03-13,384,384,384,0,7826,7868,7867,1,79,0,0,10,3013,3013,3013,3013
Glenn,65,2023-03-13,10,10,10,0,143,144,143,1,0,0,0,0,56,56,56,56
Humboldt,65,2023-03-13,28,28,28,0,507,509,508,1,4,0,0,1,170,170,170,170
Imperial,65,2023-03-13,215,215,215,0,2046,2057,2056,1,12,1,1,0,981,981,980,980
Inyo,65,2023-03-13,0,0,0,0,259,260,259,1,0,0,0,0,63,63,63,63
Kern,65,2023-03-13,340,340,340,0,7838,7879,7878,1,52,0,0,12,2493,2493,2493,2493
Kings,65,2023-03-13,60,60,60,0,1449,1458,1457,1,1,0,0,0,485,485,485,485
Lake,65,2023-03-13,11,11,11,0,422,423,422,1,1,0,0,0,163,163,163,163
Lassen,65,2023-03-13,6,6,6,0,354,355,354,1,0,0,0,0,65,65,65,65
Los Angeles,65,2023-03-13,4135,4156,4156,0,129363,130045,130044,1,418,70,70,56,35789,35789,35719,35719
Madera,65,2023-03-13,52,52,52,0,1192,1200,1199,1,6,0,0,0,377,377,377,377
Marin,65,2023-03-13,99,99,99,0,1727,1737,1736,1,21,0,0,1,260,260,260,260
Mariposa,65,2023-03-13,5,5,5,0,93,94,93,1,0,0,0,0,31,31,31,31
Mendocino,65,2023-03-13,18,18,18,0,462,463,462,1,6,0,0,1,145,145,145,145
Merced,65,2023-03-13,108,108,108,0,2112,2125,2124,1,12,0,0,2,903,903,903,903
Modoc,65,2023-03-13,1,1,1,0,12,13,12,1,0,0,0,0,11,11,11,11
Mono,65,2023-03-13,1,1,1,0,51,52,51,1,0,0,0,0,8,8,8,8
Monterey,65,2023-03-13,72,72,72,0,1843,1853,1852,1,27,0,0,2,809,809,809,809
Napa,65,2023-03-13,55,55,55,0,942,948,947,1,4,3,3,2,171,171,168,168
Nevada,65,2023-03-13,18,18,18,0,481,483,482,1,4,0,0,0,138,138,138,138
Orange,65,2023-03-13,915,920,920,0,18482,18581,18580,1,129,28,28,21,8081,8081,8053,8053
Placer,65,2023-03-13,168,168,168,0,2162,2175,2174,1,66,0,0,8,683,683,683,683
Plumas,65,2023-03-13,5,5,5,0,70,71,70,1,0,0,0,0,15,15,15,15
Riverside,65,2023-03-13,909,914,914,0,15612,15693,15692,1,79,6,6,14,6849,6849,6843,6843
Sacramento,65,2023-03-13,715,720,720,0,11551,11612,11611,1,105,7,7,21,3568,3568,3561,3561
San Benito,65,2023-03-13,13,13,13,0,415,417,416,1,0,0,0,0,115,115,115,115
San Bernardino,65,2023-03-13,720,724,724,0,15903,15988,15987,1,94,0,0,20,8143,8143,8143,8143
San Diego,65,2023-03-13,1316,1323,1323,0,24412,24540,24539,1,177,10,10,13,5846,5846,5836,5836
San Francisco,65,2023-03-13,550,552,552,0,9532,9583,9582,1,73,3,3,14,1190,1190,1187,1187
San Joaquin,65,2023-03-13,421,421,421,0,9666,9718,9717,1,34,4,4,6,2438,2438,2434,2434
San Luis Obispo,65,2023-03-13,79,79,79,0,1339,1348,1347,1,9,0,0,0,570,570,570,570
San Mateo,65,2023-03-13,372,372,372,0,6780,6816,6815,1,24,0,0,5,747,747,747,747
Santa Barbara,65,2023-03-13,149,149,149,0,3421,3440,3439,1,12,0,0,1,764,764,764,764
Santa Clara,65,2023-03-13,1060,1067,1067,0,21445,21558,21557,1,139,12,12,20,2781,2781,2769,2769
Santa Cruz,65,2023-03-13,109,109,109,0,3230,3249,3248,1,21,0,0,1,276,276,276,276
Shasta,65,2023-03-13,27,27,27,0,598,602,601,1,6,0,0,1,612,612,612,612
Siskiyou,65,2023-03-13,10,10,10,0,162,163,162,1,0,0,0,0,96,96,96,96
Solano,65,2023-03-13,232,232,232,0,3140,3158,3157,1,27,0,0,4,475,475,475,475
Sonoma,65,2023-03-13,193,193,193,0,2829,2845,2844,1,41,3,3,4,561,561,558,558
Stanislaus,65,2023-03-13,203,203,203,0,3948,3970,3969,1,52,0,0,4,1842,1842,1842,1842
Sutter,65,2023-03-13,27,27,27,0,523,525,524,1,0,0,0,0,242,242,242,242
Tehama,65,2023-03-13,17,17,17,0,231,232,231,1,1,0,0,0,235,235,235,235
Trinity,65,2023-03-13,0,0,0,0,22,23,22,1,0,0,0,0,25,25,25,25
Tulare,65,2023-03-13,164,164,164,0,3319,3338,3337,1,31,3,3,2,1594,1594,1591,1591
Tuolumne,65,2023-03-13,18,18,18,0,384,385,384,1,2,0,0,0,211,211,211,211
Ventura,65,2023-03-13,230,230,230,0,4396,4420,4419,1,25,4,4,5,1688,1688,1684,1684
Yolo,65,2023-03-13,72,72,72,0,1152,1160,1159,1,2,1,1,0,451,451,450,450
Yuba,65,2023-03-13,34,34,34,0,477,479,478,1,7,0,0,0,134,134,134,134
Alameda,66,2023-03-20,765,770,770,0,15310,15404,15403,1,69,7,7,10,2138,2138,2131,2131
Amador,66,2023-03-20,18,18,18,0,419,421,420,1,3,0,0,1,98,98,98,98
Butte,66,2023-03-20,44,44,44,0,511,514,513,1,5,1,1,3,497,497,496,496
Calaveras,66,2023-03-20,9,9,9,0,270,271,270,1,0,0,0,0,142,142,142,142
Colusa,66,2023-03-20,4,4,4,0,155,156,155,1,0,0,0,0,23,23,23,23
Contra Costa,66,2023-03-20,435,435,435,0,9631,9691,9690,1,31,6,6,8,1579,1579,1573,1573
Del Norte,66,2023-03-20,2,2,2,0,225,226,225,1,0,0,0,1,61,61,61,61
El Dorado,66,2023-03-20,46,46,46,0,862,868,867,1,2,0,0,0,247,247,247,247
Fresno,66,2023-03-20,371,371,371,0,7935,7983,7982,1,66,2,2,16,3015,3015,3013,3013
Glenn,66,2023-03-20,4,4,4,0,132,134,133,1,0,0,0,0,56,56,56,56
Humboldt,66,2023-03-20,21,21,21,0,481,483,482,1,4,0,0,2,170,170,170,170
Imperial,66,2023-03-20,158,158,158,0,1644,1655,1654,1,9,0,0,1,981,981,981,981
Inyo,66,2023-03-20,10,10,10,0,281,283,282,1,0,0,0,0,63,63,63,63
Kern,66,2023-03-20,206,206,206,0,8067,8116,8115,1,29,2,2,8,2495,2495,2493,2493
Kings,66,2023-03-20,40,40,40,0,1462,1472,1471,1,1,1,1,0,486,486,485,485
Lake,66,2023-03-20,12,12,12,0,410,412,411,1,2,0,0,0,163,163,163,163
Lassen,66,2023-03-20,4,4,4,0,334,335,334,1,0,0,0,0,65,65,65,65
Los Angeles,66,2023-03-20,3229,3249,3249,0,115938,116639,116638,1,397,60,60,44,35849,35849,35789,35789
Madera,66,2023-03-20,54,54,54,0,1145,1153,1152,1,4,0,0,0,377,377,377,377
Marin,66,2023-03-20,87,87,87,0,1529,1539,1538,1,25,0,0,2,260,260,260,260
Mariposa,66,2023-03-20,2,2,2,0,91,92,91,1,0,0,0,0,31,31,31,31
Mendocino,66,2023-03-20,11,11,11,0,426,429,428,1,2,0,0,0,145,145,145,145
Merced,66,2023-03-20,106,106,106,0,2110,2123,2122,1,6,0,0,2,903,903,903,903
Modoc,66,2023-03-20,1,1,1,0,10,11,10,1,0,0,0,0,11,11,11,11
Mono,66,2023-03-20,4,4,4,0,54,55,54,1,0,0,0,0,8,8,8,8
Monterey,66,2023-03-20,59,59,59,0,1479,1489,1488,1,21,0,0,1,809,809,809,809
Napa,66,2023-03-20,30,30,30,0,910,916,915,1,3,1,1,1,172,172,171,171
Nevada,66,2023-03-20,17,17,17,0,459,461,460,1,4,0,0,0,138,138,138,138
Orange,66,2023-03-20,745,751,751,0,16784,16885,16884,1,115,11,11,25,8092,8092,8081,8081
Placer,66,2023-03-20,124,124,124,0,2170,2184,2183,1,58,0,0,8,683,683,683,683
Plumas,66,2023-03-20,2,2,2,0,55,56,55,1,0,0,0,0,15,15,15,15
Riverside,66,2023-03-20,592,595,595,0,12810,12889,12888,1,57,1,1,7,6850,6850,6849,6849
Sacramento,66,2023-03-20,496,499,499,0,10461,10525,10524,1,85,4,4,16,3572,3572,3568,3568
San Benito,66,2023-03-20,41,41,41,0,567,570,569,1,0,1,1,0,116,116,115,115
San Bernardino,66,2023-03-20,527,530,530,0,15049,15142,15141,1,77,0,0,12,8143,8143,8143,8143
San Diego,66,2023-03-20,1121,1128,1128,0,23460,23602,23601,1,139,10,10,13,5856,5856,5846,5846
San Francisco,66,2023-03-20,421,422,422,0,9266,9323,9322,1,63,4,4,8,1194,1194,1190,1190
San Joaquin,66,2023-03-20,307,307,307,0,9152,9208,9207,1,28,6,6,5,2444,2444,2438,2438
San Luis Obispo,66,2023-03-20,48,48,48,0,1172,1181,1180,1,9,1,1,0,571,571,570,570
San Mateo,66,2023-03-20,309,309,309,0,6445,6486,6485,1,24,0,0,1,747,747,747,747
Santa Barbara,66,2023-03-20,111,111,111,0,3122,3142,3141,1,15,1,1,1,765,765,764,764
Santa Clara,66,2023-03-20,812,819,819,0,20125,20248,20247,1,151,9,9,22,2790,2790,2781,2781
Santa Cruz,66,2023-03-20,121,121,121,0,3084,3104,3103,1,9,0,0,1,276,276,276,276
Shasta,66,2023-03-20,18,18,18,0,583,587,586,1,2,0,0,3,612,612,612,612
Siskiyou,66,2023-03-20,4,4,4,0,164,165,164,1,0,0,0,0,96,96,96,96
Solano,66,2023-03-20,185,185,185,0,2938,2957,2956,1,26,1,1,5,476,476,475,475
Sonoma,66,2023-03-20,184,184,184,0,2735,2752,2751,1,33,0,0,1,561,561,561,561
Stanislaus,66,2023-03-20,202,202,202,0,3709,3731,3730,1,48,0,0,6,1842,1842,1842,1842
Sutter,66,2023-03-20,38,38,38,0,489,492,491,1,0,0,0,0,242,242,242,242
Tehama,66,2023-03-20,14,14,14,0,218,219,218,1,2,1,1,0,236,236,235,235
Trinity,66,2023-03-20,0,0,0,0,17,18,17,1,0,0,0,0,25,25,25,25
Tulare,66,2023-03-20,120,120,120,0,2705,2722,2721,1,25,1,1,0,1595,1595,1594,1594
Tuolumne,66,2023-03-20,15,15,15,0,405,407,406,1,0,0,0,0,211,211,211,211
Ventura,66,2023-03-20,176,176,176,0,4176,4202,4201,1,39,4,4,2,1692,1692,1688,1688
Yolo,66,2023-03-20,54,54,54,0,1124,1133,1132,1,6,0,0,1,451,451,451,451
Yuba,66,2023-03-20,18,18,18,0,465,467,466,1,7,0,0,0,134,134,134,134
Alameda,67,2023-03-27,593,598,598,0,13728,13827,13826,1,91,3,3,9,2141,2141,2138,2138
Amador,67,2023-03-27,10,10,10,0,374,376,375,1,3,0,0,1,98,98,98,98
Butte,67,2023-03-27,31,31,31,0,513,518,517,1,8,1,1,0,498,498,497,497
Calaveras,67,2023-03-27,12,12,12,0,271,272,271,1,0,1,1,0,143,143,142,142
Colusa,67,2023-03-27,4,4,4,0,163,164,163,1,0,0,0,0,23,23,23,23
Contra Costa,67,2023-03-27,396,396,396,0,9040,9106,9105,1,33,1,1,6,1580,1580,1579,1579
Del Norte,67,2023-03-27,6,6,6,0,208,209,208,1,0,0,0,1,61,61,61,61
El Dorado,67,2023-03-27,35,35,35,0,801,808,807,1,2,0,0,0,247,247,247,247
Fresno,67,2023-03-27,274,274,274,0,7364,7417,7416,1,59,1,1,5,3016,3016,3015,3015
Glenn,67,2023-03-27,6,6,6,0,134,136,135,1,0,0,0,0,56,56,56,56
Humboldt,67,2023-03-27,13,13,13,0,459,463,462,1,5,1,1,1,171,171,170,170
Imperial,67,2023-03-27,151,151,151,0,1691,1705,1704,1,10,0,0,1,981,981,981,981
Inyo,67,2023-03-27,10,10,10,0,224,225,224,1,0,0,0,0,63,63,63,63
Kern,67,2023-03-27,197,197,197,0,7351,7404,7403,1,29,1,1,3,2496,2496,2495,2495
Kings,67,2023-03-27,39,39,39,0,1332,1342,1341,1,2,0,0,1,486,486,486,486
Lake,67,2023-03-27,14,14,14,0,357,360,359,1,2,1,1,0,164,164,163,163
Lassen,67,2023-03-27,7,7,7,0,342,343,342,1,0,0,0,0,65,65,65,65
Los Angeles,67,2023-03-27,2441,2460,2460,0,106229,106986,106985,1,348,33,33,46,35882,35882,35849,35849
Madera,67,2023-03-27,36,36,36,0,993,1001,1000,1,5,0,0,0,377,377,377,377
Marin,67,2023-03-27,77,77,77,0,1297,1307,1306,1,18,0,0,1,260,260,260,260
Mariposa,67,2023-03-27,0,0,0,0,74,75,74,1,0,0,0,0,31,31,31,31
Mendocino,67,2023-03-27,15,15,15,0,412,415,414,1,1,0,0,1,145,145,145,145
Merced,67,2023-03-27,94,94,94,0,1973,1988,1987,1,6,0,0,2,903,903,903,903
Modoc,67,2023-03-27,0,0,0,0,5,6,5,1,0,0,0,0,11,11,11,11
Mono,67,2023-03-27,1,1,1,0,49,50,49,1,0,0,0,0,8,8,8,8
Monterey,67,2023-03-27,51,51,51,0,1744,1757,1756,1,19,0,0,0,809,809,809,809
Napa,67,2023-03-27,42,42,42,0,890,898,897,1,3,0,0,1,172,172,172,172
Nevada,67,2023-03-27,24,24,24,0,473,476,475,1,3,0,0,0,138,138,138,138
Orange,67,2023-03-27,634,639,639,0,15959,16074,16073,1,112,16,16,19,8108,8108,8092,8092
Placer,67,2023-03-27,104,104,104,0,1909,1923,1922,1,43,0,0,6,683,683,683,683
Plumas,67,2023-03-27,1,1,1,0,57,58,57,1,0,0,0,0,15,15,15,15
Riverside,67,2023-03-27,548,553,553,0,11512,11595,11594,1,41,5,5,6,6855,6855,6850,6850
Sacramento,67,2023-03-27,441,444,444,0,9878,9949,9948,1,79,9,9,11,3581,3581,3572,3572
San Benito,67,2023-03-27,25,25,25,0,762,769,768,1,1,0,0,0,116,116,116,116
San Bernardino,67,2023-03-27,426,428,428,0,13461,13559,13558,1,67,0,0,12,8143,8143,8143,8143
San Diego,67,2023-03-27,884,890,890,0,20888,21038,21037,1,137,6,6,7,5862,5862,5856,5856
San Francisco,67,2023-03-27,373,373,373,0,9379,9445,9444,1,45,3,3,5,1197,1197,1194,1194
San Joaquin,67,2023-03-27,254,254,254,0,8513,8575,8574,1,23,4,4,11,2448,2448,2444,2444
San Luis Obispo,67,2023-03-27,39,39,39,0,1150,1159,1158,1,4,0,0,0,571,571,571,571
San Mateo,67,2023-03-27,272,272,272,0,5795,5837,5836,1,29,0,0,1,747,747,747,747
Santa Barbara,67,2023-03-27,88,88,88,0,3241,3265,3264,1,9,0,0,2,765,765,765,765
Santa Clara,67,2023-03-27,712,718,718,0,19701,19842,19841,1,100,7,7,14,2797,2797,2790,2790
Santa Cruz,67,2023-03-27,128,128,128,0,2994,3017,3016,1,8,0,0,1,276,276,276,276
Shasta,67,2023-03-27,16,16,16,0,544,548,547,1,2,0,0,3,612,612,612,612
Siskiyou,67,2023-03-27,1,1,1,0,152,153,152,1,0,0,0,0,96,96,96,96
Solano,67,2023-03-27,169,169,169,0,2713,2733,2732,1,23,0,0,4,476,476,476,476
Sonoma,67,2023-03-27,154,154,154,0,2430,2448,2447,1,29,2,2,4,563,563,561,561
Stanislaus,67,2023-03-27,151,151,151,0,3045,3067,3066,1,39,0,0,6,1842,1842,1842,1842
Sutter,67,2023-03-27,37,37,37,0,423,426,425,1,0,0,0,0,242,242,242,242
Tehama,67,2023-03-27,5,5,5,0,197,198,197,1,2,1,1,0,237,237,236,236
Trinity,67,2023-03-27,0,0,0,0,25,26,25,1,0,0,0,0,25,25,25,25
Tulare,67,2023-03-27,104,104,104,0,2749,2771,2770,1,25,0,0,1,1595,1595,1595,1595
Tuolumne,67,2023-03-27,8,8,8,0,320,321,320,1,1,0,0,0,211,211,211,211
Ventura,67,2023-03-27,146,146,146,0,4108,4139,4138,1,25,4,4,2,1696,1696,1692,1692
Yolo,67,2023-03-27,60,60,60,0,1128,1138,1137,1,6,1,1,1,452,452,451,451
Yuba,67,2023-03-27,13,13,13,0,426,429,428,1,1,0,0,1,134,134,134,134
Alameda,68,2023-04-03,574,580,580,0,12653,12759,12758,1,58,3,3,9,2144,2144,2141,2141
Amador,68,2023-04-03,16,16,16,0,298,299,298,1,2,0,0,0,98,98,98,98
Butte,68,2023-04-03,22,22,22,0,472,475,474,1,7,1,1,0,499,499,498,498
Calaveras,68,2023-04-03,5,5,5,0,214,215,214,1,0,0,0,0,143,143,143,143
Colusa,68,2023-04-03,9,9,9,0,174,177,176,1,2,0,0,0,23,23,23,23
Contra Costa,68,2023-04-03,395,397,397,0,8802,8876,8875,1,37,3,3,4,1583,1583,1580,1580
Del Norte,68,2023-04-03,5,5,5,0,195,196,195,1,0,0,0,0,61,61,61,61
El Dorado,68,2023-04-03,65,65,65,0,757,765,764,1,4,0,0,0,247,247,247,247
Fresno,68,2023-04-03,276,276,276,0,7138,7197,7196,1,54,4,4,12,3020,3020,3016,3016
Glenn,68,2023-04-03,6,6,6,0,127,129,128,1,0,0,0,0,56,56,56,56
Humboldt,68,2023-04-03,20,20,20,0,453,458,457,1,5,0,0,0,171,171,171,171
Imperial,68,2023-04-03,188,188,188,0,1521,1533,1532,1,14,0,0,1,981,981,981,981
Inyo,68,2023-04-03,2,2,2,0,139,140,139,1,0,0,0,0,63,63,63,63
Kern,68,2023-04-03,155,155,155,0,5673,5721,5720,1,28,2,2,1,2498,2498,2496,2496
Kings,68,2023-04-03,35,35,35,0,1027,1037,1036,1,5,1,1,0,487,487,486,486
Lake,68,2023-04-03,16,16,16,0,350,352,351,1,0,0,0,0,164,164,164,164
Lassen,68,2023-04-03,3,3,3,0,181,182,181,1,0,0,0,0,65,65,65,65
Los Angeles,68,2023-04-03,2478,2499,2499,0,98497,99313,99312,1,318,41,41,40,35923,35923,35882,35882
Madera,68,2023-04-03,38,38,38,0,874,882,881,1,1,0,0,0,377,377,377,377
Marin,68,2023-04-03,105,105,105,0,1248,1260,1259,1,16,0,0,0,260,260,260,260
Mariposa,68,2023-04-03,6,6,6,0,71,72,71,1,0,0,0,0,31,31,31,31
Mendocino,68,2023-04-03,14,14,14,0,363,366,365,1,3,0,0,1,145,145,145,145
Merced,68,2023-04-03,75,75,75,0,1293,1305,1304,1,6,0,0,0,903,903,903,903
Modoc,68,2023-04-03,4,4,4,0,12,13,12,1,0,0,0,0,11,11,11,11
Mono,68,2023-04-03,2,2,2,0,40,41,40,1,0,0,0,0,8,8,8,8
Monterey,68,2023-04-03,59,59,59,0,1669,1683,1682,1,16,3,3,1,812,812,809,809
Napa,68,2023-04-03,40,40,40,0,806,814,813,1,8,2,2,1,174,174,172,172
Nevada,68,2023-04-03,56,56,56,0,440,444,443,1,4,1,1,0,139,139,138,138
Orange,68,2023-04-03,665,672,672,0,15478,15607,15606,1,93,14,14,14,8122,8122,8108,8108
Placer,68,2023-04-03,102,102,102,0,1884,1901,1900,1,39,0,0,5,683,683,683,683
Plumas,68,2023-04-03,2,2,2,0,57,58,57,1,0,0,0,0,15,15,15,15
Riverside,68,2023-04-03,457,461,461,0,11194,11288,11287,1,61,2,2,8,6857,6857,6855,6855
Sacramento,68,2023-04-03,526,531,531,0,9375,9454,9453,1,70,1,1,16,3582,3582,3581,3581
San Benito,68,2023-04-03,24,24,24,0,557,562,561,1,0,0,0,0,116,116,116,116
San Bernardino,68,2023-04-03,473,477,477,0,12376,12479,12478,1,54,0,0,12,8143,8143,8143,8143
San Diego,68,2023-04-03,772,779,779,0,19938,20104,20103,1,128,6,6,10,5868,5868,5862,5862
San Francisco,68,2023-04-03,334,335,335,0,7234,7296,7295,1,37,4,4,9,1201,1201,1197,1197
San Joaquin,68,2023-04-03,225,225,225,0,6611,6667,6666,1,31,4,4,8,2452,2452,2448,2448
San Luis Obispo,68,2023-04-03,45,45,45,0,971,980,979,1,5,4,4,0,575,575,571,571
San Mateo,68,2023-04-03,256,256,256,0,5707,5756,5755,1,29,0,0,0,747,747,747,747
Santa Barbara,68,2023-04-03,95,95,95,0,2639,2663,2662,1,16,0,0,1,765,765,765,765
Santa Clara,68,2023-04-03,669,676,676,0,16823,16964,16963,1,70,4,4,15,2801,2801,2797,2797
Santa Cruz,68,2023-04-03,127,127,127,0,2475,2496,2495,1,15,0,0,0,276,276,276,276
Shasta,68,2023-04-03,21,21,21,0,519,524,523,1,1,0,0,1,612,612,612,612
Siskiyou,68,2023-04-03,2,2,2,0,93,94,93,1,0,0,0,0,96,96,96,96
Solano,68,2023-04-03,125,125,125,0,2364,2384,2383,1,20,0,0,2,476,476,476,476
Sonoma,68,2023-04-03,136,136,136,0,2092,2110,2109,1,27,2,2,0,565,565,563,563
Stanislaus,68,2023-04-03,119,119,119,0,2921,2947,2946,1,33,0,0,4,1842,1842,1842,1842
Sutter,68,2023-04-03,33,33,33,0,404,406,405,1,0,0,0,0,242,242,242,242
Tehama,68,2023-04-03,10,10,10,0,192,193,192,1,0,0,0,0,237,237,237,237
Trinity,68,2023-04-03,0,0,0,0,12,13,12,1,0,0,0,0,25,25,25,25
Tulare,68,2023-04-03,96,96,96,0,2632,2655,2654,1,19,0,0,1,1595,1595,1595,1595
Tuolumne,68,2023-04-03,6,6,6,0,255,256,255,1,1,0,0,0,211,211,211,211
Ventura,68,2023-04-03,144,144,144,0,3522,3553,3552,1,22,4,4,0,1700,1700,1696,1696
Yolo,68,2023-04-03,53,53,53,0,999,1008,1007,1,3,1,1,0,453,453,452,452
Yuba,68,2023-04-03,23,23,23,0,401,405,404,1,1,0,0,0,134,134,134,134
Alameda,69,2023-04-10,543,550,550,0,11245,11357,11356,1,58,3,3,10,2147,2147,2144,2144
Amador,69,2023-04-10,11,11,11,0,209,210,209,1,1,0,0,0,98,98,98,98
Butte,69,2023-04-10,19,19,19,0,439,445,444,1,4,0,0,0,499,499,499,499
Calaveras,69,2023-04-10,11,11,11,0,190,191,190,1,0,0,0,0,143,143,143,143
Colusa,69,2023-04-10,1,1,1,0,99,101,100,1,1,0,0,0,23,23,23,23
Contra Costa,69,2023-04-10,419,424,424,0,8345,8428,8427,1,42,0,0,2,1583,1583,1583,1583
Del Norte,69,2023-04-10,2,2,2,0,123,124,123,1,0,1,1,0,62,62,61,61
El Dorado,69,2023-04-10,41,41,41,0,669,676,675,1,3,0,0,1,247,247,247,247
Fresno,69,2023-04-10,270,271,271,0,6215,6277,6276,1,63,1,1,3,3021,3021,3020,3020
Glenn,69,2023-04-10,2,2,2,0,131,133,132,1,1,0,0,0,56,56,56,56
Humboldt,69,2023-04-10,16,16,16,0,430,436,435,1,4,0,0,0,171,171,171,171
Imperial,69,2023-04-10,149,149,149,0,1309,1324,1323,1,7,1,1,3,982,982,981,981
Inyo,69,2023-04-10,5,5,5,0,212,215,214,1,0,0,0,0,63,63,63,63
Kern,69,2023-04-10,154,154,154,0,4992,5041,5040,1,28,0,0,2,2498,2498,2498,2498
Kings,69,2023-04-10,44,44,44,0,873,883,882,1,4,0,0,0,487,487,487,487
Lake,69,2023-04-10,14,14,14,0,300,304,303,1,0,0,0,0,164,164,164,164
Lassen,69,2023-04-10,0,0,0,0,119,120,119,1,0,0,0,0,65,65,65,65
Los Angeles,69,2023-04-10,2442,2465,2465,0,89518,90393,90392,1,299,43,43,35,35966,35966,35923,35923
Madera,69,2023-04-10,85,85,85,0,890,899,898,1,0,0,0,0,377,377,377,377
Marin,69,2023-04-10,99,99,99,0,1189,1202,1201,1,12,0,0,2,260,260,260,260
Mariposa,69,2023-04-10,4,4,4,0,64,65,64,1,0,0,0,0,31,31,31,31
Mendocino,69,2023-04-10,14,14,14,0,351,355,354,1,2,0,0,1,145,145,145,145
Merced,69,2023-04-10,53,53,53,0,1506,1523,1522,1,5,0,0,1,903,903,903,903
Modoc,69,2023-04-10,1,1,1,0,6,7,6,1,0,0,0,0,11,11,11,11
Mono,69,2023-04-10,1,1,1,0,45,46,45,1,0,0,0,0,8,8,8,8
Monterey,69,2023-04-10,53,53,53,0,1338,1352,1351,1,12,0,0,1,812,812,812,812
Napa,69,2023-04-10,33,33,33,0,676,683,682,1,5,1,1,0,175,175,174,174
Nevada,69,2023-04-10,43,43,43,0,355,359,358,1,3,0,0,0,139,139,139,139
Orange,69,2023-04-10,528,535,535,0,15261,15410,15409,1,87,11,11,15,8133,8133,8122,8122
Placer,69,2023-04-10,103,103,103,0,1630,1648,1647,1,32,0,0,7,683,683,683,683
Plumas,69,2023-04-10,4,4,4,0,39,40,39,1,0,0,0,0,15,15,15,15
Riverside,69,2023-04-10,402,407,407,0,11134,11244,11243,1,53,1,1,6,6858,6858,6857,6857
Sacramento,69,2023-04-10,450,456,456,0,8230,8312,8311,1,74,5,5,13,3587,3587,3582,3582
San Benito,69,2023-04-10,22,22,22,0,465,471,470,1,2,1,1,0,117,117,116,116
San Bernardino,69,2023-04-10,482,488,488,0,11909,12025,12024,1,71,0,0,11,8143,8143,8143,8143
San Diego,69,2023-04-10,849,857,857,0,20980,21186,21185,1,114,3,3,17,5871,5871,5868,5868
San Francisco,69,2023-04-10,298,300,300,0,6370,6432,6431,1,39,8,8,6,1209,1209,1201,1201
San Joaquin,69,2023-04-10,187,187,187,0,5902,5961,5960,1,22,3,3,10,2455,2455,2452,2452
San Luis Obispo,69,2023-04-10,60,60,60,0,939,949,948,1,3,1,1,1,576,576,575,575
San Mateo,69,2023-04-10,224,224,224,0,5326,5380,5379,1,21,0,0,1,747,747,747,747
Santa Barbara,69,2023-04-10,99,99,99,0,2786,2814,2813,1,16,0,0,3,765,765,765,765
Santa Clara,69,2023-04-10,629,636,636,0,16333,16491,16490,1,95,6,6,14,2807,2807,2801,2801
Santa Cruz,69,2023-04-10,103,103,103,0,1758,1775,1774,1,17,0,0,0,276,276,276,276
Shasta,69,2023-04-10,25,25,25,0,504,509,508,1,3,0,0,1,612,612,612,612
Siskiyou,69,2023-04-10,7,7,7,0,102,103,102,1,0,0,0,0,96,96,96,96
Solano,69,2023-04-10,139,139,139,0,2044,2065,2064,1,20,0,0,2,476,476,476,476
Sonoma,69,2023-04-10,131,131,131,0,1991,2013,2012,1,18,2,2,2,567,567,565,565
Stanislaus,69,2023-04-10,130,130,130,0,2561,2588,2587,1,25,0,0,2,1842,1842,1842,1842
Sutter,69,2023-04-10,30,30,30,0,419,424,423,1,0,0,0,0,242,242,242,242
Tehama,69,2023-04-10,8,8,8,0,174,175,174,1,1,0,0,0,237,237,237,237
Trinity,69,2023-04-10,2,2,2,0,13,14,13,1,0,0,0,0,25,25,25,25
Tulare,69,2023-04-10,93,93,93,0,2393,2418,2417,1,17,0,0,0,1595,1595,1595,1595
Tuolumne,69,2023-04-10,5,5,5,0,203,204,203,1,0,0,0,0,211,211,211,211
Ventura,69,2023-04-10,141,141,141,0,3296,3329,3328,1,22,0,0,0,1700,1700,1700,1700
Yolo,69,2023-04-10,62,62,62,0,957,967,966,1,3,0,0,1,453,453,453,453
Yuba,69,2023-04-10,23,23,23,0,392,397,396,1,3,0,0,0,134,134,134,134
Alameda,70,2023-04-17,572,579,579,0,11553,11683,11682,1,61,3,3,8,2150,2150,2147,2147
Amador,70,2023-04-17,13,13,13,0,209,210,209,1,1,0,0,0,98,98,98,98
Butte,70,2023-04-17,35,35,35,0,458,465,464,1,8,0,0,0,499,499,499,499
Calaveras,70,2023-04-17,8,8,8,0,207,208,207,1,0,0,0,0,143,143,143,143
Colusa,70,2023-04-17,2,2,2,0,44,45,44,1,0,1,1,0,24,24,23,23
Contra Costa,70,2023-04-17,403,408,408,0,7886,7975,7974,1,34,2,2,1,1585,1585,1583,1583
Del Norte,70,2023-04-17,1,1,1,0,108,109,108,1,0,0,0,0,62,62,62,62
El Dorado,70,2023-04-17,43,43,43,0,651,660,659,1,1,0,0,0,247,247,247,247
Fresno,70,2023-04-17,239,240,240,0,6333,6404,6403,1,59,3,3,4,3024,3024,3021,3021
Glenn,70,2023-04-17,7,7,7,0,119,121,120,1,0,0,0,0,56,56,56,56
Humboldt,70,2023-04-17,7,7,7,0,342,347,346,1,1,0,0,0,171,171,171,171
Imperial,70,2023-04-17,176,177,177,0,1208,1222,1221,1,10,0,0,1,982,982,982,982
Inyo,70,2023-04-17,4,4,4,0,121,123,122,1,0,0,0,0,63,63,63,63
Kern,70,2023-04-17,128,128,128,0,4185,4234,4233,1,18,0,0,6,2498,2498,2498,2498
Kings,70,2023-04-17,42,42,42,0,818,828,827,1,1,0,0,0,487,487,487,487
Lake,70,2023-04-17,14,14,14,0,282,286,285,1,1,0,0,0,164,164,164,164
Lassen,70,2023-04-17,3,3,3,0,93,94,93,1,0,0,0,0,65,65,65,65
Los Angeles,70,2023-04-17,2216,2239,2239,0,96347,97423,97422,1,292,39,41,27,36005,36007,35966,35966
Madera,70,2023-04-17,56,56,56,0,868,878,877,1,0,0,0,0,377,377,377,377
Marin,70,2023-04-17,68,68,68,0,968,980,979,1,16,0,0,2,260,260,260,260
Mariposa,70,2023-04-17,2,2,2,0,49,50,49,1,0,0,0,0,31,31,31,31
Mendocino,70,2023-04-17,22,22,22,0,309,314,313,1,2,1,1,2,146,146,145,145
Merced,70,2023-04-17,65,65,65,0,1496,1513,1512,1,8,0,0,0,903,903,903,903
Modoc,70,2023-04-17,1,1,1,0,5,6,5,1,1,0,0,0,11,11,11,11
Mono,70,2023-04-17,1,1,1,0,37,38,37,1,0,0,0,0,8,8,8,8
Monterey,70,2023-04-17,45,45,45,0,1677,1696,1695,1,16,0,0,0,812,812,812,812
Napa,70,2023-04-17,34,34,34,0,730,740,739,1,4,0,0,1,175,175,175,175
Nevada,70,2023-04-17,22,22,22,0,326,331,330,1,4,0,0,0,139,139,139,139
Orange,70,2023-04-17,530,536,536,0,15473,15647,15646,1,91,10,10,9,8143,8143,8133,8133
Placer,70,2023-04-17,95,95,95,0,1529,1547,1546,1,45,1,1,4,684,684,683,683
Plumas,70,2023-04-17,4,4,4,0,52,53,52,1,0,0,0,0,15,15,15,15
Riverside,70,2023-04-17,379,385,385,0,11431,11560,11559,1,55,1,1,4,6859,6859,6858,6858
Sacramento,70,2023-04-17,497,504,504,0,8305,8400,8399,1,73,2,2,10,3589,3589,3587,3587
San Benito,70,2023-04-17,15,15,15,0,490,498,497,1,0,0,0,0,117,117,117,117
San Bernardino,70,2023-04-17,458,464,464,0,11967,12102,12101,1,64,0,0,10,8143,8143,8143,8143
San Diego,70,2023-04-17,837,846,846,0,19900,20123,20122,1,115,2,2,13,5873,5873,5871,5871
San Francisco,70,2023-04-17,310,315,315,0,9667,9774,9773,1,44,2,2,8,1211,1211,1209,1209
San Joaquin,70,2023-04-17,184,184,184,0,8311,8405,8404,1,18,1,1,3,2456,2456,2455,2455
San Luis Obispo,70,2023-04-17,59,59,59,0,887,898,897,1,8,0,0,0,576,576,576,576
San Mateo,70,2023-04-17,192,192,192,0,5617,5681,5680,1,18,0,0,4,747,747,747,747
Santa Barbara,70,2023-04-17,123,123,123,0,2747,2779,2778,1,18,1,1,1,766,766,765,765
Santa Clara,70,2023-04-17,615,622,622,0,23124,23383,23382,1,75,4,4,17,2811,2811,2807,2807
Santa Cruz,70,2023-04-17,94,94,94,0,2326,2353,2352,1,21,0,0,0,276,276,276,276
Shasta,70,2023-04-17,26,26,26,0,495,501,500,1,4,0,0,1,612,612,612,612
Siskiyou,70,2023-04-17,8,8,8,0,80,81,80,1,0,0,0,1,96,96,96,96
Solano,70,2023-04-17,165,165,165,0,2028,2053,2052,1,29,0,0,2,476,476,476,476
Sonoma,70,2023-04-17,163,164,164,0,2218,2244,2243,1,31,1,1,3,568,568,567,567
Stanislaus,70,2023-04-17,115,115,115,0,2918,2952,2951,1,27,0,0,5,1842,1842,1842,1842
Sutter,70,2023-04-17,17,17,17,0,277,280,279,1,0,0,0,0,242,242,242,242
Tehama,70,2023-04-17,13,13,13,0,164,165,164,1,3,0,0,0,237,237,237,237
Trinity,70,2023-04-17,1,1,1,0,15,16,15,1,0,0,0,0,25,25,25,25
Tulare,70,2023-04-17,97,97,97,0,2293,2320,2319,1,14,1,1,1,1596,1596,1595,1595
Tuolumne,70,2023-04-17,6,6,6,0,225,226,225,1,0,0,0,0,211,211,211,211
Ventura,70,2023-04-17,120,120,120,0,3344,3383,3382,1,18,2,2,1,1702,1702,1700,1700
Yolo,70,2023-04-17,51,51,51,0,820,830,829,1,3,1,1,0,454,454,453,453
Yuba,70,2023-04-17,15,15,15,0,282,285,284,1,4,0,0,0,134,134,134,134
Alameda,71,2023-04-24,559,566,566,0,10593,10728,10727,1,67,3,3,5,2153,2153,2150,2150
Amador,71,2023-04-24,15,15,15,0,194,195,194,1,0,1,1,0,99,99,98,98
Butte,71,2023-04-24,29,29,29,0,495,503,502,1,11,1,1,1,500,500,499,499
Calaveras,71,2023-04-24,7,7,7,0,199,200,199,1,0,0,0,0,143,143,143,143
Colusa,71,2023-04-24,0,0,0,0,40,41,40,1,0,0,0,0,24,24,24,24
Contra Costa,71,2023-04-24,350,356,356,0,7484,7580,7579,1,37,5,5,4,1590,1590,1585,1585
Del Norte,71,2023-04-24,5,5,5,0,109,110,109,1,0,0,0,0,62,62,62,62
El Dorado,71,2023-04-24,40,40,40,0,627,637,636,1,5,0,0,1,247,247,247,247
Fresno,71,2023-04-24,242,243,243,0,6076,6153,6152,1,63,3,3,7,3027,3027,3024,3024
Glenn,71,2023-04-24,3,3,3,0,103,105,104,1,0,0,0,0,56,56,56,56
Humboldt,71,2023-04-24,9,9,9,0,277,281,280,1,0,0,0,0,171,171,171,171
Imperial,71,2023-04-24,119,119,119,0,1090,1105,1104,1,7,1,1,0,983,983,982,982
Inyo,71,2023-04-24,5,5,5,0,154,157,156,1,0,0,0,0,63,63,63,63
Kern,71,2023-04-24,84,84,84,0,3767,3815,3814,1,16,1,1,4,2499,2499,2498,2498
Kings,71,2023-04-24,32,32,32,0,780,791,790,1,1,0,0,0,487,487,487,487
Lake,71,2023-04-24,14,14,14,0,347,353,352,1,0,0,0,1,164,164,164,164
Lassen,71,2023-04-24,0,0,0,0,112,113,112,1,0,0,0,0,65,65,65,65
Los Angeles,71,2023-04-24,1931,1955,1955,0,93938,95120,95119,1,224,33,36,27,36038,36043,36005,36007
Madera,71,2023-04-24,33,33,33,0,800,812,811,1,2,0,0,0,377,377,377,377
Marin,71,2023-04-24,66,66,66,0,961,974,973,1,11,0,0,1,260,260,260,260
Mariposa,71,2023-04-24,5,5,5,0,53,54,53,1,0,0,0,0,31,31,31,31
Mendocino,71,2023-04-24,9,9,9,0,267,271,270,1,3,0,0,0,146,146,146,146
Merced,71,2023-04-24,50,50,50,0,1250,1267,1266,1,7,0,0,0,903,903,903,903
Modoc,71,2023-04-24,4,4,4,0,10,11,10,1,0,0,0,0,11,11,11,11
Mono,71,2023-04-24,2,2,2,0,44,45,44,1,0,0,0,0,8,8,8,8
Monterey,71,2023-04-24,64,64,64,0,1708,1731,1730,1,14,1,1,2,813,813,812,812
Napa,71,2023-04-24,26,26,26,0,712,722,721,1,4,0,0,1,175,175,175,175
Nevada,71,2023-04-24,37,37,37,0,291,296,295,1,1,0,0,1,139,139,139,139
Orange,71,2023-04-24,518,525,525,0,14197,14375,14374,1,88,14,14,11,8157,8157,8143,8143
Placer,71,2023-04-24,105,105,105,0,1460,1479,1478,1,33,1,1,2,685,685,684,684
Plumas,71,2023-04-24,4,4,4,0,77,78,77,1,1,0,0,0,15,15,15,15
Riverside,71,2023-04-24,324,329,329,0,11489,11634,11633,1,49,0,0,5,6859,6859,6859,6859
Sacramento,71,2023-04-24,504,511,511,0,8238,8343,8342,1,64,3,3,10,3592,3592,3589,3589
San Benito,71,2023-04-24,11,11,11,0,391,398,397,1,1,0,0,0,117,117,117,117
San Bernardino,71,2023-04-24,385,390,390,0,10829,10966,10965,1,132,0,0,15,8143,8143,8143,8143
San Diego,71,2023-04-24,705,713,713,0,18891,19129,19128,1,95,5,5,10,5878,5878,5873,5873
San Francisco,71,2023-04-24,343,348,348,0,8652,8761,8760,1,63,2,2,6,1213,1213,1211,1211
San Joaquin,71,2023-04-24,162,162,162,0,8603,8713,8712,1,18,1,1,1,2457,2457,2456,2456
San Luis Obispo,71,2023-04-24,40,40,40,0,820,831,830,1,10,1,1,0,577,577,576,576
San Mateo,71,2023-04-24,196,197,197,0,5055,5120,5119,1,19,0,0,1,747,747,747,747
Santa Barbara,71,2023-04-24,93,93,93,0,2842,2877,2876,1,11,1,1,2,767,767,766,766
Santa Clara,71,2023-04-24,586,594,594,0,20469,20728,20727,1,82,4,4,17,2815,2815,2811,2811
Santa Cruz,71,2023-04-24,58,58,58,0,1763,1787,1786,1,24,0,0,1,276,276,276,276
Shasta,71,2023-04-24,18,18,18,0,420,426,425,1,2,0,0,0,612,612,612,612
Siskiyou,71,2023-04-24,7,7,7,0,93,94,93,1,3,0,0,0,96,96,96,96
Solano,71,2023-04-24,139,139,139,0,2093,2120,2119,1,18,0,0,6,476,476,476,476
Sonoma,71,2023-04-24,156,156,156,0,2047,2074,2073,1,29,1,1,2,569,569,568,568
Stanislaus,71,2023-04-24,107,107,107,0,2779,2815,2814,1,22,0,0,2,1842,1842,1842,1842
Sutter,71,2023-04-24,25,25,25,0,292,298,297,1,0,0,0,0,242,242,242,242
Tehama,71,2023-04-24,6,6,6,0,160,162,161,1,0,0,0,0,237,237,237,237
Trinity,71,2023-04-24,1,1,1,0,13,14,13,1,0,0,0,0,25,25,25,25
Tulare,71,2023-04-24,77,77,77,0,2219,2248,2247,1,17,2,2,0,1598,1598,1596,1596
Tuolumne,71,2023-04-24,5,5,5,0,177,178,177,1,0,0,0,0,211,211,211,211
Ventura,71,2023-04-24,142,142,142,0,3142,3184,3183,1,18,0,0,2,1702,1702,1702,1702
Yolo,71,2023-04-24,37,37,37,0,879,891,890,1,1,1,1,0,455,455,454,454
Yuba,71,2023-04-24,16,16,16,0,273,277,276,1,5,0,0,0,134,134,134,134
Alameda,72,2023-05-01,457,464,464,0,9529,9666,9665,1,60,1,1,5,2154,2154,2153,2153
Amador,72,2023-05-01,7,7,7,0,161,162,161,1,2,0,0,0,99,99,99,99
Butte,72,2023-05-01,28,28,28,0,395,401,400,1,18,0,0,0,500,500,500,500
Calaveras,72,2023-05-01,1,1,1,0,177,179,178,1,0,0,0,1,143,143,143,143
Colusa,72,2023-05-01,4,4,4,0,48,49,48,1,0,0,0,0,24,24,24,24
Contra Costa,72,2023-05-01,350,357,357,0,7079,7181,7180,1,34,4,4,5,1594,1594,1590,1590
Del Norte,72,2023-05-01,1,1,1,0,85,86,85,1,0,0,0,0,62,62,62,62
El Dorado,72,2023-05-01,39,39,39,0,618,628,627,1,3,0,0,1,247,247,247,247
Fresno,72,2023-05-01,261,264,264,0,5951,6038,6037,1,62,3,3,6,3030,3030,3027,3027
Glenn,72,2023-05-01,6,6,6,0,115,117,116,1,1,0,0,0,56,56,56,56
Humboldt,72,2023-05-01,13,13,13,0,242,248,247,1,0,0,0,0,171,171,171,171
Imperial,72,2023-05-01,101,101,101,0,1156,1172,1171,1,12,0,0,0,983,983,983,983
Inyo,72,2023-05-01,10,10,10,0,166,169,168,1,1,0,0,0,63,63,63,63
Kern,72,2023-05-01,84,84,84,0,4114,4174,4173,1,10,1,1,3,2500,2500,2499,2499
Kings,72,2023-05-01,28,28,28,0,665,676,675,1,0,0,0,0,487,487,487,487
Lake,72,2023-05-01,8,8,8,0,287,292,291,1,1,0,0,0,164,164,164,164
Lassen,72,2023-05-01,3,3,3,0,96,97,96,1,0,0,0,0,65,65,65,65
Los Angeles,72,2023-05-01,1924,1952,1952,0,92041,93359,93358,1,249,38,43,28,36076,36086,36038,36043
Madera,72,2023-05-01,49,49,49,0,788,801,800,1,2,0,0,0,377,377,377,377
Marin,72,2023-05-01,68,68,68,0,868,882,881,1,9,0,0,1,260,260,260,260
Mariposa,72,2023-05-01,0,0,0,0,68,69,68,1,0,0,0,0,31,31,31,31
Mendocino,72,2023-05-01,10,10,10,0,227,230,229,1,1,0,0,0,146,146,146,146
Merced,72,2023-05-01,45,45,45,0,842,855,854,1,2,0,0,1,903,903,903,903
Modoc,72,2023-05-01,3,3,3,0,6,7,6,1,0,0,0,0,11,11,11,11
Mono,72,2023-05-01,1,1,1,0,30,31,30,1,0,0,0,0,8,8,8,8
Monterey,72,2023-05-01,56,56,56,0,1571,1595,1594,1,18,0,0,1,813,813,813,813
Napa,72,2023-05-01,31,31,31,0,663,672,671,1,1,1,1,0,176,176,175,175
Nevada,72,2023-05-01,27,27,27,0,244,249,248,1,6,0,0,0,139,139,139,139
Orange,72,2023-05-01,430,436,436,0,14340,14545,14544,1,60,9,9,12,8166,8166,8157,8157
Placer,72,2023-05-01,97,97,97,0,1460,1482,1481,1,45,0,0,0,685,685,685,685
Plumas,72,2023-05-01,5,5,5,0,45,46,45,1,0,0,0,0,15,15,15,15
Riverside,72,2023-05-01,292,298,298,0,10636,10788,10787,1,47,0,0,8,6859,6859,6859,6859
Sacramento,72,2023-05-01,515,522,522,0,7481,7589,7588,1,73,5,5,5,3597,3597,3592,3592
San Benito,72,2023-05-01,12,12,12,0,359,366,365,1,0,0,0,0,117,117,117,117
San Bernardino,72,2023-05-01,363,368,368,0,11287,11449,11448,1,54,0,0,12,8143,8143,8143,8143
San Diego,72,2023-05-01,577,585,585,0,17801,18057,18056,1,90,0,0,7,5878,5878,5878,5878
San Francisco,72,2023-05-01,257,262,262,0,7483,7590,7589,1,38,5,5,4,1218,1218,1213,1213
San Joaquin,72,2023-05-01,152,152,152,0,7676,7789,7788,1,15,1,1,2,2458,2458,2457,2457
San Luis Obispo,72,2023-05-01,38,38,38,0,778,790,789,1,3,2,2,0,579,579,577,577
San Mateo,72,2023-05-01,200,202,202,0,4738,4807,4806,1,15,0,0,2,747,747,747,747
Santa Barbara,72,2023-05-01,75,75,75,0,2301,2336,2335,1,16,1,1,1,768,768,767,767
Santa Clara,72,2023-05-01,582,589,589,0,17044,17288,17287,1,95,1,1,15,2816,2816,2815,2815
Santa Cruz,72,2023-05-01,53,53,53,0,1586,1611,1610,1,14,0,0,1,276,276,276,276
Shasta,72,2023-05-01,7,7,7,0,404,410,409,1,3,0,0,1,612,612,612,612
Siskiyou,72,2023-05-01,9,9,9,0,111,112,111,1,3,1,1,0,97,97,96,96
Solano,72,2023-05-01,85,85,85,0,1777,1803,1802,1,19,0,0,4,476,476,476,476
Sonoma,72,2023-05-01,104,104,104,0,1906,1934,1933,1,12,3,3,1,572,572,569,569
Stanislaus,72,2023-05-01,92,92,92,0,2278,2312,2311,1,24,0,0,4,1842,1842,1842,1842
Sutter,72,2023-05-01,16,16,16,0,224,227,226,1,0,0,0,0,242,242,242,242
Tehama,72,2023-05-01,10,10,10,0,149,151,150,1,0,0,0,0,237,237,237,237
Trinity,72,2023-05-01,2,2,2,0,10,11,10,1,0,0,0,0,25,25,25,25
Tulare,72,2023-05-01,69,69,69,0,1898,1926,1925,1,9,0,0,0,1598,1598,1598,1598
Tuolumne,72,2023-05-01,14,14,14,0,198,200,199,1,1,0,0,0,211,211,211,211
Ventura,72,2023-05-01,113,113,113,0,2824,2866,2865,1,15,0,0,1,1702,1702,1702,1702
Yolo,72,2023-05-01,45,45,45,0,872,886,885,1,3,0,0,1,455,455,455,455
Yuba,72,2023-05-01,19,19,19,0,257,262,261,1,3,0,0,0,134,134,134,134
Alameda,73,2023-05-08,438,445,445,0,8840,8986,8985,1,53,1,1,6,2155,2155,2154,2154
Amador,73,2023-05-08,7,7,7,0,156,159,158,1,1,0,0,0,99,99,99,99
Butte,73,2023-05-08,28,28,28,0,501,511,510,1,9,0,0,0,500,500,500,500
Calaveras,73,2023-05-08,7,7,7,0,175,178,177,1,1,0,0,0,143,143,143,143
Colusa,73,2023-05-08,2,2,2,0,38,39,38,1,1,0,0,0,24,24,24,24
Contra Costa,73,2023-05-08,244,250,250,0,6109,6211,6210,1,39,3,3,11,1597,1597,1594,1594
Del Norte,73,2023-05-08,6,6,6,0,89,90,89,1,1,0,0,0,62,62,62,62
El Dorado,73,2023-05-08,30,30,30,0,519,528,527,1,0,0,0,0,247,247,247,247
Fresno,73,2023-05-08,205,208,208,0,5269,5358,5357,1,61,1,1,7,3031,3031,3030,3030
Glenn,73,2023-05-08,5,5,5,0,122,124,123,1,1,0,0,0,56,56,56,56
Humboldt,73,2023-05-08,12,12,12,0,241,245,244,1,0,0,0,0,171,171,171,171
Imperial,73,2023-05-08,87,87,87,0,1036,1053,1052,1,8,1,1,1,984,984,983,983
Inyo,73,2023-05-08,3,3,3,0,150,153,152,1,0,0,0,0,63,63,63,63
Kern,73,2023-05-08,91,91,91,0,3650,3712,3711,1,8,1,1,3,2501,2501,2500,2500
Kings,73,2023-05-08,36,36,36,0,667,680,679,1,0,0,0,1,487,487,487,487
Lake,73,2023-05-08,10,10,10,0,266,272,271,1,1,0,0,0,164,164,164,164
Lassen,73,2023-05-08,7,7,7,0,89,90,89,1,0,0,0,0,65,65,65,65
Los Angeles,73,2023-05-08,1854,1884,1884,0,78658,79955,79954,1,225,31,37,25,36107,36123,36076,36086
Madera,73,2023-05-08,30,30,30,0,676,688,687,1,0,0,0,0,377,377,377,377
Marin,73,2023-05-08,54,54,54,0,785,800,799,1,12,0,0,2,260,260,260,260
Mariposa,73,2023-05-08,0,0,0,0,54,55,54,1,0,0,0,0,31,31,31,31
Mendocino,73,2023-05-08,7,7,7,0,249,255,254,1,0,0,0,0,146,146,146,146
Merced,73,2023-05-08,38,38,38,0,1100,1119,1118,1,4,0,0,0,903,903,903,903
Modoc,73,2023-05-08,10,10,10,0,11,12,11,1,0,0,0,0,11,11,11,11
Mono,73,2023-05-08,0,0,0,0,42,43,42,1,0,0,0,0,8,8,8,8
Monterey,73,2023-05-08,47,47,47,0,1601,1629,1628,1,15,1,1,0,814,814,813,813
Napa,73,2023-05-08,46,46,46,0,618,629,628,1,0,0,0,0,176,176,176,176
Nevada,73,2023-05-08,21,21,21,0,238,243,242,1,4,0,0,0,139,139,139,139
Orange,73,2023-05-08,473,481,481,0,13547,13771,13770,1,71,9,9,10,8175,8175,8166,8166
Placer,73,2023-05-08,116,116,116,0,1345,1369,1368,1,29,1,1,2,686,686,685,685
Plumas,73,2023-05-08,6,6,6,0,48,49,48,1,0,0,0,0,15,15,15,15
Riverside,73,2023-05-08,285,290,290,0,10349,10520,10519,1,37,0,0,4,6859,6859,6859,6859
Sacramento,73,2023-05-08,351,357,357,0,6801,6915,6914,1,56,1,1,9,3598,3598,3597,3597
San Benito,73,2023-05-08,10,10,10,0,323,330,329,1,1,0,0,0,117,117,117,117
San Bernardino,73,2023-05-08,271,277,277,0,10074,10240,10239,1,49,0,0,10,8143,8143,8143,8143
San Diego,73,2023-05-08,539,547,547,0,17316,17604,17603,1,88,3,3,12,5881,5881,5878,5878
San Francisco,73,2023-05-08,228,232,232,0,6119,6219,6218,1,42,2,2,5,1220,1220,1218,1218
San Joaquin,73,2023-05-08,179,180,180,0,7615,7743,7742,1,14,1,1,2,2459,2459,2458,2458
San Luis Obispo,73,2023-05-08,46,46,46,0,802,817,816,1,8,0,0,0,579,579,579,579
San Mateo,73,2023-05-08,201,204,204,0,4196,4266,4265,1,21,0,0,2,747,747,747,747
Santa Barbara,73,2023-05-08,80,80,80,0,1708,1738,1737,1,10,2,2,1,770,770,768,768
Santa Clara,73,2023-05-08,485,492,492,0,14043,14278,14277,1,94,1,1,11,2817,2817,2816,2816
Santa Cruz,73,2023-05-08,69,69,69,0,1491,1516,1515,1,10,0,0,0,276,276,276,276
Shasta,73,2023-05-08,17,17,17,0,387,394,393,1,4,0,0,1,612,612,612,612
Siskiyou,73,2023-05-08,8,8,8,0,109,110,109,1,1,0,0,0,97,97,97,97
Solano,73,2023-05-08,84,84,84,0,1550,1577,1576,1,11,0,0,2,476,476,476,476
Sonoma,73,2023-05-08,86,86,86,0,1663,1692,1691,1,15,0,0,1,572,572,572,572
Stanislaus,73,2023-05-08,77,77,77,0,2615,2660,2659,1,25,0,0,2,1842,1842,1842,1842
Sutter,73,2023-05-08,12,12,12,0,288,294,293,1,0,0,0,0,242,242,242,242
Tehama,73,2023-05-08,14,14,14,0,145,147,146,1,2,0,0,0,237,237,237,237
Trinity,73,2023-05-08,0,0,0,0,7,8,7,1,0,0,0,0,25,25,25,25
Tulare,73,2023-05-08,57,57,57,0,1764,1795,1794,1,10,1,1,0,1599,1599,1598,1598
Tuolumne,73,2023-05-08,11,11,11,0,223,229,228,1,0,0,0,0,211,211,211,211
Ventura,73,2023-05-08,101,101,101,0,2599,2644,2643,1,10,1,1,0,1703,1703,1702,1702
Yolo,73,2023-05-08,32,32,32,0,650,663,662,1,3,0,0,0,455,455,455,455
Yuba,73,2023-05-08,14,14,14,0,251,257,256,1,2,0,0,1,134,134,134,134
Alameda,74,2023-05-12,290,294,294,0,5331,5433,5432,1,44,3,3,7,2158,2158,2155,2155
Amador,74,2023-05-12,1,1,1,0,89,90,89,1,0,0,0,0,99,99,99,99
Butte,74,2023-05-12,58,58,58,0,390,399,398,1,14,0,0,0,500,500,500,500
Calaveras,74,2023-05-12,4,4,4,0,96,98,97,1,1,0,0,0,143,143,143,143
Colusa,74,2023-05-12,3,3,3,0,31,32,31,1,1,0,0,0,24,24,24,24
Contra Costa,74,2023-05-12,185,189,189,0,3768,3840,3839,1,34,1,1,4,1598,1598,1597,1597
Del Norte,74,2023-05-12,2,2,2,0,59,60,59,1,0,0,0,0,62,62,62,62
El Dorado,74,2023-05-12,22,22,22,0,367,374,373,1,0,0,0,1,247,247,247,247
Fresno,74,2023-05-12,102,104,104,0,3175,3236,3235,1,49,0,0,6,3031,3031,3031,3031
Glenn,74,2023-05-12,2,2,2,0,31,32,31,1,1,0,0,0,56,56,56,56
Humboldt,74,2023-05-12,8,8,8,0,192,197,196,1,1,0,0,0,171,171,171,171
Imperial,74,2023-05-12,46,46,46,0,701,716,715,1,10,0,0,1,984,984,984,984
Inyo,74,2023-05-12,5,5,5,0,104,107,106,1,0,0,0,0,63,63,63,63
Kern,74,2023-05-12,90,91,91,0,2515,2564,2563,1,7,0,0,5,2501,2501,2501,2501
Kings,74,2023-05-12,27,27,27,0,368,376,375,1,2,0,0,0,487,487,487,487
Lake,74,2023-05-12,11,11,11,0,185,189,188,1,1,0,0,0,164,164,164,164
Lassen,74,2023-05-12,4,4,4,0,70,71,70,1,0,0,0,0,65,65,65,65
Los Angeles,74,2023-05-12,1187,1209,1209,0,54004,55026,55025,1,222,16,19,31,36123,36142,36107,36123
Madera,74,2023-05-12,18,18,18,0,438,448,447,1,2,0,0,0,377,377,377,377
Marin,74,2023-05-12,45,45,45,0,497,508,507,1,7,0,0,0,260,260,260,260
Mariposa,74,2023-05-12,0,0,0,0,21,22,21,1,0,0,0,0,31,31,31,31
Mendocino,74,2023-05-12,1,1,1,0,148,153,152,1,2,0,0,1,146,146,146,146
Merced,74,2023-05-12,35,35,35,0,938,957,956,1,3,0,0,0,903,903,903,903
Modoc,74,2023-05-12,3,3,3,0,4,5,4,1,0,0,0,0,11,11,11,11
Mono,74,2023-05-12,0,0,0,0,24,25,24,1,0,0,0,0,8,8,8,8
Monterey,74,2023-05-12,23,23,23,0,891,909,908,1,12,1,1,1,815,815,814,814
Napa,74,2023-05-12,21,21,21,0,469,479,478,1,3,2,2,0,178,178,176,176
Nevada,74,2023-05-12,11,11,11,0,165,170,169,1,5,0,0,1,139,139,139,139
Orange,74,2023-05-12,274,278,278,0,8134,8289,8288,1,56,3,3,11,8178,8178,8175,8175
Placer,74,2023-05-12,46,46,46,0,789,805,804,1,35,0,0,3,686,686,686,686
Plumas,74,2023-05-12,2,2,2,0,19,20,19,1,0,0,0,0,15,15,15,15
Riverside,74,2023-05-12,193,197,197,0,6544,6669,6668,1,33,0,0,9,6859,6859,6859,6859
Sacramento,74,2023-05-12,273,277,277,0,4316,4399,4398,1,65,1,1,5,3599,3599,3598,3598
San Benito,74,2023-05-12,8,8,8,0,206,211,210,1,1,0,0,0,117,117,117,117
San Bernardino,74,2023-05-12,197,201,201,0,7075,7210,7209,1,49,0,0,13,8143,8143,8143,8143
San Diego,74,2023-05-12,348,355,355,0,11342,11557,11556,1,79,0,0,16,5881,5881,5881,5881
San Francisco,74,2023-05-12,113,115,115,0,4535,4622,4621,1,30,1,1,6,1221,1221,1220,1220
San Joaquin,74,2023-05-12,116,118,118,0,5177,5277,5276,1,12,0,0,1,2459,2459,2459,2459
San Luis Obispo,74,2023-05-12,23,23,23,0,491,501,500,1,5,0,0,0,579,579,579,579
San Mateo,74,2023-05-12,110,112,112,0,2455,2502,2501,1,20,0,0,0,747,747,747,747
Santa Barbara,74,2023-05-12,45,45,45,0,789,805,804,1,8,0,0,1,770,770,770,770
Santa Clara,74,2023-05-12,319,325,325,0,11373,11590,11589,1,87,2,2,16,2819,2819,2817,2817
Santa Cruz,74,2023-05-12,28,28,28,0,843,860,859,1,14,0,0,0,276,276,276,276
Shasta,74,2023-05-12,11,11,11,0,307,313,312,1,2,0,0,1,612,612,612,612
Siskiyou,74,2023-05-12,7,7,7,0,43,44,43,1,1,0,0,0,97,97,97,97
Solano,74,2023-05-12,49,49,49,0,939,958,957,1,16,0,0,3,476,476,476,476
Sonoma,74,2023-05-12,65,65,65,0,1066,1087,1086,1,17,0,0,2,572,572,572,572
Stanislaus,74,2023-05-12,72,72,72,0,1729,1763,1762,1,24,0,0,2,1842,1842,1842,1842
Sutter,74,2023-05-12,17,17,17,0,191,196,195,1,0,0,0,0,242,242,242,242
Tehama,74,2023-05-12,8,8,8,0,93,96,95,1,1,0,0,0,237,237,237,237
Trinity,74,2023-05-12,1,1,1,0,6,7,6,1,0,0,0,0,25,25,25,25
Tulare,74,2023-05-12,22,22,22,0,880,898,897,1,7,0,0,0,1599,1599,1599,1599
Tuolumne,74,2023-05-12,4,4,4,0,109,112,111,1,3,0,0,0,211,211,211,211
Ventura,74,2023-05-12,67,67,67,0,1648,1681,1680,1,9,0,0,1,1703,1703,1703,1703
Yolo,74,2023-05-12,24,24,24,0,381,390,389,1,3,0,0,0,455,455,455,455
Yuba,74,2023-05-12,13,13,13,0,141,146,145,1,1,0,0,2,134,134,134,134
Alameda,75,2023-05-19,60,62,62,0,928,952,951,1,149,0,0,18,2161,2162,2161,2162
Amador,75,2023-05-19,1,1,1,0,22,24,23,1,0,0,0,0,99,99,99,99
Butte,75,2023-05-19,3,3,3,0,28,30,29,1,24,0,0,0,500,500,500,500
Calaveras,75,2023-05-19,0,0,0,0,11,12,11,1,0,0,0,0,143,143,143,143
Colusa,75,2023-05-19,0,0,0,0,3,4,3,1,0,0,0,0,24,24,24,24
Contra Costa,75,2023-05-19,35,36,36,0,740,760,759,1,49,0,0,10,1599,1599,1599,1599
Del Norte,75,2023-05-19,1,1,1,0,12,13,12,1,0,0,0,0,62,62,62,62
El Dorado,75,2023-05-19,3,3,3,0,40,42,41,1,4,0,0,0,247,247,247,247
Fresno,75,2023-05-19,28,29,29,0,559,574,573,1,153,0,0,14,3031,3031,3031,3031
Glenn,75,2023-05-19,1,1,1,0,8,9,8,1,0,0,0,0,56,56,56,56
Humboldt,75,2023-05-19,0,0,0,0,44,46,45,1,1,0,0,1,171,171,171,171
Imperial,75,2023-05-19,8,8,8,0,110,114,113,1,25,0,0,4,984,984,984,984
Inyo,75,2023-05-19,0,0,0,0,15,16,15,1,0,0,0,0,63,63,63,63
Kern,75,2023-05-19,6,6,6,0,266,274,273,1,22,0,0,2,2501,2501,2501,2501
Kings,75,2023-05-19,2,2,2,0,50,52,51,1,5,0,0,0,487,487,487,487
Lake,75,2023-05-19,0,0,0,0,37,39,38,1,2,0,0,2,164,164,164,164
Lassen,75,2023-05-19,1,1,1,0,16,17,16,1,2,0,0,0,65,65,65,65
Los Angeles,75,2023-05-19,188,193,193,0,6595,6762,6761,1,564,3,4,58,36149,36176,36146,36172
Madera,75,2023-05-19,2,2,2,0,68,71,70,1,1,0,0,0,377,377,377,377
Marin,75,2023-05-19,15,15,15,0,115,119,118,1,30,0,0,2,260,260,260,260
Mariposa,75,2023-05-19,1,1,1,0,8,9,8,1,0,0,0,0,31,31,31,31
Mendocino,75,2023-05-19,2,2,2,0,32,34,33,1,4,0,0,0,146,146,146,146
Merced,75,2023-05-19,1,1,1,0,140,145,144,1,18,0,0,1,903,903,903,903
Modoc,75,2023-05-19,0,0,0,0,0,1,0,1,0,0,0,0,11,11,11,11
Mono,75,2023-05-19,0,0,0,0,7,8,7,1,0,0,0,0,8,8,8,8
Monterey,75,2023-05-19,0,0,0,0,169,174,173,1,42,0,0,3,816,816,816,816
Napa,75,2023-05-19,2,2,2,0,47,49,48,1,1,0,0,0,178,178,178,178
Nevada,75,2023-05-19,2,2,2,0,27,29,28,1,19,0,0,0,139,139,139,139
Orange,75,2023-05-19,52,53,53,0,1306,1340,1339,1,146,2,3,9,8184,8186,8182,8183
Placer,75,2023-05-19,14,14,14,0,159,164,163,1,117,0,0,10,686,686,686,686
Plumas,75,2023-05-19,0,0,0,0,4,5,4,1,2,0,0,0,15,15,15,15
Riverside,75,2023-05-19,30,31,31,0,795,816,815,1,114,0,0,14,6859,6859,6859,6859
Sacramento,75,2023-05-19,51,52,52,0,767,787,786,1,175,0,0,15,3603,3604,3603,3604
San Benito,75,2023-05-19,0,0,0,0,35,37,36,1,1,0,0,0,117,117,117,117
San Bernardino,75,2023-05-19,28,29,29,0,925,949,948,1,130,0,0,21,8143,8143,8143,8143
San Diego,75,2023-05-19,69,71,71,0,1713,1757,1756,1,179,0,0,11,5884,5885,5884,5885
San Francisco,75,2023-05-19,26,27,27,0,769,789,788,1,99,0,0,4,1223,1223,1223,1223
San Joaquin,75,2023-05-19,18,18,18,0,1162,1192,1191,1,37,0,0,0,2460,2460,2460,2460
San Luis Obispo,75,2023-05-19,5,5,5,0,98,101,100,1,17,0,0,0,581,581,581,581
San Mateo,75,2023-05-19,23,24,24,0,343,353,352,1,58,0,0,9,747,747,747,747
Santa Barbara,75,2023-05-19,16,16,16,0,162,167,166,1,18,0,0,0,770,770,770,770
Santa Clara,75,2023-05-19,78,80,80,0,1833,1880,1879,1,254,1,1,33,2823,2824,2822,2823
Santa Cruz,75,2023-05-19,5,5,5,0,158,163,162,1,18,0,0,0,276,276,276,276
Shasta,75,2023-05-19,2,2,2,0,48,50,49,1,11,0,0,5,612,612,612,612
Siskiyou,75,2023-05-19,0,0,0,0,9,10,9,1,0,0,0,0,97,97,97,97
Solano,75,2023-05-19,9,9,9,0,209,215,214,1,36,0,0,10,476,476,476,476
Sonoma,75,2023-05-19,13,13,13,0,178,183,182,1,31,0,0,5,574,574,574,574
Stanislaus,75,2023-05-19,17,17,17,0,310,319,318,1,76,0,0,4,1842,1842,1842,1842
Sutter,75,2023-05-19,6,6,6,0,41,43,42,1,0,0,0,0,242,242,242,242
Tehama,75,2023-05-19,3,3,3,0,13,14,13,1,9,0,0,0,237,237,237,237
Trinity,75,2023-05-19,0,0,0,0,2,3,2,1,0,0,0,0,25,25,25,25
Tulare,75,2023-05-19,6,6,6,0,55,57,56,1,18,0,0,0,1599,1599,1599,1599
Tuolumne,75,2023-05-19,1,1,1,0,24,26,25,1,0,0,0,0,211,211,211,211
Ventura,75,2023-05-19,17,17,17,0,341,351,350,1,30,1,1,4,1704,1704,1703,1703
Yolo,75,2023-05-19,1,1,1,0,75,78,77,1,4,0,0,0,455,455,455,455
Yuba,75,2023-05-19,3,3,3,0,23,25,24,1,10,0,0,3,134,134,134,134
Alameda,76,2023-05-25,56,58,58,0,933,965,964,1,330,0,0,39,2164,2167,2164,2167
Amador,76,2023-05-25,2,2,2,0,15,16,15,1,0,0,0,0,99,99,99,99
Butte,76,2023-05-25,5,5,5,0,46,49,48,1,56,0,0,0,500,500,500,500
Calaveras,76,2023-05-25,0,0,0,0,23,25,24,1,4,0,0,0,143,143,143,143
Colusa,76,2023-05-25,0,0,0,0,2,3,2,1,2,0,0,0,24,24,24,24
Contra Costa,76,2023-05-25,30,31,31,0,620,641,640,1,146,0,0,14,1600,1601,1600,1601
Del Norte,76,2023-05-25,0,0,0,0,11,12,11,1,4,0,0,4,62,62,62,62
El Dorado,76,2023-05-25,3,3,3,0,51,54,53,1,6,0,0,2,247,247,247,247
Fresno,76,2023-05-25,22,23,23,0,448,464,463,1,231,0,0,22,3031,3031,3031,3031
Glenn,76,2023-05-25,0,0,0,0,5,6,5,1,0,0,0,0,56,56,56,56
Humboldt,76,2023-05-25,1,1,1,0,24,26,25,1,13,0,0,1,171,171,171,171
Imperial,76,2023-05-25,4,4,4,0,142,148,147,1,21,0,0,5,984,984,984,984
Inyo,76,2023-05-25,0,0,0,0,3,4,3,1,0,0,0,0,63,63,63,63
Kern,76,2023-05-25,10,10,10,0,466,482,481,1,44,0,0,0,2501,2501,2501,2501
Kings,76,2023-05-25,5,5,5,0,67,70,69,1,6,0,0,0,487,487,487,487
Lake,76,2023-05-25,2,2,2,0,37,39,38,1,8,0,0,0,165,166,165,166
Lassen,76,2023-05-25,0,0,0,0,11,12,11,1,4,0,0,0,65,65,65,65
Los Angeles,76,2023-05-25,225,232,232,0,8609,8892,8891,1,1196,2,4,126,36176,36218,36174,36214
Madera,76,2023-05-25,3,3,3,0,83,87,86,1,3,0,0,0,377,377,377,377
Marin,76,2023-05-25,6,6,6,0,97,101,100,1,51,0,0,11,260,260,260,260
Mendocino,76,2023-05-25,1,1,1,0,21,23,22,1,9,0,0,0,146,146,146,146
Merced,76,2023-05-25,0,0,0,0,128,133,132,1,42,0,0,0,903,903,903,903
Modoc,76,2023-05-25,0,0,0,0,0,1,0,1,0,0,0,0,11,11,11,11
Mono,76,2023-05-25,0,0,0,0,3,4,3,1,0,0,0,0,8,8,8,8
Monterey,76,2023-05-25,6,6,6,0,195,202,201,1,74,0,0,6,816,816,816,816
Napa,76,2023-05-25,1,1,1,0,51,54,53,1,4,0,0,3,178,178,178,178
Nevada,76,2023-05-25,1,1,1,0,31,33,32,1,24,0,0,1,139,139,139,139
Orange,76,2023-05-25,63,65,65,0,1626,1680,1679,1,249,2,4,19,8191,8199,8189,8195
Placer,76,2023-05-25,14,14,14,0,162,168,167,1,262,0,0,15,686,686,686,686
Plumas,76,2023-05-25,1,1,1,0,8,9,8,1,0,0,0,0,15,15,15,15
Riverside,76,2023-05-25,27,28,28,0,874,904,903,1,185,0,0,19,6859,6859,6859,6859
Sacramento,76,2023-05-25,35,36,36,0,808,835,834,1,349,0,0,35,3603,3604,3603,3604
San Benito,76,2023-05-25,1,1,1,0,43,45,44,1,3,0,0,1,117,117,117,117
San Bernardino,76,2023-05-25,28,29,29,0,941,973,972,1,189,0,0,47,8143,8143,8143,8143
San Diego,76,2023-05-25,58,60,60,0,2023,2090,2089,1,336,1,2,31,5886,5888,5885,5886
San Francisco,76,2023-05-25,40,41,41,0,593,613,612,1,228,0,0,32,1225,1227,1225,1227
San Joaquin,76,2023-05-25,24,25,25,0,827,855,854,1,73,0,0,8,2460,2460,2460,2460
San Luis Obispo,76,2023-05-25,3,3,3,0,84,88,87,1,24,0,0,1,582,582,582,582
San Mateo,76,2023-05-25,21,22,22,0,374,387,386,1,93,0,0,3,747,747,747,747
Santa Barbara,76,2023-05-25,6,6,6,0,132,137,136,1,50,0,0,0,771,772,771,772
Santa Clara,76,2023-05-25,48,50,50,0,1000,1034,1033,1,352,0,0,42,2824,2826,2824,2826
Santa Cruz,76,2023-05-25,13,13,13,0,191,198,197,1,40,0,0,0,276,276,276,276
Shasta,76,2023-05-25,1,1,1,0,46,49,48,1,29,0,0,5,612,612,612,612
Siskiyou,76,2023-05-25,0,0,0,0,10,11,10,1,1,0,0,0,97,97,97,97
Solano,76,2023-05-25,10,10,10,0,183,190,189,1,77,0,0,16,476,476,476,476
Sonoma,76,2023-05-25,15,15,15,0,170,177,176,1,65,0,0,9,574,574,574,574
Stanislaus,76,2023-05-25,7,7,7,0,218,226,225,1,118,0,0,13,1842,1842,1842,1842
Sutter,76,2023-05-25,3,3,3,0,31,33,32,1,0,0,0,0,242,242,242,242
Tehama,76,2023-05-25,2,2,2,0,15,16,15,1,15,0,0,0,238,238,238,238
Trinity,76,2023-05-25,0,0,0,0,1,2,1,1,0,0,0,0,25,25,25,25
Tulare,76,2023-05-25,2,2,2,0,70,73,72,1,16,0,0,1,1599,1599,1599,1599
Tuolumne,76,2023-05-25,1,1,1,0,24,26,25,1,9,0,0,0,211,211,211,211
Ventura,76,2023-05-25,26,27,27,0,359,372,371,1,90,0,0,5,1704,1704,1704,1704
Yolo,76,2023-05-25,2,2,2,0,66,69,68,1,21,0,0,6,455,455,455,455
Yuba,76,2023-05-25,6,6,6,0,25,27,26,1,18,0,0,0,134,134,134,134
Alameda,77,2023-05-31,56,59,59,0,1084,1140,1139,1,357,0,0,45,2166,2171,2166,2171
Amador,77,2023-05-31,1,1,1,0,12,14,13,1,0,0,0,0,99,99,99,99
Butte,77,2023-05-31,2,2,2,0,122,129,128,1,61,0,0,0,500,500,500,500
Calaveras,77,2023-05-31,0,0,0,0,14,16,15,1,0,0,0,0,143,143,143,143
Colusa,77,2023-05-31,0,0,0,0,3,4,3,1,6,0,0,0,24,24,24,24
Contra Costa,77,2023-05-31,30,32,32,0,900,947,946,1,313,0,0,26,1600,1601,1600,1601
Del Norte,77,2023-05-31,0,0,0,0,9,10,9,1,5,0,0,0,62,62,62,62
El Dorado,77,2023-05-31,0,0,0,0,35,38,37,1,28,0,0,10,247,247,247,247
Fresno,77,2023-05-31,35,37,37,0,625,658,657,1,356,0,0,37,3031,3031,3031,3031
Glenn,77,2023-05-31,0,0,0,0,12,14,13,1,0,0,0,0,56,56,56,56
Humboldt,77,2023-05-31,2,2,2,0,24,26,25,1,15,0,0,3,171,171,171,171
Imperial,77,2023-05-31,6,6,6,0,169,179,178,1,30,0,0,13,985,987,985,987
Inyo,77,2023-05-31,0,0,0,0,12,14,13,1,0,0,0,0,63,63,63,63
Kern,77,2023-05-31,15,16,16,0,308,325,324,1,26,0,0,15,2501,2501,2501,2501
Kings,77,2023-05-31,2,2,2,0,65,69,68,1,3,0,0,0,487,487,487,487
Lake,77,2023-05-31,1,1,1,0,34,37,36,1,10,0,0,0,165,166,165,166
Lassen,77,2023-05-31,0,0,0,0,7,8,7,1,7,0,0,0,65,65,65,65
Los Angeles,77,2023-05-31,225,236,236,0,8573,9009,9008,1,1489,5,16,140,36203,36285,36198,36269
Madera,77,2023-05-31,3,3,3,0,76,81,80,1,7,0,0,0,377,377,377,377
Marin,77,2023-05-31,11,12,12,0,122,129,128,1,87,0,0,7,260,260,260,260
Mariposa,77,2023-05-31,0,0,0,0,5,6,5,1,0,0,0,0,31,31,31,31
Mendocino,77,2023-05-31,1,1,1,0,26,28,27,1,6,0,0,3,146,146,146,146
Merced,77,2023-05-31,2,2,2,0,80,85,84,1,25,0,0,0,903,903,903,903
Modoc,77,2023-05-31,0,0,0,0,1,2,1,1,0,0,0,0,11,11,11,11
Mono,77,2023-05-31,0,0,0,0,3,4,3,1,0,0,0,0,8,8,8,8
Monterey,77,2023-05-31,7,7,7,0,122,129,128,1,86,0,0,4,817,818,817,818
Napa,77,2023-05-31,3,3,3,0,156,165,164,1,8,0,0,1,178,178,178,178
Nevada,77,2023-05-31,1,1,1,0,20,22,21,1,20,0,0,8,139,139,139,139
Orange,77,2023-05-31,54,57,57,0,1164,1224,1223,1,499,0,0,88,8197,8213,8197,8213
Placer,77,2023-05-31,8,8,8,0,156,165,164,1,298,0,0,22,686,686,686,686
Plumas,77,2023-05-31,0,0,0,0,6,7,6,1,0,0,0,0,15,15,15,15
Riverside,77,2023-05-31,25,26,26,0,829,872,871,1,202,0,0,42,6859,6859,6859,6859
Sacramento,77,2023-05-31,44,46,46,0,719,756,755,1,358,0,0,62,3603,3604,3603,3604
San Benito,77,2023-05-31,4,4,4,0,52,56,55,1,3,0,0,0,117,117,117,117
San Bernardino,77,2023-05-31,31,33,33,0,1019,1072,1071,1,208,0,0,34,8143,8143,8143,8143
San Diego,77,2023-05-31,76,80,80,0,1808,1901,1900,1,480,0,0,38,5887,5891,5887,5891
San Francisco,77,2023-05-31,33,35,35,0,654,688,687,1,184,0,0,20,1226,1229,1226,1229
San Joaquin,77,2023-05-31,10,11,11,0,364,383,382,1,75,0,0,27,2460,2460,2460,2460
San Luis Obispo,77,2023-05-31,5,5,5,0,96,102,101,1,41,0,0,0,582,582,582,582
San Mateo,77,2023-05-31,18,19,19,0,401,422,421,1,98,0,0,5,747,747,747,747
Santa Barbara,77,2023-05-31,10,11,11,0,269,284,283,1,71,1,3,0,772,775,771,772
Santa Clara,77,2023-05-31,57,60,60,0,1107,1164,1163,1,485,0,0,86,2824,2826,2824,2826
Santa Cruz,77,2023-05-31,14,15,15,0,154,163,162,1,26,0,0,2,276,276,276,276
Shasta,77,2023-05-31,2,2,2,0,27,29,28,1,38,0,0,7,612,612,612,612
Siskiyou,77,2023-05-31,0,0,0,0,13,15,14,1,0,0,0,0,97,97,97,97
Solano,77,2023-05-31,18,19,19,0,231,244,243,1,86,0,0,15,476,476,476,476
Sonoma,77,2023-05-31,11,12,12,0,221,233,232,1,125,0,0,18,574,574,574,574
Stanislaus,77,2023-05-31,11,12,12,0,223,235,234,1,116,0,0,13,1842,1842,1842,1842
Sutter,77,2023-05-31,3,3,3,0,34,37,36,1,0,0,0,0,242,242,242,242
Tehama,77,2023-05-31,2,2,2,0,19,21,20,1,8,0,0,0,240,242,240,242
Trinity,77,2023-05-31,0,0,0,0,1,2,1,1,0,0,0,0,25,25,25,25
Tulare,77,2023-05-31,2,2,2,0,156,165,164,1,29,0,0,4,1599,1599,1599,1599
Tuolumne,77,2023-05-31,0,0,0,0,18,20,19,1,10,0,0,1,211,211,211,211
Ventura,77,2023-05-31,19,20,20,0,406,428,427,1,127,1,3,7,1706,1709,1705,1706
Yolo,77,2023-05-31,3,3,3,0,52,56,55,1,6,0,0,3,455,455,455,455
Yuba,77,2023-05-31,0,0,0,0,21,23,22,1,10,0,0,0,134,134,134,134
Alameda,78,2023-06-07,44,51,51,0,1005,1166,1165,1,347,0,0,19,2167,2175,2167,2175
Amador,78,2023-06-07,0,0,0,0,20,24,23,1,2,0,0,3,99,99,99,99
Butte,78,2023-06-07,2,2,2,0,91,106,105,1,33,0,0,1,500,500,500,500
Calaveras,78,2023-06-07,3,3,3,0,17,21,20,1,0,0,0,0,143,143,143,143
Colusa,78,2023-06-07,0,0,0,0,5,7,6,1,0,0,0,0,24,24,24,24
Contra Costa,78,2023-06-07,18,21,21,0,783,909,908,1,252,0,0,24,1600,1601,1600,1601
Del Norte,78,2023-06-07,1,1,1,0,7,9,8,1,8,0,0,0,62,62,62,62
El Dorado,78,2023-06-07,1,1,1,0,51,60,59,1,14,0,0,4,247,247,247,247
Fresno,78,2023-06-07,22,26,26,0,515,598,597,1,258,0,0,34,3031,3031,3031,3031
Glenn,78,2023-06-07,1,1,1,0,11,14,13,1,0,0,0,0,56,56,56,56
Humboldt,78,2023-06-07,1,1,1,0,29,35,34,1,18,0,0,0,171,171,171,171
Imperial,78,2023-06-07,1,1,1,0,91,106,105,1,5,0,0,6,986,991,986,991
Inyo,78,2023-06-07,1,1,1,0,11,14,13,1,1,0,0,2,63,63,63,63
Kern,78,2023-06-07,17,20,20,0,311,362,361,1,46,0,0,7,2501,2501,2501,2501
Kings,78,2023-06-07,4,5,5,0,79,93,92,1,4,0,0,0,487,487,487,487
Lake,78,2023-06-07,1,1,1,0,21,25,24,1,9,0,0,0,165,166,165,166
Lassen,78,2023-06-07,1,1,1,0,7,9,8,1,2,0,0,0,65,65,65,65
Los Angeles,78,2023-06-07,142,165,165,0,373,433,432,1,1726,1,11,222,36212,36341,36211,36330
Madera,78,2023-06-07,3,3,3,0,73,86,85,1,4,0,0,0,377,377,377,377
Marin,78,2023-06-07,4,5,5,0,73,86,85,1,74,0,0,18,260,260,260,260
Mariposa,78,2023-06-07,0,0,0,0,0,1,0,1,0,0,0,0,31,31,31,31
Mendocino,78,2023-06-07,1,1,1,0,21,25,24,1,3,0,0,2,146,146,146,146
Merced,78,2023-06-07,2,2,2,0,47,55,54,1,9,0,0,0,903,903,903,903
Modoc,78,2023-06-07,0,0,0,0,0,1,0,1,0,0,0,0,11,11,11,11
Mono,78,2023-06-07,0,0,0,0,4,6,5,1,0,0,0,0,8,8,8,8
Monterey,78,2023-06-07,10,12,12,0,138,161,160,1,30,0,0,0,817,818,817,818
Napa,78,2023-06-07,0,0,0,0,58,68,67,1,16,0,0,3,178,178,178,178
Nevada,78,2023-06-07,1,1,1,0,21,25,24,1,9,0,0,4,139,139,139,139
Orange,78,2023-06-07,47,54,54,0,1068,1239,1238,1,378,0,0,68,8200,8227,8200,8227
Placer,78,2023-06-07,5,6,6,0,144,168,167,1,217,0,0,20,686,686,686,686
Plumas,78,2023-06-07,0,0,0,0,4,6,5,1,0,0,0,0,15,15,15,15
Riverside,78,2023-06-07,17,20,20,0,820,952,951,1,181,0,0,17,6859,6859,6859,6859
Sacramento,78,2023-06-07,36,42,42,0,695,807,806,1,337,0,0,64,3603,3604,3603,3604
San Benito,78,2023-06-07,3,3,3,0,42,50,49,1,2,0,0,0,117,117,117,117
San Bernardino,78,2023-06-07,24,28,28,0,778,903,902,1,167,0,0,27,8143,8143,8143,8143
San Diego,78,2023-06-07,64,74,74,0,1191,1382,1381,1,511,0,0,61,5888,5898,5888,5898
San Francisco,78,2023-06-07,35,41,41,0,587,681,680,1,236,0,0,26,1227,1235,1227,1235
San Joaquin,78,2023-06-07,13,15,15,0,319,371,370,1,60,0,0,22,2460,2460,2460,2460
San Luis Obispo,78,2023-06-07,3,3,3,0,68,80,79,1,41,0,0,0,582,582,582,582
San Mateo,78,2023-06-07,28,32,32,0,404,469,468,1,98,0,0,7,747,747,747,747
Santa Barbara,78,2023-06-07,13,15,15,0,293,341,340,1,75,0,0,0,774,788,774,788
Santa Clara,78,2023-06-07,59,68,68,0,1196,1387,1386,1,469,0,0,94,2824,2826,2824,2826
Santa Cruz,78,2023-06-07,5,6,6,0,99,116,115,1,32,0,0,11,276,276,276,276
Shasta,78,2023-06-07,0,0,0,0,31,37,36,1,22,0,0,22,612,612,612,612
Siskiyou,78,2023-06-07,0,0,0,0,4,6,5,1,4,0,0,0,97,97,97,97
Solano,78,2023-06-07,14,16,16,0,193,225,224,1,110,0,0,23,476,476,476,476
Sonoma,78,2023-06-07,10,12,12,0,218,254,253,1,86,0,0,11,574,574,574,574
Stanislaus,78,2023-06-07,4,5,5,0,168,196,195,1,87,0,0,21,1842,1842,1842,1842
Sutter,78,2023-06-07,1,1,1,0,29,35,34,1,0,0,0,0,242,242,242,242
Tehama,78,2023-06-07,3,3,3,0,17,21,20,1,2,0,0,0,240,242,240,242
Trinity,78,2023-06-07,1,1,1,0,3,4,3,1,0,0,0,0,25,25,25,25
Tulare,78,2023-06-07,4,5,5,0,57,67,66,1,30,0,0,0,1599,1599,1599,1599
Tuolumne,78,2023-06-07,2,2,2,0,18,22,21,1,12,0,0,0,211,211,211,211
Ventura,78,2023-06-07,14,16,16,0,287,334,333,1,110,0,0,3,1706,1709,1706,1709
Yolo,78,2023-06-07,3,3,3,0,54,64,63,1,9,0,0,0,455,455,455,455
Yuba,78,2023-06-07,1,1,1,0,24,29,28,1,12,0,0,4,134,134,134,134
California,1,2021-12-20,84299,84299,47180,37119,2163432,2163442,1234396,929046,2585,503,503,932,77305,77305,76802,76802
California,2,2021-12-27,241967,241967,151920,90047,1954398,1954406,1192648,761758,3348,496,496,1030,77801,77801,77305,77305
California,3,2022-01-03,549768,549769,369331,180438,2956528,2956549,1966541,990008,6125,592,592,1280,78393,78393,77801,77801
California,4,2022-01-10,866772,866777,619375,247402,4666438,4666480,3353804,1312676,10002,947,947,1813,79340,79340,78393,78393
California,5,2022-01-17,661186,661189,492541,168648,3984059,3984094,3022226,961868,12343,1434,1434,2311,80774,80774,79340,79340
California,6,2022-01-24,526631,526633,411854,114779,3989051,3989098,3193409,795689,12648,1779,1779,2600,82553,82553,80774,80774
California,7,2022-01-31,269853,269853,219246,50607,3154970,3155011,2636083,518928,10873,1911,1911,2494,84464,84464,82553,82553
California,8,2022-02-07,149160,149160,125625,23535,2670370,2670403,2318211,352192,8405,1784,1784,2007,86248,86248,84464,84464
California,9,2022-02-14,85680,85680,74680,11000,2322985,2323012,2079803,243209,6407,1439,1439,1564,87687,87687,86248,86248
California,10,2022-02-21,48019,48019,42996,5023,1850859,1850881,1692115,158766,4557,1012,1012,1098,88699,88699,87687,87687
California,11,2022-02-28,32603,32603,29897,2706,2098735,2098771,1961842,136929,3357,696,696,772,89395,89395,88699,88699
California,12,2022-03-07,22946,22946,21438,1508,1819640,1819685,1725092,94593,2435,502,502,581,89897,89897,89395,89395
California,13,2022-03-14,16967,16967,16090,877,1725511,1725559,1655217,70342,1844,361,361,419,90258,90258,89897,89897
California,14,2022-03-21,14623,14623,14041,582,1646461,1646517,1593812,52705,1537,252,252,313,90510,90510,90258,90258
California,15,2022-03-28,15459,15459,14978,481,1463361,1463407,1425805,37602,1150,183,183,264,90693,90693,90510,90510
California,16,2022-04-04,17667,17667,17251,416,1525131,1525185,1495651,29534,943,144,144,211,90837,90837,90693,90693
California,17,2022-04-11,21502,21502,21110,392,1343374,1343427,1322583,20844,905,124,124,148,90961,90961,90837,90837
California,18,2022-04-18,26868,26868,26478,390,1131763,1131821,1116929,14892,823,113,113,141,91074,91074,90961,90961
California,19,2022-04-25,37262,37262,36833,429,1622867,1622970,1608112,14858,838,93,93,112,91167,91167,91074,91074
California,20,2022-05-02,48935,48935,48500,435,1701892,1702015,1689786,12229,950,85,85,143,91252,91252,91167,91167
California,21,2022-05-09,63345,63345,62900,445,1770753,1770914,1760877,10037,1050,83,83,153,91335,91335,91252,91252
California,22,2022-05-16,80327,80328,79876,452,1840275,1840475,1832226,8249,1345,120,120,182,91455,91455,91335,91335
California,23,2022-05-23,97891,97896,97476,420,1870791,1871010,1864416,6594,1714,117,117,217,91572,91572,91455,91455
California,24,2022-05-30,90581,90585,90275,310,1499378,1499578,1495327,4251,1918,152,152,272,91724,91724,91572,91572
California,25,2022-06-06,120591,120598,120280,318,1939523,1939879,1935783,4096,2305,139,139,276,91863,91863,91724,91724
California,26,2022-06-13,105278,105285,105068,217,1406990,1407312,1404830,2482,2471,180,180,291,92043,92043,91863,91863
California,27,2022-06-20,101447,101458,101296,162,1026995,1027298,1025709,1589,2552,211,211,310,92254,92254,92043,92043
California,28,2022-06-27,115560,115584,115446,138,1044203,1044631,1043379,1252,3006,219,219,339,92473,92473,92254,92254
California,29,2022-07-04,108326,108364,108262,102,837141,837561,836755,806,3167,271,271,393,92744,92744,92473,92473
California,30,2022-07-11,141416,141479,141379,100,1082794,1083431,1082640,791,3824,297,297,453,93041,93041,92744,92744
California,31,2022-07-18,129820,129890,129817,73,993246,993924,993360,564,4148,295,295,528,93336,93336,93041,93041
California,32,2022-07-25,117639,117708,117661,47,948842,949547,949123,424,4310,362,362,516,93698,93698,93336,93336
California,33,2022-08-01,99335,99393,99360,33,875914,876641,876328,313,4119,361,361,535,94059,94059,93698,93698
California,34,2022-08-08,83536,83593,83573,20,825644,826429,826197,232,3754,338,338,474,94397,94397,94059,94059
California,35,2022-08-15,69107,69157,69145,12,794602,795433,795251,182,3363,302,302,448,94699,94699,94397,94397
California,36,2022-08-22,61526,61573,61567,6,778909,779768,779622,146,3087,289,289,418,94988,94988,94699,94699
California,37,2022-08-29,51922,51963,51960,3,769338,770250,770129,121,2752,219,219,351,95207,95207,94988,94988
California,38,2022-09-05,36770,36796,36796,0,631263,632051,631962,89,2525,249,249,350,95456,95456,95207,95207
California,39,2022-09-12,36481,36502,36502,0,756024,756995,756910,85,2422,224,224,346,95680,95680,95456,95456
California,40,2022-09-19,27837,27852,27852,0,690289,691210,691139,71,2041,182,182,272,95862,95862,95680,95680
California,41,2022-09-26,25523,25538,25538,0,641904,642777,642713,64,1818,169,169,230,96031,96031,95862,95862
California,42,2022-10-03,23483,23497,23497,0,588100,588935,588875,60,1647,150,150,247,96181,96181,96031,96031
California,43,2022-10-10,23539,23547,23547,0,628795,629728,629670,58,1537,159,159,228,96322,96322,96163,96163
California,44,2022-10-17,18793,18800,18800,0,524250,525070,525013,57,1397,119,119,218,96441,96441,96322,96322
California,45,2022-10-24,18660,18669,18669,0,514526,515351,515294,57,1324,117,117,190,96558,96558,96441,96441
California,46,2022-10-31,20809,20819,20819,0,523965,524838,524781,57,1401,115,115,191,96673,96673,96558,96558
California,47,2022-11-07,27021,27040,27040,0,548932,549869,549812,57,1525,133,133,231,96806,96806,96673,96673
California,48,2022-11-14,30996,31021,31021,0,550779,551737,551680,57,1775,118,118,260,96924,96924,96806,96806
California,49,2022-11-21,40437,40486,40486,0,576940,577978,577921,57,2268,154,154,330,97078,97078,96924,96924
California,50,2022-11-28,54571,54651,54651,0,518903,519856,519799,57,3153,210,210,379,97288,97288,97078,97078
California,51,2022-12-05,66472,66572,66572,0,659916,661182,661124,58,3715,247,247,493,97535,97535,97288,97288
California,52,2022-12-12,56920,57012,57012,0,622158,623419,623361,58,3944,353,353,527,97888,97888,97535,97535
California,53,2022-12-19,51131,51217,51217,0,575826,577048,576991,57,3997,329,329,523,98217,98217,97888,97888
California,54,2022-12-26,45804,45882,45882,0,421347,422286,422229,57,3906,412,412,510,98629,98629,98217,98217
California,55,2023-01-02,45459,45539,45539,0,425585,426572,426515,57,4077,365,365,528,98994,98994,98629,98629
California,56,2023-01-09,33953,34014,34014,0,508264,509510,509453,57,3672,350,350,487,99344,99344,98994,98994
California,57,2023-01-16,20414,20445,20445,0,411430,412494,412437,57,3075,325,325,425,99669,99669,99344,99344
California,58,2023-01-23,18552,18583,18583,0,453983,455242,455185,57,2400,248,248,369,99917,99917,99669,99669
California,59,2023-01-30,19444,19477,19477,0,420868,422128,422071,57,2214,216,216,266,100133,100133,99917,99917
California,60,2023-02-06,21442,21489,21489,0,406192,407502,407445,57,2231,181,181,280,100314,100314,100133,100133
California,61,2023-02-13,21405,21457,21457,0,385866,387232,387176,56,2223,156,156,287,100470,100470,100314,100314
California,62,2023-02-20,19806,19863,19863,0,346741,348136,348080,56,2159,177,177,292,100647,100647,100470,100470
California,63,2023-02-27,19965,20031,20031,0,383150,384846,384789,57,2220,170,170,310,100817,100817,100647,100647
California,64,2023-03-06,17450,17513,17513,0,358437,360207,360151,56,2074,156,156,262,100973,100973,100817,100817
California,65,2023-03-13,15912,15976,15976,0,352697,354580,354524,56,1939,161,161,278,101134,101134,100973,100973
California,66,2023-03-20,12554,12609,12609,0,325730,327728,327672,56,1701,135,135,237,101269,101269,101134,101134
California,67,2023-03-27,10372,10423,10423,0,301950,304136,304080,56,1498,101,101,196,101370,101370,101269,101269
California,68,2023-04-03,10209,10273,10273,0,275212,277527,277471,56,1363,107,107,176,101477,101477,101370,101370
California,69,2023-04-10,9765,9842,9842,0,255949,258493,258437,56,1312,91,91,173,101568,101568,101477,101477
California,70,2023-04-17,9418,9502,9502,0,274414,277522,277466,56,1316,78,80,149,101646,101648,101568,101568
California,71,2023-04-24,8510,8594,8594,0,260844,264170,264114,56,1278,85,88,148,101731,101736,101646,101648
California,72,2023-05-01,7848,7939,7939,0,246155,249718,249662,56,1149,76,81,133,101807,101817,101731,101736
California,73,2023-05-08,7177,7271,7271,0,219977,223662,223606,56,1057,61,67,131,101868,101884,101807,101817
California,74,2023-05-12,4659,4727,4727,0,146692,149524,149468,56,999,30,33,150,101898,101917,101868,101884
California,75,2023-05-19,855,874,874,0,21654,22253,22197,56,2705,7,9,272,101954,101987,101947,101978
California,76,2023-05-25,840,864,864,0,23026,23833,23778,55,5170,5,10,542,101970,102033,101965,102023
California,77,2023-05-31,863,908,908,0,22839,24055,23999,56,6528,7,22,806,102045,102171,102038,102149
California,78,2023-06-07,690,797,797,0,12673,14751,14695,56,6158,1,11,850,102063,102275,102062,102264
