county,time,date,cases,est_cases,est_omicron_cases,est_other_cases,tests,est_tests,est_omicron_tests,est_other_tests,hospitalizations,deaths,est_deaths,icu,cum_deaths,cum_est_deaths,prev_cum_deaths,prev_cum_est_deaths
Alameda,1,2021-12-20,2983,2983,1419,1564,89769,89774,41920,47854,47,9,9,14,1549,1549,1540,1540
Amador,1,2021-12-20,49,49,18,31,1716,1716,602,1114,2,0,0,3,70,70,70,70
Butte,1,2021-12-20,193,193,101,92,4386,4386,2286,2100,24,5,5,1,359,359,354,354
Calaveras,1,2021-12-20,59,59,23,36,1520,1520,582,938,1,2,2,0,92,92,90,90
Colusa,1,2021-12-20,11,11,5,6,397,397,170,227,1,0,0,0,21,21,21,21
Contra Costa,1,2021-12-20,1684,1684,590,1094,43228,43228,14848,28380,27,4,4,7,1080,1080,1076,1076
Del Norte,1,2021-12-20,19,19,8,11,1378,1378,570,808,0,0,0,0,42,42,42,42
El Dorado,1,2021-12-20,238,238,93,145,4466,4466,1729,2737,4,4,4,3,179,179,175,175
Fresno,1,2021-12-20,1058,1058,380,678,25057,25057,8919,16138,131,19,19,45,2419,2419,2400,2400
Glenn,1,2021-12-20,20,20,8,12,462,462,185,277,0,0,0,0,41,41,41,41
Humboldt,1,2021-12-20,164,164,67,97,3772,3772,1529,2243,11,1,1,2,121,121,120,120
Imperial,1,2021-12-20,585,585,225,360,5535,5535,2109,3426,40,9,9,27,817,817,808,808
Inyo,1,2021-12-20,31,31,14,17,358,358,154,204,1,1,1,0,49,49,48,48
Kern,1,2021-12-20,927,927,401,526,26093,26093,11160,14933,84,24,24,27,2023,2023,1999,1999
Kings,1,2021-12-20,244,244,94,150,6912,6912,2638,4274,15,6,6,3,389,389,383,383
Lake,1,2021-12-20,37,37,13,24,1317,1317,464,853,0,0,0,0,116,116,116,116
Lassen,1,2021-12-20,11,11,5,6,2387,2387,1093,1294,0,0,0,0,54,54,54,54
Los Angeles,1,2021-12-20,31634,31634,22013,9621,985589,985633,676267,309366,574,107,107,174,27374,27374,27267,27267
Madera,1,2021-12-20,159,159,56,103,6014,6014,2122,3892,9,3,3,5,334,334,331,331
Marin,1,2021-12-20,567,567,211,356,11810,11810,4294,7516,5,1,1,1,256,256,255,255
Mariposa,1,2021-12-20,21,21,7,14,448,448,154,294,0,0,0,0,21,21,21,21
Mendocino,1,2021-12-20,91,91,27,64,2687,2687,789,1898,3,2,2,4,103,103,101,101
Merced,1,2021-12-20,323,323,138,185,5616,5616,2366,3250,11,6,6,12,693,693,687,687
Modoc,1,2021-12-20,5,5,2,3,67,67,30,37,2,0,0,0,6,6,6,6
Mono,1,2021-12-20,37,37,10,27,313,313,81,232,1,0,0,0,4,4,4,4
Monterey,1,2021-12-20,481,481,126,355,13259,13259,3421,9838,23,3,3,8,642,642,639,639
Napa,1,2021-12-20,229,229,106,123,5390,5390,2432,2958,2,1,1,2,108,108,107,107
Nevada,1,2021-12-20,161,161,58,103,2764,2764,999,1765,4,1,1,2,110,110,109,109
Orange,1,2021-12-20,4864,4864,2404,2460,99380,99385,48408,50977,132,34,34,56,6020,6020,5986,5986
Placer,1,2021-12-20,555,555,190,365,11155,11155,3769,7386,53,6,6,24,501,501,495,495
Plumas,1,2021-12-20,16,16,6,10,513,513,195,318,0,0,0,0,12,12,12,12
Riverside,1,2021-12-20,5609,5609,2352,3257,78334,78338,32451,45887,238,40,40,82,5579,5579,5539,5539
Sacramento,1,2021-12-20,2148,2148,857,1291,53573,53573,21167,32406,101,21,21,41,2490,2490,2469,2469
San Benito,1,2021-12-20,91,91,41,50,1928,1928,860,1068,2,3,3,2,81,81,78,78
San Bernardino,1,2021-12-20,5011,5011,2369,2642,79698,79703,37183,42520,299,66,66,112,6510,6510,6444,6444
San Diego,1,2021-12-20,8681,8681,5933,2748,149629,149636,101541,48095,249,29,29,94,4479,4479,4450,4450
San Francisco,1,2021-12-20,2988,2988,741,2247,57003,57003,13806,43197,28,3,3,10,693,693,690,690
San Joaquin,1,2021-12-20,952,952,359,593,25345,25345,9400,15945,48,13,13,27,1972,1972,1959,1959
San Luis Obispo,1,2021-12-20,425,425,187,238,9993,9993,4349,5644,11,3,3,6,371,371,368,368
San Mateo,1,2021-12-20,1560,1560,771,789,50631,50631,24529,26102,9,0,0,5,601,601,601,601
Santa Barbara,1,2021-12-20,789,789,326,463,15818,15818,6434,9384,18,8,8,12,570,570,562,562
Santa Clara,1,2021-12-20,2948,2948,1981,967,118952,118957,78837,40120,85,8,8,38,1978,1978,1970,1970
Santa Cruz,1,2021-12-20,404,404,182,222,19816,19816,8760,11056,11,2,2,5,230,230,228,228
Shasta,1,2021-12-20,163,163,65,98,6035,6035,2392,3643,28,8,8,8,448,448,440,440
Siskiyou,1,2021-12-20,20,20,9,11,449,449,207,242,2,2,2,2,63,63,61,61
Solano,1,2021-12-20,497,497,207,290,14795,14795,6087,8708,21,4,4,5,389,389,385,385
Sonoma,1,2021-12-20,754,754,320,434,20780,20780,8668,12112,22,1,1,6,420,420,419,419
Stanislaus,1,2021-12-20,670,670,210,460,13020,13020,4035,8985,90,13,13,22,1432,1432,1419,1419
Sutter,1,2021-12-20,123,123,51,72,2315,2315,947,1368,0,2,2,0,193,193,191,191
Tehama,1,2021-12-20,52,52,17,35,1324,1324,425,899,4,0,0,3,165,165,165,165
Trinity,1,2021-12-20,1,1,0,1,98,98,31,67,0,1,1,0,19,19,18,18
Tulare,1,2021-12-20,404,404,125,279,12352,12352,3799,8553,36,19,19,13,1307,1307,1288,1288
Tuolumne,1,2021-12-20,97,97,35,62,1940,1940,693,1247,7,0,0,0,150,150,150,150
Ventura,1,2021-12-20,2046,2046,1052,994,39239,39239,19902,19337,62,9,9,14,1216,1216,1207,1207
Yolo,1,2021-12-20,329,329,146,183,24709,24709,10825,13884,4,0,0,1,295,295,295,295
Yuba,1,2021-12-20,100,100,43,57,1874,1874,799,1075,3,0,0,4,102,102,102,102
Alameda,2,2021-12-27,7516,7516,4028,3488,87418,87422,46209,41213,89,12,12,19,1561,1561,1549,1549
Amador,2,2021-12-27,92,92,38,54,1445,1445,590,855,2,0,0,3,70,70,70,70
Butte,2,2021-12-27,540,540,318,222,4551,4551,2662,1889,37,3,3,3,362,362,359,359
Calaveras,2,2021-12-27,100,100,45,55,989,989,442,547,1,1,1,1,93,93,92,92
Colusa,2,2021-12-27,27,27,14,13,243,243,119,124,4,0,0,0,21,21,21,21
Contra Costa,2,2021-12-27,5141,5141,2106,3035,46336,46336,18596,27740,44,3,3,16,1083,1083,1080,1080
Del Norte,2,2021-12-27,25,25,12,13,1423,1423,679,744,0,0,0,1,42,42,42,42
El Dorado,2,2021-12-27,511,511,231,280,4086,4086,1816,2270,7,0,0,4,179,179,179,179
Fresno,2,2021-12-27,2209,2209,935,1274,23916,23916,9955,13961,122,16,16,41,2435,2435,2419,2419
Glenn,2,2021-12-27,53,53,24,29,451,451,207,244,0,1,1,0,42,42,41,41
Humboldt,2,2021-12-27,501,501,238,263,3456,3456,1617,1839,10,1,1,0,122,122,121,121
Imperial,2,2021-12-27,881,881,396,485,5910,5910,2617,3293,35,10,10,26,827,827,817,817
Inyo,2,2021-12-27,109,109,54,55,447,447,219,228,0,1,1,0,50,50,49,49
Kern,2,2021-12-27,1988,1988,996,992,22592,22592,11165,11427,79,18,18,36,2041,2041,2023,2023
Kings,2,2021-12-27,506,506,229,277,5481,5481,2433,3048,17,1,1,3,390,390,389,389
Lake,2,2021-12-27,67,67,28,39,1203,1203,495,708,0,1,1,0,117,117,116,116
Lassen,2,2021-12-27,21,21,11,10,2242,2242,1160,1082,0,0,0,0,54,54,54,54
Los Angeles,2,2021-12-27,96133,96137,71600,24537,717703,717734,530962,186772,862,115,115,207,27489,27489,27374,27374
Madera,2,2021-12-27,341,341,144,197,4210,4210,1748,2462,9,2,2,4,336,336,334,334
Marin,2,2021-12-27,1607,1607,688,919,16774,16774,7084,9690,3,0,0,1,256,256,256,256
Mariposa,2,2021-12-27,36,36,15,21,493,493,195,298,0,0,0,0,21,21,21,21
Mendocino,2,2021-12-27,152,152,55,97,2496,2496,862,1634,5,0,0,2,103,103,103,103
Merced,2,2021-12-27,653,653,322,331,5100,5100,2471,2629,11,7,7,10,700,700,693,693
Modoc,2,2021-12-27,3,3,1,2,38,38,19,19,1,0,0,0,6,6,6,6
Mono,2,2021-12-27,123,123,38,85,366,366,110,256,1,0,0,0,4,4,4,4
Monterey,2,2021-12-27,1009,1009,318,691,12882,12882,3971,8911,21,3,3,11,645,645,642,642
Napa,2,2021-12-27,809,809,422,387,6660,6660,3443,3217,6,0,0,1,108,108,108,108
Nevada,2,2021-12-27,236,236,100,136,1984,1984,815,1169,6,1,1,1,111,111,110,110
Orange,2,2021-12-27,18031,18031,10058,7973,130303,130309,71861,58448,256,31,31,66,6051,6051,6020,6020
Placer,2,2021-12-27,1251,1251,502,749,10769,10769,4261,6508,63,2,2,27,503,503,501,501
Plumas,2,2021-12-27,18,18,8,10,299,299,129,170,0,0,0,0,12,12,12,12
Riverside,2,2021-12-27,13684,13684,6601,7083,87498,87502,41714,45788,306,53,53,81,5632,5632,5579,5579
Sacramento,2,2021-12-27,5200,5200,2414,2786,52471,52472,24000,28472,135,22,22,44,2512,2512,2490,2490
San Benito,2,2021-12-27,317,317,163,154,2307,2307,1173,1134,1,3,3,3,84,84,81,81
San Bernardino,2,2021-12-27,14388,14388,7730,6658,87891,87895,46456,41439,341,69,69,141,6579,6579,6510,6510
San Diego,2,2021-12-27,27100,27100,19917,7183,177595,177602,129644,47958,315,34,34,96,4513,4513,4479,4479
San Francisco,2,2021-12-27,6858,6858,2010,4848,65930,65934,19044,46890,31,1,1,14,694,694,693,693
San Joaquin,2,2021-12-27,2350,2350,1037,1313,22785,22785,9888,12897,61,15,15,25,1987,1987,1972,1972
San Luis Obispo,2,2021-12-27,1153,1153,583,570,11182,11182,5563,5619,11,1,1,8,372,372,371,371
San Mateo,2,2021-12-27,5283,5283,2933,2350,55543,55544,30397,25147,19,2,2,5,603,603,601,601
Santa Barbara,2,2021-12-27,2142,2142,1022,1120,15278,15278,7172,8106,33,5,5,10,575,575,570,570
Santa Clara,2,2021-12-27,9051,9051,6550,2501,107056,107060,76807,30253,95,10,10,38,1988,1988,1978,1978
Santa Cruz,2,2021-12-27,946,946,489,457,12423,12423,6305,6118,11,0,0,2,230,230,230,230
Shasta,2,2021-12-27,263,263,123,140,4624,4624,2123,2501,32,5,5,12,453,453,448,448
Siskiyou,2,2021-12-27,21,21,11,10,360,360,190,170,0,0,0,0,63,63,63,63
Solano,2,2021-12-27,1300,1300,627,673,17100,17100,8112,8988,25,5,5,5,394,394,389,389
Sonoma,2,2021-12-27,1912,1912,933,979,21664,21664,10424,11240,19,1,1,5,421,421,420,420
Stanislaus,2,2021-12-27,1249,1249,468,781,11151,11151,4114,7037,94,17,17,18,1449,1449,1432,1432
Sutter,2,2021-12-27,226,226,108,118,2131,2131,1006,1125,0,2,2,0,195,195,193,193
Tehama,2,2021-12-27,103,103,40,63,1106,1106,419,687,6,2,2,3,167,167,165,165
Trinity,2,2021-12-27,4,4,2,2,101,101,37,64,0,0,0,0,19,19,19,19
Tulare,2,2021-12-27,815,815,301,514,11116,11116,4057,7059,36,10,10,9,1317,1317,1307,1307
Tuolumne,2,2021-12-27,171,171,72,99,1672,1672,692,980,5,0,0,1,150,150,150,150
Ventura,2,2021-12-27,5720,5720,3307,2413,39329,39329,22501,16828,66,8,8,19,1224,1224,1216,1216
Yolo,2,2021-12-27,818,818,417,401,22131,22131,11087,11044,7,1,1,4,296,296,295,295
Yuba,2,2021-12-27,164,164,81,83,1534,1534,749,785,8,1,1,4,103,103,102,102
Alameda,3,2022-01-03,17665,17665,10485,7180,117295,117301,69478,47823,156,5,5,31,1566,1566,1561,1561
Amador,3,2022-01-03,218,218,104,114,2179,2179,1029,1150,5,1,1,2,71,71,70,70
Butte,3,2022-01-03,1202,1202,778,424,6876,6876,4433,2443,32,0,0,4,362,362,362,362
Calaveras,3,2022-01-03,232,232,120,112,1305,1305,666,639,0,1,1,1,94,94,93,93
Colusa,3,2022-01-03,48,48,26,22,393,393,217,176,5,0,0,0,21,21,21,21
Contra Costa,3,2022-01-03,13516,13516,6287,7229,69128,69132,32073,37059,76,10,10,21,1093,1093,1083,1083
Del Norte,3,2022-01-03,86,86,47,39,2132,2132,1143,989,0,0,0,0,42,42,42,42
El Dorado,3,2022-01-03,1290,1290,660,630,6062,6062,3079,2983,7,4,4,6,183,183,179,179
Fresno,3,2022-01-03,6603,6603,3174,3429,38678,38678,18464,20214,175,14,14,44,2449,2449,2435,2435
Glenn,3,2022-01-03,77,77,40,37,610,610,318,292,0,1,1,0,43,43,42,42
Humboldt,3,2022-01-03,881,881,471,410,5295,5295,2810,2485,9,1,1,3,123,123,122,122
Imperial,3,2022-01-03,1878,1878,956,922,9148,9148,4619,4529,35,14,14,29,841,841,827,827
Inyo,3,2022-01-03,265,265,147,118,713,713,394,319,3,0,0,0,50,50,50,50
Kern,3,2022-01-03,5835,5835,3271,2564,35876,35877,19999,15878,100,16,16,32,2057,2057,2041,2041
Kings,3,2022-01-03,1096,1096,561,535,8511,8511,4310,4201,13,3,3,5,393,393,390,390
Lake,3,2022-01-03,220,220,106,114,1777,1777,847,930,1,0,0,1,117,117,117,117
Lassen,3,2022-01-03,61,61,35,26,3119,3119,1806,1313,2,0,0,0,54,54,54,54
Los Angeles,3,2022-01-03,204134,204144,160552,43592,1088044,1088098,856053,232045,1937,149,149,303,27638,27638,27489,27489
Madera,3,2022-01-03,830,830,398,432,6362,6362,3024,3338,17,3,3,6,339,339,336,336
Marin,3,2022-01-03,2363,2363,1148,1215,17674,17674,8532,9142,15,1,1,3,257,257,256,256
Mariposa,3,2022-01-03,103,103,48,55,657,657,304,353,0,0,0,0,21,21,21,21
Mendocino,3,2022-01-03,453,453,187,266,3572,3572,1454,2118,7,1,1,2,104,104,103,103
Merced,3,2022-01-03,1551,1551,852,699,8548,8548,4667,3881,3,9,9,4,709,709,700,700
Modoc,3,2022-01-03,15,15,8,7,59,59,33,26,0,0,0,0,6,6,6,6
Mono,3,2022-01-03,180,180,65,115,435,435,156,279,2,0,0,0,4,4,4,4
Monterey,3,2022-01-03,2465,2465,908,1557,20639,20639,7547,13092,30,4,4,10,649,649,645,645
Napa,3,2022-01-03,1856,1856,1076,780,11756,11756,6790,4966,9,1,1,3,109,109,108,108
Nevada,3,2022-01-03,647,647,314,333,3071,3071,1485,1586,7,1,1,3,112,112,111,111
Orange,3,2022-01-03,45470,45471,27785,17686,220202,220213,134354,85859,504,34,34,110,6085,6085,6051,6051
Placer,3,2022-01-03,2914,2914,1336,1578,15070,15070,6862,8208,113,15,15,24,518,518,503,503
Plumas,3,2022-01-03,55,55,28,27,496,496,248,248,1,0,0,0,12,12,12,12
Riverside,3,2022-01-03,32051,32051,17312,14739,138452,138459,74452,64007,564,54,54,94,5686,5686,5632,5632
Sacramento,3,2022-01-03,14147,14147,7387,6760,80498,80502,41836,38666,219,25,25,57,2537,2537,2512,2512
San Benito,3,2022-01-03,739,739,422,317,3464,3464,1976,1488,3,1,1,2,85,85,84,84
San Bernardino,3,2022-01-03,33812,33812,19999,13813,135045,135050,79600,55450,571,94,94,136,6673,6673,6579,6579
San Diego,3,2022-01-03,61070,61072,47443,13629,253655,253667,196962,56705,561,35,35,121,4548,4548,4513,4513
San Francisco,3,2022-01-03,11440,11440,3974,7466,85528,85532,29513,56019,78,5,5,22,699,699,694,694
San Joaquin,3,2022-01-03,6977,6977,3479,3498,36140,36140,17905,18235,80,13,13,27,2000,2000,1987,1987
San Luis Obispo,3,2022-01-03,2473,2473,1386,1087,15963,15963,8917,7046,24,5,5,7,377,377,372,372
San Mateo,3,2022-01-03,10628,10628,6507,4121,81980,81985,50099,31886,37,4,4,7,607,607,603,603
Santa Barbara,3,2022-01-03,5326,5326,2851,2475,28193,28193,15053,13140,53,5,5,7,580,580,575,575
Santa Clara,3,2022-01-03,23027,23027,17702,5325,170168,170176,130640,39536,186,10,10,58,1998,1998,1988,1988
Santa Cruz,3,2022-01-03,2410,2410,1388,1022,21662,21662,12485,9177,15,5,5,3,235,235,230,230
Shasta,3,2022-01-03,602,602,318,284,6174,6174,3228,2946,33,2,2,13,455,455,453,453
Siskiyou,3,2022-01-03,74,74,44,30,590,590,348,242,0,0,0,0,63,63,63,63
Solano,3,2022-01-03,4072,4072,2181,1891,26219,26219,14027,12192,54,3,3,9,397,397,394,394
Sonoma,3,2022-01-03,4541,4541,2480,2061,32189,32189,17530,14659,25,7,7,4,428,428,421,421
Stanislaus,3,2022-01-03,3333,3333,1436,1897,17985,17985,7689,10296,129,9,9,20,1458,1458,1449,1449
Sutter,3,2022-01-03,547,547,296,251,2980,2980,1594,1386,0,2,2,0,197,197,195,195
Tehama,3,2022-01-03,216,216,97,119,1474,1474,652,822,4,1,1,2,168,168,167,167
Trinity,3,2022-01-03,14,14,6,8,107,107,46,61,0,0,0,0,19,19,19,19
Tulare,3,2022-01-03,2144,2144,918,1226,16002,16002,6773,9229,57,5,5,7,1322,1322,1317,1317
Tuolumne,3,2022-01-03,383,383,186,197,2544,2544,1227,1317,7,3,3,0,153,153,150,150
Ventura,3,2022-01-03,12671,12671,7986,4685,59673,59675,37563,22112,136,11,11,28,1235,1235,1224,1224
Yolo,3,2022-01-03,2321,2321,1323,998,31713,31713,17939,13774,8,4,4,3,300,300,296,296
Yuba,3,2022-01-03,473,473,262,211,2331,2331,1284,1047,17,1,1,6,104,104,103,103
Alameda,4,2022-01-10,31207,31207,20218,10989,193866,193878,125734,68144,277,14,14,46,1580,1580,1566,1566
Amador,4,2022-01-10,391,391,209,182,2726,2726,1447,1279,4,0,0,4,71,71,71,71
Butte,4,2022-01-10,1998,1998,1394,604,10460,10460,7287,3173,55,2,2,4,364,364,362,362
Calaveras,4,2022-01-10,523,523,299,224,2607,2607,1479,1128,0,1,1,2,95,95,94,94
Colusa,4,2022-01-10,105,105,65,40,756,756,462,294,5,0,0,0,21,21,21,21
Contra Costa,4,2022-01-10,19742,19742,10340,9402,102259,102264,53549,48715,152,12,12,24,1105,1105,1093,1093
Del Norte,4,2022-01-10,177,177,106,71,3958,3958,2363,1595,2,0,0,0,42,42,42,42
El Dorado,4,2022-01-10,2214,2214,1260,954,9363,9363,5325,4038,14,6,6,2,189,189,183,183
Fresno,4,2022-01-10,14401,14401,7782,6619,60056,60061,32387,27674,301,14,14,47,2463,2463,2449,2449
Glenn,4,2022-01-10,219,219,127,92,938,938,544,394,2,0,0,0,43,43,43,43
Humboldt,4,2022-01-10,1401,1401,827,574,8356,8356,4925,3431,18,5,5,2,128,128,123,123
Imperial,4,2022-01-10,3622,3622,2047,1575,13842,13842,7805,6037,58,11,11,25,852,852,841,841
Inyo,4,2022-01-10,408,408,248,160,1356,1356,826,530,4,2,2,0,52,52,50,50
Kern,4,2022-01-10,11946,11946,7346,4600,57114,57117,35083,22034,181,26,26,35,2083,2083,2057,2057
Kings,4,2022-01-10,2413,2413,1381,1032,13013,13013,7401,5612,33,1,1,4,394,394,393,393
Lake,4,2022-01-10,499,499,268,231,2761,2761,1477,1284,0,3,3,1,120,120,117,117
Lassen,4,2022-01-10,195,195,125,70,3438,3438,2185,1253,1,0,0,0,54,54,54,54
Los Angeles,4,2022-01-10,329081,329099,270871,58228,1915111,1915216,1576887,338329,3253,270,270,513,27908,27908,27638,27638
Madera,4,2022-01-10,1914,1914,1029,885,10379,10379,5546,4833,19,1,1,6,340,340,339,339
Marin,4,2022-01-10,2940,2940,1602,1338,21011,21011,11437,9574,18,3,3,5,260,260,257,257
Mariposa,4,2022-01-10,199,199,105,94,1158,1158,607,551,0,1,1,0,22,22,21,21
Mendocino,4,2022-01-10,874,874,410,464,5538,5538,2581,2957,8,2,2,2,106,106,104,104
Merced,4,2022-01-10,3693,3693,2236,1457,14514,14514,8774,5740,33,10,10,11,719,719,709,709
Modoc,4,2022-01-10,13,13,8,5,109,109,67,42,0,0,0,0,6,6,6,6
Mono,4,2022-01-10,253,253,106,147,863,863,360,503,1,1,1,0,5,5,4,4
Monterey,4,2022-01-10,4980,4980,2117,2863,33231,33231,14051,19180,44,5,5,12,654,654,649,649
Napa,4,2022-01-10,2646,2646,1679,967,14353,14353,9103,5250,14,1,1,4,110,110,109,109
Nevada,4,2022-01-10,1189,1189,646,543,5233,5233,2839,2394,10,2,2,3,114,114,112,112
Orange,4,2022-01-10,60078,60083,39991,20092,317667,317685,211521,106164,854,100,100,159,6185,6185,6085,6085
Placer,4,2022-01-10,5195,5195,2692,2503,22555,22555,11665,10890,179,6,6,29,524,524,518,518
Plumas,4,2022-01-10,141,141,79,62,803,803,446,357,5,0,0,0,12,12,12,12
Riverside,4,2022-01-10,48260,48261,28852,19409,187755,187767,112221,75546,762,83,83,139,5769,5769,5686,5686
Sacramento,4,2022-01-10,27526,27526,15928,11598,121788,121793,70484,51309,375,37,37,89,2574,2574,2537,2537
San Benito,4,2022-01-10,1038,1038,654,384,4616,4616,2910,1706,3,1,1,2,86,86,85,85
San Bernardino,4,2022-01-10,50691,50692,32839,17853,192766,192778,124825,67953,784,113,113,187,6786,6786,6673,6673
San Diego,4,2022-01-10,82744,82749,67425,15324,330085,330103,269013,61090,895,66,66,166,4614,4614,4548,4548
San Francisco,4,2022-01-10,15094,15094,6034,9060,117289,117295,46959,70336,158,12,12,35,711,711,699,699
San Joaquin,4,2022-01-10,14515,14515,8088,6427,66859,66864,37196,29668,151,15,15,45,2015,2015,2000,2000
San Luis Obispo,4,2022-01-10,4336,4336,2675,1661,21621,21621,13356,8265,30,2,2,7,379,379,377,377
San Mateo,4,2022-01-10,15022,15022,10005,5017,113103,113109,75331,37778,95,5,5,16,612,612,607,607
Santa Barbara,4,2022-01-10,8537,8537,5053,3484,47382,47383,28052,19331,84,9,9,10,589,589,580,580
Santa Clara,4,2022-01-10,36503,36503,29458,7045,271163,271177,218791,52386,350,26,26,68,2024,2024,1998,1998
Santa Cruz,4,2022-01-10,4543,4543,2861,1682,42815,42816,26980,15836,25,2,2,2,237,237,235,235
Shasta,4,2022-01-10,1059,1059,618,441,8406,8406,4894,3512,37,7,7,12,462,462,455,455
Siskiyou,4,2022-01-10,120,120,77,43,919,919,591,328,3,1,1,1,64,64,63,63
Solano,4,2022-01-10,6924,6924,4126,2798,37199,37199,22176,15023,94,6,6,15,403,403,397,397
Sonoma,4,2022-01-10,8868,8868,5343,3525,47198,47200,28454,18746,72,9,9,8,437,437,428,428
Stanislaus,4,2022-01-10,6740,6740,3302,3438,29317,29317,14323,14994,173,13,13,19,1471,1471,1458,1458
Sutter,4,2022-01-10,1245,1245,743,502,5062,5062,3006,2056,0,2,2,0,199,199,197,197
Tehama,4,2022-01-10,513,513,257,256,2482,2482,1241,1241,13,1,1,1,169,169,168,168
Trinity,4,2022-01-10,38,38,19,19,275,275,135,140,0,0,0,0,19,19,19,19
Tulare,4,2022-01-10,5208,5208,2538,2670,24074,24074,11671,12403,66,9,9,8,1331,1331,1322,1322
Tuolumne,4,2022-01-10,806,806,436,370,4178,4178,2257,1921,13,1,1,1,154,154,153,153
Ventura,4,2022-01-10,17511,17511,11975,5536,88214,88219,60306,27913,227,23,23,34,1258,1258,1235,1235
Yolo,4,2022-01-10,3760,3760,2341,1419,48253,48254,30010,18244,6,4,4,1,304,304,300,300
Yuba,4,2022-01-10,1022,1022,624,398,4108,4108,2504,1604,41,0,0,7,104,104,104,104
Alameda,5,2022-01-17,24704,24704,17329,7375,170503,170514,119545,50969,366,33,33,62,1613,1613,1580,1580
Amador,5,2022-01-17,476,476,282,194,3557,3557,2081,1476,10,2,2,3,73,73,71,71
Butte,5,2022-01-17,2061,2061,1537,524,9328,9328,6950,2378,58,6,6,6,370,370,364,364
Calaveras,5,2022-01-17,564,564,353,211,2472,2472,1542,930,3,2,2,3,97,97,95,95
Colusa,5,2022-01-17,161,161,107,54,719,719,476,243,3,0,0,0,21,21,21,21
Contra Costa,5,2022-01-17,16223,16223,9472,6751,88051,88057,51331,36726,198,22,22,41,1127,1127,1105,1105
Del Norte,5,2022-01-17,200,200,131,69,3758,3758,2429,1329,2,0,0,1,42,42,42,42
El Dorado,5,2022-01-17,1967,1967,1229,738,8062,8062,5041,3021,9,4,4,2,193,193,189,189
Fresno,5,2022-01-17,18252,18252,10932,7320,66176,66181,39601,26580,386,28,28,61,2491,2491,2463,2463
Glenn,5,2022-01-17,306,306,194,112,1076,1076,683,393,3,2,2,0,45,45,43,43
Humboldt,5,2022-01-17,1143,1143,738,405,8322,8322,5364,2958,10,1,1,4,129,129,128,128
Imperial,5,2022-01-17,3412,3412,2122,1290,13242,13242,8232,5010,69,12,12,29,864,864,852,852
Inyo,5,2022-01-17,327,327,216,111,1040,1040,688,352,4,0,0,0,52,52,52,52
Kern,5,2022-01-17,11693,11693,7803,3890,51809,51813,34534,17279,242,29,29,44,2112,2112,2083,2083
Kings,5,2022-01-17,3198,3198,1998,1200,14866,14866,9258,5608,40,4,4,1,398,398,394,394
Lake,5,2022-01-17,583,583,348,235,3246,3246,1936,1310,2,1,1,2,121,121,120,120
Lassen,5,2022-01-17,284,284,196,88,3322,3322,2278,1044,0,0,0,0,54,54,54,54
Los Angeles,5,2022-01-17,218474,218490,186912,31578,1610421,1610534,1376832,233702,4034,504,504,680,28412,28412,27908,27908
Madera,5,2022-01-17,2400,2400,1431,969,10611,10611,6301,4310,32,5,5,10,345,345,340,340
Marin,5,2022-01-17,2420,2420,1461,959,17702,17702,10678,7024,38,4,4,6,264,264,260,260
Mariposa,5,2022-01-17,163,163,95,68,1115,1115,648,467,0,0,0,0,22,22,22,22
Mendocino,5,2022-01-17,922,922,487,435,5015,5015,2630,2385,18,3,3,2,109,109,106,106
Merced,5,2022-01-17,3971,3971,2619,1352,13639,13639,8989,4650,41,18,18,11,737,737,719,719
Modoc,5,2022-01-17,13,13,9,4,102,102,68,34,0,1,1,0,7,7,6,6
Mono,5,2022-01-17,198,198,94,104,809,809,386,423,2,0,0,0,5,5,5,5
Monterey,5,2022-01-17,5902,5902,2860,3042,28328,28328,13710,14618,69,6,6,14,660,660,654,654
Napa,5,2022-01-17,1930,1930,1329,601,11914,11914,8177,3737,21,2,2,5,112,112,110,110
Nevada,5,2022-01-17,1253,1253,753,500,5431,5431,3262,2169,19,1,1,1,115,115,114,114
Orange,5,2022-01-17,41326,41328,29645,11683,251495,251512,180242,71270,998,111,111,199,6296,6296,6185,6185
Placer,5,2022-01-17,4320,4320,2495,1825,19460,19460,11216,8244,178,14,14,36,538,538,524,524
Plumas,5,2022-01-17,194,194,119,75,852,852,524,328,3,0,0,0,12,12,12,12
Riverside,5,2022-01-17,41253,41255,26970,14285,168056,168068,109886,58182,920,97,97,158,5866,5866,5769,5769
Sacramento,5,2022-01-17,21456,21456,13654,7802,101465,101472,64499,36973,473,64,64,97,2638,2638,2574,2574
San Benito,5,2022-01-17,903,903,618,285,4273,4273,2922,1351,4,1,1,4,87,87,86,86
San Bernardino,5,2022-01-17,38500,38502,26933,11569,164350,164361,114972,49389,936,146,146,227,6932,6932,6786,6786
San Diego,5,2022-01-17,60708,60713,51536,9177,265928,265946,225770,40176,1067,103,103,193,4717,4717,4614,4614
San Francisco,5,2022-01-17,11263,11263,5202,6061,94012,94018,43308,50710,212,14,14,44,725,725,711,711
San Joaquin,5,2022-01-17,12721,12721,7805,4916,58136,58141,35677,22464,201,20,20,57,2035,2035,2015,2015
San Luis Obispo,5,2022-01-17,3935,3935,2647,1288,21023,21023,14126,6897,46,12,12,10,391,391,379,379
San Mateo,5,2022-01-17,12485,12485,8946,3539,95951,95957,68675,27282,92,10,10,30,622,622,612,612
Santa Barbara,5,2022-01-17,6852,6852,4445,2407,40485,40488,26231,14257,123,12,12,12,601,601,589,589
Santa Clara,5,2022-01-17,29559,29559,24870,4689,235959,235975,198424,37551,451,24,24,84,2048,2048,2024,2024
Santa Cruz,5,2022-01-17,4185,4185,2868,1317,42205,42208,28865,13343,23,3,3,3,240,240,237,237
Shasta,5,2022-01-17,1347,1347,863,484,9163,9163,5844,3319,55,7,7,14,469,469,462,462
Siskiyou,5,2022-01-17,158,158,110,48,927,927,640,287,3,1,1,2,65,65,64,64
Solano,5,2022-01-17,6434,6434,4199,2235,35261,35261,23011,12250,121,6,6,22,409,409,403,403
Sonoma,5,2022-01-17,7628,7628,5026,2602,42780,42783,28135,14648,73,7,7,15,444,444,437,437
Stanislaus,5,2022-01-17,7327,7327,4018,3309,29058,29058,15916,13142,206,10,10,31,1481,1481,1471,1471
Sutter,5,2022-01-17,1248,1248,812,436,4863,4863,3161,1702,0,4,4,0,203,203,199,199
Tehama,5,2022-01-17,615,615,344,271,2420,2420,1349,1071,15,5,5,2,174,174,169,169
Trinity,5,2022-01-17,41,41,23,18,255,255,140,115,0,1,1,0,20,20,19,19
Tulare,5,2022-01-17,7478,7478,4070,3408,27090,27090,14725,12365,97,16,16,16,1347,1347,1331,1331
Tuolumne,5,2022-01-17,886,886,532,354,3836,3836,2287,1549,10,8,8,1,162,162,154,154
Ventura,5,2022-01-17,11974,11974,8780,3194,66929,66934,49018,17916,300,41,41,56,1299,1299,1258,1258
Yolo,5,2022-01-17,2805,2805,1899,906,39510,39513,26716,12797,15,4,4,4,308,308,304,304
Yuba,5,2022-01-17,1064,1064,707,357,3747,3747,2489,1258,42,2,2,6,106,106,104,104
Alameda,6,2022-01-24,19743,19743,14822,4921,171782,171795,129147,42648,373,41,41,68,1654,1654,1613,1613
Amador,6,2022-01-24,544,544,352,192,4667,4667,3019,1648,8,0,0,5,73,73,73,73
Butte,6,2022-01-24,1904,1904,1501,403,9612,9612,7594,2018,82,10,10,9,380,380,370,370
Calaveras,6,2022-01-24,556,556,378,178,2506,2506,1705,801,6,2,2,2,99,99,97,97
Colusa,6,2022-01-24,177,177,127,50,951,951,680,271,6,0,0,0,21,21,21,21
Contra Costa,6,2022-01-24,13595,13595,8737,4858,85321,85326,54894,30432,217,25,25,64,1152,1152,1127,1127
Del Norte,6,2022-01-24,348,348,246,102,4326,4326,3042,1284,3,0,0,3,42,42,42,42
El Dorado,6,2022-01-24,1400,1400,954,446,7329,7329,5001,2328,17,2,2,6,195,195,193,193
Fresno,6,2022-01-24,17715,17715,11607,6108,68853,68858,45200,23658,491,43,43,83,2534,2534,2491,2491
Glenn,6,2022-01-24,250,250,172,78,971,971,670,301,0,0,0,0,45,45,45,45
Humboldt,6,2022-01-24,915,915,641,274,7714,7714,5409,2305,25,3,3,3,132,132,129,129
Imperial,6,2022-01-24,3617,3617,2455,1162,13189,13189,8970,4219,70,14,14,27,878,878,864,864
Inyo,6,2022-01-24,142,142,102,40,625,625,449,176,1,1,1,0,53,53,52,52
Kern,6,2022-01-24,10554,10554,7599,2955,53946,53951,38893,15058,267,47,47,51,2159,2159,2112,2112
Kings,6,2022-01-24,4306,4306,2925,1381,19064,19064,12977,6087,40,4,4,4,402,402,398,398
Lake,6,2022-01-24,746,746,488,258,3417,3417,2234,1183,6,2,2,3,123,123,121,121
Lassen,6,2022-01-24,418,418,307,111,3982,3982,2932,1050,6,0,0,0,54,54,54,54
Los Angeles,6,2022-01-24,164897,164910,145673,19237,1659205,1659334,1466800,192534,3769,611,611,785,29023,29023,28412,28412
Madera,6,2022-01-24,2715,2715,1771,944,12170,12170,7938,4232,49,7,7,10,352,352,345,345
Marin,6,2022-01-24,1858,1858,1228,630,17548,17548,11608,5940,38,4,4,10,268,268,264,264
Mariposa,6,2022-01-24,133,133,85,48,945,945,605,340,0,0,0,0,22,22,22,22
Mendocino,6,2022-01-24,917,917,538,379,4873,4873,2854,2019,23,2,2,3,111,111,109,109
Merced,6,2022-01-24,3234,3234,2307,927,12906,12906,9213,3693,55,9,9,12,746,746,737,737
Modoc,6,2022-01-24,14,14,10,4,114,114,82,32,2,0,0,0,7,7,7,7
Mono,6,2022-01-24,97,97,52,45,422,422,227,195,1,0,0,0,5,5,5,5
Monterey,6,2022-01-24,5088,5088,2775,2313,31797,31798,17335,14463,80,9,9,17,669,669,660,660
Napa,6,2022-01-24,1672,1672,1236,436,12465,12465,9206,3259,23,5,5,4,117,117,112,112
Nevada,6,2022-01-24,1001,1001,659,342,4806,4806,3170,1636,29,1,1,6,116,116,115,115
Orange,6,2022-01-24,26684,26684,20392,6292,230901,230918,176714,54204,923,177,177,191,6473,6473,6296,6296
Placer,6,2022-01-24,3660,3660,2330,1330,18644,18644,11867,6777,215,8,8,43,546,546,538,538
Plumas,6,2022-01-24,215,215,144,71,836,836,559,277,5,0,0,0,12,12,12,12
Riverside,6,2022-01-24,31908,31908,22576,9332,158777,158789,112471,46318,901,122,122,168,5988,5988,5866,5866
Sacramento,6,2022-01-24,17468,17468,12086,5382,98838,98845,68431,30414,542,64,64,105,2702,2702,2638,2638
San Benito,6,2022-01-24,776,776,570,206,3929,3929,2889,1040,7,1,1,3,88,88,87,87
San Bernardino,6,2022-01-24,28079,28079,21043,7036,153566,153579,115206,38373,975,170,170,223,7102,7102,6932,6932
San Diego,6,2022-01-24,51480,51485,45187,6298,252113,252132,221539,30593,1056,131,131,232,4848,4848,4717,4717
San Francisco,6,2022-01-24,8099,8099,4234,3865,88917,88923,46542,42381,232,19,19,37,744,744,725,725
San Joaquin,6,2022-01-24,11053,11053,7403,3650,59112,59117,39673,19444,241,34,34,71,2069,2069,2035,2035
San Luis Obispo,6,2022-01-24,3561,3561,2582,979,21516,21516,15603,5913,42,10,10,12,401,401,391,391
San Mateo,6,2022-01-24,8509,8509,6500,2009,95138,95144,72745,22399,139,19,19,28,641,641,622,622
Santa Barbara,6,2022-01-24,6484,6484,4559,1925,43826,43831,30825,13006,127,12,12,19,613,613,601,601
Santa Clara,6,2022-01-24,22786,22786,19872,2914,233307,233325,203472,29853,412,48,48,88,2096,2096,2048,2048
Santa Cruz,6,2022-01-24,5045,5045,3710,1335,45621,45624,33577,12047,31,1,1,2,241,241,240,240
Shasta,6,2022-01-24,1486,1486,1032,454,10135,10135,7033,3102,78,7,7,9,476,476,469,469
Siskiyou,6,2022-01-24,159,159,118,41,857,857,635,222,6,3,3,1,68,68,65,65
Solano,6,2022-01-24,5127,5127,3627,1500,32696,32697,23143,9554,143,14,14,26,423,423,409,409
Sonoma,6,2022-01-24,6926,6926,4931,1995,42475,42479,30250,12229,94,7,7,18,451,451,444,444
Stanislaus,6,2022-01-24,6376,6376,3877,2499,28268,28268,17211,11057,277,27,27,44,1508,1508,1481,1481
Sutter,6,2022-01-24,1047,1047,737,310,5002,5002,3521,1481,0,2,2,0,205,205,203,203
Tehama,6,2022-01-24,578,578,358,220,2702,2702,1674,1028,19,4,4,5,178,178,174,174
Trinity,6,2022-01-24,63,63,38,25,322,322,196,126,0,0,0,0,20,20,20,20
Tulare,6,2022-01-24,7682,7682,4635,3047,29530,29531,17856,11675,138,11,11,14,1358,1358,1347,1347
Tuolumne,6,2022-01-24,953,953,627,326,3827,3827,2510,1317,17,2,2,3,164,164,162,162
Ventura,6,2022-01-24,9411,9411,7331,2080,68519,68524,53431,15093,269,28,28,68,1327,1327,1299,1299
Yolo,6,2022-01-24,2299,2299,1677,622,40472,40476,29511,10965,18,12,12,5,320,320,308,308
Yuba,6,2022-01-24,911,911,653,258,3779,3779,2711,1068,54,3,3,10,109,109,106,106
Alameda,7,2022-01-31,10998,10998,8741,2257,137320,137332,109280,28052,336,50,50,75,1704,1704,1654,1654
Amador,7,2022-01-31,350,350,246,104,3226,3226,2273,953,15,1,1,4,74,74,73,73
Butte,7,2022-01-31,1168,1168,967,201,7609,7609,6306,1303,80,6,6,7,386,386,380,380
Calaveras,7,2022-01-31,263,263,193,70,1940,1940,1424,516,3,5,5,2,104,104,99,99
Colusa,7,2022-01-31,106,106,81,25,704,704,540,164,9,0,0,0,21,21,21,21
Contra Costa,7,2022-01-31,7315,7315,5100,2215,68627,68632,47924,20708,207,39,39,54,1191,1191,1152,1152
Del Norte,7,2022-01-31,315,315,237,78,3957,3957,2977,980,6,2,2,2,44,44,42,42
El Dorado,7,2022-01-31,742,742,545,197,6021,6021,4421,1600,13,4,4,5,199,199,195,195
Fresno,7,2022-01-31,10961,10961,7773,3188,54945,54950,39023,15927,503,39,39,98,2573,2573,2534,2534
Glenn,7,2022-01-31,190,190,140,50,759,759,563,196,2,2,2,0,47,47,45,45
Humboldt,7,2022-01-31,583,583,438,145,5790,5790,4348,1442,18,3,3,3,135,135,132,132
Imperial,7,2022-01-31,2194,2194,1599,595,11303,11303,8264,3039,71,17,17,28,895,895,878,878
Inyo,7,2022-01-31,55,55,42,13,467,467,357,110,5,3,3,0,56,56,53,53
Kern,7,2022-01-31,5650,5650,4340,1310,42263,42268,32507,9761,264,47,47,54,2206,2206,2159,2159
Kings,7,2022-01-31,2391,2391,1749,642,13681,13681,10017,3664,55,5,5,4,407,407,402,402
Lake,7,2022-01-31,478,478,338,140,3193,3193,2258,935,4,4,4,4,127,127,123,123
Lassen,7,2022-01-31,311,311,243,68,3624,3624,2838,786,7,1,1,0,55,55,54,54
Los Angeles,7,2022-01-31,74572,74577,67644,6933,1302829,1302939,1182625,120314,2991,640,640,719,29663,29663,29023,29023
Madera,7,2022-01-31,1744,1744,1233,511,9631,9631,6816,2815,50,6,6,7,358,358,352,352
Marin,7,2022-01-31,1064,1064,760,304,13816,13816,9888,3928,26,5,5,9,273,273,268,268
Mariposa,7,2022-01-31,101,101,70,31,840,840,584,256,0,2,2,0,24,24,22,22
Mendocino,7,2022-01-31,464,464,299,165,3486,3486,2252,1234,12,3,3,4,114,114,111,111
Merced,7,2022-01-31,2125,2125,1618,507,10465,10465,7975,2490,54,12,12,14,758,758,746,746
Modoc,7,2022-01-31,12,12,9,3,89,89,68,21,1,0,0,0,7,7,7,7
Mono,7,2022-01-31,41,41,25,16,339,339,203,136,0,0,0,0,5,5,5,5
Monterey,7,2022-01-31,3558,3558,2154,1404,26742,26743,16229,10514,82,9,9,13,678,678,669,669
Napa,7,2022-01-31,989,989,776,213,9376,9376,7355,2021,17,7,7,10,124,124,117,117
Nevada,7,2022-01-31,568,568,404,164,3912,3912,2788,1124,26,3,3,5,119,119,116,116
Orange,7,2022-01-31,11998,11998,9679,2319,177031,177047,142944,34103,708,170,170,164,6643,6643,6473,6473
Placer,7,2022-01-31,2256,2256,1560,696,15375,15375,10647,4728,152,19,19,42,565,565,546,546
Plumas,7,2022-01-31,137,137,98,39,753,753,542,211,1,0,0,0,12,12,12,12
Riverside,7,2022-01-31,15945,15945,12051,3894,121042,121053,91700,29353,740,111,111,171,6099,6099,5988,5988
Sacramento,7,2022-01-31,10135,10135,7520,2615,77584,77589,57654,19935,501,93,93,106,2795,2795,2702,2702
San Benito,7,2022-01-31,474,474,370,104,3323,3323,2596,727,5,2,2,3,90,90,88,88
San Bernardino,7,2022-01-31,13252,13252,10516,2736,116538,116549,92603,23946,744,185,185,207,7287,7287,7102,7102
San Diego,7,2022-01-31,24869,24869,22437,2432,181384,181400,163808,17592,944,105,105,214,4953,4953,4848,4848
San Francisco,7,2022-01-31,4049,4049,2361,1688,69165,69170,40404,28766,208,24,24,45,768,768,744,744
San Joaquin,7,2022-01-31,5701,5701,4124,1577,43685,43689,31672,12017,210,36,36,75,2105,2105,2069,2069
San Luis Obispo,7,2022-01-31,1981,1981,1530,451,16236,16236,12541,3695,40,12,12,10,413,413,401,401
San Mateo,7,2022-01-31,4328,4328,3489,839,75105,75110,60573,14537,131,10,10,19,651,651,641,641
Santa Barbara,7,2022-01-31,3634,3634,2733,901,35024,35026,26385,8641,103,23,23,13,636,636,613,613
Santa Clara,7,2022-01-31,13838,13838,12417,1421,207115,207132,185914,21218,427,54,54,93,2150,2150,2096,2096
Santa Cruz,7,2022-01-31,3439,3439,2680,759,51420,51425,40154,11271,35,5,5,6,246,246,241,241
Shasta,7,2022-01-31,900,900,670,230,8419,8419,6269,2150,59,13,13,11,489,489,476,476
Siskiyou,7,2022-01-31,119,119,94,25,691,691,545,146,8,2,2,2,70,70,68,68
Solano,7,2022-01-31,3813,3813,2885,928,28763,28763,21766,6997,126,6,6,30,429,429,423,423
Sonoma,7,2022-01-31,3570,3570,2712,858,32149,32151,24455,7696,84,12,12,15,463,463,451,451
Stanislaus,7,2022-01-31,3688,3688,2459,1229,22306,22306,14897,7409,261,33,33,53,1541,1541,1508,1508
Sutter,7,2022-01-31,619,619,466,153,3764,3764,2837,927,0,4,4,0,209,209,205,205
Tehama,7,2022-01-31,377,377,256,121,2022,2022,1368,654,17,3,3,5,181,181,178,178
Trinity,7,2022-01-31,43,43,29,14,227,227,151,76,0,0,0,0,20,20,20,20
Tulare,7,2022-01-31,4686,4686,3098,1588,22909,22909,15179,7730,150,22,22,21,1380,1380,1358,1358
Tuolumne,7,2022-01-31,710,710,502,208,3265,3265,2315,950,12,2,2,4,166,166,164,164
Ventura,7,2022-01-31,4599,4599,3766,833,52326,52331,42906,9425,253,39,39,48,1366,1366,1327,1327
Yolo,7,2022-01-31,1353,1353,1049,304,37514,37517,29112,8405,19,5,5,5,325,325,320,320
Yuba,7,2022-01-31,523,523,400,123,2930,2930,2243,687,78,2,2,11,111,111,109,109
Alameda,8,2022-02-07,5969,5969,4970,999,115668,115679,96378,19301,254,44,44,62,1748,1748,1704,1704
Amador,8,2022-02-07,204,204,153,51,2909,2909,2187,722,14,4,4,5,78,78,74,74
Butte,8,2022-02-07,782,782,673,109,6394,6394,5506,888,74,8,8,12,394,394,386,386
Calaveras,8,2022-02-07,183,183,142,41,1427,1427,1112,315,2,2,2,1,106,106,104,104
Colusa,8,2022-02-07,71,71,57,14,555,555,449,106,0,0,0,0,21,21,21,21
Contra Costa,8,2022-02-07,4137,4137,3094,1043,54157,54162,40512,13650,149,32,32,52,1223,1223,1191,1191
Del Norte,8,2022-02-07,286,286,228,58,4003,4003,3184,819,5,0,0,0,44,44,44,44
El Dorado,8,2022-02-07,427,427,333,94,5036,5036,3928,1108,20,1,1,5,200,200,199,199
Fresno,8,2022-02-07,6382,6382,4835,1547,42579,42584,32298,10286,450,49,49,87,2622,2622,2573,2573
Glenn,8,2022-02-07,113,113,88,25,620,620,488,132,4,3,3,0,50,50,47,47
Humboldt,8,2022-02-07,467,467,371,96,4875,4875,3874,1001,15,1,1,2,136,136,135,135
Imperial,8,2022-02-07,1095,1095,851,244,7941,7941,6174,1767,46,12,12,26,907,907,895,895
Inyo,8,2022-02-07,38,38,30,8,447,447,361,86,5,0,0,0,56,56,56,56
Kern,8,2022-02-07,3475,3475,2813,662,34657,34661,28091,6570,190,32,32,43,2238,2238,2206,2206
Kings,8,2022-02-07,1351,1351,1051,300,10246,10246,7975,2271,52,14,14,5,421,421,407,407
Lake,8,2022-02-07,351,351,265,86,2625,2625,1985,640,11,1,1,5,128,128,127,127
Lassen,8,2022-02-07,140,140,115,25,3023,3023,2487,536,5,2,2,0,57,57,55,55
Los Angeles,8,2022-02-07,37352,37357,34599,2758,1151457,1151572,1067013,84559,2155,638,638,547,30301,30301,29663,29663
Madera,8,2022-02-07,1060,1060,802,258,8081,8081,6118,1963,38,4,4,9,362,362,358,358
Marin,8,2022-02-07,655,655,500,155,11291,11291,8617,2674,29,8,8,6,281,281,273,273
Mariposa,8,2022-02-07,51,51,38,13,579,579,431,148,0,0,0,0,24,24,24,24
Mendocino,8,2022-02-07,327,327,229,98,2817,2817,1974,843,12,2,2,5,116,116,114,114
Merced,8,2022-02-07,1209,1209,973,236,8063,8063,6492,1571,53,13,13,12,771,771,758,758
Modoc,8,2022-02-07,25,25,20,5,219,219,179,40,3,0,0,0,7,7,7,7
Mono,8,2022-02-07,44,44,29,15,271,271,178,93,0,0,0,0,5,5,5,5
Monterey,8,2022-02-07,2221,2221,1474,747,22461,22462,14939,7523,68,11,11,14,689,689,678,678
Napa,8,2022-02-07,742,742,611,131,7766,7766,6396,1370,16,6,6,2,130,130,124,124
Nevada,8,2022-02-07,357,357,271,86,3187,3187,2429,758,24,3,3,1,122,122,119,119
Orange,8,2022-02-07,6394,6394,5391,1003,152286,152302,128453,23849,494,118,118,125,6761,6761,6643,6643
Placer,8,2022-02-07,1293,1293,959,334,11887,11887,8831,3056,148,22,22,34,587,587,565,565
Plumas,8,2022-02-07,79,79,60,19,521,521,399,122,1,1,1,0,13,13,12,12
Riverside,8,2022-02-07,8143,8143,6511,1632,93427,93438,74782,18656,548,107,107,116,6206,6206,6099,6099
Sacramento,8,2022-02-07,6077,6077,4785,1292,63991,63996,50434,13562,390,72,72,95,2867,2867,2795,2795
San Benito,8,2022-02-07,312,312,256,56,2660,2660,2184,476,3,0,0,4,90,90,90,90
San Bernardino,8,2022-02-07,7050,7050,5864,1186,90089,90099,74999,15100,528,140,140,156,7427,7427,7287,7287
San Diego,8,2022-02-07,13636,13636,12579,1057,151885,151901,140185,11716,773,116,116,169,5069,5069,4953,4953
San Francisco,8,2022-02-07,2407,2407,1552,855,55776,55781,35915,19866,171,25,25,40,793,793,768,768
San Joaquin,8,2022-02-07,3347,3347,2580,767,36551,36556,28230,8326,186,42,42,62,2147,2147,2105,2105
San Luis Obispo,8,2022-02-07,1204,1204,979,225,12341,12341,10042,2299,23,16,16,7,429,429,413,413
San Mateo,8,2022-02-07,2463,2463,2075,388,62131,62136,52356,9780,83,16,16,18,667,667,651,651
Santa Barbara,8,2022-02-07,2282,2282,1814,468,30723,30727,24436,6291,75,15,15,17,651,651,636,636
Santa Clara,8,2022-02-07,8033,8033,7376,657,175343,175361,161041,14320,377,31,31,74,2181,2181,2150,2150
Santa Cruz,8,2022-02-07,1900,1900,1560,340,38681,38685,31767,6918,28,4,4,5,250,250,246,246
Shasta,8,2022-02-07,677,677,534,143,6857,6857,5413,1444,64,15,15,10,504,504,489,489
Siskiyou,8,2022-02-07,91,91,75,16,720,720,595,125,10,2,2,0,72,72,70,70
Solano,8,2022-02-07,2238,2238,1784,454,24263,24265,19391,4874,91,5,5,28,434,434,429,429
Sonoma,8,2022-02-07,2086,2086,1676,410,27054,27056,21737,5319,57,7,7,11,470,470,463,463
Stanislaus,8,2022-02-07,2491,2491,1792,699,18738,18738,13501,5237,243,43,43,43,1584,1584,1541,1541
Sutter,8,2022-02-07,360,360,286,74,3305,3305,2631,674,0,5,5,0,214,214,209,209
Tehama,8,2022-02-07,282,282,205,77,1644,1644,1197,447,17,3,3,6,184,184,181,181
Trinity,8,2022-02-07,18,18,13,5,136,136,98,38,0,0,0,0,20,20,20,20
Tulare,8,2022-02-07,2703,2703,1932,771,17911,17911,12834,5077,130,26,26,21,1406,1406,1380,1380
Tuolumne,8,2022-02-07,348,348,263,85,2576,2576,1953,623,10,2,2,1,168,168,166,166
Ventura,8,2022-02-07,2696,2696,2301,395,42327,42332,36170,6162,207,40,40,45,1406,1406,1366,1366
Yolo,8,2022-02-07,864,864,706,158,30860,30865,25187,5678,12,11,11,6,336,336,325,325
Yuba,8,2022-02-07,333,333,269,64,2405,2405,1942,463,42,4,4,13,115,115,111,111
Alameda,9,2022-02-14,3408,3408,2946,462,98991,99003,85617,13386,190,40,40,48,1788,1788,1748,1748
Amador,9,2022-02-14,109,109,87,22,2345,2345,1866,479,8,3,3,3,81,81,78,78
Butte,9,2022-02-14,464,464,412,52,5317,5317,4721,596,64,10,10,9,404,404,394,394
Calaveras,9,2022-02-14,79,79,64,15,1161,1161,949,212,4,2,2,2,108,108,106,106
Colusa,9,2022-02-14,35,35,29,6,406,406,341,65,5,0,0,0,21,21,21,21
Contra Costa,9,2022-02-14,2405,2405,1905,500,44864,44869,35547,9322,123,23,23,31,1246,1246,1223,1223
Del Norte,9,2022-02-14,210,210,175,35,3338,3338,2775,563,6,0,0,3,44,44,44,44
El Dorado,9,2022-02-14,260,260,213,47,4433,4433,3631,802,21,4,4,3,204,204,200,200
Fresno,9,2022-02-14,3865,3865,3094,771,34936,34941,27982,6959,375,33,33,75,2655,2655,2622,2622
Glenn,9,2022-02-14,58,58,48,10,482,482,398,84,3,1,1,0,51,51,50,50
Humboldt,9,2022-02-14,331,331,275,56,4202,4202,3495,707,23,0,0,2,136,136,136,136
Imperial,9,2022-02-14,588,588,480,108,5962,5962,4871,1091,44,14,14,18,921,921,907,907
Inyo,9,2022-02-14,29,29,24,5,413,413,348,65,3,0,0,0,56,56,56,56
Kern,9,2022-02-14,2014,2014,1701,313,27232,27236,23015,4221,156,28,28,40,2266,2266,2238,2238
Kings,9,2022-02-14,774,774,633,141,8001,8001,6548,1453,43,8,8,5,429,429,421,421
Lake,9,2022-02-14,256,256,205,51,2307,2307,1842,465,6,2,2,5,130,130,128,128
Lassen,9,2022-02-14,155,155,133,22,2789,2789,2383,406,3,2,2,0,59,59,57,57
Los Angeles,9,2022-02-14,21437,21437,20184,1253,1052390,1052514,991164,61350,1572,490,490,423,30791,30791,30301,30301
Madera,9,2022-02-14,620,620,496,124,6463,6463,5165,1298,29,2,2,7,364,364,362,362
Marin,9,2022-02-14,383,383,309,74,10150,10150,8173,1977,23,5,5,4,286,286,281,281
Mariposa,9,2022-02-14,24,24,19,5,433,433,342,91,0,0,0,0,24,24,24,24
Mendocino,9,2022-02-14,207,207,155,52,2445,2445,1834,611,13,1,1,7,117,117,116,116
Merced,9,2022-02-14,745,745,627,118,6832,6832,5744,1088,37,13,13,8,784,784,771,771
Modoc,9,2022-02-14,17,17,14,3,124,124,104,20,0,0,0,0,7,7,7,7
Mono,9,2022-02-14,10,10,7,3,179,179,127,52,0,0,0,0,5,5,5,5
Monterey,9,2022-02-14,1229,1229,881,348,16949,16949,12154,4795,48,12,12,12,701,701,689,689
Napa,9,2022-02-14,400,400,343,57,6577,6577,5635,942,10,1,1,1,131,131,130,130
Nevada,9,2022-02-14,169,169,136,33,2568,2568,2066,502,19,3,3,5,125,125,122,122
Orange,9,2022-02-14,4000,4000,3495,505,132324,132341,115567,16774,354,115,115,77,6876,6876,6761,6761
Placer,9,2022-02-14,595,595,468,127,9967,9967,7844,2123,105,12,12,23,599,599,587,587
Plumas,9,2022-02-14,43,43,35,8,431,431,348,83,1,0,0,0,13,13,13,13
Riverside,9,2022-02-14,4609,4609,3856,753,74750,74761,62573,12188,400,85,85,86,6291,6291,6206,6206
Sacramento,9,2022-02-14,3416,3416,2822,594,53019,53024,43830,9194,349,59,59,66,2926,2926,2867,2867
San Benito,9,2022-02-14,158,158,135,23,2159,2159,1845,314,0,1,1,3,91,91,90,90
San Bernardino,9,2022-02-14,3704,3704,3199,505,72754,72764,62878,9886,338,117,117,128,7544,7544,7427,7427
San Diego,9,2022-02-14,8081,8081,7583,498,126079,126094,118382,7712,589,89,89,135,5158,5158,5069,5069
San Francisco,9,2022-02-14,1610,1610,1124,486,47601,47606,33266,14340,130,25,25,39,818,818,793,793
San Joaquin,9,2022-02-14,1986,1986,1613,373,30667,30671,24922,5749,123,37,37,53,2184,2184,2147,2147
San Luis Obispo,9,2022-02-14,798,798,677,121,10050,10050,8529,1521,24,9,9,7,438,438,429,429
San Mateo,9,2022-02-14,1345,1345,1174,171,55007,55012,48011,7001,63,16,16,11,683,683,667,667
Santa Barbara,9,2022-02-14,1056,1056,880,176,22481,22483,18754,3729,68,8,8,14,659,659,651,651
Santa Clara,9,2022-02-14,4635,4635,4334,301,155254,155273,145192,10081,296,27,27,59,2208,2208,2181,2181
Santa Cruz,9,2022-02-14,981,981,838,143,30369,30373,25923,4450,23,3,3,4,253,253,250,250
Shasta,9,2022-02-14,443,443,366,77,5851,5851,4841,1010,62,13,13,13,517,517,504,504
Siskiyou,9,2022-02-14,66,66,57,9,520,520,447,73,7,1,1,2,73,73,72,72
Solano,9,2022-02-14,1201,1201,1003,198,19021,19021,15903,3118,73,2,2,20,436,436,434,434
Sonoma,9,2022-02-14,1135,1135,953,182,21178,21179,17765,3414,55,8,8,7,478,478,470,470
Stanislaus,9,2022-02-14,1364,1364,1046,318,15081,15081,11572,3509,206,28,28,41,1612,1612,1584,1584
Sutter,9,2022-02-14,230,230,192,38,2862,2862,2386,476,0,3,3,0,217,217,214,214
Tehama,9,2022-02-14,180,180,139,41,1404,1404,1088,316,15,5,5,5,189,189,184,184
Trinity,9,2022-02-14,22,22,17,5,171,171,131,40,0,0,0,0,20,20,20,20
Tulare,9,2022-02-14,1479,1479,1127,352,15049,15049,11498,3551,116,27,27,19,1433,1433,1406,1406
Tuolumne,9,2022-02-14,192,192,154,38,2222,2222,1778,444,12,4,4,1,172,172,168,168
Ventura,9,2022-02-14,1511,1511,1333,178,35526,35531,31350,4181,141,36,36,26,1442,1442,1406,1406
Yolo,9,2022-02-14,479,479,407,72,26824,26828,22795,4033,10,7,7,3,343,343,336,336
Yuba,9,2022-02-14,220,220,185,35,2109,2109,1777,332,19,0,0,11,115,115,115,115
Alameda,10,2022-02-21,1927,1927,1717,210,77634,77644,69069,8575,138,28,28,26,1816,1816,1788,1788
Amador,10,2022-02-21,70,70,58,12,1921,1921,1598,323,7,3,3,3,84,84,81,81
Butte,10,2022-02-21,255,255,232,23,4426,4426,4027,399,63,12,12,4,416,416,404,404
Calaveras,10,2022-02-21,44,44,37,7,838,838,712,126,3,6,6,0,114,114,108,108
Colusa,10,2022-02-21,26,26,23,3,362,362,315,47,4,0,0,0,21,21,21,21
Contra Costa,10,2022-02-21,1305,1305,1081,224,34149,34153,28274,5879,66,17,17,30,1263,1263,1246,1246
Del Norte,10,2022-02-21,129,129,111,18,2704,2704,2329,375,8,0,0,1,44,44,44,44
El Dorado,10,2022-02-21,155,155,132,23,3612,3612,3078,534,8,1,1,5,205,205,204,204
Fresno,10,2022-02-21,2007,2007,1679,328,26913,26916,22517,4399,272,26,26,54,2681,2681,2655,2655
Glenn,10,2022-02-21,28,28,24,4,405,405,348,57,2,1,1,0,52,52,51,51
Humboldt,10,2022-02-21,193,193,166,27,3331,3331,2873,458,22,3,3,1,139,139,136,136
Imperial,10,2022-02-21,394,394,335,59,4756,4756,4047,709,31,6,6,10,927,927,921,921
Inyo,10,2022-02-21,10,10,9,1,326,326,284,42,1,0,0,0,56,56,56,56
Kern,10,2022-02-21,1285,1285,1123,162,24323,24326,21266,3060,95,23,23,25,2289,2289,2266,2266
Kings,10,2022-02-21,454,454,387,67,6543,6543,5576,967,32,4,4,5,433,433,429,429
Lake,10,2022-02-21,185,185,155,30,1935,1935,1614,321,7,2,2,1,132,132,130,130
Lassen,10,2022-02-21,111,111,98,13,2135,2135,1883,252,1,0,0,0,59,59,59,59
Los Angeles,10,2022-02-21,11808,11808,11262,546,832202,832310,793279,39031,997,322,322,279,31113,31113,30791,30791
Madera,10,2022-02-21,317,317,265,52,5176,5176,4315,861,27,2,2,7,366,366,364,364
Marin,10,2022-02-21,199,199,167,32,8845,8845,7425,1420,13,3,3,4,289,289,286,286
Mariposa,10,2022-02-21,23,23,19,4,372,372,307,65,0,1,1,0,25,25,24,24
Mendocino,10,2022-02-21,113,113,90,23,1942,1942,1539,403,9,2,2,3,119,119,117,117
Merced,10,2022-02-21,427,427,372,55,5160,5160,4489,671,26,10,10,7,794,794,784,784
Modoc,10,2022-02-21,9,9,8,1,65,65,57,8,2,0,0,0,7,7,7,7
Mono,10,2022-02-21,7,7,5,2,162,162,123,39,0,1,1,0,6,6,5,5
Monterey,10,2022-02-21,780,780,596,184,12977,12977,9894,3083,47,5,5,7,706,706,701,701
Napa,10,2022-02-21,229,229,202,27,4985,4985,4405,580,6,4,4,3,135,135,131,131
Nevada,10,2022-02-21,102,102,85,17,1985,1985,1665,320,16,2,2,5,127,127,125,125
Orange,10,2022-02-21,2463,2463,2213,250,110416,110431,99036,11395,256,79,79,69,6955,6955,6876,6876
Placer,10,2022-02-21,328,328,271,57,8679,8679,7157,1522,92,9,9,13,608,608,599,599
Plumas,10,2022-02-21,21,21,18,3,328,328,276,52,0,0,0,0,13,13,13,13
Riverside,10,2022-02-21,2439,2439,2115,324,61413,61422,53281,8141,262,53,53,61,6344,6344,6291,6291
Sacramento,10,2022-02-21,1961,1961,1683,278,42786,42791,36701,6090,249,33,33,47,2959,2959,2926,2926
San Benito,10,2022-02-21,104,104,92,12,1696,1696,1494,202,0,0,0,1,91,91,91,91
San Bernardino,10,2022-02-21,1902,1902,1694,208,60249,60257,53634,6623,251,82,82,78,7626,7626,7544,7544
San Diego,10,2022-02-21,4625,4625,4400,225,100589,100603,95702,4901,468,61,61,106,5219,5219,5158,5158
San Francisco,10,2022-02-21,975,975,730,245,40355,40360,30111,10249,98,11,11,24,829,829,818,818
San Joaquin,10,2022-02-21,1049,1049,888,161,23867,23870,20188,3682,91,25,25,31,2209,2209,2184,2184
San Luis Obispo,10,2022-02-21,441,441,386,55,7650,7650,6704,946,16,16,16,3,454,454,438,438
San Mateo,10,2022-02-21,695,695,624,71,42575,42580,38165,4415,47,8,8,8,691,691,683,683
Santa Barbara,10,2022-02-21,611,611,528,83,19195,19196,16578,2618,40,6,6,10,665,665,659,659
Santa Clara,10,2022-02-21,2515,2515,2385,130,120311,120326,114037,6289,224,25,25,53,2233,2233,2208,2208
Santa Cruz,10,2022-02-21,578,578,509,69,25013,25016,22017,2999,21,1,1,4,254,254,253,253
Shasta,10,2022-02-21,263,263,225,38,4976,4976,4276,700,46,9,9,10,526,526,517,517
Siskiyou,10,2022-02-21,47,47,42,5,450,450,398,52,6,4,4,1,77,77,73,73
Solano,10,2022-02-21,697,697,604,93,15143,15143,13122,2021,51,5,5,15,441,441,436,436
Sonoma,10,2022-02-21,629,629,547,82,16824,16825,14605,2220,36,2,2,8,480,480,478,478
Stanislaus,10,2022-02-21,732,732,590,142,11759,11759,9489,2270,168,29,29,30,1641,1641,1612,1612
Sutter,10,2022-02-21,121,121,105,16,2108,2108,1821,287,0,2,2,0,219,219,217,217
Tehama,10,2022-02-21,96,96,78,18,1219,1219,993,226,8,10,10,2,199,199,189,189
Trinity,10,2022-02-21,15,15,12,3,199,199,160,39,0,0,0,0,20,20,20,20
Tulare,10,2022-02-21,776,776,623,153,10927,10927,8785,2142,86,15,15,9,1448,1448,1433,1433
Tuolumne,10,2022-02-21,107,107,90,17,1784,1784,1491,293,2,6,6,2,178,178,172,172
Ventura,10,2022-02-21,886,886,802,84,27543,27548,24931,2617,107,22,22,22,1464,1464,1442,1442
Yolo,10,2022-02-21,282,282,248,34,20978,20982,18402,2580,7,6,6,3,349,349,343,343
Yuba,10,2022-02-21,135,135,118,17,1679,1679,1466,213,22,1,1,8,116,116,115,115
Alameda,11,2022-02-28,1476,1476,1349,127,78763,78776,71948,6828,113,17,17,23,1833,1833,1816,1816
Amador,11,2022-02-28,56,56,48,8,2077,2077,1796,281,7,0,0,2,84,84,84,84
Butte,11,2022-02-28,188,188,175,13,4475,4475,4156,319,45,6,6,4,422,422,416,416
Calaveras,11,2022-02-28,40,40,35,5,1254,1254,1105,149,0,3,3,0,117,117,114,114
Colusa,11,2022-02-28,10,10,9,1,406,406,364,42,5,0,0,0,21,21,21,21
Contra Costa,11,2022-02-28,936,936,807,129,35020,35025,30199,4826,56,15,15,19,1278,1278,1263,1263
Del Norte,11,2022-02-28,84,84,75,9,2876,2876,2557,319,5,3,3,2,47,47,44,44
El Dorado,11,2022-02-28,106,106,94,12,3686,3686,3252,434,5,2,2,3,207,207,205,205
Fresno,11,2022-02-28,1307,1307,1136,171,26369,26374,22913,3461,196,28,28,44,2709,2709,2681,2681
Glenn,11,2022-02-28,18,18,16,2,435,435,386,49,1,0,0,0,52,52,52,52
Humboldt,11,2022-02-28,157,157,140,17,2956,2956,2632,324,6,1,1,1,140,140,139,139
Imperial,11,2022-02-28,264,264,233,31,4783,4783,4210,573,13,6,6,10,933,933,927,927
Inyo,11,2022-02-28,10,10,9,1,379,379,341,38,0,0,0,0,56,56,56,56
Kern,11,2022-02-28,791,791,712,79,24603,24608,22155,2453,77,16,16,16,2305,2305,2289,2289
Kings,11,2022-02-28,246,246,216,30,6079,6079,5356,723,19,7,7,3,440,440,433,433
Lake,11,2022-02-28,110,110,95,15,1956,1956,1695,261,0,4,4,1,136,136,132,132
Lassen,11,2022-02-28,44,44,40,4,2097,2097,1899,198,1,2,2,0,61,61,59,59
Los Angeles,11,2022-02-28,8217,8217,7919,298,1057292,1057450,1018907,38543,753,222,222,174,31335,31335,31113,31113
Madera,11,2022-02-28,189,189,164,25,4623,4623,4012,611,20,2,2,6,368,368,366,366
Marin,11,2022-02-28,160,160,140,20,7664,7664,6681,983,13,3,3,3,292,292,289,289
Mariposa,11,2022-02-28,29,29,25,4,347,347,298,49,0,1,1,0,26,26,25,25
Mendocino,11,2022-02-28,84,84,70,14,1889,1889,1571,318,11,2,2,2,121,121,119,119
Merced,11,2022-02-28,283,283,254,29,5030,5030,4509,521,25,7,7,5,801,801,794,794
Modoc,11,2022-02-28,6,6,5,1,57,57,51,6,1,0,0,0,7,7,7,7
Mono,11,2022-02-28,5,5,4,1,169,169,136,33,0,0,0,0,6,6,6,6
Monterey,11,2022-02-28,355,355,286,69,14337,14339,11563,2776,28,9,9,5,715,715,706,706
Napa,11,2022-02-28,194,194,176,18,5593,5593,5079,514,8,3,3,2,138,138,135,135
Nevada,11,2022-02-28,70,70,61,9,2016,2016,1753,263,9,0,0,1,127,127,127,127
Orange,11,2022-02-28,1688,1688,1551,137,126368,126388,116123,10265,198,42,42,35,6997,6997,6955,6955
Placer,11,2022-02-28,248,248,213,35,8421,8421,7233,1188,65,4,4,13,612,612,608,608
Plumas,11,2022-02-28,23,23,20,3,370,370,323,47,0,0,0,0,13,13,13,13
Riverside,11,2022-02-28,1687,1687,1508,179,63264,63274,56577,6697,185,37,37,35,6381,6381,6344,6344
Sacramento,11,2022-02-28,1163,1163,1032,131,45697,45703,40521,5182,163,24,24,35,2983,2983,2959,2959
San Benito,11,2022-02-28,55,55,50,5,1809,1809,1638,171,0,0,0,1,91,91,91,91
San Bernardino,11,2022-02-28,1174,1174,1072,102,61093,61101,55781,5320,157,60,60,45,7686,7686,7626,7626
San Diego,11,2022-02-28,3034,3034,2918,116,100026,100040,96236,3804,341,37,37,83,5256,5256,5219,5219
San Francisco,11,2022-02-28,836,836,662,174,40065,40070,31745,8325,74,16,16,19,845,845,829,829
San Joaquin,11,2022-02-28,658,658,577,81,26110,26114,22888,3226,58,11,11,24,2220,2220,2209,2209
San Luis Obispo,11,2022-02-28,378,378,341,37,8504,8504,7672,832,9,5,5,2,459,459,454,454
San Mateo,11,2022-02-28,597,597,549,48,41439,41445,38091,3354,33,4,4,7,695,695,691,691
Santa Barbara,11,2022-02-28,369,369,329,40,21385,21388,19065,2323,36,5,5,10,670,670,665,665
Santa Clara,11,2022-02-28,1730,1730,1660,70,103090,103105,98985,4120,191,22,22,46,2255,2255,2233,2233
Santa Cruz,11,2022-02-28,460,460,416,44,27974,27978,25347,2631,20,2,2,4,256,256,254,254
Shasta,11,2022-02-28,167,167,148,19,4926,4926,4373,553,36,11,11,8,537,537,526,526
Siskiyou,11,2022-02-28,25,25,23,2,475,475,432,43,4,2,2,1,79,79,77,77
Solano,11,2022-02-28,476,476,425,51,15357,15357,13725,1632,47,3,3,17,444,444,441,441
Sonoma,11,2022-02-28,454,454,407,47,16951,16953,15188,1765,28,3,3,5,483,483,480,480
Stanislaus,11,2022-02-28,470,470,396,74,13361,13361,11275,2086,124,11,11,21,1652,1652,1641,1641
Sutter,11,2022-02-28,106,106,95,11,2333,2333,2079,254,0,2,2,0,221,221,219,219
Tehama,11,2022-02-28,60,60,51,9,1221,1221,1039,182,7,1,1,2,200,200,199,199
Trinity,11,2022-02-28,5,5,4,1,118,118,99,19,0,0,0,0,20,20,20,20
Tulare,11,2022-02-28,464,464,390,74,11876,11876,9990,1886,67,15,15,9,1463,1463,1448,1448
Tuolumne,11,2022-02-28,69,69,60,9,1486,1486,1291,195,6,3,3,1,181,181,178,178
Ventura,11,2022-02-28,548,548,507,41,29889,29894,27653,2241,75,10,10,11,1474,1474,1464,1464
Yolo,11,2022-02-28,207,207,187,20,26248,26253,23707,2546,4,5,5,6,354,354,349,349
Yuba,11,2022-02-28,75,75,67,8,1711,1711,1537,174,12,1,1,6,117,117,116,116
Alameda,12,2022-03-07,1094,1094,1019,75,72387,72403,67418,4985,77,12,12,16,1845,1845,1833,1833
Amador,12,2022-03-07,75,75,67,8,1428,1428,1274,154,6,2,2,1,86,86,84,84
Butte,12,2022-03-07,98,98,92,6,3638,3638,3434,204,33,4,4,3,426,426,422,422
Calaveras,12,2022-03-07,25,25,23,2,1048,1048,948,100,1,1,1,0,118,118,117,117
Colusa,12,2022-03-07,9,9,8,1,355,355,326,29,6,0,0,0,21,21,21,21
Contra Costa,12,2022-03-07,627,627,558,69,30970,30975,27550,3425,47,8,8,13,1286,1286,1278,1278
Del Norte,12,2022-03-07,50,50,46,4,1779,1779,1624,155,7,0,0,1,47,47,47,47
El Dorado,12,2022-03-07,77,77,70,7,3200,3200,2899,301,5,3,3,2,210,210,207,207
Fresno,12,2022-03-07,859,859,769,90,22260,22265,19933,2332,145,18,18,27,2727,2727,2709,2709
Glenn,12,2022-03-07,19,19,17,2,395,395,359,36,2,1,1,0,53,53,52,52
Humboldt,12,2022-03-07,81,81,74,7,3045,3045,2779,266,10,3,3,4,143,143,140,140
Imperial,12,2022-03-07,122,122,110,12,4481,4481,4054,427,16,5,5,10,938,938,933,933
Inyo,12,2022-03-07,10,10,9,1,269,269,247,22,0,0,0,0,56,56,56,56
Kern,12,2022-03-07,433,433,398,35,20833,20838,19189,1649,67,12,12,16,2317,2317,2305,2305
Kings,12,2022-03-07,201,201,182,19,4986,4986,4514,472,13,4,4,2,444,444,440,440
Lake,12,2022-03-07,64,64,57,7,1760,1760,1572,188,2,2,2,1,138,138,136,136
Lassen,12,2022-03-07,96,96,89,7,1889,1889,1748,141,0,1,1,0,62,62,61,61
Los Angeles,12,2022-03-07,5537,5537,5380,157,876059,876232,851304,24928,573,171,171,133,31506,31506,31335,31335
Madera,12,2022-03-07,133,133,119,14,3916,3916,3502,414,15,1,1,2,369,369,368,368
Marin,12,2022-03-07,154,154,138,16,7558,7558,6778,780,10,1,1,2,293,293,292,292
Mariposa,12,2022-03-07,11,11,10,1,296,296,263,33,0,1,1,0,27,27,26,26
Mendocino,12,2022-03-07,65,65,56,9,1643,1643,1418,225,6,0,0,2,121,121,121,121
Merced,12,2022-03-07,173,173,159,14,4536,4536,4161,375,17,7,7,5,808,808,801,801
Modoc,12,2022-03-07,0,0,0,0,54,54,50,4,0,0,0,0,7,7,7,7
Mono,12,2022-03-07,2,2,2,0,128,128,108,20,0,0,0,1,6,6,6,6
Monterey,12,2022-03-07,244,244,206,38,11053,11054,9325,1729,19,5,5,2,720,720,715,715
Napa,12,2022-03-07,199,199,185,14,4874,4874,4518,356,2,1,1,2,139,139,138,138
Nevada,12,2022-03-07,50,50,45,5,1750,1750,1568,182,0,2,2,0,129,129,127,127
Orange,12,2022-03-07,1254,1254,1174,80,107453,107475,100569,6906,138,29,29,28,7026,7026,6997,6997
Placer,12,2022-03-07,164,164,145,19,7797,7797,6916,881,54,3,3,11,615,615,612,612
Plumas,12,2022-03-07,7,7,6,1,266,266,239,27,0,0,0,0,13,13,13,13
Riverside,12,2022-03-07,980,980,898,82,53631,53643,49128,4515,125,26,26,30,6407,6407,6381,6381
Sacramento,12,2022-03-07,773,773,704,69,40204,40210,36589,3621,124,18,18,28,3001,3001,2983,2983
San Benito,12,2022-03-07,41,41,38,3,1525,1525,1411,114,0,2,2,1,93,93,91,91
San Bernardino,12,2022-03-07,792,792,737,55,54190,54202,50464,3738,95,43,43,38,7729,7729,7686,7686
San Diego,12,2022-03-07,2338,2338,2268,70,96665,96684,93800,2884,237,31,31,57,5287,5287,5256,5256
San Francisco,12,2022-03-07,700,700,582,118,37419,37425,31067,6358,62,5,5,11,850,850,845,845
San Joaquin,12,2022-03-07,439,439,396,43,21215,21220,19139,2081,33,9,9,19,2229,2229,2220,2220
San Luis Obispo,12,2022-03-07,245,245,226,19,7300,7300,6735,565,7,5,5,1,464,464,459,459
San Mateo,12,2022-03-07,529,529,495,34,40058,40065,37477,2588,30,2,2,3,697,697,695,695
Santa Barbara,12,2022-03-07,203,203,186,17,17714,17719,16191,1528,15,4,4,8,674,674,670,670
Santa Clara,12,2022-03-07,1467,1467,1421,46,112126,112148,108578,3570,128,13,13,38,2268,2268,2255,2255
Santa Cruz,12,2022-03-07,335,335,310,25,24974,24978,23119,1859,11,0,0,7,256,256,256,256
Shasta,12,2022-03-07,140,140,127,13,4940,4940,4498,442,24,8,8,3,545,545,537,537
Siskiyou,12,2022-03-07,12,12,11,1,399,399,370,29,2,1,1,0,80,80,79,79
Solano,12,2022-03-07,352,352,322,30,14104,14106,12911,1195,46,2,2,10,446,446,444,444
Sonoma,12,2022-03-07,321,321,294,27,14921,14923,13686,1237,26,3,3,6,486,486,483,483
Stanislaus,12,2022-03-07,276,276,241,35,10858,10859,9501,1358,94,10,10,13,1662,1662,1652,1652
Sutter,12,2022-03-07,81,81,74,7,1908,1908,1742,166,0,1,1,0,222,222,221,221
Tehama,12,2022-03-07,40,40,35,5,1115,1115,980,135,5,2,2,1,202,202,200,200
Trinity,12,2022-03-07,4,4,3,1,114,114,100,14,0,0,0,0,20,20,20,20
Tulare,12,2022-03-07,302,302,263,39,10282,10283,8975,1308,37,13,13,3,1476,1476,1463,1463
Tuolumne,12,2022-03-07,48,48,43,5,1253,1253,1122,131,2,0,0,1,181,181,181,181
Ventura,12,2022-03-07,417,417,392,25,26717,26722,25141,1581,45,4,4,11,1478,1478,1474,1474
Yolo,12,2022-03-07,160,160,148,12,22158,22163,20458,1705,3,2,2,2,356,356,354,354
Yuba,12,2022-03-07,59,59,54,5,1553,1553,1426,127,13,0,0,6,117,117,117,117
Alameda,13,2022-03-14,877,877,829,48,68949,68966,65214,3752,64,9,9,6,1854,1854,1845,1845
Amador,13,2022-03-14,32,32,29,3,1439,1439,1315,124,4,0,0,0,86,86,86,86
Butte,13,2022-03-14,82,82,78,4,3592,3592,3432,160,24,1,1,0,427,427,426,426
Calaveras,13,2022-03-14,17,17,16,1,990,990,914,76,1,1,1,1,119,119,118,118
Colusa,13,2022-03-14,4,4,4,0,257,257,240,17,4,0,0,0,21,21,21,21
Contra Costa,13,2022-03-14,567,567,517,50,29143,29149,26579,2570,19,5,5,9,1291,1291,1286,1286
Del Norte,13,2022-03-14,31,31,29,2,1415,1415,1317,98,1,2,2,1,49,49,47,47
El Dorado,13,2022-03-14,44,44,41,3,2980,2980,2757,223,4,1,1,0,211,211,210,210
Fresno,13,2022-03-14,523,523,479,44,21169,21174,19405,1769,120,10,10,20,2737,2737,2727,2727
Glenn,13,2022-03-14,11,11,10,1,342,342,318,24,1,0,0,0,53,53,53,53
Humboldt,13,2022-03-14,56,56,52,4,2651,2651,2466,185,3,1,1,2,144,144,143,143
Imperial,13,2022-03-14,74,74,68,6,4551,4551,4203,348,5,2,2,7,940,940,938,938
Inyo,13,2022-03-14,6,6,6,0,165,165,154,11,0,0,0,0,56,56,56,56
Kern,13,2022-03-14,301,301,282,19,20273,20278,19007,1271,42,14,14,12,2331,2331,2317,2317
Kings,13,2022-03-14,155,155,143,12,4695,4695,4341,354,17,1,1,2,445,445,444,444
Lake,13,2022-03-14,48,48,44,4,1570,1570,1436,134,1,1,1,0,139,139,138,138
Lassen,13,2022-03-14,5,5,5,0,1515,1515,1426,89,0,0,0,0,62,62,62,62
Los Angeles,13,2022-03-14,4057,4057,3967,90,845621,845830,826971,18859,412,115,115,91,31621,31621,31506,31506
Madera,13,2022-03-14,52,52,48,4,3575,3575,3272,303,12,0,0,2,369,369,369,369
Marin,13,2022-03-14,170,170,156,14,6532,6532,5997,535,7,1,1,0,294,294,293,293
Mariposa,13,2022-03-14,9,9,8,1,222,222,202,20,0,0,0,0,27,27,27,27
Mendocino,13,2022-03-14,35,35,31,4,1434,1434,1276,158,4,2,2,1,123,123,121,121
Merced,13,2022-03-14,134,134,125,9,4167,4167,3895,272,17,2,2,4,810,810,808,808
Modoc,13,2022-03-14,3,3,3,0,52,52,49,3,1,0,0,0,7,7,7,7
Mono,13,2022-03-14,2,2,2,0,118,118,103,15,0,0,0,0,6,6,6,6
Monterey,13,2022-03-14,156,156,136,20,10113,10115,8836,1279,14,4,4,2,724,724,720,720
Napa,13,2022-03-14,121,121,114,7,4104,4104,3867,237,6,1,1,3,140,140,139,139
Nevada,13,2022-03-14,50,50,46,4,1571,1571,1441,130,2,0,0,0,129,129,129,129
Orange,13,2022-03-14,822,822,780,42,101559,101585,96429,5156,109,31,31,31,7057,7057,7026,7026
Placer,13,2022-03-14,148,148,135,13,7319,7319,6658,661,45,3,3,5,618,618,615,615
Plumas,13,2022-03-14,4,4,4,0,317,317,291,26,0,0,0,0,13,13,13,13
Riverside,13,2022-03-14,739,739,690,49,52736,52749,49232,3517,87,15,15,16,6422,6422,6407,6407
Sacramento,13,2022-03-14,587,587,545,42,35139,35147,32623,2524,122,16,16,22,3017,3017,3001,3001
San Benito,13,2022-03-14,36,36,34,2,1462,1462,1375,87,0,0,0,1,93,93,93,93
San Bernardino,13,2022-03-14,568,568,537,31,51684,51697,48876,2821,68,26,26,32,7755,7755,7729,7729
San Diego,13,2022-03-14,1844,1844,1801,43,96065,96089,93834,2255,174,17,17,47,5304,5304,5287,5287
San Francisco,13,2022-03-14,608,608,525,83,34320,34329,29607,4722,28,7,7,7,857,857,850,850
San Joaquin,13,2022-03-14,268,268,247,21,18891,18896,17409,1487,28,7,7,11,2236,2236,2229,2229
San Luis Obispo,13,2022-03-14,162,162,152,10,6664,6664,6254,410,7,7,7,1,471,471,464,464
San Mateo,13,2022-03-14,441,441,419,22,35834,35842,34007,1835,27,0,0,3,697,697,697,697
Santa Barbara,13,2022-03-14,196,196,183,13,16859,16864,15704,1160,16,7,7,2,681,681,674,674
Santa Clara,13,2022-03-14,1177,1177,1148,29,99875,99898,97400,2498,108,13,13,28,2281,2281,2268,2268
Santa Cruz,13,2022-03-14,239,239,225,14,22176,22181,20873,1308,10,3,3,3,259,259,256,256
Shasta,13,2022-03-14,97,97,90,7,4838,4838,4492,346,16,5,5,2,550,550,545,545
Siskiyou,13,2022-03-14,9,9,8,1,370,370,349,21,0,3,3,0,83,83,80,80
Solano,13,2022-03-14,221,221,206,15,12336,12340,11509,831,34,1,1,6,447,447,446,446
Sonoma,13,2022-03-14,228,228,213,15,13400,13404,12518,886,14,1,1,4,487,487,486,486
Stanislaus,13,2022-03-14,216,216,194,22,9401,9402,8454,948,82,11,11,17,1673,1673,1662,1662
Sutter,13,2022-03-14,41,41,38,3,1815,1815,1689,126,0,0,0,0,222,222,222,222
Tehama,13,2022-03-14,17,17,15,2,981,981,886,95,2,3,3,0,205,205,202,202
Trinity,13,2022-03-14,3,3,3,0,96,96,86,10,0,0,0,0,20,20,20,20
Tulare,13,2022-03-14,174,174,156,18,9301,9302,8349,953,33,0,0,6,1476,1476,1476,1476
Tuolumne,13,2022-03-14,22,22,20,2,1246,1246,1142,104,1,0,0,0,181,181,181,181
Ventura,13,2022-03-14,326,326,311,15,24591,24597,23446,1151,37,6,6,7,1484,1484,1478,1478
Yolo,13,2022-03-14,118,118,111,7,21624,21629,20311,1318,1,3,3,2,359,359,356,356
Yuba,13,2022-03-14,35,35,33,2,1417,1417,1325,92,10,0,0,3,117,117,117,117
Alameda,14,2022-03-21,723,723,692,31,65826,65848,63015,2833,58,7,7,3,1861,1861,1854,1854
Amador,14,2022-03-21,29,29,27,2,1356,1356,1263,93,2,0,0,0,86,86,86,86
Butte,14,2022-03-21,81,81,78,3,3158,3158,3048,110,17,0,0,2,427,427,427,427
Calaveras,14,2022-03-21,8,8,8,0,657,657,618,39,0,0,0,0,119,119,119,119
Colusa,14,2022-03-21,3,3,3,0,231,231,219,12,2,0,0,0,21,21,21,21
Contra Costa,14,2022-03-21,466,466,434,32,26932,26941,25048,1893,27,7,7,9,1298,1298,1291,1291
Del Norte,14,2022-03-21,19,19,18,1,1192,1192,1127,65,0,0,0,0,49,49,49,49
El Dorado,14,2022-03-21,46,46,43,3,2813,2813,2647,166,1,2,2,0,213,213,211,211
Fresno,14,2022-03-21,349,349,326,23,19379,19384,18098,1286,97,11,11,12,2748,2748,2737,2737
Glenn,14,2022-03-21,7,7,7,0,366,366,345,21,1,0,0,0,53,53,53,53
Humboldt,14,2022-03-21,31,31,29,2,2456,2456,2322,134,5,1,1,2,145,145,144,144
Imperial,14,2022-03-21,58,58,54,4,3965,3965,3727,238,4,3,3,4,943,943,940,940
Inyo,14,2022-03-21,1,1,1,0,148,148,140,8,0,0,0,0,56,56,56,56
Kern,14,2022-03-21,206,206,196,10,19490,19496,18530,966,34,4,4,9,2335,2335,2331,2331
Kings,14,2022-03-21,79,79,74,5,4411,4411,4147,264,7,1,1,1,446,446,445,445
Lake,14,2022-03-21,18,18,17,1,1365,1365,1272,93,0,0,0,0,139,139,139,139
Lassen,14,2022-03-21,10,10,10,0,1388,1388,1323,65,0,0,0,0,62,62,62,62
Los Angeles,14,2022-03-21,4130,4130,4059,71,822835,823096,808720,14376,338,76,76,66,31697,31697,31621,31621
Madera,14,2022-03-21,40,40,37,3,3392,3392,3164,228,9,1,1,1,370,370,369,369
Marin,14,2022-03-21,133,133,124,9,6231,6231,5825,406,6,1,1,0,295,295,294,294
Mariposa,14,2022-03-21,7,7,6,1,236,236,219,17,0,0,0,0,27,27,27,27
Mendocino,14,2022-03-21,28,28,26,2,1508,1508,1376,132,4,0,0,1,123,123,123,123
Merced,14,2022-03-21,87,87,82,5,3771,3771,3576,195,13,5,5,1,815,815,810,810
Modoc,14,2022-03-21,2,2,2,0,60,60,57,3,0,0,0,0,7,7,7,7
Mono,14,2022-03-21,4,4,4,0,134,134,120,14,1,0,0,0,6,6,6,6
Monterey,14,2022-03-21,152,152,137,15,10087,10089,9064,1025,22,0,0,1,724,724,724,724
Napa,14,2022-03-21,54,54,52,2,3451,3451,3294,157,6,1,1,2,141,141,140,140
Nevada,14,2022-03-21,18,18,17,1,1528,1528,1428,100,2,0,0,0,129,129,129,129
Orange,14,2022-03-21,757,757,727,30,96133,96164,92310,3854,100,12,12,25,7069,7069,7057,7057
Placer,14,2022-03-21,112,112,104,8,6475,6476,6011,465,40,2,2,6,620,620,618,618
Plumas,14,2022-03-21,2,2,2,0,228,228,213,15,0,0,0,0,13,13,13,13
Riverside,14,2022-03-21,616,616,583,33,51895,51911,49154,2757,69,13,13,18,6435,6435,6422,6422
Sacramento,14,2022-03-21,460,460,434,26,32984,32996,31124,1872,89,13,13,13,3030,3030,3017,3017
San Benito,14,2022-03-21,19,19,18,1,1385,1385,1320,65,0,1,1,0,94,94,93,93
San Bernardino,14,2022-03-21,473,473,453,20,49316,49332,47200,2132,49,20,20,31,7775,7775,7755,7755
San Diego,14,2022-03-21,1372,1372,1347,25,84591,84619,83063,1556,146,15,15,39,5319,5319,5304,5304
San Francisco,14,2022-03-21,687,687,612,75,33568,33580,29867,3713,34,3,3,3,860,860,857,857
San Joaquin,14,2022-03-21,221,221,207,14,15687,15692,14720,972,23,6,6,6,2242,2242,2236,2236
San Luis Obispo,14,2022-03-21,107,107,102,5,6416,6417,6104,313,3,5,5,0,476,476,471,471
San Mateo,14,2022-03-21,369,369,354,15,34927,34938,33533,1405,30,1,1,1,698,698,697,697
Santa Barbara,14,2022-03-21,160,160,151,9,14296,14301,13512,789,17,5,5,4,686,686,681,681
Santa Clara,14,2022-03-21,1099,1099,1078,21,95231,95260,93394,1866,101,5,5,20,2286,2286,2281,2281
Santa Cruz,14,2022-03-21,184,184,175,9,20037,20044,19108,936,8,0,0,3,259,259,259,259
Shasta,14,2022-03-21,41,41,39,2,4136,4136,3902,234,10,6,6,2,556,556,550,550
Siskiyou,14,2022-03-21,9,9,9,0,370,370,353,17,1,0,0,0,83,83,83,83
Solano,14,2022-03-21,187,187,177,10,11782,11786,11160,626,17,1,1,5,448,448,447,447
Sonoma,14,2022-03-21,229,229,217,12,12377,12381,11729,652,15,2,2,2,489,489,487,487
Stanislaus,14,2022-03-21,142,142,131,11,8428,8430,7754,676,59,12,12,8,1685,1685,1673,1673
Sutter,14,2022-03-21,34,34,32,2,1478,1478,1398,80,0,1,1,0,223,223,222,222
Tehama,14,2022-03-21,10,10,9,1,926,926,854,72,2,0,0,0,205,205,205,205
Trinity,14,2022-03-21,0,0,0,0,111,111,102,9,0,0,0,0,20,20,20,20
Tulare,14,2022-03-21,109,109,100,9,8167,8168,7501,667,27,5,5,4,1481,1481,1476,1476
Tuolumne,14,2022-03-21,19,19,18,1,1131,1131,1055,76,2,0,0,0,181,181,181,181
Ventura,14,2022-03-21,289,289,278,11,23283,23289,22429,860,30,5,5,6,1489,1489,1484,1484
Yolo,14,2022-03-21,107,107,102,5,21433,21438,20399,1039,1,0,0,1,359,359,359,359
Yuba,14,2022-03-21,42,42,40,2,1318,1318,1251,67,8,0,0,2,117,117,117,117
Alameda,15,2022-03-28,926,926,895,31,59262,59287,57288,1999,35,4,4,5,1865,1865,1861,1861
Amador,15,2022-03-28,8,8,8,0,1376,1376,1301,75,3,0,0,0,86,86,86,86
Butte,15,2022-03-28,64,64,62,2,2854,2854,2776,78,11,0,0,1,427,427,427,427
Calaveras,15,2022-03-28,15,15,14,1,580,580,553,27,0,0,0,0,119,119,119,119
Colusa,15,2022-03-28,4,4,4,0,207,207,199,8,0,0,0,0,21,21,21,21
Contra Costa,15,2022-03-28,535,535,506,29,24910,24921,23539,1382,29,1,1,6,1299,1299,1298,1298
Del Norte,15,2022-03-28,16,16,15,1,1038,1038,993,45,1,0,0,0,49,49,49,49
El Dorado,15,2022-03-28,60,60,57,3,2810,2810,2679,131,0,0,0,0,213,213,213,213
Fresno,15,2022-03-28,275,275,261,14,17945,17953,17011,942,71,5,5,18,2753,2753,2748,2748
Glenn,15,2022-03-28,8,8,8,0,333,333,318,15,0,0,0,0,53,53,53,53
Humboldt,15,2022-03-28,27,27,26,1,2608,2608,2495,113,4,0,0,3,145,145,145,145
Imperial,15,2022-03-28,62,62,59,3,3535,3535,3367,168,4,1,1,3,944,944,943,943
Inyo,15,2022-03-28,4,4,4,0,186,186,178,8,1,0,0,0,56,56,56,56
Kern,15,2022-03-28,144,144,138,6,18179,18185,17475,710,17,4,4,8,2339,2339,2335,2335
Kings,15,2022-03-28,57,57,54,3,4275,4275,4073,202,6,2,2,0,448,448,446,446
Lake,15,2022-03-28,10,10,9,1,1068,1068,1010,58,0,0,0,0,139,139,139,139
Lassen,15,2022-03-28,4,4,4,0,1284,1284,1236,48,0,0,0,0,62,62,62,62
Los Angeles,15,2022-03-28,4473,4473,4412,61,703825,704120,694389,9731,264,52,52,57,31749,31749,31697,31697
Madera,15,2022-03-28,24,24,23,1,3451,3451,3268,183,4,0,0,2,370,370,370,370
Marin,15,2022-03-28,180,180,171,9,6000,6001,5693,308,3,0,0,0,295,295,295,295
Mariposa,15,2022-03-28,5,5,5,0,179,179,169,10,0,1,1,0,28,28,27,27
Mendocino,15,2022-03-28,31,31,29,2,1314,1314,1223,91,0,1,1,0,124,124,123,123
Merced,15,2022-03-28,64,64,61,3,3359,3359,3223,136,5,1,1,3,816,816,815,815
Modoc,15,2022-03-28,3,3,3,0,45,45,43,2,0,0,0,0,7,7,7,7
Mono,15,2022-03-28,1,1,1,0,134,134,123,11,0,0,0,0,6,6,6,6
Monterey,15,2022-03-28,150,150,138,12,8782,8787,8073,714,14,1,1,0,725,725,724,724
Napa,15,2022-03-28,68,68,66,2,3329,3329,3210,119,1,2,2,1,143,143,141,141
Nevada,15,2022-03-28,27,27,26,1,1431,1431,1357,74,1,1,1,0,130,130,129,129
Orange,15,2022-03-28,809,809,784,25,90210,90250,87413,2837,81,12,12,17,7081,7081,7069,7069
Placer,15,2022-03-28,107,107,101,6,6222,6223,5871,352,26,4,4,6,624,624,620,620
Plumas,15,2022-03-28,3,3,3,0,267,267,253,14,0,0,0,0,13,13,13,13
Riverside,15,2022-03-28,522,522,500,22,43927,43945,42113,1832,47,7,7,10,6442,6442,6435,6435
Sacramento,15,2022-03-28,458,458,438,20,32473,32487,31036,1451,68,6,6,19,3036,3036,3030,3030
San Benito,15,2022-03-28,14,14,13,1,1365,1365,1315,50,0,0,0,0,94,94,94,94
San Bernardino,15,2022-03-28,545,545,527,18,41307,41325,39927,1398,40,18,18,24,7793,7793,7775,7775
San Diego,15,2022-03-28,1325,1325,1306,19,72132,72162,71126,1036,114,9,9,26,5328,5328,5319,5319
San Francisco,15,2022-03-28,844,844,770,74,32805,32819,29923,2896,23,5,5,5,865,865,860,860
San Joaquin,15,2022-03-28,190,190,181,9,17505,17511,16656,855,20,4,4,4,2246,2246,2242,2242
San Luis Obispo,15,2022-03-28,96,96,92,4,5701,5702,5485,217,5,1,1,1,477,477,476,476
San Mateo,15,2022-03-28,582,582,564,18,33959,33974,32898,1076,26,3,3,3,701,701,698,698
Santa Barbara,15,2022-03-28,135,135,129,6,10222,10227,9796,431,15,1,1,4,687,687,686,686
Santa Clara,15,2022-03-28,1275,1275,1256,19,95189,95229,93776,1453,88,10,10,18,2296,2296,2286,2286
Santa Cruz,15,2022-03-28,145,145,140,5,19692,19702,18985,717,3,0,0,2,259,259,259,259
Shasta,15,2022-03-28,34,34,32,2,3879,3880,3707,173,7,2,2,3,558,558,556,556
Siskiyou,15,2022-03-28,5,5,5,0,292,292,282,10,0,0,0,0,83,83,83,83
Solano,15,2022-03-28,169,169,162,7,10957,10962,10504,458,18,0,0,6,448,448,448,448
Sonoma,15,2022-03-28,260,260,250,10,8553,8556,8209,347,13,0,0,1,489,489,489,489
Stanislaus,15,2022-03-28,119,119,111,8,8184,8187,7668,519,28,2,2,3,1687,1687,1685,1685
Sutter,15,2022-03-28,25,25,24,1,1490,1490,1426,64,0,1,1,0,224,224,223,223
Tehama,15,2022-03-28,13,13,12,1,798,798,749,49,3,1,1,0,206,206,205,205
Trinity,15,2022-03-28,0,0,0,0,79,79,74,5,0,0,0,0,20,20,20,20
Tulare,15,2022-03-28,81,81,76,5,7838,7843,7335,508,20,6,6,1,1487,1487,1481,1481
Tuolumne,15,2022-03-28,7,7,7,0,1083,1083,1026,57,3,1,1,0,182,182,181,181
Ventura,15,2022-03-28,335,335,325,10,21204,21212,20598,614,23,6,6,3,1495,1495,1489,1489
Yolo,15,2022-03-28,103,103,99,4,20514,20522,19758,764,3,2,2,0,361,361,359,359
Yuba,15,2022-03-28,26,26,25,1,1214,1214,1165,49,2,2,2,1,119,119,117,117
Alameda,16,2022-04-04,1055,1055,1028,27,56224,56255,54760,1495,40,3,3,3,1868,1868,1865,1865
Amador,16,2022-04-04,2,2,2,0,1107,1107,1060,47,1,0,0,0,86,86,86,86
Butte,16,2022-04-04,44,44,43,1,2582,2582,2526,56,8,2,2,1,429,429,427,427
Calaveras,16,2022-04-04,8,8,8,0,589,589,567,22,0,0,0,0,119,119,119,119
Colusa,16,2022-04-04,2,2,2,0,202,202,196,6,0,0,0,0,21,21,21,21
Contra Costa,16,2022-04-04,544,544,520,24,23559,23571,22535,1036,13,1,1,4,1300,1300,1299,1299
Del Norte,16,2022-04-04,8,8,8,0,1118,1118,1080,38,0,0,0,1,49,49,49,49
El Dorado,16,2022-04-04,50,50,48,2,2717,2717,2617,100,0,1,1,1,214,214,213,213
Fresno,16,2022-04-04,188,188,180,8,16848,16857,16161,696,62,4,4,12,2757,2757,2753,2753
Glenn,16,2022-04-04,3,3,3,0,287,287,277,10,0,0,0,0,53,53,53,53
Humboldt,16,2022-04-04,23,23,22,1,2385,2385,2303,82,5,0,0,2,145,145,145,145
Imperial,16,2022-04-04,39,39,37,2,3451,3451,3322,129,3,0,0,2,944,944,944,944
Inyo,16,2022-04-04,9,9,9,0,182,182,176,6,0,0,0,0,56,56,56,56
Kern,16,2022-04-04,152,152,147,5,16751,16760,16245,515,16,2,2,7,2341,2341,2339,2339
Kings,16,2022-04-04,47,47,45,2,4178,4178,4022,156,2,0,0,1,448,448,448,448
Lake,16,2022-04-04,14,14,13,1,973,973,931,42,0,0,0,0,139,139,139,139
Lassen,16,2022-04-04,5,5,5,0,1284,1284,1247,37,0,0,0,0,62,62,62,62
Los Angeles,16,2022-04-04,5461,5462,5405,57,803346,803765,795153,8612,255,47,47,42,31796,31796,31749,31749
Madera,16,2022-04-04,27,27,26,1,3190,3190,3057,133,3,0,0,1,370,370,370,370
Marin,16,2022-04-04,167,167,160,7,6346,6351,6093,258,3,0,0,1,295,295,295,295
Mariposa,16,2022-04-04,7,7,7,0,235,235,225,10,0,0,0,0,28,28,28,28
Mendocino,16,2022-04-04,25,25,24,1,1196,1196,1130,66,2,0,0,0,124,124,124,124
Merced,16,2022-04-04,58,58,56,2,3350,3350,3243,107,2,2,2,0,818,818,816,816
Modoc,16,2022-04-04,4,4,4,0,43,43,42,1,0,0,0,0,7,7,7,7
Mono,16,2022-04-04,1,1,1,0,142,142,133,9,0,0,0,0,6,6,6,6
Monterey,16,2022-04-04,128,128,120,8,7487,7492,7012,480,8,3,3,0,728,728,725,725
Napa,16,2022-04-04,75,75,73,2,3146,3146,3058,88,1,0,0,1,143,143,143,143
Nevada,16,2022-04-04,30,30,29,1,1447,1447,1388,59,1,1,1,0,131,131,130,130
Orange,16,2022-04-04,989,989,965,24,81527,81571,79538,2033,56,17,17,14,7098,7098,7081,7081
Placer,16,2022-04-04,129,129,123,6,6693,6697,6398,299,19,1,1,5,625,625,624,624
Plumas,16,2022-04-04,4,4,4,0,235,235,225,10,0,0,0,0,13,13,13,13
Riverside,16,2022-04-04,692,692,670,22,38908,38928,37654,1274,36,5,5,8,6447,6447,6442,6442
Sacramento,16,2022-04-04,430,430,415,15,32890,32908,31752,1156,50,8,8,11,3044,3044,3036,3036
San Benito,16,2022-04-04,13,13,13,0,1187,1187,1153,34,0,0,0,0,94,94,94,94
San Bernardino,16,2022-04-04,613,613,597,16,42053,42075,40957,1118,32,11,11,13,7804,7804,7793,7793
San Diego,16,2022-04-04,1548,1548,1531,17,66684,66719,65975,744,88,7,7,29,5335,5335,5328,5328
San Francisco,16,2022-04-04,1001,1001,932,69,28766,28781,26771,2010,20,1,1,3,866,866,865,865
San Joaquin,16,2022-04-04,229,229,220,9,15715,15723,15118,605,9,2,2,8,2248,2248,2246,2246
San Luis Obispo,16,2022-04-04,99,99,96,3,5382,5385,5223,162,2,1,1,1,478,478,477,477
San Mateo,16,2022-04-04,725,725,707,18,29369,29385,28659,726,14,2,2,1,703,703,701,701
Santa Barbara,16,2022-04-04,187,187,181,6,15277,15285,14768,517,7,2,2,1,689,689,687,687
Santa Clara,16,2022-04-04,1492,1492,1474,18,88302,88349,87290,1059,89,2,2,18,2298,2298,2296,2296
Santa Cruz,16,2022-04-04,210,210,204,6,16701,16709,16219,490,4,0,0,2,259,259,259,259
Shasta,16,2022-04-04,29,29,28,1,3320,3320,3203,117,4,1,1,2,559,559,558,558
Siskiyou,16,2022-04-04,2,2,2,0,294,294,286,8,0,0,0,0,83,83,83,83
Solano,16,2022-04-04,173,173,167,6,10251,10256,9919,337,21,1,1,4,449,449,448,448
Sonoma,16,2022-04-04,330,330,320,10,10655,10660,10316,344,9,1,1,1,490,490,489,489
Stanislaus,16,2022-04-04,113,113,107,6,7960,7964,7566,398,21,3,3,5,1690,1690,1687,1687
Sutter,16,2022-04-04,24,24,23,1,1324,1324,1280,44,0,0,0,0,224,224,224,224
Tehama,16,2022-04-04,6,6,6,0,765,765,728,37,0,1,1,0,207,207,206,206
Trinity,16,2022-04-04,1,1,1,0,87,87,83,4,0,0,0,0,20,20,20,20
Tulare,16,2022-04-04,48,48,46,2,7740,7744,7348,396,13,3,3,0,1490,1490,1487,1487
Tuolumne,16,2022-04-04,10,10,10,0,1034,1034,991,43,1,1,1,0,183,183,182,182
Ventura,16,2022-04-04,298,298,291,7,20329,20341,19877,464,19,5,5,5,1500,1500,1495,1495
Yolo,16,2022-04-04,104,104,101,3,26256,26271,25484,787,0,0,0,0,361,361,361,361
Yuba,16,2022-04-04,11,11,11,0,1071,1071,1037,34,4,0,0,1,119,119,119,119
Alameda,17,2022-04-11,1494,1494,1464,30,49841,49872,48842,1030,51,6,6,2,1874,1874,1868,1868
Amador,17,2022-04-11,9,9,9,0,1068,1068,1032,36,1,0,0,0,86,86,86,86
Butte,17,2022-04-11,33,33,32,1,2262,2262,2224,38,3,0,0,1,429,429,429,429
Calaveras,17,2022-04-11,14,14,14,0,649,649,630,19,0,0,0,0,119,119,119,119
Colusa,17,2022-04-11,6,6,6,0,203,203,198,5,0,0,0,0,21,21,21,21
Contra Costa,17,2022-04-11,713,713,689,24,20840,20853,20143,710,15,1,1,5,1301,1301,1300,1300
Del Norte,17,2022-04-11,9,9,9,0,1012,1012,985,27,0,0,0,0,49,49,49,49
El Dorado,17,2022-04-11,48,48,47,1,2508,2508,2436,72,1,0,0,0,214,214,214,214
Fresno,17,2022-04-11,195,195,189,6,15778,15789,15275,514,54,3,3,6,2760,2760,2757,2757
Glenn,17,2022-04-11,2,2,2,0,258,258,251,7,0,0,0,0,53,53,53,53
Humboldt,17,2022-04-11,46,46,45,1,2347,2347,2284,63,5,1,1,2,146,146,145,145
Imperial,17,2022-04-11,28,28,27,1,3448,3449,3348,101,2,1,1,1,945,945,944,944
Inyo,17,2022-04-11,4,4,4,0,188,188,183,5,0,0,0,0,56,56,56,56
Kern,17,2022-04-11,135,135,132,3,16366,16377,15979,398,20,2,2,6,2343,2343,2341,2341
Kings,17,2022-04-11,31,31,30,1,4161,4162,4040,122,3,0,0,0,448,448,448,448
Lake,17,2022-04-11,22,22,21,1,869,869,840,29,0,0,0,0,139,139,139,139
Lassen,17,2022-04-11,1,1,1,0,1292,1292,1263,29,1,0,0,0,62,62,62,62
Los Angeles,17,2022-04-11,6736,6741,6686,55,675656,676059,670350,5709,234,46,46,36,31842,31842,31796,31796
Madera,17,2022-04-11,29,29,28,1,3076,3076,2975,101,4,0,0,2,370,370,370,370
Marin,17,2022-04-11,214,214,207,7,5555,5560,5384,176,6,0,0,1,295,295,295,295
Mariposa,17,2022-04-11,7,7,7,0,246,246,237,9,0,0,0,0,28,28,28,28
Mendocino,17,2022-04-11,32,32,31,1,1158,1158,1108,50,0,0,0,0,124,124,124,124
Merced,17,2022-04-11,69,69,67,2,3221,3221,3140,81,6,2,2,0,820,820,818,818
Modoc,17,2022-04-11,0,0,0,0,40,40,39,1,0,0,0,0,7,7,7,7
Mono,17,2022-04-11,9,9,9,0,170,170,161,9,0,0,0,0,6,6,6,6
Monterey,17,2022-04-11,109,109,103,6,6890,6895,6545,350,9,2,2,0,730,730,728,728
Napa,17,2022-04-11,120,120,117,3,2802,2802,2740,62,1,0,0,0,143,143,143,143
Nevada,17,2022-04-11,45,45,44,1,1431,1431,1385,46,2,0,0,0,131,131,131,131
Orange,17,2022-04-11,1164,1164,1142,22,62009,62048,60869,1179,70,9,9,16,7107,7107,7098,7098
Placer,17,2022-04-11,126,126,122,4,5632,5637,5438,199,18,2,2,2,627,627,625,625
Plumas,17,2022-04-11,7,7,7,0,247,247,239,8,0,0,0,0,13,13,13,13
Riverside,17,2022-04-11,728,728,710,18,37776,37798,36828,970,35,5,5,9,6452,6452,6447,6447
Sacramento,17,2022-04-11,508,508,494,14,30137,30156,29322,834,47,11,11,5,3055,3055,3044,3044
San Benito,17,2022-04-11,16,16,16,0,1182,1182,1155,27,0,0,0,0,94,94,94,94
San Bernardino,17,2022-04-11,914,914,895,19,42011,42036,41160,876,33,5,5,7,7809,7809,7804,7804
San Diego,17,2022-04-11,1831,1831,1815,16,74105,74150,73501,649,91,4,4,22,5339,5339,5335,5335
San Francisco,17,2022-04-11,1182,1182,1117,65,29897,29915,28258,1657,19,6,6,4,872,872,866,866
San Joaquin,17,2022-04-11,221,221,214,7,15242,15250,14788,462,10,0,0,1,2248,2248,2248,2248
San Luis Obispo,17,2022-04-11,120,120,117,3,4908,4911,4795,116,2,1,1,0,479,479,478,478
San Mateo,17,2022-04-11,858,858,842,16,30381,30399,29808,591,8,2,2,1,705,705,703,703
Santa Barbara,17,2022-04-11,303,303,295,8,15120,15129,14727,402,6,2,2,1,691,691,689,689
Santa Clara,17,2022-04-11,1662,1662,1647,15,81519,81567,80807,760,61,4,4,13,2302,2302,2298,2298
Santa Cruz,17,2022-04-11,327,327,320,7,10999,11006,10765,241,7,1,1,0,260,260,259,259
Shasta,17,2022-04-11,18,18,18,0,3123,3123,3036,87,2,1,1,1,560,560,559,559
Siskiyou,17,2022-04-11,1,1,1,0,340,340,332,8,0,0,0,0,83,83,83,83
Solano,17,2022-04-11,249,249,243,6,9441,9446,9202,244,16,0,0,1,449,449,449,449
Sonoma,17,2022-04-11,416,416,406,10,10688,10693,10422,271,8,1,1,0,491,491,490,490
Stanislaus,17,2022-04-11,124,124,119,5,7639,7644,7343,301,22,1,1,1,1691,1691,1690,1690
Sutter,17,2022-04-11,20,20,19,1,1237,1237,1204,33,0,1,1,0,225,225,224,224
Tehama,17,2022-04-11,9,9,9,0,753,753,724,29,1,0,0,0,207,207,207,207
Trinity,17,2022-04-11,0,0,0,0,77,77,74,3,0,0,0,0,20,20,20,20
Tulare,17,2022-04-11,58,58,56,2,7840,7845,7528,317,11,3,3,0,1493,1493,1490,1490
Tuolumne,17,2022-04-11,22,22,21,1,1062,1062,1027,35,1,0,0,0,183,183,183,183
Ventura,17,2022-04-11,323,323,317,6,17587,17599,17286,313,16,2,2,2,1502,1502,1500,1500
Yolo,17,2022-04-11,130,130,127,3,18076,18088,17668,420,1,0,0,0,361,361,361,361
Yuba,17,2022-04-11,15,15,15,0,1019,1019,994,25,2,0,0,0,119,119,119,119
Alameda,18,2022-04-18,1779,1779,1750,29,54177,54213,53331,882,42,4,4,4,1878,1878,1874,1874
Amador,18,2022-04-18,12,12,12,0,1194,1194,1162,32,2,0,0,0,86,86,86,86
Butte,18,2022-04-18,47,47,46,1,2268,2268,2238,30,5,2,2,0,431,431,429,429
Calaveras,18,2022-04-18,16,16,16,0,579,579,566,13,0,1,1,0,120,120,119,119
Colusa,18,2022-04-18,3,3,3,0,157,157,154,3,0,0,0,0,21,21,21,21
Contra Costa,18,2022-04-18,1050,1050,1022,28,24754,24772,24102,670,26,1,1,5,1302,1302,1301,1301
Del Norte,18,2022-04-18,13,13,13,0,1010,1010,989,21,0,0,0,0,49,49,49,49
El Dorado,18,2022-04-18,66,66,65,1,2455,2455,2400,55,0,0,0,0,214,214,214,214
Fresno,18,2022-04-18,247,247,241,6,13938,13948,13595,353,42,4,4,5,2764,2764,2760,2760
Glenn,18,2022-04-18,4,4,4,0,278,278,272,6,0,0,0,0,53,53,53,53
Humboldt,18,2022-04-18,107,107,105,2,2052,2052,2009,43,4,1,1,2,147,147,146,146
Imperial,18,2022-04-18,49,49,48,1,3219,3219,3145,74,2,0,0,1,945,945,945,945
Inyo,18,2022-04-18,2,2,2,0,164,164,161,3,0,0,0,0,56,56,56,56
Kern,18,2022-04-18,150,150,147,3,13634,13643,13386,257,9,1,1,5,2344,2344,2343,2343
Kings,18,2022-04-18,44,44,43,1,3580,3581,3499,82,3,1,1,1,449,449,448,448
Lake,18,2022-04-18,16,16,16,0,782,782,762,20,2,1,1,1,140,140,139,139
Lassen,18,2022-04-18,1,1,1,0,1340,1340,1316,24,0,0,0,0,62,62,62,62
Los Angeles,18,2022-04-18,8316,8323,8270,53,469197,469525,466552,2973,200,35,35,26,31877,31877,31842,31842
Madera,18,2022-04-18,23,23,22,1,2521,2521,2456,65,2,0,0,2,370,370,370,370
Marin,18,2022-04-18,322,322,314,8,5992,5997,5846,151,6,0,0,0,295,295,295,295
Mariposa,18,2022-04-18,18,18,18,0,248,248,241,7,0,0,0,0,28,28,28,28
Mendocino,18,2022-04-18,53,53,51,2,1285,1285,1241,44,0,1,1,0,125,125,124,124
Merced,18,2022-04-18,65,65,64,1,3047,3047,2987,60,3,2,2,0,822,822,820,820
Modoc,18,2022-04-18,1,1,1,0,40,40,39,1,0,0,0,0,7,7,7,7
Mono,18,2022-04-18,9,9,9,0,122,122,117,5,0,0,0,0,6,6,6,6
Monterey,18,2022-04-18,157,157,151,6,6522,6527,6268,259,2,1,1,0,731,731,730,730
Napa,18,2022-04-18,164,164,161,3,2860,2860,2811,49,1,0,0,0,143,143,143,143
Nevada,18,2022-04-18,41,41,40,1,1260,1260,1228,32,1,0,0,0,131,131,131,131
Orange,18,2022-04-18,1443,1443,1422,21,79760,79815,78606,1209,50,5,5,10,7112,7112,7107,7107
Placer,18,2022-04-18,161,161,157,4,4800,4803,4671,132,30,0,0,3,627,627,627,627
Plumas,18,2022-04-18,6,6,6,0,225,225,219,6,0,0,0,0,13,13,13,13
Riverside,18,2022-04-18,937,937,918,19,36721,36747,36006,741,36,7,7,7,6459,6459,6452,6452
Sacramento,18,2022-04-18,715,715,700,15,27855,27874,27273,601,47,9,9,8,3064,3064,3055,3055
San Benito,18,2022-04-18,24,24,24,0,1170,1170,1149,21,0,0,0,0,94,94,94,94
San Bernardino,18,2022-04-18,1058,1058,1041,17,40085,40113,39459,654,35,7,7,8,7816,7816,7809,7809
San Diego,18,2022-04-18,2046,2046,2032,14,67089,67134,66675,459,78,9,9,17,5348,5348,5339,5339
San Francisco,18,2022-04-18,1440,1440,1378,62,30566,30587,29249,1338,27,2,2,2,874,874,872,872
San Joaquin,18,2022-04-18,248,248,242,6,14745,14755,14404,351,8,1,1,4,2249,2249,2248,2248
San Luis Obispo,18,2022-04-18,180,180,177,3,4959,4963,4871,92,2,2,2,0,481,481,479,479
San Mateo,18,2022-04-18,1153,1153,1136,17,30636,30658,30194,464,15,2,2,2,707,707,705,705
Santa Barbara,18,2022-04-18,299,299,293,6,14686,14696,14390,306,8,0,0,0,691,691,691,691
Santa Clara,18,2022-04-18,2238,2238,2222,16,71271,71320,70799,521,67,4,4,16,2306,2306,2302,2302
Santa Cruz,18,2022-04-18,438,438,430,8,12234,12243,12028,215,3,0,0,1,260,260,260,260
Shasta,18,2022-04-18,32,32,31,1,2849,2850,2788,62,2,1,1,2,561,561,560,560
Siskiyou,18,2022-04-18,8,8,8,0,318,318,312,6,0,0,0,0,83,83,83,83
Solano,18,2022-04-18,254,254,249,5,9338,9345,9156,189,6,1,1,1,450,450,449,449
Sonoma,18,2022-04-18,502,502,492,10,11184,11191,10968,223,16,1,1,4,492,492,491,491
Stanislaus,18,2022-04-18,161,161,156,5,7667,7672,7433,239,15,0,0,3,1691,1691,1691,1691
Sutter,18,2022-04-18,24,24,24,0,1173,1173,1149,24,0,0,0,0,225,225,225,225
Tehama,18,2022-04-18,7,7,7,0,685,685,664,21,1,0,0,0,207,207,207,207
Trinity,18,2022-04-18,1,1,1,0,72,72,70,2,0,0,0,0,20,20,20,20
Tulare,18,2022-04-18,77,77,75,2,6660,6665,6454,211,13,0,0,0,1493,1493,1493,1493
Tuolumne,18,2022-04-18,26,26,25,1,1025,1025,999,26,1,0,0,0,183,183,183,183
Ventura,18,2022-04-18,367,367,362,5,16412,16423,16195,228,8,3,3,0,1505,1505,1502,1502
Yolo,18,2022-04-18,217,217,213,4,17918,17930,17601,329,2,1,1,0,362,362,361,361
Yuba,18,2022-04-18,28,28,27,1,996,996,977,19,1,0,0,1,119,119,119,119
Alameda,19,2022-04-25,2541,2541,2509,32,60892,60938,60170,768,44,6,6,4,1884,1884,1878,1878
Amador,19,2022-04-25,26,26,25,1,1316,1316,1289,27,0,0,0,0,86,86,86,86
Butte,19,2022-04-25,66,66,65,1,2597,2598,2571,27,5,1,1,1,432,432,431,431
Calaveras,19,2022-04-25,34,34,33,1,688,688,676,12,0,0,0,0,120,120,120,120
Colusa,19,2022-04-25,3,3,3,0,199,199,196,3,0,0,0,0,21,21,21,21
Contra Costa,19,2022-04-25,1508,1508,1476,32,27266,27286,26711,575,25,3,3,3,1305,1305,1302,1302
Del Norte,19,2022-04-25,25,25,25,0,1104,1104,1086,18,0,0,0,0,49,49,49,49
El Dorado,19,2022-04-25,103,103,101,2,2648,2648,2601,47,1,0,0,0,214,214,214,214
Fresno,19,2022-04-25,334,334,327,7,15893,15906,15589,317,34,3,3,2,2767,2767,2764,2764
Glenn,19,2022-04-25,4,4,4,0,287,287,282,5,0,0,0,0,53,53,53,53
Humboldt,19,2022-04-25,168,168,165,3,2853,2854,2807,47,2,0,0,2,147,147,147,147
Imperial,19,2022-04-25,65,65,64,1,3512,3514,3451,63,4,0,0,1,945,945,945,945
Inyo,19,2022-04-25,7,7,7,0,194,194,191,3,0,0,0,0,56,56,56,56
Kern,19,2022-04-25,251,251,247,4,18299,18313,18042,271,14,2,2,4,2346,2346,2344,2344
Kings,19,2022-04-25,54,54,53,1,4515,4519,4438,81,3,0,0,1,449,449,449,449
Lake,19,2022-04-25,21,21,21,0,887,887,869,18,0,0,0,0,140,140,140,140
Lassen,19,2022-04-25,1,1,1,0,1556,1556,1534,22,0,0,0,0,62,62,62,62
Los Angeles,19,2022-04-25,11368,11376,11319,57,884889,885562,881074,4488,207,29,29,25,31906,31906,31877,31877
Madera,19,2022-04-25,44,44,43,1,2916,2916,2857,59,2,0,0,0,370,370,370,370
Marin,19,2022-04-25,329,329,323,6,6440,6445,6319,126,7,0,0,0,295,295,295,295
Mariposa,19,2022-04-25,9,9,9,0,205,205,201,4,0,0,0,0,28,28,28,28
Mendocino,19,2022-04-25,55,55,54,1,1254,1254,1220,34,0,1,1,0,126,126,125,125
Merced,19,2022-04-25,99,99,98,1,3030,3031,2985,46,5,0,0,0,822,822,822,822
Modoc,19,2022-04-25,1,1,1,0,41,41,40,1,0,0,0,0,7,7,7,7
Mono,19,2022-04-25,4,4,4,0,94,94,91,3,0,0,0,0,6,6,6,6
Monterey,19,2022-04-25,322,322,312,10,8006,8012,7762,250,5,1,1,0,732,732,731,731
Napa,19,2022-04-25,199,199,196,3,3376,3377,3331,46,2,0,0,0,143,143,143,143
Nevada,19,2022-04-25,52,52,51,1,1399,1399,1371,28,1,0,0,1,131,131,131,131
Orange,19,2022-04-25,1969,1969,1946,23,86609,86675,85652,1023,53,7,7,13,7119,7119,7112,7112
Placer,19,2022-04-25,238,238,233,5,6091,6096,5964,132,18,0,0,4,627,627,627,627
Plumas,19,2022-04-25,2,2,2,0,228,228,223,5,0,0,0,0,13,13,13,13
Riverside,19,2022-04-25,1304,1304,1284,20,40534,40565,39925,640,33,4,4,5,6463,6463,6459,6459
Sacramento,19,2022-04-25,1023,1023,1006,17,31868,31892,31352,540,44,4,4,4,3068,3068,3064,3064
San Benito,19,2022-04-25,34,34,34,0,1118,1118,1102,16,0,0,0,0,94,94,94,94
San Bernardino,19,2022-04-25,1294,1294,1278,16,42974,43007,42459,548,21,10,10,7,7826,7826,7816,7816
San Diego,19,2022-04-25,3011,3012,2996,16,74322,74380,73984,396,86,5,5,10,5353,5353,5348,5348
San Francisco,19,2022-04-25,2001,2001,1933,68,32532,32557,31440,1117,23,1,1,3,875,875,874,874
San Joaquin,19,2022-04-25,387,387,380,7,15482,15495,15206,289,12,0,0,1,2249,2249,2249,2249
San Luis Obispo,19,2022-04-25,209,209,206,3,5036,5041,4968,73,6,0,0,0,481,481,481,481
San Mateo,19,2022-04-25,1538,1538,1520,18,32870,32895,32506,389,14,1,1,3,708,708,707,707
Santa Barbara,19,2022-04-25,371,371,365,6,15227,15239,14992,247,7,2,2,1,693,693,691,691
Santa Clara,19,2022-04-25,3142,3143,3125,18,77133,77191,76757,434,73,4,4,9,2310,2310,2306,2306
Santa Cruz,19,2022-04-25,474,474,468,6,20467,20481,20199,282,4,1,1,0,261,261,260,260
Shasta,19,2022-04-25,48,48,47,1,3317,3318,3262,56,3,0,0,1,561,561,561,561
Siskiyou,19,2022-04-25,7,7,7,0,322,322,318,4,0,0,0,0,83,83,83,83
Solano,19,2022-04-25,479,479,471,8,10655,10662,10493,169,11,0,0,2,450,450,450,450
Sonoma,19,2022-04-25,674,674,664,10,12065,12073,11885,188,19,0,0,2,492,492,492,492
Stanislaus,19,2022-04-25,241,241,235,6,7899,7906,7714,192,25,3,3,0,1694,1694,1691,1691
Sutter,19,2022-04-25,39,39,38,1,1399,1399,1376,23,0,1,1,0,226,226,225,225
Tehama,19,2022-04-25,17,17,17,0,711,711,694,17,1,0,0,0,207,207,207,207
Trinity,19,2022-04-25,1,1,1,0,72,72,70,2,0,0,0,0,20,20,20,20
Tulare,19,2022-04-25,91,91,89,2,6913,6918,6746,172,11,1,1,0,1494,1494,1493,1493
Tuolumne,19,2022-04-25,43,43,42,1,1124,1124,1101,23,2,0,0,0,183,183,183,183
Ventura,19,2022-04-25,605,605,598,7,18901,18914,18709,205,10,1,1,3,1506,1506,1505,1505
Yolo,19,2022-04-25,272,272,268,4,19382,19398,19120,278,1,0,0,0,362,362,362,362
Yuba,19,2022-04-25,31,31,31,0,1106,1106,1089,17,0,0,0,0,119,119,119,119
Alameda,20,2022-05-02,3377,3378,3345,33,68023,68079,67402,677,42,2,2,5,1886,1886,1884,1884
Amador,20,2022-05-02,19,19,19,0,1335,1335,1313,22,0,0,0,0,86,86,86,86
Butte,20,2022-05-02,91,91,90,1,2385,2386,2367,19,4,2,2,0,434,434,432,432
Calaveras,20,2022-05-02,23,23,23,0,727,727,717,10,0,0,0,0,120,120,120,120
Colusa,20,2022-05-02,2,2,2,0,203,203,201,2,0,0,0,0,21,21,21,21
Contra Costa,20,2022-05-02,1881,1881,1850,31,29265,29292,28808,484,40,2,2,5,1307,1307,1305,1305
Del Norte,20,2022-05-02,40,40,39,1,1202,1202,1187,15,1,0,0,0,49,49,49,49
El Dorado,20,2022-05-02,140,140,138,2,2756,2757,2719,38,1,1,1,0,215,215,214,214
Fresno,20,2022-05-02,503,503,495,8,16710,16724,16463,261,42,3,3,4,2770,2770,2767,2767
Glenn,20,2022-05-02,4,4,4,0,252,252,249,3,0,0,0,0,53,53,53,53
Humboldt,20,2022-05-02,269,269,266,3,2941,2942,2904,38,6,0,0,2,147,147,147,147
Imperial,20,2022-05-02,123,123,121,2,3645,3647,3595,52,1,0,0,1,945,945,945,945
Inyo,20,2022-05-02,2,2,2,0,179,179,177,2,0,0,0,0,56,56,56,56
Kern,20,2022-05-02,293,293,290,3,17932,17947,17739,208,10,0,0,5,2346,2346,2346,2346
Kings,20,2022-05-02,58,58,57,1,4847,4852,4784,68,3,0,0,1,449,449,449,449
Lake,20,2022-05-02,29,29,29,0,1003,1003,987,16,1,0,0,0,140,140,140,140
Lassen,20,2022-05-02,8,8,8,0,1608,1608,1590,18,0,0,0,0,62,62,62,62
Los Angeles,20,2022-05-02,14804,14817,14759,58,917589,918362,914717,3645,214,23,23,22,31929,31929,31906,31906
Madera,20,2022-05-02,75,75,74,1,3307,3308,3256,52,5,0,0,0,370,370,370,370
Marin,20,2022-05-02,427,427,421,6,6544,6549,6449,100,10,0,0,0,295,295,295,295
Mariposa,20,2022-05-02,7,7,7,0,244,244,240,4,0,0,0,0,28,28,28,28
Mendocino,20,2022-05-02,60,60,59,1,1222,1222,1196,26,0,0,0,0,126,126,126,126
Merced,20,2022-05-02,130,130,128,2,3283,3285,3246,39,8,4,4,0,826,826,822,822
Modoc,20,2022-05-02,0,0,0,0,36,37,36,1,0,0,0,0,7,7,7,7
Mono,20,2022-05-02,6,6,6,0,106,106,103,3,0,0,0,0,6,6,6,6
Monterey,20,2022-05-02,356,356,347,9,8386,8392,8186,206,8,1,1,0,733,733,732,732
Napa,20,2022-05-02,228,228,226,2,3547,3550,3512,38,4,0,0,0,143,143,143,143
Nevada,20,2022-05-02,80,80,79,1,1535,1535,1511,24,2,0,0,0,131,131,131,131
Orange,20,2022-05-02,2639,2639,2615,24,87486,87559,86750,809,61,5,5,13,7124,7124,7119,7119
Placer,20,2022-05-02,306,306,301,5,6373,6378,6270,108,20,0,0,4,627,627,627,627
Plumas,20,2022-05-02,9,9,9,0,256,256,252,4,0,0,0,0,13,13,13,13
Riverside,20,2022-05-02,2050,2050,2025,25,42958,42994,42464,530,37,3,3,5,6466,6466,6463,6463
Sacramento,20,2022-05-02,1392,1392,1374,18,33656,33683,33239,444,43,5,5,9,3073,3073,3068,3068
San Benito,20,2022-05-02,50,50,49,1,1285,1285,1271,14,0,0,0,0,94,94,94,94
San Bernardino,20,2022-05-02,1489,1489,1474,15,43533,43570,43136,434,30,7,7,6,7833,7833,7826,7826
San Diego,20,2022-05-02,4120,4123,4106,17,72928,72992,72690,302,79,3,3,13,5356,5356,5353,5353
San Francisco,20,2022-05-02,2424,2424,2359,65,35539,35570,34610,960,39,3,3,13,878,878,875,875
San Joaquin,20,2022-05-02,547,547,539,8,15216,15230,15008,222,14,1,1,1,2250,2250,2249,2249
San Luis Obispo,20,2022-05-02,249,249,246,3,5109,5114,5056,58,5,2,2,0,483,483,481,481
San Mateo,20,2022-05-02,1820,1820,1803,17,35990,36020,35686,334,22,2,2,5,710,710,708,708
Santa Barbara,20,2022-05-02,440,440,435,5,15309,15323,15128,195,10,0,0,2,693,693,693,693
Santa Clara,20,2022-05-02,4358,4361,4342,19,96570,96651,96222,429,88,5,5,15,2315,2315,2310,2310
Santa Cruz,20,2022-05-02,678,678,671,7,22027,22046,21808,238,2,1,1,0,262,262,261,261
Shasta,20,2022-05-02,68,68,67,1,3451,3454,3408,46,7,0,0,1,561,561,561,561
Siskiyou,20,2022-05-02,9,9,9,0,329,329,326,3,0,0,0,0,83,83,83,83
Solano,20,2022-05-02,624,624,616,8,11789,11799,11653,146,20,0,0,2,450,450,450,450
Sonoma,20,2022-05-02,898,898,887,11,12794,12805,12650,155,16,1,1,4,493,493,492,492
Stanislaus,20,2022-05-02,269,269,264,5,8083,8090,7936,154,22,0,0,3,1694,1694,1694,1694
Sutter,20,2022-05-02,47,47,46,1,1263,1263,1247,16,0,1,1,0,227,227,226,226
Tehama,20,2022-05-02,17,17,17,0,700,700,687,13,0,0,0,0,207,207,207,207
Trinity,20,2022-05-02,1,1,1,0,84,84,82,2,0,0,0,0,20,20,20,20
Tulare,20,2022-05-02,164,164,161,3,7286,7292,7150,142,10,3,3,0,1497,1497,1494,1494
Tuolumne,20,2022-05-02,93,93,92,1,1297,1297,1277,20,5,0,0,0,183,183,183,183
Ventura,20,2022-05-02,744,744,738,6,19920,19937,19768,169,15,4,4,1,1510,1510,1506,1506
Yolo,20,2022-05-02,352,352,348,4,18791,18808,18597,211,1,1,1,0,363,363,362,362
Yuba,20,2022-05-02,46,46,45,1,1052,1052,1040,12,2,0,0,1,119,119,119,119
Alameda,21,2022-05-09,4152,4157,4125,32,71485,71553,70999,554,44,7,7,6,1893,1893,1886,1886
Amador,21,2022-05-09,25,25,25,0,1518,1518,1499,19,0,0,0,0,86,86,86,86
Butte,21,2022-05-09,115,115,114,1,2412,2413,2398,15,5,0,0,0,434,434,434,434
Calaveras,21,2022-05-09,33,33,33,0,689,689,681,8,1,0,0,0,120,120,120,120
Colusa,21,2022-05-09,3,3,3,0,215,215,213,2,0,0,0,0,21,21,21,21
Contra Costa,21,2022-05-09,2515,2516,2484,32,30523,30552,30157,395,48,4,4,12,1311,1311,1307,1307
Del Norte,21,2022-05-09,49,49,49,0,1358,1358,1344,14,0,0,0,0,49,49,49,49
El Dorado,21,2022-05-09,179,179,177,2,2889,2890,2859,31,3,0,0,1,215,215,215,215
Fresno,21,2022-05-09,745,745,736,9,17853,17870,17652,218,29,1,1,1,2771,2771,2770,2770
Glenn,21,2022-05-09,8,8,8,0,228,228,226,2,0,0,0,0,53,53,53,53
Humboldt,21,2022-05-09,273,273,270,3,3149,3153,3121,32,5,0,0,2,147,147,147,147
Imperial,21,2022-05-09,131,131,130,1,3827,3831,3789,42,0,0,0,1,945,945,945,945
Inyo,21,2022-05-09,26,26,26,0,236,236,234,2,0,0,0,0,56,56,56,56
Kern,21,2022-05-09,467,467,463,4,18698,18716,18547,169,18,2,2,2,2348,2348,2346,2346
Kings,21,2022-05-09,91,91,90,1,4936,4941,4887,54,1,0,0,1,449,449,449,449
Lake,21,2022-05-09,30,30,30,0,1029,1029,1016,13,1,0,0,0,140,140,140,140
Lassen,21,2022-05-09,6,6,6,0,1689,1689,1675,14,0,0,0,0,62,62,62,62
Los Angeles,21,2022-05-09,18425,18444,18388,56,926866,927749,924882,2867,225,29,29,27,31958,31958,31929,31929
Madera,21,2022-05-09,132,132,130,2,3725,3729,3683,46,3,0,0,0,370,370,370,370
Marin,21,2022-05-09,711,711,703,8,7781,7788,7695,93,12,0,0,0,295,295,295,295
Mariposa,21,2022-05-09,32,32,32,0,287,287,283,4,0,0,0,0,28,28,28,28
Mendocino,21,2022-05-09,92,92,91,1,1264,1264,1243,21,0,1,1,0,127,127,126,126
Merced,21,2022-05-09,198,198,196,2,3431,3435,3403,32,4,1,1,0,827,827,826,826
Modoc,21,2022-05-09,2,2,2,0,41,42,41,1,0,0,0,0,7,7,7,7
Mono,21,2022-05-09,9,9,9,0,113,113,111,2,0,0,0,0,6,6,6,6
Monterey,21,2022-05-09,440,440,432,8,9377,9384,9203,181,11,0,0,0,733,733,733,733
Napa,21,2022-05-09,233,233,231,2,3121,3124,3098,26,2,0,0,0,143,143,143,143
Nevada,21,2022-05-09,102,102,101,1,1655,1655,1635,20,5,0,0,0,131,131,131,131
Orange,21,2022-05-09,3516,3518,3493,25,91769,91856,91193,663,84,8,8,17,7132,7132,7124,7124
Placer,21,2022-05-09,537,537,530,7,6752,6758,6668,90,25,0,0,2,627,627,627,627
Plumas,21,2022-05-09,13,13,13,0,274,274,271,3,0,0,0,0,13,13,13,13
Riverside,21,2022-05-09,2402,2402,2379,23,45141,45185,44749,436,42,4,4,8,6470,6470,6466,6466
Sacramento,21,2022-05-09,2256,2257,2234,23,36120,36155,35781,374,62,4,4,10,3077,3077,3073,3073
San Benito,21,2022-05-09,74,74,73,1,1433,1433,1421,12,0,0,0,0,94,94,94,94
San Bernardino,21,2022-05-09,1934,1934,1919,15,46592,46636,46273,363,31,5,5,4,7838,7838,7833,7833
San Diego,21,2022-05-09,5217,5222,5205,17,87126,87209,86925,284,98,2,2,11,5358,5358,5356,5356
San Francisco,21,2022-05-09,3049,3050,2986,64,38186,38222,37413,809,52,6,6,9,884,884,878,878
San Joaquin,21,2022-05-09,773,773,764,9,16059,16075,15892,183,11,1,1,3,2251,2251,2250,2250
San Luis Obispo,21,2022-05-09,289,289,286,3,5221,5226,5180,46,0,0,0,0,483,483,483,483
San Mateo,21,2022-05-09,2315,2315,2299,16,37695,37730,37457,273,26,3,3,1,713,713,710,710
Santa Barbara,21,2022-05-09,638,638,632,6,15589,15605,15450,155,10,0,0,3,693,693,693,693
Santa Clara,21,2022-05-09,5623,5630,5611,19,106179,106280,105912,368,87,3,3,23,2318,2318,2315,2315
Santa Cruz,21,2022-05-09,729,729,723,6,23980,24003,23801,202,2,0,0,0,262,262,262,262
Shasta,21,2022-05-09,106,106,105,1,3301,3304,3270,34,7,0,0,0,561,561,561,561
Siskiyou,21,2022-05-09,16,16,16,0,285,285,283,2,0,0,0,0,83,83,83,83
Solano,21,2022-05-09,920,920,911,9,12322,12334,12214,120,20,0,0,1,450,450,450,450
Sonoma,21,2022-05-09,1181,1181,1170,11,13977,13991,13858,133,18,1,1,2,494,494,493,493
Stanislaus,21,2022-05-09,461,461,454,7,8942,8950,8816,134,27,0,0,2,1694,1694,1694,1694
Sutter,21,2022-05-09,61,61,60,1,1565,1565,1549,16,0,0,0,0,227,227,227,227
Tehama,21,2022-05-09,28,28,28,0,692,692,682,10,1,0,0,0,207,207,207,207
Trinity,21,2022-05-09,4,4,4,0,69,69,68,1,0,0,0,0,20,20,20,20
Tulare,21,2022-05-09,183,183,180,3,7633,7639,7523,116,11,1,1,1,1498,1498,1497,1497
Tuolumne,21,2022-05-09,71,71,70,1,1429,1429,1412,17,1,2,2,0,185,185,183,183
Ventura,21,2022-05-09,1151,1151,1143,8,20949,20968,20829,139,15,1,1,2,1511,1511,1510,1510
Yolo,21,2022-05-09,493,493,489,4,19657,19676,19503,173,1,0,0,1,363,363,363,363
Yuba,21,2022-05-09,77,77,76,1,1241,1241,1229,12,2,0,0,0,119,119,119,119
Alameda,22,2022-05-16,4995,5001,4971,30,75024,75102,74647,455,73,8,8,6,1901,1901,1893,1893
Amador,22,2022-05-16,54,54,53,1,1672,1672,1655,17,0,0,0,0,86,86,86,86
Butte,22,2022-05-16,207,207,206,1,2664,2665,2652,13,7,2,2,0,436,436,434,434
Calaveras,22,2022-05-16,43,43,43,0,765,765,758,7,0,1,1,1,121,121,120,120
Colusa,22,2022-05-16,7,7,7,0,217,217,215,2,0,0,0,0,21,21,21,21
Contra Costa,22,2022-05-16,3488,3491,3456,35,33517,33553,33214,339,50,5,5,7,1316,1316,1311,1311
Del Norte,22,2022-05-16,174,174,173,1,1859,1860,1845,15,0,0,0,0,49,49,49,49
El Dorado,22,2022-05-16,266,266,264,2,3039,3043,3017,26,5,0,0,1,215,215,215,215
Fresno,22,2022-05-16,1140,1140,1129,11,19033,19052,18871,181,46,2,2,6,2773,2773,2771,2771
Glenn,22,2022-05-16,15,15,15,0,259,259,257,2,0,0,0,0,53,53,53,53
Humboldt,22,2022-05-16,275,275,273,2,3253,3257,3231,26,9,1,1,2,148,148,147,147
Imperial,22,2022-05-16,207,207,205,2,4276,4281,4244,37,1,0,0,1,945,945,945,945
Inyo,22,2022-05-16,19,19,19,0,228,228,226,2,1,0,0,0,56,56,56,56
Kern,22,2022-05-16,687,687,682,5,19978,19999,19858,141,22,3,3,3,2351,2351,2348,2348
Kings,22,2022-05-16,220,220,218,2,5418,5423,5377,46,0,1,1,0,450,450,449,449
Lake,22,2022-05-16,75,75,74,1,1118,1118,1107,11,2,0,0,0,140,140,140,140
Lassen,22,2022-05-16,21,21,21,0,1704,1704,1693,11,1,0,0,0,62,62,62,62
Los Angeles,22,2022-05-16,21418,21439,21388,51,938057,939036,936773,2263,283,39,39,44,31997,31997,31958,31958
Madera,22,2022-05-16,199,199,197,2,3632,3636,3601,35,2,0,0,0,370,370,370,370
Marin,22,2022-05-16,815,815,807,8,8391,8400,8321,79,12,0,0,0,295,295,295,295
Mariposa,22,2022-05-16,23,23,23,0,340,340,336,4,0,0,0,0,28,28,28,28
Mendocino,22,2022-05-16,99,99,98,1,1326,1326,1309,17,0,1,1,1,128,128,127,127
Merced,22,2022-05-16,314,314,312,2,4010,4015,3986,29,8,1,1,1,828,828,827,827
Modoc,22,2022-05-16,4,4,4,0,43,44,43,1,0,0,0,0,7,7,7,7
Mono,22,2022-05-16,11,11,11,0,112,112,110,2,0,0,0,0,6,6,6,6
Monterey,22,2022-05-16,509,509,501,8,9600,9611,9466,145,6,1,1,0,734,734,733,733
Napa,22,2022-05-16,299,299,297,2,3740,3745,3721,24,3,0,0,0,143,143,143,143
Nevada,22,2022-05-16,146,146,145,1,1834,1834,1817,17,2,0,0,0,131,131,131,131
Orange,22,2022-05-16,4548,4553,4528,25,94642,94741,94208,533,74,7,7,15,7139,7139,7132,7132
Placer,22,2022-05-16,742,742,734,8,7777,7784,7703,81,43,2,2,3,629,629,627,627
Plumas,22,2022-05-16,48,48,48,0,242,242,240,2,1,0,0,0,13,13,13,13
Riverside,22,2022-05-16,3344,3346,3321,25,47984,48034,47673,361,65,1,1,6,6471,6471,6470,6470
Sacramento,22,2022-05-16,3137,3139,3114,25,39840,39881,39559,322,89,8,8,12,3085,3085,3077,3077
San Benito,22,2022-05-16,110,110,109,1,1529,1529,1519,10,1,0,0,0,94,94,94,94
San Bernardino,22,2022-05-16,2471,2472,2457,15,49169,49221,48922,299,44,8,8,5,7846,7846,7838,7838
San Diego,22,2022-05-16,6664,6672,6655,17,94782,94881,94641,240,91,6,6,25,5364,5364,5358,5358
San Francisco,22,2022-05-16,3413,3417,3361,56,39359,39399,38746,653,68,5,5,8,889,889,884,884
San Joaquin,22,2022-05-16,1201,1201,1190,11,19015,19036,18867,169,16,1,1,1,2252,2252,2251,2251
San Luis Obispo,22,2022-05-16,425,425,422,3,6056,6062,6020,42,3,0,0,0,483,483,483,483
San Mateo,22,2022-05-16,2776,2777,2762,15,39916,39958,39733,225,39,1,1,1,714,714,713,713
Santa Barbara,22,2022-05-16,912,912,905,7,17041,17059,16927,132,13,0,0,2,693,693,693,693
Santa Clara,22,2022-05-16,7204,7212,7193,19,113212,113331,113025,306,111,9,9,15,2327,2327,2318,2318
Santa Cruz,22,2022-05-16,808,808,803,5,20748,20769,20629,140,5,0,0,0,262,262,262,262
Shasta,22,2022-05-16,126,126,125,1,3812,3816,3785,31,6,0,0,1,561,561,561,561
Siskiyou,22,2022-05-16,19,19,19,0,372,372,370,2,0,0,0,0,83,83,83,83
Solano,22,2022-05-16,1279,1279,1269,10,14209,14225,14117,108,29,0,0,2,450,450,450,450
Sonoma,22,2022-05-16,1570,1570,1559,11,15543,15559,15444,115,28,0,0,4,494,494,494,494
Stanislaus,22,2022-05-16,749,749,740,9,9951,9961,9845,116,33,2,2,5,1696,1696,1694,1694
Sutter,22,2022-05-16,109,109,108,1,1828,1828,1814,14,0,0,0,0,227,227,227,227
Tehama,22,2022-05-16,38,38,38,0,840,840,831,9,0,1,1,1,208,208,207,207
Trinity,22,2022-05-16,5,5,5,0,69,69,68,1,0,0,0,0,20,20,20,20
Tulare,22,2022-05-16,397,397,392,5,8314,8321,8222,99,14,1,1,0,1499,1499,1498,1498
Tuolumne,22,2022-05-16,139,139,138,1,1448,1448,1434,14,1,1,1,0,186,186,185,185
Ventura,22,2022-05-16,1552,1552,1544,8,23859,23884,23760,124,34,2,2,2,1513,1513,1511,1511
Yolo,22,2022-05-16,688,688,683,5,22152,22175,22023,152,0,0,0,1,363,363,363,363
Yuba,22,2022-05-16,119,119,118,1,1335,1335,1325,10,4,0,0,0,119,119,119,119
Alameda,23,2022-05-23,5608,5615,5589,26,77852,77939,77571,368,76,4,4,4,1905,1905,1901,1901
Amador,23,2022-05-23,80,80,79,1,1441,1441,1430,11,0,0,0,0,86,86,86,86
Butte,23,2022-05-23,284,284,283,1,2768,2771,2760,11,5,1,1,1,437,437,436,436
Calaveras,23,2022-05-23,52,52,52,0,744,744,739,5,0,1,1,0,122,122,121,121
Colusa,23,2022-05-23,7,7,7,0,232,232,231,1,0,0,0,0,21,21,21,21
Contra Costa,23,2022-05-23,3833,3838,3808,30,35373,35411,35131,280,71,10,10,7,1326,1326,1316,1316
Del Norte,23,2022-05-23,67,67,67,0,1346,1346,1338,8,0,1,1,0,50,50,49,49
El Dorado,23,2022-05-23,359,359,357,2,3419,3424,3401,23,6,2,2,0,217,217,215,215
Fresno,23,2022-05-23,1646,1646,1634,12,21382,21405,21246,159,63,2,2,8,2775,2775,2773,2773
Glenn,23,2022-05-23,26,26,26,0,273,273,271,2,0,0,0,0,53,53,53,53
Humboldt,23,2022-05-23,245,245,244,1,2911,2915,2897,18,14,1,1,3,149,149,148,148
Imperial,23,2022-05-23,343,343,341,2,4746,4751,4719,32,2,0,0,1,945,945,945,945
Inyo,23,2022-05-23,27,27,27,0,221,221,220,1,0,0,0,0,56,56,56,56
Kern,23,2022-05-23,1006,1006,1001,5,21275,21298,21181,117,34,0,0,7,2351,2351,2351,2351
Kings,23,2022-05-23,250,250,248,2,5644,5649,5611,38,1,0,0,0,450,450,450,450
Lake,23,2022-05-23,96,96,95,1,1238,1238,1228,10,1,0,0,1,140,140,140,140
Lassen,23,2022-05-23,41,41,41,0,1763,1764,1755,9,0,0,0,0,62,62,62,62
Los Angeles,23,2022-05-23,27744,27776,27724,52,946343,947391,945612,1779,366,31,31,53,32028,32028,31997,31997
Madera,23,2022-05-23,215,215,213,2,3764,3769,3740,29,1,0,0,2,370,370,370,370
Marin,23,2022-05-23,798,798,792,6,8785,8796,8732,64,15,0,0,1,295,295,295,295
Mariposa,23,2022-05-23,32,32,32,0,340,340,337,3,0,0,0,0,28,28,28,28
Mendocino,23,2022-05-23,150,150,149,1,1659,1659,1642,17,3,1,1,1,129,129,128,128
Merced,23,2022-05-23,409,409,407,2,4201,4206,4182,24,4,0,0,0,828,828,828,828
Modoc,23,2022-05-23,2,2,2,0,40,41,40,1,0,0,0,0,7,7,7,7
Mono,23,2022-05-23,14,14,14,0,163,163,161,2,0,0,0,0,6,6,6,6
Monterey,23,2022-05-23,702,702,694,8,9613,9625,9512,113,17,1,1,1,735,735,734,734
Napa,23,2022-05-23,332,332,330,2,3938,3943,3923,20,5,0,0,0,143,143,143,143
Nevada,23,2022-05-23,150,150,149,1,1904,1905,1891,14,2,0,0,0,131,131,131,131
Orange,23,2022-05-23,5576,5583,5559,24,94776,94880,94463,417,111,11,11,20,7150,7150,7139,7139
Placer,23,2022-05-23,887,887,880,7,7834,7841,7777,64,49,2,2,4,631,631,629,629
Plumas,23,2022-05-23,46,46,46,0,279,279,277,2,0,0,0,0,13,13,13,13
Riverside,23,2022-05-23,4453,4460,4434,26,52422,52480,52172,308,73,6,6,10,6477,6477,6471,6471
Sacramento,23,2022-05-23,3892,3897,3873,24,41039,41084,40824,260,122,7,7,10,3092,3092,3085,3085
San Benito,23,2022-05-23,168,168,167,1,1668,1668,1659,9,0,0,0,0,94,94,94,94
San Bernardino,23,2022-05-23,3325,3330,3314,16,50641,50697,50457,240,53,3,3,10,7849,7849,7846,7846
San Diego,23,2022-05-23,8835,8846,8829,17,103288,103402,103197,205,138,4,4,20,5368,5368,5364,5364
San Francisco,23,2022-05-23,3604,3609,3562,47,41636,41683,41142,541,85,6,6,9,895,895,889,889
San Joaquin,23,2022-05-23,1548,1548,1537,11,20968,20990,20844,146,20,3,3,7,2255,2255,2252,2252
San Luis Obispo,23,2022-05-23,672,672,668,4,7270,7277,7238,39,10,3,3,0,486,486,483,483
San Mateo,23,2022-05-23,3155,3159,3145,14,40826,40872,40692,180,35,0,0,0,714,714,714,714
Santa Barbara,23,2022-05-23,1064,1064,1058,6,17776,17795,17687,108,20,0,0,3,693,693,693,693
Santa Clara,23,2022-05-23,7830,7838,7822,16,111312,111435,111200,235,126,7,7,18,2334,2334,2327,2327
Santa Cruz,23,2022-05-23,505,505,502,3,7816,7824,7784,40,16,0,0,0,262,262,262,262
Shasta,23,2022-05-23,195,195,194,1,3606,3611,3588,23,4,1,1,3,562,562,561,561
Siskiyou,23,2022-05-23,29,29,29,0,364,364,362,2,1,0,0,0,83,83,83,83
Solano,23,2022-05-23,1513,1513,1504,9,14923,14940,14852,88,24,1,1,3,451,451,450,450
Sonoma,23,2022-05-23,1488,1488,1479,9,16334,16352,16257,95,34,2,2,3,496,496,494,494
Stanislaus,23,2022-05-23,872,872,864,8,10700,10714,10616,98,37,2,2,3,1698,1698,1696,1696
Sutter,23,2022-05-23,141,141,140,1,1912,1913,1902,11,0,1,1,0,228,228,227,227
Tehama,23,2022-05-23,50,50,50,0,812,812,805,7,1,0,0,1,208,208,208,208
Trinity,23,2022-05-23,3,3,3,0,90,90,89,1,0,0,0,0,20,20,20,20
Tulare,23,2022-05-23,560,560,555,5,9068,9077,8993,84,26,0,0,0,1499,1499,1499,1499
Tuolumne,23,2022-05-23,136,136,135,1,1576,1576,1564,12,0,1,1,0,187,187,186,186
Ventura,23,2022-05-23,1917,1917,1909,8,24017,24044,23947,97,36,1,1,1,1514,1514,1513,1513
Yolo,23,2022-05-23,731,731,727,4,22659,22683,22561,122,1,1,1,1,364,364,363,363
Yuba,23,2022-05-23,151,151,150,1,1453,1453,1445,8,6,0,0,1,119,119,119,119
Alameda,24,2022-05-30,4910,4916,4898,18,60787,60857,60627,230,95,4,4,7,1909,1909,1905,1905
Amador,24,2022-05-30,89,89,88,1,1191,1191,1184,7,0,1,1,0,87,87,86,86
Butte,24,2022-05-30,276,276,275,1,2709,2713,2705,8,20,0,0,1,437,437,437,437
Calaveras,24,2022-05-30,54,54,54,0,617,617,614,3,0,0,0,0,122,122,122,122
Colusa,24,2022-05-30,13,13,13,0,170,170,169,1,0,0,0,0,21,21,21,21
Contra Costa,24,2022-05-30,3318,3322,3301,21,28988,29023,28840,183,65,7,7,9,1333,1333,1326,1326
Del Norte,24,2022-05-30,36,36,36,0,975,975,970,5,2,1,1,0,51,51,50,50
El Dorado,24,2022-05-30,332,332,330,2,2940,2944,2928,16,6,2,2,2,219,219,217,217
Fresno,24,2022-05-30,1667,1667,1657,10,19525,19548,19432,116,71,6,6,7,2781,2781,2775,2775
Glenn,24,2022-05-30,27,27,27,0,290,290,289,1,2,0,0,0,53,53,53,53
Humboldt,24,2022-05-30,181,181,180,1,2296,2300,2289,11,10,0,0,5,149,149,149,149
Imperial,24,2022-05-30,332,332,330,2,4148,4153,4131,22,2,1,1,2,946,946,945,945
Inyo,24,2022-05-30,18,18,18,0,151,151,150,1,0,0,0,0,56,56,56,56
Kern,24,2022-05-30,1078,1078,1073,5,17986,18006,17927,79,36,0,0,6,2351,2351,2351,2351
Kings,24,2022-05-30,292,292,290,2,4664,4669,4644,25,2,0,0,1,450,450,450,450
Lake,24,2022-05-30,89,89,88,1,994,994,988,6,1,0,0,0,140,140,140,140
Lassen,24,2022-05-30,50,50,50,0,1615,1615,1608,7,1,0,0,0,62,62,62,62
Los Angeles,24,2022-05-30,26042,26072,26033,39,746742,747614,746487,1127,425,47,47,54,32075,32075,32028,32028
Madera,24,2022-05-30,235,235,234,1,3313,3317,3297,20,4,0,0,1,370,370,370,370
Marin,24,2022-05-30,650,650,646,4,7153,7163,7121,42,16,3,3,1,298,298,295,295
Mariposa,24,2022-05-30,39,39,39,0,303,303,301,2,0,0,0,0,28,28,28,28
Mendocino,24,2022-05-30,137,137,136,1,1264,1264,1254,10,4,0,0,1,129,129,129,129
Merced,24,2022-05-30,365,365,363,2,3406,3410,3395,15,6,0,0,2,828,828,828,828
Modoc,24,2022-05-30,4,4,4,0,38,39,38,1,0,0,0,0,7,7,7,7
Mono,24,2022-05-30,6,6,6,0,81,81,80,1,0,0,0,0,6,6,6,6
Monterey,24,2022-05-30,527,527,522,5,7151,7161,7094,67,19,1,1,1,736,736,735,735
Napa,24,2022-05-30,312,312,311,1,3180,3184,3171,13,4,0,0,0,143,143,143,143
Nevada,24,2022-05-30,181,181,180,1,1595,1596,1587,9,3,2,2,1,133,133,131,131
Orange,24,2022-05-30,5598,5605,5586,19,82104,82199,81911,288,122,12,12,18,7162,7162,7150,7150
Placer,24,2022-05-30,738,738,733,5,6133,6141,6101,40,52,0,0,8,631,631,631,631
Plumas,24,2022-05-30,35,35,35,0,200,200,199,1,1,0,0,0,13,13,13,13
Riverside,24,2022-05-30,3868,3872,3854,18,43863,43915,43710,205,82,3,3,10,6480,6480,6477,6477
Sacramento,24,2022-05-30,3841,3846,3827,19,33074,33112,32946,166,130,9,9,20,3101,3101,3092,3092
San Benito,24,2022-05-30,154,154,153,1,1276,1276,1271,5,0,0,0,0,94,94,94,94
San Bernardino,24,2022-05-30,3335,3339,3327,12,42867,42917,42756,161,49,5,5,10,7854,7854,7849,7849
San Diego,24,2022-05-30,8410,8421,8408,13,85853,85954,85819,135,153,10,10,26,5378,5378,5368,5368
San Francisco,24,2022-05-30,3133,3138,3106,32,33425,33465,33121,344,88,11,11,14,906,906,895,895
San Joaquin,24,2022-05-30,1398,1398,1390,8,17018,17038,16944,94,25,2,2,9,2257,2257,2255,2255
San Luis Obispo,24,2022-05-30,656,656,653,3,5437,5443,5420,23,12,1,1,0,487,487,486,486
San Mateo,24,2022-05-30,2753,2756,2746,10,31176,31212,31102,110,33,3,3,2,717,717,714,714
Santa Barbara,24,2022-05-30,1032,1032,1027,5,14449,14466,14396,70,23,2,2,5,695,695,693,693
Santa Clara,24,2022-05-30,7030,7038,7026,12,85313,85413,85270,143,154,10,10,22,2344,2344,2334,2334
Santa Cruz,24,2022-05-30,526,526,524,2,6255,6261,6235,26,7,1,1,1,263,263,262,262
Shasta,24,2022-05-30,133,133,132,1,2838,2841,2827,14,4,3,3,4,565,565,562,562
Siskiyou,24,2022-05-30,53,53,53,0,340,340,339,1,3,0,0,0,83,83,83,83
Solano,24,2022-05-30,1185,1185,1179,6,11566,11580,11525,55,28,0,0,7,451,451,451,451
Sonoma,24,2022-05-30,1201,1201,1196,5,13239,13256,13195,61,38,2,2,5,498,498,496,496
Stanislaus,24,2022-05-30,801,801,795,6,8585,8596,8534,62,55,2,2,3,1700,1700,1698,1698
Sutter,24,2022-05-30,158,158,157,1,1701,1702,1694,8,0,0,0,0,228,228,228,228
Tehama,24,2022-05-30,62,62,62,0,757,757,752,5,2,0,0,0,208,208,208,208
Trinity,24,2022-05-30,8,8,8,0,96,96,95,1,0,0,0,0,20,20,20,20
Tulare,24,2022-05-30,596,596,592,4,7483,7491,7435,56,19,0,0,0,1499,1499,1499,1499
Tuolumne,24,2022-05-30,122,122,121,1,1306,1306,1298,8,3,0,0,0,187,187,187,187
Ventura,24,2022-05-30,1681,1681,1676,5,19545,19569,19506,63,30,1,1,4,1515,1515,1514,1514
Yolo,24,2022-05-30,610,610,607,3,17639,17658,17583,75,4,0,0,1,364,364,364,364
Yuba,24,2022-05-30,144,144,143,1,1276,1276,1270,6,7,0,0,2,119,119,119,119
Alameda,25,2022-06-06,6489,6497,6478,19,73223,73313,73101,212,112,5,5,12,1914,1914,1909,1909
Amador,25,2022-06-06,114,114,113,1,1723,1723,1715,8,1,0,0,1,87,87,87,87
Butte,25,2022-06-06,453,453,452,1,3617,3622,3614,8,24,1,1,1,438,438,437,437
Calaveras,25,2022-06-06,73,73,73,0,737,737,734,3,0,2,2,0,124,124,122,122
Colusa,25,2022-06-06,22,22,22,0,276,276,275,1,3,0,0,0,21,21,21,21
Contra Costa,25,2022-06-06,4236,4241,4221,20,35705,35750,35576,174,107,9,9,7,1342,1342,1333,1333
Del Norte,25,2022-06-06,65,65,65,0,1134,1134,1130,4,2,0,0,0,51,51,51,51
El Dorado,25,2022-06-06,413,413,411,2,3637,3642,3627,15,5,0,0,5,219,219,219,219
Fresno,25,2022-06-06,2451,2453,2442,11,22694,22721,22617,104,94,2,2,6,2783,2783,2781,2781
Glenn,25,2022-06-06,41,41,41,0,325,325,324,1,3,0,0,0,53,53,53,53
Humboldt,25,2022-06-06,261,261,260,1,3054,3059,3048,11,14,1,1,3,150,150,149,149
Imperial,25,2022-06-06,466,466,464,2,4875,4880,4860,20,2,0,0,0,946,946,946,946
Inyo,25,2022-06-06,20,20,20,0,213,213,212,1,1,0,0,0,56,56,56,56
Kern,25,2022-06-06,1611,1611,1606,5,22977,23005,22927,78,35,1,1,6,2352,2352,2351,2351
Kings,25,2022-06-06,397,397,395,2,5504,5510,5487,23,10,0,0,1,450,450,450,450
Lake,25,2022-06-06,136,136,135,1,1180,1180,1174,6,5,0,0,2,140,140,140,140
Lassen,25,2022-06-06,71,71,71,0,2398,2400,2392,8,2,0,0,0,62,62,62,62
Los Angeles,25,2022-06-06,35101,35144,35104,40,1041665,1042936,1041733,1203,496,39,39,61,32114,32114,32075,32075
Madera,25,2022-06-06,353,353,351,2,4126,4131,4112,19,7,0,0,1,370,370,370,370
Marin,25,2022-06-06,740,740,737,3,7650,7660,7626,34,10,2,2,5,300,300,298,298
Mariposa,25,2022-06-06,57,57,57,0,403,403,401,2,0,0,0,0,28,28,28,28
Mendocino,25,2022-06-06,209,209,208,1,1711,1711,1700,11,9,1,1,2,130,130,129,129
Merced,25,2022-06-06,531,531,529,2,4529,4534,4518,16,16,0,0,0,828,828,828,828
Modoc,25,2022-06-06,11,11,11,0,37,38,37,1,0,0,0,0,7,7,7,7
Mono,25,2022-06-06,15,15,15,0,120,120,119,1,0,0,0,0,6,6,6,6
Monterey,25,2022-06-06,1002,1002,995,7,10243,10256,10181,75,17,2,2,1,738,738,736,736
Napa,25,2022-06-06,543,543,541,2,4232,4237,4224,13,8,1,1,0,144,144,143,143
Nevada,25,2022-06-06,246,246,245,1,2149,2152,2142,10,5,0,0,0,133,133,133,133
Orange,25,2022-06-06,7569,7580,7560,20,73558,73647,73450,197,140,12,12,18,7174,7174,7162,7162
Placer,25,2022-06-06,868,868,864,4,7604,7614,7576,38,65,0,0,11,631,631,631,631
Plumas,25,2022-06-06,40,40,40,0,321,321,320,1,0,0,0,0,13,13,13,13
Riverside,25,2022-06-06,5358,5365,5346,19,55968,56038,55837,201,88,6,6,10,6486,6486,6480,6480
Sacramento,25,2022-06-06,4952,4958,4939,19,42460,42512,42347,165,149,14,14,20,3115,3115,3101,3101
San Benito,25,2022-06-06,273,273,272,1,2016,2017,2011,6,0,0,0,1,94,94,94,94
San Bernardino,25,2022-06-06,5130,5137,5122,15,55836,55904,55742,162,77,7,7,14,7861,7861,7854,7854
San Diego,25,2022-06-06,10782,10795,10782,13,100449,100571,100449,122,185,8,8,22,5386,5386,5378,5378
San Francisco,25,2022-06-06,3525,3530,3502,28,38263,38311,38006,305,77,0,0,11,906,906,906,906
San Joaquin,25,2022-06-06,2132,2133,2124,9,22164,22191,22097,94,40,4,4,9,2261,2261,2257,2257
San Luis Obispo,25,2022-06-06,901,901,898,3,7531,7539,7514,25,16,1,1,1,488,488,487,487
San Mateo,25,2022-06-06,3212,3216,3207,9,37066,37111,37010,101,36,2,2,4,719,719,717,717
Santa Barbara,25,2022-06-06,1246,1246,1241,5,15068,15087,15031,56,22,1,1,5,696,696,695,695
Santa Clara,25,2022-06-06,8505,8515,8504,11,102647,102773,102641,132,176,6,6,22,2350,2350,2344,2344
Santa Cruz,25,2022-06-06,896,896,893,3,9720,9731,9701,30,24,1,1,3,264,264,263,263
Shasta,25,2022-06-06,210,210,209,1,4423,4428,4411,17,10,2,2,2,567,567,565,565
Siskiyou,25,2022-06-06,41,41,41,0,431,431,430,1,1,0,0,0,83,83,83,83
Solano,25,2022-06-06,1745,1745,1739,6,15188,15206,15151,55,29,2,2,1,453,453,451,451
Sonoma,25,2022-06-06,1636,1636,1630,6,13998,14015,13966,49,38,1,1,1,499,499,498,498
Stanislaus,25,2022-06-06,1183,1183,1176,7,10914,10927,10866,61,60,1,1,2,1701,1701,1700,1700
Sutter,25,2022-06-06,206,206,205,1,1941,1942,1935,7,0,0,0,0,228,228,228,228
Tehama,25,2022-06-06,83,83,83,0,1051,1051,1045,6,2,0,0,0,208,208,208,208
Trinity,25,2022-06-06,7,7,7,0,110,110,109,1,0,0,0,0,20,20,20,20
Tulare,25,2022-06-06,860,860,855,5,10775,10789,10728,61,24,0,0,0,1499,1499,1499,1499
Tuolumne,25,2022-06-06,124,124,123,1,1723,1724,1716,8,4,0,0,1,187,187,187,187
Ventura,25,2022-06-06,1973,1973,1968,5,24765,24795,24734,61,43,3,3,3,1518,1518,1515,1515
Yolo,25,2022-06-06,827,827,824,3,21441,21468,21398,70,2,1,1,0,365,365,364,364
Yuba,25,2022-06-06,187,187,186,1,1556,1556,1551,5,9,0,0,1,119,119,119,119
Alameda,26,2022-06-13,5084,5091,5080,11,55930,56000,55874,126,106,6,6,18,1920,1920,1914,1914
Amador,26,2022-06-13,132,132,132,0,1413,1413,1408,5,1,0,0,0,87,87,87,87
Butte,26,2022-06-13,394,394,393,1,3459,3464,3458,6,31,4,4,0,442,442,438,438
Calaveras,26,2022-06-13,69,69,69,0,658,658,656,2,0,0,0,0,124,124,124,124
Colusa,26,2022-06-13,12,12,12,0,328,328,327,1,17,0,0,0,21,21,21,21
Contra Costa,26,2022-06-13,3414,3419,3406,13,27984,28018,27912,106,89,8,8,12,1350,1350,1342,1342
Del Norte,26,2022-06-13,79,79,79,0,658,658,656,2,4,0,0,0,51,51,51,51
El Dorado,26,2022-06-13,324,324,323,1,3197,3202,3192,10,7,3,3,1,222,222,219,219
Fresno,26,2022-06-13,2397,2399,2391,8,20697,20724,20651,73,103,4,4,13,2787,2787,2783,2783
Glenn,26,2022-06-13,32,32,32,0,329,329,328,1,2,0,0,0,53,53,53,53
Humboldt,26,2022-06-13,262,262,261,1,2325,2329,2322,7,11,0,0,3,150,150,150,150
Imperial,26,2022-06-13,446,446,445,1,4530,4535,4521,14,6,1,1,0,947,947,946,946
Inyo,26,2022-06-13,13,13,13,0,189,189,188,1,0,0,0,0,56,56,56,56
Kern,26,2022-06-13,1565,1565,1561,4,21421,21448,21392,56,38,1,1,5,2353,2353,2352,2352
Kings,26,2022-06-13,357,357,356,1,5156,5161,5145,16,4,1,1,0,451,451,450,450
Lake,26,2022-06-13,138,138,137,1,1227,1227,1223,4,1,0,0,0,140,140,140,140
Lassen,26,2022-06-13,77,77,77,0,1994,1997,1992,5,2,0,0,0,62,62,62,62
Los Angeles,26,2022-06-13,29985,30023,29996,27,660454,661282,660683,599,519,54,54,60,32168,32168,32114,32114
Madera,26,2022-06-13,381,381,380,1,4230,4235,4220,15,7,0,0,2,370,370,370,370
Marin,26,2022-06-13,688,688,686,2,7040,7049,7024,25,16,2,2,2,302,302,300,300
Mariposa,26,2022-06-13,45,45,45,0,372,372,371,1,0,0,0,0,28,28,28,28
Mendocino,26,2022-06-13,162,162,161,1,1567,1567,1559,8,9,0,0,1,130,130,130,130
Merced,26,2022-06-13,561,561,559,2,4169,4174,4163,11,13,0,0,2,828,828,828,828
Modoc,26,2022-06-13,7,7,7,0,34,35,34,1,1,1,1,0,8,8,7,7
Mono,26,2022-06-13,19,19,19,0,92,92,91,1,0,0,0,0,6,6,6,6
Monterey,26,2022-06-13,838,838,833,5,8656,8668,8619,49,25,3,3,1,741,741,738,738
Napa,26,2022-06-13,433,433,432,1,3939,3944,3935,9,2,1,1,1,145,145,144,144
Nevada,26,2022-06-13,186,186,185,1,1874,1876,1869,7,8,0,0,0,133,133,133,133
Orange,26,2022-06-13,7001,7009,6995,14,65112,65195,65059,136,175,14,14,19,7188,7188,7174,7174
Placer,26,2022-06-13,790,790,787,3,6801,6810,6784,26,79,2,2,7,633,633,631,631
Plumas,26,2022-06-13,34,34,34,0,271,271,270,1,0,0,0,0,13,13,13,13
Riverside,26,2022-06-13,5044,5051,5037,14,47839,47900,47766,134,105,3,3,11,6489,6489,6486,6486
Sacramento,26,2022-06-13,4178,4184,4171,13,37535,37582,37469,113,190,12,12,20,3127,3127,3115,3115
San Benito,26,2022-06-13,200,200,200,0,1780,1781,1777,4,1,0,0,1,94,94,94,94
San Bernardino,26,2022-06-13,4676,4683,4673,10,48695,48755,48645,110,96,6,6,15,7867,7867,7861,7861
San Diego,26,2022-06-13,9614,9626,9617,9,84893,84999,84919,80,192,9,9,27,5395,5395,5386,5386
San Francisco,26,2022-06-13,3045,3049,3030,19,31136,31174,30981,193,72,11,11,13,917,917,906,906
San Joaquin,26,2022-06-13,1919,1919,1913,6,19010,19033,18970,63,32,5,5,3,2266,2266,2261,2261
San Luis Obispo,26,2022-06-13,661,661,659,2,6049,6056,6041,15,21,0,0,0,488,488,488,488
San Mateo,26,2022-06-13,2635,2639,2634,5,29173,29210,29149,61,44,3,3,3,722,722,719,719
Santa Barbara,26,2022-06-13,931,931,928,3,9475,9487,9460,27,15,1,1,5,697,697,696,696
Santa Clara,26,2022-06-13,7043,7052,7045,7,76835,76932,76855,77,182,13,13,23,2363,2363,2350,2350
Santa Cruz,26,2022-06-13,842,842,840,2,9962,9974,9950,24,23,0,0,1,264,264,264,264
Shasta,26,2022-06-13,220,220,219,1,3390,3395,3385,10,8,1,1,0,568,568,567,567
Siskiyou,26,2022-06-13,50,50,50,0,372,372,371,1,1,0,0,0,83,83,83,83
Solano,26,2022-06-13,1686,1686,1681,5,12902,12918,12882,36,33,0,0,2,453,453,453,453
Sonoma,26,2022-06-13,1337,1337,1333,4,11653,11668,11636,32,36,3,3,6,502,502,499,499
Stanislaus,26,2022-06-13,1132,1132,1127,5,9453,9465,9424,41,63,1,1,7,1702,1702,1701,1701
Sutter,26,2022-06-13,193,193,192,1,1721,1721,1716,5,0,0,0,0,228,228,228,228
Tehama,26,2022-06-13,88,88,88,0,967,967,963,4,3,0,0,0,208,208,208,208
Trinity,26,2022-06-13,11,11,11,0,84,85,84,1,0,0,0,0,20,20,20,20
Tulare,26,2022-06-13,823,823,819,4,9450,9462,9420,42,26,2,2,1,1501,1501,1499,1499
Tuolumne,26,2022-06-13,148,148,147,1,1445,1445,1440,5,2,0,0,0,187,187,187,187
Ventura,26,2022-06-13,1934,1934,1930,4,20979,21005,20965,40,38,3,3,5,1521,1521,1518,1518
Yolo,26,2022-06-13,767,767,765,2,14401,14418,14381,37,4,1,1,0,366,366,365,365
Yuba,26,2022-06-13,188,188,187,1,1420,1420,1416,4,8,0,0,1,119,119,119,119
Alameda,27,2022-06-20,4963,4970,4961,9,48648,48712,48627,85,105,12,12,14,1932,1932,1920,1920
Amador,27,2022-06-20,104,104,104,0,1247,1247,1243,4,2,0,0,0,87,87,87,87
Butte,27,2022-06-20,413,413,412,1,3559,3564,3559,5,28,4,4,1,446,446,442,442
Calaveras,27,2022-06-20,82,82,82,0,624,624,622,2,0,0,0,0,124,124,124,124
Colusa,27,2022-06-20,16,16,16,0,176,177,176,1,15,1,1,0,22,22,21,21
Contra Costa,27,2022-06-20,3342,3347,3337,10,26017,26050,25973,77,81,7,7,8,1357,1357,1350,1350
Del Norte,27,2022-06-20,82,82,82,0,611,611,610,1,3,1,1,1,52,52,51,51
El Dorado,27,2022-06-20,351,351,350,1,3074,3079,3071,8,5,2,2,1,224,224,222,222
Fresno,27,2022-06-20,2469,2472,2465,7,19498,19523,19469,54,100,2,2,16,2789,2789,2787,2787
Glenn,27,2022-06-20,41,41,41,0,314,314,313,1,3,0,0,0,53,53,53,53
Humboldt,27,2022-06-20,274,274,273,1,2273,2275,2270,5,11,0,0,3,150,150,150,150
Imperial,27,2022-06-20,602,602,601,1,3692,3697,3688,9,5,0,0,0,947,947,947,947
Inyo,27,2022-06-20,19,19,19,0,187,188,187,1,0,0,0,0,56,56,56,56
Kern,27,2022-06-20,1652,1652,1649,3,20130,20156,20115,41,39,5,5,9,2358,2358,2353,2353
Kings,27,2022-06-20,413,413,412,1,4866,4871,4859,12,6,1,1,0,452,452,451,451
Lake,27,2022-06-20,120,120,120,0,1237,1237,1233,4,1,0,0,2,140,140,140,140
Lassen,27,2022-06-20,43,43,43,0,1223,1224,1222,2,1,0,0,0,62,62,62,62
Los Angeles,27,2022-06-20,27526,27562,27543,19,351458,351916,351672,244,596,57,57,68,32225,32225,32168,32168
Madera,27,2022-06-20,340,340,339,1,4163,4167,4155,12,4,0,0,1,370,370,370,370
Marin,27,2022-06-20,694,694,692,2,6328,6335,6318,17,21,0,0,1,302,302,302,302
Mariposa,27,2022-06-20,53,53,53,0,335,335,334,1,0,0,0,0,28,28,28,28
Mendocino,27,2022-06-20,180,180,179,1,1580,1580,1574,6,3,0,0,0,130,130,130,130
Merced,27,2022-06-20,541,541,540,1,3955,3960,3952,8,7,3,3,1,831,831,828,828
Modoc,27,2022-06-20,5,5,5,0,37,38,37,1,0,0,0,0,8,8,8,8
Mono,27,2022-06-20,6,6,6,0,82,83,82,1,1,1,1,0,7,7,6,6
Monterey,27,2022-06-20,894,894,890,4,8906,8918,8879,39,38,1,1,2,742,742,741,741
Napa,27,2022-06-20,365,365,364,1,3129,3134,3128,6,3,1,1,0,146,146,145,145
Nevada,27,2022-06-20,170,170,170,0,1619,1619,1615,4,6,1,1,0,134,134,133,133
Orange,27,2022-06-20,7013,7022,7011,11,60425,60505,60407,98,152,10,10,23,7198,7198,7188,7188
Placer,27,2022-06-20,674,674,672,2,6053,6060,6042,18,69,1,1,7,634,634,633,633
Plumas,27,2022-06-20,38,38,38,0,239,239,238,1,0,0,0,0,13,13,13,13
Riverside,27,2022-06-20,4959,4966,4955,11,43303,43360,43265,95,112,5,5,14,6494,6494,6489,6489
Sacramento,27,2022-06-20,3928,3934,3925,9,34808,34853,34771,82,171,12,12,21,3139,3139,3127,3127
San Benito,27,2022-06-20,173,173,173,0,1598,1598,1595,3,0,1,1,2,95,95,94,94
San Bernardino,27,2022-06-20,4538,4545,4537,8,46252,46313,46232,81,105,12,12,17,7879,7879,7867,7867
San Diego,27,2022-06-20,9694,9706,9699,7,77518,77620,77563,57,203,9,9,17,5404,5404,5395,5395
San Francisco,27,2022-06-20,3059,3064,3049,15,28298,28334,28196,138,72,12,12,14,929,929,917,917
San Joaquin,27,2022-06-20,1669,1669,1665,4,17897,17920,17874,46,38,6,6,6,2272,2272,2266,2266
San Luis Obispo,27,2022-06-20,601,601,600,1,5812,5818,5806,12,27,10,10,0,498,498,488,488
San Mateo,27,2022-06-20,2623,2626,2622,4,25938,25972,25929,43,42,2,2,1,724,724,722,722
Santa Barbara,27,2022-06-20,934,934,932,2,8260,8272,8254,18,33,2,2,6,699,699,697,697
Santa Clara,27,2022-06-20,6808,6816,6811,5,63482,63565,63516,49,170,8,8,21,2371,2371,2363,2363
Santa Cruz,27,2022-06-20,818,818,816,2,9130,9142,9125,17,19,1,1,2,265,265,264,264
Shasta,27,2022-06-20,241,241,240,1,3372,3377,3369,8,9,1,1,1,569,569,568,568
Siskiyou,27,2022-06-20,61,61,61,0,394,394,393,1,5,1,1,0,84,84,83,83
Solano,27,2022-06-20,1419,1419,1416,3,11473,11489,11464,25,41,0,0,5,453,453,453,453
Sonoma,27,2022-06-20,1399,1399,1396,3,10797,10811,10788,23,28,1,1,3,503,503,502,502
Stanislaus,27,2022-06-20,1035,1035,1032,3,8832,8843,8813,30,70,5,5,7,1707,1707,1702,1702
Sutter,27,2022-06-20,197,197,197,0,1858,1859,1855,4,0,0,0,0,228,228,228,228
Tehama,27,2022-06-20,97,97,97,0,889,889,886,3,3,0,0,0,208,208,208,208
Trinity,27,2022-06-20,10,10,10,0,106,107,106,1,0,0,0,0,20,20,20,20
Tulare,27,2022-06-20,892,892,889,3,8725,8736,8706,30,32,8,8,0,1509,1509,1501,1501
Tuolumne,27,2022-06-20,141,141,141,0,1554,1554,1550,4,3,0,0,1,187,187,187,187
Ventura,27,2022-06-20,1835,1835,1832,3,18669,18694,18666,28,50,1,1,7,1522,1522,1521,1521
Yolo,27,2022-06-20,680,680,679,1,10858,10872,10850,22,1,2,2,2,368,368,366,366
Yuba,27,2022-06-20,149,149,149,0,1339,1339,1336,3,13,0,0,5,119,119,119,119
Alameda,28,2022-06-27,5477,5484,5477,7,48322,48387,48321,66,124,8,8,16,1940,1940,1932,1932
Amador,28,2022-06-27,88,88,88,0,1149,1149,1146,3,3,0,0,1,87,87,87,87
Butte,28,2022-06-27,410,410,410,0,3468,3473,3469,4,30,2,2,0,448,448,446,446
Calaveras,28,2022-06-27,69,69,69,0,571,571,570,1,1,2,2,0,126,126,124,124
Colusa,28,2022-06-27,28,28,28,0,282,283,282,1,6,0,0,0,22,22,22,22
Contra Costa,28,2022-06-27,3527,3532,3524,8,25919,25954,25895,59,82,11,11,7,1368,1368,1357,1357
Del Norte,28,2022-06-27,140,140,140,0,669,669,668,1,5,1,1,2,53,53,52,52
El Dorado,28,2022-06-27,427,427,426,1,3357,3362,3356,6,5,0,0,1,224,224,224,224
Fresno,28,2022-06-27,2825,2830,2824,6,19937,19964,19921,43,136,2,2,17,2791,2791,2789,2789
Glenn,28,2022-06-27,28,28,28,0,296,296,295,1,1,0,0,0,53,53,53,53
Humboldt,28,2022-06-27,261,261,261,0,2189,2192,2188,4,10,1,1,2,151,151,150,150
Imperial,28,2022-06-27,705,705,704,1,4019,4024,4016,8,7,0,0,4,947,947,947,947
Inyo,28,2022-06-27,32,32,32,0,311,311,310,1,1,0,0,0,56,56,56,56
Kern,28,2022-06-27,1812,1812,1809,3,17276,17298,17270,28,52,7,7,8,2365,2365,2358,2358
Kings,28,2022-06-27,470,470,469,1,3931,3936,3928,8,9,0,0,0,452,452,452,452
Lake,28,2022-06-27,122,122,122,0,1139,1139,1136,3,2,0,0,0,140,140,140,140
Lassen,28,2022-06-27,51,51,51,0,848,848,847,1,1,0,0,0,62,62,62,62
Los Angeles,28,2022-06-27,32757,32800,32782,18,364316,364802,364605,197,679,73,73,68,32298,32298,32225,32225
Madera,28,2022-06-27,414,414,413,1,4286,4291,4282,9,8,0,0,0,370,370,370,370
Marin,28,2022-06-27,660,660,659,1,6243,6251,6238,13,20,1,1,2,303,303,302,302
Mariposa,28,2022-06-27,55,55,55,0,310,310,309,1,0,0,0,0,28,28,28,28
Mendocino,28,2022-06-27,153,153,153,0,1447,1447,1443,4,5,1,1,1,131,131,130,130
Merced,28,2022-06-27,613,613,612,1,4035,4040,4033,7,14,2,2,0,833,833,831,831
Modoc,28,2022-06-27,7,7,7,0,32,33,32,1,0,0,0,0,8,8,8,8
Mono,28,2022-06-27,25,25,25,0,110,111,110,1,1,0,0,0,7,7,7,7
Monterey,28,2022-06-27,935,935,932,3,8274,8286,8258,28,44,2,2,3,744,744,742,742
Napa,28,2022-06-27,391,391,390,1,3313,3318,3313,5,3,2,2,1,148,148,146,146
Nevada,28,2022-06-27,189,189,189,0,1619,1620,1617,3,4,0,0,3,134,134,134,134
Orange,28,2022-06-27,7544,7555,7546,9,59329,59408,59333,75,183,16,16,26,7214,7214,7198,7198
Placer,28,2022-06-27,808,808,806,2,6185,6193,6178,15,79,6,6,6,640,640,634,634
Plumas,28,2022-06-27,50,50,50,0,257,257,256,1,1,0,0,0,13,13,13,13
Riverside,28,2022-06-27,6195,6203,6193,10,44958,45018,44942,76,141,11,11,17,6505,6505,6494,6494
Sacramento,28,2022-06-27,4164,4170,4162,8,35277,35324,35259,65,173,10,10,25,3149,3149,3139,3139
San Benito,28,2022-06-27,221,221,221,0,1655,1655,1653,2,0,0,0,1,95,95,95,95
San Bernardino,28,2022-06-27,5724,5732,5724,8,48816,48880,48813,67,130,12,12,24,7891,7891,7879,7879
San Diego,28,2022-06-27,10873,10887,10881,6,80651,80758,80712,46,264,9,9,28,5413,5413,5404,5404
San Francisco,28,2022-06-27,3270,3275,3263,12,29255,29294,29184,110,92,5,5,23,934,934,929,929
San Joaquin,28,2022-06-27,1894,1895,1891,4,17966,17991,17955,36,46,2,2,5,2274,2274,2272,2272
San Luis Obispo,28,2022-06-27,645,645,644,1,5644,5650,5641,9,25,3,3,0,501,501,498,498
San Mateo,28,2022-06-27,2890,2894,2890,4,26906,26942,26908,34,36,2,2,2,726,726,724,724
Santa Barbara,28,2022-06-27,1148,1148,1146,2,9812,9825,9808,17,26,2,2,2,701,701,699,699
Santa Clara,28,2022-06-27,7542,7552,7547,5,61416,61498,61461,37,213,11,11,19,2382,2382,2371,2371
Santa Cruz,28,2022-06-27,861,861,860,1,9188,9200,9186,14,26,2,2,1,267,267,265,265
Shasta,28,2022-06-27,339,339,338,1,3308,3313,3307,6,21,0,0,4,569,569,569,569
Siskiyou,28,2022-06-27,63,63,63,0,355,355,354,1,2,1,1,0,85,85,84,84
Solano,28,2022-06-27,1614,1614,1611,3,13048,13066,13044,22,47,0,0,4,453,453,453,453
Sonoma,28,2022-06-27,1368,1368,1366,2,10098,10112,10095,17,33,2,2,3,505,505,503,503
Stanislaus,28,2022-06-27,1212,1212,1209,3,8583,8595,8572,23,96,2,2,6,1709,1709,1707,1707
Sutter,28,2022-06-27,197,197,197,0,1843,1844,1841,3,0,0,0,0,228,228,228,228
Tehama,28,2022-06-27,93,93,93,0,888,888,886,2,3,0,0,0,208,208,208,208
Trinity,28,2022-06-27,24,24,24,0,142,143,142,1,1,0,0,0,20,20,20,20
Tulare,28,2022-06-27,910,910,908,2,7883,7893,7872,21,35,0,0,2,1509,1509,1509,1509
Tuolumne,28,2022-06-27,172,172,172,0,1405,1405,1402,3,1,4,4,1,191,191,187,187
Ventura,28,2022-06-27,2090,2091,2089,2,18528,18554,18532,22,61,3,3,1,1525,1525,1522,1522
Yolo,28,2022-06-27,794,794,793,1,11421,11437,11419,18,8,0,0,1,368,368,368,368
Yuba,28,2022-06-27,172,172,172,0,1435,1435,1433,2,10,2,2,2,121,121,119,119
Alameda,29,2022-07-04,4837,4844,4839,5,38878,38930,38888,42,128,11,11,10,1951,1951,1940,1940
Amador,29,2022-07-04,66,66,66,0,1534,1535,1532,3,3,1,1,1,88,88,87,87
Butte,29,2022-07-04,284,284,284,0,2489,2492,2490,2,28,2,2,1,450,450,448,448
Calaveras,29,2022-07-04,81,81,81,0,486,486,485,1,0,2,2,0,128,128,126,126
Colusa,29,2022-07-04,21,21,21,0,150,151,150,1,4,0,0,0,22,22,22,22
Contra Costa,29,2022-07-04,3319,3324,3318,6,20930,20958,20920,38,76,10,10,12,1378,1378,1368,1368
Del Norte,29,2022-07-04,140,140,140,0,587,587,586,1,3,0,0,0,53,53,53,53
El Dorado,29,2022-07-04,307,307,307,0,2395,2399,2395,4,10,1,1,0,225,225,224,224
Fresno,29,2022-07-04,2469,2473,2469,4,15677,15700,15673,27,158,6,6,17,2797,2797,2791,2791
Glenn,29,2022-07-04,24,24,24,0,157,158,157,1,1,0,0,0,53,53,53,53
Humboldt,29,2022-07-04,188,188,188,0,1584,1584,1582,2,12,2,2,3,153,153,151,151
Imperial,29,2022-07-04,698,698,697,1,3234,3238,3233,5,8,1,1,3,948,948,947,947
Inyo,29,2022-07-04,42,42,42,0,292,293,292,1,1,0,0,0,56,56,56,56
Kern,29,2022-07-04,1757,1757,1755,2,14149,14169,14151,18,63,4,4,9,2369,2369,2365,2365
Kings,29,2022-07-04,436,436,435,1,3446,3450,3445,5,5,0,0,0,452,452,452,452
Lake,29,2022-07-04,107,107,107,0,790,790,789,1,3,2,2,0,142,142,140,140
Lassen,29,2022-07-04,31,31,31,0,640,640,639,1,2,0,0,0,62,62,62,62
Los Angeles,29,2022-07-04,32266,32310,32296,14,285895,286287,286164,123,801,88,88,85,32386,32386,32298,32298
Madera,29,2022-07-04,341,341,340,1,3179,3182,3176,6,9,0,0,1,370,370,370,370
Marin,29,2022-07-04,608,608,607,1,5169,5175,5166,9,25,1,1,2,304,304,303,303
Mariposa,29,2022-07-04,36,36,36,0,222,223,222,1,0,0,0,0,28,28,28,28
Mendocino,29,2022-07-04,164,164,164,0,1119,1119,1116,3,6,2,2,1,133,133,131,131
Merced,29,2022-07-04,597,597,596,1,2920,2924,2920,4,14,2,2,1,835,835,833,833
Modoc,29,2022-07-04,10,10,10,0,31,32,31,1,0,0,0,0,8,8,8,8
Mono,29,2022-07-04,22,22,22,0,81,82,81,1,1,0,0,0,7,7,7,7
Monterey,29,2022-07-04,843,843,841,2,6318,6329,6312,17,39,2,2,4,746,746,744,744
Napa,29,2022-07-04,340,340,340,0,2557,2561,2558,3,13,0,0,1,148,148,148,148
Nevada,29,2022-07-04,177,177,177,0,1268,1268,1266,2,5,0,0,1,134,134,134,134
Orange,29,2022-07-04,6975,6986,6979,7,50716,50784,50733,51,203,25,25,34,7239,7239,7214,7214
Placer,29,2022-07-04,808,808,807,1,5048,5054,5045,9,72,3,3,6,643,643,640,640
Plumas,29,2022-07-04,32,32,32,0,172,173,172,1,0,0,0,0,13,13,13,13
Riverside,29,2022-07-04,6398,6408,6399,9,38528,38579,38527,52,137,5,5,8,6510,6510,6505,6505
Sacramento,29,2022-07-04,3578,3583,3578,5,26532,26569,26530,39,163,19,19,22,3168,3168,3149,3149
San Benito,29,2022-07-04,211,211,211,0,1274,1274,1272,2,3,0,0,0,95,95,95,95
San Bernardino,29,2022-07-04,6066,6074,6067,7,41595,41651,41606,45,147,12,12,26,7903,7903,7891,7891
San Diego,29,2022-07-04,9602,9615,9611,4,65499,65589,65559,30,262,10,10,43,5423,5423,5413,5413
San Francisco,29,2022-07-04,2890,2894,2885,9,24200,24233,24161,72,100,11,11,18,945,945,934,934
San Joaquin,29,2022-07-04,1682,1682,1679,3,14665,14685,14662,23,41,5,5,4,2279,2279,2274,2274
San Luis Obispo,29,2022-07-04,616,616,615,1,4165,4169,4164,5,24,0,0,0,501,501,501,501
San Mateo,29,2022-07-04,2600,2604,2601,3,21586,21616,21594,22,39,1,1,3,727,727,726,726
Santa Barbara,29,2022-07-04,1057,1057,1056,1,7665,7676,7665,11,26,4,4,4,705,705,701,701
Santa Clara,29,2022-07-04,6804,6814,6811,3,50743,50813,50789,24,191,16,16,34,2398,2398,2382,2382
Santa Cruz,29,2022-07-04,733,733,732,1,7158,7167,7158,9,22,0,0,0,267,267,267,267
Shasta,29,2022-07-04,280,280,280,0,2396,2399,2395,4,15,5,5,3,574,574,569,569
Siskiyou,29,2022-07-04,34,34,34,0,326,327,326,1,1,0,0,1,85,85,85,85
Solano,29,2022-07-04,1345,1345,1343,2,9845,9858,9845,13,50,0,0,5,453,453,453,453
Sonoma,29,2022-07-04,1088,1088,1087,1,8092,8103,8092,11,35,2,2,1,507,507,505,505
Stanislaus,29,2022-07-04,1165,1165,1163,2,6990,7001,6986,15,84,7,7,16,1716,1716,1709,1709
Sutter,29,2022-07-04,230,230,230,0,1671,1672,1670,2,0,0,0,0,228,228,228,228
Tehama,29,2022-07-04,132,132,132,0,821,821,819,2,3,1,1,0,209,209,208,208
Trinity,29,2022-07-04,17,17,17,0,143,144,143,1,2,0,0,0,20,20,20,20
Tulare,29,2022-07-04,945,945,943,2,6100,6108,6095,13,40,4,4,1,1513,1513,1509,1509
Tuolumne,29,2022-07-04,165,165,165,0,938,938,936,2,8,0,0,1,191,191,191,191
Ventura,29,2022-07-04,1948,1949,1947,2,15408,15429,15415,14,66,2,2,8,1527,1527,1525,1525
Yolo,29,2022-07-04,535,535,534,1,7261,7269,7260,9,6,3,3,2,371,371,368,368
Yuba,29,2022-07-04,168,168,168,0,1078,1078,1077,1,9,0,0,1,121,121,121,121
Alameda,30,2022-07-11,5801,5809,5804,5,48338,48409,48369,40,119,8,8,16,1959,1959,1951,1951
Amador,30,2022-07-11,92,92,92,0,1504,1505,1503,2,2,0,0,0,88,88,88,88
Butte,30,2022-07-11,497,497,497,0,3299,3304,3302,2,27,1,1,4,451,451,450,450
Calaveras,30,2022-07-11,78,78,78,0,566,566,565,1,0,1,1,1,129,129,128,128
Colusa,30,2022-07-11,26,26,26,0,483,484,483,1,0,0,0,0,22,22,22,22
Contra Costa,30,2022-07-11,3683,3689,3684,5,26546,26586,26549,37,91,11,11,11,1389,1389,1378,1378
Del Norte,30,2022-07-11,175,175,175,0,677,677,676,1,5,0,0,1,53,53,53,53
El Dorado,30,2022-07-11,384,384,384,0,3153,3158,3154,4,12,1,1,3,226,226,225,225
Fresno,30,2022-07-11,3662,3668,3663,5,21579,21610,21582,28,161,7,7,14,2804,2804,2797,2797
Glenn,30,2022-07-11,45,45,45,0,382,383,382,1,0,0,0,0,53,53,53,53
Humboldt,30,2022-07-11,291,291,291,0,2189,2192,2190,2,11,1,1,2,154,154,153,153
Imperial,30,2022-07-11,1118,1118,1117,1,4746,4753,4747,6,14,1,1,1,949,949,948,948
Inyo,30,2022-07-11,38,38,38,0,389,390,389,1,0,1,1,0,57,57,56,56
Kern,30,2022-07-11,2457,2460,2458,2,16952,16975,16959,16,77,2,2,9,2371,2371,2369,2369
Kings,30,2022-07-11,732,732,731,1,4341,4346,4341,5,11,4,4,0,456,456,452,452
Lake,30,2022-07-11,126,126,126,0,1115,1115,1113,2,0,0,0,0,142,142,142,142
Lassen,30,2022-07-11,59,59,59,0,821,821,820,1,2,1,1,0,63,63,62,62
Los Angeles,30,2022-07-11,43322,43384,43370,14,381158,381713,381588,125,1038,90,90,115,32476,32476,32386,32386
Madera,30,2022-07-11,532,532,531,1,4126,4131,4126,5,15,0,0,3,370,370,370,370
Marin,30,2022-07-11,603,603,602,1,5928,5936,5928,8,17,1,1,1,305,305,304,304
Mariposa,30,2022-07-11,52,52,52,0,283,284,283,1,0,0,0,0,28,28,28,28
Mendocino,30,2022-07-11,190,190,190,0,1387,1388,1386,2,4,0,0,0,133,133,133,133
Merced,30,2022-07-11,764,764,763,1,4273,4278,4274,4,16,5,5,1,840,840,835,835
Modoc,30,2022-07-11,28,28,28,0,57,58,57,1,0,0,0,0,8,8,8,8
Mono,30,2022-07-11,11,11,11,0,105,106,105,1,0,0,0,0,7,7,7,7
Monterey,30,2022-07-11,1096,1096,1094,2,7948,7960,7943,17,47,5,5,3,751,751,746,746
Napa,30,2022-07-11,367,367,367,0,3664,3669,3666,3,13,1,1,1,149,149,148,148
Nevada,30,2022-07-11,221,221,221,0,1826,1829,1827,2,7,0,0,1,134,134,134,134
Orange,30,2022-07-11,9751,9765,9758,7,64155,64248,64198,50,257,20,20,30,7259,7259,7239,7239
Placer,30,2022-07-11,784,784,783,1,5963,5972,5963,9,76,2,2,8,645,645,643,643
Plumas,30,2022-07-11,71,71,71,0,282,283,282,1,0,0,0,0,13,13,13,13
Riverside,30,2022-07-11,9208,9220,9211,9,52069,52145,52091,54,225,17,17,12,6527,6527,6510,6510
Sacramento,30,2022-07-11,4205,4211,4206,5,35516,35568,35528,40,184,22,22,24,3190,3190,3168,3168
San Benito,30,2022-07-11,235,235,235,0,1666,1668,1666,2,1,0,0,0,95,95,95,95
San Bernardino,30,2022-07-11,8441,8453,8446,7,57670,57754,57706,48,188,14,14,20,7917,7917,7903,7903
San Diego,30,2022-07-11,13667,13687,13682,5,85548,85674,85644,30,332,11,11,41,5434,5434,5423,5423
San Francisco,30,2022-07-11,2998,3003,2996,7,27840,27879,27815,64,105,11,11,23,956,956,945,945
San Joaquin,30,2022-07-11,2142,2145,2142,3,19354,19382,19358,24,55,7,7,11,2286,2286,2279,2279
San Luis Obispo,30,2022-07-11,755,755,754,1,5272,5279,5274,5,22,3,3,1,504,504,501,501
San Mateo,30,2022-07-11,2778,2783,2781,2,25654,25692,25672,20,42,6,6,4,733,733,727,727
Santa Barbara,30,2022-07-11,1326,1326,1325,1,9703,9717,9707,10,46,5,5,9,710,710,705,705
Santa Clara,30,2022-07-11,7402,7413,7410,3,59980,60069,60047,22,211,12,12,38,2410,2410,2398,2398
Santa Cruz,30,2022-07-11,1031,1031,1030,1,9513,9526,9517,9,16,0,0,0,267,267,267,267
Shasta,30,2022-07-11,328,328,328,0,3565,3569,3565,4,21,2,2,6,576,576,574,574
Siskiyou,30,2022-07-11,29,29,29,0,361,362,361,1,1,1,1,1,86,86,85,85
Solano,30,2022-07-11,1632,1633,1631,2,11661,11679,11667,12,40,1,1,6,454,454,453,453
Sonoma,30,2022-07-11,1300,1300,1299,1,9943,9958,9948,10,50,0,0,7,507,507,507,507
Stanislaus,30,2022-07-11,1493,1493,1491,2,8686,8699,8685,14,103,7,7,11,1723,1723,1716,1716
Sutter,30,2022-07-11,287,287,287,0,1777,1778,1776,2,0,0,0,0,228,228,228,228
Tehama,30,2022-07-11,134,134,134,0,925,925,924,1,5,0,0,1,209,209,209,209
Trinity,30,2022-07-11,35,35,35,0,120,121,120,1,0,0,0,0,20,20,20,20
Tulare,30,2022-07-11,1385,1385,1383,2,9558,9571,9555,16,47,4,4,2,1517,1517,1513,1513
Tuolumne,30,2022-07-11,254,254,254,0,1303,1303,1301,2,6,0,0,0,191,191,191,191
Ventura,30,2022-07-11,2549,2553,2551,2,19713,19741,19727,14,89,9,9,6,1536,1536,1527,1527
Yolo,30,2022-07-11,502,502,502,0,5427,5434,5429,5,4,3,3,4,374,374,371,371
Yuba,30,2022-07-11,218,218,218,0,1404,1404,1403,1,9,0,0,1,121,121,121,121
Alameda,31,2022-07-18,4954,4961,4958,3,42947,43013,42985,28,149,10,10,25,1969,1969,1959,1959
Amador,31,2022-07-18,85,85,85,0,1348,1349,1348,1,6,0,0,1,88,88,88,88
Butte,31,2022-07-18,334,334,334,0,2794,2798,2797,1,25,1,1,3,452,452,451,451
Calaveras,31,2022-07-18,78,78,78,0,545,546,545,1,0,0,0,0,129,129,129,129
Colusa,31,2022-07-18,23,23,23,0,349,350,349,1,2,0,0,0,22,22,22,22
Contra Costa,31,2022-07-18,3059,3064,3061,3,22722,22757,22732,25,88,4,4,16,1393,1393,1389,1389
Del Norte,31,2022-07-18,168,168,168,0,705,705,704,1,7,0,0,0,53,53,53,53
El Dorado,31,2022-07-18,279,279,279,0,2638,2643,2641,2,11,1,1,1,227,227,226,226
Fresno,31,2022-07-18,3701,3707,3703,4,21121,21153,21131,22,199,9,9,15,2813,2813,2804,2804
Glenn,31,2022-07-18,34,34,34,0,263,264,263,1,0,0,0,0,53,53,53,53
Humboldt,31,2022-07-18,294,294,294,0,2025,2029,2027,2,10,0,0,4,154,154,154,154
Imperial,31,2022-07-18,1022,1022,1021,1,4434,4439,4435,4,18,2,2,3,951,951,949,949
Inyo,31,2022-07-18,30,30,30,0,331,332,331,1,0,0,0,0,57,57,57,57
Kern,31,2022-07-18,2296,2300,2298,2,16469,16494,16482,12,72,10,10,14,2381,2381,2371,2371
Kings,31,2022-07-18,708,708,707,1,4154,4159,4155,4,16,1,1,0,457,457,456,456
Lake,31,2022-07-18,132,132,132,0,993,993,992,1,3,0,0,0,142,142,142,142
Lassen,31,2022-07-18,78,78,78,0,1239,1241,1240,1,1,0,0,0,63,63,63,63
Los Angeles,31,2022-07-18,41834,41896,41885,11,352140,352675,352585,90,1162,112,112,137,32588,32588,32476,32476
Madera,31,2022-07-18,529,529,528,1,3632,3637,3633,4,5,0,0,3,370,370,370,370
Marin,31,2022-07-18,516,516,515,1,5504,5512,5506,6,12,1,1,5,306,306,305,305
Mariposa,31,2022-07-18,42,42,42,0,242,243,242,1,0,1,1,0,29,29,28,28
Mendocino,31,2022-07-18,185,185,185,0,1491,1491,1489,2,6,0,0,2,133,133,133,133
Merced,31,2022-07-18,753,753,752,1,3981,3986,3983,3,15,1,1,1,841,841,840,840
Modoc,31,2022-07-18,13,13,13,0,34,35,34,1,1,0,0,0,8,8,8,8
Mono,31,2022-07-18,10,10,10,0,85,86,85,1,1,0,0,0,7,7,7,7
Monterey,31,2022-07-18,985,985,983,2,7188,7199,7187,12,46,6,6,4,757,757,751,751
Napa,31,2022-07-18,318,318,318,0,2954,2959,2957,2,10,2,2,2,151,151,149,149
Nevada,31,2022-07-18,135,135,135,0,1331,1332,1331,1,8,0,0,3,134,134,134,134
Orange,31,2022-07-18,8793,8805,8800,5,59781,59872,59836,36,253,24,24,45,7283,7283,7259,7259
Placer,31,2022-07-18,684,684,683,1,5240,5248,5242,6,89,1,1,5,646,646,645,645
Plumas,31,2022-07-18,60,60,60,0,279,280,279,1,0,0,0,0,13,13,13,13
Riverside,31,2022-07-18,8246,8258,8251,7,48075,48148,48109,39,222,16,16,17,6543,6543,6527,6527
Sacramento,31,2022-07-18,3541,3547,3544,3,30408,30454,30428,26,180,12,12,26,3202,3202,3190,3190
San Benito,31,2022-07-18,199,199,199,0,1588,1590,1589,1,1,1,1,0,96,96,95,95
San Bernardino,31,2022-07-18,7997,8009,8004,5,53733,53814,53779,35,214,13,13,35,7930,7930,7917,7917
San Diego,31,2022-07-18,13078,13099,13095,4,79857,79978,79956,22,402,18,18,52,5452,5452,5434,5434
San Francisco,31,2022-07-18,2490,2495,2491,4,25514,25554,25509,45,111,10,10,24,966,966,956,956
San Joaquin,31,2022-07-18,2053,2055,2053,2,18031,18060,18043,17,66,2,2,11,2288,2288,2286,2286
San Luis Obispo,31,2022-07-18,560,560,560,0,4628,4634,4631,3,17,3,3,1,507,507,504,504
San Mateo,31,2022-07-18,2289,2293,2292,1,23091,23125,23111,14,33,0,0,4,733,733,733,733
Santa Barbara,31,2022-07-18,1297,1297,1296,1,9270,9284,9276,8,47,1,1,6,711,711,710,710
Santa Clara,31,2022-07-18,6194,6203,6201,2,54685,54768,54752,16,199,12,12,30,2422,2422,2410,2410
Santa Cruz,31,2022-07-18,874,874,873,1,7449,7460,7455,5,24,1,1,2,268,268,267,267
Shasta,31,2022-07-18,320,320,320,0,3209,3214,3211,3,40,3,3,3,579,579,576,576
Siskiyou,31,2022-07-18,34,34,34,0,345,346,345,1,3,0,0,0,86,86,86,86
Solano,31,2022-07-18,1246,1246,1245,1,9543,9558,9550,8,49,1,1,6,455,455,454,454
Sonoma,31,2022-07-18,1053,1053,1052,1,8747,8760,8753,7,44,0,0,5,507,507,507,507
Stanislaus,31,2022-07-18,1395,1395,1393,2,8396,8410,8399,11,109,5,5,9,1728,1728,1723,1723
Sutter,31,2022-07-18,253,253,253,0,1673,1674,1673,1,0,0,0,0,228,228,228,228
Tehama,31,2022-07-18,110,110,110,0,896,896,895,1,7,1,1,0,210,210,209,209
Trinity,31,2022-07-18,20,20,20,0,111,112,111,1,1,0,0,0,20,20,20,20
Tulare,31,2022-07-18,1185,1185,1183,2,8085,8097,8087,10,45,0,0,0,1517,1517,1517,1517
Tuolumne,31,2022-07-18,239,239,239,0,1142,1142,1141,1,7,4,4,0,195,195,191,191
Ventura,31,2022-07-18,2324,2328,2327,1,19560,19589,19578,11,92,4,4,7,1540,1540,1536,1536
Yolo,31,2022-07-18,430,430,430,0,4659,4665,4662,3,2,3,3,1,377,377,374,374
Yuba,31,2022-07-18,213,213,213,0,1292,1292,1291,1,18,0,0,0,121,121,121,121
Alameda,32,2022-07-25,4400,4407,4405,2,40432,40494,40474,20,143,12,12,19,1981,1981,1969,1969
Amador,32,2022-07-25,90,90,90,0,1206,1206,1205,1,3,0,0,1,88,88,88,88
Butte,32,2022-07-25,359,359,359,0,2945,2949,2948,1,30,1,1,2,453,453,452,452
Calaveras,32,2022-07-25,82,82,82,0,558,559,558,1,0,2,2,1,131,131,129,129
Colusa,32,2022-07-25,26,26,26,0,373,374,373,1,1,0,0,0,22,22,22,22
Contra Costa,32,2022-07-25,2822,2827,2825,2,21982,22017,21998,19,102,7,7,18,1400,1400,1393,1393
Del Norte,32,2022-07-25,67,67,67,0,534,535,534,1,6,0,0,0,53,53,53,53
El Dorado,32,2022-07-25,270,270,270,0,2485,2490,2488,2,9,1,1,0,228,228,227,227
Fresno,32,2022-07-25,3358,3363,3360,3,20401,20434,20418,16,195,6,6,29,2819,2819,2813,2813
Glenn,32,2022-07-25,31,31,31,0,271,272,271,1,0,0,0,0,53,53,53,53
Humboldt,32,2022-07-25,230,230,230,0,1923,1927,1926,1,13,2,2,4,156,156,154,154
Imperial,32,2022-07-25,873,873,872,1,4341,4346,4343,3,18,1,1,6,952,952,951,951
Inyo,32,2022-07-25,18,18,18,0,284,285,284,1,2,1,1,0,58,58,57,57
Kern,32,2022-07-25,1899,1900,1899,1,14987,15011,15002,9,82,3,3,12,2384,2384,2381,2381
Kings,32,2022-07-25,571,571,571,0,3887,3892,3889,3,15,1,1,0,458,458,457,457
Lake,32,2022-07-25,128,128,128,0,1041,1041,1040,1,5,1,1,2,143,143,142,142
Lassen,32,2022-07-25,53,53,53,0,1071,1072,1071,1,1,0,0,0,63,63,63,63
Los Angeles,32,2022-07-25,37132,37192,37185,7,334148,334671,334604,67,1152,121,121,134,32709,32709,32588,32588
Madera,32,2022-07-25,539,539,539,0,3829,3834,3831,3,11,1,1,5,371,371,370,370
Marin,32,2022-07-25,489,489,489,0,5417,5426,5422,4,26,2,2,2,308,308,306,306
Mariposa,32,2022-07-25,40,40,40,0,232,233,232,1,0,0,0,0,29,29,29,29
Mendocino,32,2022-07-25,196,196,196,0,1426,1426,1424,2,6,0,0,0,133,133,133,133
Merced,32,2022-07-25,732,732,732,0,3917,3923,3921,2,22,2,2,2,843,843,841,841
Modoc,32,2022-07-25,5,5,5,0,28,29,28,1,0,1,1,0,9,9,8,8
Mono,32,2022-07-25,15,15,15,0,84,85,84,1,0,0,0,0,7,7,7,7
Monterey,32,2022-07-25,933,933,932,1,7142,7153,7144,9,39,1,1,3,758,758,757,757
Napa,32,2022-07-25,297,297,297,0,2933,2938,2936,2,6,3,3,0,154,154,151,151
Nevada,32,2022-07-25,116,116,116,0,1316,1317,1316,1,3,1,1,0,135,135,134,134
Orange,32,2022-07-25,8020,8032,8028,4,58144,58235,58208,27,306,37,37,35,7320,7320,7283,7283
Placer,32,2022-07-25,606,606,605,1,5086,5094,5090,4,77,5,5,11,651,651,646,646
Plumas,32,2022-07-25,25,25,25,0,188,189,188,1,0,0,0,0,13,13,13,13
Riverside,32,2022-07-25,7513,7525,7520,5,45936,46009,45980,29,259,16,16,27,6559,6559,6543,6543
Sacramento,32,2022-07-25,3632,3638,3636,2,29835,29881,29861,20,207,18,18,32,3220,3220,3202,3202
San Benito,32,2022-07-25,200,200,200,0,1836,1839,1838,1,0,1,1,0,97,97,96,96
San Bernardino,32,2022-07-25,7099,7111,7107,4,52139,52221,52195,26,214,30,30,23,7960,7960,7930,7930
San Diego,32,2022-07-25,11897,11916,11913,3,76173,76293,76277,16,393,19,19,41,5471,5471,5452,5452
San Francisco,32,2022-07-25,2300,2305,2302,3,24271,24309,24275,34,126,9,9,24,975,975,966,966
San Joaquin,32,2022-07-25,1837,1839,1838,1,16574,16601,16589,12,73,5,5,9,2293,2293,2288,2288
San Luis Obispo,32,2022-07-25,539,539,539,0,4382,4387,4384,3,16,4,4,1,511,511,507,507
San Mateo,32,2022-07-25,2029,2031,2030,1,21675,21708,21698,10,57,1,1,7,734,734,733,733
Santa Barbara,32,2022-07-25,1178,1178,1177,1,8770,8783,8777,6,37,4,4,3,715,715,711,711
Santa Clara,32,2022-07-25,5772,5781,5780,1,50880,50960,50949,11,238,16,16,26,2438,2438,2422,2422
Santa Cruz,32,2022-07-25,832,832,832,0,7663,7675,7671,4,23,0,0,0,268,268,268,268
Shasta,32,2022-07-25,305,305,305,0,3079,3084,3082,2,38,2,2,6,581,581,579,579
Siskiyou,32,2022-07-25,36,36,36,0,333,334,333,1,1,0,0,0,86,86,86,86
Solano,32,2022-07-25,1203,1203,1202,1,9484,9500,9494,6,56,0,0,5,455,455,455,455
Sonoma,32,2022-07-25,1066,1066,1065,1,8653,8667,8662,5,48,2,2,4,509,509,507,507
Stanislaus,32,2022-07-25,1377,1377,1376,1,8160,8174,8166,8,104,8,8,11,1736,1736,1728,1728
Sutter,32,2022-07-25,222,222,222,0,1721,1722,1721,1,0,0,0,0,228,228,228,228
Tehama,32,2022-07-25,103,103,103,0,920,920,919,1,5,2,2,0,212,212,210,210
Trinity,32,2022-07-25,12,12,12,0,102,103,102,1,0,0,0,0,20,20,20,20
Tulare,32,2022-07-25,1144,1144,1143,1,8015,8027,8019,8,42,2,2,2,1519,1519,1517,1517
Tuolumne,32,2022-07-25,200,200,200,0,1150,1150,1149,1,5,1,1,0,196,196,195,195
Ventura,32,2022-07-25,2153,2157,2156,1,18389,18418,18410,8,76,5,5,8,1545,1545,1540,1540
Yolo,32,2022-07-25,413,413,413,0,4399,4404,4401,3,4,3,3,1,380,380,377,377
Yuba,32,2022-07-25,175,175,175,0,1282,1282,1281,1,15,0,0,0,121,121,121,121
Alameda,33,2022-08-01,3816,3823,3822,1,37187,37247,37232,15,176,8,8,21,1989,1989,1981,1981
Amador,33,2022-08-01,53,53,53,0,1133,1133,1132,1,3,1,1,0,89,89,88,88
Butte,33,2022-08-01,368,368,368,0,2843,2848,2847,1,33,2,2,3,455,455,453,453
Calaveras,33,2022-08-01,68,68,68,0,573,574,573,1,2,1,1,2,132,132,131,131
Colusa,33,2022-08-01,26,26,26,0,362,363,362,1,7,0,0,0,22,22,22,22
Contra Costa,33,2022-08-01,2623,2628,2626,2,21022,21054,21040,14,86,13,13,15,1413,1413,1400,1400
Del Norte,33,2022-08-01,53,53,53,0,476,477,476,1,4,0,0,2,53,53,53,53
El Dorado,33,2022-08-01,232,232,232,0,2456,2461,2460,1,4,3,3,2,231,231,228,228
Fresno,33,2022-08-01,2994,2999,2997,2,18320,18350,18339,11,231,10,10,16,2829,2829,2819,2819
Glenn,33,2022-08-01,28,28,28,0,251,252,251,1,0,0,0,0,53,53,53,53
Humboldt,33,2022-08-01,224,224,224,0,1880,1883,1882,1,12,0,0,3,156,156,156,156
Imperial,33,2022-08-01,636,636,636,0,3530,3535,3533,2,22,5,5,3,957,957,952,952
Inyo,33,2022-08-01,20,20,20,0,280,281,280,1,2,0,0,0,58,58,58,58
Kern,33,2022-08-01,1692,1694,1693,1,14821,14844,14837,7,81,6,6,17,2390,2390,2384,2384
Kings,33,2022-08-01,624,624,624,0,4043,4048,4046,2,6,0,0,1,458,458,458,458
Lake,33,2022-08-01,125,125,125,0,994,994,993,1,7,0,0,2,143,143,143,143
Lassen,33,2022-08-01,103,103,103,0,947,949,948,1,0,0,0,0,63,63,63,63
Los Angeles,33,2022-08-01,30589,30639,30634,5,308923,309423,309375,48,1105,129,129,137,32838,32838,32709,32709
Madera,33,2022-08-01,463,463,463,0,3481,3486,3484,2,10,0,0,7,371,371,371,371
Marin,33,2022-08-01,411,411,411,0,5134,5142,5139,3,32,1,1,4,309,309,308,308
Mariposa,33,2022-08-01,22,22,22,0,225,226,225,1,0,0,0,0,29,29,29,29
Mendocino,33,2022-08-01,175,175,175,0,1258,1258,1257,1,6,1,1,1,134,134,133,133
Merced,33,2022-08-01,643,643,643,0,3567,3572,3570,2,22,6,6,2,849,849,843,843
Modoc,33,2022-08-01,16,16,16,0,31,32,31,1,0,0,0,0,9,9,9,9
Mono,33,2022-08-01,9,9,9,0,67,68,67,1,0,0,0,0,7,7,7,7
Monterey,33,2022-08-01,930,930,929,1,6430,6441,6435,6,33,2,2,1,760,760,758,758
Napa,33,2022-08-01,282,282,282,0,2838,2843,2842,1,8,0,0,2,154,154,154,154
Nevada,33,2022-08-01,125,125,125,0,1404,1406,1405,1,12,0,0,0,135,135,135,135
Orange,33,2022-08-01,6491,6503,6501,2,52422,52506,52487,19,246,34,34,49,7354,7354,7320,7320
Placer,33,2022-08-01,588,588,588,0,4744,4752,4749,3,71,1,1,11,652,652,651,651
Plumas,33,2022-08-01,23,23,23,0,162,163,162,1,0,0,0,0,13,13,13,13
Riverside,33,2022-08-01,6120,6131,6128,3,42287,42355,42334,21,200,5,5,23,6564,6564,6559,6559
Sacramento,33,2022-08-01,3095,3101,3099,2,27844,27890,27875,15,179,18,18,26,3238,3238,3220,3220
San Benito,33,2022-08-01,177,177,177,0,1561,1563,1562,1,2,1,1,0,98,98,97,97
San Bernardino,33,2022-08-01,6065,6075,6073,2,48914,48994,48975,19,184,26,26,23,7986,7986,7960,7960
San Diego,33,2022-08-01,9362,9377,9375,2,68638,68749,68738,11,396,16,16,46,5487,5487,5471,5471
San Francisco,33,2022-08-01,1817,1819,1817,2,21993,22029,22005,24,105,13,13,20,988,988,975,975
San Joaquin,33,2022-08-01,1734,1735,1734,1,16120,16146,16137,9,69,7,7,11,2300,2300,2293,2293
San Luis Obispo,33,2022-08-01,578,578,578,0,4141,4146,4144,2,14,3,3,0,514,514,511,511
San Mateo,33,2022-08-01,1773,1774,1773,1,20330,20363,20356,7,67,1,1,3,735,735,734,734
Santa Barbara,33,2022-08-01,1119,1119,1118,1,7779,7791,7787,4,40,1,1,3,716,716,715,715
Santa Clara,33,2022-08-01,4818,4825,4824,1,45489,45564,45556,8,230,19,19,36,2457,2457,2438,2438
Santa Cruz,33,2022-08-01,748,748,748,0,6875,6886,6883,3,20,1,1,3,269,269,268,268
Shasta,33,2022-08-01,245,245,245,0,2968,2973,2971,2,34,1,1,7,582,582,581,581
Siskiyou,33,2022-08-01,29,29,29,0,298,299,298,1,2,0,0,0,86,86,86,86
Solano,33,2022-08-01,1145,1145,1144,1,9149,9164,9159,5,53,0,0,4,455,455,455,455
Sonoma,33,2022-08-01,921,921,921,0,8186,8199,8195,4,46,3,3,3,512,512,509,509
Stanislaus,33,2022-08-01,1233,1233,1232,1,7720,7733,7727,6,115,6,6,8,1742,1742,1736,1736
Sutter,33,2022-08-01,232,232,232,0,1634,1635,1634,1,0,3,3,0,231,231,228,228
Tehama,33,2022-08-01,89,89,89,0,757,757,756,1,4,0,0,0,212,212,212,212
Trinity,33,2022-08-01,11,11,11,0,71,72,71,1,0,1,1,0,21,21,20,20
Tulare,33,2022-08-01,1036,1036,1035,1,7462,7474,7468,6,46,1,1,3,1520,1520,1519,1519
Tuolumne,33,2022-08-01,144,144,144,0,1111,1111,1110,1,4,0,0,1,196,196,196,196
Ventura,33,2022-08-01,1807,1808,1807,1,16968,16997,16991,6,75,10,10,10,1555,1555,1545,1545
Yolo,33,2022-08-01,333,333,333,0,4181,4188,4186,2,3,3,3,1,383,383,380,380
Yuba,33,2022-08-01,159,159,159,0,1216,1216,1215,1,10,0,0,3,121,121,121,121
Alameda,34,2022-08-08,3278,3284,3283,1,35236,35296,35285,11,133,15,15,20,2004,2004,1989,1989
Amador,34,2022-08-08,50,50,50,0,852,853,852,1,3,0,0,1,89,89,89,89
Butte,34,2022-08-08,334,334,334,0,2493,2498,2497,1,33,1,1,1,456,456,455,455
Calaveras,34,2022-08-08,57,57,57,0,559,560,559,1,1,1,1,0,133,133,132,132
Colusa,34,2022-08-08,15,15,15,0,362,363,362,1,0,0,0,0,22,22,22,22
Contra Costa,34,2022-08-08,2180,2184,2183,1,19793,19826,19816,10,102,4,4,14,1417,1417,1413,1413
Del Norte,34,2022-08-08,49,49,49,0,498,499,498,1,4,1,1,1,54,54,53,53
El Dorado,34,2022-08-08,191,191,191,0,2317,2322,2321,1,4,0,0,2,231,231,231,231
Fresno,34,2022-08-08,2421,2426,2425,1,17767,17797,17788,9,207,9,9,25,2838,2838,2829,2829
Glenn,34,2022-08-08,22,22,22,0,249,250,249,1,0,0,0,0,53,53,53,53
Humboldt,34,2022-08-08,208,208,208,0,1919,1923,1922,1,12,1,1,2,157,157,156,156
Imperial,34,2022-08-08,548,548,548,0,3278,3283,3282,1,16,2,2,2,959,959,957,957
Inyo,34,2022-08-08,8,8,8,0,276,277,276,1,1,0,0,1,58,58,58,58
Kern,34,2022-08-08,1314,1314,1314,0,13659,13681,13676,5,61,6,6,16,2396,2396,2390,2390
Kings,34,2022-08-08,467,467,467,0,3323,3328,3327,1,20,1,1,2,459,459,458,458
Lake,34,2022-08-08,106,106,106,0,893,894,893,1,4,0,0,1,143,143,143,143
Lassen,34,2022-08-08,132,132,132,0,1023,1025,1024,1,1,0,0,0,63,63,63,63
Los Angeles,34,2022-08-08,25754,25796,25793,3,290995,291477,291442,35,1030,128,128,121,32966,32966,32838,32838
Madera,34,2022-08-08,380,380,380,0,3175,3180,3178,2,16,0,0,3,371,371,371,371
Marin,34,2022-08-08,360,360,360,0,4484,4490,4488,2,26,2,2,2,311,311,309,309
Mariposa,34,2022-08-08,28,28,28,0,197,198,197,1,0,0,0,0,29,29,29,29
Mendocino,34,2022-08-08,132,132,132,0,1128,1128,1127,1,3,1,1,1,135,135,134,134
Merced,34,2022-08-08,538,538,538,0,3396,3401,3400,1,17,1,1,5,850,850,849,849
Modoc,34,2022-08-08,2,2,2,0,22,23,22,1,0,0,0,0,9,9,9,9
Mono,34,2022-08-08,10,10,10,0,85,86,85,1,0,0,0,0,7,7,7,7
Monterey,34,2022-08-08,736,736,735,1,5773,5783,5779,4,28,1,1,0,761,761,760,760
Napa,34,2022-08-08,252,252,252,0,2611,2616,2615,1,10,2,2,3,156,156,154,154
Nevada,34,2022-08-08,94,94,94,0,1290,1292,1291,1,4,0,0,0,135,135,135,135
Orange,34,2022-08-08,5281,5290,5289,1,48047,48126,48112,14,242,29,29,40,7383,7383,7354,7354
Placer,34,2022-08-08,513,513,513,0,4519,4526,4524,2,65,3,3,9,655,655,652,652
Plumas,34,2022-08-08,23,23,23,0,190,191,190,1,1,0,0,0,13,13,13,13
Riverside,34,2022-08-08,5508,5518,5516,2,40564,40632,40617,15,174,13,13,13,6577,6577,6564,6564
Sacramento,34,2022-08-08,2622,2627,2626,1,26966,27011,27000,11,156,17,17,20,3255,3255,3238,3238
San Benito,34,2022-08-08,187,187,187,0,1433,1435,1434,1,1,0,0,0,98,98,98,98
San Bernardino,34,2022-08-08,5055,5064,5062,2,45838,45914,45900,14,204,20,20,15,8006,8006,7986,7986
San Diego,34,2022-08-08,7275,7287,7286,1,64412,64519,64511,8,337,11,11,30,5498,5498,5487,5487
San Francisco,34,2022-08-08,1494,1494,1493,1,20620,20654,20637,17,94,11,11,21,999,999,988,988
San Joaquin,34,2022-08-08,1522,1523,1522,1,15717,15744,15737,7,55,6,6,12,2306,2306,2300,2300
San Luis Obispo,34,2022-08-08,509,509,509,0,3610,3615,3614,1,14,0,0,2,514,514,514,514
San Mateo,34,2022-08-08,1519,1519,1519,0,18503,18533,18528,5,60,0,0,5,735,735,735,735
Santa Barbara,34,2022-08-08,964,964,964,0,7519,7531,7528,3,46,3,3,4,719,719,716,716
Santa Clara,34,2022-08-08,4139,4146,4145,1,40868,40936,40930,6,203,17,17,40,2474,2474,2457,2457
Santa Cruz,34,2022-08-08,619,619,619,0,6055,6066,6064,2,28,1,1,0,270,270,269,269
Shasta,34,2022-08-08,197,197,197,0,2831,2835,2834,1,33,1,1,3,583,583,582,582
Siskiyou,34,2022-08-08,27,27,27,0,291,292,291,1,0,1,1,0,87,87,86,86
Solano,34,2022-08-08,883,883,883,0,7967,7981,7978,3,54,0,0,9,455,455,455,455
Sonoma,34,2022-08-08,839,839,839,0,7725,7738,7735,3,34,4,4,3,516,516,512,512
Stanislaus,34,2022-08-08,1035,1035,1034,1,7175,7188,7184,4,90,7,7,11,1749,1749,1742,1742
Sutter,34,2022-08-08,223,223,223,0,1551,1552,1551,1,0,0,0,0,231,231,231,231
Tehama,34,2022-08-08,77,77,77,0,681,682,681,1,0,0,0,1,212,212,212,212
Trinity,34,2022-08-08,5,5,5,0,71,72,71,1,0,0,0,0,21,21,21,21
Tulare,34,2022-08-08,887,887,886,1,7320,7331,7327,4,46,4,4,3,1524,1524,1520,1520
Tuolumne,34,2022-08-08,118,118,118,0,1054,1054,1053,1,4,2,2,0,198,198,196,196
Ventura,34,2022-08-08,1503,1503,1503,0,15930,15956,15952,4,67,7,7,7,1562,1562,1555,1555
Yolo,34,2022-08-08,287,287,287,0,3889,3894,3893,1,4,1,1,3,384,384,383,383
Yuba,34,2022-08-08,136,136,136,0,1086,1087,1086,1,6,1,1,0,122,122,121,121
Alameda,35,2022-08-15,2562,2567,2566,1,33712,33770,33762,8,105,9,9,22,2013,2013,2004,2004
Amador,35,2022-08-15,47,47,47,0,848,849,848,1,2,0,0,0,89,89,89,89
Butte,35,2022-08-15,262,262,262,0,2244,2249,2248,1,19,0,0,2,456,456,456,456
Calaveras,35,2022-08-15,46,46,46,0,528,529,528,1,0,0,0,0,133,133,133,133
Colusa,35,2022-08-15,16,16,16,0,359,360,359,1,1,0,0,0,22,22,22,22
Contra Costa,35,2022-08-15,1777,1778,1777,1,18964,18996,18988,8,72,6,6,9,1423,1423,1417,1417
Del Norte,35,2022-08-15,53,53,53,0,499,500,499,1,2,0,0,1,54,54,54,54
El Dorado,35,2022-08-15,177,177,177,0,2304,2309,2308,1,5,0,0,3,231,231,231,231
Fresno,35,2022-08-15,1869,1872,1871,1,16175,16203,16197,6,170,7,7,17,2845,2845,2838,2838
Glenn,35,2022-08-15,15,15,15,0,225,226,225,1,3,0,0,0,53,53,53,53
Humboldt,35,2022-08-15,179,179,179,0,1587,1589,1588,1,16,0,0,2,157,157,157,157
Imperial,35,2022-08-15,365,365,365,0,3099,3104,3103,1,11,0,0,2,959,959,959,959
Inyo,35,2022-08-15,14,14,14,0,236,237,236,1,2,1,1,0,59,59,58,58
Kern,35,2022-08-15,1216,1216,1216,0,13481,13504,13500,4,59,7,7,16,2403,2403,2396,2396
Kings,35,2022-08-15,332,332,332,0,3234,3239,3238,1,9,0,0,1,459,459,459,459
Lake,35,2022-08-15,104,104,104,0,1028,1030,1029,1,3,1,1,2,144,144,143,143
Lassen,35,2022-08-15,59,59,59,0,897,898,897,1,0,0,0,0,63,63,63,63
Los Angeles,35,2022-08-15,20921,20956,20954,2,287480,287971,287944,27,905,110,110,117,33076,33076,32966,32966
Madera,35,2022-08-15,305,305,305,0,2954,2959,2958,1,12,0,0,3,371,371,371,371
Marin,35,2022-08-15,294,294,294,0,4111,4117,4115,2,15,0,0,0,311,311,311,311
Mariposa,35,2022-08-15,15,15,15,0,192,193,192,1,0,0,0,0,29,29,29,29
Mendocino,35,2022-08-15,104,104,104,0,996,996,995,1,7,0,0,3,135,135,135,135
Merced,35,2022-08-15,452,452,452,0,3426,3431,3430,1,12,2,2,1,852,852,850,850
Modoc,35,2022-08-15,4,4,4,0,23,24,23,1,0,0,0,0,9,9,9,9
Mono,35,2022-08-15,4,4,4,0,61,62,61,1,0,0,0,0,7,7,7,7
Monterey,35,2022-08-15,662,662,662,0,5824,5836,5833,3,30,0,0,1,761,761,761,761
Napa,35,2022-08-15,212,212,212,0,2280,2285,2284,1,13,0,0,0,156,156,156,156
Nevada,35,2022-08-15,98,98,98,0,1209,1211,1210,1,7,0,0,0,135,135,135,135
Orange,35,2022-08-15,4577,4584,4583,1,43031,43104,43094,10,270,31,31,44,7414,7414,7383,7383
Placer,35,2022-08-15,411,411,411,0,4469,4477,4475,2,61,1,1,11,656,656,655,655
Plumas,35,2022-08-15,17,17,17,0,184,185,184,1,0,0,0,0,13,13,13,13
Riverside,35,2022-08-15,4560,4567,4566,1,38035,38099,38088,11,143,16,16,22,6593,6593,6577,6577
Sacramento,35,2022-08-15,2353,2358,2357,1,25411,25455,25447,8,149,11,11,22,3266,3266,3255,3255
San Benito,35,2022-08-15,140,140,140,0,1334,1337,1336,1,3,1,1,1,99,99,98,98
San Bernardino,35,2022-08-15,4699,4707,4706,1,44152,44228,44217,11,144,14,14,22,8020,8020,8006,8006
San Diego,35,2022-08-15,5499,5509,5508,1,59501,59603,59597,6,288,14,14,34,5512,5512,5498,5498
San Francisco,35,2022-08-15,1265,1265,1264,1,19570,19603,19590,13,103,15,15,11,1014,1014,999,999
San Joaquin,35,2022-08-15,1443,1444,1443,1,15217,15244,15239,5,64,8,8,8,2314,2314,2306,2306
San Luis Obispo,35,2022-08-15,325,325,325,0,3301,3306,3305,1,15,4,4,3,518,518,514,514
San Mateo,35,2022-08-15,1220,1220,1220,0,17366,17395,17391,4,56,1,1,5,736,736,735,735
Santa Barbara,35,2022-08-15,831,831,831,0,7118,7130,7128,2,44,1,1,4,720,720,719,719
Santa Clara,35,2022-08-15,3332,3339,3339,0,39767,39836,39832,4,200,8,8,24,2482,2482,2474,2474
Santa Cruz,35,2022-08-15,493,493,493,0,7543,7556,7554,2,23,3,3,1,273,273,270,270
Shasta,35,2022-08-15,194,194,194,0,2786,2790,2789,1,19,1,1,1,584,584,583,583
Siskiyou,35,2022-08-15,19,19,19,0,284,285,284,1,3,0,0,1,87,87,87,87
Solano,35,2022-08-15,663,663,663,0,7459,7472,7470,2,45,0,0,10,455,455,455,455
Sonoma,35,2022-08-15,631,631,631,0,7286,7298,7296,2,39,2,2,2,518,518,516,516
Stanislaus,35,2022-08-15,940,940,940,0,7657,7670,7666,4,99,9,9,11,1758,1758,1749,1749
Sutter,35,2022-08-15,197,197,197,0,1587,1589,1588,1,0,1,1,0,232,232,231,231
Tehama,35,2022-08-15,60,60,60,0,645,646,645,1,1,0,0,0,212,212,212,212
Trinity,35,2022-08-15,8,8,8,0,58,59,58,1,0,0,0,0,21,21,21,21
Tulare,35,2022-08-15,735,735,735,0,7326,7337,7334,3,32,3,3,1,1527,1527,1524,1524
Tuolumne,35,2022-08-15,110,110,110,0,991,992,991,1,1,0,0,0,198,198,198,198
Ventura,35,2022-08-15,1494,1494,1494,0,15260,15287,15284,3,70,6,6,7,1568,1568,1562,1562
Yolo,35,2022-08-15,264,264,264,0,3544,3549,3548,1,2,4,4,1,388,388,384,384
Yuba,35,2022-08-15,128,128,128,0,1080,1081,1080,1,9,0,0,0,122,122,122,122
Alameda,36,2022-08-22,2233,2238,2238,0,33143,33202,33196,6,117,9,9,21,2022,2022,2013,2013
Amador,36,2022-08-22,49,49,49,0,815,816,815,1,2,1,1,0,90,90,89,89
Butte,36,2022-08-22,222,222,222,0,2131,2136,2135,1,17,1,1,2,457,457,456,456
Calaveras,36,2022-08-22,43,43,43,0,572,573,572,1,1,0,0,0,133,133,133,133
Colusa,36,2022-08-22,16,16,16,0,394,395,394,1,0,0,0,0,22,22,22,22
Contra Costa,36,2022-08-22,1530,1531,1531,0,18837,18870,18864,6,56,5,5,9,1428,1428,1423,1423
Del Norte,36,2022-08-22,32,32,32,0,461,462,461,1,3,1,1,0,55,55,54,54
El Dorado,36,2022-08-22,152,152,152,0,2219,2224,2223,1,4,1,1,0,232,232,231,231
Fresno,36,2022-08-22,1595,1596,1596,0,15784,15812,15807,5,162,6,6,14,2851,2851,2845,2845
Glenn,36,2022-08-22,23,23,23,0,227,228,227,1,1,0,0,0,53,53,53,53
Humboldt,36,2022-08-22,151,151,151,0,1677,1682,1681,1,6,1,1,3,158,158,157,157
Imperial,36,2022-08-22,292,292,292,0,2844,2849,2848,1,15,0,0,0,959,959,959,959
Inyo,36,2022-08-22,8,8,8,0,213,214,213,1,0,0,0,0,59,59,59,59
Kern,36,2022-08-22,982,982,982,0,13745,13769,13766,3,69,6,6,10,2409,2409,2403,2403
Kings,36,2022-08-22,369,369,369,0,3636,3641,3640,1,10,2,2,0,461,461,459,459
Lake,36,2022-08-22,104,104,104,0,884,885,884,1,5,0,0,0,144,144,144,144
Lassen,36,2022-08-22,36,36,36,0,833,834,833,1,0,0,0,0,63,63,63,63
Los Angeles,36,2022-08-22,18453,18485,18484,1,274621,275103,275083,20,811,121,121,104,33197,33197,33076,33076
Madera,36,2022-08-22,300,300,300,0,2613,2618,2617,1,14,2,2,4,373,373,371,371
Marin,36,2022-08-22,250,250,250,0,3967,3973,3972,1,17,0,0,3,311,311,311,311
Mariposa,36,2022-08-22,14,14,14,0,172,173,172,1,0,0,0,0,29,29,29,29
Mendocino,36,2022-08-22,121,121,121,0,1145,1146,1145,1,3,0,0,2,135,135,135,135
Merced,36,2022-08-22,447,447,447,0,3657,3663,3662,1,12,4,4,1,856,856,852,852
Modoc,36,2022-08-22,6,6,6,0,27,28,27,1,0,0,0,0,9,9,9,9
Mono,36,2022-08-22,4,4,4,0,63,64,63,1,0,0,0,0,7,7,7,7
Monterey,36,2022-08-22,548,548,548,0,5923,5934,5931,3,27,1,1,2,762,762,761,761
Napa,36,2022-08-22,128,128,128,0,1999,2004,2003,1,5,2,2,1,158,158,156,156
Nevada,36,2022-08-22,84,84,84,0,1180,1182,1181,1,6,0,0,0,135,135,135,135
Orange,36,2022-08-22,3808,3815,3814,1,40768,40840,40833,7,224,21,21,35,7435,7435,7414,7414
Placer,36,2022-08-22,384,384,384,0,4303,4310,4309,1,61,1,1,14,657,657,656,656
Plumas,36,2022-08-22,20,20,20,0,175,176,175,1,1,0,0,0,13,13,13,13
Riverside,36,2022-08-22,4379,4386,4385,1,37513,37578,37569,9,142,13,13,19,6606,6606,6593,6593
Sacramento,36,2022-08-22,2079,2084,2083,1,24955,24999,24993,6,144,14,14,25,3280,3280,3266,3266
San Benito,36,2022-08-22,102,102,102,0,1268,1270,1269,1,1,1,1,1,100,100,99,99
San Bernardino,36,2022-08-22,4616,4624,4623,1,44256,44333,44325,8,160,18,18,22,8038,8038,8020,8020
San Diego,36,2022-08-22,4784,4792,4792,0,57535,57636,57632,4,287,6,6,28,5518,5518,5512,5512
San Francisco,36,2022-08-22,1096,1096,1095,1,18859,18891,18881,10,81,16,16,12,1030,1030,1014,1014
San Joaquin,36,2022-08-22,1195,1195,1195,0,15726,15754,15750,4,56,1,1,8,2315,2315,2314,2314
San Luis Obispo,36,2022-08-22,259,259,259,0,3089,3094,3093,1,16,1,1,0,519,519,518,518
San Mateo,36,2022-08-22,1013,1013,1013,0,17202,17231,17228,3,42,0,0,2,736,736,736,736
Santa Barbara,36,2022-08-22,736,736,736,0,7435,7448,7446,2,37,1,1,2,721,721,720,720
Santa Clara,36,2022-08-22,3013,3019,3019,0,40203,40273,40270,3,173,10,10,27,2492,2492,2482,2482
Santa Cruz,36,2022-08-22,502,502,502,0,11963,11983,11981,2,13,0,0,0,273,273,273,273
Shasta,36,2022-08-22,174,174,174,0,2757,2761,2760,1,10,2,2,2,586,586,584,584
Siskiyou,36,2022-08-22,25,25,25,0,249,250,249,1,4,1,1,2,88,88,87,87
Solano,36,2022-08-22,533,533,533,0,7221,7234,7232,2,35,0,0,12,455,455,455,455
Sonoma,36,2022-08-22,605,605,605,0,7371,7384,7382,2,42,1,1,1,519,519,518,518
Stanislaus,36,2022-08-22,893,893,893,0,7650,7663,7660,3,79,7,7,16,1765,1765,1758,1758
Sutter,36,2022-08-22,189,189,189,0,1657,1660,1659,1,0,0,0,0,232,232,232,232
Tehama,36,2022-08-22,53,53,53,0,629,630,629,1,1,0,0,0,212,212,212,212
Trinity,36,2022-08-22,10,10,10,0,63,64,63,1,0,0,0,0,21,21,21,21
Tulare,36,2022-08-22,730,730,730,0,6781,6793,6791,2,33,4,4,1,1531,1531,1527,1527
Tuolumne,36,2022-08-22,106,106,106,0,1018,1019,1018,1,0,1,1,0,199,199,198,198
Ventura,36,2022-08-22,1318,1318,1318,0,14997,15024,15022,2,59,4,4,9,1572,1572,1568,1568
Yolo,36,2022-08-22,200,200,200,0,3489,3494,3493,1,10,1,1,1,389,389,388,388
Yuba,36,2022-08-22,127,127,127,0,1106,1107,1106,1,13,0,0,3,122,122,122,122
Alameda,37,2022-08-29,1964,1969,1969,0,34182,34243,34238,5,99,11,11,20,2033,2033,2022,2022
Amador,37,2022-08-29,46,46,46,0,804,805,804,1,2,1,1,0,91,91,90,90
Butte,37,2022-08-29,236,236,236,0,2170,2176,2175,1,18,0,0,3,457,457,457,457
Calaveras,37,2022-08-29,59,59,59,0,592,593,592,1,1,0,0,0,133,133,133,133
Colusa,37,2022-08-29,11,11,11,0,329,330,329,1,3,0,0,0,22,22,22,22
Contra Costa,37,2022-08-29,1354,1354,1354,0,18792,18826,18821,5,44,5,5,7,1433,1433,1428,1428
Del Norte,37,2022-08-29,28,28,28,0,431,432,431,1,5,0,0,1,55,55,55,55
El Dorado,37,2022-08-29,143,143,143,0,1947,1953,1952,1,1,0,0,1,232,232,232,232
Fresno,37,2022-08-29,1418,1418,1418,0,15741,15769,15765,4,159,3,3,15,2854,2854,2851,2851
Glenn,37,2022-08-29,22,22,22,0,220,221,220,1,1,0,0,0,53,53,53,53
Humboldt,37,2022-08-29,124,124,124,0,1662,1666,1665,1,4,0,0,0,158,158,158,158
Imperial,37,2022-08-29,294,294,294,0,2936,2941,2940,1,14,1,1,2,960,960,959,959
Inyo,37,2022-08-29,8,8,8,0,175,176,175,1,0,0,0,0,59,59,59,59
Kern,37,2022-08-29,885,885,885,0,13225,13248,13246,2,50,0,0,8,2409,2409,2409,2409
Kings,37,2022-08-29,314,314,314,0,3490,3495,3494,1,8,0,0,0,461,461,461,461
Lake,37,2022-08-29,93,93,93,0,870,871,870,1,1,1,1,0,145,145,144,144
Lassen,37,2022-08-29,28,28,28,0,771,772,771,1,0,0,0,0,63,63,63,63
Los Angeles,37,2022-08-29,15526,15554,15553,1,271297,271788,271772,16,753,86,86,83,33283,33283,33197,33197
Madera,37,2022-08-29,302,302,302,0,3019,3024,3023,1,13,0,0,3,373,373,373,373
Marin,37,2022-08-29,215,215,215,0,3847,3853,3852,1,16,2,2,2,313,313,311,311
Mariposa,37,2022-08-29,25,25,25,0,186,187,186,1,0,0,0,0,29,29,29,29
Mendocino,37,2022-08-29,87,87,87,0,969,970,969,1,2,0,0,1,135,135,135,135
Merced,37,2022-08-29,393,393,393,0,3417,3422,3421,1,11,3,3,0,859,859,856,856
Modoc,37,2022-08-29,1,1,1,0,30,31,30,1,0,0,0,0,9,9,9,9
Mono,37,2022-08-29,2,2,2,0,45,46,45,1,0,0,0,0,7,7,7,7
Monterey,37,2022-08-29,395,395,395,0,5380,5391,5389,2,33,2,2,5,764,764,762,762
Napa,37,2022-08-29,128,128,128,0,2159,2165,2164,1,10,0,0,1,158,158,158,158
Nevada,37,2022-08-29,116,116,116,0,1206,1208,1207,1,6,0,0,0,135,135,135,135
Orange,37,2022-08-29,2950,2955,2955,0,39171,39240,39235,5,195,18,18,25,7453,7453,7435,7435
Placer,37,2022-08-29,370,370,370,0,4210,4217,4216,1,55,1,1,12,658,658,657,657
Plumas,37,2022-08-29,18,18,18,0,159,160,159,1,1,0,0,0,13,13,13,13
Riverside,37,2022-08-29,3650,3657,3656,1,36835,36901,36894,7,124,9,9,11,6615,6615,6606,6606
Sacramento,37,2022-08-29,1856,1859,1859,0,24695,24740,24735,5,137,11,11,20,3291,3291,3280,3280
San Benito,37,2022-08-29,120,120,120,0,1410,1413,1412,1,1,0,0,0,100,100,100,100
San Bernardino,37,2022-08-29,3620,3627,3626,1,42080,42157,42151,6,156,14,14,18,8052,8052,8038,8038
San Diego,37,2022-08-29,3934,3941,3941,0,56587,56690,56687,3,222,12,12,25,5530,5530,5518,5518
San Francisco,37,2022-08-29,875,875,875,0,19135,19169,19161,8,57,7,7,12,1037,1037,1030,1030
San Joaquin,37,2022-08-29,1005,1005,1005,0,14301,14328,14325,3,27,5,5,11,2320,2320,2315,2315
San Luis Obispo,37,2022-08-29,326,326,326,0,3216,3221,3220,1,17,3,3,0,522,522,519,519
San Mateo,37,2022-08-29,853,853,853,0,16781,16811,16809,2,26,0,0,5,736,736,736,736
Santa Barbara,37,2022-08-29,639,639,639,0,7623,7636,7635,1,24,1,1,3,722,722,721,721
Santa Clara,37,2022-08-29,2308,2313,2313,0,39573,39644,39641,3,135,5,5,24,2497,2497,2492,2492
Santa Cruz,37,2022-08-29,384,384,384,0,12676,12699,12697,2,16,0,0,1,273,273,273,273
Shasta,37,2022-08-29,130,130,130,0,2576,2580,2579,1,19,1,1,1,587,587,586,586
Siskiyou,37,2022-08-29,24,24,24,0,249,250,249,1,0,1,1,0,89,89,88,88
Solano,37,2022-08-29,549,549,549,0,7290,7303,7302,1,33,1,1,8,456,456,455,455
Sonoma,37,2022-08-29,486,486,486,0,7105,7118,7117,1,37,1,1,4,520,520,519,519
Stanislaus,37,2022-08-29,849,849,849,0,8083,8098,8096,2,79,7,7,6,1772,1772,1765,1765
Sutter,37,2022-08-29,170,170,170,0,1638,1641,1640,1,0,0,0,0,232,232,232,232
Tehama,37,2022-08-29,66,66,66,0,737,738,737,1,4,0,0,1,212,212,212,212
Trinity,37,2022-08-29,9,9,9,0,56,57,56,1,0,0,0,0,21,21,21,21
Tulare,37,2022-08-29,683,683,683,0,7370,7385,7383,2,42,0,0,1,1531,1531,1531,1531
Tuolumne,37,2022-08-29,91,91,91,0,856,857,856,1,1,0,0,0,199,199,199,199
Ventura,37,2022-08-29,1020,1020,1020,0,14599,14624,14622,2,71,6,6,7,1578,1578,1572,1572
Yolo,37,2022-08-29,204,204,204,0,3715,3720,3719,1,5,0,0,3,389,389,389,389
Yuba,37,2022-08-29,135,135,135,0,1176,1177,1176,1,14,0,0,1,122,122,122,122
Alameda,38,2022-09-05,1434,1435,1435,0,28120,28173,28170,3,89,4,4,16,2037,2037,2033,2033
Amador,38,2022-09-05,44,44,44,0,748,749,748,1,3,0,0,2,91,91,91,91
Butte,38,2022-09-05,193,193,193,0,2122,2126,2125,1,14,2,2,2,459,459,457,457
Calaveras,38,2022-09-05,22,22,22,0,451,452,451,1,0,0,0,0,133,133,133,133
Colusa,38,2022-09-05,8,8,8,0,197,198,197,1,2,0,0,0,22,22,22,22
Contra Costa,38,2022-09-05,955,955,955,0,15427,15456,15453,3,62,5,5,9,1438,1438,1433,1433
Del Norte,38,2022-09-05,9,9,9,0,347,348,347,1,1,0,0,1,55,55,55,55
El Dorado,38,2022-09-05,90,90,90,0,1523,1526,1525,1,3,1,1,3,233,233,232,232
Fresno,38,2022-09-05,1085,1085,1085,0,13052,13076,13074,2,162,10,10,16,2864,2864,2854,2854
Glenn,38,2022-09-05,11,11,11,0,188,189,188,1,1,0,0,0,53,53,53,53
Humboldt,38,2022-09-05,110,110,110,0,1294,1296,1295,1,9,1,1,2,159,159,158,158
Imperial,38,2022-09-05,235,235,235,0,2521,2526,2525,1,8,1,1,2,961,961,960,960
Inyo,38,2022-09-05,12,12,12,0,139,140,139,1,0,0,0,1,59,59,59,59
Kern,38,2022-09-05,719,719,719,0,11238,11259,11257,2,50,5,5,8,2414,2414,2409,2409
Kings,38,2022-09-05,229,229,229,0,2869,2874,2873,1,8,0,0,0,461,461,461,461
Lake,38,2022-09-05,62,62,62,0,655,656,655,1,1,3,3,1,148,148,145,145
Lassen,38,2022-09-05,19,19,19,0,633,634,633,1,0,0,0,0,63,63,63,63
Los Angeles,38,2022-09-05,10672,10692,10692,0,221979,222395,222385,10,695,96,96,91,33379,33379,33283,33283
Madera,38,2022-09-05,205,205,205,0,2505,2510,2509,1,12,0,0,4,373,373,373,373
Marin,38,2022-09-05,191,191,191,0,3557,3563,3562,1,12,0,0,1,313,313,313,313
Mariposa,38,2022-09-05,16,16,16,0,166,167,166,1,0,0,0,0,29,29,29,29
Mendocino,38,2022-09-05,57,57,57,0,828,829,828,1,2,1,1,1,136,136,135,135
Merced,38,2022-09-05,251,251,251,0,2637,2642,2641,1,12,2,2,1,861,861,859,859
Modoc,38,2022-09-05,3,3,3,0,17,18,17,1,0,0,0,0,9,9,9,9
Mono,38,2022-09-05,4,4,4,0,52,53,52,1,1,0,0,0,7,7,7,7
Monterey,38,2022-09-05,245,245,245,0,4379,4389,4388,1,24,4,4,0,768,768,764,764
Napa,38,2022-09-05,102,102,102,0,1725,1730,1729,1,6,1,1,2,159,159,158,158
Nevada,38,2022-09-05,81,81,81,0,899,900,899,1,3,0,0,0,135,135,135,135
Orange,38,2022-09-05,2171,2175,2175,0,32128,32188,32185,3,169,13,13,34,7466,7466,7453,7453
Placer,38,2022-09-05,238,238,238,0,3469,3476,3475,1,36,0,0,4,658,658,658,658
Plumas,38,2022-09-05,9,9,9,0,130,131,130,1,0,0,0,0,13,13,13,13
Riverside,38,2022-09-05,2402,2406,2406,0,28561,28614,28610,4,99,7,7,14,6622,6622,6615,6615
Sacramento,38,2022-09-05,1243,1244,1244,0,19661,19697,19694,3,139,12,12,22,3303,3303,3291,3291
San Benito,38,2022-09-05,65,65,65,0,1086,1087,1086,1,0,0,0,2,100,100,100,100
San Bernardino,38,2022-09-05,2333,2337,2337,0,34212,34277,34273,4,122,14,14,19,8066,8066,8052,8052
San Diego,38,2022-09-05,2801,2806,2806,0,48218,48308,48306,2,212,15,15,25,5545,5545,5530,5530
San Francisco,38,2022-09-05,678,678,678,0,15724,15754,15749,5,52,9,9,9,1046,1046,1037,1037
San Joaquin,38,2022-09-05,831,831,831,0,11953,11976,11974,2,43,4,4,10,2324,2324,2320,2320
San Luis Obispo,38,2022-09-05,176,176,176,0,2676,2681,2680,1,7,2,2,1,524,524,522,522
San Mateo,38,2022-09-05,611,611,611,0,13543,13569,13568,1,23,1,1,2,737,737,736,736
Santa Barbara,38,2022-09-05,485,485,485,0,6632,6644,6643,1,39,4,4,3,726,726,722,722
Santa Clara,38,2022-09-05,1892,1896,1896,0,33058,33121,33119,2,127,10,10,20,2507,2507,2497,2497
Santa Cruz,38,2022-09-05,282,282,282,0,10218,10237,10236,1,16,0,0,0,273,273,273,273
Shasta,38,2022-09-05,103,103,103,0,2022,2026,2025,1,15,0,0,0,587,587,587,587
Siskiyou,38,2022-09-05,30,30,30,0,216,217,216,1,0,0,0,0,89,89,89,89
Solano,38,2022-09-05,368,368,368,0,5962,5974,5973,1,34,1,1,11,457,457,456,456
Sonoma,38,2022-09-05,368,368,368,0,6002,6013,6012,1,40,0,0,2,520,520,520,520
Stanislaus,38,2022-09-05,547,547,547,0,6347,6359,6358,1,69,5,5,4,1777,1777,1772,1772
Sutter,38,2022-09-05,118,118,118,0,1482,1485,1484,1,0,0,0,0,232,232,232,232
Tehama,38,2022-09-05,50,50,50,0,581,582,581,1,2,1,1,0,213,213,212,212
Trinity,38,2022-09-05,4,4,4,0,51,52,51,1,0,0,0,0,21,21,21,21
Tulare,38,2022-09-05,429,429,429,0,5163,5172,5171,1,37,2,2,1,1533,1533,1531,1531
Tuolumne,38,2022-09-05,68,68,68,0,737,738,737,1,1,0,0,0,199,199,199,199
Ventura,38,2022-09-05,864,864,864,0,12305,12329,12328,1,48,8,8,1,1586,1586,1578,1578
Yolo,38,2022-09-05,140,140,140,0,2902,2907,2906,1,1,3,3,2,392,392,389,389
Yuba,38,2022-09-05,88,88,88,0,975,976,975,1,14,0,0,1,122,122,122,122
Alameda,39,2022-09-12,1607,1610,1610,0,32011,32075,32072,3,94,5,5,16,2042,2042,2037,2037
Amador,39,2022-09-12,32,32,32,0,873,874,873,1,3,0,0,2,91,91,91,91
Butte,39,2022-09-12,196,196,196,0,2466,2472,2471,1,15,3,3,2,462,462,459,459
Calaveras,39,2022-09-12,14,14,14,0,501,502,501,1,1,0,0,0,133,133,133,133
Colusa,39,2022-09-12,17,17,17,0,414,415,414,1,0,0,0,0,22,22,22,22
Contra Costa,39,2022-09-12,979,979,979,0,17329,17364,17361,3,59,6,6,12,1444,1444,1438,1438
Del Norte,39,2022-09-12,34,34,34,0,595,596,595,1,1,0,0,1,55,55,55,55
El Dorado,39,2022-09-12,104,104,104,0,1899,1904,1903,1,3,0,0,1,233,233,233,233
Fresno,39,2022-09-12,906,906,906,0,14677,14705,14703,2,155,6,6,15,2870,2870,2864,2864
Glenn,39,2022-09-12,15,15,15,0,208,209,208,1,0,0,0,0,53,53,53,53
Humboldt,39,2022-09-12,113,113,113,0,1652,1657,1656,1,6,0,0,5,159,159,159,159
Imperial,39,2022-09-12,258,258,258,0,3287,3294,3293,1,10,0,0,2,961,961,961,961
Inyo,39,2022-09-12,15,15,15,0,194,195,194,1,0,1,1,0,60,60,59,59
Kern,39,2022-09-12,638,638,638,0,12821,12845,12844,1,45,7,7,13,2421,2421,2414,2414
Kings,39,2022-09-12,229,229,229,0,3171,3177,3176,1,6,1,1,0,462,462,461,461
Lake,39,2022-09-12,48,48,48,0,882,883,882,1,3,0,0,1,148,148,148,148
Lassen,39,2022-09-12,20,20,20,0,917,918,917,1,0,0,0,0,63,63,63,63
Los Angeles,39,2022-09-12,10983,11006,11006,0,282451,283009,282999,10,652,85,85,83,33464,33464,33379,33379
Madera,39,2022-09-12,242,242,242,0,2923,2929,2928,1,8,0,0,3,373,373,373,373
Marin,39,2022-09-12,174,174,174,0,3912,3921,3920,1,12,2,2,2,315,315,313,313
Mariposa,39,2022-09-12,16,16,16,0,192,193,192,1,0,0,0,0,29,29,29,29
Mendocino,39,2022-09-12,58,58,58,0,952,953,952,1,2,0,0,1,136,136,136,136
Merced,39,2022-09-12,237,237,237,0,3317,3324,3323,1,6,2,2,1,863,863,861,861
Modoc,39,2022-09-12,2,2,2,0,22,23,22,1,0,0,0,0,9,9,9,9
Mono,39,2022-09-12,7,7,7,0,76,77,76,1,0,0,0,0,7,7,7,7
Monterey,39,2022-09-12,229,229,229,0,5123,5135,5134,1,22,1,1,1,769,769,768,768
Napa,39,2022-09-12,119,119,119,0,2249,2255,2254,1,10,0,0,1,159,159,159,159
Nevada,39,2022-09-12,61,61,61,0,1179,1182,1181,1,2,1,1,0,136,136,135,135
Orange,39,2022-09-12,2093,2098,2098,0,36677,36750,36747,3,159,27,27,22,7493,7493,7466,7466
Placer,39,2022-09-12,239,239,239,0,4074,4082,4081,1,38,0,0,5,658,658,658,658
Plumas,39,2022-09-12,22,22,22,0,194,195,194,1,1,0,0,0,13,13,13,13
Riverside,39,2022-09-12,2249,2254,2254,0,32986,33052,33048,4,124,5,5,12,6627,6627,6622,6622
Sacramento,39,2022-09-12,1275,1276,1276,0,23403,23450,23447,3,119,16,16,15,3319,3319,3303,3303
San Benito,39,2022-09-12,93,93,93,0,1503,1507,1506,1,1,0,0,1,100,100,100,100
San Bernardino,39,2022-09-12,1931,1936,1936,0,38561,38637,38634,3,92,13,13,26,8079,8079,8066,8066
San Diego,39,2022-09-12,3034,3040,3040,0,55707,55817,55815,2,194,7,7,24,5552,5552,5545,5545
San Francisco,39,2022-09-12,814,814,814,0,17415,17450,17446,4,58,8,8,15,1054,1054,1046,1046
San Joaquin,39,2022-09-12,643,643,643,0,14275,14305,14303,2,35,6,6,9,2330,2330,2324,2324
San Luis Obispo,39,2022-09-12,187,187,187,0,3219,3226,3225,1,10,0,0,1,524,524,524,524
San Mateo,39,2022-09-12,658,658,658,0,14178,14207,14206,1,20,1,1,2,738,738,737,737
Santa Barbara,39,2022-09-12,329,329,329,0,7232,7246,7245,1,27,1,1,2,727,727,726,726
Santa Clara,39,2022-09-12,1882,1887,1887,0,38056,38132,38131,1,144,8,8,28,2515,2515,2507,2507
Santa Cruz,39,2022-09-12,272,272,272,0,13346,13373,13372,1,15,0,0,0,273,273,273,273
Shasta,39,2022-09-12,181,181,181,0,2589,2594,2593,1,26,1,1,2,588,588,587,587
Siskiyou,39,2022-09-12,27,27,27,0,289,290,289,1,1,0,0,0,89,89,89,89
Solano,39,2022-09-12,416,416,416,0,6739,6753,6752,1,32,0,0,4,457,457,457,457
Sonoma,39,2022-09-12,398,398,398,0,7021,7035,7034,1,39,3,3,1,523,523,520,520
Stanislaus,39,2022-09-12,447,447,447,0,7741,7755,7754,1,73,1,1,4,1778,1778,1777,1777
Sutter,39,2022-09-12,119,119,119,0,1531,1534,1533,1,0,0,0,0,232,232,232,232
Tehama,39,2022-09-12,48,48,48,0,699,700,699,1,2,0,0,0,213,213,213,213
Trinity,39,2022-09-12,2,2,2,0,74,75,74,1,0,0,0,0,21,21,21,21
Tulare,39,2022-09-12,370,370,370,0,6886,6899,6898,1,39,4,4,0,1537,1537,1533,1533
Tuolumne,39,2022-09-12,61,61,61,0,810,811,810,1,2,0,0,1,199,199,199,199
Ventura,39,2022-09-12,842,842,842,0,14804,14833,14832,1,49,1,1,7,1587,1587,1586,1586
Yolo,39,2022-09-12,143,143,143,0,3450,3458,3457,1,1,2,2,3,394,394,392,392
Yuba,39,2022-09-12,93,93,93,0,1162,1163,1162,1,6,0,0,0,122,122,122,122
Alameda,40,2022-09-19,1227,1227,1227,0,29125,29185,29183,2,80,4,4,7,2046,2046,2042,2042
Amador,40,2022-09-19,33,33,33,0,759,760,759,1,1,3,3,1,94,94,91,91
Butte,40,2022-09-19,121,121,121,0,2119,2124,2123,1,18,0,0,1,462,462,462,462
Calaveras,40,2022-09-19,28,28,28,0,476,477,476,1,0,0,0,0,133,133,133,133
Colusa,40,2022-09-19,13,13,13,0,289,290,289,1,3,0,0,0,22,22,22,22
Contra Costa,40,2022-09-19,826,826,826,0,16772,16807,16805,2,52,8,8,8,1452,1452,1444,1444
Del Norte,40,2022-09-19,22,22,22,0,478,479,478,1,2,0,0,0,55,55,55,55
El Dorado,40,2022-09-19,79,79,79,0,1616,1621,1620,1,3,0,0,0,233,233,233,233
Fresno,40,2022-09-19,606,606,606,0,13301,13328,13327,1,110,7,7,14,2877,2877,2870,2870
Glenn,40,2022-09-19,14,14,14,0,201,202,201,1,2,0,0,0,53,53,53,53
Humboldt,40,2022-09-19,105,105,105,0,1457,1462,1461,1,8,0,0,3,159,159,159,159
Imperial,40,2022-09-19,150,150,150,0,2866,2872,2871,1,11,0,0,2,961,961,961,961
Inyo,40,2022-09-19,8,8,8,0,169,170,169,1,0,0,0,0,60,60,60,60
Kern,40,2022-09-19,439,439,439,0,11535,11558,11557,1,34,2,2,6,2423,2423,2421,2421
Kings,40,2022-09-19,137,137,137,0,2642,2648,2647,1,7,2,2,0,464,464,462,462
Lake,40,2022-09-19,37,37,37,0,903,904,903,1,0,0,0,0,148,148,148,148
Lassen,40,2022-09-19,7,7,7,0,704,705,704,1,0,0,0,0,63,63,63,63
Los Angeles,40,2022-09-19,8528,8546,8546,0,254631,255160,255153,7,564,65,65,69,33529,33529,33464,33464
Madera,40,2022-09-19,109,109,109,0,2691,2697,2696,1,9,1,1,2,374,374,373,373
Marin,40,2022-09-19,137,137,137,0,3701,3710,3709,1,6,0,0,0,315,315,315,315
Mariposa,40,2022-09-19,12,12,12,0,170,171,170,1,0,1,1,0,30,30,29,29
Mendocino,40,2022-09-19,43,43,43,0,928,929,928,1,0,0,0,1,136,136,136,136
Merced,40,2022-09-19,170,170,170,0,2911,2917,2916,1,8,3,3,1,866,866,863,863
Modoc,40,2022-09-19,2,2,2,0,17,18,17,1,0,0,0,0,9,9,9,9
Mono,40,2022-09-19,4,4,4,0,63,64,63,1,0,0,0,0,7,7,7,7
Monterey,40,2022-09-19,162,162,162,0,4268,4278,4277,1,14,1,1,2,770,770,769,769
Napa,40,2022-09-19,101,101,101,0,1772,1778,1777,1,4,0,0,0,159,159,159,159
Nevada,40,2022-09-19,66,66,66,0,1110,1112,1111,1,2,0,0,0,136,136,136,136
Orange,40,2022-09-19,1722,1726,1726,0,33955,34025,34023,2,129,16,16,19,7509,7509,7493,7493
Placer,40,2022-09-19,223,223,223,0,3830,3838,3837,1,51,1,1,4,659,659,658,658
Plumas,40,2022-09-19,22,22,22,0,183,184,183,1,1,0,0,0,13,13,13,13
Riverside,40,2022-09-19,1416,1418,1418,0,29083,29144,29142,2,68,4,4,19,6631,6631,6627,6627
Sacramento,40,2022-09-19,1018,1018,1018,0,21293,21339,21337,2,102,7,7,17,3326,3326,3319,3319
San Benito,40,2022-09-19,54,54,54,0,1231,1234,1233,1,0,0,0,0,100,100,100,100
San Bernardino,40,2022-09-19,1465,1468,1468,0,32531,32598,32596,2,83,7,7,19,8086,8086,8079,8079
San Diego,40,2022-09-19,2562,2568,2568,0,55906,56023,56021,2,175,9,9,19,5561,5561,5552,5552
San Francisco,40,2022-09-19,690,690,690,0,16822,16858,16855,3,43,9,9,11,1063,1063,1054,1054
San Joaquin,40,2022-09-19,457,457,457,0,12858,12884,12883,1,35,5,5,2,2335,2335,2330,2330
San Luis Obispo,40,2022-09-19,155,155,155,0,2764,2770,2769,1,8,0,0,0,524,524,524,524
San Mateo,40,2022-09-19,585,585,585,0,13587,13616,13615,1,20,0,0,2,738,738,738,738
Santa Barbara,40,2022-09-19,269,269,269,0,6790,6803,6802,1,34,2,2,0,729,729,727,727
Santa Clara,40,2022-09-19,1415,1417,1417,0,37023,37100,37099,1,137,7,7,21,2522,2522,2515,2515
Santa Cruz,40,2022-09-19,148,148,148,0,12319,12344,12343,1,5,0,0,1,273,273,273,273
Shasta,40,2022-09-19,100,100,100,0,2112,2117,2116,1,21,0,0,3,588,588,588,588
Siskiyou,40,2022-09-19,21,21,21,0,233,234,233,1,2,1,1,0,90,90,89,89
Solano,40,2022-09-19,274,274,274,0,6128,6141,6140,1,24,1,1,5,458,458,457,457
Sonoma,40,2022-09-19,319,319,319,0,6359,6372,6371,1,27,3,3,1,526,526,523,523
Stanislaus,40,2022-09-19,333,333,333,0,6290,6304,6303,1,57,4,4,4,1782,1782,1778,1778
Sutter,40,2022-09-19,75,75,75,0,1388,1391,1390,1,0,0,0,0,232,232,232,232
Tehama,40,2022-09-19,35,35,35,0,599,600,599,1,2,1,1,0,214,214,213,213
Trinity,40,2022-09-19,3,3,3,0,53,54,53,1,0,0,0,0,21,21,21,21
Tulare,40,2022-09-19,234,234,234,0,5725,5737,5736,1,32,1,1,0,1538,1538,1537,1537
Tuolumne,40,2022-09-19,59,59,59,0,717,718,717,1,0,0,0,0,199,199,199,199
Ventura,40,2022-09-19,615,615,615,0,13372,13401,13400,1,42,2,2,6,1589,1589,1587,1587
Yolo,40,2022-09-19,83,83,83,0,3730,3738,3737,1,2,3,3,2,397,397,394,394
Yuba,40,2022-09-19,60,60,60,0,1029,1030,1029,1,3,0,0,0,122,122,122,122
Alameda,41,2022-09-26,1129,1129,1129,0,27663,27724,27723,1,77,2,2,4,2048,2048,2046,2046
Amador,41,2022-09-26,27,27,27,0,721,722,721,1,1,0,0,1,94,94,94,94
Butte,41,2022-09-26,90,90,90,0,1793,1798,1797,1,23,0,0,1,462,462,462,462
Calaveras,41,2022-09-26,20,20,20,0,390,391,390,1,2,1,1,0,134,134,133,133
Colusa,41,2022-09-26,7,7,7,0,299,300,299,1,1,0,0,0,22,22,22,22
Contra Costa,41,2022-09-26,775,775,775,0,16343,16378,16377,1,48,5,5,7,1457,1457,1452,1452
Del Norte,41,2022-09-26,22,22,22,0,469,470,469,1,2,0,0,0,55,55,55,55
El Dorado,41,2022-09-26,86,86,86,0,1580,1584,1583,1,5,0,0,0,233,233,233,233
Fresno,41,2022-09-26,517,517,517,0,12119,12147,12146,1,84,3,3,13,2880,2880,2877,2877
Glenn,41,2022-09-26,7,7,7,0,176,177,176,1,2,0,0,0,53,53,53,53
Humboldt,41,2022-09-26,98,98,98,0,1311,1314,1313,1,10,2,2,0,161,161,159,159
Imperial,41,2022-09-26,115,115,115,0,2628,2634,2633,1,4,1,1,1,962,962,961,961
Inyo,41,2022-09-26,5,5,5,0,165,166,165,1,0,0,0,0,60,60,60,60
Kern,41,2022-09-26,344,344,344,0,10734,10757,10756,1,32,3,3,7,2426,2426,2423,2423
Kings,41,2022-09-26,107,107,107,0,2620,2626,2625,1,2,0,0,0,464,464,464,464
Lake,41,2022-09-26,26,26,26,0,815,816,815,1,0,0,0,0,148,148,148,148
Lassen,41,2022-09-26,13,13,13,0,533,534,533,1,0,0,0,0,63,63,63,63
Los Angeles,41,2022-09-26,7699,7716,7716,0,239300,239821,239816,5,443,63,63,53,33592,33592,33529,33529
Madera,41,2022-09-26,84,84,84,0,2231,2236,2235,1,8,0,0,2,374,374,374,374
Marin,41,2022-09-26,173,173,173,0,3657,3666,3665,1,10,0,0,0,315,315,315,315
Mariposa,41,2022-09-26,4,4,4,0,155,156,155,1,0,0,0,0,30,30,30,30
Mendocino,41,2022-09-26,41,41,41,0,850,851,850,1,1,0,0,0,136,136,136,136
Merced,41,2022-09-26,127,127,127,0,2854,2861,2860,1,10,1,1,0,867,867,866,866
Modoc,41,2022-09-26,0,0,0,0,13,14,13,1,0,0,0,0,9,9,9,9
Mono,41,2022-09-26,1,1,1,0,60,61,60,1,0,0,0,0,7,7,7,7
Monterey,41,2022-09-26,135,135,135,0,4050,4059,4058,1,14,0,0,2,770,770,770,770
Napa,41,2022-09-26,85,85,85,0,1955,1961,1960,1,5,0,0,1,159,159,159,159
Nevada,41,2022-09-26,49,49,49,0,1077,1079,1078,1,1,0,0,0,136,136,136,136
Orange,41,2022-09-26,1672,1676,1676,0,31082,31151,31149,2,117,19,19,23,7528,7528,7509,7509
Placer,41,2022-09-26,209,209,209,0,3592,3601,3600,1,42,1,1,4,660,660,659,659
Plumas,41,2022-09-26,21,21,21,0,151,152,151,1,1,0,0,0,13,13,13,13
Riverside,41,2022-09-26,1280,1281,1281,0,25783,25839,25837,2,55,8,8,15,6639,6639,6631,6631
Sacramento,41,2022-09-26,918,918,918,0,19151,19192,19191,1,106,11,11,20,3337,3337,3326,3326
San Benito,41,2022-09-26,50,50,50,0,1160,1163,1162,1,0,1,1,2,101,101,100,100
San Bernardino,41,2022-09-26,1217,1218,1218,0,27813,27874,27873,1,75,5,5,12,8091,8091,8086,8086
San Diego,41,2022-09-26,2484,2490,2490,0,50929,51041,51040,1,201,7,7,15,5568,5568,5561,5561
San Francisco,41,2022-09-26,677,677,677,0,16151,16187,16185,2,45,2,2,9,1065,1065,1063,1063
San Joaquin,41,2022-09-26,408,408,408,0,11073,11098,11097,1,35,1,1,3,2336,2336,2335,2335
San Luis Obispo,41,2022-09-26,131,131,131,0,2520,2526,2525,1,7,1,1,0,525,525,524,524
San Mateo,41,2022-09-26,593,593,593,0,13030,13059,13058,1,25,0,0,1,738,738,738,738
Santa Barbara,41,2022-09-26,259,259,259,0,6379,6394,6393,1,22,2,2,0,731,731,729,729
Santa Clara,41,2022-09-26,1363,1364,1364,0,35857,35935,35934,1,113,10,10,17,2532,2532,2522,2522
Santa Cruz,41,2022-09-26,225,225,225,0,12503,12529,12528,1,13,0,0,0,273,273,273,273
Shasta,41,2022-09-26,74,74,74,0,1739,1744,1743,1,14,0,0,3,588,588,588,588
Siskiyou,41,2022-09-26,18,18,18,0,183,184,183,1,1,2,2,0,92,92,90,90
Solano,41,2022-09-26,310,310,310,0,5728,5742,5741,1,23,1,1,2,459,459,458,458
Sonoma,41,2022-09-26,291,291,291,0,6334,6348,6347,1,31,1,1,2,527,527,526,526
Stanislaus,41,2022-09-26,261,261,261,0,5812,5825,5824,1,46,2,2,3,1784,1784,1782,1782
Sutter,41,2022-09-26,69,69,69,0,1146,1148,1147,1,0,0,0,0,232,232,232,232
Tehama,41,2022-09-26,36,36,36,0,550,551,550,1,1,2,2,0,216,216,214,214
Trinity,41,2022-09-26,3,3,3,0,44,45,44,1,0,0,0,0,21,21,21,21
Tulare,41,2022-09-26,168,168,168,0,5090,5101,5100,1,18,3,3,2,1541,1541,1538,1538
Tuolumne,41,2022-09-26,44,44,44,0,689,690,689,1,1,0,0,0,199,199,199,199
Ventura,41,2022-09-26,551,551,551,0,11570,11597,11596,1,33,4,4,1,1593,1593,1589,1589
Yolo,41,2022-09-26,129,129,129,0,3979,3989,3988,1,2,3,3,3,400,400,397,397
Yuba,41,2022-09-26,41,41,41,0,933,934,933,1,6,0,0,1,122,122,122,122
Alameda,42,2022-10-03,1123,1123,1123,0,26140,26198,26197,1,54,3,3,5,2051,2051,2048,2048
Amador,42,2022-10-03,14,14,14,0,690,691,690,1,0,0,0,1,94,94,94,94
Butte,42,2022-10-03,67,67,67,0,1751,1756,1755,1,11,2,2,2,464,464,462,462
Calaveras,42,2022-10-03,20,20,20,0,336,337,336,1,1,0,0,0,134,134,134,134
Colusa,42,2022-10-03,7,7,7,0,188,189,188,1,0,0,0,0,22,22,22,22
Contra Costa,42,2022-10-03,741,741,741,0,15771,15808,15807,1,34,3,3,6,1460,1460,1457,1457
Del Norte,42,2022-10-03,12,12,12,0,382,383,382,1,1,0,0,1,55,55,55,55
El Dorado,42,2022-10-03,80,80,80,0,1449,1454,1453,1,3,0,0,1,233,233,233,233
Fresno,42,2022-10-03,463,463,463,0,11208,11233,11232,1,77,2,2,11,2882,2882,2880,2880
Glenn,42,2022-10-03,7,7,7,0,155,156,155,1,0,0,0,0,53,53,53,53
Humboldt,42,2022-10-03,79,79,79,0,1157,1159,1158,1,6,0,0,1,161,161,161,161
Imperial,42,2022-10-03,140,140,140,0,2564,2570,2569,1,6,0,0,0,962,962,962,962
Inyo,42,2022-10-03,5,5,5,0,159,160,159,1,0,0,0,1,60,60,60,60
Kern,42,2022-10-03,285,285,285,0,9961,9984,9983,1,24,4,4,5,2430,2430,2426,2426
Kings,42,2022-10-03,87,87,87,0,2414,2420,2419,1,2,0,0,0,464,464,464,464
Lake,42,2022-10-03,35,35,35,0,759,760,759,1,3,1,1,0,149,149,148,148
Lassen,42,2022-10-03,7,7,7,0,530,531,530,1,2,0,0,0,63,63,63,63
Los Angeles,42,2022-10-03,7004,7021,7021,0,220019,220521,220517,4,439,50,50,69,33642,33642,33592,33592
Madera,42,2022-10-03,65,65,65,0,1563,1568,1567,1,6,0,0,2,374,374,374,374
Marin,42,2022-10-03,191,191,191,0,3475,3483,3482,1,6,0,0,2,315,315,315,315
Mariposa,42,2022-10-03,5,5,5,0,131,132,131,1,0,0,0,0,30,30,30,30
Mendocino,42,2022-10-03,50,50,50,0,778,779,778,1,4,0,0,0,136,136,136,136
Merced,42,2022-10-03,109,109,109,0,2610,2616,2615,1,5,3,3,1,870,870,867,867
Modoc,42,2022-10-03,2,2,2,0,14,15,14,1,0,0,0,0,9,9,9,9
Mono,42,2022-10-03,4,4,4,0,69,70,69,1,0,0,0,0,7,7,7,7
Monterey,42,2022-10-03,111,111,111,0,3785,3796,3795,1,11,1,1,1,771,771,770,770
Napa,42,2022-10-03,88,88,88,0,1698,1704,1703,1,4,0,0,2,159,159,159,159
Nevada,42,2022-10-03,51,51,51,0,954,956,955,1,1,0,0,4,136,136,136,136
Orange,42,2022-10-03,1533,1538,1538,0,27925,27988,27987,1,131,22,22,16,7550,7550,7528,7528
Placer,42,2022-10-03,208,208,208,0,3336,3345,3344,1,41,2,2,3,662,662,660,660
Plumas,42,2022-10-03,12,12,12,0,107,108,107,1,1,0,0,0,13,13,13,13
Riverside,42,2022-10-03,1138,1138,1138,0,22051,22102,22101,1,59,7,7,12,6646,6646,6639,6639
Sacramento,42,2022-10-03,901,901,901,0,18059,18100,18099,1,88,12,12,19,3349,3349,3337,3337
San Benito,42,2022-10-03,34,34,34,0,1105,1108,1107,1,0,0,0,0,101,101,101,101
San Bernardino,42,2022-10-03,1210,1212,1212,0,24842,24898,24897,1,77,4,4,7,8095,8095,8091,8091
San Diego,42,2022-10-03,2085,2090,2090,0,46607,46715,46714,1,162,9,9,18,5577,5577,5568,5568
San Francisco,42,2022-10-03,646,646,646,0,15333,15369,15367,2,44,3,3,9,1068,1068,1065,1065
San Joaquin,42,2022-10-03,343,343,343,0,9932,9955,9954,1,25,4,4,3,2340,2340,2336,2336
San Luis Obispo,42,2022-10-03,150,150,150,0,2382,2388,2387,1,2,1,1,1,526,526,525,525
San Mateo,42,2022-10-03,549,549,549,0,12299,12328,12327,1,22,0,0,2,738,738,738,738
Santa Barbara,42,2022-10-03,253,253,253,0,6288,6304,6303,1,15,0,0,2,731,731,731,731
Santa Clara,42,2022-10-03,1402,1404,1404,0,32167,32240,32239,1,109,6,6,20,2538,2538,2532,2532
Santa Cruz,42,2022-10-03,227,227,227,0,11229,11255,11254,1,10,0,0,1,273,273,273,273
Shasta,42,2022-10-03,55,55,55,0,1441,1445,1444,1,10,0,0,2,588,588,588,588
Siskiyou,42,2022-10-03,10,10,10,0,204,205,204,1,0,0,0,0,92,92,92,92
Solano,42,2022-10-03,251,251,251,0,5361,5375,5374,1,17,0,0,2,459,459,459,459
Sonoma,42,2022-10-03,323,323,323,0,5932,5946,5945,1,17,0,0,3,527,527,527,527
Stanislaus,42,2022-10-03,200,200,200,0,5353,5367,5366,1,49,1,1,6,1785,1785,1784,1784
Sutter,42,2022-10-03,57,57,57,0,1108,1110,1109,1,0,0,0,0,232,232,232,232
Tehama,42,2022-10-03,20,20,20,0,526,527,526,1,1,0,0,0,216,216,216,216
Trinity,42,2022-10-03,1,1,1,0,43,44,43,1,0,0,0,0,21,21,21,21
Tulare,42,2022-10-03,163,163,163,0,5046,5058,5057,1,19,4,4,1,1545,1545,1541,1541
Tuolumne,42,2022-10-03,26,26,26,0,622,623,622,1,0,0,0,0,199,199,199,199
Ventura,42,2022-10-03,477,477,477,0,10424,10449,10448,1,41,2,2,2,1595,1595,1593,1593
Yolo,42,2022-10-03,122,122,122,0,2986,2993,2992,1,3,2,2,2,402,402,400,400
Yuba,42,2022-10-03,35,35,35,0,801,802,801,1,4,0,0,1,122,122,122,122
Alameda,43,2022-10-10,1133,1133,1133,0,27784,27851,27850,1,45,2,2,7,2053,2053,2051,2051
Amador,43,2022-10-10,15,15,15,0,801,802,801,1,0,0,0,2,94,94,94,94
Butte,43,2022-10-10,65,65,65,0,1750,1754,1753,1,12,3,3,1,466,466,463,463
Calaveras,43,2022-10-10,15,15,15,0,374,375,374,1,0,1,1,0,135,135,134,134
Colusa,43,2022-10-10,1,1,1,0,120,121,120,1,1,0,0,0,22,22,22,22
Contra Costa,43,2022-10-10,774,774,774,0,16851,16893,16892,1,31,7,7,6,1465,1465,1458,1458
Del Norte,43,2022-10-10,10,10,10,0,492,493,492,1,1,0,0,1,55,55,55,55
El Dorado,43,2022-10-10,81,81,81,0,1748,1755,1754,1,7,0,0,4,233,233,233,233
Fresno,43,2022-10-10,483,483,483,0,12471,12500,12499,1,60,3,3,9,2885,2885,2882,2882
Glenn,43,2022-10-10,10,10,10,0,226,227,226,1,1,0,0,0,53,53,53,53
Humboldt,43,2022-10-10,98,98,98,0,1418,1422,1421,1,7,1,1,0,162,162,161,161
Imperial,43,2022-10-10,203,203,203,0,2960,2967,2966,1,7,0,0,0,962,962,962,962
Inyo,43,2022-10-10,4,4,4,0,123,124,123,1,0,0,0,0,60,60,60,60
Kern,43,2022-10-10,325,325,325,0,11655,11683,11682,1,24,2,2,2,2432,2432,2430,2430
Kings,43,2022-10-10,102,102,102,0,2751,2758,2757,1,1,1,1,0,465,465,464,464
Lake,43,2022-10-10,33,33,33,0,920,921,920,1,1,0,0,0,149,149,149,149
Lassen,43,2022-10-10,3,3,3,0,573,574,573,1,0,0,0,0,63,63,63,63
Los Angeles,43,2022-10-10,6734,6748,6748,0,226552,227098,227095,3,436,70,70,51,33704,33704,33634,33634
Madera,43,2022-10-10,68,68,68,0,1717,1723,1722,1,7,1,1,2,375,375,374,374
Marin,43,2022-10-10,207,207,207,0,3777,3787,3786,1,9,0,0,0,315,315,315,315
Mariposa,43,2022-10-10,8,8,8,0,128,129,128,1,0,0,0,0,30,30,30,30
Mendocino,43,2022-10-10,32,32,32,0,973,974,973,1,1,0,0,2,136,136,136,136
Merced,43,2022-10-10,111,111,111,0,2788,2795,2794,1,8,1,1,3,871,871,870,870
Modoc,43,2022-10-10,5,5,5,0,12,13,12,1,0,0,0,0,9,9,9,9
Mono,43,2022-10-10,1,1,1,0,55,56,55,1,0,0,0,0,7,7,7,7
Monterey,43,2022-10-10,108,108,108,0,4372,4385,4384,1,9,0,0,1,771,771,771,771
Napa,43,2022-10-10,78,78,78,0,1768,1774,1773,1,3,0,0,2,159,159,159,159
Nevada,43,2022-10-10,42,42,42,0,980,981,980,1,1,0,0,1,136,136,136,136
Orange,43,2022-10-10,1476,1479,1479,0,29654,29726,29725,1,129,14,14,19,7562,7562,7548,7548
Placer,43,2022-10-10,187,187,187,0,3819,3828,3827,1,24,0,0,7,662,662,662,662
Plumas,43,2022-10-10,20,20,20,0,106,107,106,1,0,0,0,0,13,13,13,13
Riverside,43,2022-10-10,1177,1177,1177,0,23898,23956,23955,1,56,5,5,4,6651,6651,6646,6646
Sacramento,43,2022-10-10,943,943,943,0,20312,20360,20359,1,81,5,5,16,3354,3354,3349,3349
San Benito,43,2022-10-10,35,35,35,0,1267,1271,1270,1,3,0,0,0,101,101,101,101
San Bernardino,43,2022-10-10,1096,1096,1096,0,27130,27196,27195,1,66,0,0,13,8095,8095,8095,8095
San Diego,43,2022-10-10,1991,1997,1997,0,51325,51449,51448,1,130,7,7,21,5582,5582,5575,5575
San Francisco,43,2022-10-10,687,687,687,0,16055,16094,16093,1,37,2,2,9,1070,1070,1068,1068
San Joaquin,43,2022-10-10,431,431,431,0,11577,11605,11604,1,17,2,2,8,2342,2342,2340,2340
San Luis Obispo,43,2022-10-10,88,88,88,0,2567,2574,2573,1,2,2,2,0,528,528,526,526
San Mateo,43,2022-10-10,647,647,647,0,13627,13661,13660,1,19,0,0,0,738,738,738,738
Santa Barbara,43,2022-10-10,242,242,242,0,7841,7861,7860,1,20,1,1,1,732,732,731,731
Santa Clara,43,2022-10-10,1423,1426,1426,0,34086,34170,34169,1,107,4,4,18,2542,2542,2538,2538
Santa Cruz,43,2022-10-10,338,338,338,0,12278,12310,12309,1,9,0,0,1,273,273,273,273
Shasta,43,2022-10-10,99,99,99,0,1292,1295,1294,1,13,3,3,1,591,591,588,588
Siskiyou,43,2022-10-10,9,9,9,0,244,245,244,1,0,1,1,0,93,93,92,92
Solano,43,2022-10-10,333,333,333,0,6278,6295,6294,1,23,0,0,4,459,459,459,459
Sonoma,43,2022-10-10,288,288,288,0,6771,6788,6787,1,15,1,1,3,528,528,527,527
Stanislaus,43,2022-10-10,208,208,208,0,5925,5940,5939,1,51,7,7,7,1790,1790,1783,1783
Sutter,43,2022-10-10,57,57,57,0,1126,1128,1127,1,0,0,0,0,232,232,232,232
Tehama,43,2022-10-10,21,21,21,0,566,567,566,1,1,0,0,0,216,216,216,216
Trinity,43,2022-10-10,1,1,1,0,53,54,53,1,0,0,0,0,21,21,21,21
Tulare,43,2022-10-10,170,170,170,0,4979,4991,4990,1,16,1,1,1,1546,1546,1545,1545
Tuolumne,43,2022-10-10,36,36,36,0,661,662,661,1,1,1,1,0,200,200,199,199
Ventura,43,2022-10-10,430,430,430,0,10969,10997,10996,1,41,4,4,1,1598,1598,1594,1594
Yolo,43,2022-10-10,126,126,126,0,3087,3095,3094,1,4,2,2,0,404,404,402,402
Yuba,43,2022-10-10,23,23,23,0,924,925,924,1,0,0,0,0,122,122,122,122
Alameda,44,2022-10-17,913,913,913,0,24484,24546,24545,1,60,5,5,8,2058,2058,2053,2053
Amador,44,2022-10-17,15,15,15,0,591,592,591,1,1,0,0,0,94,94,94,94
Butte,44,2022-10-17,76,76,76,0,1424,1430,1429,1,13,0,0,0,466,466,466,466
Calaveras,44,2022-10-17,19,19,19,0,306,307,306,1,0,0,0,0,135,135,135,135
Colusa,44,2022-10-17,4,4,4,0,80,81,80,1,0,0,0,0,22,22,22,22
Contra Costa,44,2022-10-17,669,669,669,0,14536,14573,14572,1,30,4,4,6,1469,1469,1465,1465
Del Norte,44,2022-10-17,11,11,11,0,379,380,379,1,1,0,0,0,55,55,55,55
El Dorado,44,2022-10-17,89,89,89,0,1380,1385,1384,1,2,0,0,1,233,233,233,233
Fresno,44,2022-10-17,349,349,349,0,10197,10224,10223,1,62,2,2,11,2887,2887,2885,2885
Glenn,44,2022-10-17,6,6,6,0,141,142,141,1,1,0,0,0,53,53,53,53
Humboldt,44,2022-10-17,70,70,70,0,1146,1149,1148,1,1,0,0,0,162,162,162,162
Imperial,44,2022-10-17,117,117,117,0,2320,2326,2325,1,5,0,0,0,962,962,962,962
Inyo,44,2022-10-17,6,6,6,0,122,123,122,1,1,0,0,0,60,60,60,60
Kern,44,2022-10-17,230,230,230,0,9626,9652,9651,1,32,0,0,1,2432,2432,2432,2432
Kings,44,2022-10-17,70,70,70,0,2320,2326,2325,1,2,0,0,0,465,465,465,465
Lake,44,2022-10-17,25,25,25,0,774,776,775,1,1,0,0,0,149,149,149,149
Lassen,44,2022-10-17,7,7,7,0,513,514,513,1,1,0,0,0,63,63,63,63
Los Angeles,44,2022-10-17,5075,5087,5087,0,188184,188662,188660,2,350,41,41,53,33745,33745,33704,33704
Madera,44,2022-10-17,59,59,59,0,1465,1470,1469,1,3,0,0,2,375,375,375,375
Marin,44,2022-10-17,132,132,132,0,3095,3104,3103,1,8,0,0,1,315,315,315,315
Mariposa,44,2022-10-17,6,6,6,0,119,120,119,1,0,0,0,0,30,30,30,30
Mendocino,44,2022-10-17,48,48,48,0,742,743,742,1,2,0,0,0,136,136,136,136
Merced,44,2022-10-17,129,129,129,0,2343,2349,2348,1,15,0,0,2,871,871,871,871
Modoc,44,2022-10-17,1,1,1,0,7,8,7,1,0,0,0,0,9,9,9,9
Mono,44,2022-10-17,6,6,6,0,41,42,41,1,1,0,0,0,7,7,7,7
Monterey,44,2022-10-17,125,125,125,0,3550,3561,3560,1,12,1,1,1,772,772,771,771
Napa,44,2022-10-17,60,60,60,0,1416,1421,1420,1,2,0,0,1,159,159,159,159
Nevada,44,2022-10-17,49,49,49,0,777,778,777,1,0,0,0,5,136,136,136,136
Orange,44,2022-10-17,1084,1085,1085,0,24751,24814,24813,1,91,21,21,18,7583,7583,7562,7562
Placer,44,2022-10-17,148,148,148,0,2919,2928,2927,1,32,0,0,3,662,662,662,662
Plumas,44,2022-10-17,11,11,11,0,98,99,98,1,0,0,0,0,13,13,13,13
Riverside,44,2022-10-17,885,885,885,0,20669,20722,20721,1,66,2,2,2,6653,6653,6651,6651
Sacramento,44,2022-10-17,853,853,853,0,16072,16113,16112,1,84,9,9,14,3363,3363,3354,3354
San Benito,44,2022-10-17,28,28,28,0,880,882,881,1,0,1,1,0,102,102,101,101
San Bernardino,44,2022-10-17,816,816,816,0,23222,23280,23279,1,63,1,1,9,8096,8096,8095,8095
San Diego,44,2022-10-17,1648,1654,1654,0,43407,43517,43516,1,117,8,8,24,5590,5590,5582,5582
San Francisco,44,2022-10-17,564,564,564,0,14423,14460,14459,1,34,3,3,13,1073,1073,1070,1070
San Joaquin,44,2022-10-17,353,353,353,0,9076,9101,9100,1,8,2,2,8,2344,2344,2342,2342
San Luis Obispo,44,2022-10-17,109,109,109,0,2130,2136,2135,1,4,1,1,0,529,529,528,528
San Mateo,44,2022-10-17,542,542,542,0,11236,11266,11265,1,21,0,0,1,738,738,738,738
Santa Barbara,44,2022-10-17,182,182,182,0,5624,5640,5639,1,18,0,0,2,732,732,732,732
Santa Clara,44,2022-10-17,1136,1137,1137,0,28440,28513,28512,1,93,5,5,16,2547,2547,2542,2542
Santa Cruz,44,2022-10-17,284,284,284,0,10290,10317,10316,1,7,1,1,0,274,274,273,273
Shasta,44,2022-10-17,82,82,82,0,1105,1108,1107,1,12,0,0,2,591,591,591,591
Siskiyou,44,2022-10-17,12,12,12,0,181,182,181,1,2,1,1,0,94,94,93,93
Solano,44,2022-10-17,265,265,265,0,4845,4859,4858,1,25,1,1,3,460,460,459,459
Sonoma,44,2022-10-17,244,244,244,0,5371,5385,5384,1,20,1,1,1,529,529,528,528
Stanislaus,44,2022-10-17,222,222,222,0,5293,5308,5307,1,45,1,1,5,1791,1791,1790,1790
Sutter,44,2022-10-17,40,40,40,0,909,912,911,1,0,0,0,0,232,232,232,232
Tehama,44,2022-10-17,21,21,21,0,396,397,396,1,0,0,0,0,216,216,216,216
Trinity,44,2022-10-17,0,0,0,0,34,35,34,1,0,0,0,0,21,21,21,21
Tulare,44,2022-10-17,136,136,136,0,4269,4280,4279,1,11,1,1,1,1547,1547,1546,1546
Tuolumne,44,2022-10-17,35,35,35,0,620,621,620,1,2,0,0,0,200,200,200,200
Ventura,44,2022-10-17,376,376,376,0,9333,9358,9357,1,32,3,3,1,1601,1601,1598,1598
Yolo,44,2022-10-17,103,103,103,0,2204,2211,2210,1,3,2,2,3,406,406,404,404
Yuba,44,2022-10-17,44,44,44,0,767,768,767,1,1,0,0,0,122,122,122,122
Alameda,45,2022-10-24,925,926,926,0,23194,23256,23255,1,46,8,8,10,2066,2066,2058,2058
Amador,45,2022-10-24,18,18,18,0,635,636,635,1,2,0,0,0,94,94,94,94
Butte,45,2022-10-24,68,68,68,0,1406,1411,1410,1,10,1,1,1,467,467,466,466
Calaveras,45,2022-10-24,20,20,20,0,322,323,322,1,0,0,0,0,135,135,135,135
Colusa,45,2022-10-24,3,3,3,0,95,96,95,1,0,0,0,0,22,22,22,22
Contra Costa,45,2022-10-24,624,624,624,0,13908,13947,13946,1,37,5,5,5,1474,1474,1469,1469
Del Norte,45,2022-10-24,6,6,6,0,361,362,361,1,0,0,0,1,55,55,55,55
El Dorado,45,2022-10-24,91,91,91,0,1519,1525,1524,1,1,0,0,0,233,233,233,233
Fresno,45,2022-10-24,376,376,376,0,9743,9770,9769,1,63,0,0,6,2887,2887,2887,2887
Glenn,45,2022-10-24,9,9,9,0,148,149,148,1,0,0,0,0,53,53,53,53
Humboldt,45,2022-10-24,69,69,69,0,1148,1151,1150,1,7,0,0,2,162,162,162,162
Imperial,45,2022-10-24,96,96,96,0,2344,2350,2349,1,8,1,1,0,963,963,962,962
Inyo,45,2022-10-24,8,8,8,0,272,273,272,1,0,0,0,0,60,60,60,60
Kern,45,2022-10-24,269,269,269,0,9631,9659,9658,1,24,2,2,2,2434,2434,2432,2432
Kings,45,2022-10-24,88,88,88,0,2338,2345,2344,1,8,0,0,0,465,465,465,465
Lake,45,2022-10-24,22,22,22,0,643,644,643,1,1,1,1,1,150,150,149,149
Lassen,45,2022-10-24,16,16,16,0,484,485,484,1,1,0,0,0,63,63,63,63
Los Angeles,45,2022-10-24,5316,5330,5330,0,185815,186320,186318,2,332,54,54,43,33799,33799,33745,33745
Madera,45,2022-10-24,61,61,61,0,1388,1393,1392,1,4,0,0,2,375,375,375,375
Marin,45,2022-10-24,138,138,138,0,3079,3089,3088,1,12,1,1,2,316,316,315,315
Mariposa,45,2022-10-24,12,12,12,0,120,121,120,1,0,0,0,0,30,30,30,30
Mendocino,45,2022-10-24,42,42,42,0,770,771,770,1,2,0,0,0,136,136,136,136
Merced,45,2022-10-24,88,88,88,0,2409,2415,2414,1,7,3,3,3,874,874,871,871
Modoc,45,2022-10-24,1,1,1,0,13,14,13,1,0,0,0,0,9,9,9,9
Mono,45,2022-10-24,3,3,3,0,63,64,63,1,0,1,1,0,8,8,7,7
Monterey,45,2022-10-24,131,131,131,0,3718,3729,3728,1,18,0,0,0,772,772,772,772
Napa,45,2022-10-24,51,51,51,0,1468,1474,1473,1,3,0,0,0,159,159,159,159
Nevada,45,2022-10-24,38,38,38,0,784,786,785,1,6,0,0,0,136,136,136,136
Orange,45,2022-10-24,1129,1131,1131,0,25652,25721,25720,1,84,11,11,14,7594,7594,7583,7583
Placer,45,2022-10-24,190,190,190,0,3026,3035,3034,1,39,0,0,6,662,662,662,662
Plumas,45,2022-10-24,12,12,12,0,91,92,91,1,0,0,0,0,13,13,13,13
Riverside,45,2022-10-24,919,920,920,0,20049,20103,20102,1,53,0,0,6,6653,6653,6653,6653
Sacramento,45,2022-10-24,798,798,798,0,15200,15241,15240,1,84,5,5,19,3368,3368,3363,3363
San Benito,45,2022-10-24,41,41,41,0,844,846,845,1,0,0,0,1,102,102,102,102
San Bernardino,45,2022-10-24,778,778,778,0,21411,21468,21467,1,39,3,3,10,8099,8099,8096,8096
San Diego,45,2022-10-24,1684,1689,1689,0,41861,41974,41973,1,83,5,5,18,5595,5595,5590,5590
San Francisco,45,2022-10-24,508,508,508,0,13870,13907,13906,1,35,1,1,5,1074,1074,1073,1073
San Joaquin,45,2022-10-24,271,271,271,0,8493,8518,8517,1,13,2,2,3,2346,2346,2344,2344
San Luis Obispo,45,2022-10-24,89,89,89,0,2053,2059,2058,1,2,0,0,0,529,529,529,529
San Mateo,45,2022-10-24,466,466,466,0,11067,11097,11096,1,19,0,0,2,738,738,738,738
Santa Barbara,45,2022-10-24,164,164,164,0,5728,5744,5743,1,19,2,2,4,734,734,732,732
Santa Clara,45,2022-10-24,1181,1183,1183,0,29140,29221,29220,1,92,3,3,9,2550,2550,2547,2547
Santa Cruz,45,2022-10-24,240,240,240,0,10202,10232,10231,1,14,1,1,0,275,275,274,274
Shasta,45,2022-10-24,73,73,73,0,983,985,984,1,5,0,0,2,591,591,591,591
Siskiyou,45,2022-10-24,12,12,12,0,171,172,171,1,0,0,0,0,94,94,94,94
Solano,45,2022-10-24,239,239,239,0,5022,5036,5035,1,20,0,0,1,460,460,460,460
Sonoma,45,2022-10-24,246,246,246,0,5438,5452,5451,1,23,0,0,1,529,529,529,529
Stanislaus,45,2022-10-24,199,199,199,0,4851,4865,4864,1,40,3,3,3,1794,1794,1791,1791
Sutter,45,2022-10-24,28,28,28,0,881,884,883,1,0,0,0,0,232,232,232,232
Tehama,45,2022-10-24,36,36,36,0,405,406,405,1,1,0,0,0,216,216,216,216
Trinity,45,2022-10-24,1,1,1,0,35,36,35,1,0,0,0,0,21,21,21,21
Tulare,45,2022-10-24,110,110,110,0,4341,4353,4352,1,16,1,1,1,1548,1548,1547,1547
Tuolumne,45,2022-10-24,33,33,33,0,625,626,625,1,1,1,1,0,201,201,200,200
Ventura,45,2022-10-24,293,293,293,0,9021,9047,9046,1,40,3,3,6,1604,1604,1601,1601
Yolo,45,2022-10-24,91,91,91,0,2042,2050,2049,1,5,1,1,0,407,407,406,406
Yuba,45,2022-10-24,51,51,51,0,799,800,799,1,5,0,0,1,122,122,122,122
Alameda,46,2022-10-31,1030,1031,1031,0,22825,22891,22890,1,57,5,5,4,2071,2071,2066,2066
Amador,46,2022-10-31,18,18,18,0,577,578,577,1,2,1,1,0,95,95,94,94
Butte,46,2022-10-31,82,82,82,0,1458,1464,1463,1,11,0,0,3,467,467,467,467
Calaveras,46,2022-10-31,13,13,13,0,257,258,257,1,0,0,0,0,135,135,135,135
Colusa,46,2022-10-31,11,11,11,0,95,96,95,1,0,0,0,0,22,22,22,22
Contra Costa,46,2022-10-31,748,748,748,0,13885,13925,13924,1,37,6,6,7,1480,1480,1474,1474
Del Norte,46,2022-10-31,16,16,16,0,357,358,357,1,1,0,0,0,55,55,55,55
El Dorado,46,2022-10-31,100,100,100,0,1404,1410,1409,1,2,0,0,0,233,233,233,233
Fresno,46,2022-10-31,426,426,426,0,10495,10528,10527,1,57,4,4,8,2891,2891,2887,2887
Glenn,46,2022-10-31,16,16,16,0,156,157,156,1,1,0,0,0,53,53,53,53
Humboldt,46,2022-10-31,44,44,44,0,1019,1023,1022,1,6,0,0,2,162,162,162,162
Imperial,46,2022-10-31,126,126,126,0,2786,2796,2795,1,7,0,0,0,963,963,963,963
Inyo,46,2022-10-31,7,7,7,0,242,243,242,1,0,0,0,0,60,60,60,60
Kern,46,2022-10-31,330,330,330,0,9783,9812,9811,1,20,2,2,2,2436,2436,2434,2434
Kings,46,2022-10-31,117,117,117,0,2460,2468,2467,1,3,0,0,1,465,465,465,465
Lake,46,2022-10-31,30,30,30,0,752,754,753,1,1,0,0,1,150,150,150,150
Lassen,46,2022-10-31,19,19,19,0,522,523,522,1,1,0,0,0,63,63,63,63
Los Angeles,46,2022-10-31,6202,6222,6222,0,190969,191527,191525,2,344,37,37,44,33836,33836,33799,33799
Madera,46,2022-10-31,54,54,54,0,1433,1441,1440,1,3,0,0,2,375,375,375,375
Marin,46,2022-10-31,137,137,137,0,3505,3517,3516,1,10,1,1,1,317,317,316,316
Mariposa,46,2022-10-31,8,8,8,0,126,127,126,1,0,0,0,0,30,30,30,30
Mendocino,46,2022-10-31,23,23,23,0,709,710,709,1,1,0,0,2,136,136,136,136
Merced,46,2022-10-31,114,114,114,0,2138,2144,2143,1,5,1,1,0,875,875,874,874
Modoc,46,2022-10-31,1,1,1,0,13,14,13,1,0,0,0,0,9,9,9,9
Mono,46,2022-10-31,1,1,1,0,85,86,85,1,1,0,0,0,8,8,8,8
Monterey,46,2022-10-31,150,150,150,0,3688,3699,3698,1,18,2,2,0,774,774,772,772
Napa,46,2022-10-31,54,54,54,0,1506,1512,1511,1,2,0,0,0,159,159,159,159
Nevada,46,2022-10-31,37,37,37,0,774,776,775,1,6,0,0,0,136,136,136,136
Orange,46,2022-10-31,1151,1156,1156,0,26767,26845,26844,1,91,14,14,14,7608,7608,7594,7594
Placer,46,2022-10-31,149,149,149,0,2746,2754,2753,1,40,0,0,5,662,662,662,662
Plumas,46,2022-10-31,5,5,5,0,87,88,87,1,0,0,0,0,13,13,13,13
Riverside,46,2022-10-31,1029,1030,1030,0,19442,19499,19498,1,64,5,5,5,6658,6658,6653,6653
Sacramento,46,2022-10-31,730,730,730,0,14046,14087,14086,1,80,8,8,16,3376,3376,3368,3368
San Benito,46,2022-10-31,33,33,33,0,744,745,744,1,1,0,0,1,102,102,102,102
San Bernardino,46,2022-10-31,1030,1031,1031,0,22281,22347,22346,1,64,2,2,11,8101,8101,8099,8099
San Diego,46,2022-10-31,1772,1778,1778,0,42543,42667,42666,1,109,5,5,13,5600,5600,5595,5595
San Francisco,46,2022-10-31,615,615,615,0,14584,14627,14626,1,45,3,3,3,1077,1077,1074,1074
San Joaquin,46,2022-10-31,330,330,330,0,8592,8617,8616,1,21,6,6,3,2352,2352,2346,2346
San Luis Obispo,46,2022-10-31,81,81,81,0,2010,2016,2015,1,1,1,1,0,530,530,529,529
San Mateo,46,2022-10-31,511,511,511,0,11505,11539,11538,1,30,0,0,2,738,738,738,738
Santa Barbara,46,2022-10-31,181,181,181,0,6033,6050,6049,1,20,1,1,6,735,735,734,734
Santa Clara,46,2022-10-31,1257,1262,1262,0,30687,30778,30777,1,85,3,3,16,2553,2553,2550,2550
Santa Cruz,46,2022-10-31,188,188,188,0,9953,9983,9982,1,7,0,0,0,275,275,275,275
Shasta,46,2022-10-31,64,64,64,0,829,830,829,1,6,2,2,1,593,593,591,591
Siskiyou,46,2022-10-31,17,17,17,0,216,217,216,1,1,1,1,0,95,95,94,94
Solano,46,2022-10-31,312,312,312,0,5249,5266,5265,1,16,0,0,4,460,460,460,460
Sonoma,46,2022-10-31,205,205,205,0,5597,5615,5614,1,24,0,0,3,529,529,529,529
Stanislaus,46,2022-10-31,234,234,234,0,4830,4845,4844,1,49,1,1,8,1795,1795,1794,1794
Sutter,46,2022-10-31,55,55,55,0,901,903,902,1,0,0,0,0,232,232,232,232
Tehama,46,2022-10-31,26,26,26,0,395,396,395,1,1,0,0,0,216,216,216,216
Trinity,46,2022-10-31,18,18,18,0,73,74,73,1,5,0,0,0,21,21,21,21
Tulare,46,2022-10-31,153,153,153,0,3675,3686,3685,1,12,0,0,0,1548,1548,1548,1548
Tuolumne,46,2022-10-31,27,27,27,0,518,519,518,1,3,0,0,0,201,201,201,201
Ventura,46,2022-10-31,377,377,377,0,9516,9546,9545,1,24,2,2,2,1606,1606,1604,1604
Yolo,46,2022-10-31,82,82,82,0,1825,1833,1832,1,3,0,0,1,407,407,407,407
Yuba,46,2022-10-31,46,46,46,0,775,776,775,1,3,0,0,0,122,122,122,122
Alameda,47,2022-11-07,1304,1309,1309,0,24308,24386,24385,1,58,8,8,11,2079,2079,2071,2071
Amador,47,2022-11-07,32,32,32,0,685,687,686,1,3,0,0,0,95,95,95,95
Butte,47,2022-11-07,118,118,118,0,1369,1375,1374,1,11,0,0,2,467,467,467,467
Calaveras,47,2022-11-07,16,16,16,0,333,334,333,1,0,0,0,0,135,135,135,135
Colusa,47,2022-11-07,2,2,2,0,102,103,102,1,0,0,0,0,22,22,22,22
Contra Costa,47,2022-11-07,879,880,880,0,15660,15709,15708,1,43,3,3,4,1483,1483,1480,1480
Del Norte,47,2022-11-07,10,10,10,0,400,401,400,1,0,0,0,0,55,55,55,55
El Dorado,47,2022-11-07,108,108,108,0,1598,1604,1603,1,7,2,2,0,235,235,233,233
Fresno,47,2022-11-07,598,598,598,0,10701,10737,10736,1,61,3,3,9,2894,2894,2891,2891
Glenn,47,2022-11-07,29,29,29,0,131,132,131,1,0,0,0,0,53,53,53,53
Humboldt,47,2022-11-07,85,85,85,0,1022,1027,1026,1,9,0,0,2,162,162,162,162
Imperial,47,2022-11-07,209,209,209,0,3708,3721,3720,1,7,0,0,0,963,963,963,963
Inyo,47,2022-11-07,19,19,19,0,264,265,264,1,0,0,0,0,60,60,60,60
Kern,47,2022-11-07,454,454,454,0,10640,10673,10672,1,29,1,1,5,2437,2437,2436,2436
Kings,47,2022-11-07,149,149,149,0,2457,2466,2465,1,7,1,1,0,466,466,465,465
Lake,47,2022-11-07,50,50,50,0,795,797,796,1,3,0,0,1,150,150,150,150
Lassen,47,2022-11-07,10,10,10,0,451,452,451,1,0,0,0,0,63,63,63,63
Los Angeles,47,2022-11-07,8079,8105,8105,0,190497,191097,191095,2,387,55,55,53,33891,33891,33836,33836
Madera,47,2022-11-07,78,78,78,0,1612,1620,1619,1,3,0,0,4,375,375,375,375
Marin,47,2022-11-07,152,152,152,0,3367,3379,3378,1,9,0,0,0,317,317,317,317
Mariposa,47,2022-11-07,14,14,14,0,121,122,121,1,0,0,0,0,30,30,30,30
Mendocino,47,2022-11-07,37,37,37,0,819,821,820,1,4,1,1,0,137,137,136,136
Merced,47,2022-11-07,142,142,142,0,2592,2601,2600,1,9,4,4,0,879,879,875,875
Modoc,47,2022-11-07,2,2,2,0,6,7,6,1,0,0,0,0,9,9,9,9
Mono,47,2022-11-07,3,3,3,0,96,97,96,1,0,0,0,0,8,8,8,8
Monterey,47,2022-11-07,219,219,219,0,3931,3945,3944,1,18,1,1,0,775,775,774,774
Napa,47,2022-11-07,77,77,77,0,1756,1762,1761,1,6,0,0,0,159,159,159,159
Nevada,47,2022-11-07,60,60,60,0,743,745,744,1,3,0,0,1,136,136,136,136
Orange,47,2022-11-07,1248,1253,1253,0,28539,28630,28629,1,94,11,11,20,7619,7619,7608,7608
Placer,47,2022-11-07,228,228,228,0,3331,3341,3340,1,53,2,2,7,664,664,662,662
Plumas,47,2022-11-07,5,5,5,0,69,70,69,1,0,0,0,0,13,13,13,13
Riverside,47,2022-11-07,1492,1499,1499,0,21551,21618,21617,1,71,2,2,5,6660,6660,6658,6658
Sacramento,47,2022-11-07,1090,1093,1093,0,15903,15953,15952,1,90,7,7,9,3383,3383,3376,3376
San Benito,47,2022-11-07,43,43,43,0,924,928,927,1,1,0,0,0,102,102,102,102
San Bernardino,47,2022-11-07,1431,1436,1436,0,23833,23908,23907,1,76,2,2,17,8103,8103,8101,8101
San Diego,47,2022-11-07,2155,2163,2163,0,45390,45534,45533,1,117,8,8,24,5608,5608,5600,5600
San Francisco,47,2022-11-07,714,714,714,0,14870,14917,14916,1,42,2,2,8,1079,1079,1077,1077
San Joaquin,47,2022-11-07,482,482,482,0,8807,8836,8835,1,24,2,2,3,2354,2354,2352,2352
San Luis Obispo,47,2022-11-07,130,130,130,0,2269,2276,2275,1,4,0,0,2,530,530,530,530
San Mateo,47,2022-11-07,566,566,566,0,12247,12286,12285,1,27,0,0,3,738,738,738,738
Santa Barbara,47,2022-11-07,225,225,225,0,6670,6693,6692,1,18,1,1,2,736,736,735,735
Santa Clara,47,2022-11-07,1627,1634,1634,0,31249,31349,31348,1,76,7,7,19,2560,2560,2553,2553
Santa Cruz,47,2022-11-07,282,282,282,0,11332,11368,11367,1,8,0,0,0,275,275,275,275
Shasta,47,2022-11-07,95,95,95,0,1052,1055,1054,1,11,1,1,3,594,594,593,593
Siskiyou,47,2022-11-07,15,15,15,0,295,296,295,1,1,0,0,0,95,95,95,95
Solano,47,2022-11-07,384,384,384,0,5515,5533,5532,1,22,2,2,3,462,462,460,460
Sonoma,47,2022-11-07,250,250,250,0,5931,5952,5951,1,11,2,2,2,531,531,529,529
Stanislaus,47,2022-11-07,300,300,300,0,4929,4945,4944,1,42,2,2,9,1797,1797,1795,1795
Sutter,47,2022-11-07,87,87,87,0,958,960,959,1,0,0,0,0,232,232,232,232
Tehama,47,2022-11-07,47,47,47,0,472,473,472,1,2,0,0,0,216,216,216,216
Trinity,47,2022-11-07,2,2,2,0,34,35,34,1,0,0,0,0,21,21,21,21
Tulare,47,2022-11-07,160,160,160,0,4365,4381,4380,1,14,0,0,0,1548,1548,1548,1548
Tuolumne,47,2022-11-07,82,82,82,0,681,682,681,1,2,0,0,0,201,201,201,201
Ventura,47,2022-11-07,446,446,446,0,10346,10379,10378,1,36,2,2,1,1608,1608,1606,1606
Yolo,47,2022-11-07,173,173,173,0,2237,2246,2245,1,3,2,2,0,409,409,407,407
Yuba,47,2022-11-07,47,47,47,0,902,904,903,1,3,0,0,2,122,122,122,122
Alameda,48,2022-11-14,1468,1475,1475,0,24069,24152,24151,1,77,3,3,9,2082,2082,2079,2079
Amador,48,2022-11-14,20,20,20,0,656,658,657,1,2,0,0,0,95,95,95,95
Butte,48,2022-11-14,119,119,119,0,1378,1384,1383,1,20,0,0,1,467,467,467,467
Calaveras,48,2022-11-14,30,30,30,0,341,342,341,1,0,0,0,0,135,135,135,135
Colusa,48,2022-11-14,11,11,11,0,100,101,100,1,1,0,0,0,22,22,22,22
Contra Costa,48,2022-11-14,967,968,968,0,15937,15993,15992,1,56,1,1,5,1484,1484,1483,1483
Del Norte,48,2022-11-14,20,20,20,0,429,430,429,1,1,0,0,0,55,55,55,55
El Dorado,48,2022-11-14,143,143,143,0,1590,1597,1596,1,7,0,0,1,235,235,235,235
Fresno,48,2022-11-14,771,772,772,0,11264,11304,11303,1,72,8,8,13,2902,2902,2894,2894
Glenn,48,2022-11-14,20,20,20,0,160,161,160,1,0,0,0,0,53,53,53,53
Humboldt,48,2022-11-14,84,84,84,0,1103,1109,1108,1,6,0,0,0,162,162,162,162
Imperial,48,2022-11-14,251,251,251,0,3221,3233,3232,1,4,0,0,1,963,963,963,963
Inyo,48,2022-11-14,11,11,11,0,542,544,543,1,0,0,0,0,60,60,60,60
Kern,48,2022-11-14,445,445,445,0,10602,10640,10639,1,26,1,1,6,2438,2438,2437,2437
Kings,48,2022-11-14,200,200,200,0,2624,2635,2634,1,6,2,2,0,468,468,466,466
Lake,48,2022-11-14,54,54,54,0,803,805,804,1,2,0,0,1,150,150,150,150
Lassen,48,2022-11-14,35,35,35,0,544,545,544,1,0,1,1,0,64,64,63,63
Los Angeles,48,2022-11-14,9386,9419,9419,0,195294,195975,195973,2,477,49,49,75,33940,33940,33891,33891
Madera,48,2022-11-14,95,95,95,0,1712,1720,1719,1,4,0,0,3,375,375,375,375
Marin,48,2022-11-14,175,175,175,0,3569,3583,3582,1,8,0,0,2,317,317,317,317
Mariposa,48,2022-11-14,18,18,18,0,137,138,137,1,0,0,0,0,30,30,30,30
Mendocino,48,2022-11-14,39,39,39,0,908,911,910,1,3,0,0,1,137,137,137,137
Merced,48,2022-11-14,186,186,186,0,2638,2647,2646,1,6,0,0,0,879,879,879,879
Modoc,48,2022-11-14,3,3,3,0,11,12,11,1,0,0,0,0,9,9,9,9
Mono,48,2022-11-14,10,10,10,0,122,123,122,1,0,0,0,0,8,8,8,8
Monterey,48,2022-11-14,200,200,200,0,4156,4170,4169,1,20,1,1,1,776,776,775,775
Napa,48,2022-11-14,105,105,105,0,1918,1925,1924,1,5,0,0,0,159,159,159,159
Nevada,48,2022-11-14,65,65,65,0,797,799,798,1,3,0,0,2,136,136,136,136
Orange,48,2022-11-14,1561,1568,1568,0,26772,26865,26864,1,118,8,8,21,7627,7627,7619,7619
Placer,48,2022-11-14,313,313,313,0,3834,3849,3848,1,54,1,1,5,665,665,664,664
Plumas,48,2022-11-14,4,4,4,0,79,80,79,1,0,0,0,0,13,13,13,13
Riverside,48,2022-11-14,1642,1649,1649,0,22363,22442,22441,1,95,4,4,10,6664,6664,6660,6660
Sacramento,48,2022-11-14,1181,1186,1186,0,16853,16912,16911,1,82,6,6,18,3389,3389,3383,3383
San Benito,48,2022-11-14,42,42,42,0,979,983,982,1,1,0,0,0,102,102,102,102
San Bernardino,48,2022-11-14,1780,1787,1787,0,23980,24064,24063,1,83,0,0,14,8103,8103,8103,8103
San Diego,48,2022-11-14,2455,2463,2463,0,43498,43650,43649,1,124,7,7,21,5615,5615,5608,5608
San Francisco,48,2022-11-14,710,711,711,0,13676,13723,13722,1,52,7,7,5,1086,1086,1079,1079
San Joaquin,48,2022-11-14,610,611,611,0,9501,9535,9534,1,20,0,0,5,2354,2354,2354,2354
San Luis Obispo,48,2022-11-14,120,120,120,0,2200,2209,2208,1,6,0,0,1,530,530,530,530
San Mateo,48,2022-11-14,639,639,639,0,11297,11337,11336,1,27,0,0,2,738,738,738,738
Santa Barbara,48,2022-11-14,192,192,192,0,5891,5913,5912,1,15,1,1,2,737,737,736,736
Santa Clara,48,2022-11-14,1731,1738,1738,0,30462,30569,30568,1,117,3,3,14,2563,2563,2560,2560
Santa Cruz,48,2022-11-14,249,249,249,0,9602,9638,9637,1,11,1,1,0,276,276,275,275
Shasta,48,2022-11-14,101,101,101,0,1070,1074,1073,1,10,1,1,2,595,595,594,594
Siskiyou,48,2022-11-14,27,27,27,0,397,398,397,1,2,0,0,0,95,95,95,95
Solano,48,2022-11-14,439,439,439,0,5419,5438,5437,1,26,0,0,3,462,462,462,462
Sonoma,48,2022-11-14,268,268,268,0,6034,6055,6054,1,23,1,1,0,532,532,531,531
Stanislaus,48,2022-11-14,328,328,328,0,5222,5243,5242,1,48,0,0,10,1797,1797,1797,1797
Sutter,48,2022-11-14,95,95,95,0,1182,1187,1186,1,0,0,0,0,232,232,232,232
Tehama,48,2022-11-14,49,49,49,0,574,576,575,1,1,0,0,0,216,216,216,216
Trinity,48,2022-11-14,11,11,11,0,52,53,52,1,0,1,1,0,22,22,21,21
Tulare,48,2022-11-14,308,308,308,0,4283,4299,4298,1,16,0,0,1,1548,1548,1548,1548
Tuolumne,48,2022-11-14,77,77,77,0,695,698,697,1,2,0,0,0,201,201,201,201
Ventura,48,2022-11-14,572,572,572,0,10613,10652,10651,1,28,1,1,4,1609,1609,1608,1608
Yolo,48,2022-11-14,152,152,152,0,2158,2168,2167,1,2,6,6,0,415,415,409,409
Yuba,48,2022-11-14,60,60,60,0,987,991,990,1,6,0,0,1,122,122,122,122
Alameda,49,2022-11-21,1708,1715,1715,0,25225,25324,25323,1,82,9,9,16,2091,2091,2082,2082
Amador,49,2022-11-21,28,28,28,0,833,836,835,1,2,0,0,0,95,95,95,95
Butte,49,2022-11-21,143,143,143,0,1327,1333,1332,1,21,0,0,1,467,467,467,467
Calaveras,49,2022-11-21,40,40,40,0,421,422,421,1,2,0,0,0,135,135,135,135
Colusa,49,2022-11-21,9,9,9,0,110,111,110,1,0,0,0,0,22,22,22,22
Contra Costa,49,2022-11-21,1028,1033,1033,0,16512,16576,16575,1,52,3,3,8,1487,1487,1484,1484
Del Norte,49,2022-11-21,18,18,18,0,489,490,489,1,4,0,0,0,55,55,55,55
El Dorado,49,2022-11-21,186,186,186,0,1827,1835,1834,1,10,0,0,1,235,235,235,235
Fresno,49,2022-11-21,1068,1073,1073,0,12140,12189,12188,1,114,5,5,9,2907,2907,2902,2902
Glenn,49,2022-11-21,21,21,21,0,214,215,214,1,0,0,0,0,53,53,53,53
Humboldt,49,2022-11-21,123,123,123,0,1172,1179,1178,1,4,1,1,1,163,163,162,162
Imperial,49,2022-11-21,280,280,280,0,3123,3137,3136,1,3,1,1,1,964,964,963,963
Inyo,49,2022-11-21,29,29,29,0,402,403,402,1,0,1,1,0,61,61,60,60
Kern,49,2022-11-21,483,483,483,0,10095,10136,10135,1,54,3,3,10,2441,2441,2438,2438
Kings,49,2022-11-21,296,296,296,0,2779,2792,2791,1,4,2,2,1,470,470,468,468
Lake,49,2022-11-21,56,56,56,0,928,934,933,1,0,1,1,1,151,151,150,150
Lassen,49,2022-11-21,34,34,34,0,540,542,541,1,0,0,0,0,64,64,64,64
Los Angeles,49,2022-11-21,13165,13218,13218,0,197914,198698,198696,2,648,69,69,93,34009,34009,33940,33940
Madera,49,2022-11-21,168,168,168,0,1861,1869,1868,1,11,0,0,1,375,375,375,375
Marin,49,2022-11-21,179,179,179,0,3351,3365,3364,1,8,0,0,0,317,317,317,317
Mariposa,49,2022-11-21,19,19,19,0,170,171,170,1,0,0,0,0,30,30,30,30
Mendocino,49,2022-11-21,38,38,38,0,889,894,893,1,4,0,0,1,137,137,137,137
Merced,49,2022-11-21,269,269,269,0,2931,2944,2943,1,9,2,2,4,881,881,879,879
Modoc,49,2022-11-21,8,8,8,0,13,14,13,1,0,0,0,0,9,9,9,9
Mono,49,2022-11-21,3,3,3,0,107,108,107,1,0,0,0,0,8,8,8,8
Monterey,49,2022-11-21,227,227,227,0,4442,4462,4461,1,17,1,1,0,777,777,776,776
Napa,49,2022-11-21,145,145,145,0,2037,2046,2045,1,4,0,0,1,159,159,159,159
Nevada,49,2022-11-21,92,92,92,0,933,938,937,1,2,0,0,2,136,136,136,136
Orange,49,2022-11-21,2162,2170,2170,0,28140,28251,28250,1,170,14,14,32,7641,7641,7627,7627
Placer,49,2022-11-21,361,361,361,0,4059,4076,4075,1,53,0,0,6,665,665,665,665
Plumas,49,2022-11-21,7,7,7,0,104,105,104,1,1,0,0,0,13,13,13,13
Riverside,49,2022-11-21,2144,2152,2152,0,24363,24459,24458,1,110,7,7,9,6671,6671,6664,6664
Sacramento,49,2022-11-21,1521,1527,1527,0,18921,18998,18997,1,105,3,3,18,3392,3392,3389,3389
San Benito,49,2022-11-21,64,64,64,0,1154,1159,1158,1,2,0,0,0,102,102,102,102
San Bernardino,49,2022-11-21,2333,2341,2341,0,26601,26707,26706,1,89,1,1,19,8104,8104,8103,8103
San Diego,49,2022-11-21,3171,3184,3184,0,43786,43958,43957,1,198,3,3,26,5618,5618,5615,5615
San Francisco,49,2022-11-21,943,947,947,0,15065,15125,15124,1,54,5,5,7,1091,1091,1086,1086
San Joaquin,49,2022-11-21,763,764,764,0,11077,11123,11122,1,36,1,1,5,2355,2355,2354,2354
San Luis Obispo,49,2022-11-21,170,170,170,0,2350,2361,2360,1,4,1,1,0,531,531,530,530
San Mateo,49,2022-11-21,739,741,741,0,12300,12349,12348,1,36,0,0,1,738,738,738,738
Santa Barbara,49,2022-11-21,321,321,321,0,6106,6131,6130,1,15,3,3,3,740,740,737,737
Santa Clara,49,2022-11-21,2153,2161,2161,0,34256,34393,34392,1,119,10,10,23,2573,2573,2563,2563
Santa Cruz,49,2022-11-21,286,286,286,0,9522,9561,9560,1,12,0,0,2,276,276,276,276
Shasta,49,2022-11-21,91,91,91,0,1051,1056,1055,1,14,0,0,1,595,595,595,595
Siskiyou,49,2022-11-21,24,24,24,0,342,343,342,1,1,0,0,0,95,95,95,95
Solano,49,2022-11-21,491,491,491,0,5667,5690,5689,1,32,1,1,5,463,463,462,462
Sonoma,49,2022-11-21,326,326,326,0,5780,5805,5804,1,22,0,0,4,532,532,532,532
Stanislaus,49,2022-11-21,445,445,445,0,5969,5993,5992,1,51,0,0,10,1797,1797,1797,1797
Sutter,49,2022-11-21,91,91,91,0,1139,1145,1144,1,0,0,0,0,232,232,232,232
Tehama,49,2022-11-21,72,72,72,0,673,675,674,1,3,0,0,2,216,216,216,216
Trinity,49,2022-11-21,5,5,5,0,51,52,51,1,0,0,0,0,22,22,22,22
Tulare,49,2022-11-21,431,431,431,0,5503,5526,5525,1,23,0,0,1,1548,1548,1548,1548
Tuolumne,49,2022-11-21,97,97,97,0,765,767,766,1,3,0,0,0,201,201,201,201
Ventura,49,2022-11-21,728,729,729,0,10699,10742,10741,1,43,1,1,2,1610,1610,1609,1609
Yolo,49,2022-11-21,132,132,132,0,2238,2248,2247,1,7,4,4,2,419,419,415,415
Yuba,49,2022-11-21,70,70,70,0,1027,1033,1032,1,10,0,0,1,122,122,122,122
Alameda,50,2022-11-28,2232,2242,2242,0,22049,22147,22146,1,103,6,6,13,2097,2097,2091,2091
Amador,50,2022-11-28,32,32,32,0,757,761,760,1,5,1,1,1,96,96,95,95
Butte,50,2022-11-28,204,204,204,0,1477,1484,1483,1,41,0,0,1,467,467,467,467
Calaveras,50,2022-11-28,32,32,32,0,402,403,402,1,3,0,0,0,135,135,135,135
Colusa,50,2022-11-28,14,14,14,0,184,185,184,1,0,0,0,0,22,22,22,22
Contra Costa,50,2022-11-28,1470,1477,1477,0,15532,15600,15599,1,67,4,4,8,1491,1491,1487,1487
Del Norte,50,2022-11-28,33,33,33,0,458,460,459,1,1,1,1,0,56,56,55,55
El Dorado,50,2022-11-28,185,185,185,0,1548,1556,1555,1,13,1,1,1,236,236,235,235
Fresno,50,2022-11-28,1321,1328,1328,0,11704,11755,11754,1,136,5,5,19,2912,2912,2907,2907
Glenn,50,2022-11-28,17,17,17,0,194,195,194,1,3,0,0,0,53,53,53,53
Humboldt,50,2022-11-28,114,114,114,0,1042,1048,1047,1,10,0,0,0,163,163,163,163
Imperial,50,2022-11-28,379,379,379,0,2791,2805,2804,1,6,1,1,1,965,965,964,964
Inyo,50,2022-11-28,34,34,34,0,376,377,376,1,2,0,0,0,61,61,61,61
Kern,50,2022-11-28,586,587,587,0,9373,9415,9414,1,60,4,4,6,2445,2445,2441,2441
Kings,50,2022-11-28,244,244,244,0,2544,2557,2556,1,10,0,0,0,470,470,470,470
Lake,50,2022-11-28,49,49,49,0,848,852,851,1,1,0,0,0,151,151,151,151
Lassen,50,2022-11-28,27,27,27,0,493,495,494,1,0,0,0,0,64,64,64,64
Los Angeles,50,2022-11-28,18873,18957,18957,0,183062,183874,183872,2,918,88,88,122,34097,34097,34009,34009
Madera,50,2022-11-28,162,162,162,0,1627,1635,1634,1,13,0,0,2,375,375,375,375
Marin,50,2022-11-28,298,298,298,0,3071,3087,3086,1,19,0,0,1,317,317,317,317
Mariposa,50,2022-11-28,23,23,23,0,136,137,136,1,0,0,0,0,30,30,30,30
Mendocino,50,2022-11-28,49,49,49,0,726,730,729,1,5,0,0,2,137,137,137,137
Merced,50,2022-11-28,349,350,350,0,2550,2564,2563,1,18,5,5,2,886,886,881,881
Modoc,50,2022-11-28,5,5,5,0,10,11,10,1,0,0,0,0,9,9,9,9
Mono,50,2022-11-28,4,4,4,0,94,95,94,1,0,0,0,0,8,8,8,8
Monterey,50,2022-11-28,283,283,283,0,3890,3909,3908,1,26,1,1,0,778,778,777,777
Napa,50,2022-11-28,141,141,141,0,1885,1894,1893,1,6,0,0,3,159,159,159,159
Nevada,50,2022-11-28,118,118,118,0,1008,1013,1012,1,9,0,0,0,136,136,136,136
Orange,50,2022-11-28,3105,3120,3120,0,26227,26344,26343,1,221,17,17,34,7658,7658,7641,7641
Placer,50,2022-11-28,387,387,387,0,3778,3796,3795,1,69,3,3,5,668,668,665,665
Plumas,50,2022-11-28,6,6,6,0,143,144,143,1,0,0,0,0,13,13,13,13
Riverside,50,2022-11-28,3191,3206,3206,0,23286,23389,23388,1,188,12,12,22,6683,6683,6671,6671
Sacramento,50,2022-11-28,1786,1794,1794,0,17966,18045,18044,1,126,8,8,14,3400,3400,3392,3392
San Benito,50,2022-11-28,131,131,131,0,1221,1228,1227,1,1,0,0,0,102,102,102,102
San Bernardino,50,2022-11-28,3301,3316,3316,0,25798,25910,25909,1,146,1,1,20,8105,8105,8104,8104
San Diego,50,2022-11-28,4092,4110,4110,0,31679,31821,31820,1,259,7,7,27,5625,5625,5618,5618
San Francisco,50,2022-11-28,1161,1167,1167,0,12719,12776,12775,1,67,6,6,8,1097,1097,1091,1091
San Joaquin,50,2022-11-28,992,997,997,0,10941,10991,10990,1,50,3,3,11,2358,2358,2355,2355
San Luis Obispo,50,2022-11-28,179,179,179,0,2248,2260,2259,1,9,3,3,1,534,534,531,531
San Mateo,50,2022-11-28,1087,1093,1093,0,10982,11031,11030,1,42,1,1,3,739,739,738,738
Santa Barbara,50,2022-11-28,466,467,467,0,5210,5233,5232,1,27,2,2,5,742,742,740,740
Santa Clara,50,2022-11-28,2890,2903,2903,0,28045,28168,28167,1,159,9,9,22,2582,2582,2573,2573
Santa Cruz,50,2022-11-28,371,372,372,0,6665,6696,6695,1,20,0,0,2,276,276,276,276
Shasta,50,2022-11-28,97,97,97,0,1010,1014,1013,1,16,1,1,3,596,596,595,595
Siskiyou,50,2022-11-28,27,27,27,0,277,278,277,1,2,0,0,0,95,95,95,95
Solano,50,2022-11-28,590,592,592,0,5182,5206,5205,1,34,2,2,7,465,465,463,463
Sonoma,50,2022-11-28,456,457,457,0,5011,5033,5032,1,48,2,2,3,534,534,532,532
Stanislaus,50,2022-11-28,523,524,524,0,5363,5388,5387,1,77,3,3,4,1800,1800,1797,1797
Sutter,50,2022-11-28,82,82,82,0,1119,1126,1125,1,0,0,0,0,232,232,232,232
Tehama,50,2022-11-28,70,70,70,0,632,634,633,1,6,0,0,3,216,216,216,216
Trinity,50,2022-11-28,3,3,3,0,60,61,60,1,0,0,0,0,22,22,22,22
Tulare,50,2022-11-28,510,511,511,0,4930,4953,4952,1,34,0,0,0,1548,1548,1548,1548
Tuolumne,50,2022-11-28,72,72,72,0,676,679,678,1,4,0,0,0,201,201,201,201
Ventura,50,2022-11-28,963,968,968,0,10588,10637,10636,1,58,2,2,2,1612,1612,1610,1610
Yolo,50,2022-11-28,169,169,169,0,2027,2036,2035,1,3,4,4,1,423,423,419,419
Yuba,50,2022-11-28,92,92,92,0,926,931,930,1,12,0,0,0,122,122,122,122
Alameda,51,2022-12-05,2773,2786,2786,0,29017,29160,29159,1,126,7,7,13,2104,2104,2097,2097
Amador,51,2022-12-05,41,41,41,0,812,815,814,1,3,0,0,2,96,96,96,96
Butte,51,2022-12-05,238,238,238,0,1886,1897,1896,1,38,7,7,5,474,474,467,467
Calaveras,51,2022-12-05,46,46,46,0,486,488,487,1,0,1,1,0,136,136,135,135
Colusa,51,2022-12-05,12,12,12,0,206,207,206,1,4,0,0,0,22,22,22,22
Contra Costa,51,2022-12-05,1776,1784,1784,0,19284,19379,19378,1,78,0,0,11,1491,1491,1491,1491
Del Norte,51,2022-12-05,39,39,39,0,566,569,568,1,2,0,0,0,56,56,56,56
El Dorado,51,2022-12-05,182,182,182,0,1576,1584,1583,1,14,1,1,0,237,237,236,236
Fresno,51,2022-12-05,1537,1545,1545,0,14288,14358,14357,1,177,6,6,17,2918,2918,2912,2912
Glenn,51,2022-12-05,24,24,24,0,232,234,233,1,2,0,0,0,53,53,53,53
Humboldt,51,2022-12-05,134,134,134,0,1083,1090,1089,1,17,1,1,2,164,164,163,163
Imperial,51,2022-12-05,587,589,589,0,3396,3414,3413,1,18,2,2,5,967,967,965,965
Inyo,51,2022-12-05,26,26,26,0,332,333,332,1,1,1,1,0,62,62,61,61
Kern,51,2022-12-05,797,801,801,0,10541,10595,10594,1,55,1,1,10,2446,2446,2445,2445
Kings,51,2022-12-05,295,295,295,0,3047,3063,3062,1,8,0,0,0,470,470,470,470
Lake,51,2022-12-05,64,64,64,0,830,836,835,1,2,0,0,0,151,151,151,151
Lassen,51,2022-12-05,14,14,14,0,444,446,445,1,0,0,0,0,64,64,64,64
Los Angeles,51,2022-12-05,22376,22484,22484,0,241679,242859,242856,3,1119,110,111,151,34207,34208,34097,34097
Madera,51,2022-12-05,205,205,205,0,1982,1994,1993,1,12,0,0,3,375,375,375,375
Marin,51,2022-12-05,312,312,312,0,3507,3525,3524,1,14,0,0,2,317,317,317,317
Mariposa,51,2022-12-05,19,19,19,0,174,175,174,1,0,0,0,0,30,30,30,30
Mendocino,51,2022-12-05,47,47,47,0,797,803,802,1,6,1,1,2,138,138,137,137
Merced,51,2022-12-05,352,352,352,0,3210,3225,3224,1,23,2,2,2,888,888,886,886
Modoc,51,2022-12-05,12,12,12,0,13,14,13,1,0,0,0,0,9,9,9,9
Mono,51,2022-12-05,9,9,9,0,91,92,91,1,0,0,0,0,8,8,8,8
Monterey,51,2022-12-05,271,271,271,0,4384,4406,4405,1,34,1,1,0,779,779,778,778
Napa,51,2022-12-05,161,161,161,0,2341,2355,2354,1,7,0,0,0,159,159,159,159
Nevada,51,2022-12-05,115,115,115,0,1123,1129,1128,1,8,0,0,2,136,136,136,136
Orange,51,2022-12-05,4183,4204,4204,0,34027,34194,34193,1,301,21,21,48,7679,7679,7658,7658
Placer,51,2022-12-05,392,392,392,0,4041,4061,4060,1,72,1,1,4,669,669,668,668
Plumas,51,2022-12-05,22,22,22,0,184,185,184,1,1,0,0,0,13,13,13,13
Riverside,51,2022-12-05,3960,3979,3979,0,27241,27374,27373,1,186,13,13,25,6696,6696,6683,6683
Sacramento,51,2022-12-05,2120,2131,2131,0,21126,21231,21230,1,128,8,8,28,3408,3408,3400,3400
San Benito,51,2022-12-05,219,219,219,0,1483,1492,1491,1,6,1,1,3,103,103,102,102
San Bernardino,51,2022-12-05,4017,4037,4037,0,28260,28398,28397,1,167,0,0,34,8105,8105,8105,8105
San Diego,51,2022-12-05,5673,5699,5699,0,44335,44552,44551,1,302,12,12,30,5637,5637,5625,5625
San Francisco,51,2022-12-05,1486,1494,1494,0,15939,16016,16015,1,77,7,7,7,1104,1104,1097,1097
San Joaquin,51,2022-12-05,1118,1124,1124,0,12629,12691,12690,1,70,8,8,16,2366,2366,2358,2358
San Luis Obispo,51,2022-12-05,206,206,206,0,2660,2674,2673,1,15,3,3,1,537,537,534,534
San Mateo,51,2022-12-05,1226,1233,1233,0,13442,13508,13507,1,56,1,1,1,740,740,739,739
Santa Barbara,51,2022-12-05,521,522,522,0,6764,6798,6797,1,38,1,1,9,743,743,742,742
Santa Clara,51,2022-12-05,3445,3462,3462,0,35389,35563,35562,1,207,11,11,26,2593,2593,2582,2582
Santa Cruz,51,2022-12-05,471,471,471,0,12732,12796,12795,1,22,0,0,3,276,276,276,276
Shasta,51,2022-12-05,132,132,132,0,1107,1114,1113,1,23,0,0,5,596,596,596,596
Siskiyou,51,2022-12-05,22,22,22,0,309,310,309,1,2,0,0,0,95,95,95,95
Solano,51,2022-12-05,643,646,646,0,6611,6645,6644,1,33,1,1,7,466,466,465,465
Sonoma,51,2022-12-05,505,506,506,0,5880,5910,5909,1,35,5,5,1,539,539,534,534
Stanislaus,51,2022-12-05,640,643,643,0,6730,6763,6762,1,76,1,1,7,1801,1801,1800,1800
Sutter,51,2022-12-05,96,96,96,0,1171,1179,1178,1,0,1,1,0,233,233,232,232
Tehama,51,2022-12-05,93,93,93,0,817,822,821,1,9,2,2,0,218,218,216,216
Trinity,51,2022-12-05,3,3,3,0,39,40,39,1,0,0,0,0,22,22,22,22
Tulare,51,2022-12-05,522,523,523,0,5950,5980,5979,1,35,0,0,1,1548,1548,1548,1548
Tuolumne,51,2022-12-05,107,107,107,0,852,857,856,1,2,0,0,0,201,201,201,201
Ventura,51,2022-12-05,1102,1108,1108,0,12163,12223,12222,1,71,2,2,6,1614,1614,1612,1612
Yolo,51,2022-12-05,214,214,214,0,2646,2661,2660,1,2,1,1,3,424,424,423,423
Yuba,51,2022-12-05,82,82,82,0,1038,1044,1043,1,11,0,0,1,122,122,122,122
Alameda,52,2022-12-12,2641,2653,2653,0,29272,29426,29425,1,147,11,11,20,2115,2115,2104,2104
Amador,52,2022-12-12,32,32,32,0,789,793,792,1,3,0,0,0,96,96,96,96
Butte,52,2022-12-12,183,183,183,0,1834,1844,1843,1,39,2,2,2,476,476,474,474
Calaveras,52,2022-12-12,41,41,41,0,454,456,455,1,1,0,0,0,136,136,136,136
Colusa,52,2022-12-12,12,12,12,0,272,273,272,1,1,0,0,0,22,22,22,22
Contra Costa,52,2022-12-12,1742,1751,1751,0,18419,18517,18516,1,78,10,10,4,1501,1501,1491,1491
Del Norte,52,2022-12-12,34,34,34,0,534,538,537,1,3,0,0,0,56,56,56,56
El Dorado,52,2022-12-12,146,146,146,0,1410,1419,1418,1,8,1,1,3,238,238,237,237
Fresno,52,2022-12-12,1477,1484,1484,0,13850,13923,13922,1,186,12,12,18,2930,2930,2918,2918
Glenn,52,2022-12-12,17,17,17,0,230,231,230,1,6,0,0,0,53,53,53,53
Humboldt,52,2022-12-12,106,106,106,0,1011,1018,1017,1,13,1,1,2,165,165,164,164
Imperial,52,2022-12-12,455,456,456,0,2943,2959,2958,1,27,3,3,3,970,970,967,967
Inyo,52,2022-12-12,22,22,22,0,303,304,303,1,1,0,0,0,62,62,62,62
Kern,52,2022-12-12,940,946,946,0,10846,10904,10903,1,55,2,2,4,2448,2448,2446,2446
Kings,52,2022-12-12,256,256,256,0,2855,2870,2869,1,8,2,2,0,472,472,470,470
Lake,52,2022-12-12,56,56,56,0,761,767,766,1,3,0,0,1,151,151,151,151
Lassen,52,2022-12-12,15,15,15,0,423,425,424,1,0,0,0,0,64,64,64,64
Los Angeles,52,2022-12-12,17480,17573,17573,0,225523,226713,226710,3,1113,158,162,154,34365,34370,34207,34208
Madera,52,2022-12-12,212,212,212,0,2174,2185,2184,1,15,0,0,2,375,375,375,375
Marin,52,2022-12-12,315,315,315,0,3616,3636,3635,1,24,0,0,2,317,317,317,317
Mariposa,52,2022-12-12,18,18,18,0,122,123,122,1,0,0,0,0,30,30,30,30
Mendocino,52,2022-12-12,53,53,53,0,657,661,660,1,7,1,1,0,139,139,138,138
Merced,52,2022-12-12,319,319,319,0,3323,3342,3341,1,14,0,0,2,888,888,888,888
Modoc,52,2022-12-12,5,5,5,0,10,11,10,1,0,0,0,0,9,9,9,9
Mono,52,2022-12-12,9,9,9,0,122,123,122,1,0,0,0,0,8,8,8,8
Monterey,52,2022-12-12,265,265,265,0,4255,4279,4278,1,25,3,3,2,782,782,779,779
Napa,52,2022-12-12,161,161,161,0,2173,2185,2184,1,9,1,1,0,160,160,159,159
Nevada,52,2022-12-12,90,90,90,0,969,975,974,1,5,0,0,2,136,136,136,136
Orange,52,2022-12-12,3424,3443,3443,0,31016,31180,31179,1,300,35,35,48,7714,7714,7679,7679
Placer,52,2022-12-12,330,330,330,0,3883,3905,3904,1,73,5,5,6,674,674,669,669
Plumas,52,2022-12-12,7,7,7,0,186,187,186,1,2,0,0,0,13,13,13,13
Riverside,52,2022-12-12,3300,3318,3318,0,24452,24582,24581,1,204,19,19,25,6715,6715,6696,6696
Sacramento,52,2022-12-12,1805,1815,1815,0,20061,20167,20166,1,173,7,7,31,3415,3415,3408,3408
San Benito,52,2022-12-12,125,125,125,0,1329,1338,1337,1,2,2,2,2,105,105,103,103
San Bernardino,52,2022-12-12,3544,3564,3564,0,26668,26807,26806,1,226,3,3,36,8108,8108,8105,8105
San Diego,52,2022-12-12,4840,4864,4864,0,40208,40421,40420,1,331,15,15,45,5652,5652,5637,5637
San Francisco,52,2022-12-12,1417,1424,1424,0,16730,16818,16817,1,103,7,7,12,1111,1111,1104,1104
San Joaquin,52,2022-12-12,998,1003,1003,0,12710,12776,12775,1,68,6,6,19,2372,2372,2366,2366
San Luis Obispo,52,2022-12-12,231,231,231,0,2650,2665,2664,1,10,1,1,0,538,538,537,537
San Mateo,52,2022-12-12,1147,1154,1154,0,12351,12416,12415,1,59,0,0,3,740,740,740,740
Santa Barbara,52,2022-12-12,512,513,513,0,5761,5793,5792,1,36,2,2,6,745,745,743,743
Santa Clara,52,2022-12-12,3204,3222,3222,0,34812,34996,34995,1,198,17,17,30,2610,2610,2593,2593
Santa Cruz,52,2022-12-12,578,581,581,0,12934,13003,13002,1,29,0,0,1,276,276,276,276
Shasta,52,2022-12-12,104,104,104,0,1154,1161,1160,1,22,0,0,5,596,596,596,596
Siskiyou,52,2022-12-12,15,15,15,0,244,245,244,1,2,0,0,0,95,95,95,95
Solano,52,2022-12-12,637,642,642,0,6175,6208,6207,1,42,2,2,7,468,468,466,466
Sonoma,52,2022-12-12,560,561,561,0,5592,5624,5623,1,41,2,2,7,541,541,539,539
Stanislaus,52,2022-12-12,593,596,596,0,6381,6415,6414,1,104,8,8,12,1809,1809,1801,1801
Sutter,52,2022-12-12,114,114,114,0,1154,1162,1161,1,0,0,0,0,233,233,233,233
Tehama,52,2022-12-12,80,80,80,0,774,779,778,1,6,1,1,0,219,219,218,218
Trinity,52,2022-12-12,3,3,3,0,45,46,45,1,0,0,0,0,22,22,22,22
Tulare,52,2022-12-12,437,438,438,0,5891,5922,5921,1,27,2,2,2,1550,1550,1548,1548
Tuolumne,52,2022-12-12,133,133,133,0,934,941,940,1,5,0,0,0,201,201,201,201
Ventura,52,2022-12-12,914,919,919,0,10629,10687,10686,1,72,4,4,7,1618,1618,1614,1614
Yolo,52,2022-12-12,210,210,210,0,2296,2309,2308,1,5,2,2,2,426,426,424,424
Yuba,52,2022-12-12,75,75,75,0,948,954,953,1,13,0,0,0,122,122,122,122
Alameda,53,2022-12-19,2294,2307,2307,0,26706,26867,26866,1,144,11,11,19,2126,2126,2115,2115
Amador,53,2022-12-19,42,42,42,0,806,813,812,1,6,0,0,0,96,96,96,96
Butte,53,2022-12-19,128,128,128,0,1638,1649,1648,1,34,3,3,2,479,479,476,476
Calaveras,53,2022-12-19,29,29,29,0,441,443,442,1,1,1,1,0,137,137,136,136
Colusa,53,2022-12-19,12,12,12,0,214,215,214,1,1,0,0,0,22,22,22,22
Contra Costa,53,2022-12-19,1713,1724,1724,0,17323,17428,17427,1,95,6,6,7,1507,1507,1501,1501
Del Norte,53,2022-12-19,39,39,39,0,553,557,556,1,3,0,0,0,56,56,56,56
El Dorado,53,2022-12-19,160,160,160,0,1632,1643,1642,1,9,1,1,2,239,239,238,238
Fresno,53,2022-12-19,1176,1183,1183,0,12883,12962,12961,1,212,7,7,22,2937,2937,2930,2930
Glenn,53,2022-12-19,21,21,21,0,205,207,206,1,6,0,0,0,53,53,53,53
Humboldt,53,2022-12-19,113,113,113,0,942,949,948,1,9,0,0,1,165,165,165,165
Imperial,53,2022-12-19,262,262,262,0,2546,2561,2560,1,16,1,1,0,971,971,970,970
Inyo,53,2022-12-19,12,12,12,0,324,325,324,1,1,0,0,0,62,62,62,62
Kern,53,2022-12-19,921,927,927,0,10638,10704,10703,1,60,3,3,5,2451,2451,2448,2448
Kings,53,2022-12-19,229,229,229,0,2770,2787,2786,1,6,3,3,1,475,475,472,472
Lake,53,2022-12-19,70,70,70,0,794,800,799,1,4,1,1,0,152,152,151,151
Lassen,53,2022-12-19,8,8,8,0,466,469,468,1,0,0,0,0,64,64,64,64
Los Angeles,53,2022-12-19,15221,15312,15312,0,201944,203161,203159,2,1096,130,136,155,34495,34506,34365,34370
Madera,53,2022-12-19,186,186,186,0,1889,1902,1901,1,10,0,0,1,375,375,375,375
Marin,53,2022-12-19,268,268,268,0,3233,3253,3252,1,17,0,0,0,317,317,317,317
Mariposa,53,2022-12-19,25,25,25,0,133,134,133,1,0,0,0,0,30,30,30,30
Mendocino,53,2022-12-19,66,66,66,0,755,761,760,1,4,0,0,0,139,139,139,139
Merced,53,2022-12-19,262,262,262,0,2773,2791,2790,1,15,2,2,2,890,890,888,888
Modoc,53,2022-12-19,8,8,8,0,21,22,21,1,0,0,0,0,9,9,9,9
Mono,53,2022-12-19,11,11,11,0,121,122,121,1,1,0,0,0,8,8,8,8
Monterey,53,2022-12-19,231,231,231,0,3876,3901,3900,1,13,1,1,1,783,783,782,782
Napa,53,2022-12-19,181,181,181,0,2091,2105,2104,1,8,0,0,0,160,160,160,160
Nevada,53,2022-12-19,72,72,72,0,883,889,888,1,5,0,0,2,136,136,136,136
Orange,53,2022-12-19,3227,3247,3247,0,29780,29960,29959,1,296,32,32,51,7746,7746,7714,7714
Placer,53,2022-12-19,361,361,361,0,3829,3854,3853,1,90,1,1,10,675,675,674,674
Plumas,53,2022-12-19,7,7,7,0,188,189,188,1,0,0,0,0,13,13,13,13
Riverside,53,2022-12-19,3098,3117,3117,0,22555,22693,22692,1,177,21,21,22,6736,6736,6715,6715
Sacramento,53,2022-12-19,1718,1729,1729,0,19655,19776,19775,1,210,13,13,22,3428,3428,3415,3415
San Benito,53,2022-12-19,105,105,105,0,1136,1143,1142,1,0,4,4,1,109,109,105,105
San Bernardino,53,2022-12-19,3154,3173,3173,0,24750,24900,24899,1,200,4,4,38,8112,8112,8108,8108
San Diego,53,2022-12-19,4845,4875,4875,0,39022,39258,39257,1,381,16,16,45,5668,5668,5652,5652
San Francisco,53,2022-12-19,1216,1224,1224,0,15628,15722,15721,1,106,10,10,17,1121,1121,1111,1111
San Joaquin,53,2022-12-19,853,859,859,0,12989,13069,13068,1,58,11,11,19,2383,2383,2372,2372
San Luis Obispo,53,2022-12-19,242,242,242,0,2423,2437,2436,1,17,1,1,0,539,539,538,538
San Mateo,53,2022-12-19,917,924,924,0,11730,11801,11800,1,62,0,0,5,740,740,740,740
Santa Barbara,53,2022-12-19,468,469,469,0,5246,5279,5278,1,35,4,4,5,749,749,745,745
Santa Clara,53,2022-12-19,2783,2800,2800,0,32127,32321,32320,1,205,14,14,30,2624,2624,2610,2610
Santa Cruz,53,2022-12-19,260,260,260,0,11201,11268,11267,1,31,0,0,1,276,276,276,276
Shasta,53,2022-12-19,109,109,109,0,1126,1134,1133,1,24,1,1,4,597,597,596,596
Siskiyou,53,2022-12-19,15,15,15,0,258,259,258,1,2,0,0,0,95,95,95,95
Solano,53,2022-12-19,636,641,641,0,6177,6216,6215,1,41,0,0,6,468,468,468,468
Sonoma,53,2022-12-19,478,480,480,0,5421,5453,5452,1,38,1,1,4,542,542,541,541
Stanislaus,53,2022-12-19,474,475,475,0,5996,6033,6032,1,94,1,1,12,1810,1810,1809,1809
Sutter,53,2022-12-19,81,81,81,0,1074,1083,1082,1,0,1,1,0,234,234,233,233
Tehama,53,2022-12-19,67,67,67,0,676,682,681,1,6,1,1,0,220,220,219,219
Trinity,53,2022-12-19,2,2,2,0,31,32,31,1,0,0,0,0,22,22,22,22
Tulare,53,2022-12-19,468,469,469,0,5381,5416,5415,1,53,5,5,1,1555,1555,1550,1550
Tuolumne,53,2022-12-19,88,88,88,0,841,848,847,1,2,1,1,1,202,202,201,201
Ventura,53,2022-12-19,936,943,943,0,9941,10002,10001,1,81,4,4,9,1622,1622,1618,1618
Yolo,53,2022-12-19,172,172,172,0,1959,1971,1970,1,5,4,4,0,430,430,426,426
Yuba,53,2022-12-19,81,81,81,0,900,907,906,1,7,0,0,0,122,122,122,122
Alameda,54,2022-12-26,1941,1953,1953,0,20334,20478,20477,1,150,9,9,17,2135,2135,2126,2126
Amador,54,2022-12-26,43,43,43,0,758,765,764,1,5,1,1,0,97,97,96,96
Butte,54,2022-12-26,96,96,96,0,1294,1305,1304,1,33,0,0,1,479,479,479,479
Calaveras,54,2022-12-26,24,24,24,0,366,368,367,1,0,1,1,0,138,138,137,137
Colusa,54,2022-12-26,14,14,14,0,150,151,150,1,0,0,0,0,22,22,22,22
Contra Costa,54,2022-12-26,1454,1466,1466,0,13725,13821,13820,1,89,10,10,11,1517,1517,1507,1507
Del Norte,54,2022-12-26,33,33,33,0,420,423,422,1,3,0,0,0,56,56,56,56
El Dorado,54,2022-12-26,152,152,152,0,1317,1329,1328,1,7,1,1,0,240,240,239,239
Fresno,54,2022-12-26,1078,1085,1085,0,10644,10721,10720,1,186,10,10,33,2947,2947,2937,2937
Glenn,54,2022-12-26,12,12,12,0,196,198,197,1,0,0,0,0,53,53,53,53
Humboldt,54,2022-12-26,82,82,82,0,629,635,634,1,5,2,2,2,167,167,165,165
Imperial,54,2022-12-26,235,235,235,0,2162,2179,2178,1,67,2,2,0,973,973,971,971
Inyo,54,2022-12-26,13,13,13,0,158,159,158,1,1,0,0,0,62,62,62,62
Kern,54,2022-12-26,690,695,695,0,8722,8784,8783,1,51,9,9,8,2460,2460,2451,2451
Kings,54,2022-12-26,201,201,201,0,2297,2314,2313,1,5,0,0,2,475,475,475,475
Lake,54,2022-12-26,58,58,58,0,600,605,604,1,3,0,0,1,152,152,152,152
Lassen,54,2022-12-26,27,27,27,0,485,487,486,1,0,0,0,0,64,64,64,64
Los Angeles,54,2022-12-26,13432,13528,13528,0,132098,133032,133030,2,1032,170,177,164,34665,34683,34495,34506
Madera,54,2022-12-26,166,166,166,0,1563,1575,1574,1,6,0,0,1,375,375,375,375
Marin,54,2022-12-26,216,216,216,0,2555,2576,2575,1,29,0,0,2,317,317,317,317
Mariposa,54,2022-12-26,22,22,22,0,105,106,105,1,0,0,0,0,30,30,30,30
Mendocino,54,2022-12-26,75,75,75,0,646,652,651,1,10,0,0,0,139,139,139,139
Merced,54,2022-12-26,212,212,212,0,1964,1980,1979,1,17,5,5,3,895,895,890,890
Modoc,54,2022-12-26,4,4,4,0,11,12,11,1,0,0,0,0,9,9,9,9
Mono,54,2022-12-26,10,10,10,0,82,83,82,1,0,0,0,0,8,8,8,8
Monterey,54,2022-12-26,191,191,191,0,2956,2978,2977,1,21,4,4,0,787,787,783,783
Napa,54,2022-12-26,142,142,142,0,1718,1730,1729,1,12,0,0,0,160,160,160,160
Nevada,54,2022-12-26,66,66,66,0,749,756,755,1,9,0,0,1,136,136,136,136
Orange,54,2022-12-26,3155,3177,3177,0,24462,24635,24634,1,274,38,38,31,7784,7784,7746,7746
Placer,54,2022-12-26,293,293,293,0,3038,3060,3059,1,87,2,2,12,677,677,675,675
Plumas,54,2022-12-26,10,10,10,0,123,124,123,1,0,0,0,0,13,13,13,13
Riverside,54,2022-12-26,2855,2875,2875,0,18262,18391,18390,1,194,12,12,18,6748,6748,6736,6736
Sacramento,54,2022-12-26,1366,1377,1377,0,14466,14569,14568,1,179,12,12,25,3440,3440,3428,3428
San Benito,54,2022-12-26,106,106,106,0,810,817,816,1,1,0,0,1,109,109,109,109
San Bernardino,54,2022-12-26,2864,2885,2885,0,19895,20036,20035,1,210,7,7,26,8119,8119,8112,8112
San Diego,54,2022-12-26,4593,4625,4625,0,28541,28745,28744,1,395,25,25,45,5693,5693,5668,5668
San Francisco,54,2022-12-26,1011,1017,1017,0,11737,11820,11819,1,90,20,20,15,1141,1141,1121,1121
San Joaquin,54,2022-12-26,749,754,754,0,10079,10152,10151,1,60,7,7,10,2390,2390,2383,2383
San Luis Obispo,54,2022-12-26,212,212,212,0,1971,1987,1986,1,20,3,3,0,542,542,539,539
San Mateo,54,2022-12-26,818,823,823,0,8789,8852,8851,1,55,0,0,6,740,740,740,740
Santa Barbara,54,2022-12-26,486,490,490,0,4096,4125,4124,1,40,0,0,4,749,749,749,749
Santa Clara,54,2022-12-26,2272,2289,2289,0,23758,23929,23928,1,179,9,9,35,2633,2633,2624,2624
Santa Cruz,54,2022-12-26,221,221,221,0,4639,4671,4670,1,25,0,0,2,276,276,276,276
Shasta,54,2022-12-26,100,100,100,0,923,931,930,1,18,0,0,1,597,597,597,597
Siskiyou,54,2022-12-26,17,17,17,0,266,267,266,1,1,0,0,0,95,95,95,95
Solano,54,2022-12-26,648,653,653,0,5238,5276,5275,1,59,2,2,7,470,470,468,468
Sonoma,54,2022-12-26,453,456,456,0,4246,4277,4276,1,39,1,1,4,543,543,542,542
Stanislaus,54,2022-12-26,451,454,454,0,4898,4933,4932,1,96,10,10,5,1820,1820,1810,1810
Sutter,54,2022-12-26,128,128,128,0,928,937,936,1,0,0,0,0,234,234,234,234
Tehama,54,2022-12-26,48,48,48,0,607,612,611,1,2,3,3,0,223,223,220,220
Trinity,54,2022-12-26,3,3,3,0,39,40,39,1,0,0,0,0,22,22,22,22
Tulare,54,2022-12-26,442,444,444,0,3938,3966,3965,1,41,7,7,3,1562,1562,1555,1555
Tuolumne,54,2022-12-26,93,93,93,0,758,766,765,1,6,0,0,2,202,202,202,202
Ventura,54,2022-12-26,888,895,895,0,7838,7894,7893,1,71,16,16,11,1638,1638,1622,1622
Yolo,54,2022-12-26,140,140,140,0,1603,1616,1615,1,9,2,2,1,432,432,430,430
Yuba,54,2022-12-26,99,99,99,0,754,760,759,1,14,0,0,0,122,122,122,122
Alameda,55,2023-01-02,1820,1835,1835,0,19728,19891,19890,1,175,14,14,19,2149,2149,2135,2135
Amador,55,2023-01-02,34,34,34,0,675,683,682,1,3,1,1,0,98,98,97,97
Butte,55,2023-01-02,98,98,98,0,1327,1340,1339,1,35,3,3,2,482,482,479,479
Calaveras,55,2023-01-02,33,33,33,0,361,364,363,1,0,2,2,0,140,140,138,138
Colusa,55,2023-01-02,5,5,5,0,94,95,94,1,0,0,0,0,22,22,22,22
Contra Costa,55,2023-01-02,1380,1391,1391,0,14027,14143,14142,1,89,5,5,13,1522,1522,1517,1517
Del Norte,55,2023-01-02,32,32,32,0,408,411,410,1,3,0,0,2,56,56,56,56
El Dorado,55,2023-01-02,147,147,147,0,1408,1422,1421,1,7,1,1,2,241,241,240,240
Fresno,55,2023-01-02,1063,1072,1072,0,11335,11428,11427,1,195,16,16,28,2963,2963,2947,2947
Glenn,55,2023-01-02,12,12,12,0,190,192,191,1,0,0,0,0,53,53,53,53
Humboldt,55,2023-01-02,47,47,47,0,614,620,619,1,2,0,0,2,167,167,167,167
Imperial,55,2023-01-02,205,205,205,0,2034,2053,2052,1,11,0,0,1,973,973,973,973
Inyo,55,2023-01-02,16,16,16,0,226,228,227,1,1,0,0,0,62,62,62,62
Kern,55,2023-01-02,888,894,894,0,9583,9662,9661,1,66,2,2,8,2462,2462,2460,2460
Kings,55,2023-01-02,186,186,186,0,2165,2183,2182,1,4,2,2,1,477,477,475,475
Lake,55,2023-01-02,46,46,46,0,603,610,609,1,3,1,1,0,153,153,152,152
Lassen,55,2023-01-02,14,14,14,0,490,495,494,1,0,0,0,0,64,64,64,64
Los Angeles,55,2023-01-02,13329,13438,13438,0,135846,136967,136965,2,1091,143,151,154,34808,34834,34665,34683
Madera,55,2023-01-02,153,153,153,0,1650,1665,1664,1,7,0,0,0,375,375,375,375
Marin,55,2023-01-02,224,224,224,0,2408,2429,2428,1,24,0,0,2,317,317,317,317
Mariposa,55,2023-01-02,15,15,15,0,94,95,94,1,0,0,0,0,30,30,30,30
Mendocino,55,2023-01-02,59,59,59,0,687,694,693,1,6,1,1,3,140,140,139,139
Merced,55,2023-01-02,194,194,194,0,2012,2029,2028,1,8,2,2,4,897,897,895,895
Modoc,55,2023-01-02,9,9,9,0,13,14,13,1,0,0,0,0,9,9,9,9
Mono,55,2023-01-02,10,10,10,0,66,67,66,1,0,0,0,0,8,8,8,8
Monterey,55,2023-01-02,215,215,215,0,3041,3067,3066,1,27,0,0,0,787,787,787,787
Napa,55,2023-01-02,124,124,124,0,1676,1691,1690,1,8,1,1,1,161,161,160,160
Nevada,55,2023-01-02,54,54,54,0,721,728,727,1,8,0,0,2,136,136,136,136
Orange,55,2023-01-02,3186,3213,3213,0,24749,24953,24952,1,312,37,37,28,7821,7821,7784,7784
Placer,55,2023-01-02,302,302,302,0,3231,3258,3257,1,108,1,1,8,678,678,677,677
Plumas,55,2023-01-02,12,12,12,0,145,146,145,1,1,1,1,0,14,14,13,13
Riverside,55,2023-01-02,3036,3061,3061,0,19661,19823,19822,1,223,8,8,31,6756,6756,6748,6748
Sacramento,55,2023-01-02,1506,1518,1518,0,15212,15338,15337,1,201,19,19,26,3459,3459,3440,3440
San Benito,55,2023-01-02,58,58,58,0,790,798,797,1,1,0,0,1,109,109,109,109
San Bernardino,55,2023-01-02,2820,2842,2842,0,20608,20778,20777,1,183,3,3,31,8122,8122,8119,8119
San Diego,55,2023-01-02,4632,4670,4670,0,29186,29428,29427,1,401,24,24,43,5717,5717,5693,5693
San Francisco,55,2023-01-02,879,887,887,0,10123,10206,10205,1,77,11,11,15,1152,1152,1141,1141
San Joaquin,55,2023-01-02,753,759,759,0,10407,10494,10493,1,62,6,6,12,2396,2396,2390,2390
San Luis Obispo,55,2023-01-02,210,210,210,0,1994,2012,2011,1,17,6,6,0,548,548,542,542
San Mateo,55,2023-01-02,719,724,724,0,7887,7953,7952,1,50,0,0,9,740,740,740,740
Santa Barbara,55,2023-01-02,433,438,438,0,4040,4075,4074,1,47,1,1,5,750,750,749,749
Santa Clara,55,2023-01-02,2395,2416,2416,0,23023,23214,23213,1,200,15,15,32,2648,2648,2633,2633
Santa Cruz,55,2023-01-02,171,171,171,0,3000,3024,3023,1,27,0,0,0,276,276,276,276
Shasta,55,2023-01-02,98,98,98,0,945,954,953,1,20,0,0,1,597,597,597,597
Siskiyou,55,2023-01-02,15,15,15,0,268,269,268,1,1,0,0,0,95,95,95,95
Solano,55,2023-01-02,638,643,643,0,5295,5340,5339,1,60,3,3,11,473,473,470,470
Sonoma,55,2023-01-02,422,426,426,0,4255,4291,4290,1,56,0,0,2,543,543,543,543
Stanislaus,55,2023-01-02,474,478,478,0,5017,5059,5058,1,88,6,6,8,1826,1826,1820,1820
Sutter,55,2023-01-02,97,97,97,0,887,896,895,1,0,0,0,0,234,234,234,234
Tehama,55,2023-01-02,54,54,54,0,621,627,626,1,2,5,5,0,228,228,223,223
Trinity,55,2023-01-02,4,4,4,0,41,42,41,1,0,0,0,0,22,22,22,22
Tulare,55,2023-01-02,470,474,474,0,4714,4753,4752,1,52,1,1,6,1563,1563,1562,1562
Tuolumne,55,2023-01-02,66,66,66,0,662,669,668,1,5,0,0,0,202,202,202,202
Ventura,55,2023-01-02,902,910,910,0,7461,7524,7523,1,87,10,10,13,1648,1648,1638,1638
Yolo,55,2023-01-02,135,135,135,0,1520,1533,1532,1,4,2,2,1,434,434,432,432
Yuba,55,2023-01-02,79,79,79,0,730,737,736,1,19,0,0,1,122,122,122,122
Alameda,56,2023-01-09,1470,1483,1483,0,23074,23299,23298,1,149,12,12,11,2161,2161,2149,2149
Amador,56,2023-01-09,28,28,28,0,706,714,713,1,2,0,0,0,98,98,98,98
Butte,56,2023-01-09,86,86,86,0,1199,1212,1211,1,39,2,2,3,484,484,482,482
Calaveras,56,2023-01-09,19,19,19,0,341,345,344,1,0,0,0,1,140,140,140,140
Colusa,56,2023-01-09,8,8,8,0,92,93,92,1,0,0,0,0,22,22,22,22
Contra Costa,56,2023-01-09,1057,1068,1068,0,15349,15498,15497,1,85,6,6,11,1528,1528,1522,1522
Del Norte,56,2023-01-09,17,17,17,0,367,371,370,1,5,0,0,2,56,56,56,56
El Dorado,56,2023-01-09,87,87,87,0,1453,1468,1467,1,4,0,0,0,241,241,241,241
Fresno,56,2023-01-09,805,813,813,0,11449,11561,11560,1,171,7,7,23,2970,2970,2963,2963
Glenn,56,2023-01-09,8,8,8,0,185,187,186,1,0,0,0,0,53,53,53,53
Humboldt,56,2023-01-09,57,57,57,0,705,713,712,1,7,0,0,4,167,167,167,167
Imperial,56,2023-01-09,162,162,162,0,2438,2463,2462,1,12,2,2,2,975,975,973,973
Inyo,56,2023-01-09,10,10,10,0,205,208,207,1,0,0,0,0,62,62,62,62
Kern,56,2023-01-09,612,617,617,0,10477,10579,10578,1,73,1,1,8,2463,2463,2462,2462
Kings,56,2023-01-09,184,184,184,0,2314,2337,2336,1,9,0,0,0,477,477,477,477
Lake,56,2023-01-09,44,44,44,0,622,629,628,1,3,0,0,0,153,153,153,153
Lassen,56,2023-01-09,19,19,19,0,506,512,511,1,2,0,0,0,64,64,64,64
Los Angeles,56,2023-01-09,10130,10227,10227,0,187853,189681,189679,2,965,141,150,136,34949,34984,34808,34834
Madera,56,2023-01-09,100,100,100,0,1645,1662,1661,1,8,0,0,1,375,375,375,375
Marin,56,2023-01-09,146,146,146,0,2558,2584,2583,1,18,0,0,3,317,317,317,317
Mariposa,56,2023-01-09,9,9,9,0,105,106,105,1,0,1,1,0,31,31,30,30
Mendocino,56,2023-01-09,40,40,40,0,643,651,650,1,10,2,2,3,142,142,140,140
Merced,56,2023-01-09,185,185,185,0,2150,2173,2172,1,11,1,1,1,898,898,897,897
Modoc,56,2023-01-09,8,8,8,0,14,15,14,1,0,0,0,0,9,9,9,9
Mono,56,2023-01-09,12,12,12,0,78,79,78,1,0,0,0,0,8,8,8,8
Monterey,56,2023-01-09,170,170,170,0,3119,3150,3149,1,20,4,4,3,791,791,787,787
Napa,56,2023-01-09,132,132,132,0,1877,1897,1896,1,9,0,0,3,161,161,161,161
Nevada,56,2023-01-09,42,42,42,0,759,768,767,1,6,0,0,0,136,136,136,136
Orange,56,2023-01-09,2398,2421,2421,0,27564,27833,27832,1,267,37,38,34,7858,7859,7821,7821
Placer,56,2023-01-09,259,259,259,0,3386,3421,3420,1,89,0,0,6,678,678,678,678
Plumas,56,2023-01-09,5,5,5,0,88,89,88,1,1,0,0,0,14,14,14,14
Riverside,56,2023-01-09,1975,1995,1995,0,20862,21063,21062,1,186,11,11,26,6767,6767,6756,6756
Sacramento,56,2023-01-09,1012,1022,1022,0,15551,15702,15701,1,178,17,17,28,3476,3476,3459,3459
San Benito,56,2023-01-09,51,51,51,0,817,827,826,1,1,0,0,2,109,109,109,109
San Bernardino,56,2023-01-09,1718,1735,1735,0,20419,20616,20615,1,179,6,6,36,8128,8128,8122,8122
San Diego,56,2023-01-09,3582,3616,3616,0,34792,35132,35131,1,397,24,24,40,5741,5741,5717,5717
San Francisco,56,2023-01-09,785,793,793,0,12709,12833,12832,1,75,6,6,17,1158,1158,1152,1152
San Joaquin,56,2023-01-09,584,591,591,0,10951,11059,11058,1,51,10,10,12,2406,2406,2396,2396
San Luis Obispo,56,2023-01-09,186,187,187,0,2145,2167,2166,1,12,3,3,0,551,551,548,548
San Mateo,56,2023-01-09,597,603,603,0,9544,9637,9636,1,47,0,0,5,740,740,740,740
Santa Barbara,56,2023-01-09,367,370,370,0,4502,4547,4546,1,39,3,3,1,753,753,750,750
Santa Clara,56,2023-01-09,1935,1953,1953,0,28148,28423,28422,1,182,11,11,28,2659,2659,2648,2648
Santa Cruz,56,2023-01-09,152,152,152,0,4061,4101,4100,1,27,0,0,1,276,276,276,276
Shasta,56,2023-01-09,59,59,59,0,889,899,898,1,17,0,0,2,597,597,597,597
Siskiyou,56,2023-01-09,20,20,20,0,233,234,233,1,0,0,0,0,95,95,95,95
Solano,56,2023-01-09,402,407,407,0,5181,5233,5232,1,54,1,1,6,474,474,473,473
Sonoma,56,2023-01-09,286,289,289,0,4754,4802,4801,1,31,2,2,4,545,545,543,543
Stanislaus,56,2023-01-09,303,305,305,0,5177,5229,5228,1,87,6,6,8,1832,1832,1826,1826
Sutter,56,2023-01-09,62,62,62,0,869,879,878,1,0,0,0,0,234,234,234,234
Tehama,56,2023-01-09,28,28,28,0,491,497,496,1,1,2,2,0,230,230,228,228
Trinity,56,2023-01-09,3,3,3,0,30,31,30,1,0,0,0,0,22,22,22,22
Tulare,56,2023-01-09,334,338,338,0,5103,5153,5152,1,53,4,4,2,1567,1567,1563,1563
Tuolumne,56,2023-01-09,74,74,74,0,654,662,661,1,2,0,0,0,202,202,202,202
Ventura,56,2023-01-09,662,669,669,0,9359,9451,9450,1,65,5,5,12,1653,1653,1648,1648
Yolo,56,2023-01-09,107,107,107,0,1654,1671,1670,1,2,2,2,1,436,436,434,434
Yuba,56,2023-01-09,48,48,48,0,735,743,742,1,21,0,0,1,122,122,122,122
Alameda,57,2023-01-16,864,873,873,0,18930,19141,19140,1,105,5,5,11,2166,2166,2161,2161
Amador,57,2023-01-16,21,21,21,0,585,594,593,1,4,0,0,0,98,98,98,98
Butte,57,2023-01-16,58,58,58,0,1157,1170,1169,1,21,1,1,0,485,485,484,484
Calaveras,57,2023-01-16,10,10,10,0,308,313,312,1,2,0,0,1,140,140,140,140
Colusa,57,2023-01-16,7,7,7,0,86,87,86,1,1,0,0,0,22,22,22,22
Contra Costa,57,2023-01-16,617,624,624,0,12083,12216,12215,1,61,5,5,11,1533,1533,1528,1528
Del Norte,57,2023-01-16,10,10,10,0,303,306,305,1,3,2,2,1,58,58,56,56
El Dorado,57,2023-01-16,61,61,61,0,978,990,989,1,2,1,1,1,242,242,241,241
Fresno,57,2023-01-16,461,466,466,0,9714,9822,9821,1,162,7,7,13,2977,2977,2970,2970
Glenn,57,2023-01-16,3,3,3,0,163,165,164,1,0,0,0,0,53,53,53,53
Humboldt,57,2023-01-16,35,35,35,0,494,501,500,1,9,1,1,2,168,168,167,167
Imperial,57,2023-01-16,127,127,127,0,2068,2091,2090,1,10,2,2,2,977,977,975,975
Inyo,57,2023-01-16,11,11,11,0,199,202,201,1,0,0,0,0,62,62,62,62
Kern,57,2023-01-16,384,388,388,0,8223,8316,8315,1,55,4,4,13,2467,2467,2463,2463
Kings,57,2023-01-16,125,125,125,0,1982,2006,2005,1,5,2,2,0,479,479,477,477
Lake,57,2023-01-16,23,23,23,0,575,582,581,1,2,1,1,1,154,154,153,153
Lassen,57,2023-01-16,6,6,6,0,440,446,445,1,0,0,0,0,64,64,64,64
Los Angeles,57,2023-01-16,6102,6170,6170,0,147476,149116,149114,2,855,140,151,113,35089,35135,34949,34984
Madera,57,2023-01-16,67,67,67,0,1349,1365,1364,1,4,0,0,2,375,375,375,375
Marin,57,2023-01-16,124,124,124,0,2137,2161,2160,1,20,0,0,1,317,317,317,317
Mariposa,57,2023-01-16,11,11,11,0,95,96,95,1,0,0,0,0,31,31,31,31
Mendocino,57,2023-01-16,25,25,25,0,499,506,505,1,6,0,0,0,142,142,142,142
Merced,57,2023-01-16,120,120,120,0,1681,1701,1700,1,12,3,3,5,901,901,898,898
Modoc,57,2023-01-16,2,2,2,0,9,10,9,1,0,0,0,0,9,9,9,9
Mono,57,2023-01-16,6,6,6,0,68,69,68,1,0,0,0,0,8,8,8,8
Monterey,57,2023-01-16,113,113,113,0,2601,2632,2631,1,20,3,3,2,794,794,791,791
Napa,57,2023-01-16,63,63,63,0,1508,1525,1524,1,5,0,0,0,161,161,161,161
Nevada,57,2023-01-16,24,24,24,0,564,572,571,1,4,0,0,0,136,136,136,136
Orange,57,2023-01-16,1447,1464,1464,0,23903,24169,24168,1,245,36,38,32,7894,7897,7858,7859
Placer,57,2023-01-16,163,163,163,0,2631,2661,2660,1,68,0,0,6,678,678,678,678
Plumas,57,2023-01-16,2,2,2,0,71,72,71,1,1,0,0,0,14,14,14,14
Riverside,57,2023-01-16,1214,1227,1227,0,16949,17137,17136,1,169,15,15,36,6782,6782,6767,6767
Sacramento,57,2023-01-16,567,574,574,0,12387,12527,12526,1,149,18,19,23,3494,3495,3476,3476
San Benito,57,2023-01-16,28,28,28,0,467,474,473,1,0,1,1,0,110,110,109,109
San Bernardino,57,2023-01-16,985,997,997,0,16605,16791,16790,1,148,2,2,35,8130,8130,8128,8128
San Diego,57,2023-01-16,2062,2085,2085,0,28430,28748,28747,1,327,14,14,39,5755,5755,5741,5741
San Francisco,57,2023-01-16,439,444,444,0,10123,10236,10235,1,75,1,1,12,1159,1159,1158,1158
San Joaquin,57,2023-01-16,355,360,360,0,8772,8870,8869,1,42,8,8,11,2414,2414,2406,2406
San Luis Obispo,57,2023-01-16,108,108,108,0,1776,1797,1796,1,12,2,2,3,553,553,551,551
San Mateo,57,2023-01-16,388,394,394,0,7656,7743,7742,1,37,0,0,3,740,740,740,740
Santa Barbara,57,2023-01-16,242,244,244,0,3918,3962,3961,1,34,2,2,0,755,755,753,753
Santa Clara,57,2023-01-16,1090,1102,1102,0,23747,24012,24011,1,106,15,15,16,2674,2674,2659,2659
Santa Cruz,57,2023-01-16,171,171,171,0,6495,6567,6566,1,23,0,0,1,276,276,276,276
Shasta,57,2023-01-16,40,40,40,0,690,699,698,1,13,2,2,2,599,599,597,597
Siskiyou,57,2023-01-16,6,6,6,0,208,209,208,1,0,0,0,0,95,95,95,95
Solano,57,2023-01-16,222,223,223,0,3709,3751,3750,1,49,0,0,6,474,474,474,474
Sonoma,57,2023-01-16,189,189,189,0,3768,3811,3810,1,26,5,5,2,550,550,545,545
Stanislaus,57,2023-01-16,206,206,206,0,4244,4294,4293,1,72,3,3,3,1835,1835,1832,1832
Sutter,57,2023-01-16,47,47,47,0,713,722,721,1,0,0,0,0,234,234,234,234
Tehama,57,2023-01-16,16,16,16,0,367,373,372,1,1,0,0,0,230,230,230,230
Trinity,57,2023-01-16,3,3,3,0,23,24,23,1,0,0,0,0,22,22,22,22
Tulare,57,2023-01-16,264,267,267,0,4120,4167,4166,1,45,2,2,2,1569,1569,1567,1567
Tuolumne,57,2023-01-16,44,44,44,0,548,556,555,1,1,0,0,0,202,202,202,202
Ventura,57,2023-01-16,413,418,418,0,7819,7906,7905,1,53,4,4,12,1657,1657,1653,1653
Yolo,57,2023-01-16,74,74,74,0,1250,1266,1265,1,2,2,2,0,438,438,436,436
Yuba,57,2023-01-16,38,38,38,0,595,603,602,1,9,0,0,2,122,122,122,122
Alameda,58,2023-01-23,734,743,743,0,21015,21279,21278,1,100,11,11,9,2177,2177,2166,2166
Amador,58,2023-01-23,34,34,34,0,590,599,598,1,1,1,1,0,99,99,98,98
Butte,58,2023-01-23,42,42,42,0,1080,1094,1093,1,13,1,1,0,486,486,485,485
Calaveras,58,2023-01-23,15,15,15,0,279,283,282,1,0,0,0,0,140,140,140,140
Colusa,58,2023-01-23,10,10,10,0,142,144,143,1,0,0,0,0,22,22,22,22
Contra Costa,58,2023-01-23,515,522,522,0,13282,13450,13449,1,61,6,6,6,1539,1539,1533,1533
Del Norte,58,2023-01-23,22,22,22,0,359,365,364,1,1,0,0,0,58,58,58,58
El Dorado,58,2023-01-23,40,40,40,0,1080,1094,1093,1,2,0,0,0,242,242,242,242
Fresno,58,2023-01-23,441,447,447,0,10083,10211,10210,1,117,5,5,19,2982,2982,2977,2977
Glenn,58,2023-01-23,3,3,3,0,153,155,154,1,0,0,0,0,53,53,53,53
Humboldt,58,2023-01-23,34,34,34,0,549,556,555,1,9,1,1,4,169,169,168,168
Imperial,58,2023-01-23,84,84,84,0,2257,2287,2286,1,10,0,0,1,977,977,977,977
Inyo,58,2023-01-23,6,6,6,0,164,166,165,1,0,1,1,0,63,63,62,62
Kern,58,2023-01-23,302,307,307,0,9212,9328,9327,1,34,3,3,8,2470,2470,2467,2467
Kings,58,2023-01-23,108,108,108,0,1984,2011,2010,1,6,0,0,0,479,479,479,479
Lake,58,2023-01-23,28,28,28,0,579,588,587,1,2,2,2,2,156,156,154,154
Lassen,58,2023-01-23,5,5,5,0,465,472,471,1,0,0,0,0,64,64,64,64
Los Angeles,58,2023-01-23,5592,5663,5663,0,168902,171018,171016,2,665,108,119,96,35197,35254,35089,35135
Madera,58,2023-01-23,51,51,51,0,1433,1451,1450,1,6,0,0,2,375,375,375,375
Marin,58,2023-01-23,108,108,108,0,2350,2381,2380,1,18,0,0,3,317,317,317,317
Mariposa,58,2023-01-23,7,7,7,0,103,104,103,1,0,0,0,0,31,31,31,31
Mendocino,58,2023-01-23,21,21,21,0,546,553,552,1,4,0,0,0,142,142,142,142
Merced,58,2023-01-23,126,126,126,0,1922,1947,1946,1,9,2,2,3,903,903,901,901
Modoc,58,2023-01-23,1,1,1,0,11,12,11,1,1,0,0,0,9,9,9,9
Mono,58,2023-01-23,5,5,5,0,73,74,73,1,0,0,0,0,8,8,8,8
Monterey,58,2023-01-23,106,106,106,0,2753,2789,2788,1,15,1,1,2,795,795,794,794
Napa,58,2023-01-23,78,78,78,0,1506,1526,1525,1,4,0,0,1,161,161,161,161
Nevada,58,2023-01-23,20,20,20,0,600,610,609,1,3,0,0,2,136,136,136,136
Orange,58,2023-01-23,1156,1169,1169,0,23848,24147,24146,1,177,23,24,27,7917,7921,7894,7897
Placer,58,2023-01-23,139,139,139,0,2717,2752,2751,1,42,1,1,7,679,679,678,678
Plumas,58,2023-01-23,5,5,5,0,90,91,90,1,1,0,0,0,14,14,14,14
Riverside,58,2023-01-23,1010,1022,1022,0,16073,16276,16275,1,111,12,12,22,6794,6794,6782,6782
Sacramento,58,2023-01-23,594,602,602,0,13675,13849,13848,1,134,10,10,21,3504,3505,3494,3495
San Benito,58,2023-01-23,27,27,27,0,563,570,569,1,0,0,0,0,110,110,110,110
San Bernardino,58,2023-01-23,1027,1039,1039,0,18966,19204,19203,1,127,1,1,33,8131,8131,8130,8130
San Diego,58,2023-01-23,2025,2050,2050,0,33038,33455,33454,1,236,9,9,37,5764,5764,5755,5755
San Francisco,58,2023-01-23,450,457,457,0,11230,11372,11371,1,58,6,6,5,1165,1165,1159,1159
San Joaquin,58,2023-01-23,242,243,243,0,8399,8506,8505,1,29,3,3,8,2417,2417,2414,2414
San Luis Obispo,58,2023-01-23,110,110,110,0,1949,1975,1974,1,8,3,3,2,556,556,553,553
San Mateo,58,2023-01-23,346,351,351,0,8645,8755,8754,1,21,0,0,0,740,740,740,740
Santa Barbara,58,2023-01-23,209,210,210,0,4241,4295,4294,1,28,2,2,4,757,757,755,755
Santa Clara,58,2023-01-23,1012,1024,1024,0,24371,24677,24676,1,119,5,5,23,2679,2679,2674,2674
Santa Cruz,58,2023-01-23,121,121,121,0,9480,9602,9601,1,16,0,0,0,276,276,276,276
Shasta,58,2023-01-23,23,23,23,0,747,758,757,1,6,1,1,1,600,600,599,599
Siskiyou,58,2023-01-23,6,6,6,0,178,179,178,1,0,0,0,0,95,95,95,95
Solano,58,2023-01-23,228,231,231,0,4211,4265,4264,1,33,0,0,2,474,474,474,474
Sonoma,58,2023-01-23,199,199,199,0,4277,4333,4332,1,26,0,0,4,550,550,550,550
Stanislaus,58,2023-01-23,180,180,180,0,4287,4342,4341,1,57,2,2,6,1837,1837,1835,1835
Sutter,58,2023-01-23,41,41,41,0,778,789,788,1,0,1,1,0,235,235,234,234
Tehama,58,2023-01-23,15,15,15,0,295,299,298,1,1,0,0,0,230,230,230,230
Trinity,58,2023-01-23,4,4,4,0,31,32,31,1,0,1,1,0,23,23,22,22
Tulare,58,2023-01-23,220,221,221,0,4168,4221,4220,1,27,1,1,5,1570,1570,1569,1569
Tuolumne,58,2023-01-23,36,36,36,0,484,492,491,1,0,0,0,1,202,202,202,202
Ventura,58,2023-01-23,367,373,373,0,8578,8687,8686,1,57,5,5,3,1662,1662,1657,1657
Yolo,58,2023-01-23,84,84,84,0,1364,1381,1380,1,2,3,3,0,441,441,438,438
Yuba,58,2023-01-23,29,29,29,0,725,736,735,1,3,0,0,0,122,122,122,122
Alameda,59,2023-01-30,833,845,845,0,18314,18576,18575,1,85,3,3,4,2180,2180,2177,2177
Amador,59,2023-01-30,24,24,24,0,620,631,630,1,3,0,0,0,99,99,99,99
Butte,59,2023-01-30,55,55,55,0,1124,1140,1139,1,13,1,1,2,487,487,486,486
Calaveras,59,2023-01-30,15,15,15,0,318,324,323,1,0,0,0,0,140,140,140,140
Colusa,59,2023-01-30,7,7,7,0,169,172,171,1,0,0,0,0,22,22,22,22
Contra Costa,59,2023-01-30,647,655,655,0,12401,12579,12578,1,38,9,9,6,1548,1548,1539,1539
Del Norte,59,2023-01-30,31,31,31,0,382,389,388,1,1,1,1,0,59,59,58,58
El Dorado,59,2023-01-30,60,60,60,0,1190,1209,1208,1,4,2,2,0,244,244,242,242
Fresno,59,2023-01-30,445,452,452,0,9854,9996,9995,1,117,8,8,10,2990,2990,2982,2982
Glenn,59,2023-01-30,2,2,2,0,155,157,156,1,0,0,0,0,53,53,53,53
Humboldt,59,2023-01-30,29,29,29,0,563,572,571,1,6,0,0,1,169,169,169,169
Imperial,59,2023-01-30,103,103,103,0,2068,2100,2099,1,7,0,0,0,977,977,977,977
Inyo,59,2023-01-30,10,10,10,0,202,206,205,1,1,0,0,0,63,63,63,63
Kern,59,2023-01-30,301,306,306,0,8706,8833,8832,1,36,1,1,8,2471,2471,2470,2470
Kings,59,2023-01-30,136,136,136,0,2211,2243,2242,1,7,0,0,1,479,479,479,479
Lake,59,2023-01-30,26,26,26,0,555,564,563,1,5,2,2,1,158,158,156,156
Lassen,59,2023-01-30,4,4,4,0,490,498,497,1,0,0,0,0,64,64,64,64
Los Angeles,59,2023-01-30,5772,5854,5854,0,150941,153103,153101,2,633,104,117,72,35301,35371,35197,35254
Madera,59,2023-01-30,48,48,48,0,1478,1500,1499,1,7,0,0,0,375,375,375,375
Marin,59,2023-01-30,97,97,97,0,2152,2184,2183,1,19,0,0,1,317,317,317,317
Mariposa,59,2023-01-30,5,5,5,0,105,106,105,1,0,0,0,0,31,31,31,31
Mendocino,59,2023-01-30,24,24,24,0,517,526,525,1,2,0,0,1,142,142,142,142
Merced,59,2023-01-30,135,135,135,0,1797,1823,1822,1,11,0,0,3,903,903,903,903
Modoc,59,2023-01-30,0,0,0,0,8,9,8,1,1,0,0,0,9,9,9,9
Mono,59,2023-01-30,2,2,2,0,67,68,67,1,0,0,0,0,8,8,8,8
Monterey,59,2023-01-30,155,155,155,0,2846,2888,2887,1,8,1,1,1,796,796,795,795
Napa,59,2023-01-30,72,72,72,0,1370,1392,1391,1,4,0,0,0,161,161,161,161
Nevada,59,2023-01-30,29,29,29,0,589,598,597,1,2,0,0,1,136,136,136,136
Orange,59,2023-01-30,1182,1199,1199,0,22513,22835,22834,1,136,11,11,25,7928,7932,7917,7921
Placer,59,2023-01-30,169,169,169,0,2705,2745,2744,1,49,2,2,3,681,681,679,679
Plumas,59,2023-01-30,3,3,3,0,75,76,75,1,0,0,0,0,14,14,14,14
Riverside,59,2023-01-30,1071,1086,1086,0,15878,16106,16105,1,84,4,4,17,6798,6798,6794,6794
Sacramento,59,2023-01-30,662,672,672,0,13344,13536,13535,1,117,8,8,13,3512,3513,3504,3505
San Benito,59,2023-01-30,30,30,30,0,562,571,570,1,0,0,0,0,110,110,110,110
San Bernardino,59,2023-01-30,922,936,936,0,17117,17364,17363,1,140,0,0,19,8131,8131,8131,8131
San Diego,59,2023-01-30,1857,1883,1883,0,30025,30456,30455,1,202,10,10,32,5774,5774,5764,5764
San Francisco,59,2023-01-30,472,479,479,0,10852,11006,11005,1,51,2,2,4,1167,1167,1165,1165
San Joaquin,59,2023-01-30,301,306,306,0,7656,7766,7765,1,22,2,2,5,2419,2419,2417,2417
San Luis Obispo,59,2023-01-30,141,141,141,0,1912,1941,1940,1,13,5,5,0,561,561,556,556
San Mateo,59,2023-01-30,425,431,431,0,8558,8682,8681,1,25,0,0,3,740,740,740,740
Santa Barbara,59,2023-01-30,226,229,229,0,4263,4325,4324,1,25,1,1,2,758,758,757,757
Santa Clara,59,2023-01-30,1171,1187,1187,0,23403,23740,23739,1,132,5,5,14,2684,2684,2679,2679
Santa Cruz,59,2023-01-30,133,133,133,0,9328,9463,9462,1,12,0,0,0,276,276,276,276
Shasta,59,2023-01-30,18,18,18,0,656,667,666,1,7,0,0,0,600,600,600,600
Siskiyou,59,2023-01-30,6,6,6,0,195,198,197,1,0,0,0,0,95,95,95,95
Solano,59,2023-01-30,234,236,236,0,4167,4229,4228,1,40,0,0,1,474,474,474,474
Sonoma,59,2023-01-30,156,157,157,0,3594,3647,3646,1,23,1,1,1,551,551,550,550
Stanislaus,59,2023-01-30,229,231,231,0,4127,4187,4186,1,43,2,2,3,1839,1839,1837,1837
Sutter,59,2023-01-30,36,36,36,0,608,618,617,1,0,1,1,0,236,236,235,235
Tehama,59,2023-01-30,8,8,8,0,255,261,260,1,1,1,1,0,231,231,230,230
Trinity,59,2023-01-30,7,7,7,0,26,27,26,1,0,0,0,0,23,23,23,23
Tulare,59,2023-01-30,262,265,265,0,4020,4080,4079,1,28,3,3,3,1573,1573,1570,1570
Tuolumne,59,2023-01-30,45,45,45,0,600,610,609,1,3,0,0,0,202,202,202,202
Ventura,59,2023-01-30,363,369,369,0,8119,8237,8236,1,46,7,7,8,1669,1669,1662,1662
Yolo,59,2023-01-30,85,85,85,0,1296,1316,1315,1,2,1,1,0,442,442,441,441
Yuba,59,2023-01-30,31,31,31,0,656,666,665,1,3,0,0,1,122,122,122,122
Alameda,60,2023-02-06,1094,1112,1112,0,18114,18415,18414,1,86,5,5,9,2185,2185,2180,2180
Amador,60,2023-02-06,29,29,29,0,637,648,647,1,1,0,0,0,99,99,99,99
Butte,60,2023-02-06,82,82,82,0,1208,1228,1227,1,20,0,0,1,487,487,487,487
Calaveras,60,2023-02-06,14,14,14,0,323,330,329,1,0,0,0,0,140,140,140,140
Colusa,60,2023-02-06,6,6,6,0,184,187,186,1,0,0,0,0,22,22,22,22
Contra Costa,60,2023-02-06,709,720,720,0,11843,12038,12037,1,50,2,2,9,1550,1550,1548,1548
Del Norte,60,2023-02-06,58,58,58,0,394,402,401,1,0,0,0,0,59,59,59,59
El Dorado,60,2023-02-06,59,59,59,0,1132,1151,1150,1,3,0,0,0,244,244,244,244
Fresno,60,2023-02-06,500,508,508,0,9021,9171,9170,1,89,4,4,15,2994,2994,2990,2990
Glenn,60,2023-02-06,10,10,10,0,170,173,172,1,0,0,0,0,53,53,53,53
Humboldt,60,2023-02-06,54,54,54,0,565,575,574,1,6,1,1,0,170,170,169,169
Imperial,60,2023-02-06,120,120,120,0,2097,2131,2130,1,7,1,1,0,978,978,977,977
Inyo,60,2023-02-06,9,9,9,0,209,213,212,1,0,0,0,0,63,63,63,63
Kern,60,2023-02-06,327,334,334,0,8523,8665,8664,1,34,2,2,4,2473,2473,2471,2471
Kings,60,2023-02-06,126,126,126,0,2055,2088,2087,1,3,0,0,1,479,479,479,479
Lake,60,2023-02-06,25,25,25,0,561,571,570,1,5,1,1,0,159,159,158,158
Lassen,60,2023-02-06,6,6,6,0,445,453,452,1,0,0,0,0,64,64,64,64
Los Angeles,60,2023-02-06,5877,5975,5975,0,141082,143413,143411,2,609,87,102,83,35388,35473,35301,35371
Madera,60,2023-02-06,55,55,55,0,1308,1332,1331,1,4,1,1,0,376,376,375,375
Marin,60,2023-02-06,142,142,142,0,2129,2165,2164,1,13,0,0,3,317,317,317,317
Mariposa,60,2023-02-06,2,2,2,0,105,106,105,1,0,0,0,0,31,31,31,31
Mendocino,60,2023-02-06,31,31,31,0,513,522,521,1,4,0,0,2,142,142,142,142
Merced,60,2023-02-06,166,167,167,0,1885,1917,1916,1,12,0,0,0,903,903,903,903
Modoc,60,2023-02-06,2,2,2,0,6,7,6,1,0,0,0,0,9,9,9,9
Mono,60,2023-02-06,4,4,4,0,92,93,92,1,0,0,0,0,8,8,8,8
Monterey,60,2023-02-06,227,232,232,0,2937,2986,2985,1,22,3,3,1,799,799,796,796
Napa,60,2023-02-06,109,109,109,0,1406,1430,1429,1,4,0,0,3,161,161,161,161
Nevada,60,2023-02-06,32,32,32,0,572,583,582,1,4,0,0,0,136,136,136,136
Orange,60,2023-02-06,1276,1297,1297,0,22045,22411,22410,1,154,15,17,20,7943,7949,7928,7932
Placer,60,2023-02-06,164,164,164,0,2650,2695,2694,1,41,0,0,4,681,681,681,681
Plumas,60,2023-02-06,1,1,1,0,70,71,70,1,0,1,1,0,15,15,14,14
Riverside,60,2023-02-06,1119,1138,1138,0,15374,15629,15628,1,89,2,2,14,6800,6800,6798,6798
Sacramento,60,2023-02-06,729,742,742,0,13142,13360,13359,1,96,5,6,19,3517,3519,3512,3513
San Benito,60,2023-02-06,50,50,50,0,538,547,546,1,1,0,0,0,110,110,110,110
San Bernardino,60,2023-02-06,1061,1078,1078,0,17309,17595,17594,1,152,0,0,17,8131,8131,8131,8131
San Diego,60,2023-02-06,1869,1900,1900,0,29906,30404,30403,1,230,8,9,23,5782,5783,5774,5774
San Francisco,60,2023-02-06,573,583,583,0,10493,10668,10667,1,58,3,3,2,1170,1170,1167,1167
San Joaquin,60,2023-02-06,433,441,441,0,6926,7044,7043,1,32,1,1,3,2420,2420,2419,2419
San Luis Obispo,60,2023-02-06,147,149,149,0,1901,1934,1933,1,7,1,1,0,562,562,561,561
San Mateo,60,2023-02-06,527,536,536,0,8136,8272,8271,1,42,0,0,1,740,740,740,740
Santa Barbara,60,2023-02-06,238,242,242,0,4364,4436,4435,1,21,1,1,0,759,759,758,758
Santa Clara,60,2023-02-06,1304,1325,1325,0,23215,23600,23599,1,123,9,9,23,2693,2693,2684,2684
Santa Cruz,60,2023-02-06,231,234,234,0,10392,10566,10565,1,11,0,0,0,276,276,276,276
Shasta,60,2023-02-06,24,24,24,0,638,650,649,1,9,0,0,0,600,600,600,600
Siskiyou,60,2023-02-06,11,11,11,0,221,227,226,1,0,0,0,0,95,95,95,95
Solano,60,2023-02-06,285,290,290,0,3850,3915,3914,1,41,0,0,5,474,474,474,474
Sonoma,60,2023-02-06,265,270,270,0,3566,3626,3625,1,17,2,2,1,553,553,551,551
Stanislaus,60,2023-02-06,276,283,283,0,3926,3993,3992,1,54,1,1,6,1840,1840,1839,1839
Sutter,60,2023-02-06,50,50,50,0,705,718,717,1,0,0,0,0,236,236,236,236
Tehama,60,2023-02-06,17,17,17,0,283,291,290,1,2,0,0,0,231,231,231,231
Trinity,60,2023-02-06,1,1,1,0,19,20,19,1,0,0,0,0,23,23,23,23
Tulare,60,2023-02-06,271,276,276,0,4389,4463,4462,1,28,2,2,3,1575,1575,1573,1573
Tuolumne,60,2023-02-06,48,48,48,0,555,564,563,1,1,0,0,0,202,202,202,202
Ventura,60,2023-02-06,324,331,331,0,6921,7036,7035,1,39,1,1,5,1670,1670,1669,1669
Yolo,60,2023-02-06,80,80,80,0,1247,1269,1268,1,4,1,1,2,443,443,442,442
Yuba,60,2023-02-06,22,22,22,0,623,633,632,1,3,0,0,1,122,122,122,122
Alameda,61,2023-02-13,1092,1113,1113,0,17497,17844,17843,1,90,1,1,8,2186,2186,2185,2185
Amador,61,2023-02-13,19,19,19,0,497,507,506,1,0,0,0,0,99,99,99,99
Butte,61,2023-02-13,85,85,85,0,1250,1277,1276,1,25,1,1,2,488,488,487,487
Calaveras,61,2023-02-13,14,14,14,0,295,302,301,1,0,0,0,0,140,140,140,140
Colusa,61,2023-02-13,8,8,8,0,137,139,138,1,0,0,0,0,22,22,22,22
Contra Costa,61,2023-02-13,679,691,691,0,11529,11759,11758,1,44,2,2,10,1552,1552,1550,1550
Del Norte,61,2023-02-13,19,19,19,0,299,306,305,1,2,0,0,0,59,59,59,59
El Dorado,61,2023-02-13,65,65,65,0,1099,1123,1122,1,2,0,0,0,244,244,244,244
Fresno,61,2023-02-13,467,476,476,0,8719,8892,8891,1,106,4,4,7,2998,2998,2994,2994
Glenn,61,2023-02-13,11,11,11,0,175,178,177,1,5,0,0,0,53,53,53,53
Humboldt,61,2023-02-13,35,35,35,0,577,591,590,1,7,0,0,1,170,170,170,170
Imperial,61,2023-02-13,141,144,144,0,1855,1893,1892,1,3,0,0,5,978,978,978,978
Inyo,61,2023-02-13,6,6,6,0,199,203,202,1,0,0,0,0,63,63,63,63
Kern,61,2023-02-13,322,329,329,0,7970,8129,8128,1,37,2,2,6,2475,2475,2473,2473
Kings,61,2023-02-13,88,88,88,0,1890,1928,1927,1,6,1,1,0,480,480,479,479
Lake,61,2023-02-13,20,20,20,0,567,579,578,1,2,0,0,0,159,159,159,159
Lassen,61,2023-02-13,5,5,5,0,361,370,369,1,0,0,0,0,64,64,64,64
Los Angeles,61,2023-02-13,5875,5991,5991,0,129359,131917,131916,1,613,68,85,67,35456,35558,35388,35473
Madera,61,2023-02-13,58,58,58,0,1238,1264,1263,1,7,0,0,2,376,376,376,376
Marin,61,2023-02-13,139,139,139,0,1928,1967,1966,1,19,0,0,3,317,317,317,317
Mariposa,61,2023-02-13,3,3,3,0,102,103,102,1,0,0,0,0,31,31,31,31
Mendocino,61,2023-02-13,28,28,28,0,538,551,550,1,3,2,2,1,144,144,142,142
Merced,61,2023-02-13,167,171,171,0,1856,1894,1893,1,8,0,0,0,903,903,903,903
Modoc,61,2023-02-13,0,0,0,0,2,3,2,1,0,0,0,0,9,9,9,9
Mono,61,2023-02-13,1,1,1,0,66,67,66,1,0,0,0,0,8,8,8,8
Monterey,61,2023-02-13,220,226,226,0,2489,2540,2539,1,25,3,3,1,802,802,799,799
Napa,61,2023-02-13,92,92,92,0,1366,1393,1392,1,4,0,0,0,161,161,161,161
Nevada,61,2023-02-13,35,35,35,0,596,610,609,1,4,0,0,1,136,136,136,136
Orange,61,2023-02-13,1362,1390,1390,0,20350,20751,20750,1,161,8,10,21,7951,7959,7943,7949
Placer,61,2023-02-13,159,163,163,0,2612,2663,2662,1,35,0,0,6,681,681,681,681
Plumas,61,2023-02-13,3,3,3,0,79,80,79,1,1,0,0,0,15,15,15,15
Riverside,61,2023-02-13,1087,1108,1108,0,15939,16256,16255,1,93,6,7,16,6806,6807,6800,6800
Sacramento,61,2023-02-13,813,829,829,0,13019,13276,13275,1,113,5,5,19,3522,3524,3517,3519
San Benito,61,2023-02-13,42,42,42,0,565,578,577,1,1,0,0,0,110,110,110,110
San Bernardino,61,2023-02-13,1009,1029,1029,0,16810,17144,17143,1,134,0,0,18,8131,8131,8131,8131
San Diego,61,2023-02-13,2019,2059,2059,0,29010,29583,29582,1,218,3,3,25,5785,5786,5782,5783
San Francisco,61,2023-02-13,591,603,603,0,10651,10862,10861,1,59,3,3,5,1173,1173,1170,1170
San Joaquin,61,2023-02-13,448,457,457,0,6959,7098,7097,1,28,1,1,3,2421,2421,2420,2420
San Luis Obispo,61,2023-02-13,128,129,129,0,1676,1711,1710,1,4,1,1,4,563,563,562,562
San Mateo,61,2023-02-13,519,529,529,0,8127,8289,8288,1,29,0,0,5,740,740,740,740
Santa Barbara,61,2023-02-13,188,193,193,0,3936,4016,4015,1,16,1,1,5,760,760,759,759
Santa Clara,61,2023-02-13,1356,1383,1383,0,22920,23374,23373,1,114,8,10,25,2701,2703,2693,2693
Santa Cruz,61,2023-02-13,205,209,209,0,9620,9812,9811,1,19,0,0,0,276,276,276,276
Shasta,61,2023-02-13,33,33,33,0,667,682,681,1,7,0,0,0,600,600,600,600
Siskiyou,61,2023-02-13,11,11,11,0,199,205,204,1,0,0,0,0,95,95,95,95
Solano,61,2023-02-13,259,264,264,0,3771,3846,3845,1,28,0,0,3,474,474,474,474
Sonoma,61,2023-02-13,234,239,239,0,3421,3490,3489,1,32,1,1,1,554,554,553,553
Stanislaus,61,2023-02-13,265,271,271,0,3808,3885,3884,1,47,1,1,9,1841,1841,1840,1840
Sutter,61,2023-02-13,46,46,46,0,658,672,671,1,0,1,1,0,237,237,236,236
Tehama,61,2023-02-13,16,16,16,0,283,291,290,1,1,2,2,0,233,233,231,231
Trinity,61,2023-02-13,1,1,1,0,26,27,26,1,0,0,0,0,23,23,23,23
Tulare,61,2023-02-13,241,247,247,0,4114,4198,4197,1,29,2,2,1,1577,1577,1575,1575
Tuolumne,61,2023-02-13,34,34,34,0,508,518,517,1,2,0,0,0,202,202,202,202
Ventura,61,2023-02-13,309,315,315,0,6654,6788,6787,1,29,3,3,6,1673,1673,1670,1670
Yolo,61,2023-02-13,73,73,73,0,1241,1265,1264,1,3,0,0,1,443,443,443,443
Yuba,61,2023-02-13,30,30,30,0,643,656,655,1,8,0,0,0,122,122,122,122
Alameda,62,2023-02-20,1010,1034,1034,0,15331,15712,15711,1,79,3,4,5,2189,2190,2186,2186
Amador,62,2023-02-20,25,25,25,0,496,510,509,1,1,0,0,1,99,99,99,99
Butte,62,2023-02-20,42,42,42,0,1051,1078,1077,1,7,2,3,1,490,491,488,488
Calaveras,62,2023-02-20,17,17,17,0,289,296,295,1,0,0,0,1,140,140,140,140
Colusa,62,2023-02-20,12,12,12,0,92,94,93,1,0,0,0,0,22,22,22,22
Contra Costa,62,2023-02-20,654,669,669,0,9980,10231,10230,1,57,5,7,6,1557,1559,1552,1552
Del Norte,62,2023-02-20,11,11,11,0,258,266,265,1,2,0,0,0,59,59,59,59
El Dorado,62,2023-02-20,51,51,51,0,975,1000,999,1,2,0,0,1,244,244,244,244
Fresno,62,2023-02-20,450,462,462,0,8221,8429,8428,1,84,2,3,17,3000,3001,2998,2998
Glenn,62,2023-02-20,5,5,5,0,146,149,148,1,5,0,0,0,53,53,53,53
Humboldt,62,2023-02-20,30,30,30,0,575,590,589,1,7,0,0,1,170,170,170,170
Imperial,62,2023-02-20,107,108,108,0,1778,1825,1824,1,8,0,0,0,978,978,978,978
Inyo,62,2023-02-20,6,6,6,0,162,166,165,1,0,0,0,0,63,63,63,63
Kern,62,2023-02-20,400,408,408,0,7387,7573,7572,1,29,2,3,5,2477,2478,2475,2475
Kings,62,2023-02-20,77,77,77,0,1638,1679,1678,1,5,1,1,0,481,481,480,480
Lake,62,2023-02-20,18,18,18,0,483,496,495,1,2,0,0,1,159,159,159,159
Lassen,62,2023-02-20,2,2,2,0,327,335,334,1,0,0,0,0,64,64,64,64
Los Angeles,62,2023-02-20,5584,5725,5725,0,117469,120401,120400,1,601,64,90,76,35520,35648,35456,35558
Madera,62,2023-02-20,56,56,56,0,1089,1117,1116,1,3,0,0,2,376,376,376,376
Marin,62,2023-02-20,152,157,157,0,1849,1897,1896,1,13,0,0,2,317,317,317,317
Mariposa,62,2023-02-20,6,6,6,0,121,124,123,1,0,0,0,0,31,31,31,31
Mendocino,62,2023-02-20,25,25,25,0,489,503,502,1,3,0,0,0,144,144,144,144
Merced,62,2023-02-20,122,124,124,0,1753,1798,1797,1,19,0,0,1,903,903,903,903
Modoc,62,2023-02-20,1,1,1,0,15,16,15,1,0,0,0,0,9,9,9,9
Mono,62,2023-02-20,2,2,2,0,66,67,66,1,0,0,0,0,8,8,8,8
Monterey,62,2023-02-20,152,155,155,0,2319,2377,2376,1,22,0,0,0,802,802,802,802
Napa,62,2023-02-20,77,77,77,0,1087,1115,1114,1,3,0,0,1,161,161,161,161
Nevada,62,2023-02-20,26,26,26,0,611,628,627,1,7,1,1,1,137,137,136,136
Orange,62,2023-02-20,1319,1353,1353,0,19208,19688,19687,1,158,9,13,21,7960,7972,7951,7959
Placer,62,2023-02-20,160,166,166,0,2413,2473,2472,1,48,0,0,3,681,681,681,681
Plumas,62,2023-02-20,7,7,7,0,74,75,74,1,0,0,0,0,15,15,15,15
Riverside,62,2023-02-20,983,1009,1009,0,15072,15450,15449,1,92,5,7,9,6811,6814,6806,6807
Sacramento,62,2023-02-20,725,743,743,0,11510,11799,11798,1,103,5,7,16,3527,3531,3522,3524
San Benito,62,2023-02-20,24,24,24,0,476,489,488,1,1,2,3,0,112,113,110,110
San Bernardino,62,2023-02-20,883,906,906,0,15067,15446,15445,1,117,0,0,27,8131,8131,8131,8131
San Diego,62,2023-02-20,1759,1803,1803,0,25193,25821,25820,1,201,7,10,25,5792,5796,5785,5786
San Francisco,62,2023-02-20,586,600,600,0,9878,10127,10126,1,79,0,0,7,1173,1173,1173,1173
San Joaquin,62,2023-02-20,412,422,422,0,7361,7547,7546,1,30,0,0,7,2421,2421,2421,2421
San Luis Obispo,62,2023-02-20,94,95,95,0,1433,1469,1468,1,11,0,0,0,563,563,563,563
San Mateo,62,2023-02-20,464,477,477,0,7370,7554,7553,1,44,0,0,3,740,740,740,740
Santa Barbara,62,2023-02-20,204,209,209,0,3626,3718,3717,1,18,0,0,5,760,760,760,760
Santa Clara,62,2023-02-20,1210,1242,1242,0,19310,19790,19789,1,111,9,12,26,2710,2715,2701,2703
Santa Cruz,62,2023-02-20,136,139,139,0,6262,6412,6411,1,20,0,0,2,276,276,276,276
Shasta,62,2023-02-20,18,18,18,0,728,746,745,1,2,0,0,0,600,600,600,600
Siskiyou,62,2023-02-20,14,14,14,0,198,205,204,1,0,0,0,0,95,95,95,95
Solano,62,2023-02-20,229,235,235,0,3260,3343,3342,1,26,0,0,3,474,474,474,474
Sonoma,62,2023-02-20,260,268,268,0,3198,3279,3278,1,24,1,1,4,555,555,554,554
Stanislaus,62,2023-02-20,263,270,270,0,3643,3734,3733,1,55,0,0,4,1841,1841,1841,1841
Sutter,62,2023-02-20,38,38,38,0,539,551,550,1,0,1,1,0,238,238,237,237
Tehama,62,2023-02-20,13,13,13,0,279,288,287,1,0,0,0,0,233,233,233,233
Trinity,62,2023-02-20,0,0,0,0,30,31,30,1,0,0,0,0,23,23,23,23
Tulare,62,2023-02-20,214,220,220,0,3794,3890,3889,1,23,0,0,0,1577,1577,1577,1577
Tuolumne,62,2023-02-20,28,28,28,0,446,459,458,1,0,0,0,0,202,202,202,202
Ventura,62,2023-02-20,276,283,283,0,5595,5736,5735,1,30,4,4,7,1677,1677,1673,1673
Yolo,62,2023-02-20,87,88,88,0,1277,1312,1311,1,1,2,3,1,445,446,443,443
Yuba,62,2023-02-20,25,25,25,0,507,520,519,1,6,0,0,0,122,122,122,122
Alameda,63,2023-02-27,1106,1144,1144,0,18443,19089,19088,1,96,3,6,9,2192,2196,2189,2190
Amador,63,2023-02-27,19,19,19,0,521,541,540,1,1,0,0,1,99,99,99,99
Butte,63,2023-02-27,52,52,52,0,944,977,976,1,8,1,2,1,491,493,490,491
Calaveras,63,2023-02-27,15,15,15,0,306,317,316,1,1,0,0,0,140,140,140,140
Colusa,63,2023-02-27,12,12,12,0,85,89,88,1,0,0,0,0,22,22,22,22
Contra Costa,63,2023-02-27,709,734,734,0,11403,11800,11799,1,63,1,2,11,1558,1561,1557,1559
Del Norte,63,2023-02-27,7,7,7,0,288,298,297,1,0,0,0,0,59,59,59,59
El Dorado,63,2023-02-27,61,62,62,0,1037,1074,1073,1,2,0,0,0,244,244,244,244
Fresno,63,2023-02-27,461,477,477,0,8995,9313,9312,1,93,0,0,7,3000,3001,3000,3001
Glenn,63,2023-02-27,3,3,3,0,143,149,148,1,1,0,0,0,53,53,53,53
Humboldt,63,2023-02-27,24,24,24,0,489,507,506,1,4,0,0,1,170,170,170,170
Imperial,63,2023-02-27,165,171,171,0,1827,1891,1890,1,13,0,0,0,978,978,978,978
Inyo,63,2023-02-27,4,4,4,0,154,160,159,1,0,0,0,0,63,63,63,63
Kern,63,2023-02-27,397,411,411,0,8166,8453,8452,1,42,3,7,7,2480,2485,2477,2478
Kings,63,2023-02-27,62,63,63,0,1685,1745,1744,1,4,0,0,0,481,481,481,481
Lake,63,2023-02-27,21,21,21,0,465,484,483,1,2,0,0,1,159,159,159,159
Lassen,63,2023-02-27,3,3,3,0,352,364,363,1,0,0,0,0,64,64,64,64
Los Angeles,63,2023-02-27,5252,5435,5435,0,133577,138224,138222,2,573,49,99,75,35569,35747,35520,35648
Madera,63,2023-02-27,55,56,56,0,1187,1229,1228,1,7,0,0,1,376,376,376,376
Marin,63,2023-02-27,144,150,150,0,1962,2032,2031,1,16,0,0,3,317,317,317,317
Mariposa,63,2023-02-27,7,7,7,0,97,102,101,1,0,0,0,0,31,31,31,31
Mendocino,63,2023-02-27,21,21,21,0,492,509,508,1,5,0,0,1,144,144,144,144
Merced,63,2023-02-27,122,127,127,0,1885,1953,1952,1,19,0,0,1,903,903,903,903
Modoc,63,2023-02-27,1,1,1,0,8,9,8,1,0,0,0,0,9,9,9,9
Mono,63,2023-02-27,5,5,5,0,52,53,52,1,0,0,0,0,8,8,8,8
Monterey,63,2023-02-27,172,179,179,0,2577,2669,2668,1,30,1,2,1,803,804,802,802
Napa,63,2023-02-27,78,80,80,0,1316,1363,1362,1,7,0,0,4,161,161,161,161
Nevada,63,2023-02-27,24,24,24,0,565,585,584,1,2,0,0,0,137,137,137,137
Orange,63,2023-02-27,1176,1216,1216,0,19391,20071,20070,1,161,14,30,21,7974,8002,7960,7972
Placer,63,2023-02-27,182,189,189,0,2564,2656,2655,1,44,0,0,7,681,681,681,681
Plumas,63,2023-02-27,2,2,2,0,87,90,89,1,0,0,0,0,15,15,15,15
Riverside,63,2023-02-27,907,940,940,0,15320,15856,15855,1,76,5,9,15,6816,6823,6811,6814
Sacramento,63,2023-02-27,924,957,957,0,12713,13160,13159,1,121,3,5,19,3530,3536,3527,3531
San Benito,63,2023-02-27,28,28,28,0,473,491,490,1,2,0,0,0,112,113,112,113
San Bernardino,63,2023-02-27,857,888,888,0,16199,16770,16769,1,111,0,0,24,8131,8131,8131,8131
San Diego,63,2023-02-27,1796,1859,1859,0,27268,28221,28220,1,210,5,11,21,5797,5807,5792,5796
San Francisco,63,2023-02-27,658,681,681,0,11534,11940,11939,1,76,5,10,8,1178,1183,1173,1173
San Joaquin,63,2023-02-27,411,426,426,0,7510,7776,7775,1,33,0,0,3,2421,2421,2421,2421
San Luis Obispo,63,2023-02-27,80,82,82,0,1662,1721,1720,1,11,1,3,0,564,566,563,563
San Mateo,63,2023-02-27,476,494,494,0,7369,7630,7629,1,43,0,0,4,740,740,740,740
Santa Barbara,63,2023-02-27,176,183,183,0,3558,3685,3684,1,18,1,2,8,761,762,760,760
Santa Clara,63,2023-02-27,1324,1370,1370,0,21343,22093,22092,1,126,5,10,26,2715,2725,2710,2715
Santa Cruz,63,2023-02-27,161,168,168,0,8752,9061,9060,1,7,0,0,1,276,276,276,276
Shasta,63,2023-02-27,37,37,37,0,653,678,677,1,9,0,0,1,600,600,600,600
Siskiyou,63,2023-02-27,11,11,11,0,235,244,243,1,0,0,0,0,95,95,95,95
Solano,63,2023-02-27,293,303,303,0,3674,3804,3803,1,30,0,0,8,474,474,474,474
Sonoma,63,2023-02-27,217,225,225,0,3407,3528,3527,1,33,1,2,5,556,557,555,555
Stanislaus,63,2023-02-27,243,252,252,0,3839,3975,3974,1,58,0,0,3,1841,1841,1841,1841
Sutter,63,2023-02-27,46,46,46,0,503,522,521,1,0,0,0,0,238,238,238,238
Tehama,63,2023-02-27,14,14,14,0,267,278,277,1,2,0,0,1,233,233,233,233
Trinity,63,2023-02-27,0,0,0,0,20,21,20,1,0,0,0,0,23,23,23,23
Tulare,63,2023-02-27,217,225,225,0,4009,4152,4151,1,22,2,4,2,1579,1581,1577,1577
Tuolumne,63,2023-02-27,38,39,39,0,472,489,488,1,0,0,0,1,202,202,202,202
Ventura,63,2023-02-27,266,275,275,0,5911,6118,6117,1,35,2,4,7,1679,1681,1677,1677
Yolo,63,2023-02-27,91,94,94,0,1360,1409,1408,1,3,0,0,1,445,446,445,446
Yuba,63,2023-02-27,36,36,36,0,508,527,526,1,0,0,0,0,122,122,122,122
Alameda,64,2023-03-06,898,958,958,0,16397,17461,17460,1,96,0,0,12,2192,2196,2192,2196
Amador,64,2023-03-06,12,13,13,0,461,492,491,1,0,0,0,0,99,99,99,99
Butte,64,2023-03-06,33,33,33,0,589,630,629,1,5,0,0,0,491,493,491,493
Calaveras,64,2023-03-06,18,18,18,0,267,286,285,1,0,0,0,0,140,140,140,140
Colusa,64,2023-03-06,12,12,12,0,161,176,175,1,0,0,0,0,22,22,22,22
Contra Costa,64,2023-03-06,668,712,712,0,10199,10871,10870,1,64,0,0,8,1558,1561,1558,1561
Del Norte,64,2023-03-06,6,6,6,0,252,270,269,1,1,0,0,1,59,59,59,59
El Dorado,64,2023-03-06,53,56,56,0,955,1021,1020,1,2,0,0,0,244,244,244,244
Fresno,64,2023-03-06,382,406,406,0,7889,8411,8410,1,77,0,0,16,3000,3001,3000,3001
Glenn,64,2023-03-06,4,4,4,0,163,178,177,1,0,0,0,0,53,53,53,53
Humboldt,64,2023-03-06,18,18,18,0,489,522,521,1,1,0,0,1,170,170,170,170
Imperial,64,2023-03-06,160,170,170,0,1593,1700,1699,1,9,0,0,0,978,978,978,978
Inyo,64,2023-03-06,4,4,4,0,135,145,144,1,1,0,0,0,63,63,63,63
Kern,64,2023-03-06,310,329,329,0,7623,8121,8120,1,35,0,0,4,2480,2485,2480,2485
Kings,64,2023-03-06,63,66,66,0,1560,1664,1663,1,1,0,0,0,481,481,481,481
Lake,64,2023-03-06,18,18,18,0,487,519,518,1,1,0,0,0,159,159,159,159
Lassen,64,2023-03-06,4,4,4,0,305,326,325,1,1,0,0,0,64,64,64,64
Los Angeles,64,2023-03-06,4210,4481,4481,0,118788,126491,126490,1,509,32,131,60,35601,35878,35569,35747
Madera,64,2023-03-06,81,86,86,0,1142,1218,1217,1,5,0,0,0,376,376,376,376
Marin,64,2023-03-06,133,141,141,0,1768,1888,1887,1,21,0,0,2,317,317,317,317
Mariposa,64,2023-03-06,0,0,0,0,69,74,73,1,0,0,0,0,31,31,31,31
Mendocino,64,2023-03-06,25,25,25,0,448,478,477,1,7,0,0,1,144,144,144,144
Merced,64,2023-03-06,145,153,153,0,1710,1822,1821,1,14,0,0,2,903,903,903,903
Modoc,64,2023-03-06,1,1,1,0,9,10,9,1,0,0,0,0,9,9,9,9
Mono,64,2023-03-06,5,5,5,0,56,61,60,1,0,0,0,0,8,8,8,8
Monterey,64,2023-03-06,139,149,149,0,2157,2300,2299,1,29,1,3,3,804,807,803,804
Napa,64,2023-03-06,53,56,56,0,1051,1122,1121,1,9,0,0,2,161,161,161,161
Nevada,64,2023-03-06,16,16,16,0,483,517,516,1,2,0,0,0,137,137,137,137
Orange,64,2023-03-06,957,1019,1019,0,18471,19694,19693,1,111,7,34,18,7981,8036,7974,8002
Placer,64,2023-03-06,167,177,177,0,2454,2618,2617,1,62,0,0,5,681,681,681,681
Plumas,64,2023-03-06,0,0,0,0,66,71,70,1,0,0,0,0,15,15,15,15
Riverside,64,2023-03-06,854,911,911,0,13638,14521,14520,1,78,2,10,8,6818,6833,6816,6823
Sacramento,64,2023-03-06,841,896,896,0,11731,12507,12506,1,113,3,15,6,3533,3551,3530,3536
San Benito,64,2023-03-06,16,16,16,0,462,493,492,1,1,0,0,0,112,113,112,113
San Bernardino,64,2023-03-06,724,772,772,0,14758,15725,15724,1,99,0,0,18,8131,8131,8131,8131
San Diego,64,2023-03-06,1397,1488,1488,0,24531,26128,26127,1,179,11,44,13,5808,5851,5797,5807
San Francisco,64,2023-03-06,586,624,624,0,10602,11296,11295,1,73,1,5,11,1179,1188,1178,1183
San Joaquin,64,2023-03-06,376,402,402,0,6795,7247,7246,1,42,0,0,8,2421,2421,2421,2421
San Luis Obispo,64,2023-03-06,91,99,99,0,1299,1387,1386,1,9,0,0,0,564,566,564,566
San Mateo,64,2023-03-06,417,444,444,0,7078,7542,7541,1,28,0,0,3,740,740,740,740
Santa Barbara,64,2023-03-06,145,154,154,0,3658,3897,3896,1,18,1,5,1,762,767,761,762
Santa Clara,64,2023-03-06,1051,1121,1121,0,20650,21962,21961,1,133,0,0,32,2715,2725,2715,2725
Santa Cruz,64,2023-03-06,128,136,136,0,5120,5441,5440,1,20,0,0,0,276,276,276,276
Shasta,64,2023-03-06,22,23,23,0,633,677,676,1,5,0,0,2,600,600,600,600
Siskiyou,64,2023-03-06,6,6,6,0,223,239,238,1,1,0,0,0,95,95,95,95
Solano,64,2023-03-06,256,273,273,0,3330,3551,3550,1,34,0,0,5,474,474,474,474
Sonoma,64,2023-03-06,203,217,217,0,3230,3441,3440,1,23,0,0,2,556,557,556,557
Stanislaus,64,2023-03-06,253,269,269,0,3538,3777,3776,1,67,0,0,9,1841,1841,1841,1841
Sutter,64,2023-03-06,35,35,35,0,592,631,630,1,0,0,0,0,238,238,238,238
Tehama,64,2023-03-06,12,12,12,0,250,267,266,1,5,0,0,1,233,233,233,233
Trinity,64,2023-03-06,2,2,2,0,18,19,18,1,0,0,0,0,23,23,23,23
Tulare,64,2023-03-06,203,217,217,0,3259,3472,3471,1,29,0,0,3,1579,1581,1579,1581
Tuolumne,64,2023-03-06,34,36,36,0,401,427,426,1,1,0,0,0,202,202,202,202
Ventura,64,2023-03-06,245,261,261,0,4959,5283,5282,1,42,0,0,5,1679,1681,1679,1681
Yolo,64,2023-03-06,59,63,63,0,1257,1342,1341,1,4,0,0,0,445,446,445,446
Yuba,64,2023-03-06,38,39,39,0,508,543,542,1,7,0,0,0,122,122,122,122
Alameda,65,2023-03-13,691,2307,2307,0,12980,31891,31890,1,76,0,0,18,2192,2196,2192,2196
Amador,65,2023-03-13,14,35,35,0,297,674,673,1,5,0,0,1,99,99,99,99
Butte,65,2023-03-13,31,53,53,0,505,1294,1293,1,9,0,0,1,491,493,491,493
Calaveras,65,2023-03-13,12,44,44,0,199,515,514,1,0,0,0,0,140,140,140,140
Colusa,65,2023-03-13,5,22,22,0,97,247,246,1,0,0,0,0,22,22,22,22
Contra Costa,65,2023-03-13,472,1251,1251,0,8340,21601,21600,1,44,0,0,7,1558,1561,1558,1561
Del Norte,65,2023-03-13,8,24,24,0,197,485,484,1,1,0,0,0,59,59,59,59
El Dorado,65,2023-03-13,38,74,74,0,701,1922,1921,1,1,0,0,0,244,244,244,244
Fresno,65,2023-03-13,303,691,691,0,6660,16195,16194,1,79,0,0,10,3000,3001,3000,3001
Glenn,65,2023-03-13,8,27,27,0,65,174,173,1,0,0,0,0,53,53,53,53
Humboldt,65,2023-03-13,19,52,52,0,416,1337,1336,1,4,0,0,1,170,170,170,170
Imperial,65,2023-03-13,164,430,430,0,1623,4689,4688,1,12,0,0,0,978,978,978,978
Inyo,65,2023-03-13,0,0,0,0,185,382,381,1,0,0,0,0,63,63,63,63
Kern,65,2023-03-13,236,567,567,0,5306,9226,9225,1,52,0,0,12,2480,2485,2480,2485
Kings,65,2023-03-13,54,138,138,0,1137,2817,2816,1,1,0,0,0,481,481,481,481
Lake,65,2023-03-13,9,13,13,0,352,1068,1067,1,1,0,0,0,159,159,159,159
Lassen,65,2023-03-13,3,17,17,0,214,364,363,1,0,0,0,0,64,64,64,64
Los Angeles,65,2023-03-13,2587,4002,4002,0,74799,99583,99582,1,418,12,189,56,35613,36067,35601,35878
Madera,65,2023-03-13,39,135,135,0,931,2070,2069,1,6,0,0,0,376,376,376,376
Marin,65,2023-03-13,83,271,271,0,1396,3657,3656,1,21,0,0,1,317,317,317,317
Mariposa,65,2023-03-13,4,7,7,0,71,176,175,1,0,0,0,0,31,31,31,31
Mendocino,65,2023-03-13,17,53,53,0,418,1194,1193,1,6,0,0,1,144,144,144,144
Merced,65,2023-03-13,70,130,130,0,1149,2656,2655,1,12,0,0,2,903,903,903,903
Modoc,65,2023-03-13,1,1,1,0,10,13,12,1,0,0,0,0,9,9,9,9
Mono,65,2023-03-13,1,1,1,0,44,113,112,1,0,0,0,0,8,8,8,8
Monterey,65,2023-03-13,60,203,203,0,1491,3746,3745,1,27,0,0,2,804,807,804,807
Napa,65,2023-03-13,48,152,152,0,834,2524,2523,1,4,0,0,2,161,161,161,161
Nevada,65,2023-03-13,13,17,17,0,329,640,639,1,4,0,0,0,137,137,137,137
Orange,65,2023-03-13,733,1945,1945,0,14266,34439,34438,1,129,1,11,21,7982,8047,7981,8036
Placer,65,2023-03-13,140,421,421,0,1835,4924,4923,1,66,0,0,8,681,681,681,681
Plumas,65,2023-03-13,5,6,6,0,59,215,214,1,0,0,0,0,15,15,15,15
Riverside,65,2023-03-13,613,1169,1169,0,10195,20019,20018,1,79,1,14,14,6819,6847,6818,6833
Sacramento,65,2023-03-13,580,1750,1750,0,8569,21826,21825,1,105,0,0,21,3533,3551,3533,3551
San Benito,65,2023-03-13,12,41,41,0,369,1399,1398,1,0,0,0,0,112,113,112,113
San Bernardino,65,2023-03-13,477,1018,1018,0,10720,21004,21003,1,94,0,0,20,8131,8131,8131,8131
San Diego,65,2023-03-13,1090,2462,2462,0,19004,41912,41911,1,177,2,18,13,5810,5869,5808,5851
San Francisco,65,2023-03-13,444,1424,1424,0,7688,19326,19324,2,73,0,0,14,1179,1188,1179,1188
San Joaquin,65,2023-03-13,300,979,979,0,5215,12255,12254,1,34,0,0,6,2421,2421,2421,2421
San Luis Obispo,65,2023-03-13,53,127,127,0,990,2493,2492,1,9,0,0,0,564,566,564,566
San Mateo,65,2023-03-13,293,772,772,0,5500,13361,13360,1,24,0,0,5,740,740,740,740
Santa Barbara,65,2023-03-13,133,449,449,0,2919,7276,7275,1,12,0,0,1,762,767,762,767
Santa Clara,65,2023-03-13,822,2401,2401,0,15489,32746,32745,1,139,0,0,20,2715,2725,2715,2725
Santa Cruz,65,2023-03-13,55,108,108,0,2370,3824,3823,1,21,0,0,1,276,276,276,276
Shasta,65,2023-03-13,13,18,18,0,397,624,623,1,6,0,0,1,600,600,600,600
Siskiyou,65,2023-03-13,8,54,54,0,136,508,507,1,0,0,0,0,95,95,95,95
Solano,65,2023-03-13,202,820,820,0,2665,8560,8559,1,27,0,0,4,474,474,474,474
Sonoma,65,2023-03-13,161,473,473,0,2486,6608,6607,1,41,0,0,4,556,557,556,557
Stanislaus,65,2023-03-13,173,439,439,0,2884,8478,8477,1,52,0,0,4,1841,1841,1841,1841
Sutter,65,2023-03-13,28,109,109,0,497,1436,1435,1,0,0,0,0,238,238,238,238
Tehama,65,2023-03-13,8,10,10,0,152,236,235,1,1,0,0,0,233,233,233,233
Trinity,65,2023-03-13,0,0,0,0,18,48,47,1,0,0,0,0,23,23,23,23
Tulare,65,2023-03-13,114,308,308,0,2361,4971,4970,1,31,0,0,2,1579,1581,1579,1581
Tuolumne,65,2023-03-13,14,30,30,0,305,939,938,1,2,0,0,0,202,202,202,202
Ventura,65,2023-03-13,186,400,400,0,3679,9999,9998,1,25,0,0,5,1679,1681,1679,1681
Yolo,65,2023-03-13,58,135,135,0,826,2153,2152,1,2,0,0,0,445,446,445,446
Yuba,65,2023-03-13,21,49,49,0,407,1344,1343,1,7,0,0,0,122,122,122,122
California,1,2021-12-20,84318,84318,47197,37121,2163408,2163483,1234412,929071,2585,503,503,932,77358,77358,76855,76855
California,2,2021-12-27,241927,241931,151913,90018,1954244,1954310,1192586,761724,3348,496,496,1030,77854,77854,77358,77358
California,3,2022-01-03,549700,549713,369356,180357,2956411,2956534,1966532,990002,6125,592,592,1280,78446,78446,77854,77854
California,4,2022-01-10,867280,867310,619884,247426,4666321,4666557,3353849,1312708,10002,946,946,1813,79392,79392,78446,78446
California,5,2022-01-17,661865,661892,493173,168719,3984125,3984379,3022418,961961,12343,1433,1433,2311,80825,80825,79392,79392
California,6,2022-01-24,527381,527399,412576,114823,3989131,3989415,3193649,795766,12648,1778,1778,2600,82603,82603,80825,80825
California,7,2022-01-31,270344,270349,219715,50634,3155019,3155264,2636283,518981,10873,1907,1907,2494,84510,84510,82603,82603
California,8,2022-02-07,149321,149326,125792,23534,2670442,2670696,2318458,352238,8405,1778,1778,2007,86288,86288,84510,84510
California,9,2022-02-14,85820,85820,74807,11013,2323019,2323276,2080032,243244,6407,1434,1434,1564,87722,87722,86288,86288
California,10,2022-02-21,48085,48085,43058,5027,1850895,1851116,1692328,158788,4557,1004,1004,1098,88726,88726,87722,87722
California,11,2022-02-28,32661,32661,29951,2710,2098798,2099093,1962137,136956,3357,695,695,772,89421,89421,88726,88726
California,12,2022-03-07,22987,22987,21481,1506,1819449,1819790,1725195,94595,2435,501,501,581,89922,89922,89421,89421
California,13,2022-03-14,16968,16968,16091,877,1725521,1725925,1655561,70364,1844,358,358,419,90280,90280,89922,89922
California,14,2022-03-21,14645,14645,14062,583,1646475,1646976,1594252,52724,1537,253,253,313,90533,90533,90280,90280
California,15,2022-03-28,15472,15472,14991,481,1463360,1463956,1426336,37620,1150,179,179,264,90712,90712,90533,90533
California,16,2022-04-04,17686,17687,17270,417,1525140,1525923,1496377,29546,943,141,141,211,90853,90853,90712,90712
California,17,2022-04-11,21512,21517,21124,393,1343382,1344173,1323317,20856,905,125,125,148,90978,90978,90853,90853
California,18,2022-04-18,26865,26872,26483,389,1131774,1132535,1117632,14903,823,110,110,141,91088,91088,90978,90978
California,19,2022-04-25,37238,37248,36820,428,1622713,1623926,1609060,14866,838,91,91,112,91179,91179,91088,91088
California,20,2022-05-02,48938,48958,48523,435,1701886,1703306,1691065,12241,950,85,85,143,91264,91264,91179,91179
California,21,2022-05-09,63341,63382,62937,445,1770573,1772241,1762196,10045,1050,86,86,153,91350,91350,91264,91264
California,22,2022-05-16,80323,80384,79932,452,1840153,1842057,1833800,8257,1345,120,120,182,91470,91470,91350,91350
California,23,2022-05-23,97864,97960,97540,420,1870443,1872496,1865895,6601,1714,117,117,217,91587,91587,91470,91470
California,24,2022-05-30,90521,90608,90298,310,1499086,1500828,1496574,4254,1918,152,152,272,91739,91739,91587,91587
California,25,2022-06-06,120598,120720,120402,318,1939124,1941477,1937378,4099,2305,138,138,276,91877,91877,91739,91739
California,26,2022-06-13,105290,105399,105182,217,1406725,1408474,1405991,2483,2471,179,179,291,92056,92056,91877,91877
California,27,2022-06-20,101445,101553,101392,161,1026847,1028169,1026578,1591,2552,209,209,310,92265,92265,92056,92056
California,28,2022-06-27,115548,115676,115538,138,1043920,1045298,1044046,1252,3006,220,220,339,92485,92485,92265,92265
California,29,2022-07-04,108315,108441,108339,102,836792,837921,837115,806,3167,272,272,393,92757,92757,92485,92485
California,30,2022-07-11,141390,141568,141469,99,1082463,1084026,1083236,790,3824,298,298,453,93055,93055,92757,92757
California,31,2022-07-18,129772,129943,129870,73,992946,994444,993880,564,4148,296,296,528,93351,93351,93055,93055
California,32,2022-07-25,117659,117820,117772,48,948432,949908,949483,425,4310,360,360,516,93711,93711,93351,93351
California,33,2022-08-01,99242,99377,99344,33,875496,876905,876592,313,4119,362,362,535,94073,94073,93711,93711
California,34,2022-08-08,83113,83223,83204,19,820085,821444,821213,231,3754,335,335,474,94408,94408,94073,94073
California,35,2022-08-15,68772,68861,68849,12,789938,791290,791108,182,3363,297,297,448,94705,94705,94408,94408
California,36,2022-08-22,61141,61221,61215,6,774020,775379,775233,146,3087,287,287,418,94992,94992,94705,94705
California,37,2022-08-29,51541,51608,51605,3,763794,765176,765055,121,2752,218,218,351,95210,95210,94992,94992
California,38,2022-09-05,36458,36501,36501,0,626282,627464,627376,88,2525,247,247,350,95457,95457,95210,95210
California,39,2022-09-12,36221,36274,36274,0,750914,752415,752331,84,2422,224,224,346,95681,95681,95457,95457
California,40,2022-09-19,27598,27633,27633,0,685584,687023,686952,71,2041,180,180,272,95861,95861,95681,95681
California,41,2022-09-26,25288,25318,25318,0,637532,638942,638879,63,1818,167,167,230,96028,96028,95861,95861
California,42,2022-10-03,23283,23314,23314,0,584219,585576,585516,60,1647,148,148,247,96176,96176,96028,96028
California,43,2022-10-10,23331,23357,23357,0,624556,626085,626027,58,1537,154,154,228,96312,96312,96158,96158
California,44,2022-10-17,18589,18609,18609,0,520642,521996,521939,57,1397,117,117,218,96429,96429,96312,96312
California,45,2022-10-24,18471,18496,18496,0,511119,512528,512471,57,1324,119,119,190,96548,96548,96429,96429
California,46,2022-10-31,20592,20631,20631,0,520438,521985,521928,57,1401,113,113,191,96661,96661,96548,96548
California,47,2022-11-07,26741,26808,26808,0,544865,546613,546556,57,1525,134,134,231,96795,96795,96661,96661
California,48,2022-11-14,30647,30732,30732,0,546298,548237,548180,57,1775,114,114,260,96909,96909,96795,96795
California,49,2022-11-21,40004,40133,40133,0,571493,573794,573737,57,2268,152,152,330,97061,97061,96909,96909
California,50,2022-11-28,54077,54300,54300,0,514540,516852,516795,57,3153,203,203,379,97264,97264,97061,97061
California,51,2022-12-05,65684,65977,65977,0,652892,656126,656068,58,3715,241,242,493,97505,97506,97264,97264
California,52,2022-12-12,56439,56714,56714,0,617118,620407,620349,58,3944,347,351,527,97852,97857,97505,97506
California,53,2022-12-19,50621,50903,50903,0,570640,574126,574069,57,3997,320,326,523,98172,98183,97852,97857
California,54,2022-12-26,45210,45505,45505,0,415406,418390,418333,57,3906,400,407,510,98572,98590,98172,98183
California,55,2023-01-02,44978,45322,45322,0,419954,423460,423403,57,4077,353,361,528,98925,98951,98572,98590
California,56,2023-01-09,33641,33943,33943,0,502951,507889,507832,57,3672,329,339,487,99254,99290,98925,98951
California,57,2023-01-16,20303,20507,20507,0,408259,412848,412791,57,3075,309,323,425,99563,99613,99254,99290
California,58,2023-01-23,18443,18647,18647,0,450880,456587,456530,57,2400,231,243,369,99794,99856,99563,99613
California,59,2023-01-30,19312,19559,19559,0,417702,423741,423684,57,2214,198,211,266,99992,100067,99794,99856
California,60,2023-02-06,21271,21606,21606,0,402920,409630,409573,57,2231,160,179,280,100152,100246,99992,100067
California,61,2023-02-13,21175,21578,21578,0,382722,390345,390289,56,2223,130,152,287,100282,100398,100152,100246
California,62,2023-02-20,19551,20026,20026,0,343804,352424,352368,56,2159,125,173,292,100407,100571,100282,100398
California,63,2023-02-27,19669,20347,20347,0,379622,392945,392888,57,2220,102,208,310,100509,100779,100407,100571
California,64,2023-03-06,16589,17652,17652,0,340717,362972,362916,56,2074,58,247,262,100567,101026,100509,100779
California,65,2023-03-13,11726,28634,28634,0,242747,494176,494119,57,1939,16,232,278,100583,101258,100567,101026
