county,time,date,cases,est_cases,est_omicron_cases,est_other_cases,tests,est_tests,est_omicron_tests,est_other_tests,hospitalizations,deaths,est_deaths,icu,cum_deaths,cum_est_deaths,prev_cum_deaths,prev_cum_est_deaths
Alameda,1,2021-12-20,2980,2980,1418,1562,89791,89791,41928,47863,47,9,9,14,1540,1540,1531,1531
Amador,1,2021-12-20,49,49,18,31,1719,1719,603,1116,2,0,0,3,70,70,70,70
Butte,1,2021-12-20,193,193,101,92,4385,4385,2285,2100,24,5,5,1,359,359,354,354
Calaveras,1,2021-12-20,59,59,23,36,1521,1521,583,938,1,2,2,0,92,92,90,90
Colusa,1,2021-12-20,11,11,5,6,397,397,170,227,1,0,0,0,21,21,21,21
Contra Costa,1,2021-12-20,1687,1687,591,1096,43230,43230,14848,28382,27,4,4,7,1080,1080,1076,1076
Del Norte,1,2021-12-20,19,19,8,11,1378,1378,570,808,0,0,0,0,42,42,42,42
El Dorado,1,2021-12-20,238,238,93,145,4466,4466,1729,2737,4,4,4,3,179,179,175,175
Fresno,1,2021-12-20,1057,1057,380,677,24966,24966,8886,16080,131,19,19,45,2420,2420,2401,2401
Glenn,1,2021-12-20,20,20,8,12,462,462,185,277,0,0,0,0,41,41,41,41
Humboldt,1,2021-12-20,164,164,67,97,3772,3772,1529,2243,11,1,1,2,121,121,120,120
Imperial,1,2021-12-20,585,585,225,360,5522,5522,2104,3418,40,9,9,27,817,817,808,808
Inyo,1,2021-12-20,31,31,14,17,358,358,154,204,1,1,1,0,49,49,48,48
Kern,1,2021-12-20,927,927,401,526,26095,26095,11161,14934,84,24,24,27,2023,2023,1999,1999
Kings,1,2021-12-20,244,244,94,150,6917,6917,2640,4277,15,6,6,3,389,389,383,383
Lake,1,2021-12-20,37,37,13,24,1317,1317,464,853,0,0,0,0,116,116,116,116
Lassen,1,2021-12-20,11,11,5,6,2387,2387,1093,1294,0,0,0,0,54,54,54,54
Los Angeles,1,2021-12-20,31637,31637,22015,9622,985587,985601,676245,309356,574,107,107,174,27372,27372,27265,27265
Madera,1,2021-12-20,159,159,56,103,6019,6019,2124,3895,9,3,3,5,334,334,331,331
Marin,1,2021-12-20,566,566,210,356,11814,11814,4296,7518,5,1,1,1,200,200,199,199
Mariposa,1,2021-12-20,21,21,7,14,448,448,154,294,0,0,0,0,21,21,21,21
Mendocino,1,2021-12-20,91,91,27,64,2687,2687,789,1898,3,2,2,4,103,103,101,101
Merced,1,2021-12-20,323,323,138,185,5620,5620,2368,3252,11,6,6,12,693,693,687,687
Modoc,1,2021-12-20,5,5,2,3,67,67,30,37,2,0,0,0,6,6,6,6
Mono,1,2021-12-20,37,37,10,27,313,313,81,232,1,0,0,0,4,4,4,4
Monterey,1,2021-12-20,481,481,126,355,13259,13259,3421,9838,23,3,3,8,642,642,639,639
Napa,1,2021-12-20,229,229,106,123,5390,5390,2432,2958,2,1,1,2,108,108,107,107
Nevada,1,2021-12-20,161,161,58,103,2764,2764,999,1765,4,1,1,2,110,110,109,109
Orange,1,2021-12-20,4871,4871,2407,2464,99405,99405,48418,50987,132,34,34,56,6023,6023,5989,5989
Placer,1,2021-12-20,555,555,190,365,11155,11155,3769,7386,53,6,6,24,501,501,495,495
Plumas,1,2021-12-20,16,16,6,10,513,513,195,318,0,0,0,0,12,12,12,12
Riverside,1,2021-12-20,5609,5609,2352,3257,78336,78336,32450,45886,238,40,40,82,5582,5582,5542,5542
Sacramento,1,2021-12-20,2148,2148,857,1291,53579,53579,21169,32410,101,21,21,41,2490,2490,2469,2469
San Benito,1,2021-12-20,91,91,41,50,1928,1928,860,1068,2,3,3,2,81,81,78,78
San Bernardino,1,2021-12-20,5012,5012,2369,2643,79713,79713,37188,42525,299,66,66,112,6512,6512,6446,6446
San Diego,1,2021-12-20,8680,8680,5932,2748,149645,149645,101547,48098,249,29,29,94,4479,4479,4450,4450
San Francisco,1,2021-12-20,2990,2990,741,2249,57027,57027,13812,43215,28,3,3,10,693,693,690,690
San Joaquin,1,2021-12-20,952,952,359,593,25325,25325,9393,15932,48,13,13,27,1973,1973,1960,1960
San Luis Obispo,1,2021-12-20,426,426,187,239,9994,9994,4350,5644,11,3,3,6,371,371,368,368
San Mateo,1,2021-12-20,1560,1560,771,789,50637,50637,24532,26105,9,0,0,5,601,601,601,601
Santa Barbara,1,2021-12-20,789,789,326,463,15821,15821,6436,9385,18,8,8,12,570,570,562,562
Santa Clara,1,2021-12-20,2949,2949,1982,967,118972,118972,78847,40125,85,8,8,38,1979,1979,1971,1971
Santa Cruz,1,2021-12-20,404,404,182,222,19820,19820,8762,11058,11,2,2,5,230,230,228,228
Shasta,1,2021-12-20,163,163,65,98,6035,6035,2392,3643,28,8,8,8,448,448,440,440
Siskiyou,1,2021-12-20,20,20,9,11,449,449,207,242,2,2,2,2,63,63,61,61
Solano,1,2021-12-20,495,495,206,289,14746,14746,6067,8679,21,4,4,5,389,389,385,385
Sonoma,1,2021-12-20,754,754,320,434,20781,20781,8669,12112,22,1,1,6,420,420,419,419
Stanislaus,1,2021-12-20,669,669,209,460,13023,13023,4036,8987,90,13,13,22,1432,1432,1419,1419
Sutter,1,2021-12-20,123,123,51,72,2315,2315,947,1368,0,2,2,0,193,193,191,191
Tehama,1,2021-12-20,52,52,17,35,1324,1324,425,899,4,0,0,3,165,165,165,165
Trinity,1,2021-12-20,1,1,0,1,98,98,31,67,0,1,1,0,19,19,18,18
Tulare,1,2021-12-20,404,404,125,279,12361,12361,3802,8559,36,19,19,13,1308,1308,1289,1289
Tuolumne,1,2021-12-20,97,97,35,62,1942,1942,694,1248,7,0,0,0,150,150,150,150
Ventura,1,2021-12-20,2046,2046,1052,994,39241,39241,19903,19338,62,9,9,14,1216,1216,1207,1207
Yolo,1,2021-12-20,329,329,146,183,24700,24700,10821,13879,4,0,0,1,294,294,294,294
Yuba,1,2021-12-20,100,100,43,57,1874,1874,799,1075,3,0,0,4,102,102,102,102
Alameda,2,2021-12-27,7514,7514,4027,3487,87425,87425,46211,41214,89,12,12,19,1552,1552,1540,1540
Amador,2,2021-12-27,92,92,38,54,1447,1447,591,856,2,0,0,3,70,70,70,70
Butte,2,2021-12-27,540,540,318,222,4553,4553,2663,1890,37,3,3,3,362,362,359,359
Calaveras,2,2021-12-27,100,100,45,55,989,989,442,547,1,1,1,1,93,93,92,92
Colusa,2,2021-12-27,27,27,14,13,243,243,119,124,4,0,0,0,21,21,21,21
Contra Costa,2,2021-12-27,5144,5144,2107,3037,46342,46342,18598,27744,44,3,3,16,1083,1083,1080,1080
Del Norte,2,2021-12-27,25,25,12,13,1423,1423,679,744,0,0,0,1,42,42,42,42
El Dorado,2,2021-12-27,511,511,231,280,4083,4083,1815,2268,7,0,0,4,179,179,179,179
Fresno,2,2021-12-27,2211,2211,935,1276,23827,23827,9917,13910,122,16,16,41,2436,2436,2420,2420
Glenn,2,2021-12-27,53,53,24,29,451,451,207,244,0,1,1,0,42,42,41,41
Humboldt,2,2021-12-27,501,501,238,263,3457,3457,1618,1839,10,1,1,0,122,122,121,121
Imperial,2,2021-12-27,884,884,397,487,5893,5893,2609,3284,35,10,10,26,827,827,817,817
Inyo,2,2021-12-27,109,109,54,55,447,447,219,228,0,1,1,0,50,50,49,49
Kern,2,2021-12-27,1987,1987,996,991,22595,22595,11167,11428,79,18,18,36,2041,2041,2023,2023
Kings,2,2021-12-27,507,507,230,277,5484,5484,2434,3050,17,1,1,3,390,390,389,389
Lake,2,2021-12-27,67,67,28,39,1203,1203,495,708,0,1,1,0,117,117,116,116
Lassen,2,2021-12-27,21,21,11,10,2242,2242,1160,1082,0,0,0,0,54,54,54,54
Los Angeles,2,2021-12-27,96149,96149,71609,24540,717729,717739,530966,186773,862,115,115,207,27487,27487,27372,27372
Madera,2,2021-12-27,342,342,145,197,4217,4217,1751,2466,9,2,2,4,336,336,334,334
Marin,2,2021-12-27,1606,1606,687,919,16776,16776,7085,9691,3,0,0,1,200,200,200,200
Mariposa,2,2021-12-27,36,36,15,21,493,493,195,298,0,0,0,0,21,21,21,21
Mendocino,2,2021-12-27,152,152,55,97,2496,2496,862,1634,5,0,0,2,103,103,103,103
Merced,2,2021-12-27,653,653,322,331,5105,5105,2474,2631,11,7,7,10,700,700,693,693
Modoc,2,2021-12-27,3,3,1,2,38,38,19,19,1,0,0,0,6,6,6,6
Mono,2,2021-12-27,123,123,38,85,366,366,110,256,1,0,0,0,4,4,4,4
Monterey,2,2021-12-27,1007,1007,318,689,12882,12882,3971,8911,21,3,3,11,645,645,642,642
Napa,2,2021-12-27,814,814,424,390,6694,6694,3461,3233,6,0,0,1,108,108,108,108
Nevada,2,2021-12-27,236,236,100,136,1985,1985,815,1170,6,1,1,1,111,111,110,110
Orange,2,2021-12-27,18074,18074,10082,7992,130371,130371,71895,58476,256,31,31,66,6054,6054,6023,6023
Placer,2,2021-12-27,1256,1256,504,752,10769,10769,4261,6508,63,2,2,27,503,503,501,501
Plumas,2,2021-12-27,18,18,8,10,299,299,129,170,0,0,0,0,12,12,12,12
Riverside,2,2021-12-27,13692,13692,6605,7087,87511,87511,41718,45793,306,53,53,81,5635,5635,5582,5582
Sacramento,2,2021-12-27,5199,5199,2414,2785,52480,52480,24003,28477,135,22,22,44,2512,2512,2490,2490
San Benito,2,2021-12-27,317,317,163,154,2307,2307,1173,1134,1,3,3,3,84,84,81,81
San Bernardino,2,2021-12-27,14406,14406,7740,6666,87909,87909,46464,41445,341,69,69,141,6581,6581,6512,6512
San Diego,2,2021-12-27,27115,27115,19928,7187,177616,177617,129655,47962,315,34,34,96,4513,4513,4479,4479
San Francisco,2,2021-12-27,6859,6859,2010,4849,65951,65951,19049,46902,31,1,1,14,694,694,693,693
San Joaquin,2,2021-12-27,2353,2353,1038,1315,22773,22773,9883,12890,61,15,15,25,1988,1988,1973,1973
San Luis Obispo,2,2021-12-27,1153,1153,583,570,11189,11189,5566,5623,11,1,1,8,372,372,371,371
San Mateo,2,2021-12-27,5282,5282,2932,2350,55547,55547,30398,25149,19,2,2,5,603,603,601,601
Santa Barbara,2,2021-12-27,2143,2143,1022,1121,15282,15282,7174,8108,33,5,5,10,575,575,570,570
Santa Clara,2,2021-12-27,9051,9051,6550,2501,107077,107077,76820,30257,95,10,10,38,1989,1989,1979,1979
Santa Cruz,2,2021-12-27,946,946,489,457,12423,12423,6305,6118,11,0,0,2,230,230,230,230
Shasta,2,2021-12-27,263,263,123,140,4624,4624,2123,2501,32,5,5,12,453,453,448,448
Siskiyou,2,2021-12-27,21,21,11,10,361,361,190,171,0,0,0,0,63,63,63,63
Solano,2,2021-12-27,1301,1301,627,674,17044,17044,8086,8958,25,5,5,5,394,394,389,389
Sonoma,2,2021-12-27,1914,1914,934,980,21666,21666,10425,11241,19,1,1,5,421,421,420,420
Stanislaus,2,2021-12-27,1249,1249,468,781,11157,11157,4117,7040,94,17,17,18,1449,1449,1432,1432
Sutter,2,2021-12-27,226,226,108,118,2131,2131,1006,1125,0,2,2,0,195,195,193,193
Tehama,2,2021-12-27,102,102,40,62,1106,1106,419,687,6,2,2,3,167,167,165,165
Trinity,2,2021-12-27,4,4,2,2,101,101,37,64,0,0,0,0,19,19,19,19
Tulare,2,2021-12-27,815,815,301,514,11126,11126,4060,7066,36,10,10,9,1318,1318,1308,1308
Tuolumne,2,2021-12-27,171,171,72,99,1674,1674,693,981,5,0,0,1,150,150,150,150
Ventura,2,2021-12-27,5720,5720,3307,2413,39332,39332,22503,16829,66,8,8,19,1224,1224,1216,1216
Yolo,2,2021-12-27,818,818,417,401,22119,22119,11081,11038,7,1,1,4,295,295,294,294
Yuba,2,2021-12-27,164,164,81,83,1534,1534,749,785,8,1,1,4,103,103,102,102
Alameda,3,2022-01-03,17674,17674,10490,7184,117303,117303,69479,47824,156,5,5,31,1557,1557,1552,1552
Amador,3,2022-01-03,220,220,105,115,2182,2182,1031,1151,5,1,1,2,71,71,70,70
Butte,3,2022-01-03,1203,1203,779,424,6871,6871,4430,2441,32,0,0,4,362,362,362,362
Calaveras,3,2022-01-03,232,232,120,112,1305,1305,666,639,0,1,1,1,94,94,93,93
Colusa,3,2022-01-03,48,48,26,22,393,393,217,176,5,0,0,0,21,21,21,21
Contra Costa,3,2022-01-03,13519,13519,6289,7230,69129,69129,32071,37058,76,10,10,21,1093,1093,1083,1083
Del Norte,3,2022-01-03,86,86,47,39,2132,2132,1143,989,0,0,0,0,42,42,42,42
El Dorado,3,2022-01-03,1292,1292,661,631,6062,6062,3079,2983,7,4,4,6,183,183,179,179
Fresno,3,2022-01-03,6612,6612,3178,3434,38553,38553,18404,20149,175,14,14,44,2450,2450,2436,2436
Glenn,3,2022-01-03,78,78,40,38,610,610,318,292,0,1,1,0,43,43,42,42
Humboldt,3,2022-01-03,881,881,471,410,5295,5295,2810,2485,9,1,1,3,123,123,122,122
Imperial,3,2022-01-03,1881,1881,957,924,9131,9131,4610,4521,35,14,14,29,841,841,827,827
Inyo,3,2022-01-03,265,265,147,118,713,713,394,319,3,0,0,0,50,50,50,50
Kern,3,2022-01-03,5835,5835,3271,2564,35878,35878,19999,15879,100,16,16,32,2057,2057,2041,2041
Kings,3,2022-01-03,1100,1100,563,537,8519,8519,4314,4205,13,3,3,5,393,393,390,390
Lake,3,2022-01-03,222,222,107,115,1777,1777,847,930,1,0,0,1,117,117,117,117
Lassen,3,2022-01-03,61,61,35,26,3119,3119,1806,1313,2,0,0,0,54,54,54,54
Los Angeles,3,2022-01-03,204177,204178,160578,43600,1088037,1088054,856017,232037,1937,149,149,303,27636,27636,27487,27487
Madera,3,2022-01-03,831,831,398,433,6371,6371,3028,3343,17,3,3,6,339,339,336,336
Marin,3,2022-01-03,2366,2366,1149,1217,17675,17675,8532,9143,15,1,1,3,201,201,200,200
Mariposa,3,2022-01-03,103,103,48,55,657,657,304,353,0,0,0,0,21,21,21,21
Mendocino,3,2022-01-03,453,453,187,266,3572,3572,1454,2118,7,1,1,2,104,104,103,103
Merced,3,2022-01-03,1607,1607,884,723,8551,8551,4668,3883,3,9,9,4,709,709,700,700
Modoc,3,2022-01-03,15,15,8,7,59,59,33,26,0,0,0,0,6,6,6,6
Mono,3,2022-01-03,180,180,65,115,435,435,156,279,2,0,0,0,4,4,4,4
Monterey,3,2022-01-03,2463,2463,907,1556,20639,20639,7547,13092,30,4,4,10,649,649,645,645
Napa,3,2022-01-03,1859,1859,1077,782,11772,11772,6799,4973,9,1,1,3,109,109,108,108
Nevada,3,2022-01-03,647,647,314,333,3071,3071,1485,1586,7,1,1,3,112,112,111,111
Orange,3,2022-01-03,45622,45622,27878,17744,220369,220373,134453,85920,504,34,34,110,6088,6088,6054,6054
Placer,3,2022-01-03,2913,2913,1336,1577,15072,15072,6863,8209,113,15,15,24,518,518,503,503
Plumas,3,2022-01-03,55,55,28,27,496,496,248,248,1,0,0,0,12,12,12,12
Riverside,3,2022-01-03,32071,32071,17323,14748,138460,138461,74453,64008,564,54,54,94,5689,5689,5635,5635
Sacramento,3,2022-01-03,14148,14148,7388,6760,80507,80507,41839,38668,219,25,25,57,2537,2537,2512,2512
San Benito,3,2022-01-03,739,739,422,317,3464,3464,1976,1488,3,1,1,2,85,85,84,84
San Bernardino,3,2022-01-03,33874,33874,20036,13838,135068,135069,79612,55457,571,94,94,136,6675,6675,6581,6581
San Diego,3,2022-01-03,61079,61079,47448,13631,253663,253667,196962,56705,561,35,35,121,4548,4548,4513,4513
San Francisco,3,2022-01-03,11448,11448,3977,7471,85547,85547,29518,56029,78,5,5,22,699,699,694,694
San Joaquin,3,2022-01-03,6979,6979,3480,3499,36112,36112,17891,18221,80,13,13,27,2001,2001,1988,1988
San Luis Obispo,3,2022-01-03,2473,2473,1386,1087,15977,15977,8925,7052,24,5,5,7,377,377,372,372
San Mateo,3,2022-01-03,10627,10627,6506,4121,81979,81979,50095,31884,37,4,4,7,607,607,603,603
Santa Barbara,3,2022-01-03,5328,5328,2852,2476,28196,28196,15054,13142,53,5,5,7,580,580,575,575
Santa Clara,3,2022-01-03,23033,23033,17707,5326,170186,170187,130649,39538,186,10,10,58,1999,1999,1989,1989
Santa Cruz,3,2022-01-03,2409,2409,1387,1022,21662,21662,12485,9177,15,5,5,3,235,235,230,230
Shasta,3,2022-01-03,601,601,318,283,6173,6173,3228,2945,33,2,2,13,455,455,453,453
Siskiyou,3,2022-01-03,74,74,43,31,590,590,348,242,0,0,0,0,63,63,63,63
Solano,3,2022-01-03,4069,4069,2179,1890,26133,26133,13981,12152,54,3,3,9,397,397,394,394
Sonoma,3,2022-01-03,4541,4541,2480,2061,32187,32187,17529,14658,25,7,7,4,428,428,421,421
Stanislaus,3,2022-01-03,3332,3332,1435,1897,17993,17993,7692,10301,129,9,9,20,1458,1458,1449,1449
Sutter,3,2022-01-03,547,547,296,251,2980,2980,1594,1386,0,2,2,0,197,197,195,195
Tehama,3,2022-01-03,215,215,96,119,1474,1474,652,822,4,1,1,2,168,168,167,167
Trinity,3,2022-01-03,14,14,6,8,107,107,46,61,0,0,0,0,19,19,19,19
Tulare,3,2022-01-03,2143,2143,917,1226,16017,16017,6779,9238,57,5,5,7,1323,1323,1318,1318
Tuolumne,3,2022-01-03,383,383,186,197,2549,2549,1229,1320,7,3,3,0,153,153,150,150
Ventura,3,2022-01-03,12672,12672,7987,4685,59674,59674,37562,22112,136,11,11,28,1235,1235,1224,1224
Yolo,3,2022-01-03,2327,2327,1327,1000,31706,31706,17935,13771,8,4,4,3,299,299,295,295
Yuba,3,2022-01-03,474,474,263,211,2331,2331,1284,1047,17,1,1,6,104,104,103,103
Alameda,4,2022-01-10,31206,31206,20217,10989,193863,193868,125728,68140,277,14,14,46,1571,1571,1557,1557
Amador,4,2022-01-10,388,388,207,181,2728,2728,1448,1280,4,0,0,4,71,71,71,71
Butte,4,2022-01-10,2000,2000,1395,605,10455,10455,7284,3171,55,2,2,4,364,364,362,362
Calaveras,4,2022-01-10,522,522,299,223,2606,2606,1478,1128,0,1,1,2,95,95,94,94
Colusa,4,2022-01-10,105,105,65,40,756,756,462,294,5,0,0,0,21,21,21,21
Contra Costa,4,2022-01-10,19736,19736,10337,9399,102258,102258,53546,48712,152,12,12,24,1105,1105,1093,1093
Del Norte,4,2022-01-10,177,177,106,71,3958,3958,2363,1595,2,0,0,0,42,42,42,42
El Dorado,4,2022-01-10,2214,2214,1260,954,9363,9363,5325,4038,14,6,6,2,189,189,183,183
Fresno,4,2022-01-10,14421,14421,7793,6628,59858,59858,32277,27581,301,14,14,47,2464,2464,2450,2450
Glenn,4,2022-01-10,219,219,127,92,938,938,544,394,2,0,0,0,43,43,43,43
Humboldt,4,2022-01-10,1401,1401,827,574,8355,8355,4924,3431,18,5,5,2,128,128,123,123
Imperial,4,2022-01-10,3624,3624,2048,1576,13821,13821,7793,6028,58,11,11,25,852,852,841,841
Inyo,4,2022-01-10,407,407,248,159,1356,1356,826,530,4,2,2,0,52,52,50,50
Kern,4,2022-01-10,11945,11945,7345,4600,57114,57114,35081,22033,181,26,26,35,2083,2083,2057,2057
Kings,4,2022-01-10,2405,2405,1376,1029,13020,13020,7405,5615,33,1,1,4,394,394,393,393
Lake,4,2022-01-10,497,497,267,230,2761,2761,1477,1284,0,3,3,1,120,120,117,117
Lassen,4,2022-01-10,196,196,126,70,3438,3438,2185,1253,1,0,0,0,54,54,54,54
Los Angeles,4,2022-01-10,329115,329121,270889,58232,1915141,1915175,1576853,338322,3253,270,270,513,27906,27906,27636,27636
Madera,4,2022-01-10,1913,1913,1029,884,10391,10391,5553,4838,19,1,1,6,340,340,339,339
Marin,4,2022-01-10,2942,2942,1602,1340,21014,21014,11439,9575,18,3,3,5,204,204,201,201
Mariposa,4,2022-01-10,199,199,105,94,1158,1158,607,551,0,1,1,0,22,22,21,21
Mendocino,4,2022-01-10,874,874,410,464,5538,5538,2581,2957,8,2,2,2,106,106,104,104
Merced,4,2022-01-10,3930,3930,2379,1551,14518,14518,8777,5741,33,10,10,11,719,719,709,709
Modoc,4,2022-01-10,13,13,8,5,109,109,67,42,0,0,0,0,6,6,6,6
Mono,4,2022-01-10,253,253,106,147,863,863,360,503,1,1,1,0,5,5,4,4
Monterey,4,2022-01-10,4976,4976,2115,2861,33232,33232,14051,19181,44,5,5,12,654,654,649,649
Napa,4,2022-01-10,2657,2657,1686,971,14407,14407,9137,5270,14,1,1,4,110,110,109,109
Nevada,4,2022-01-10,1193,1193,648,545,5233,5233,2839,2394,10,2,2,3,114,114,112,112
Orange,4,2022-01-10,60282,60282,40124,20158,317875,317880,211651,106229,854,100,100,159,6188,6188,6088,6088
Placer,4,2022-01-10,5202,5202,2695,2507,22555,22555,11665,10890,179,6,6,29,524,524,518,518
Plumas,4,2022-01-10,141,141,79,62,804,804,447,357,5,0,0,0,12,12,12,12
Riverside,4,2022-01-10,48253,48253,28848,19405,187773,187777,112227,75550,762,83,83,139,5772,5772,5689,5689
Sacramento,4,2022-01-10,27531,27531,15931,11600,121789,121789,70482,51307,375,37,37,89,2574,2574,2537,2537
San Benito,4,2022-01-10,1039,1039,655,384,4617,4617,2910,1707,3,1,1,2,86,86,85,85
San Bernardino,4,2022-01-10,50612,50612,32787,17825,192772,192776,124823,67953,784,113,113,187,6788,6788,6675,6675
San Diego,4,2022-01-10,82727,82727,67407,15320,330087,330092,269004,61088,895,66,66,166,4614,4614,4548,4548
San Francisco,4,2022-01-10,15104,15104,6038,9066,117291,117291,46957,70334,158,12,12,35,711,711,699,699
San Joaquin,4,2022-01-10,14508,14508,8084,6424,66818,66818,37170,29648,151,15,15,45,2016,2016,2001,2001
San Luis Obispo,4,2022-01-10,4337,4337,2676,1661,21634,21634,13364,8270,30,2,2,7,379,379,377,377
San Mateo,4,2022-01-10,15025,15025,10007,5018,113108,113108,75331,37777,95,5,5,16,612,612,607,607
Santa Barbara,4,2022-01-10,8537,8537,5053,3484,47384,47384,28052,19332,84,9,9,10,589,589,580,580
Santa Clara,4,2022-01-10,36500,36500,29455,7045,271172,271177,218791,52386,350,27,27,68,2026,2026,1999,1999
Santa Cruz,4,2022-01-10,4541,4541,2860,1681,42815,42815,26980,15835,25,2,2,2,237,237,235,235
Shasta,4,2022-01-10,1060,1060,619,441,8406,8406,4894,3512,37,7,7,12,462,462,455,455
Siskiyou,4,2022-01-10,120,120,77,43,919,919,591,328,3,1,1,1,64,64,63,63
Solano,4,2022-01-10,6927,6927,4128,2799,37137,37137,22139,14998,94,6,6,15,403,403,397,397
Sonoma,4,2022-01-10,8870,8870,5344,3526,47197,47197,28452,18745,72,9,9,8,437,437,428,428
Stanislaus,4,2022-01-10,6753,6753,3308,3445,29327,29327,14328,14999,173,13,13,19,1471,1471,1458,1458
Sutter,4,2022-01-10,1246,1246,743,503,5063,5063,3006,2057,0,2,2,0,199,199,197,197
Tehama,4,2022-01-10,509,509,255,254,2482,2482,1241,1241,13,1,1,1,169,169,168,168
Trinity,4,2022-01-10,38,38,19,19,275,275,135,140,0,0,0,0,19,19,19,19
Tulare,4,2022-01-10,5219,5219,2543,2676,24096,24096,11681,12415,66,9,9,8,1332,1332,1323,1323
Tuolumne,4,2022-01-10,806,806,436,370,4181,4181,2258,1923,13,1,1,1,154,154,153,153
Ventura,4,2022-01-10,17512,17512,11976,5536,88216,88216,60304,27912,227,23,23,34,1258,1258,1235,1235
Yolo,4,2022-01-10,3755,3755,2337,1418,48235,48235,29998,18237,6,4,4,1,303,303,299,299
Yuba,4,2022-01-10,1018,1018,622,396,4108,4108,2504,1604,41,0,0,7,104,104,104,104
Alameda,5,2022-01-17,24709,24709,17333,7376,170496,170500,119535,50965,366,33,33,62,1604,1604,1571,1571
Amador,5,2022-01-17,476,476,282,194,3561,3561,2083,1478,10,2,2,3,73,73,71,71
Butte,5,2022-01-17,2063,2063,1538,525,9327,9327,6949,2378,58,6,6,6,370,370,364,364
Calaveras,5,2022-01-17,564,564,353,211,2473,2473,1543,930,3,2,2,3,97,97,95,95
Colusa,5,2022-01-17,161,161,107,54,719,719,476,243,3,0,0,0,21,21,21,21
Contra Costa,5,2022-01-17,16224,16224,9473,6751,88044,88044,51323,36721,198,22,22,41,1127,1127,1105,1105
Del Norte,5,2022-01-17,199,199,130,69,3758,3758,2429,1329,2,0,0,1,42,42,42,42
El Dorado,5,2022-01-17,1964,1964,1228,736,8062,8062,5041,3021,9,4,4,2,193,193,189,189
Fresno,5,2022-01-17,18274,18274,10945,7329,65981,65981,39482,26499,386,27,27,61,2491,2491,2464,2464
Glenn,5,2022-01-17,306,306,194,112,1076,1076,683,393,3,2,2,0,45,45,43,43
Humboldt,5,2022-01-17,1144,1144,739,405,8323,8323,5365,2958,10,1,1,4,129,129,128,128
Imperial,5,2022-01-17,3416,3416,2124,1292,13217,13217,8216,5001,69,12,12,29,864,864,852,852
Inyo,5,2022-01-17,327,327,216,111,1040,1040,688,352,4,0,0,0,52,52,52,52
Kern,5,2022-01-17,11694,11694,7804,3890,51813,51813,34534,17279,242,29,29,44,2112,2112,2083,2083
Kings,5,2022-01-17,3200,3200,1999,1201,14870,14870,9261,5609,40,4,4,1,398,398,394,394
Lake,5,2022-01-17,582,582,347,235,3245,3245,1935,1310,2,1,1,2,121,121,120,120
Lassen,5,2022-01-17,284,284,196,88,3322,3322,2278,1044,0,0,0,0,54,54,54,54
Los Angeles,5,2022-01-17,218496,218500,186921,31579,1610439,1610469,1376777,233692,4034,504,504,680,28410,28410,27906,27906
Madera,5,2022-01-17,2402,2402,1433,969,10619,10619,6306,4313,32,5,5,10,345,345,340,340
Marin,5,2022-01-17,2418,2418,1459,959,17704,17704,10679,7025,38,4,4,6,208,208,204,204
Mariposa,5,2022-01-17,163,163,95,68,1115,1115,648,467,0,0,0,0,22,22,22,22
Mendocino,5,2022-01-17,922,922,487,435,5015,5015,2630,2385,18,3,3,2,109,109,106,106
Merced,5,2022-01-17,4193,4193,2764,1429,13645,13645,8993,4652,41,18,18,11,737,737,719,719
Modoc,5,2022-01-17,13,13,9,4,102,102,68,34,0,1,1,0,7,7,6,6
Mono,5,2022-01-17,198,198,94,104,809,809,386,423,2,0,0,0,5,5,5,5
Monterey,5,2022-01-17,5903,5903,2860,3043,28328,28328,13710,14618,69,6,6,14,660,660,654,654
Napa,5,2022-01-17,1940,1940,1335,605,11943,11943,8197,3746,21,2,2,5,112,112,110,110
Nevada,5,2022-01-17,1248,1248,750,498,5429,5429,3261,2168,19,1,1,1,115,115,114,114
Orange,5,2022-01-17,41410,41410,29704,11706,251613,251618,180318,71300,998,111,111,199,6299,6299,6188,6188
Placer,5,2022-01-17,4311,4311,2489,1822,19461,19461,11216,8245,178,14,14,36,538,538,524,524
Plumas,5,2022-01-17,193,193,119,74,852,852,524,328,3,0,0,0,12,12,12,12
Riverside,5,2022-01-17,41260,41260,26973,14287,168068,168072,109889,58183,920,97,97,158,5869,5869,5772,5772
Sacramento,5,2022-01-17,21470,21470,13663,7807,101467,101467,64495,36972,473,64,64,97,2638,2638,2574,2574
San Benito,5,2022-01-17,905,905,620,285,4273,4273,2922,1351,4,1,1,4,87,87,86,86
San Bernardino,5,2022-01-17,38408,38408,26868,11540,164345,164349,114963,49386,936,146,146,227,6934,6934,6788,6788
San Diego,5,2022-01-17,60665,60665,51496,9169,265929,265934,225760,40174,1067,103,103,193,4717,4717,4614,4614
San Francisco,5,2022-01-17,11258,11258,5199,6059,94020,94020,43309,50711,212,14,14,44,725,725,711,711
San Joaquin,5,2022-01-17,12718,12718,7803,4915,58094,58094,35648,22446,201,20,20,57,2036,2036,2016,2016
San Luis Obispo,5,2022-01-17,3934,3934,2647,1287,21033,21033,14133,6900,46,12,12,10,391,391,379,379
San Mateo,5,2022-01-17,12485,12485,8946,3539,95950,95950,68670,27280,92,10,10,30,622,622,612,612
Santa Barbara,5,2022-01-17,6854,6854,4446,2408,40488,40488,26232,14256,123,12,12,12,601,601,589,589
Santa Clara,5,2022-01-17,29564,29564,24875,4689,235966,235971,198420,37551,451,24,24,84,2050,2050,2026,2026
Santa Cruz,5,2022-01-17,4182,4182,2866,1316,42205,42205,28863,13342,23,3,3,3,240,240,237,237
Shasta,5,2022-01-17,1347,1347,863,484,9163,9163,5844,3319,55,7,7,14,469,469,462,462
Siskiyou,5,2022-01-17,158,158,110,48,927,927,640,287,3,1,1,2,65,65,64,64
Solano,5,2022-01-17,6433,6433,4199,2234,35205,35205,22974,12231,121,6,6,22,409,409,403,403
Sonoma,5,2022-01-17,7625,7625,5024,2601,42779,42779,28133,14646,73,7,7,15,444,444,437,437
Stanislaus,5,2022-01-17,7322,7322,4016,3306,29064,29064,15919,13145,206,10,10,31,1481,1481,1471,1471
Sutter,5,2022-01-17,1248,1248,812,436,4864,4864,3161,1703,0,4,4,0,203,203,199,199
Tehama,5,2022-01-17,615,615,344,271,2420,2420,1349,1071,15,5,5,2,174,174,169,169
Trinity,5,2022-01-17,41,41,23,18,255,255,140,115,0,1,1,0,20,20,19,19
Tulare,5,2022-01-17,7477,7477,4070,3407,27102,27102,14732,12370,97,16,16,16,1348,1348,1332,1332
Tuolumne,5,2022-01-17,887,887,532,355,3838,3838,2288,1550,10,8,8,1,162,162,154,154
Ventura,5,2022-01-17,11978,11978,8783,3195,66932,66932,49016,17916,300,41,41,56,1299,1299,1258,1258
Yolo,5,2022-01-17,2805,2805,1899,906,39489,39489,26700,12789,15,4,4,4,307,307,303,303
Yuba,5,2022-01-17,1063,1063,706,357,3747,3747,2489,1258,42,3,3,6,107,107,104,104
Alameda,6,2022-01-24,19751,19751,14828,4923,171784,171789,129142,42647,373,39,39,68,1643,1643,1604,1604
Amador,6,2022-01-24,543,543,351,192,4668,4668,3020,1648,8,0,0,5,73,73,73,73
Butte,6,2022-01-24,1906,1906,1503,403,9606,9606,7589,2017,82,10,10,9,380,380,370,370
Calaveras,6,2022-01-24,556,556,378,178,2508,2508,1706,802,6,2,2,2,99,99,97,97
Colusa,6,2022-01-24,177,177,127,50,951,951,680,271,6,0,0,0,21,21,21,21
Contra Costa,6,2022-01-24,13592,13592,8735,4857,85315,85315,54887,30428,217,25,25,64,1152,1152,1127,1127
Del Norte,6,2022-01-24,347,347,245,102,4326,4326,3042,1284,3,0,0,3,42,42,42,42
El Dorado,6,2022-01-24,1400,1400,954,446,7330,7330,5001,2329,17,2,2,6,195,195,193,193
Fresno,6,2022-01-24,17751,17751,11631,6120,68682,68682,45084,23598,491,43,43,83,2534,2534,2491,2491
Glenn,6,2022-01-24,250,250,172,78,971,971,670,301,0,0,0,0,45,45,45,45
Humboldt,6,2022-01-24,913,913,639,274,7714,7714,5409,2305,25,3,3,3,132,132,129,129
Imperial,6,2022-01-24,3626,3626,2461,1165,13165,13165,8953,4212,70,14,14,27,878,878,864,864
Inyo,6,2022-01-24,142,142,102,40,625,625,449,176,1,1,1,0,53,53,52,52
Kern,6,2022-01-24,10553,10553,7598,2955,53949,53949,38891,15058,267,47,47,51,2159,2159,2112,2112
Kings,6,2022-01-24,4306,4306,2925,1381,19068,19068,12979,6089,40,4,4,4,402,402,398,398
Lake,6,2022-01-24,744,744,487,257,3417,3417,2234,1183,6,2,2,3,123,123,121,121
Lassen,6,2022-01-24,418,418,307,111,3982,3982,2932,1050,6,0,0,0,54,54,54,54
Los Angeles,6,2022-01-24,164920,164923,145684,19239,1659206,1659237,1466714,192523,3769,611,611,785,29021,29021,28410,28410
Madera,6,2022-01-24,2716,2716,1771,945,12179,12179,7943,4236,49,8,8,10,353,353,345,345
Marin,6,2022-01-24,1855,1855,1226,629,17549,17549,11609,5940,38,4,4,10,212,212,208,208
Mariposa,6,2022-01-24,133,133,85,48,945,945,605,340,0,0,0,0,22,22,22,22
Mendocino,6,2022-01-24,917,917,538,379,4873,4873,2854,2019,23,2,2,3,111,111,109,109
Merced,6,2022-01-24,3443,3443,2456,987,12908,12908,9215,3693,55,9,9,12,746,746,737,737
Modoc,6,2022-01-24,14,14,10,4,114,114,82,32,2,0,0,0,7,7,7,7
Mono,6,2022-01-24,97,97,52,45,422,422,227,195,1,0,0,0,5,5,5,5
Monterey,6,2022-01-24,5090,5090,2776,2314,31797,31797,17335,14462,80,9,9,17,669,669,660,660
Napa,6,2022-01-24,1679,1679,1241,438,12490,12490,9224,3266,23,5,5,4,117,117,112,112
Nevada,6,2022-01-24,1001,1001,659,342,4806,4806,3170,1636,29,1,1,6,116,116,115,115
Orange,6,2022-01-24,26756,26756,20447,6309,230980,230985,176765,54220,923,177,177,191,6476,6476,6299,6299
Placer,6,2022-01-24,3660,3660,2330,1330,18645,18645,11868,6777,215,8,8,43,546,546,538,538
Plumas,6,2022-01-24,214,214,143,71,836,836,559,277,5,0,0,0,12,12,12,12
Riverside,6,2022-01-24,31909,31909,22577,9332,158787,158791,112472,46319,901,122,122,168,5991,5991,5869,5869
Sacramento,6,2022-01-24,17479,17479,12094,5385,98844,98844,68430,30414,542,64,64,105,2702,2702,2638,2638
San Benito,6,2022-01-24,776,776,570,206,3929,3929,2889,1040,7,1,1,3,88,88,87,87
San Bernardino,6,2022-01-24,28063,28063,21031,7032,153576,153578,115206,38372,975,171,171,223,7105,7105,6934,6934
San Diego,6,2022-01-24,51447,51447,45154,6293,252119,252124,221532,30592,1056,131,131,232,4848,4848,4717,4717
San Francisco,6,2022-01-24,8095,8095,4232,3863,88917,88917,46539,42378,232,19,19,37,744,744,725,725
San Joaquin,6,2022-01-24,11056,11056,7405,3651,59076,59076,39646,19430,241,34,34,71,2070,2070,2036,2036
San Luis Obispo,6,2022-01-24,3561,3561,2582,979,21529,21529,15612,5917,42,10,10,12,401,401,391,391
San Mateo,6,2022-01-24,8510,8510,6501,2009,95135,95135,72738,22397,139,20,20,28,642,642,622,622
Santa Barbara,6,2022-01-24,6483,6483,4558,1925,43832,43832,30826,13006,127,12,12,19,613,613,601,601
Santa Clara,6,2022-01-24,22788,22788,19874,2914,233312,233317,203465,29852,412,48,48,88,2098,2098,2050,2050
Santa Cruz,6,2022-01-24,5042,5042,3708,1334,45621,45621,33575,12046,31,1,1,2,241,241,240,240
Shasta,6,2022-01-24,1486,1486,1032,454,10135,10135,7033,3102,78,7,7,9,476,476,469,469
Siskiyou,6,2022-01-24,158,158,117,41,857,857,635,222,6,3,3,1,68,68,65,65
Solano,6,2022-01-24,5131,5131,3629,1502,32626,32626,23092,9534,143,14,14,26,423,423,409,409
Sonoma,6,2022-01-24,6926,6926,4931,1995,42476,42476,30248,12228,94,7,7,18,451,451,444,444
Stanislaus,6,2022-01-24,6378,6378,3878,2500,28276,28276,17216,11060,277,27,27,44,1508,1508,1481,1481
Sutter,6,2022-01-24,1046,1046,736,310,5002,5002,3521,1481,0,2,2,0,205,205,203,203
Tehama,6,2022-01-24,575,575,356,219,2702,2702,1674,1028,19,4,4,5,178,178,174,174
Trinity,6,2022-01-24,63,63,38,25,322,322,196,126,0,0,0,0,20,20,20,20
Tulare,6,2022-01-24,7679,7679,4633,3046,29535,29535,17858,11677,138,11,11,14,1359,1359,1348,1348
Tuolumne,6,2022-01-24,954,954,628,326,3833,3833,2514,1319,17,2,2,3,164,164,162,162
Ventura,6,2022-01-24,9412,9412,7331,2081,68521,68521,53428,15093,269,28,28,68,1327,1327,1299,1299
Yolo,6,2022-01-24,2299,2299,1676,623,40464,40464,29502,10962,18,12,12,5,319,319,307,307
Yuba,6,2022-01-24,909,909,652,257,3777,3777,2709,1068,54,3,3,10,110,110,107,107
Alameda,7,2022-01-31,11000,11000,8743,2257,137323,137325,109274,28051,336,50,50,75,1693,1693,1643,1643
Amador,7,2022-01-31,349,349,246,103,3226,3226,2273,953,15,1,1,4,74,74,73,73
Butte,7,2022-01-31,1163,1163,963,200,7608,7608,6305,1303,80,6,6,7,386,386,380,380
Calaveras,7,2022-01-31,263,263,193,70,1941,1941,1425,516,3,5,5,2,104,104,99,99
Colusa,7,2022-01-31,106,106,81,25,704,704,540,164,9,0,0,0,21,21,21,21
Contra Costa,7,2022-01-31,7310,7310,5096,2214,68626,68626,47920,20706,207,39,39,54,1191,1191,1152,1152
Del Norte,7,2022-01-31,314,314,236,78,3957,3957,2977,980,6,2,2,2,44,44,42,42
El Dorado,7,2022-01-31,739,739,542,197,6020,6020,4421,1599,13,4,4,5,199,199,195,195
Fresno,7,2022-01-31,11003,11003,7803,3200,54826,54826,38934,15892,503,39,39,98,2573,2573,2534,2534
Glenn,7,2022-01-31,190,190,140,50,759,759,563,196,2,3,3,0,48,48,45,45
Humboldt,7,2022-01-31,583,583,438,145,5790,5790,4348,1442,18,3,3,3,135,135,132,132
Imperial,7,2022-01-31,2200,2200,1604,596,11274,11274,8242,3032,71,17,17,28,895,895,878,878
Inyo,7,2022-01-31,55,55,42,13,467,467,357,110,5,3,3,0,56,56,53,53
Kern,7,2022-01-31,5650,5650,4340,1310,42265,42265,32504,9761,264,47,47,54,2206,2206,2159,2159
Kings,7,2022-01-31,2391,2391,1749,642,13683,13683,10019,3664,55,5,5,4,407,407,402,402
Lake,7,2022-01-31,474,474,335,139,3193,3193,2258,935,4,4,4,4,127,127,123,123
Lassen,7,2022-01-31,311,311,243,68,3624,3624,2838,786,7,1,1,0,55,55,54,54
Los Angeles,7,2022-01-31,74579,74579,67646,6933,1302839,1302864,1182557,120307,2991,640,640,719,29661,29661,29021,29021
Madera,7,2022-01-31,1746,1746,1235,511,9642,9642,6823,2819,50,6,6,7,359,359,353,353
Marin,7,2022-01-31,1063,1063,759,304,13818,13818,9889,3929,26,5,5,9,217,217,212,212
Mariposa,7,2022-01-31,101,101,70,31,842,842,586,256,0,2,2,0,24,24,22,22
Mendocino,7,2022-01-31,464,464,299,165,3486,3486,2252,1234,12,3,3,4,114,114,111,111
Merced,7,2022-01-31,2234,2234,1700,534,10469,10469,7978,2491,54,12,12,14,758,758,746,746
Modoc,7,2022-01-31,12,12,9,3,89,89,68,21,1,1,1,0,8,8,7,7
Mono,7,2022-01-31,41,41,25,16,339,339,203,136,0,0,0,0,5,5,5,5
Monterey,7,2022-01-31,3556,3556,2152,1404,26737,26737,16225,10512,82,9,9,13,678,678,669,669
Napa,7,2022-01-31,998,998,783,215,9406,9406,7378,2028,17,7,7,10,124,124,117,117
Nevada,7,2022-01-31,568,568,404,164,3912,3912,2788,1124,26,3,3,5,119,119,116,116
Orange,7,2022-01-31,12003,12003,9683,2320,177064,177069,142962,34107,708,170,170,164,6646,6646,6476,6476
Placer,7,2022-01-31,2256,2256,1560,696,15375,15375,10647,4728,152,19,19,42,565,565,546,546
Plumas,7,2022-01-31,136,136,98,38,753,753,542,211,1,0,0,0,12,12,12,12
Riverside,7,2022-01-31,15946,15946,12052,3894,121047,121047,91695,29352,740,111,111,171,6102,6102,5991,5991
Sacramento,7,2022-01-31,10146,10146,7528,2618,77594,77594,57658,19936,501,93,93,106,2795,2795,2702,2702
San Benito,7,2022-01-31,474,474,370,104,3323,3323,2596,727,5,2,2,3,90,90,88,88
San Bernardino,7,2022-01-31,13239,13239,10506,2733,116546,116546,92600,23946,744,185,185,207,7290,7290,7105,7105
San Diego,7,2022-01-31,24830,24830,22402,2428,181385,181389,163798,17591,944,105,105,214,4953,4953,4848,4848
San Francisco,7,2022-01-31,4047,4047,2359,1688,69168,69168,40403,28765,208,24,24,45,768,768,744,744
San Joaquin,7,2022-01-31,5699,5699,4123,1576,43659,43659,31651,12008,210,36,36,75,2106,2106,2070,2070
San Luis Obispo,7,2022-01-31,1981,1981,1530,451,16245,16245,12548,3697,40,12,12,10,413,413,401,401
San Mateo,7,2022-01-31,4327,4327,3488,839,75104,75104,60568,14536,131,10,10,19,652,652,642,642
Santa Barbara,7,2022-01-31,3634,3634,2733,901,35029,35029,26387,8642,103,23,23,13,636,636,613,613
Santa Clara,7,2022-01-31,13838,13838,12417,1421,207120,207125,185908,21217,427,55,55,93,2153,2153,2098,2098
Santa Cruz,7,2022-01-31,3439,3439,2680,759,51420,51420,40150,11270,35,5,5,6,246,246,241,241
Shasta,7,2022-01-31,900,900,670,230,8419,8419,6269,2150,59,13,13,11,489,489,476,476
Siskiyou,7,2022-01-31,119,119,94,25,691,691,545,146,8,2,2,2,70,70,68,68
Solano,7,2022-01-31,3812,3812,2885,927,28704,28704,21721,6983,126,6,6,30,429,429,423,423
Sonoma,7,2022-01-31,3569,3569,2711,858,32148,32148,24453,7695,84,12,12,15,463,463,451,451
Stanislaus,7,2022-01-31,3693,3693,2462,1231,22315,22315,14903,7412,261,33,33,53,1541,1541,1508,1508
Sutter,7,2022-01-31,618,618,465,153,3764,3764,2837,927,0,4,4,0,209,209,205,205
Tehama,7,2022-01-31,377,377,256,121,2022,2022,1368,654,17,3,3,5,181,181,178,178
Trinity,7,2022-01-31,43,43,29,14,227,227,151,76,0,0,0,0,20,20,20,20
Tulare,7,2022-01-31,4689,4689,3100,1589,22911,22911,15180,7731,150,22,22,21,1381,1381,1359,1359
Tuolumne,7,2022-01-31,710,710,502,208,3268,3268,2317,951,12,2,2,4,166,166,164,164
Ventura,7,2022-01-31,4596,4596,3764,832,52325,52325,42901,9424,253,39,39,48,1366,1366,1327,1327
Yolo,7,2022-01-31,1353,1353,1049,304,37501,37501,29100,8401,19,5,5,5,324,324,319,319
Yuba,7,2022-01-31,523,523,400,123,2931,2931,2243,688,78,2,2,11,112,112,110,110
Alameda,8,2022-02-07,5976,5976,4976,1000,115671,115672,96373,19299,254,44,44,62,1737,1737,1693,1693
Amador,8,2022-02-07,203,203,152,51,2909,2909,2187,722,14,4,4,5,78,78,74,74
Butte,8,2022-02-07,784,784,674,110,6392,6392,5504,888,74,8,8,12,394,394,386,386
Calaveras,8,2022-02-07,183,183,142,41,1427,1427,1112,315,2,2,2,1,106,106,104,104
Colusa,8,2022-02-07,71,71,57,14,555,555,449,106,0,0,0,0,21,21,21,21
Contra Costa,8,2022-02-07,4134,4134,3091,1043,54151,54151,40504,13647,149,32,32,52,1223,1223,1191,1191
Del Norte,8,2022-02-07,286,286,228,58,4003,4003,3184,819,5,0,0,0,44,44,44,44
El Dorado,8,2022-02-07,427,427,333,94,5034,5034,3927,1107,20,1,1,5,200,200,199,199
Fresno,8,2022-02-07,6396,6396,4845,1551,42476,42476,32216,10260,450,49,49,87,2622,2622,2573,2573
Glenn,8,2022-02-07,113,113,88,25,620,620,488,132,4,3,3,0,51,51,48,48
Humboldt,8,2022-02-07,467,467,371,96,4875,4875,3874,1001,15,1,1,2,136,136,135,135
Imperial,8,2022-02-07,1100,1100,854,246,7925,7925,6162,1763,46,12,12,26,907,907,895,895
Inyo,8,2022-02-07,38,38,30,8,447,447,361,86,5,0,0,0,56,56,56,56
Kern,8,2022-02-07,3473,3473,2812,661,34658,34658,28089,6569,190,33,33,43,2239,2239,2206,2206
Kings,8,2022-02-07,1353,1353,1052,301,10250,10250,7978,2272,52,14,14,5,421,421,407,407
Lake,8,2022-02-07,349,349,264,85,2624,2624,1985,639,11,1,1,5,128,128,127,127
Lassen,8,2022-02-07,140,140,115,25,3023,3023,2487,536,5,2,2,0,57,57,55,55
Los Angeles,8,2022-02-07,37351,37351,34594,2757,1151464,1151488,1066935,84553,2155,638,638,547,30299,30299,29661,29661
Madera,8,2022-02-07,1058,1058,800,258,8089,8089,6124,1965,38,4,4,9,363,363,359,359
Marin,8,2022-02-07,655,655,500,155,11292,11292,8617,2675,29,8,8,6,225,225,217,217
Mariposa,8,2022-02-07,51,51,38,13,581,581,432,149,0,0,0,0,24,24,24,24
Mendocino,8,2022-02-07,327,327,229,98,2817,2817,1974,843,12,2,2,5,116,116,114,114
Merced,8,2022-02-07,1235,1235,993,242,8069,8069,6496,1573,53,13,13,12,771,771,758,758
Modoc,8,2022-02-07,25,25,20,5,219,219,179,40,3,0,0,0,8,8,8,8
Mono,8,2022-02-07,44,44,29,15,271,271,178,93,0,0,0,0,5,5,5,5
Monterey,8,2022-02-07,2221,2221,1474,747,22455,22455,14935,7520,68,11,11,14,689,689,678,678
Napa,8,2022-02-07,746,746,615,131,7782,7782,6409,1373,16,6,6,2,130,130,124,124
Nevada,8,2022-02-07,357,357,271,86,3187,3187,2429,758,24,3,3,1,122,122,119,119
Orange,8,2022-02-07,6410,6410,5404,1006,152316,152321,128469,23852,494,118,118,125,6764,6764,6646,6646
Placer,8,2022-02-07,1294,1294,960,334,11887,11887,8831,3056,148,22,22,34,587,587,565,565
Plumas,8,2022-02-07,79,79,60,19,521,521,399,122,1,1,1,0,13,13,12,12
Riverside,8,2022-02-07,8146,8146,6513,1633,93432,93432,74777,18655,548,107,107,116,6209,6209,6102,6102
Sacramento,8,2022-02-07,6078,6078,4786,1292,63993,63993,50431,13562,390,72,72,95,2867,2867,2795,2795
San Benito,8,2022-02-07,310,310,255,55,2660,2660,2184,476,3,0,0,4,90,90,90,90
San Bernardino,8,2022-02-07,7047,7047,5861,1186,90093,90093,74994,15099,528,141,141,156,7431,7431,7290,7290
San Diego,8,2022-02-07,13632,13632,12575,1057,151886,151889,140174,11715,773,116,116,169,5069,5069,4953,4953
San Francisco,8,2022-02-07,2406,2406,1551,855,55777,55777,35912,19865,171,25,25,40,793,793,768,768
San Joaquin,8,2022-02-07,3347,3347,2580,767,36523,36523,28204,8319,186,43,43,62,2149,2149,2106,2106
San Luis Obispo,8,2022-02-07,1204,1204,979,225,12349,12349,10048,2301,23,16,16,7,429,429,413,413
San Mateo,8,2022-02-07,2463,2463,2075,388,62132,62132,52353,9779,83,16,16,18,668,668,652,652
Santa Barbara,8,2022-02-07,2282,2282,1814,468,30728,30728,24436,6292,75,15,15,17,651,651,636,636
Santa Clara,8,2022-02-07,8033,8033,7376,657,175345,175350,161031,14319,377,32,32,74,2185,2185,2153,2153
Santa Cruz,8,2022-02-07,1900,1900,1560,340,38681,38681,31764,6917,28,4,4,5,250,250,246,246
Shasta,8,2022-02-07,674,674,532,142,6857,6857,5413,1444,64,16,16,10,505,505,489,489
Siskiyou,8,2022-02-07,90,90,74,16,720,720,595,125,10,2,2,0,72,72,70,70
Solano,8,2022-02-07,2238,2238,1784,454,24206,24206,19343,4863,91,5,5,28,434,434,429,429
Sonoma,8,2022-02-07,2086,2086,1676,410,27054,27054,21735,5319,57,7,7,11,470,470,463,463
Stanislaus,8,2022-02-07,2490,2490,1791,699,18746,18746,13507,5239,243,43,43,43,1584,1584,1541,1541
Sutter,8,2022-02-07,359,359,285,74,3305,3305,2631,674,0,5,5,0,214,214,209,209
Tehama,8,2022-02-07,279,279,203,76,1644,1644,1197,447,17,3,3,6,184,184,181,181
Trinity,8,2022-02-07,18,18,13,5,136,136,98,38,0,0,0,0,20,20,20,20
Tulare,8,2022-02-07,2705,2705,1933,772,17918,17918,12839,5079,130,27,27,21,1408,1408,1381,1381
Tuolumne,8,2022-02-07,348,348,263,85,2578,2578,1954,624,10,2,2,1,168,168,166,166
Ventura,8,2022-02-07,2695,2695,2301,394,42327,42327,36165,6162,207,40,40,45,1406,1406,1366,1366
Yolo,8,2022-02-07,863,863,705,158,30851,30851,25175,5676,12,11,11,6,335,335,324,324
Yuba,8,2022-02-07,333,333,269,64,2406,2406,1942,464,42,4,4,13,116,116,112,112
Alameda,9,2022-02-14,3405,3405,2944,461,98992,98993,85608,13385,190,39,39,48,1776,1776,1737,1737
Amador,9,2022-02-14,109,109,87,22,2345,2345,1866,479,8,3,3,3,81,81,78,78
Butte,9,2022-02-14,464,464,412,52,5317,5317,4721,596,64,10,10,9,404,404,394,394
Calaveras,9,2022-02-14,79,79,64,15,1163,1163,950,213,4,2,2,2,108,108,106,106
Colusa,9,2022-02-14,35,35,29,6,406,406,341,65,5,0,0,0,21,21,21,21
Contra Costa,9,2022-02-14,2401,2401,1901,500,44862,44862,35542,9320,123,23,23,31,1246,1246,1223,1223
Del Norte,9,2022-02-14,210,210,175,35,3338,3338,2775,563,6,0,0,3,44,44,44,44
El Dorado,9,2022-02-14,260,260,213,47,4433,4433,3631,802,21,4,4,3,204,204,200,200
Fresno,9,2022-02-14,3868,3868,3096,772,34840,34840,27901,6939,375,34,34,75,2656,2656,2622,2622
Glenn,9,2022-02-14,58,58,48,10,482,482,398,84,3,2,2,0,53,53,51,51
Humboldt,9,2022-02-14,330,330,274,56,4202,4202,3495,707,23,0,0,2,136,136,136,136
Imperial,9,2022-02-14,589,589,481,108,5945,5945,4857,1088,44,14,14,18,921,921,907,907
Inyo,9,2022-02-14,29,29,24,5,413,413,348,65,3,0,0,0,56,56,56,56
Kern,9,2022-02-14,2014,2014,1701,313,27235,27235,23014,4221,156,28,28,40,2267,2267,2239,2239
Kings,9,2022-02-14,774,774,633,141,8004,8004,6550,1454,43,8,8,5,429,429,421,421
Lake,9,2022-02-14,256,256,205,51,2307,2307,1842,465,6,2,2,5,130,130,128,128
Lassen,9,2022-02-14,155,155,133,22,2789,2789,2383,406,3,2,2,0,59,59,57,57
Los Angeles,9,2022-02-14,21444,21444,20191,1253,1052402,1052430,991085,61345,1572,489,489,423,30788,30788,30299,30299
Madera,9,2022-02-14,621,621,497,124,6469,6469,5170,1299,29,2,2,7,365,365,363,363
Marin,9,2022-02-14,382,382,308,74,10150,10150,8173,1977,23,5,5,4,230,230,225,225
Mariposa,9,2022-02-14,24,24,19,5,433,433,342,91,0,0,0,0,24,24,24,24
Mendocino,9,2022-02-14,207,207,155,52,2445,2445,1834,611,13,1,1,7,117,117,116,116
Merced,9,2022-02-14,745,745,627,118,6836,6836,5748,1088,37,13,13,8,784,784,771,771
Modoc,9,2022-02-14,17,17,14,3,124,124,104,20,0,0,0,0,8,8,8,8
Mono,9,2022-02-14,10,10,7,3,179,179,127,52,0,0,0,0,5,5,5,5
Monterey,9,2022-02-14,1227,1227,880,347,16948,16948,12153,4795,48,12,12,12,701,701,689,689
Napa,9,2022-02-14,400,400,343,57,6607,6607,5661,946,10,1,1,1,131,131,130,130
Nevada,9,2022-02-14,169,169,136,33,2568,2568,2066,502,19,3,3,5,125,125,122,122
Orange,9,2022-02-14,4007,4007,3501,506,132333,132337,115564,16773,354,115,115,77,6879,6879,6764,6764
Placer,9,2022-02-14,595,595,468,127,9967,9967,7844,2123,105,12,12,23,599,599,587,587
Plumas,9,2022-02-14,43,43,35,8,431,431,348,83,1,0,0,0,13,13,13,13
Riverside,9,2022-02-14,4611,4611,3858,753,74757,74757,62570,12187,400,85,85,86,6294,6294,6209,6209
Sacramento,9,2022-02-14,3418,3418,2824,594,53025,53025,43831,9194,349,60,60,66,2927,2927,2867,2867
San Benito,9,2022-02-14,158,158,135,23,2159,2159,1845,314,0,2,2,3,92,92,90,90
San Bernardino,9,2022-02-14,3708,3708,3203,505,72761,72761,62876,9885,338,117,117,128,7548,7548,7431,7431
San Diego,9,2022-02-14,8073,8073,7576,497,126083,126088,118376,7712,589,89,89,135,5158,5158,5069,5069
San Francisco,9,2022-02-14,1610,1610,1124,486,47605,47605,33265,14340,130,25,25,39,818,818,793,793
San Joaquin,9,2022-02-14,1985,1985,1612,373,30641,30641,24898,5743,123,37,37,53,2186,2186,2149,2149
San Luis Obispo,9,2022-02-14,798,798,677,121,10058,10058,8536,1522,24,9,9,7,438,438,429,429
San Mateo,9,2022-02-14,1345,1345,1174,171,55007,55007,48007,7000,63,17,17,11,685,685,668,668
Santa Barbara,9,2022-02-14,1055,1055,880,175,22483,22483,18754,3729,68,8,8,14,659,659,651,651
Santa Clara,9,2022-02-14,4635,4635,4334,301,155255,155260,145180,10080,296,27,27,59,2212,2212,2185,2185
Santa Cruz,9,2022-02-14,981,981,838,143,30369,30369,25920,4449,23,3,3,4,253,253,250,250
Shasta,9,2022-02-14,442,442,366,76,5851,5851,4841,1010,62,13,13,13,518,518,505,505
Siskiyou,9,2022-02-14,66,66,57,9,520,520,447,73,7,1,1,2,73,73,72,72
Solano,9,2022-02-14,1201,1201,1003,198,18983,18983,15871,3112,73,2,2,20,436,436,434,434
Sonoma,9,2022-02-14,1135,1135,953,182,21176,21176,17763,3413,55,8,8,7,478,478,470,470
Stanislaus,9,2022-02-14,1363,1363,1045,318,15085,15085,11575,3510,206,28,28,41,1612,1612,1584,1584
Sutter,9,2022-02-14,230,230,192,38,2862,2862,2386,476,0,3,3,0,217,217,214,214
Tehama,9,2022-02-14,179,179,138,41,1404,1404,1088,316,15,5,5,5,189,189,184,184
Trinity,9,2022-02-14,22,22,17,5,171,171,131,40,0,0,0,0,20,20,20,20
Tulare,9,2022-02-14,1479,1479,1127,352,15063,15063,11509,3554,116,27,27,19,1435,1435,1408,1408
Tuolumne,9,2022-02-14,192,192,154,38,2225,2225,1781,444,12,4,4,1,172,172,168,168
Ventura,9,2022-02-14,1510,1510,1332,178,35531,35531,31350,4181,141,36,36,26,1442,1442,1406,1406
Yolo,9,2022-02-14,479,479,407,72,26818,26818,22786,4032,10,7,7,3,342,342,335,335
Yuba,9,2022-02-14,216,216,182,34,2109,2109,1777,332,19,2,2,11,118,118,116,116
Alameda,10,2022-02-21,1930,1930,1720,210,77638,77641,69066,8575,138,28,28,26,1804,1804,1776,1776
Amador,10,2022-02-21,69,69,57,12,1921,1921,1598,323,7,3,3,3,84,84,81,81
Butte,10,2022-02-21,256,256,233,23,4424,4424,4025,399,63,12,12,4,416,416,404,404
Calaveras,10,2022-02-21,44,44,37,7,838,838,712,126,3,6,6,0,114,114,108,108
Colusa,10,2022-02-21,26,26,23,3,362,362,315,47,4,0,0,0,21,21,21,21
Contra Costa,10,2022-02-21,1304,1304,1081,223,34150,34150,28271,5879,66,18,18,30,1264,1264,1246,1246
Del Norte,10,2022-02-21,129,129,111,18,2704,2704,2329,375,8,0,0,1,44,44,44,44
El Dorado,10,2022-02-21,155,155,132,23,3612,3612,3078,534,8,2,2,5,206,206,204,204
Fresno,10,2022-02-21,2013,2013,1684,329,26834,26834,22448,4386,272,26,26,54,2682,2682,2656,2656
Glenn,10,2022-02-21,28,28,24,4,405,405,348,57,2,1,1,0,54,54,53,53
Humboldt,10,2022-02-21,192,192,166,26,3331,3331,2873,458,22,3,3,1,139,139,136,136
Imperial,10,2022-02-21,394,394,335,59,4741,4741,4034,707,31,6,6,10,927,927,921,921
Inyo,10,2022-02-21,10,10,9,1,326,326,284,42,1,0,0,0,56,56,56,56
Kern,10,2022-02-21,1285,1285,1123,162,24327,24327,21267,3060,95,23,23,25,2290,2290,2267,2267
Kings,10,2022-02-21,454,454,387,67,6546,6546,5579,967,32,4,4,5,433,433,429,429
Lake,10,2022-02-21,185,185,155,30,1935,1935,1614,321,7,2,2,1,132,132,130,130
Lassen,10,2022-02-21,111,111,98,13,2135,2135,1883,252,1,0,0,0,59,59,59,59
Los Angeles,10,2022-02-21,11810,11810,11263,547,832207,832234,793206,39028,997,323,323,279,31111,31111,30788,30788
Madera,10,2022-02-21,317,317,265,52,5184,5184,4322,862,27,2,2,7,367,367,365,365
Marin,10,2022-02-21,199,199,167,32,8846,8846,7426,1420,13,3,3,4,233,233,230,230
Mariposa,10,2022-02-21,23,23,19,4,374,374,309,65,0,1,1,0,25,25,24,24
Mendocino,10,2022-02-21,113,113,90,23,1942,1942,1539,403,9,2,2,3,119,119,117,117
Merced,10,2022-02-21,426,426,371,55,5161,5161,4490,671,26,10,10,7,794,794,784,784
Modoc,10,2022-02-21,9,9,8,1,65,65,57,8,2,0,0,0,8,8,8,8
Mono,10,2022-02-21,7,7,5,2,162,162,123,39,0,1,1,0,6,6,5,5
Monterey,10,2022-02-21,780,780,596,184,12977,12977,9894,3083,47,5,5,7,706,706,701,701
Napa,10,2022-02-21,229,229,202,27,4991,4991,4410,581,6,4,4,3,135,135,131,131
Nevada,10,2022-02-21,102,102,85,17,1985,1985,1665,320,16,2,2,5,127,127,125,125
Orange,10,2022-02-21,2468,2468,2217,251,110425,110428,99034,11394,256,79,79,69,6958,6958,6879,6879
Placer,10,2022-02-21,328,328,271,57,8679,8679,7157,1522,92,9,9,13,608,608,599,599
Plumas,10,2022-02-21,21,21,18,3,328,328,276,52,0,0,0,0,13,13,13,13
Riverside,10,2022-02-21,2436,2436,2112,324,61420,61420,53280,8140,262,53,53,61,6347,6347,6294,6294
Sacramento,10,2022-02-21,1965,1965,1686,279,42793,42793,36703,6090,249,33,33,47,2960,2960,2927,2927
San Benito,10,2022-02-21,104,104,92,12,1696,1696,1494,202,0,0,0,1,92,92,92,92
San Bernardino,10,2022-02-21,1902,1902,1694,208,60255,60255,53633,6622,251,82,82,78,7630,7630,7548,7548
San Diego,10,2022-02-21,4622,4622,4397,225,100591,100595,95694,4901,468,63,63,106,5221,5221,5158,5158
San Francisco,10,2022-02-21,975,975,730,245,40358,40358,30109,10249,98,11,11,24,829,829,818,818
San Joaquin,10,2022-02-21,1047,1047,886,161,23844,23844,20166,3678,91,25,25,31,2211,2211,2186,2186
San Luis Obispo,10,2022-02-21,441,441,386,55,7659,7659,6712,947,16,16,16,3,454,454,438,438
San Mateo,10,2022-02-21,694,694,623,71,42574,42574,38159,4415,47,8,8,8,693,693,685,685
Santa Barbara,10,2022-02-21,610,610,527,83,19196,19196,16578,2618,40,6,6,10,665,665,659,659
Santa Clara,10,2022-02-21,2515,2515,2385,130,120314,120318,114029,6289,224,26,26,53,2238,2238,2212,2212
Santa Cruz,10,2022-02-21,578,578,509,69,25013,25013,22014,2999,21,1,1,4,254,254,253,253
Shasta,10,2022-02-21,262,262,225,37,4976,4976,4276,700,46,9,9,10,527,527,518,518
Siskiyou,10,2022-02-21,47,47,42,5,450,450,398,52,6,4,4,1,77,77,73,73
Solano,10,2022-02-21,696,696,603,93,15111,15111,13094,2017,51,5,5,15,441,441,436,436
Sonoma,10,2022-02-21,628,628,546,82,16821,16821,14601,2220,36,2,2,8,480,480,478,478
Stanislaus,10,2022-02-21,731,731,590,141,11765,11765,9494,2271,168,29,29,30,1641,1641,1612,1612
Sutter,10,2022-02-21,121,121,105,16,2108,2108,1821,287,0,2,2,0,219,219,217,217
Tehama,10,2022-02-21,94,94,76,18,1219,1219,993,226,8,10,10,2,199,199,189,189
Trinity,10,2022-02-21,15,15,12,3,199,199,160,39,0,0,0,0,20,20,20,20
Tulare,10,2022-02-21,774,774,622,152,10933,10933,8790,2143,86,16,16,9,1451,1451,1435,1435
Tuolumne,10,2022-02-21,107,107,90,17,1786,1786,1493,293,2,6,6,2,178,178,172,172
Ventura,10,2022-02-21,884,884,800,84,27543,27543,24926,2617,107,22,22,22,1464,1464,1442,1442
Yolo,10,2022-02-21,282,282,248,34,20975,20975,18396,2579,7,6,6,3,348,348,342,342
Yuba,10,2022-02-21,132,132,115,17,1679,1679,1466,213,22,2,2,8,120,120,118,118
Alameda,11,2022-02-28,1475,1475,1348,127,78767,78771,71944,6827,113,15,15,23,1819,1819,1804,1804
Amador,11,2022-02-28,56,56,48,8,2077,2077,1796,281,7,0,0,2,84,84,84,84
Butte,11,2022-02-28,187,187,174,13,4476,4476,4157,319,45,6,6,4,422,422,416,416
Calaveras,11,2022-02-28,40,40,35,5,1254,1254,1105,149,0,3,3,0,117,117,114,114
Colusa,11,2022-02-28,10,10,9,1,406,406,364,42,5,0,0,0,21,21,21,21
Contra Costa,11,2022-02-28,934,934,805,129,35020,35020,30195,4825,56,15,15,19,1279,1279,1264,1264
Del Norte,11,2022-02-28,84,84,75,9,2876,2876,2557,319,5,3,3,2,47,47,44,44
El Dorado,11,2022-02-28,105,105,93,12,3686,3686,3252,434,5,2,2,3,208,208,206,206
Fresno,11,2022-02-28,1309,1309,1137,172,26292,26292,22842,3450,196,28,28,44,2710,2710,2682,2682
Glenn,11,2022-02-28,18,18,16,2,435,435,386,49,1,0,0,0,54,54,54,54
Humboldt,11,2022-02-28,157,157,140,17,2957,2957,2633,324,6,1,1,1,140,140,139,139
Imperial,11,2022-02-28,264,264,233,31,4766,4766,4195,571,13,6,6,10,933,933,927,927
Inyo,11,2022-02-28,10,10,9,1,379,379,341,38,0,0,0,0,56,56,56,56
Kern,11,2022-02-28,792,792,713,79,24605,24605,22152,2453,77,16,16,16,2306,2306,2290,2290
Kings,11,2022-02-28,246,246,216,30,6083,6083,5359,724,19,7,7,3,440,440,433,433
Lake,11,2022-02-28,110,110,95,15,1956,1956,1695,261,0,4,4,1,136,136,132,132
Lassen,11,2022-02-28,44,44,40,4,2097,2097,1899,198,1,2,2,0,61,61,59,59
Los Angeles,11,2022-02-28,8219,8219,7921,298,1057296,1057336,1018797,38539,753,220,220,174,31331,31331,31111,31111
Madera,11,2022-02-28,189,189,164,25,4632,4632,4020,612,20,2,2,6,369,369,367,367
Marin,11,2022-02-28,160,160,140,20,7664,7664,6681,983,13,3,3,3,236,236,233,233
Mariposa,11,2022-02-28,29,29,25,4,348,348,299,49,0,1,1,0,26,26,25,25
Mendocino,11,2022-02-28,84,84,70,14,1889,1889,1571,318,11,2,2,2,121,121,119,119
Merced,11,2022-02-28,283,283,254,29,5033,5033,4511,522,25,7,7,5,801,801,794,794
Modoc,11,2022-02-28,6,6,5,1,57,57,51,6,1,0,0,0,8,8,8,8
Mono,11,2022-02-28,5,5,4,1,169,169,136,33,0,0,0,0,6,6,6,6
Monterey,11,2022-02-28,356,356,287,69,14337,14337,11561,2776,28,9,9,5,715,715,706,706
Napa,11,2022-02-28,194,194,176,18,5599,5599,5084,515,8,3,3,2,138,138,135,135
Nevada,11,2022-02-28,71,71,62,9,2016,2016,1753,263,9,0,0,1,127,127,127,127
Orange,11,2022-02-28,1693,1693,1556,137,126375,126380,116116,10264,198,43,43,35,7001,7001,6958,6958
Placer,11,2022-02-28,248,248,213,35,8421,8421,7233,1188,65,4,4,13,612,612,608,608
Plumas,11,2022-02-28,23,23,20,3,370,370,323,47,0,0,0,0,13,13,13,13
Riverside,11,2022-02-28,1685,1685,1506,179,63269,63270,56573,6697,185,37,37,35,6384,6384,6347,6347
Sacramento,11,2022-02-28,1164,1164,1033,131,45702,45702,40520,5182,163,24,24,35,2984,2984,2960,2960
San Benito,11,2022-02-28,55,55,50,5,1809,1809,1638,171,0,0,0,1,92,92,92,92
San Bernardino,11,2022-02-28,1173,1173,1071,102,61097,61098,55778,5320,157,61,61,45,7691,7691,7630,7630
San Diego,11,2022-02-28,3034,3034,2918,116,100028,100033,96229,3804,341,38,38,83,5259,5259,5221,5221
San Francisco,11,2022-02-28,836,836,662,174,40068,40068,31744,8324,74,16,16,19,845,845,829,829
San Joaquin,11,2022-02-28,655,655,574,81,26086,26086,22864,3222,58,11,11,24,2222,2222,2211,2211
San Luis Obispo,11,2022-02-28,378,378,341,37,8513,8513,7680,833,9,5,5,2,459,459,454,454
San Mateo,11,2022-02-28,597,597,549,48,41440,41440,38086,3354,33,4,4,7,697,697,693,693
Santa Barbara,11,2022-02-28,368,368,328,40,21387,21387,19065,2322,36,5,5,10,670,670,665,665
Santa Clara,11,2022-02-28,1730,1730,1660,70,103093,103097,98977,4120,191,23,23,46,2261,2261,2238,2238
Santa Cruz,11,2022-02-28,460,460,416,44,27974,27974,25344,2630,20,2,2,4,256,256,254,254
Shasta,11,2022-02-28,167,167,148,19,4926,4926,4373,553,36,11,11,8,538,538,527,527
Siskiyou,11,2022-02-28,25,25,23,2,475,475,432,43,4,2,2,1,79,79,77,77
Solano,11,2022-02-28,475,475,425,50,15305,15305,13679,1626,47,3,3,17,444,444,441,441
Sonoma,11,2022-02-28,454,454,407,47,16949,16949,15184,1765,28,3,3,5,483,483,480,480
Stanislaus,11,2022-02-28,470,470,396,74,13370,13370,11283,2087,124,11,11,21,1652,1652,1641,1641
Sutter,11,2022-02-28,106,106,95,11,2333,2333,2079,254,0,2,2,0,221,221,219,219
Tehama,11,2022-02-28,58,58,49,9,1221,1221,1039,182,7,1,1,2,200,200,199,199
Trinity,11,2022-02-28,5,5,4,1,118,118,99,19,0,0,0,0,20,20,20,20
Tulare,11,2022-02-28,462,462,389,73,11881,11881,9994,1887,67,15,15,9,1466,1466,1451,1451
Tuolumne,11,2022-02-28,68,68,59,9,1489,1489,1294,195,6,3,3,1,181,181,178,178
Ventura,11,2022-02-28,548,548,507,41,29890,29890,27650,2240,75,10,10,11,1474,1474,1464,1464
Yolo,11,2022-02-28,207,207,187,20,26245,26245,23700,2545,4,5,5,6,353,353,348,348
Yuba,11,2022-02-28,71,71,64,7,1711,1711,1537,174,12,2,2,6,122,122,120,120
Alameda,12,2022-03-07,1093,1093,1018,75,72600,72604,67606,4998,77,11,11,16,1830,1830,1819,1819
Amador,12,2022-03-07,75,75,67,8,1428,1428,1274,154,6,2,2,1,86,86,84,84
Butte,12,2022-03-07,98,98,92,6,3638,3638,3434,204,33,4,4,3,426,426,422,422
Calaveras,12,2022-03-07,25,25,23,2,1048,1048,948,100,1,1,1,0,118,118,117,117
Colusa,12,2022-03-07,9,9,8,1,355,355,326,29,6,0,0,0,21,21,21,21
Contra Costa,12,2022-03-07,627,627,558,69,30971,30971,27546,3425,47,8,8,13,1287,1287,1279,1279
Del Norte,12,2022-03-07,50,50,46,4,1779,1779,1624,155,7,0,0,1,47,47,47,47
El Dorado,12,2022-03-07,77,77,70,7,3200,3200,2899,301,5,3,3,2,211,211,208,208
Fresno,12,2022-03-07,860,860,770,90,22201,22201,19876,2325,145,18,18,27,2728,2728,2710,2710
Glenn,12,2022-03-07,19,19,17,2,395,395,359,36,2,2,2,0,56,56,54,54
Humboldt,12,2022-03-07,80,80,73,7,3045,3045,2779,266,10,3,3,4,143,143,140,140
Imperial,12,2022-03-07,122,122,110,12,4465,4465,4039,426,16,5,5,10,938,938,933,933
Inyo,12,2022-03-07,10,10,9,1,269,269,247,22,0,0,0,0,56,56,56,56
Kern,12,2022-03-07,433,433,398,35,20836,20836,19187,1649,67,12,12,16,2318,2318,2306,2306
Kings,12,2022-03-07,201,201,182,19,4987,4987,4515,472,13,4,4,2,444,444,440,440
Lake,12,2022-03-07,63,63,56,7,1760,1760,1572,188,2,2,2,1,138,138,136,136
Lassen,12,2022-03-07,96,96,89,7,1889,1889,1748,141,0,1,1,0,62,62,61,61
Los Angeles,12,2022-03-07,5536,5536,5379,157,876065,876102,851178,24924,573,171,171,133,31502,31502,31331,31331
Madera,12,2022-03-07,133,133,119,14,3925,3925,3510,415,15,1,1,2,370,370,369,369
Marin,12,2022-03-07,154,154,138,16,7559,7559,6778,781,10,1,1,2,237,237,236,236
Mariposa,12,2022-03-07,11,11,10,1,298,298,264,34,0,1,1,0,27,27,26,26
Mendocino,12,2022-03-07,65,65,56,9,1643,1643,1418,225,6,0,0,2,121,121,121,121
Merced,12,2022-03-07,173,173,159,14,4539,4539,4164,375,17,7,7,5,808,808,801,801
Modoc,12,2022-03-07,0,0,0,0,54,54,50,4,0,0,0,0,8,8,8,8
Mono,12,2022-03-07,2,2,2,0,128,128,108,20,0,0,0,1,6,6,6,6
Monterey,12,2022-03-07,243,243,205,38,11053,11053,9324,1729,19,5,5,2,720,720,715,715
Napa,12,2022-03-07,200,200,185,15,4896,4896,4539,357,2,2,2,2,140,140,138,138
Nevada,12,2022-03-07,50,50,45,5,1751,1751,1569,182,0,2,2,0,129,129,127,127
Orange,12,2022-03-07,1257,1257,1176,81,107467,107472,100566,6906,138,29,29,28,7030,7030,7001,7001
Placer,12,2022-03-07,164,164,145,19,7797,7797,6916,881,54,3,3,11,615,615,612,612
Plumas,12,2022-03-07,7,7,6,1,266,266,239,27,0,0,0,0,13,13,13,13
Riverside,12,2022-03-07,980,980,898,82,53634,53634,49120,4514,125,26,26,30,6410,6410,6384,6384
Sacramento,12,2022-03-07,774,774,704,70,40207,40207,36586,3621,124,18,18,28,3002,3002,2984,2984
San Benito,12,2022-03-07,41,41,38,3,1525,1525,1411,114,0,2,2,1,94,94,92,92
San Bernardino,12,2022-03-07,792,792,737,55,54193,54193,50456,3737,95,43,43,38,7734,7734,7691,7691
San Diego,12,2022-03-07,2336,2336,2266,70,96670,96675,93791,2884,237,31,31,57,5290,5290,5259,5259
San Francisco,12,2022-03-07,699,699,581,118,37420,37420,31063,6357,62,5,5,11,850,850,845,845
San Joaquin,12,2022-03-07,439,439,396,43,21198,21198,19119,2079,33,9,9,19,2231,2231,2222,2222
San Luis Obispo,12,2022-03-07,245,245,226,19,7309,7309,6744,565,7,5,5,1,464,464,459,459
San Mateo,12,2022-03-07,528,528,494,34,40059,40059,37471,2588,30,2,2,3,699,699,697,697
Santa Barbara,12,2022-03-07,202,202,185,17,17716,17716,16188,1528,15,4,4,8,674,674,670,670
Santa Clara,12,2022-03-07,1466,1466,1420,46,112127,112132,108562,3570,128,13,13,38,2274,2274,2261,2261
Santa Cruz,12,2022-03-07,334,334,309,25,24974,24974,23115,1859,11,0,0,7,256,256,256,256
Shasta,12,2022-03-07,140,140,127,13,4940,4940,4498,442,24,8,8,3,546,546,538,538
Siskiyou,12,2022-03-07,12,12,11,1,399,399,370,29,2,1,1,0,80,80,79,79
Solano,12,2022-03-07,351,351,321,30,14066,14066,12875,1191,46,2,2,10,446,446,444,444
Sonoma,12,2022-03-07,321,321,294,27,14923,14923,13686,1237,26,3,3,6,486,486,483,483
Stanislaus,12,2022-03-07,276,276,241,35,10863,10863,9504,1359,94,10,10,13,1662,1662,1652,1652
Sutter,12,2022-03-07,81,81,74,7,1908,1908,1742,166,0,1,1,0,222,222,221,221
Tehama,12,2022-03-07,40,40,35,5,1115,1115,980,135,5,2,2,1,202,202,200,200
Trinity,12,2022-03-07,4,4,3,1,114,114,100,14,0,0,0,0,20,20,20,20
Tulare,12,2022-03-07,303,303,264,39,10287,10287,8978,1309,37,13,13,3,1479,1479,1466,1466
Tuolumne,12,2022-03-07,48,48,43,5,1254,1254,1123,131,2,0,0,1,181,181,181,181
Ventura,12,2022-03-07,417,417,392,25,26717,26717,25137,1580,45,4,4,11,1478,1478,1474,1474
Yolo,12,2022-03-07,160,160,148,12,22154,22154,20450,1704,3,2,2,2,355,355,353,353
Yuba,12,2022-03-07,59,59,54,5,1552,1552,1425,127,13,0,0,6,122,122,122,122
Alameda,13,2022-03-14,879,879,831,48,68953,68957,65206,3751,64,8,8,6,1838,1838,1830,1830
Amador,13,2022-03-14,32,32,29,3,1439,1439,1315,124,4,0,0,0,86,86,86,86
Butte,13,2022-03-14,82,82,78,4,3592,3592,3432,160,24,1,1,0,427,427,426,426
Calaveras,13,2022-03-14,17,17,16,1,990,990,914,76,1,1,1,1,119,119,118,118
Colusa,13,2022-03-14,4,4,4,0,257,257,240,17,4,0,0,0,21,21,21,21
Contra Costa,13,2022-03-14,566,566,516,50,29141,29141,26572,2569,19,5,5,9,1292,1292,1287,1287
Del Norte,13,2022-03-14,31,31,29,2,1415,1415,1317,98,1,2,2,1,49,49,47,47
El Dorado,13,2022-03-14,44,44,41,3,2980,2980,2757,223,4,1,1,0,212,212,211,211
Fresno,13,2022-03-14,526,526,482,44,21110,21110,19346,1764,120,10,10,20,2738,2738,2728,2728
Glenn,13,2022-03-14,11,11,10,1,342,342,318,24,1,0,0,0,56,56,56,56
Humboldt,13,2022-03-14,56,56,52,4,2651,2651,2466,185,3,1,1,2,144,144,143,143
Imperial,13,2022-03-14,75,75,69,6,4537,4537,4190,347,5,2,2,7,940,940,938,938
Inyo,13,2022-03-14,6,6,6,0,165,165,154,11,0,0,0,0,56,56,56,56
Kern,13,2022-03-14,301,301,282,19,20274,20274,19004,1270,42,14,14,12,2332,2332,2318,2318
Kings,13,2022-03-14,156,156,144,12,4698,4698,4344,354,17,1,1,2,445,445,444,444
Lake,13,2022-03-14,48,48,44,4,1570,1570,1436,134,1,1,1,0,139,139,138,138
Lassen,13,2022-03-14,5,5,5,0,1515,1515,1426,89,0,0,0,0,62,62,62,62
Los Angeles,13,2022-03-14,4061,4061,3971,90,845638,845675,826820,18855,412,115,115,91,31617,31617,31502,31502
Madera,13,2022-03-14,52,52,48,4,3583,3583,3280,303,12,0,0,2,370,370,370,370
Marin,13,2022-03-14,170,170,156,14,6532,6532,5997,535,7,1,1,0,238,238,237,237
Mariposa,13,2022-03-14,9,9,8,1,224,224,204,20,0,0,0,0,27,27,27,27
Mendocino,13,2022-03-14,35,35,31,4,1434,1434,1276,158,4,2,2,1,123,123,121,121
Merced,13,2022-03-14,134,134,125,9,4171,4171,3898,273,17,2,2,4,810,810,808,808
Modoc,13,2022-03-14,3,3,3,0,52,52,49,3,1,0,0,0,8,8,8,8
Mono,13,2022-03-14,2,2,2,0,118,118,103,15,0,0,0,0,6,6,6,6
Monterey,13,2022-03-14,157,157,137,20,10116,10116,8837,1279,14,4,4,2,724,724,720,720
Napa,13,2022-03-14,123,123,116,7,4114,4114,3876,238,6,1,1,3,141,141,140,140
Nevada,13,2022-03-14,50,50,46,4,1571,1571,1441,130,2,0,0,0,129,129,129,129
Orange,13,2022-03-14,827,827,785,42,101568,101573,96418,5155,109,32,32,31,7062,7062,7030,7030
Placer,13,2022-03-14,148,148,135,13,7319,7319,6658,661,45,3,3,5,618,618,615,615
Plumas,13,2022-03-14,4,4,4,0,317,317,291,26,0,0,0,0,13,13,13,13
Riverside,13,2022-03-14,742,742,693,49,52739,52739,49223,3516,87,15,15,16,6425,6425,6410,6410
Sacramento,13,2022-03-14,588,588,546,42,35141,35141,32618,2523,122,17,17,22,3019,3019,3002,3002
San Benito,13,2022-03-14,36,36,34,2,1462,1462,1375,87,0,0,0,1,94,94,94,94
San Bernardino,13,2022-03-14,572,572,541,31,51689,51689,48869,2820,68,26,26,32,7760,7760,7734,7734
San Diego,13,2022-03-14,1843,1843,1800,43,96066,96071,93816,2255,174,17,17,47,5307,5307,5290,5290
San Francisco,13,2022-03-14,608,608,525,83,34320,34320,29599,4721,28,7,7,7,857,857,850,850
San Joaquin,13,2022-03-14,268,268,247,21,18876,18876,17390,1486,28,7,7,11,2238,2238,2231,2231
San Luis Obispo,13,2022-03-14,162,162,152,10,6671,6671,6261,410,7,7,7,1,471,471,464,464
San Mateo,13,2022-03-14,441,441,419,22,35834,35834,34000,1834,27,0,0,3,699,699,699,699
Santa Barbara,13,2022-03-14,195,195,182,13,16861,16861,15702,1159,16,7,7,2,681,681,674,674
Santa Clara,13,2022-03-14,1177,1177,1148,29,99878,99883,97385,2498,108,13,13,28,2287,2287,2274,2274
Santa Cruz,13,2022-03-14,239,239,225,14,22176,22176,20869,1307,10,3,3,3,259,259,256,256
Shasta,13,2022-03-14,97,97,90,7,4838,4838,4492,346,16,5,5,2,551,551,546,546
Siskiyou,13,2022-03-14,9,9,8,1,370,370,349,21,0,3,3,0,83,83,80,80
Solano,13,2022-03-14,221,221,206,15,12301,12301,11473,828,34,1,1,6,447,447,446,446
Sonoma,13,2022-03-14,229,229,214,15,13398,13398,12513,885,14,1,1,4,487,487,486,486
Stanislaus,13,2022-03-14,216,216,194,22,9403,9403,8455,948,82,11,11,17,1673,1673,1662,1662
Sutter,13,2022-03-14,41,41,38,3,1815,1815,1689,126,0,0,0,0,222,222,222,222
Tehama,13,2022-03-14,17,17,15,2,981,981,886,95,2,3,3,0,205,205,202,202
Trinity,13,2022-03-14,3,3,3,0,96,96,86,10,0,0,0,0,20,20,20,20
Tulare,13,2022-03-14,174,174,156,18,9308,9308,8354,954,33,0,0,6,1479,1479,1479,1479
Tuolumne,13,2022-03-14,22,22,20,2,1250,1250,1145,105,1,0,0,0,181,181,181,181
Ventura,13,2022-03-14,326,326,311,15,24591,24591,23440,1151,37,6,6,7,1484,1484,1478,1478
Yolo,13,2022-03-14,118,118,111,7,21620,21620,20302,1318,1,3,3,2,358,358,355,355
Yuba,13,2022-03-14,35,35,33,2,1417,1417,1325,92,10,2,2,3,124,124,122,122
Alameda,14,2022-03-21,721,721,690,31,65828,65832,63000,2832,58,6,6,3,1844,1844,1838,1838
Amador,14,2022-03-21,29,29,27,2,1356,1356,1263,93,2,0,0,0,86,86,86,86
Butte,14,2022-03-21,81,81,78,3,3158,3158,3048,110,17,0,0,2,427,427,427,427
Calaveras,14,2022-03-21,8,8,8,0,657,657,618,39,0,0,0,0,119,119,119,119
Colusa,14,2022-03-21,3,3,3,0,231,231,219,12,2,0,0,0,21,21,21,21
Contra Costa,14,2022-03-21,466,466,434,32,26931,26931,25039,1892,27,7,7,9,1299,1299,1292,1292
Del Norte,14,2022-03-21,19,19,18,1,1192,1192,1127,65,0,0,0,0,49,49,49,49
El Dorado,14,2022-03-21,46,46,43,3,2813,2813,2647,166,1,2,2,0,214,214,212,212
Fresno,14,2022-03-21,346,346,323,23,19327,19327,18045,1282,97,11,11,12,2749,2749,2738,2738
Glenn,14,2022-03-21,7,7,7,0,366,366,345,21,1,0,0,0,56,56,56,56
Humboldt,14,2022-03-21,31,31,29,2,2456,2456,2322,134,5,1,1,2,145,145,144,144
Imperial,14,2022-03-21,58,58,54,4,3952,3952,3714,238,4,3,3,4,943,943,940,940
Inyo,14,2022-03-21,1,1,1,0,148,148,140,8,0,0,0,0,56,56,56,56
Kern,14,2022-03-21,206,206,196,10,19492,19492,18527,965,34,4,4,9,2336,2336,2332,2332
Kings,14,2022-03-21,79,79,74,5,4413,4413,4149,264,7,1,1,1,446,446,445,445
Lake,14,2022-03-21,17,17,16,1,1365,1365,1272,93,0,0,0,0,139,139,139,139
Lassen,14,2022-03-21,10,10,10,0,1388,1388,1323,65,0,0,0,0,62,62,62,62
Los Angeles,14,2022-03-21,4131,4131,4060,71,822850,822888,808515,14373,338,76,76,66,31693,31693,31617,31617
Madera,14,2022-03-21,40,40,37,3,3397,3397,3169,228,9,1,1,1,371,371,370,370
Marin,14,2022-03-21,133,133,124,9,6231,6231,5825,406,6,1,1,0,239,239,238,238
Mariposa,14,2022-03-21,7,7,6,1,238,238,221,17,0,0,0,0,27,27,27,27
Mendocino,14,2022-03-21,28,28,26,2,1508,1508,1376,132,4,0,0,1,123,123,123,123
Merced,14,2022-03-21,86,86,82,4,3774,3774,3579,195,13,5,5,1,815,815,810,810
Modoc,14,2022-03-21,2,2,2,0,60,60,57,3,0,0,0,0,8,8,8,8
Mono,14,2022-03-21,4,4,4,0,134,134,120,14,1,0,0,0,6,6,6,6
Monterey,14,2022-03-21,152,152,137,15,10087,10087,9063,1024,22,0,0,1,724,724,724,724
Napa,14,2022-03-21,55,55,52,3,3454,3454,3297,157,6,1,1,2,142,142,141,141
Nevada,14,2022-03-21,18,18,17,1,1528,1528,1428,100,2,0,0,0,129,129,129,129
Orange,14,2022-03-21,761,761,731,30,96141,96146,92293,3853,100,12,12,25,7074,7074,7062,7062
Placer,14,2022-03-21,112,112,104,8,6475,6475,6010,465,40,2,2,6,620,620,618,618
Plumas,14,2022-03-21,2,2,2,0,228,228,213,15,0,0,0,0,13,13,13,13
Riverside,14,2022-03-21,613,613,581,32,51897,51897,49140,2757,69,13,13,18,6438,6438,6425,6425
Sacramento,14,2022-03-21,464,464,438,26,32988,32988,31117,1871,89,13,13,13,3032,3032,3019,3019
San Benito,14,2022-03-21,19,19,18,1,1385,1385,1320,65,0,1,1,0,95,95,94,94
San Bernardino,14,2022-03-21,473,473,453,20,49320,49320,47189,2131,49,20,20,31,7780,7780,7760,7760
San Diego,14,2022-03-21,1371,1371,1346,25,84594,84599,83043,1556,146,15,15,39,5322,5322,5307,5307
San Francisco,14,2022-03-21,687,687,612,75,33568,33568,29856,3712,34,3,3,3,860,860,857,857
San Joaquin,14,2022-03-21,220,220,206,14,15671,15671,14700,971,23,6,6,6,2244,2244,2238,2238
San Luis Obispo,14,2022-03-21,107,107,102,5,6426,6426,6113,313,3,5,5,0,476,476,471,471
San Mateo,14,2022-03-21,368,368,353,15,34928,34928,33524,1404,30,1,1,1,700,700,699,699
Santa Barbara,14,2022-03-21,161,161,152,9,14301,14301,13512,789,17,5,5,4,686,686,681,681
Santa Clara,14,2022-03-21,1099,1099,1078,21,95233,95238,93372,1866,101,5,5,20,2292,2292,2287,2287
Santa Cruz,14,2022-03-21,184,184,175,9,20037,20037,19102,935,8,0,0,3,259,259,259,259
Shasta,14,2022-03-21,41,41,39,2,4136,4136,3902,234,10,6,6,2,557,557,551,551
Siskiyou,14,2022-03-21,9,9,9,0,370,370,353,17,1,0,0,0,83,83,83,83
Solano,14,2022-03-21,187,187,177,10,11750,11750,11125,625,17,1,1,5,448,448,447,447
Sonoma,14,2022-03-21,230,230,218,12,12379,12379,11727,652,15,2,2,2,489,489,487,487
Stanislaus,14,2022-03-21,142,142,131,11,8430,8430,7754,676,59,12,12,8,1685,1685,1673,1673
Sutter,14,2022-03-21,34,34,32,2,1478,1478,1398,80,0,1,1,0,223,223,222,222
Tehama,14,2022-03-21,10,10,9,1,926,926,854,72,2,0,0,0,205,205,205,205
Trinity,14,2022-03-21,0,0,0,0,111,111,102,9,0,0,0,0,20,20,20,20
Tulare,14,2022-03-21,108,108,99,9,8170,8170,7503,667,27,5,5,4,1484,1484,1479,1479
Tuolumne,14,2022-03-21,19,19,18,1,1133,1133,1057,76,2,0,0,0,181,181,181,181
Ventura,14,2022-03-21,286,286,276,10,23283,23283,22423,860,30,5,5,6,1489,1489,1484,1484
Yolo,14,2022-03-21,106,106,101,5,21432,21432,20394,1038,1,0,0,1,358,358,358,358
Yuba,14,2022-03-21,42,42,40,2,1318,1318,1251,67,8,0,0,2,124,124,124,124
Alameda,15,2022-03-28,928,928,897,31,59266,59270,57271,1999,35,4,4,5,1848,1848,1844,1844
Amador,15,2022-03-28,8,8,8,0,1376,1376,1301,75,3,0,0,0,86,86,86,86
Butte,15,2022-03-28,64,64,62,2,2853,2853,2775,78,11,0,0,1,427,427,427,427
Calaveras,15,2022-03-28,15,15,14,1,580,580,553,27,0,0,0,0,119,119,119,119
Colusa,15,2022-03-28,4,4,4,0,207,207,199,8,0,0,0,0,21,21,21,21
Contra Costa,15,2022-03-28,533,533,504,29,24910,24910,23529,1381,29,1,1,6,1300,1300,1299,1299
Del Norte,15,2022-03-28,16,16,15,1,1038,1038,993,45,1,0,0,0,49,49,49,49
El Dorado,15,2022-03-28,60,60,57,3,2810,2810,2679,131,0,0,0,0,214,214,214,214
Fresno,15,2022-03-28,275,275,261,14,17893,17893,16954,939,71,5,5,18,2754,2754,2749,2749
Glenn,15,2022-03-28,8,8,8,0,333,333,318,15,0,0,0,0,56,56,56,56
Humboldt,15,2022-03-28,27,27,26,1,2608,2608,2495,113,4,0,0,3,145,145,145,145
Imperial,15,2022-03-28,62,62,59,3,3529,3529,3361,168,4,1,1,3,944,944,943,943
Inyo,15,2022-03-28,4,4,4,0,186,186,178,8,1,0,0,0,56,56,56,56
Kern,15,2022-03-28,144,144,138,6,18181,18181,17471,710,17,4,4,8,2340,2340,2336,2336
Kings,15,2022-03-28,57,57,54,3,4276,4276,4074,202,6,2,2,0,448,448,446,446
Lake,15,2022-03-28,10,10,9,1,1068,1068,1010,58,0,0,0,0,139,139,139,139
Lassen,15,2022-03-28,4,4,4,0,1284,1284,1236,48,0,0,0,0,62,62,62,62
Los Angeles,15,2022-03-28,4475,4475,4414,61,703835,703873,694146,9727,264,53,53,57,31746,31746,31693,31693
Madera,15,2022-03-28,24,24,23,1,3460,3460,3277,183,4,0,0,2,371,371,371,371
Marin,15,2022-03-28,181,181,172,9,6000,6000,5692,308,3,0,0,0,239,239,239,239
Mariposa,15,2022-03-28,5,5,5,0,181,181,171,10,0,1,1,0,28,28,27,27
Mendocino,15,2022-03-28,31,31,29,2,1314,1314,1223,91,0,1,1,0,124,124,123,123
Merced,15,2022-03-28,64,64,61,3,3363,3363,3227,136,5,1,1,3,816,816,815,815
Modoc,15,2022-03-28,3,3,3,0,45,45,43,2,0,0,0,0,8,8,8,8
Mono,15,2022-03-28,1,1,1,0,134,134,123,11,0,0,0,0,6,6,6,6
Monterey,15,2022-03-28,148,148,136,12,8782,8782,8069,713,14,1,1,0,725,725,724,724
Napa,15,2022-03-28,70,70,68,2,3335,3335,3216,119,1,2,2,1,144,144,142,142
Nevada,15,2022-03-28,27,27,26,1,1431,1431,1357,74,1,1,1,0,130,130,129,129
Orange,15,2022-03-28,815,815,790,25,90220,90225,87388,2837,81,12,12,17,7086,7086,7074,7074
Placer,15,2022-03-28,108,108,102,6,6223,6223,5871,352,26,4,4,6,624,624,620,620
Plumas,15,2022-03-28,3,3,3,0,267,267,253,14,0,0,0,0,13,13,13,13
Riverside,15,2022-03-28,522,522,500,22,43927,43927,42096,1831,47,7,7,10,6445,6445,6438,6438
Sacramento,15,2022-03-28,454,454,434,20,32474,32474,31024,1450,68,6,6,19,3038,3038,3032,3032
San Benito,15,2022-03-28,14,14,13,1,1365,1365,1315,50,0,0,0,0,95,95,95,95
San Bernardino,15,2022-03-28,545,545,527,18,41309,41309,39912,1397,40,18,18,24,7798,7798,7780,7780
San Diego,15,2022-03-28,1327,1327,1308,19,72132,72137,71102,1035,114,9,9,26,5331,5331,5322,5322
San Francisco,15,2022-03-28,844,844,770,74,32805,32805,29910,2895,23,5,5,5,865,865,860,860
San Joaquin,15,2022-03-28,189,189,180,9,17488,17488,16634,854,20,4,4,4,2248,2248,2244,2244
San Luis Obispo,15,2022-03-28,96,96,92,4,5710,5710,5492,218,5,1,1,1,477,477,476,476
San Mateo,15,2022-03-28,582,582,564,18,33959,33959,32884,1075,26,5,5,3,705,705,700,700
Santa Barbara,15,2022-03-28,135,135,129,6,10226,10226,9795,431,15,1,1,4,687,687,686,686
Santa Clara,15,2022-03-28,1276,1276,1257,19,95196,95201,93749,1452,88,11,11,18,2303,2303,2292,2292
Santa Cruz,15,2022-03-28,145,145,140,5,19692,19692,18975,717,3,0,0,2,259,259,259,259
Shasta,15,2022-03-28,34,34,32,2,3879,3879,3706,173,7,2,2,3,559,559,557,557
Siskiyou,15,2022-03-28,5,5,5,0,292,292,282,10,0,0,0,0,83,83,83,83
Solano,15,2022-03-28,169,169,162,7,10932,10932,10475,457,18,0,0,6,448,448,448,448
Sonoma,15,2022-03-28,259,259,249,10,8553,8553,8206,347,13,0,0,1,489,489,489,489
Stanislaus,15,2022-03-28,118,118,110,8,8187,8187,7668,519,28,2,2,3,1687,1687,1685,1685
Sutter,15,2022-03-28,25,25,24,1,1490,1490,1426,64,0,1,1,0,224,224,223,223
Tehama,15,2022-03-28,13,13,12,1,798,798,749,49,3,1,1,0,206,206,205,205
Trinity,15,2022-03-28,0,0,0,0,79,79,74,5,0,0,0,0,20,20,20,20
Tulare,15,2022-03-28,81,81,76,5,7844,7844,7336,508,20,6,6,1,1490,1490,1484,1484
Tuolumne,15,2022-03-28,7,7,7,0,1085,1085,1028,57,3,1,1,0,182,182,181,181
Ventura,15,2022-03-28,335,335,325,10,21204,21204,20590,614,23,6,6,3,1495,1495,1489,1489
Yolo,15,2022-03-28,103,103,99,4,20514,20514,19751,763,3,2,2,0,360,360,358,358
Yuba,15,2022-03-28,26,26,25,1,1214,1214,1165,49,2,2,2,1,126,126,124,124
Alameda,16,2022-04-04,1057,1057,1030,27,56225,56230,54736,1494,40,3,3,3,1851,1851,1848,1848
Amador,16,2022-04-04,2,2,2,0,1107,1107,1060,47,1,0,0,0,86,86,86,86
Butte,16,2022-04-04,44,44,43,1,2582,2582,2526,56,8,2,2,1,429,429,427,427
Calaveras,16,2022-04-04,8,8,8,0,589,589,567,22,0,0,0,0,119,119,119,119
Colusa,16,2022-04-04,2,2,2,0,202,202,196,6,0,0,0,0,21,21,21,21
Contra Costa,16,2022-04-04,543,543,520,23,23558,23558,22523,1035,13,1,1,4,1301,1301,1300,1300
Del Norte,16,2022-04-04,8,8,8,0,1118,1118,1080,38,0,0,0,1,49,49,49,49
El Dorado,16,2022-04-04,50,50,48,2,2717,2717,2617,100,0,1,1,1,215,215,214,214
Fresno,16,2022-04-04,188,188,180,8,16789,16789,16096,693,62,4,4,12,2758,2758,2754,2754
Glenn,16,2022-04-04,3,3,3,0,287,287,277,10,0,0,0,0,56,56,56,56
Humboldt,16,2022-04-04,23,23,22,1,2385,2385,2303,82,5,0,0,2,145,145,145,145
Imperial,16,2022-04-04,39,39,37,2,3437,3437,3308,129,3,0,0,2,944,944,944,944
Inyo,16,2022-04-04,9,9,9,0,182,182,176,6,0,0,0,0,56,56,56,56
Kern,16,2022-04-04,152,152,147,5,16756,16756,16241,515,16,2,2,7,2342,2342,2340,2340
Kings,16,2022-04-04,47,47,45,2,4182,4182,4026,156,2,0,0,1,448,448,448,448
Lake,16,2022-04-04,14,14,13,1,973,973,931,42,0,0,0,0,139,139,139,139
Lassen,16,2022-04-04,5,5,5,0,1284,1284,1247,37,0,0,0,0,62,62,62,62
Los Angeles,16,2022-04-04,5460,5460,5403,57,803355,803411,794802,8609,255,47,47,42,31793,31793,31746,31746
Madera,16,2022-04-04,27,27,26,1,3199,3199,3065,134,3,0,0,1,371,371,371,371
Marin,16,2022-04-04,167,167,160,7,6347,6347,6089,258,3,0,0,1,239,239,239,239
Mariposa,16,2022-04-04,7,7,7,0,237,237,227,10,0,0,0,0,28,28,28,28
Mendocino,16,2022-04-04,25,25,24,1,1196,1196,1130,66,2,0,0,0,124,124,124,124
Merced,16,2022-04-04,58,58,56,2,3353,3353,3246,107,2,2,2,0,818,818,816,816
Modoc,16,2022-04-04,4,4,4,0,43,43,42,1,0,0,0,0,8,8,8,8
Mono,16,2022-04-04,1,1,1,0,142,142,133,9,0,0,0,0,6,6,6,6
Monterey,16,2022-04-04,128,128,120,8,7491,7491,7011,480,8,3,3,0,728,728,725,725
Napa,16,2022-04-04,76,76,74,2,3150,3150,3061,89,1,0,0,1,144,144,144,144
Nevada,16,2022-04-04,30,30,29,1,1447,1447,1388,59,1,1,1,0,131,131,130,130
Orange,16,2022-04-04,995,995,971,24,81538,81543,79511,2032,56,17,17,14,7103,7103,7086,7086
Placer,16,2022-04-04,128,128,122,6,6692,6692,6393,299,19,1,1,5,625,625,624,624
Plumas,16,2022-04-04,4,4,4,0,235,235,225,10,0,0,0,0,13,13,13,13
Riverside,16,2022-04-04,693,693,671,22,38909,38911,37638,1273,36,5,5,8,6450,6450,6445,6445
Sacramento,16,2022-04-04,432,432,417,15,32908,32909,31753,1156,50,8,8,11,3046,3046,3038,3038
San Benito,16,2022-04-04,13,13,13,0,1187,1187,1153,34,0,0,0,0,95,95,95,95
San Bernardino,16,2022-04-04,613,613,597,16,42056,42060,40942,1118,32,11,11,13,7809,7809,7798,7798
San Diego,16,2022-04-04,1543,1543,1526,17,66686,66691,65947,744,88,7,7,29,5338,5338,5331,5331
San Francisco,16,2022-04-04,1002,1002,933,69,28771,28771,26761,2010,20,1,1,3,866,866,865,865
San Joaquin,16,2022-04-04,227,227,218,9,15699,15699,15095,604,9,2,2,8,2250,2250,2248,2248
San Luis Obispo,16,2022-04-04,99,99,96,3,5388,5388,5226,162,2,1,1,1,478,478,477,477
San Mateo,16,2022-04-04,724,724,706,18,29370,29370,28644,726,14,3,3,1,708,708,705,705
Santa Barbara,16,2022-04-04,187,187,181,6,15280,15280,14763,517,7,2,2,1,689,689,687,687
Santa Clara,16,2022-04-04,1493,1493,1475,18,88302,88307,87248,1059,89,3,3,18,2306,2306,2303,2303
Santa Cruz,16,2022-04-04,210,210,204,6,16701,16701,16211,490,4,0,0,2,259,259,259,259
Shasta,16,2022-04-04,29,29,28,1,3320,3320,3203,117,4,2,2,2,561,561,559,559
Siskiyou,16,2022-04-04,2,2,2,0,294,294,286,8,0,0,0,0,83,83,83,83
Solano,16,2022-04-04,173,173,167,6,10221,10221,9885,336,21,1,1,4,449,449,448,448
Sonoma,16,2022-04-04,330,330,320,10,10653,10653,10309,344,9,1,1,1,490,490,489,489
Stanislaus,16,2022-04-04,113,113,107,6,7964,7964,7566,398,21,3,3,5,1690,1690,1687,1687
Sutter,16,2022-04-04,24,24,23,1,1324,1324,1280,44,0,0,0,0,224,224,224,224
Tehama,16,2022-04-04,6,6,6,0,765,765,728,37,0,1,1,0,207,207,206,206
Trinity,16,2022-04-04,1,1,1,0,87,87,83,4,0,0,0,0,20,20,20,20
Tulare,16,2022-04-04,48,48,46,2,7745,7745,7349,396,13,3,3,0,1493,1493,1490,1490
Tuolumne,16,2022-04-04,10,10,10,0,1037,1037,994,43,1,1,1,0,183,183,182,182
Ventura,16,2022-04-04,296,296,289,7,20331,20331,19867,464,19,5,5,5,1500,1500,1495,1495
Yolo,16,2022-04-04,104,104,101,3,26252,26252,25466,786,0,0,0,0,360,360,360,360
Yuba,16,2022-04-04,11,11,11,0,1071,1071,1037,34,4,0,0,1,126,126,126,126
Alameda,17,2022-04-11,1493,1493,1463,30,49842,49847,48818,1029,51,5,5,2,1856,1856,1851,1851
Amador,17,2022-04-11,9,9,9,0,1068,1068,1032,36,1,0,0,0,86,86,86,86
Butte,17,2022-04-11,33,33,32,1,2262,2262,2224,38,3,0,0,1,429,429,429,429
Calaveras,17,2022-04-11,14,14,14,0,651,651,632,19,0,0,0,0,119,119,119,119
Colusa,17,2022-04-11,6,6,6,0,203,203,198,5,0,0,0,0,21,21,21,21
Contra Costa,17,2022-04-11,714,714,690,24,20841,20841,20131,710,15,1,1,5,1302,1302,1301,1301
Del Norte,17,2022-04-11,9,9,9,0,1012,1012,985,27,0,0,0,0,49,49,49,49
El Dorado,17,2022-04-11,48,48,47,1,2508,2508,2436,72,1,0,0,0,215,215,215,215
Fresno,17,2022-04-11,196,196,190,6,15720,15720,15208,512,54,3,3,6,2761,2761,2758,2758
Glenn,17,2022-04-11,2,2,2,0,258,258,251,7,0,0,0,0,56,56,56,56
Humboldt,17,2022-04-11,46,46,45,1,2347,2347,2284,63,5,1,1,2,146,146,145,145
Imperial,17,2022-04-11,28,28,27,1,3439,3439,3338,101,2,1,1,1,945,945,944,944
Inyo,17,2022-04-11,4,4,4,0,188,188,183,5,0,0,0,0,56,56,56,56
Kern,17,2022-04-11,135,135,132,3,16370,16370,15972,398,20,2,2,6,2344,2344,2342,2342
Kings,17,2022-04-11,31,31,30,1,4164,4164,4042,122,3,0,0,0,448,448,448,448
Lake,17,2022-04-11,22,22,21,1,870,870,841,29,0,0,0,0,139,139,139,139
Lassen,17,2022-04-11,1,1,1,0,1292,1292,1263,29,1,0,0,0,62,62,62,62
Los Angeles,17,2022-04-11,6737,6737,6682,55,675665,675718,670012,5706,234,46,46,36,31839,31839,31793,31793
Madera,17,2022-04-11,29,29,28,1,3088,3088,2987,101,4,0,0,2,371,371,371,371
Marin,17,2022-04-11,214,214,207,7,5555,5555,5379,176,6,0,0,1,239,239,239,239
Mariposa,17,2022-04-11,7,7,7,0,248,248,239,9,0,0,0,0,28,28,28,28
Mendocino,17,2022-04-11,32,32,31,1,1158,1158,1108,50,0,0,0,0,124,124,124,124
Merced,17,2022-04-11,68,68,66,2,3225,3225,3144,81,6,2,2,0,820,820,818,818
Modoc,17,2022-04-11,0,0,0,0,40,40,39,1,0,0,0,0,8,8,8,8
Mono,17,2022-04-11,9,9,9,0,170,170,161,9,0,0,0,0,6,6,6,6
Monterey,17,2022-04-11,107,107,102,5,6890,6890,6540,350,9,2,2,0,730,730,728,728
Napa,17,2022-04-11,120,120,117,3,2805,2805,2743,62,1,0,0,0,144,144,144,144
Nevada,17,2022-04-11,45,45,44,1,1431,1431,1385,46,2,0,0,0,131,131,131,131
Orange,17,2022-04-11,1169,1169,1147,22,62014,62019,60840,1179,70,9,9,16,7112,7112,7103,7103
Placer,17,2022-04-11,126,126,122,4,5632,5632,5433,199,18,2,2,2,627,627,625,625
Plumas,17,2022-04-11,7,7,7,0,247,247,239,8,0,0,0,0,13,13,13,13
Riverside,17,2022-04-11,728,728,710,18,37779,37781,36811,970,35,5,5,9,6455,6455,6450,6450
Sacramento,17,2022-04-11,509,509,495,14,30144,30145,29312,833,47,11,11,5,3057,3057,3046,3046
San Benito,17,2022-04-11,16,16,16,0,1182,1182,1155,27,0,0,0,0,95,95,95,95
San Bernardino,17,2022-04-11,917,917,898,19,42013,42018,41142,876,33,5,5,7,7814,7814,7809,7809
San Diego,17,2022-04-11,1833,1833,1817,16,74105,74110,73462,648,91,4,4,22,5342,5342,5338,5338
San Francisco,17,2022-04-11,1180,1180,1115,65,29898,29898,28242,1656,19,6,6,4,872,872,866,866
San Joaquin,17,2022-04-11,221,221,214,7,15224,15224,14763,461,10,0,0,1,2250,2250,2250,2250
San Luis Obispo,17,2022-04-11,120,120,117,3,4912,4912,4796,116,2,1,1,0,479,479,478,478
San Mateo,17,2022-04-11,859,859,843,16,30382,30382,29791,591,8,2,2,1,710,710,708,708
Santa Barbara,17,2022-04-11,302,302,294,8,15122,15122,14720,402,6,2,2,1,691,691,689,689
Santa Clara,17,2022-04-11,1661,1661,1646,15,81519,81524,80764,760,61,4,4,13,2310,2310,2306,2306
Santa Cruz,17,2022-04-11,327,327,320,7,10999,10999,10758,241,7,1,1,0,260,260,259,259
Shasta,17,2022-04-11,18,18,18,0,3123,3123,3036,87,2,1,1,1,562,562,561,561
Siskiyou,17,2022-04-11,1,1,1,0,340,340,332,8,0,0,0,0,83,83,83,83
Solano,17,2022-04-11,249,249,243,6,9420,9420,9177,243,16,0,0,1,449,449,449,449
Sonoma,17,2022-04-11,416,416,406,10,10686,10686,10416,270,8,1,1,0,491,491,490,490
Stanislaus,17,2022-04-11,124,124,119,5,7644,7644,7343,301,22,1,1,1,1691,1691,1690,1690
Sutter,17,2022-04-11,20,20,19,1,1237,1237,1204,33,0,1,1,0,225,225,224,224
Tehama,17,2022-04-11,9,9,9,0,753,753,724,29,1,0,0,0,207,207,207,207
Trinity,17,2022-04-11,0,0,0,0,77,77,74,3,0,0,0,0,20,20,20,20
Tulare,17,2022-04-11,58,58,56,2,7847,7847,7530,317,11,3,3,0,1496,1496,1493,1493
Tuolumne,17,2022-04-11,22,22,21,1,1065,1065,1030,35,1,0,0,0,183,183,183,183
Ventura,17,2022-04-11,323,323,317,6,17587,17587,17274,313,16,2,2,2,1502,1502,1500,1500
Yolo,17,2022-04-11,130,130,127,3,18074,18074,17654,420,1,0,0,0,360,360,360,360
Yuba,17,2022-04-11,15,15,15,0,1019,1019,994,25,2,0,0,0,126,126,126,126
Alameda,18,2022-04-18,1781,1781,1752,29,54178,54183,53301,882,42,4,4,4,1860,1860,1856,1856
Amador,18,2022-04-18,12,12,12,0,1194,1194,1162,32,2,0,0,0,86,86,86,86
Butte,18,2022-04-18,47,47,46,1,2267,2267,2237,30,5,2,2,0,431,431,429,429
Calaveras,18,2022-04-18,16,16,16,0,580,580,567,13,0,1,1,0,120,120,119,119
Colusa,18,2022-04-18,3,3,3,0,157,157,154,3,0,0,0,0,21,21,21,21
Contra Costa,18,2022-04-18,1051,1051,1023,28,24756,24756,24087,669,26,1,1,5,1303,1303,1302,1302
Del Norte,18,2022-04-18,13,13,13,0,1010,1010,989,21,0,0,0,0,49,49,49,49
El Dorado,18,2022-04-18,66,66,65,1,2455,2455,2400,55,0,0,0,0,215,215,215,215
Fresno,18,2022-04-18,247,247,241,6,13865,13865,13514,351,42,4,4,5,2765,2765,2761,2761
Glenn,18,2022-04-18,4,4,4,0,278,278,272,6,0,0,0,0,56,56,56,56
Humboldt,18,2022-04-18,106,106,104,2,2052,2052,2009,43,4,1,1,2,147,147,146,146
Imperial,18,2022-04-18,49,49,48,1,3207,3207,3133,74,2,0,0,1,945,945,945,945
Inyo,18,2022-04-18,2,2,2,0,164,164,161,3,0,0,0,0,56,56,56,56
Kern,18,2022-04-18,150,150,147,3,13638,13638,13381,257,9,1,1,5,2345,2345,2344,2344
Kings,18,2022-04-18,44,44,43,1,3587,3587,3505,82,3,1,1,1,449,449,448,448
Lake,18,2022-04-18,16,16,16,0,782,782,762,20,2,1,1,1,140,140,139,139
Lassen,18,2022-04-18,1,1,1,0,1340,1340,1316,24,0,0,0,0,62,62,62,62
Los Angeles,18,2022-04-18,8319,8319,8266,53,469203,469244,466272,2972,200,37,37,26,31876,31876,31839,31839
Madera,18,2022-04-18,23,23,22,1,2531,2531,2466,65,2,0,0,2,371,371,371,371
Marin,18,2022-04-18,322,322,314,8,5992,5992,5842,150,6,0,0,0,239,239,239,239
Mariposa,18,2022-04-18,18,18,18,0,250,250,243,7,0,0,0,0,28,28,28,28
Mendocino,18,2022-04-18,53,53,51,2,1285,1285,1241,44,0,1,1,0,125,125,124,124
Merced,18,2022-04-18,64,64,63,1,3051,3051,2991,60,3,2,2,0,822,822,820,820
Modoc,18,2022-04-18,1,1,1,0,40,40,39,1,0,0,0,0,8,8,8,8
Mono,18,2022-04-18,9,9,9,0,122,122,117,5,0,0,0,0,6,6,6,6
Monterey,18,2022-04-18,157,157,151,6,6522,6522,6263,259,2,1,1,0,731,731,730,730
Napa,18,2022-04-18,164,164,161,3,2869,2869,2820,49,1,0,0,0,144,144,144,144
Nevada,18,2022-04-18,41,41,40,1,1260,1260,1228,32,1,0,0,0,131,131,131,131
Orange,18,2022-04-18,1449,1449,1427,22,79777,79783,78575,1208,50,6,6,10,7118,7118,7112,7112
Placer,18,2022-04-18,161,161,157,4,4800,4800,4668,132,30,0,0,3,627,627,627,627
Plumas,18,2022-04-18,6,6,6,0,225,225,219,6,0,0,0,0,13,13,13,13
Riverside,18,2022-04-18,937,937,918,19,36724,36728,35988,740,36,7,7,7,6462,6462,6455,6455
Sacramento,18,2022-04-18,716,716,701,15,27856,27857,27256,601,47,9,9,8,3066,3066,3057,3057
San Benito,18,2022-04-18,24,24,24,0,1170,1170,1149,21,0,0,0,0,95,95,95,95
San Bernardino,18,2022-04-18,1058,1058,1041,17,40086,40090,39436,654,35,7,7,8,7821,7821,7814,7814
San Diego,18,2022-04-18,2047,2047,2033,14,67090,67095,66637,458,78,9,9,17,5351,5351,5342,5342
San Francisco,18,2022-04-18,1440,1440,1378,62,30566,30567,29230,1337,27,2,2,2,874,874,872,872
San Joaquin,18,2022-04-18,249,249,243,6,14731,14731,14381,350,8,1,1,4,2251,2251,2250,2250
San Luis Obispo,18,2022-04-18,180,180,177,3,4960,4960,4868,92,2,2,2,0,481,481,479,479
San Mateo,18,2022-04-18,1154,1154,1137,17,30636,30638,30174,464,15,2,2,2,712,712,710,710
Santa Barbara,18,2022-04-18,300,300,294,6,14690,14690,14384,306,8,0,0,0,691,691,691,691
Santa Clara,18,2022-04-18,2238,2238,2222,16,71272,71277,70756,521,67,4,4,16,2314,2314,2310,2310
Santa Cruz,18,2022-04-18,438,438,430,8,12234,12234,12019,215,3,0,0,1,260,260,260,260
Shasta,18,2022-04-18,32,32,31,1,2849,2849,2787,62,2,1,1,2,563,563,562,562
Siskiyou,18,2022-04-18,8,8,8,0,318,318,312,6,0,0,0,0,83,83,83,83
Solano,18,2022-04-18,254,254,249,5,9328,9328,9139,189,6,1,1,1,450,450,449,449
Sonoma,18,2022-04-18,502,502,492,10,11184,11184,10961,223,16,1,1,4,492,492,491,491
Stanislaus,18,2022-04-18,162,162,157,5,7668,7668,7429,239,15,0,0,3,1691,1691,1691,1691
Sutter,18,2022-04-18,24,24,24,0,1173,1173,1149,24,0,0,0,0,225,225,225,225
Tehama,18,2022-04-18,7,7,7,0,685,685,664,21,1,0,0,0,207,207,207,207
Trinity,18,2022-04-18,1,1,1,0,72,72,70,2,0,0,0,0,20,20,20,20
Tulare,18,2022-04-18,79,79,77,2,6665,6665,6454,211,13,0,0,0,1496,1496,1496,1496
Tuolumne,18,2022-04-18,26,26,25,1,1026,1026,1000,26,1,0,0,0,183,183,183,183
Ventura,18,2022-04-18,367,367,362,5,16412,16412,16185,227,8,3,3,0,1505,1505,1502,1502
Yolo,18,2022-04-18,217,217,213,4,17915,17915,17586,329,2,1,1,0,361,361,360,360
Yuba,18,2022-04-18,27,27,26,1,996,996,977,19,1,0,0,1,126,126,126,126
Alameda,19,2022-04-25,2539,2539,2507,32,60892,60898,60131,767,44,6,6,4,1866,1866,1860,1860
Amador,19,2022-04-25,26,26,25,1,1317,1317,1290,27,0,0,0,0,86,86,86,86
Butte,19,2022-04-25,66,66,65,1,2596,2596,2569,27,5,1,1,1,432,432,431,431
Calaveras,19,2022-04-25,34,34,33,1,688,688,676,12,0,0,0,0,120,120,120,120
Colusa,19,2022-04-25,3,3,3,0,199,199,196,3,0,0,0,0,21,21,21,21
Contra Costa,19,2022-04-25,1509,1509,1477,32,27267,27269,26695,574,25,3,3,3,1306,1306,1303,1303
Del Norte,19,2022-04-25,25,25,25,0,1104,1104,1086,18,0,0,0,0,49,49,49,49
El Dorado,19,2022-04-25,103,103,101,2,2648,2648,2601,47,1,0,0,0,215,215,215,215
Fresno,19,2022-04-25,336,336,329,7,15806,15806,15491,315,34,3,3,2,2768,2768,2765,2765
Glenn,19,2022-04-25,4,4,4,0,287,287,282,5,0,0,0,0,56,56,56,56
Humboldt,19,2022-04-25,168,168,165,3,2853,2853,2806,47,2,0,0,2,147,147,147,147
Imperial,19,2022-04-25,65,65,64,1,3505,3505,3442,63,4,0,0,1,945,945,945,945
Inyo,19,2022-04-25,7,7,7,0,194,194,191,3,0,0,0,0,56,56,56,56
Kern,19,2022-04-25,251,251,247,4,18305,18305,18034,271,14,2,2,4,2347,2347,2345,2345
Kings,19,2022-04-25,54,54,53,1,4525,4525,4444,81,3,0,0,1,449,449,449,449
Lake,19,2022-04-25,21,21,21,0,888,888,870,18,0,0,0,0,140,140,140,140
Lassen,19,2022-04-25,1,1,1,0,1556,1556,1534,22,0,0,0,0,62,62,62,62
Los Angeles,19,2022-04-25,11371,11371,11314,57,884902,884993,880508,4485,207,30,30,25,31906,31906,31876,31876
Madera,19,2022-04-25,44,44,43,1,2925,2925,2866,59,2,0,0,0,371,371,371,371
Marin,19,2022-04-25,329,329,323,6,6440,6440,6314,126,7,0,0,0,239,239,239,239
Mariposa,19,2022-04-25,9,9,9,0,207,207,203,4,0,0,0,0,28,28,28,28
Mendocino,19,2022-04-25,55,55,54,1,1254,1254,1220,34,0,1,1,0,126,126,125,125
Merced,19,2022-04-25,99,99,98,1,3034,3034,2988,46,5,0,0,0,822,822,822,822
Modoc,19,2022-04-25,1,1,1,0,41,41,40,1,0,0,0,0,8,8,8,8
Mono,19,2022-04-25,4,4,4,0,94,94,91,3,0,0,0,0,6,6,6,6
Monterey,19,2022-04-25,323,323,313,10,8008,8008,7758,250,5,1,1,0,732,732,731,731
Napa,19,2022-04-25,208,208,205,3,3391,3391,3345,46,2,0,0,0,144,144,144,144
Nevada,19,2022-04-25,52,52,51,1,1399,1399,1371,28,1,0,0,1,131,131,131,131
Orange,19,2022-04-25,1983,1983,1960,23,86636,86645,85622,1023,53,7,7,13,7125,7125,7118,7118
Placer,19,2022-04-25,239,239,234,5,6091,6091,5959,132,18,0,0,4,627,627,627,627
Plumas,19,2022-04-25,2,2,2,0,228,228,223,5,0,0,0,0,13,13,13,13
Riverside,19,2022-04-25,1304,1304,1284,20,40563,40568,39928,640,33,4,4,5,6466,6466,6462,6462
Sacramento,19,2022-04-25,1026,1026,1009,17,31873,31877,31338,539,44,4,4,4,3070,3070,3066,3066
San Benito,19,2022-04-25,34,34,34,0,1118,1118,1102,16,0,0,0,0,95,95,95,95
San Bernardino,19,2022-04-25,1293,1293,1277,16,42981,42986,42438,548,21,10,10,7,7831,7831,7821,7821
San Diego,19,2022-04-25,3013,3013,2997,16,74327,74334,73938,396,86,5,5,10,5356,5356,5351,5351
San Francisco,19,2022-04-25,2001,2001,1933,68,32544,32549,31432,1117,23,1,1,3,875,875,874,874
San Joaquin,19,2022-04-25,389,389,382,7,15463,15463,15174,289,12,0,0,1,2251,2251,2251,2251
San Luis Obispo,19,2022-04-25,209,209,206,3,5037,5037,4964,73,6,0,0,0,481,481,481,481
San Mateo,19,2022-04-25,1541,1541,1523,18,32933,32936,32547,389,14,1,1,3,713,713,712,712
Santa Barbara,19,2022-04-25,370,370,364,6,15230,15230,14983,247,7,2,2,1,693,693,691,691
Santa Clara,19,2022-04-25,3142,3142,3124,18,77136,77142,76708,434,73,4,4,9,2318,2318,2314,2314
Santa Cruz,19,2022-04-25,474,474,468,6,20467,20468,20186,282,4,1,1,0,261,261,260,260
Shasta,19,2022-04-25,49,49,48,1,3318,3318,3262,56,3,0,0,1,563,563,563,563
Siskiyou,19,2022-04-25,7,7,7,0,322,322,318,4,0,0,0,0,83,83,83,83
Solano,19,2022-04-25,479,479,471,8,10651,10651,10483,168,11,0,0,2,450,450,450,450
Sonoma,19,2022-04-25,673,673,663,10,12066,12066,11878,188,19,0,0,2,492,492,492,492
Stanislaus,19,2022-04-25,241,241,235,6,7902,7902,7710,192,25,4,4,0,1695,1695,1691,1691
Sutter,19,2022-04-25,38,38,37,1,1399,1399,1376,23,0,1,1,0,226,226,225,225
Tehama,19,2022-04-25,17,17,17,0,711,711,694,17,1,0,0,0,207,207,207,207
Trinity,19,2022-04-25,1,1,1,0,72,72,70,2,0,0,0,0,20,20,20,20
Tulare,19,2022-04-25,100,100,98,2,6934,6934,6762,172,11,1,1,0,1497,1497,1496,1496
Tuolumne,19,2022-04-25,43,43,42,1,1126,1126,1103,23,2,0,0,0,183,183,183,183
Ventura,19,2022-04-25,604,604,597,7,18901,18901,18696,205,10,1,1,3,1506,1506,1505,1505
Yolo,19,2022-04-25,272,272,268,4,19383,19383,19105,278,1,0,0,0,361,361,361,361
Yuba,19,2022-04-25,31,31,31,0,1106,1106,1089,17,0,0,0,0,126,126,126,126
Alameda,20,2022-05-02,3379,3379,3346,33,68021,68027,67350,677,42,1,1,5,1867,1867,1866,1866
Amador,20,2022-05-02,19,19,19,0,1337,1337,1315,22,0,0,0,0,86,86,86,86
Butte,20,2022-05-02,91,91,90,1,2385,2385,2366,19,4,2,2,0,434,434,432,432
Calaveras,20,2022-05-02,23,23,23,0,727,727,717,10,0,0,0,0,120,120,120,120
Colusa,20,2022-05-02,2,2,2,0,203,203,201,2,0,0,0,0,21,21,21,21
Contra Costa,20,2022-05-02,1876,1876,1845,31,29267,29272,28789,483,40,2,2,5,1308,1308,1306,1306
Del Norte,20,2022-05-02,42,42,41,1,1202,1202,1187,15,1,0,0,0,49,49,49,49
El Dorado,20,2022-05-02,140,140,138,2,2756,2756,2718,38,1,1,1,0,216,216,215,215
Fresno,20,2022-05-02,503,503,495,8,16616,16616,16357,259,42,3,3,4,2771,2771,2768,2768
Glenn,20,2022-05-02,4,4,4,0,252,252,249,3,0,0,0,0,56,56,56,56
Humboldt,20,2022-05-02,268,268,265,3,2941,2941,2903,38,6,0,0,2,147,147,147,147
Imperial,20,2022-05-02,123,123,121,2,3631,3631,3580,51,1,0,0,1,945,945,945,945
Inyo,20,2022-05-02,2,2,2,0,179,179,177,2,0,0,0,0,56,56,56,56
Kern,20,2022-05-02,294,294,291,3,17933,17934,17727,207,10,0,0,5,2347,2347,2347,2347
Kings,20,2022-05-02,59,59,58,1,4855,4855,4787,68,3,0,0,1,449,449,449,449
Lake,20,2022-05-02,28,28,28,0,1003,1003,987,16,1,0,0,0,140,140,140,140
Lassen,20,2022-05-02,8,8,8,0,1608,1608,1590,18,0,0,0,0,62,62,62,62
Los Angeles,20,2022-05-02,14813,14813,14755,58,917599,917710,914068,3642,214,24,24,22,31930,31930,31906,31906
Madera,20,2022-05-02,76,76,75,1,3317,3317,3265,52,5,0,0,0,371,371,371,371
Marin,20,2022-05-02,427,427,421,6,6544,6544,6444,100,10,0,0,0,239,239,239,239
Mariposa,20,2022-05-02,7,7,7,0,246,246,242,4,0,0,0,0,28,28,28,28
Mendocino,20,2022-05-02,60,60,59,1,1222,1222,1196,26,0,0,0,0,126,126,126,126
Merced,20,2022-05-02,131,131,129,2,3285,3285,3246,39,8,4,4,0,826,826,822,822
Modoc,20,2022-05-02,0,0,0,0,36,37,36,1,0,0,0,0,8,8,8,8
Mono,20,2022-05-02,6,6,6,0,106,106,103,3,0,0,0,0,6,6,6,6
Monterey,20,2022-05-02,355,355,346,9,8388,8388,8182,206,8,1,1,0,733,733,732,732
Napa,20,2022-05-02,229,229,227,2,3553,3553,3515,38,4,0,0,0,144,144,144,144
Nevada,20,2022-05-02,80,80,79,1,1535,1535,1511,24,2,0,0,0,131,131,131,131
Orange,20,2022-05-02,2655,2655,2631,24,87515,87525,86716,809,61,5,5,13,7130,7130,7125,7125
Placer,20,2022-05-02,306,306,301,5,6373,6373,6265,108,20,0,0,4,627,627,627,627
Plumas,20,2022-05-02,9,9,9,0,256,256,252,4,0,0,0,0,13,13,13,13
Riverside,20,2022-05-02,2051,2051,2026,25,42960,42965,42436,529,37,3,3,5,6469,6469,6466,6466
Sacramento,20,2022-05-02,1396,1396,1378,18,33658,33663,33219,444,43,5,5,9,3075,3075,3070,3070
San Benito,20,2022-05-02,50,50,49,1,1285,1285,1271,14,0,0,0,0,95,95,95,95
San Bernardino,20,2022-05-02,1490,1490,1475,15,43536,43541,43108,433,30,7,7,6,7838,7838,7831,7831
San Diego,20,2022-05-02,4122,4122,4105,17,72931,72939,72637,302,79,3,3,13,5359,5359,5356,5356
San Francisco,20,2022-05-02,2424,2424,2359,65,35539,35544,34585,959,39,3,3,13,878,878,875,875
San Joaquin,20,2022-05-02,545,545,537,8,15209,15209,14987,222,14,1,1,1,2252,2252,2251,2251
San Luis Obispo,20,2022-05-02,249,249,246,3,5109,5109,5051,58,5,2,2,0,483,483,481,481
San Mateo,20,2022-05-02,1819,1819,1802,17,35991,35996,35662,334,22,2,2,5,715,715,713,713
Santa Barbara,20,2022-05-02,440,440,435,5,15311,15311,15116,195,10,0,0,2,693,693,693,693
Santa Clara,20,2022-05-02,4358,4358,4339,19,96570,96582,96154,428,88,5,5,15,2323,2323,2318,2318
Santa Cruz,20,2022-05-02,678,678,671,7,22027,22030,21792,238,2,1,1,0,262,262,261,261
Shasta,20,2022-05-02,68,68,67,1,3451,3451,3405,46,7,0,0,1,563,563,563,563
Siskiyou,20,2022-05-02,9,9,9,0,329,329,326,3,0,0,0,0,83,83,83,83
Solano,20,2022-05-02,624,624,616,8,11785,11785,11639,146,20,0,0,2,450,450,450,450
Sonoma,20,2022-05-02,898,898,887,11,12794,12794,12639,155,16,1,1,4,493,493,492,492
Stanislaus,20,2022-05-02,270,270,265,5,8084,8084,7930,154,22,0,0,3,1695,1695,1695,1695
Sutter,20,2022-05-02,45,45,44,1,1263,1263,1247,16,0,1,1,0,227,227,226,226
Tehama,20,2022-05-02,17,17,17,0,700,700,687,13,0,0,0,0,207,207,207,207
Trinity,20,2022-05-02,1,1,1,0,84,84,82,2,0,0,0,0,20,20,20,20
Tulare,20,2022-05-02,163,163,160,3,7298,7298,7156,142,10,3,3,0,1500,1500,1497,1497
Tuolumne,20,2022-05-02,94,94,93,1,1301,1301,1281,20,5,0,0,0,183,183,183,183
Ventura,20,2022-05-02,744,744,738,6,19920,19921,19752,169,15,4,4,1,1510,1510,1506,1506
Yolo,20,2022-05-02,352,352,348,4,18790,18790,18579,211,1,1,1,0,362,362,361,361
Yuba,20,2022-05-02,46,46,45,1,1052,1052,1040,12,2,0,0,1,126,126,126,126
Alameda,21,2022-05-09,4154,4154,4122,32,71488,71498,70944,554,44,5,5,6,1872,1872,1867,1867
Amador,21,2022-05-09,25,25,25,0,1520,1520,1501,19,0,0,0,0,86,86,86,86
Butte,21,2022-05-09,116,116,115,1,2412,2412,2397,15,5,0,0,0,434,434,434,434
Calaveras,21,2022-05-09,33,33,33,0,689,689,681,8,1,0,0,0,120,120,120,120
Colusa,21,2022-05-09,3,3,3,0,215,215,213,2,0,0,0,0,21,21,21,21
Contra Costa,21,2022-05-09,2516,2516,2484,32,30525,30530,30135,395,48,4,4,12,1312,1312,1308,1308
Del Norte,21,2022-05-09,49,49,49,0,1358,1358,1344,14,0,0,0,0,49,49,49,49
El Dorado,21,2022-05-09,179,179,177,2,2889,2889,2858,31,3,0,0,1,216,216,216,216
Fresno,21,2022-05-09,746,746,737,9,17764,17765,17548,217,29,1,1,1,2772,2772,2771,2771
Glenn,21,2022-05-09,8,8,8,0,228,228,226,2,0,0,0,0,56,56,56,56
Humboldt,21,2022-05-09,273,273,270,3,3149,3149,3117,32,5,0,0,2,147,147,147,147
Imperial,21,2022-05-09,131,131,130,1,3818,3818,3776,42,0,0,0,1,945,945,945,945
Inyo,21,2022-05-09,26,26,26,0,236,236,234,2,0,0,0,0,56,56,56,56
Kern,21,2022-05-09,467,467,463,4,18704,18705,18536,169,18,2,2,2,2349,2349,2347,2347
Kings,21,2022-05-09,91,91,90,1,4941,4941,4887,54,1,0,0,1,449,449,449,449
Lake,21,2022-05-09,30,30,30,0,1029,1029,1016,13,1,0,0,0,140,140,140,140
Lassen,21,2022-05-09,7,7,7,0,1689,1689,1675,14,0,0,0,0,62,62,62,62
Los Angeles,21,2022-05-09,18429,18429,18373,56,927014,927135,924270,2865,225,29,29,27,31959,31959,31930,31930
Madera,21,2022-05-09,132,132,130,2,3735,3735,3689,46,3,0,0,0,371,371,371,371
Marin,21,2022-05-09,711,711,703,8,7781,7781,7688,93,12,0,0,0,239,239,239,239
Mariposa,21,2022-05-09,32,32,32,0,289,289,285,4,0,0,0,0,28,28,28,28
Mendocino,21,2022-05-09,92,92,91,1,1264,1264,1243,21,0,1,1,0,127,127,126,126
Merced,21,2022-05-09,198,198,196,2,3436,3436,3404,32,4,1,1,0,827,827,826,826
Modoc,21,2022-05-09,2,2,2,0,41,42,41,1,0,0,0,0,8,8,8,8
Mono,21,2022-05-09,9,9,9,0,113,113,111,2,0,0,0,0,6,6,6,6
Monterey,21,2022-05-09,440,440,432,8,9377,9377,9196,181,11,0,0,0,733,733,733,733
Napa,21,2022-05-09,234,234,232,2,3126,3126,3100,26,2,0,0,0,144,144,144,144
Nevada,21,2022-05-09,102,102,101,1,1655,1655,1635,20,5,0,0,0,131,131,131,131
Orange,21,2022-05-09,3536,3536,3511,25,91811,91822,91159,663,84,8,8,17,7138,7138,7130,7130
Placer,21,2022-05-09,537,537,530,7,6753,6753,6663,90,25,0,0,2,627,627,627,627
Plumas,21,2022-05-09,13,13,13,0,274,274,271,3,0,0,0,0,13,13,13,13
Riverside,21,2022-05-09,2402,2402,2379,23,45141,45146,44711,435,42,4,4,8,6473,6473,6469,6469
Sacramento,21,2022-05-09,2258,2258,2235,23,36132,36137,35763,374,62,4,4,10,3079,3079,3075,3075
San Benito,21,2022-05-09,74,74,73,1,1433,1433,1421,12,0,0,0,0,95,95,95,95
San Bernardino,21,2022-05-09,1937,1937,1922,15,46593,46598,46236,362,31,5,5,4,7843,7843,7838,7838
San Diego,21,2022-05-09,5222,5222,5205,17,87128,87140,86857,283,98,2,2,11,5361,5361,5359,5359
San Francisco,21,2022-05-09,3050,3050,2986,64,38188,38193,37385,808,52,6,6,9,884,884,878,878
San Joaquin,21,2022-05-09,772,772,763,9,16051,16051,15868,183,11,1,1,3,2253,2253,2252,2252
San Luis Obispo,21,2022-05-09,290,290,287,3,5222,5222,5176,46,0,0,0,0,483,483,483,483
San Mateo,21,2022-05-09,2315,2315,2299,16,37695,37700,37427,273,26,3,3,1,718,718,715,715
Santa Barbara,21,2022-05-09,638,638,632,6,15590,15590,15435,155,10,0,0,3,693,693,693,693
Santa Clara,21,2022-05-09,5621,5621,5602,19,106179,106194,105826,368,87,3,3,23,2326,2326,2323,2323
Santa Cruz,21,2022-05-09,729,729,723,6,23980,23984,23782,202,2,0,0,0,262,262,262,262
Shasta,21,2022-05-09,107,107,106,1,3301,3301,3267,34,7,0,0,0,563,563,563,563
Siskiyou,21,2022-05-09,16,16,16,0,285,285,283,2,0,0,0,0,83,83,83,83
Solano,21,2022-05-09,920,920,911,9,12318,12318,12198,120,20,0,0,1,450,450,450,450
Sonoma,21,2022-05-09,1179,1179,1168,11,13978,13978,13845,133,18,1,1,2,494,494,493,493
Stanislaus,21,2022-05-09,460,460,453,7,8943,8943,8810,133,27,0,0,2,1695,1695,1695,1695
Sutter,21,2022-05-09,61,61,60,1,1565,1565,1549,16,0,0,0,0,227,227,227,227
Tehama,21,2022-05-09,28,28,28,0,692,692,682,10,1,0,0,0,207,207,207,207
Trinity,21,2022-05-09,4,4,4,0,69,69,68,1,0,0,0,0,20,20,20,20
Tulare,21,2022-05-09,187,187,184,3,7649,7649,7532,117,11,1,1,1,1501,1501,1500,1500
Tuolumne,21,2022-05-09,71,71,70,1,1431,1431,1414,17,1,2,2,0,185,185,183,183
Ventura,21,2022-05-09,1151,1151,1143,8,20949,20950,20811,139,15,1,1,2,1511,1511,1510,1510
Yolo,21,2022-05-09,493,493,489,4,19655,19656,19484,172,1,0,0,1,362,362,362,362
Yuba,21,2022-05-09,77,77,76,1,1241,1241,1229,12,2,0,0,0,126,126,126,126
Alameda,22,2022-05-16,4997,4997,4967,30,75033,75045,74591,454,73,7,7,6,1879,1879,1872,1872
Amador,22,2022-05-16,54,54,53,1,1672,1672,1655,17,0,0,0,0,86,86,86,86
Butte,22,2022-05-16,207,207,206,1,2664,2664,2651,13,7,2,2,0,436,436,434,434
Calaveras,22,2022-05-16,43,43,43,0,765,765,758,7,0,1,1,1,121,121,120,120
Colusa,22,2022-05-16,7,7,7,0,217,217,215,2,0,0,0,0,21,21,21,21
Contra Costa,22,2022-05-16,3487,3487,3452,35,33516,33521,33182,339,50,5,5,7,1317,1317,1312,1312
Del Norte,22,2022-05-16,175,175,174,1,1859,1859,1844,15,0,0,0,0,49,49,49,49
El Dorado,22,2022-05-16,266,266,264,2,3040,3040,3014,26,5,0,0,1,216,216,216,216
Fresno,22,2022-05-16,1139,1139,1128,11,18945,18946,18766,180,46,2,2,6,2774,2774,2772,2772
Glenn,22,2022-05-16,15,15,15,0,259,259,257,2,0,0,0,0,56,56,56,56
Humboldt,22,2022-05-16,274,274,272,2,3253,3253,3227,26,9,1,1,2,148,148,147,147
Imperial,22,2022-05-16,207,207,205,2,4261,4261,4224,37,1,0,0,1,945,945,945,945
Inyo,22,2022-05-16,19,19,19,0,228,228,226,2,1,0,0,0,56,56,56,56
Kern,22,2022-05-16,688,688,683,5,19983,19986,19845,141,22,3,3,3,2352,2352,2349,2349
Kings,22,2022-05-16,221,221,219,2,5426,5426,5380,46,0,1,1,0,450,450,449,449
Lake,22,2022-05-16,75,75,74,1,1118,1118,1107,11,2,0,0,0,140,140,140,140
Lassen,22,2022-05-16,21,21,21,0,1704,1704,1693,11,1,0,0,0,62,62,62,62
Los Angeles,22,2022-05-16,21421,21422,21371,51,938126,938268,936007,2261,283,38,38,44,31997,31997,31959,31959
Madera,22,2022-05-16,199,199,197,2,3645,3645,3610,35,2,0,0,0,371,371,371,371
Marin,22,2022-05-16,816,816,808,8,8391,8391,8313,78,12,0,0,0,239,239,239,239
Mariposa,22,2022-05-16,23,23,23,0,342,342,338,4,0,0,0,0,28,28,28,28
Mendocino,22,2022-05-16,98,98,97,1,1326,1326,1309,17,0,1,1,1,128,128,127,127
Merced,22,2022-05-16,314,314,312,2,4017,4017,3988,29,8,1,1,1,828,828,827,827
Modoc,22,2022-05-16,4,4,4,0,43,44,43,1,0,0,0,0,8,8,8,8
Mono,22,2022-05-16,11,11,11,0,112,112,110,2,0,0,0,0,6,6,6,6
Monterey,22,2022-05-16,509,509,501,8,9600,9600,9456,144,6,1,1,0,734,734,733,733
Napa,22,2022-05-16,299,299,297,2,3741,3741,3717,24,3,0,0,0,144,144,144,144
Nevada,22,2022-05-16,146,146,145,1,1834,1834,1817,17,2,0,0,0,131,131,131,131
Orange,22,2022-05-16,4574,4574,4549,25,94715,94730,94197,533,74,7,7,15,7145,7145,7138,7138
Placer,22,2022-05-16,742,742,734,8,7777,7777,7696,81,43,2,2,3,629,629,627,627
Plumas,22,2022-05-16,47,47,47,0,242,242,240,2,1,0,0,0,13,13,13,13
Riverside,22,2022-05-16,3347,3347,3322,25,47987,47993,47632,361,65,1,1,6,6474,6474,6473,6473
Sacramento,22,2022-05-16,3141,3141,3116,25,39845,39850,39528,322,89,8,8,12,3087,3087,3079,3079
San Benito,22,2022-05-16,110,110,109,1,1529,1529,1519,10,1,0,0,0,95,95,95,95
San Bernardino,22,2022-05-16,2470,2470,2455,15,49169,49175,48877,298,44,8,8,5,7851,7851,7843,7843
San Diego,22,2022-05-16,6665,6665,6648,17,94785,94798,94558,240,91,6,6,25,5367,5367,5361,5361
San Francisco,22,2022-05-16,3412,3412,3356,56,39358,39363,38710,653,68,5,5,8,889,889,884,884
San Joaquin,22,2022-05-16,1200,1200,1189,11,19000,19002,18833,169,16,1,1,1,2254,2254,2253,2253
San Luis Obispo,22,2022-05-16,426,426,423,3,6058,6058,6016,42,3,0,0,0,483,483,483,483
San Mateo,22,2022-05-16,2776,2776,2761,15,39916,39921,39696,225,39,1,1,1,719,719,718,718
Santa Barbara,22,2022-05-16,913,913,906,7,17045,17046,16914,132,13,0,0,2,693,693,693,693
Santa Clara,22,2022-05-16,7206,7206,7187,19,113216,113234,112929,305,111,10,10,15,2336,2336,2326,2326
Santa Cruz,22,2022-05-16,808,808,803,5,20748,20751,20611,140,5,0,0,0,262,262,262,262
Shasta,22,2022-05-16,126,126,125,1,3812,3812,3781,31,6,0,0,1,563,563,563,563
Siskiyou,22,2022-05-16,19,19,19,0,372,372,370,2,0,0,0,0,83,83,83,83
Solano,22,2022-05-16,1278,1278,1268,10,14198,14199,14092,107,29,0,0,2,450,450,450,450
Sonoma,22,2022-05-16,1573,1573,1562,11,15544,15545,15430,115,28,0,0,4,494,494,494,494
Stanislaus,22,2022-05-16,749,749,740,9,9953,9953,9837,116,33,2,2,5,1697,1697,1695,1695
Sutter,22,2022-05-16,108,108,107,1,1828,1828,1814,14,0,0,0,0,227,227,227,227
Tehama,22,2022-05-16,37,37,37,0,840,840,831,9,0,1,1,1,208,208,207,207
Trinity,22,2022-05-16,5,5,5,0,69,69,68,1,0,0,0,0,20,20,20,20
Tulare,22,2022-05-16,398,398,393,5,8329,8329,8230,99,14,1,1,0,1502,1502,1501,1501
Tuolumne,22,2022-05-16,139,139,138,1,1450,1450,1436,14,1,1,1,0,186,186,185,185
Ventura,22,2022-05-16,1552,1552,1544,8,23859,23864,23741,123,34,2,2,2,1513,1513,1511,1511
Yolo,22,2022-05-16,688,688,683,5,22152,22157,22005,152,0,0,0,1,362,362,362,362
Yuba,22,2022-05-16,119,119,118,1,1335,1335,1325,10,4,0,0,0,126,126,126,126
Alameda,23,2022-05-23,5610,5610,5584,26,77863,77880,77512,368,76,4,4,4,1883,1883,1879,1879
Amador,23,2022-05-23,80,80,79,1,1441,1441,1430,11,0,0,0,0,86,86,86,86
Butte,23,2022-05-23,284,284,283,1,2766,2766,2755,11,5,1,1,1,437,437,436,436
Calaveras,23,2022-05-23,52,52,52,0,744,744,739,5,0,1,1,0,122,122,121,121
Colusa,23,2022-05-23,7,7,7,0,232,232,231,1,0,0,0,0,21,21,21,21
Contra Costa,23,2022-05-23,3828,3828,3798,30,35373,35379,35100,279,71,10,10,7,1327,1327,1317,1317
Del Norte,23,2022-05-23,67,67,67,0,1346,1346,1338,8,0,1,1,0,50,50,49,49
El Dorado,23,2022-05-23,359,359,357,2,3421,3421,3398,23,6,2,2,0,218,218,216,216
Fresno,23,2022-05-23,1652,1652,1640,12,21277,21282,21124,158,63,2,2,8,2776,2776,2774,2774
Glenn,23,2022-05-23,26,26,26,0,273,273,271,2,0,0,0,0,56,56,56,56
Humboldt,23,2022-05-23,245,245,244,1,2911,2911,2893,18,14,1,1,3,149,149,148,148
Imperial,23,2022-05-23,343,343,341,2,4737,4737,4705,32,2,0,0,1,945,945,945,945
Inyo,23,2022-05-23,27,27,27,0,221,221,220,1,0,0,0,0,56,56,56,56
Kern,23,2022-05-23,1006,1006,1001,5,21279,21284,21167,117,34,0,0,7,2352,2352,2352,2352
Kings,23,2022-05-23,251,251,249,2,5652,5652,5614,38,1,0,0,0,450,450,450,450
Lake,23,2022-05-23,96,96,95,1,1238,1238,1228,10,1,0,0,1,140,140,140,140
Lassen,23,2022-05-23,41,41,41,0,1763,1763,1754,9,0,0,0,0,62,62,62,62
Los Angeles,23,2022-05-23,27748,27753,27701,52,946456,946645,944867,1778,366,31,31,53,32028,32028,31997,31997
Madera,23,2022-05-23,216,216,214,2,3773,3773,3744,29,1,0,0,2,371,371,371,371
Marin,23,2022-05-23,798,798,792,6,8785,8785,8721,64,15,0,0,1,239,239,239,239
Mariposa,23,2022-05-23,32,32,32,0,342,342,339,3,0,0,0,0,28,28,28,28
Mendocino,23,2022-05-23,150,150,149,1,1659,1659,1642,17,3,1,1,1,129,129,128,128
Merced,23,2022-05-23,409,409,407,2,4204,4204,4180,24,4,0,0,0,828,828,828,828
Modoc,23,2022-05-23,2,2,2,0,40,41,40,1,0,0,0,0,8,8,8,8
Mono,23,2022-05-23,14,14,14,0,163,163,161,2,0,0,0,0,6,6,6,6
Monterey,23,2022-05-23,701,701,693,8,9613,9614,9501,113,17,1,1,1,735,735,734,734
Napa,23,2022-05-23,339,339,337,2,3951,3951,3931,20,5,0,0,0,144,144,144,144
Nevada,23,2022-05-23,150,150,149,1,1904,1904,1890,14,2,0,0,0,131,131,131,131
Orange,23,2022-05-23,5644,5644,5620,24,94959,94978,94560,418,111,11,11,20,7156,7156,7145,7145
Placer,23,2022-05-23,888,888,881,7,7838,7838,7774,64,49,2,2,4,631,631,629,629
Plumas,23,2022-05-23,46,46,46,0,279,279,277,2,0,0,0,0,13,13,13,13
Riverside,23,2022-05-23,4454,4454,4428,26,52427,52440,52133,307,73,6,6,10,6480,6480,6474,6474
Sacramento,23,2022-05-23,3899,3899,3875,24,41058,41065,40805,260,122,7,7,10,3094,3094,3087,3087
San Benito,23,2022-05-23,168,168,167,1,1668,1668,1659,9,0,0,0,0,95,95,95,95
San Bernardino,23,2022-05-23,3323,3323,3307,16,50641,50653,50413,240,53,3,3,10,7854,7854,7851,7851
San Diego,23,2022-05-23,8841,8841,8824,17,103290,103310,103106,204,138,4,4,20,5371,5371,5367,5367
San Francisco,23,2022-05-23,3604,3604,3557,47,41636,41644,41104,540,85,6,6,9,895,895,889,889
San Joaquin,23,2022-05-23,1548,1548,1537,11,20956,20961,20815,146,20,3,3,7,2257,2257,2254,2254
San Luis Obispo,23,2022-05-23,669,669,665,4,7273,7273,7234,39,10,3,3,0,486,486,483,483
San Mateo,23,2022-05-23,3156,3156,3142,14,40830,40838,40658,180,35,0,0,0,719,719,719,719
Santa Barbara,23,2022-05-23,1064,1064,1058,6,17777,17782,17674,108,20,0,0,3,693,693,693,693
Santa Clara,23,2022-05-23,7829,7829,7813,16,111314,111336,111102,234,126,7,7,18,2343,2343,2336,2336
Santa Cruz,23,2022-05-23,505,505,502,3,7816,7816,7776,40,16,0,0,0,262,262,262,262
Shasta,23,2022-05-23,195,195,194,1,3606,3606,3583,23,4,1,1,3,564,564,563,563
Siskiyou,23,2022-05-23,29,29,29,0,364,364,362,2,1,0,0,0,83,83,83,83
Solano,23,2022-05-23,1513,1513,1504,9,14915,14917,14829,88,24,1,1,3,451,451,450,450
Sonoma,23,2022-05-23,1487,1487,1478,9,16336,16341,16246,95,34,2,2,3,496,496,494,494
Stanislaus,23,2022-05-23,873,873,865,8,10702,10703,10605,98,37,2,2,3,1699,1699,1697,1697
Sutter,23,2022-05-23,141,141,140,1,1912,1912,1901,11,0,1,1,0,228,228,227,227
Tehama,23,2022-05-23,50,50,50,0,812,812,805,7,1,0,0,1,208,208,208,208
Trinity,23,2022-05-23,3,3,3,0,90,90,89,1,0,0,0,0,20,20,20,20
Tulare,23,2022-05-23,561,561,556,5,9082,9083,8999,84,26,0,0,0,1502,1502,1502,1502
Tuolumne,23,2022-05-23,135,135,134,1,1578,1578,1566,12,0,1,1,0,187,187,186,186
Ventura,23,2022-05-23,1918,1918,1910,8,24021,24026,23929,97,36,1,1,1,1514,1514,1513,1513
Yolo,23,2022-05-23,731,731,727,4,22658,22663,22542,121,1,1,1,1,363,363,362,362
Yuba,23,2022-05-23,151,151,150,1,1453,1453,1445,8,6,0,0,1,126,126,126,126
Alameda,24,2022-05-30,4913,4913,4895,18,60796,60810,60581,229,95,4,4,7,1887,1887,1883,1883
Amador,24,2022-05-30,89,89,88,1,1191,1191,1184,7,0,1,1,0,87,87,86,86
Butte,24,2022-05-30,276,276,275,1,2708,2708,2700,8,20,0,0,1,437,437,437,437
Calaveras,24,2022-05-30,54,54,54,0,617,617,614,3,0,0,0,0,122,122,122,122
Colusa,24,2022-05-30,12,12,12,0,170,170,169,1,0,0,0,0,21,21,21,21
Contra Costa,24,2022-05-30,3321,3321,3300,21,28984,28990,28808,182,65,7,7,9,1334,1334,1327,1327
Del Norte,24,2022-05-30,36,36,36,0,975,975,970,5,2,1,1,0,51,51,50,50
El Dorado,24,2022-05-30,332,332,330,2,2940,2940,2924,16,6,2,2,2,220,220,218,218
Fresno,24,2022-05-30,1669,1669,1659,10,19453,19457,19342,115,71,6,6,7,2782,2782,2776,2776
Glenn,24,2022-05-30,27,27,27,0,290,290,289,1,2,0,0,0,56,56,56,56
Humboldt,24,2022-05-30,180,180,179,1,2296,2296,2285,11,10,0,0,5,149,149,149,149
Imperial,24,2022-05-30,332,332,330,2,4134,4134,4112,22,2,1,1,2,946,946,945,945
Inyo,24,2022-05-30,18,18,18,0,151,151,150,1,0,0,0,0,56,56,56,56
Kern,24,2022-05-30,1078,1078,1073,5,17990,17995,17916,79,36,0,0,6,2352,2352,2352,2352
Kings,24,2022-05-30,293,293,291,2,4671,4671,4646,25,2,0,0,1,450,450,450,450
Lake,24,2022-05-30,89,89,88,1,994,994,988,6,1,0,0,0,140,140,140,140
Lassen,24,2022-05-30,50,50,50,0,1615,1615,1608,7,1,0,0,0,62,62,62,62
Los Angeles,24,2022-05-30,26045,26052,26013,39,746793,746971,745845,1126,425,47,47,54,32075,32075,32028,32028
Madera,24,2022-05-30,235,235,234,1,3320,3320,3300,20,4,0,0,1,371,371,371,371
Marin,24,2022-05-30,651,651,647,4,7154,7154,7112,42,16,3,3,1,242,242,239,239
Mariposa,24,2022-05-30,39,39,39,0,305,305,303,2,0,0,0,0,28,28,28,28
Mendocino,24,2022-05-30,136,136,135,1,1264,1264,1254,10,4,0,0,1,129,129,129,129
Merced,24,2022-05-30,365,365,363,2,3411,3411,3395,16,6,0,0,2,828,828,828,828
Modoc,24,2022-05-30,4,4,4,0,38,39,38,1,0,0,0,0,8,8,8,8
Mono,24,2022-05-30,6,6,6,0,81,81,80,1,0,0,0,0,6,6,6,6
Monterey,24,2022-05-30,524,524,519,5,7149,7149,7082,67,19,1,1,1,736,736,735,735
Napa,24,2022-05-30,328,328,327,1,3207,3207,3194,13,4,0,0,0,144,144,144,144
Nevada,24,2022-05-30,181,181,180,1,1595,1595,1586,9,3,2,2,1,133,133,131,131
Orange,24,2022-05-30,5668,5668,5649,19,82311,82330,82042,288,122,12,12,18,7168,7168,7156,7156
Placer,24,2022-05-30,738,738,733,5,6136,6136,6096,40,52,0,0,8,631,631,631,631
Plumas,24,2022-05-30,35,35,35,0,200,200,199,1,1,0,0,0,13,13,13,13
Riverside,24,2022-05-30,3863,3863,3845,18,43870,43881,43676,205,82,3,3,10,6483,6483,6480,6480
Sacramento,24,2022-05-30,3844,3844,3825,19,33087,33094,32928,166,130,9,9,20,3103,3103,3094,3094
San Benito,24,2022-05-30,154,154,153,1,1276,1276,1271,5,0,0,0,0,95,95,95,95
San Bernardino,24,2022-05-30,3336,3336,3324,12,42870,42881,42720,161,49,5,5,10,7859,7859,7854,7854
San Diego,24,2022-05-30,8414,8414,8401,13,85859,85880,85745,135,153,10,10,26,5381,5381,5371,5371
San Francisco,24,2022-05-30,3136,3136,3104,32,33425,33435,33091,344,88,11,11,14,906,906,895,895
San Joaquin,24,2022-05-30,1399,1399,1391,8,17011,17016,16922,94,25,2,2,9,2259,2259,2257,2257
San Luis Obispo,24,2022-05-30,653,653,650,3,5439,5439,5416,23,12,1,1,0,487,487,486,486
San Mateo,24,2022-05-30,2757,2757,2747,10,31176,31184,31074,110,33,3,3,2,722,722,719,719
Santa Barbara,24,2022-05-30,1032,1032,1027,5,14451,14455,14385,70,23,2,2,5,695,695,693,693
Santa Clara,24,2022-05-30,7030,7030,7018,12,85318,85338,85195,143,154,10,10,22,2353,2353,2343,2343
Santa Cruz,24,2022-05-30,526,526,524,2,6255,6255,6229,26,7,1,1,1,263,263,262,262
Shasta,24,2022-05-30,133,133,132,1,2838,2838,2824,14,4,3,3,4,567,567,564,564
Siskiyou,24,2022-05-30,53,53,53,0,340,340,339,1,3,0,0,0,83,83,83,83
Solano,24,2022-05-30,1186,1186,1180,6,11558,11561,11506,55,28,0,0,7,451,451,451,451
Sonoma,24,2022-05-30,1200,1200,1195,5,13239,13243,13182,61,38,2,2,5,498,498,496,496
Stanislaus,24,2022-05-30,801,801,795,6,8587,8588,8526,62,55,2,2,3,1701,1701,1699,1699
Sutter,24,2022-05-30,157,157,156,1,1701,1701,1693,8,0,0,0,0,228,228,228,228
Tehama,24,2022-05-30,62,62,62,0,757,757,752,5,2,0,0,0,208,208,208,208
Trinity,24,2022-05-30,8,8,8,0,96,96,95,1,0,0,0,0,20,20,20,20
Tulare,24,2022-05-30,601,601,597,4,7503,7503,7447,56,19,0,0,0,1502,1502,1502,1502
Tuolumne,24,2022-05-30,121,121,120,1,1308,1308,1300,8,3,0,0,0,187,187,187,187
Ventura,24,2022-05-30,1681,1681,1676,5,19545,19549,19486,63,30,1,1,4,1515,1515,1514,1514
Yolo,24,2022-05-30,611,611,608,3,17632,17636,17561,75,4,0,0,1,363,363,363,363
Yuba,24,2022-05-30,144,144,143,1,1276,1276,1270,6,7,0,0,2,126,126,126,126
Alameda,25,2022-06-06,6493,6493,6474,19,73239,73262,73050,212,112,4,4,12,1891,1891,1887,1887
Amador,25,2022-06-06,114,114,113,1,1723,1723,1715,8,1,0,0,1,87,87,87,87
Butte,25,2022-06-06,452,452,451,1,3616,3616,3608,8,24,1,1,1,438,438,437,437
Calaveras,25,2022-06-06,73,73,73,0,737,737,734,3,0,2,2,0,124,124,122,122
Colusa,25,2022-06-06,22,22,22,0,275,275,274,1,3,0,0,0,21,21,21,21
Contra Costa,25,2022-06-06,4231,4231,4211,20,35707,35719,35546,173,107,9,9,7,1343,1343,1334,1334
Del Norte,25,2022-06-06,64,64,64,0,1134,1134,1130,4,2,0,0,0,51,51,51,51
El Dorado,25,2022-06-06,413,413,411,2,3637,3637,3622,15,5,0,0,5,220,220,220,220
Fresno,25,2022-06-06,2451,2451,2440,11,22607,22615,22512,103,94,2,2,6,2784,2784,2782,2782
Glenn,25,2022-06-06,41,41,41,0,325,325,324,1,3,0,0,0,56,56,56,56
Humboldt,25,2022-06-06,260,260,259,1,3054,3054,3043,11,14,1,1,3,150,150,149,149
Imperial,25,2022-06-06,465,465,463,2,4855,4855,4835,20,2,0,0,0,946,946,946,946
Inyo,25,2022-06-06,20,20,20,0,213,213,212,1,1,0,0,0,56,56,56,56
Kern,25,2022-06-06,1612,1612,1607,5,22979,22986,22909,77,35,1,1,6,2353,2353,2352,2352
Kings,25,2022-06-06,397,397,395,2,5509,5509,5486,23,10,0,0,1,450,450,450,450
Lake,25,2022-06-06,136,136,135,1,1180,1180,1174,6,5,0,0,2,140,140,140,140
Lassen,25,2022-06-06,71,71,71,0,2398,2398,2390,8,2,0,0,0,62,62,62,62
Los Angeles,25,2022-06-06,35103,35114,35074,40,1041708,1042035,1040833,1202,496,39,39,61,32114,32114,32075,32075
Madera,25,2022-06-06,354,354,352,2,4140,4140,4121,19,7,0,0,1,371,371,371,371
Marin,25,2022-06-06,739,739,736,3,7650,7650,7616,34,10,2,2,5,244,244,242,242
Mariposa,25,2022-06-06,57,57,57,0,404,404,402,2,0,0,0,0,28,28,28,28
Mendocino,25,2022-06-06,209,209,208,1,1711,1711,1700,11,9,1,1,2,130,130,129,129
Merced,25,2022-06-06,532,532,530,2,4533,4533,4517,16,16,0,0,0,828,828,828,828
Modoc,25,2022-06-06,11,11,11,0,37,38,37,1,0,0,0,0,8,8,8,8
Mono,25,2022-06-06,15,15,15,0,120,120,119,1,0,0,0,0,6,6,6,6
Monterey,25,2022-06-06,1000,1000,993,7,10243,10245,10170,75,17,2,2,1,738,738,736,736
Napa,25,2022-06-06,556,556,554,2,4267,4267,4254,13,8,1,1,0,145,145,144,144
Nevada,25,2022-06-06,245,245,244,1,2149,2149,2139,10,5,0,0,0,133,133,133,133
Orange,25,2022-06-06,7628,7628,7608,20,73831,73855,73657,198,140,12,12,18,7180,7180,7168,7168
Placer,25,2022-06-06,868,868,864,4,7605,7606,7568,38,65,0,0,11,631,631,631,631
Plumas,25,2022-06-06,40,40,40,0,321,321,320,1,0,0,0,0,13,13,13,13
Riverside,25,2022-06-06,5357,5357,5338,19,55978,55995,55794,201,88,6,6,10,6489,6489,6483,6483
Sacramento,25,2022-06-06,4951,4951,4932,19,42474,42488,42323,165,149,14,14,20,3117,3117,3103,3103
San Benito,25,2022-06-06,273,273,272,1,2016,2016,2010,6,0,0,0,1,95,95,95,95
San Bernardino,25,2022-06-06,5132,5132,5117,15,55844,55863,55701,162,77,7,7,14,7866,7866,7859,7859
San Diego,25,2022-06-06,10776,10780,10767,13,100464,100495,100373,122,185,8,8,22,5389,5389,5381,5381
San Francisco,25,2022-06-06,3521,3521,3493,28,38262,38274,37969,305,77,0,0,11,906,906,906,906
San Joaquin,25,2022-06-06,2134,2134,2125,9,22161,22167,22073,94,40,4,4,9,2263,2263,2259,2259
San Luis Obispo,25,2022-06-06,901,901,898,3,7532,7534,7509,25,16,1,1,1,488,488,487,487
San Mateo,25,2022-06-06,3214,3214,3205,9,37066,37078,36978,100,36,2,2,4,724,724,722,722
Santa Barbara,25,2022-06-06,1246,1246,1241,5,15076,15081,15025,56,22,1,1,5,696,696,695,695
Santa Clara,25,2022-06-06,8503,8504,8493,11,102647,102679,102547,132,176,7,7,22,2360,2360,2353,2353
Santa Cruz,25,2022-06-06,896,896,893,3,9720,9722,9692,30,24,1,1,3,264,264,263,263
Shasta,25,2022-06-06,210,210,209,1,4425,4425,4408,17,10,2,2,2,569,569,567,567
Siskiyou,25,2022-06-06,41,41,41,0,431,431,430,1,1,0,0,0,83,83,83,83
Solano,25,2022-06-06,1749,1749,1743,6,15183,15188,15133,55,29,2,2,1,453,453,451,451
Sonoma,25,2022-06-06,1635,1635,1629,6,13997,14002,13953,49,38,1,1,1,499,499,498,498
Stanislaus,25,2022-06-06,1182,1182,1175,7,10913,10915,10854,61,60,1,1,2,1702,1702,1701,1701
Sutter,25,2022-06-06,206,206,205,1,1941,1941,1934,7,0,0,0,0,228,228,228,228
Tehama,25,2022-06-06,83,83,83,0,1051,1051,1045,6,2,0,0,0,208,208,208,208
Trinity,25,2022-06-06,7,7,7,0,110,110,109,1,0,0,0,0,20,20,20,20
Tulare,25,2022-06-06,864,864,859,5,10815,10818,10756,62,24,0,0,0,1502,1502,1502,1502
Tuolumne,25,2022-06-06,122,122,121,1,1724,1724,1716,8,4,0,0,1,187,187,187,187
Ventura,25,2022-06-06,1972,1972,1967,5,24766,24773,24712,61,43,4,4,3,1519,1519,1515,1515
Yolo,25,2022-06-06,828,828,825,3,21439,21445,21375,70,2,1,1,0,364,364,363,363
Yuba,25,2022-06-06,187,187,186,1,1556,1556,1551,5,9,0,0,1,126,126,126,126
Alameda,26,2022-06-13,5084,5084,5073,11,55927,55951,55825,126,106,5,5,18,1896,1896,1891,1891
Amador,26,2022-06-13,129,129,129,0,1413,1413,1408,5,1,0,0,0,87,87,87,87
Butte,26,2022-06-13,394,394,393,1,3459,3459,3453,6,31,4,4,0,442,442,438,438
Calaveras,26,2022-06-13,69,69,69,0,658,658,656,2,0,0,0,0,124,124,124,124
Colusa,26,2022-06-13,12,12,12,0,328,328,327,1,17,0,0,0,21,21,21,21
Contra Costa,26,2022-06-13,3409,3409,3396,13,27986,27998,27892,106,89,8,8,12,1351,1351,1343,1343
Del Norte,26,2022-06-13,79,79,79,0,658,658,656,2,4,0,0,0,51,51,51,51
El Dorado,26,2022-06-13,324,324,323,1,3197,3197,3187,10,7,3,3,1,223,223,220,220
Fresno,26,2022-06-13,2399,2399,2391,8,20613,20621,20548,73,103,4,4,13,2788,2788,2784,2784
Glenn,26,2022-06-13,32,32,32,0,329,329,328,1,2,0,0,0,56,56,56,56
Humboldt,26,2022-06-13,262,262,261,1,2325,2325,2318,7,11,0,0,3,150,150,150,150
Imperial,26,2022-06-13,447,447,446,1,4519,4519,4505,14,6,1,1,0,947,947,946,946
Inyo,26,2022-06-13,13,13,13,0,189,189,188,1,0,0,0,0,56,56,56,56
Kern,26,2022-06-13,1565,1565,1561,4,21425,21434,21378,56,38,1,1,5,2354,2354,2353,2353
Kings,26,2022-06-13,357,357,356,1,5162,5163,5147,16,4,1,1,0,451,451,450,450
Lake,26,2022-06-13,137,137,137,0,1228,1228,1224,4,1,0,0,0,140,140,140,140
Lassen,26,2022-06-13,77,77,77,0,1994,1994,1989,5,2,0,0,0,62,62,62,62
Los Angeles,26,2022-06-13,29994,30006,29979,27,660499,660774,660176,598,519,54,54,60,32168,32168,32114,32114
Madera,26,2022-06-13,381,381,380,1,4244,4244,4229,15,7,0,0,2,371,371,371,371
Marin,26,2022-06-13,686,686,684,2,7039,7043,7018,25,16,2,2,2,246,246,244,244
Mariposa,26,2022-06-13,45,45,45,0,374,374,373,1,0,0,0,0,28,28,28,28
Mendocino,26,2022-06-13,161,161,160,1,1567,1567,1559,8,9,0,0,1,130,130,130,130
Merced,26,2022-06-13,561,561,559,2,4171,4172,4161,11,13,0,0,2,828,828,828,828
Modoc,26,2022-06-13,7,7,7,0,34,35,34,1,1,1,1,0,9,9,8,8
Mono,26,2022-06-13,19,19,19,0,92,92,91,1,0,0,0,0,6,6,6,6
Monterey,26,2022-06-13,837,837,832,5,8659,8664,8615,49,25,3,3,1,741,741,738,738
Napa,26,2022-06-13,445,445,444,1,3967,3967,3957,10,2,1,1,1,146,146,145,145
Nevada,26,2022-06-13,186,186,185,1,1874,1874,1867,7,8,0,0,0,133,133,133,133
Orange,26,2022-06-13,7049,7050,7035,15,65294,65322,65186,136,175,15,15,19,7195,7195,7180,7180
Placer,26,2022-06-13,790,790,787,3,6801,6802,6776,26,79,2,2,7,633,633,631,631
Plumas,26,2022-06-13,34,34,34,0,271,271,270,1,0,0,0,0,13,13,13,13
Riverside,26,2022-06-13,5046,5046,5032,14,47851,47871,47737,134,105,4,4,11,6493,6493,6489,6489
Sacramento,26,2022-06-13,4179,4179,4166,13,37542,37558,37445,113,190,13,13,20,3130,3130,3117,3117
San Benito,26,2022-06-13,199,199,199,0,1780,1780,1776,4,1,0,0,1,95,95,95,95
San Bernardino,26,2022-06-13,4674,4674,4664,10,48701,48721,48611,110,96,6,6,15,7872,7872,7866,7866
San Diego,26,2022-06-13,9614,9619,9610,9,84903,84940,84860,80,192,9,9,27,5398,5398,5389,5389
San Francisco,26,2022-06-13,3026,3026,3007,19,31122,31135,30942,193,72,11,11,13,917,917,906,906
San Joaquin,26,2022-06-13,1919,1919,1913,6,19010,19017,18954,63,32,5,5,3,2268,2268,2263,2263
San Luis Obispo,26,2022-06-13,661,661,659,2,6054,6056,6041,15,21,0,0,0,488,488,488,488
San Mateo,26,2022-06-13,2635,2635,2630,5,29175,29188,29127,61,44,3,3,3,727,727,724,724
Santa Barbara,26,2022-06-13,931,931,928,3,9477,9482,9455,27,15,1,1,5,697,697,696,696
Santa Clara,26,2022-06-13,7043,7044,7037,7,76835,76867,76790,77,182,13,13,23,2373,2373,2360,2360
Santa Cruz,26,2022-06-13,842,842,840,2,9962,9967,9943,24,23,0,0,1,264,264,264,264
Shasta,26,2022-06-13,220,220,219,1,3390,3390,3380,10,8,1,1,0,570,570,569,569
Siskiyou,26,2022-06-13,50,50,50,0,372,372,371,1,1,0,0,0,83,83,83,83
Solano,26,2022-06-13,1689,1689,1684,5,12902,12907,12871,36,33,0,0,2,453,453,453,453
Sonoma,26,2022-06-13,1336,1336,1332,4,11653,11658,11626,32,36,2,2,6,501,501,499,499
Stanislaus,26,2022-06-13,1132,1132,1127,5,9454,9459,9418,41,63,1,1,7,1703,1703,1702,1702
Sutter,26,2022-06-13,193,193,192,1,1721,1721,1716,5,0,0,0,0,228,228,228,228
Tehama,26,2022-06-13,86,86,86,0,967,967,963,4,3,0,0,0,208,208,208,208
Trinity,26,2022-06-13,11,11,11,0,84,85,84,1,0,0,0,0,20,20,20,20
Tulare,26,2022-06-13,833,833,829,4,9481,9486,9444,42,26,2,2,1,1504,1504,1502,1502
Tuolumne,26,2022-06-13,147,147,146,1,1446,1446,1441,5,2,0,0,0,187,187,187,187
Ventura,26,2022-06-13,1936,1936,1932,4,20982,20992,20952,40,38,3,3,5,1522,1522,1519,1519
Yolo,26,2022-06-13,767,767,765,2,14394,14399,14362,37,4,1,1,0,365,365,364,364
Yuba,26,2022-06-13,188,188,187,1,1419,1419,1415,4,8,0,0,1,126,126,126,126
Alameda,27,2022-06-20,4950,4951,4942,9,48647,48672,48587,85,105,11,11,14,1907,1907,1896,1896
Amador,27,2022-06-20,104,104,104,0,1247,1247,1243,4,2,0,0,0,87,87,87,87
Butte,27,2022-06-20,414,414,413,1,3562,3562,3557,5,28,4,4,1,446,446,442,442
Calaveras,27,2022-06-20,82,82,82,0,625,625,623,2,0,0,0,0,124,124,124,124
Colusa,27,2022-06-20,16,16,16,0,176,177,176,1,15,1,1,0,22,22,21,21
Contra Costa,27,2022-06-20,3348,3348,3338,10,26023,26036,25959,77,81,7,7,8,1358,1358,1351,1351
Del Norte,27,2022-06-20,82,82,82,0,611,611,610,1,3,1,1,1,52,52,51,51
El Dorado,27,2022-06-20,351,351,350,1,3074,3074,3066,8,5,2,2,1,225,225,223,223
Fresno,27,2022-06-20,2471,2471,2464,7,19409,19421,19367,54,100,2,2,16,2790,2790,2788,2788
Glenn,27,2022-06-20,41,41,41,0,314,314,313,1,3,0,0,0,56,56,56,56
Humboldt,27,2022-06-20,273,273,272,1,2274,2274,2269,5,11,0,0,3,150,150,150,150
Imperial,27,2022-06-20,602,602,601,1,3690,3690,3681,9,5,0,0,0,947,947,947,947
Inyo,27,2022-06-20,19,19,19,0,187,188,187,1,0,0,0,0,56,56,56,56
Kern,27,2022-06-20,1652,1652,1649,3,20141,20152,20111,41,39,5,5,9,2359,2359,2354,2354
Kings,27,2022-06-20,413,413,412,1,4871,4872,4860,12,6,1,1,0,452,452,451,451
Lake,27,2022-06-20,120,120,120,0,1237,1237,1233,4,1,0,0,2,140,140,140,140
Lassen,27,2022-06-20,43,43,43,0,1223,1223,1221,2,1,0,0,0,62,62,62,62
Los Angeles,27,2022-06-20,27528,27542,27523,19,351485,351669,351425,244,596,58,58,68,32226,32226,32168,32168
Madera,27,2022-06-20,341,341,340,1,4171,4172,4160,12,4,0,0,1,371,371,371,371
Marin,27,2022-06-20,693,693,691,2,6328,6333,6316,17,21,0,0,1,246,246,246,246
Mariposa,27,2022-06-20,53,53,53,0,338,338,337,1,0,0,0,0,28,28,28,28
Mendocino,27,2022-06-20,180,180,179,1,1580,1580,1574,6,3,0,0,0,130,130,130,130
Merced,27,2022-06-20,541,541,540,1,3959,3960,3952,8,7,3,3,1,831,831,828,828
Modoc,27,2022-06-20,5,5,5,0,37,38,37,1,0,0,0,0,9,9,9,9
Mono,27,2022-06-20,6,6,6,0,82,83,82,1,1,1,1,0,7,7,6,6
Monterey,27,2022-06-20,894,894,890,4,8905,8910,8871,39,38,1,1,2,742,742,741,741
Napa,27,2022-06-20,371,371,370,1,3150,3150,3144,6,3,1,1,0,147,147,146,146
Nevada,27,2022-06-20,170,170,170,0,1619,1619,1615,4,6,1,1,0,134,134,133,133
Orange,27,2022-06-20,7063,7068,7057,11,60498,60529,60430,99,152,10,10,23,7205,7205,7195,7195
Placer,27,2022-06-20,674,674,672,2,6053,6056,6038,18,69,1,1,7,634,634,633,633
Plumas,27,2022-06-20,38,38,38,0,239,239,238,1,0,0,0,0,13,13,13,13
Riverside,27,2022-06-20,4959,4959,4948,11,43309,43332,43237,95,112,5,5,14,6498,6498,6493,6493
Sacramento,27,2022-06-20,3932,3932,3923,9,34815,34833,34751,82,171,12,12,21,3142,3142,3130,3130
San Benito,27,2022-06-20,173,173,173,0,1598,1598,1595,3,0,1,1,2,96,96,95,95
San Bernardino,27,2022-06-20,4527,4527,4519,8,46254,46278,46197,81,105,12,12,17,7884,7884,7872,7872
San Diego,27,2022-06-20,9697,9703,9696,7,77523,77564,77507,57,203,9,9,17,5407,5407,5398,5398
San Francisco,27,2022-06-20,3060,3060,3045,15,28297,28312,28175,137,72,12,12,14,929,929,917,917
San Joaquin,27,2022-06-20,1671,1671,1667,4,17898,17909,17863,46,38,6,6,6,2274,2274,2268,2268
San Luis Obispo,27,2022-06-20,601,601,600,1,5814,5817,5805,12,27,10,10,0,498,498,488,488
San Mateo,27,2022-06-20,2623,2623,2619,4,25948,25961,25918,43,42,2,2,1,729,729,727,727
Santa Barbara,27,2022-06-20,934,934,932,2,8261,8266,8248,18,33,2,2,6,699,699,697,697
Santa Clara,27,2022-06-20,6808,6813,6808,5,63485,63519,63470,49,170,10,10,21,2383,2383,2373,2373
Santa Cruz,27,2022-06-20,818,818,816,2,9130,9135,9118,17,19,1,1,2,265,265,264,264
Shasta,27,2022-06-20,241,241,240,1,3374,3374,3366,8,9,1,1,1,571,571,570,570
Siskiyou,27,2022-06-20,61,61,61,0,394,394,393,1,5,1,1,0,84,84,83,83
Solano,27,2022-06-20,1419,1419,1416,3,11466,11471,11446,25,41,0,0,5,453,453,453,453
Sonoma,27,2022-06-20,1400,1400,1397,3,10797,10802,10779,23,28,1,1,3,502,502,501,501
Stanislaus,27,2022-06-20,1038,1038,1034,4,8834,8839,8809,30,70,5,5,7,1708,1708,1703,1703
Sutter,27,2022-06-20,197,197,197,0,1858,1858,1854,4,0,0,0,0,228,228,228,228
Tehama,27,2022-06-20,97,97,97,0,889,889,886,3,3,0,0,0,208,208,208,208
Trinity,27,2022-06-20,10,10,10,0,106,107,106,1,0,0,0,0,20,20,20,20
Tulare,27,2022-06-20,899,899,896,3,8753,8758,8728,30,32,8,8,0,1512,1512,1504,1504
Tuolumne,27,2022-06-20,140,140,140,0,1558,1558,1554,4,3,0,0,1,187,187,187,187
Ventura,27,2022-06-20,1835,1835,1832,3,18671,18682,18654,28,50,1,1,7,1523,1523,1522,1522
Yolo,27,2022-06-20,680,680,679,1,10848,10853,10831,22,1,2,2,2,367,367,365,365
Yuba,27,2022-06-20,149,149,149,0,1339,1339,1336,3,13,0,0,5,126,126,126,126
Alameda,28,2022-06-27,5476,5478,5471,7,48326,48354,48288,66,124,6,6,16,1913,1913,1907,1907
Amador,28,2022-06-27,88,88,88,0,1149,1149,1146,3,3,0,0,1,87,87,87,87
Butte,28,2022-06-27,410,410,410,0,3468,3468,3464,4,30,2,2,0,448,448,446,446
Calaveras,28,2022-06-27,69,69,69,0,571,571,570,1,1,2,2,0,126,126,124,124
Colusa,28,2022-06-27,28,28,28,0,282,283,282,1,6,0,0,0,22,22,22,22
Contra Costa,28,2022-06-27,3526,3526,3518,8,25912,25926,25867,59,82,12,12,7,1370,1370,1358,1358
Del Norte,28,2022-06-27,140,140,140,0,669,669,668,1,5,1,1,2,53,53,52,52
El Dorado,28,2022-06-27,427,427,426,1,3357,3358,3352,6,5,0,0,1,225,225,225,225
Fresno,28,2022-06-27,2828,2828,2822,6,19886,19898,19855,43,136,2,2,17,2792,2792,2790,2790
Glenn,28,2022-06-27,28,28,28,0,296,296,295,1,1,0,0,0,56,56,56,56
Humboldt,28,2022-06-27,261,261,261,0,2189,2189,2185,4,10,1,1,2,151,151,150,150
Imperial,28,2022-06-27,705,705,704,1,4017,4019,4011,8,7,0,0,4,947,947,947,947
Inyo,28,2022-06-27,32,32,32,0,311,311,310,1,1,0,0,0,56,56,56,56
Kern,28,2022-06-27,1819,1819,1816,3,17409,17421,17393,28,52,7,7,8,2366,2366,2359,2359
Kings,28,2022-06-27,470,470,469,1,3932,3933,3925,8,9,0,0,0,452,452,452,452
Lake,28,2022-06-27,122,122,122,0,1139,1139,1136,3,2,0,0,0,140,140,140,140
Lassen,28,2022-06-27,51,51,51,0,848,848,847,1,1,0,0,0,62,62,62,62
Los Angeles,28,2022-06-27,32764,32784,32767,17,364342,364562,364365,197,679,73,73,68,32299,32299,32226,32226
Madera,28,2022-06-27,414,414,413,1,4288,4290,4281,9,8,0,0,0,371,371,371,371
Marin,28,2022-06-27,659,659,658,1,6242,6247,6234,13,20,0,0,2,246,246,246,246
Mariposa,28,2022-06-27,55,55,55,0,311,311,310,1,0,0,0,0,28,28,28,28
Mendocino,28,2022-06-27,153,153,153,0,1447,1447,1443,4,5,1,1,1,131,131,130,130
Merced,28,2022-06-27,614,614,613,1,4040,4041,4034,7,14,2,2,0,833,833,831,831
Modoc,28,2022-06-27,7,7,7,0,32,33,32,1,0,0,0,0,9,9,9,9
Mono,28,2022-06-27,25,25,25,0,110,111,110,1,1,0,0,0,7,7,7,7
Monterey,28,2022-06-27,933,933,930,3,8274,8279,8251,28,44,2,2,3,744,744,742,742
Napa,28,2022-06-27,394,394,393,1,3322,3322,3317,5,3,2,2,1,149,149,147,147
Nevada,28,2022-06-27,189,189,189,0,1619,1619,1616,3,4,0,0,3,134,134,134,134
Orange,28,2022-06-27,7594,7599,7589,10,59409,59445,59370,75,183,16,16,26,7221,7221,7205,7205
Placer,28,2022-06-27,808,808,806,2,6185,6190,6175,15,79,6,6,6,640,640,634,634
Plumas,28,2022-06-27,49,49,49,0,257,257,256,1,1,0,0,0,13,13,13,13
Riverside,28,2022-06-27,6195,6200,6190,10,44972,45000,44924,76,141,11,11,17,6509,6509,6498,6498
Sacramento,28,2022-06-27,4165,4166,4158,8,35282,35302,35237,65,173,10,10,25,3152,3152,3142,3142
San Benito,28,2022-06-27,221,221,221,0,1655,1655,1653,2,0,0,0,1,96,96,96,96
San Bernardino,28,2022-06-27,5723,5725,5717,8,48827,48856,48789,67,130,12,12,24,7896,7896,7884,7884
San Diego,28,2022-06-27,10871,10878,10872,6,80655,80704,80658,46,264,9,9,28,5416,5416,5407,5407
San Francisco,28,2022-06-27,3270,3270,3258,12,29259,29277,29167,110,92,5,5,23,934,934,929,929
San Joaquin,28,2022-06-27,1894,1894,1890,4,17964,17975,17939,36,46,2,2,5,2276,2276,2274,2274
San Luis Obispo,28,2022-06-27,645,645,644,1,5645,5649,5640,9,25,3,3,0,501,501,498,498
San Mateo,28,2022-06-27,2890,2890,2886,4,26919,26934,26900,34,36,2,2,2,731,731,729,729
Santa Barbara,28,2022-06-27,1148,1148,1146,2,9814,9819,9802,17,26,2,2,2,701,701,699,699
Santa Clara,28,2022-06-27,7542,7549,7544,5,61418,61456,61419,37,213,11,11,19,2394,2394,2383,2383
Santa Cruz,28,2022-06-27,861,861,860,1,9188,9193,9179,14,26,2,2,1,267,267,265,265
Shasta,28,2022-06-27,339,339,338,1,3308,3309,3303,6,21,0,0,4,571,571,571,571
Siskiyou,28,2022-06-27,63,63,63,0,355,355,354,1,2,1,1,0,85,85,84,84
Solano,28,2022-06-27,1614,1614,1611,3,13044,13052,13030,22,47,0,0,4,453,453,453,453
Sonoma,28,2022-06-27,1368,1368,1366,2,10098,10103,10086,17,33,2,2,3,504,504,502,502
Stanislaus,28,2022-06-27,1211,1211,1208,3,8585,8590,8567,23,96,2,2,6,1710,1710,1708,1708
Sutter,28,2022-06-27,194,194,194,0,1843,1843,1840,3,0,0,0,0,228,228,228,228
Tehama,28,2022-06-27,93,93,93,0,888,888,886,2,3,0,0,0,208,208,208,208
Trinity,28,2022-06-27,24,24,24,0,142,143,142,1,1,0,0,0,20,20,20,20
Tulare,28,2022-06-27,910,910,908,2,7901,7906,7885,21,35,0,0,2,1512,1512,1512,1512
Tuolumne,28,2022-06-27,169,169,169,0,1406,1406,1403,3,1,4,4,1,191,191,187,187
Ventura,28,2022-06-27,2090,2090,2088,2,18543,18555,18533,22,61,3,3,1,1526,1526,1523,1523
Yolo,28,2022-06-27,794,794,793,1,11408,11415,11397,18,8,0,0,1,367,367,367,367
Yuba,28,2022-06-27,173,173,173,0,1435,1435,1433,2,10,3,3,2,129,129,126,126
Alameda,29,2022-07-04,4838,4842,4837,5,38884,38911,38869,42,128,10,10,10,1923,1923,1913,1913
Amador,29,2022-07-04,66,66,66,0,1534,1534,1531,3,3,0,0,1,87,87,87,87
Butte,29,2022-07-04,284,284,284,0,2489,2489,2487,2,28,2,2,1,450,450,448,448
Calaveras,29,2022-07-04,81,81,81,0,486,486,485,1,0,2,2,0,128,128,126,126
Colusa,29,2022-07-04,21,21,21,0,150,151,150,1,4,0,0,0,22,22,22,22
Contra Costa,29,2022-07-04,3316,3316,3310,6,20931,20946,20908,38,76,10,10,12,1380,1380,1370,1370
Del Norte,29,2022-07-04,140,140,140,0,587,587,586,1,3,0,0,0,53,53,53,53
El Dorado,29,2022-07-04,306,306,306,0,2394,2394,2390,4,10,1,1,0,226,226,225,225
Fresno,29,2022-07-04,2469,2469,2465,4,15665,15676,15649,27,158,6,6,17,2798,2798,2792,2792
Glenn,29,2022-07-04,24,24,24,0,157,158,157,1,1,0,0,0,56,56,56,56
Humboldt,29,2022-07-04,187,187,187,0,1584,1584,1582,2,12,2,2,3,153,153,151,151
Imperial,29,2022-07-04,697,697,696,1,3233,3234,3229,5,8,1,1,3,948,948,947,947
Inyo,29,2022-07-04,42,42,42,0,292,293,292,1,1,0,0,0,56,56,56,56
Kern,29,2022-07-04,1794,1794,1792,2,14291,14302,14284,18,63,4,4,9,2370,2370,2366,2366
Kings,29,2022-07-04,436,436,435,1,3446,3448,3443,5,5,0,0,0,452,452,452,452
Lake,29,2022-07-04,107,107,107,0,790,790,789,1,3,2,2,0,142,142,140,140
Lassen,29,2022-07-04,31,31,31,0,640,640,639,1,2,0,0,0,62,62,62,62
Los Angeles,29,2022-07-04,32266,32288,32274,14,285975,286172,286049,123,801,88,88,85,32387,32387,32299,32299
Madera,29,2022-07-04,341,341,340,1,3179,3181,3175,6,9,0,0,1,371,371,371,371
Marin,29,2022-07-04,608,608,607,1,5170,5174,5165,9,25,1,1,2,247,247,246,246
Mariposa,29,2022-07-04,36,36,36,0,222,223,222,1,0,0,0,0,28,28,28,28
Mendocino,29,2022-07-04,164,164,164,0,1119,1119,1116,3,6,2,2,1,133,133,131,131
Merced,29,2022-07-04,596,596,595,1,2921,2921,2917,4,14,2,2,1,835,835,833,833
Modoc,29,2022-07-04,10,10,10,0,31,32,31,1,0,0,0,0,9,9,9,9
Mono,29,2022-07-04,22,22,22,0,81,82,81,1,1,0,0,0,7,7,7,7
Monterey,29,2022-07-04,842,842,840,2,6322,6326,6309,17,39,2,2,4,746,746,744,744
Napa,29,2022-07-04,345,345,345,0,2564,2564,2561,3,13,0,0,1,149,149,149,149
Nevada,29,2022-07-04,177,177,177,0,1268,1268,1266,2,5,0,0,1,134,134,134,134
Orange,29,2022-07-04,7021,7026,7019,7,50771,50806,50755,51,203,25,25,34,7246,7246,7221,7221
Placer,29,2022-07-04,808,808,807,1,5049,5053,5044,9,72,3,3,6,643,643,640,640
Plumas,29,2022-07-04,32,32,32,0,172,173,172,1,0,0,0,0,13,13,13,13
Riverside,29,2022-07-04,6395,6400,6391,9,38526,38553,38501,52,137,5,5,8,6514,6514,6509,6509
Sacramento,29,2022-07-04,3579,3579,3574,5,26535,26552,26513,39,163,19,19,22,3171,3171,3152,3152
San Benito,29,2022-07-04,211,211,211,0,1274,1274,1272,2,3,0,0,0,96,96,96,96
San Bernardino,29,2022-07-04,6066,6070,6063,7,41600,41629,41584,45,147,12,12,26,7908,7908,7896,7896
San Diego,29,2022-07-04,9597,9604,9600,4,65500,65545,65515,30,262,10,10,43,5426,5426,5416,5416
San Francisco,29,2022-07-04,2891,2891,2882,9,24203,24218,24146,72,100,11,11,18,945,945,934,934
San Joaquin,29,2022-07-04,1683,1683,1680,3,14679,14690,14667,23,41,5,5,4,2281,2281,2276,2276
San Luis Obispo,29,2022-07-04,616,616,615,1,4166,4169,4164,5,24,0,0,0,501,501,501,501
San Mateo,29,2022-07-04,2600,2600,2597,3,21595,21609,21587,22,39,1,1,3,732,732,731,731
Santa Barbara,29,2022-07-04,1057,1057,1056,1,7666,7670,7659,11,26,4,4,4,705,705,701,701
Santa Clara,29,2022-07-04,6804,6810,6807,3,50747,50782,50758,24,191,16,16,34,2410,2410,2394,2394
Santa Cruz,29,2022-07-04,733,733,732,1,7158,7162,7153,9,22,0,0,0,267,267,267,267
Shasta,29,2022-07-04,280,280,280,0,2396,2396,2392,4,15,5,5,3,576,576,571,571
Siskiyou,29,2022-07-04,34,34,34,0,326,327,326,1,1,0,0,1,85,85,85,85
Solano,29,2022-07-04,1344,1344,1342,2,9841,9847,9834,13,50,0,0,5,453,453,453,453
Sonoma,29,2022-07-04,1088,1088,1087,1,8092,8097,8086,11,35,2,2,1,506,506,504,504
Stanislaus,29,2022-07-04,1165,1165,1163,2,6991,6995,6980,15,84,7,7,16,1717,1717,1710,1710
Sutter,29,2022-07-04,228,228,228,0,1671,1671,1669,2,0,0,0,0,228,228,228,228
Tehama,29,2022-07-04,131,131,131,0,821,821,819,2,3,2,2,0,210,210,208,208
Trinity,29,2022-07-04,17,17,17,0,143,144,143,1,2,0,0,0,20,20,20,20
Tulare,29,2022-07-04,947,947,945,2,6121,6125,6112,13,40,4,4,1,1516,1516,1512,1512
Tuolumne,29,2022-07-04,164,164,164,0,938,938,936,2,8,0,0,1,191,191,191,191
Ventura,29,2022-07-04,1948,1948,1946,2,15410,15421,15407,14,66,2,2,8,1528,1528,1526,1526
Yolo,29,2022-07-04,535,535,534,1,7258,7262,7253,9,6,3,3,2,370,370,367,367
Yuba,29,2022-07-04,168,168,168,0,1078,1078,1077,1,9,0,0,1,129,129,129,129
Alameda,30,2022-07-11,5797,5802,5797,5,48338,48375,48335,40,119,5,5,16,1928,1928,1923,1923
Amador,30,2022-07-11,92,92,92,0,1504,1504,1502,2,2,0,0,0,87,87,87,87
Butte,30,2022-07-11,497,497,497,0,3298,3299,3297,2,27,1,1,4,451,451,450,450
Calaveras,30,2022-07-11,78,78,78,0,566,566,565,1,0,1,1,1,129,129,128,128
Colusa,30,2022-07-11,26,26,26,0,483,484,483,1,0,0,0,0,22,22,22,22
Contra Costa,30,2022-07-11,3685,3686,3681,5,26541,26560,26523,37,91,11,11,11,1391,1391,1380,1380
Del Norte,30,2022-07-11,174,174,174,0,677,677,676,1,5,0,0,1,53,53,53,53
El Dorado,30,2022-07-11,384,384,384,0,3153,3154,3150,4,12,1,1,3,227,227,226,226
Fresno,30,2022-07-11,3661,3662,3657,5,21551,21567,21539,28,161,7,7,14,2805,2805,2798,2798
Glenn,30,2022-07-11,45,45,45,0,382,383,382,1,0,0,0,0,56,56,56,56
Humboldt,30,2022-07-11,290,290,290,0,2189,2189,2187,2,11,1,1,2,154,154,153,153
Imperial,30,2022-07-11,1118,1118,1117,1,4746,4749,4743,6,14,1,1,1,949,949,948,948
Inyo,30,2022-07-11,40,40,40,0,391,392,391,1,0,1,1,0,57,57,56,56
Kern,30,2022-07-11,2481,2481,2479,2,17068,17082,17065,17,77,2,2,9,2372,2372,2370,2370
Kings,30,2022-07-11,732,732,731,1,4341,4345,4340,5,11,4,4,0,456,456,452,452
Lake,30,2022-07-11,126,126,126,0,1115,1115,1113,2,0,0,0,0,142,142,142,142
Lassen,30,2022-07-11,59,59,59,0,821,821,820,1,2,1,1,0,63,63,62,62
Los Angeles,30,2022-07-11,43329,43362,43348,14,381203,381494,381369,125,1038,90,90,115,32477,32477,32387,32387
Madera,30,2022-07-11,532,532,531,1,4126,4130,4125,5,15,0,0,3,371,371,371,371
Marin,30,2022-07-11,603,603,602,1,5929,5934,5926,8,17,1,1,1,248,248,247,247
Mariposa,30,2022-07-11,52,52,52,0,283,284,283,1,0,0,0,0,28,28,28,28
Mendocino,30,2022-07-11,190,190,190,0,1387,1387,1385,2,4,0,0,0,133,133,133,133
Merced,30,2022-07-11,764,764,763,1,4273,4277,4273,4,16,5,5,1,840,840,835,835
Modoc,30,2022-07-11,28,28,28,0,57,58,57,1,0,1,1,0,10,10,9,9
Mono,30,2022-07-11,11,11,11,0,105,106,105,1,0,0,0,0,7,7,7,7
Monterey,30,2022-07-11,1093,1093,1091,2,7953,7958,7941,17,47,5,5,3,751,751,746,746
Napa,30,2022-07-11,372,372,372,0,3692,3695,3692,3,13,1,1,1,150,150,149,149
Nevada,30,2022-07-11,221,221,221,0,1826,1826,1824,2,7,0,0,1,134,134,134,134
Orange,30,2022-07-11,9812,9819,9811,8,64227,64275,64225,50,257,20,20,30,7266,7266,7246,7246
Placer,30,2022-07-11,784,784,783,1,5963,5968,5959,9,76,2,2,8,645,645,643,643
Plumas,30,2022-07-11,71,71,71,0,282,283,282,1,0,0,0,0,13,13,13,13
Riverside,30,2022-07-11,9213,9220,9211,9,52075,52114,52060,54,225,17,17,12,6531,6531,6514,6514
Sacramento,30,2022-07-11,4210,4213,4208,5,35517,35543,35503,40,184,22,22,24,3193,3193,3171,3171
San Benito,30,2022-07-11,235,235,235,0,1667,1667,1665,2,1,0,0,0,96,96,96,96
San Bernardino,30,2022-07-11,8439,8446,8439,7,57674,57717,57669,48,188,14,14,20,7922,7922,7908,7908
San Diego,30,2022-07-11,13665,13676,13671,5,85555,85620,85590,30,332,11,11,41,5437,5437,5426,5426
San Francisco,30,2022-07-11,2999,2999,2992,7,27845,27866,27802,64,105,11,11,23,956,956,945,945
San Joaquin,30,2022-07-11,2141,2141,2138,3,19356,19370,19346,24,55,7,7,11,2288,2288,2281,2281
San Luis Obispo,30,2022-07-11,754,754,753,1,5272,5277,5272,5,22,3,3,1,504,504,501,501
San Mateo,30,2022-07-11,2778,2778,2776,2,25663,25684,25664,20,42,6,6,4,738,738,732,732
Santa Barbara,30,2022-07-11,1326,1326,1325,1,9704,9712,9702,10,46,5,5,9,710,710,705,705
Santa Clara,30,2022-07-11,7402,7409,7406,3,59984,60029,60007,22,211,13,13,38,2423,2423,2410,2410
Santa Cruz,30,2022-07-11,1031,1031,1030,1,9513,9520,9511,9,16,0,0,0,267,267,267,267
Shasta,30,2022-07-11,328,328,328,0,3565,3567,3563,4,21,2,2,6,578,578,576,576
Siskiyou,30,2022-07-11,29,29,29,0,361,362,361,1,1,1,1,1,86,86,85,85
Solano,30,2022-07-11,1632,1632,1630,2,11658,11667,11655,12,40,1,1,6,454,454,453,453
Sonoma,30,2022-07-11,1300,1300,1299,1,9944,9951,9941,10,50,0,0,7,506,506,506,506
Stanislaus,30,2022-07-11,1494,1494,1492,2,8691,8697,8683,14,103,7,7,11,1724,1724,1717,1717
Sutter,30,2022-07-11,286,286,286,0,1777,1777,1775,2,0,0,0,0,228,228,228,228
Tehama,30,2022-07-11,133,133,133,0,925,925,924,1,5,0,0,1,210,210,210,210
Trinity,30,2022-07-11,35,35,35,0,120,121,120,1,0,0,0,0,20,20,20,20
Tulare,30,2022-07-11,1389,1389,1387,2,9608,9615,9599,16,47,4,4,2,1520,1520,1516,1516
Tuolumne,30,2022-07-11,253,253,253,0,1303,1303,1301,2,6,0,0,0,191,191,191,191
Ventura,30,2022-07-11,2552,2552,2550,2,19718,19733,19719,14,89,9,9,6,1537,1537,1528,1528
Yolo,30,2022-07-11,502,502,502,0,5418,5422,5417,5,4,3,3,4,373,373,370,370
Yuba,30,2022-07-11,217,217,217,0,1402,1402,1401,1,9,0,0,1,129,129,129,129
Alameda,31,2022-07-18,4947,4952,4949,3,42944,42979,42951,28,149,7,7,25,1935,1935,1928,1928
Amador,31,2022-07-18,85,85,85,0,1348,1348,1347,1,6,0,0,1,87,87,87,87
Butte,31,2022-07-18,335,335,335,0,2796,2797,2796,1,25,1,1,3,452,452,451,451
Calaveras,31,2022-07-18,78,78,78,0,545,546,545,1,0,0,0,0,129,129,129,129
Colusa,31,2022-07-18,23,23,23,0,349,350,349,1,2,0,0,0,22,22,22,22
Contra Costa,31,2022-07-18,3056,3056,3053,3,22717,22735,22710,25,88,4,4,16,1395,1395,1391,1391
Del Norte,31,2022-07-18,168,168,168,0,705,705,704,1,7,0,0,0,53,53,53,53
El Dorado,31,2022-07-18,279,279,279,0,2638,2638,2636,2,11,1,1,1,228,228,227,227
Fresno,31,2022-07-18,3705,3707,3703,4,21098,21117,21095,22,199,9,9,15,2814,2814,2805,2805
Glenn,31,2022-07-18,34,34,34,0,263,264,263,1,0,0,0,0,56,56,56,56
Humboldt,31,2022-07-18,293,293,293,0,2026,2026,2024,2,10,0,0,4,154,154,154,154
Imperial,31,2022-07-18,1025,1025,1024,1,4435,4440,4436,4,18,2,2,3,951,951,949,949
Inyo,31,2022-07-18,30,30,30,0,332,333,332,1,0,0,0,0,57,57,57,57
Kern,31,2022-07-18,2318,2318,2316,2,16584,16598,16586,12,72,10,10,14,2382,2382,2372,2372
Kings,31,2022-07-18,708,708,707,1,4154,4159,4155,4,16,1,1,0,457,457,456,456
Lake,31,2022-07-18,132,132,132,0,994,994,993,1,3,0,0,0,142,142,142,142
Lassen,31,2022-07-18,78,78,78,0,1239,1239,1238,1,1,0,0,0,63,63,63,63
Los Angeles,31,2022-07-18,41852,41888,41877,11,352178,352475,352385,90,1162,112,112,137,32589,32589,32477,32477
Madera,31,2022-07-18,530,530,529,1,3632,3635,3631,4,5,0,0,3,371,371,371,371
Marin,31,2022-07-18,516,516,515,1,5504,5509,5503,6,12,1,1,5,249,249,248,248
Mariposa,31,2022-07-18,42,42,42,0,242,243,242,1,0,1,1,0,29,29,28,28
Mendocino,31,2022-07-18,185,185,185,0,1491,1491,1489,2,6,0,0,2,133,133,133,133
Merced,31,2022-07-18,753,753,752,1,3982,3987,3984,3,15,1,1,1,841,841,840,840
Modoc,31,2022-07-18,13,13,13,0,34,35,34,1,1,0,0,0,10,10,10,10
Mono,31,2022-07-18,10,10,10,0,85,86,85,1,1,0,0,0,7,7,7,7
Monterey,31,2022-07-18,980,980,978,2,7190,7195,7183,12,46,6,6,4,757,757,751,751
Napa,31,2022-07-18,327,327,327,0,2974,2974,2972,2,10,2,2,2,152,152,150,150
Nevada,31,2022-07-18,135,135,135,0,1331,1331,1330,1,8,0,0,3,134,134,134,134
Orange,31,2022-07-18,8865,8872,8867,5,59858,59908,59872,36,253,24,24,45,7290,7290,7266,7266
Placer,31,2022-07-18,684,684,683,1,5240,5245,5239,6,89,1,1,5,646,646,645,645
Plumas,31,2022-07-18,60,60,60,0,279,280,279,1,0,0,0,0,13,13,13,13
Riverside,31,2022-07-18,8243,8250,8243,7,48076,48117,48078,39,222,16,16,17,6547,6547,6531,6531
Sacramento,31,2022-07-18,3543,3544,3541,3,30409,30435,30409,26,180,12,12,26,3205,3205,3193,3193
San Benito,31,2022-07-18,199,199,199,0,1588,1588,1587,1,1,2,2,0,98,98,96,96
San Bernardino,31,2022-07-18,8002,8009,8004,5,53747,53791,53756,35,214,13,13,35,7935,7935,7922,7922
San Diego,31,2022-07-18,13080,13092,13088,4,79860,79927,79905,22,402,18,18,52,5455,5455,5437,5437
San Francisco,31,2022-07-18,2488,2488,2484,4,25516,25538,25493,45,111,10,10,24,966,966,956,956
San Joaquin,31,2022-07-18,2054,2054,2052,2,18031,18045,18028,17,66,2,2,11,2290,2290,2288,2288
San Luis Obispo,31,2022-07-18,559,559,559,0,4627,4631,4628,3,17,3,3,1,507,507,504,504
San Mateo,31,2022-07-18,2290,2290,2289,1,23097,23117,23103,14,33,0,0,4,738,738,738,738
Santa Barbara,31,2022-07-18,1298,1298,1297,1,9272,9280,9272,8,47,1,1,6,711,711,710,710
Santa Clara,31,2022-07-18,6194,6201,6199,2,54689,54736,54720,16,199,12,12,30,2435,2435,2423,2423
Santa Cruz,31,2022-07-18,874,874,873,1,7449,7456,7451,5,24,1,1,2,268,268,267,267
Shasta,31,2022-07-18,320,320,320,0,3209,3211,3208,3,40,3,3,3,581,581,578,578
Siskiyou,31,2022-07-18,34,34,34,0,345,346,345,1,3,0,0,0,86,86,86,86
Solano,31,2022-07-18,1246,1246,1245,1,9543,9550,9542,8,49,1,1,6,455,455,454,454
Sonoma,31,2022-07-18,1055,1055,1054,1,8749,8755,8748,7,44,0,0,5,506,506,506,506
Stanislaus,31,2022-07-18,1394,1394,1392,2,8398,8404,8393,11,109,5,5,9,1729,1729,1724,1724
Sutter,31,2022-07-18,252,252,252,0,1673,1673,1672,1,0,0,0,0,228,228,228,228
Tehama,31,2022-07-18,109,109,109,0,896,896,895,1,7,2,2,0,212,212,210,210
Trinity,31,2022-07-18,20,20,20,0,111,112,111,1,1,0,0,0,20,20,20,20
Tulare,31,2022-07-18,1188,1188,1186,2,8115,8121,8111,10,45,0,0,0,1520,1520,1520,1520
Tuolumne,31,2022-07-18,238,238,238,0,1142,1142,1141,1,7,4,4,0,195,195,191,191
Ventura,31,2022-07-18,2324,2324,2323,1,19561,19577,19566,11,92,4,4,7,1541,1541,1537,1537
Yolo,31,2022-07-18,430,430,430,0,4653,4657,4654,3,2,3,3,1,376,376,373,373
Yuba,31,2022-07-18,213,213,213,0,1292,1292,1291,1,18,0,0,0,129,129,129,129
Alameda,32,2022-07-25,4409,4414,4412,2,40435,40474,40454,20,143,11,11,19,1946,1946,1935,1935
Amador,32,2022-07-25,90,90,90,0,1206,1206,1205,1,3,0,0,1,87,87,87,87
Butte,32,2022-07-25,359,359,359,0,2945,2948,2947,1,30,1,1,2,453,453,452,452
Calaveras,32,2022-07-25,82,82,82,0,558,559,558,1,0,2,2,1,131,131,129,129
Colusa,32,2022-07-25,26,26,26,0,373,374,373,1,1,0,0,0,22,22,22,22
Contra Costa,32,2022-07-25,2826,2827,2825,2,21983,22004,21985,19,102,7,7,18,1402,1402,1395,1395
Del Norte,32,2022-07-25,67,67,67,0,534,535,534,1,6,0,0,0,53,53,53,53
El Dorado,32,2022-07-25,270,270,270,0,2485,2486,2484,2,9,1,1,0,229,229,228,228
Fresno,32,2022-07-25,3359,3362,3359,3,20379,20398,20382,16,195,6,6,29,2820,2820,2814,2814
Glenn,32,2022-07-25,31,31,31,0,271,272,271,1,0,0,0,0,56,56,56,56
Humboldt,32,2022-07-25,230,230,230,0,1923,1923,1922,1,13,2,2,4,156,156,154,154
Imperial,32,2022-07-25,871,871,870,1,4338,4343,4340,3,18,1,1,6,952,952,951,951
Inyo,32,2022-07-25,18,18,18,0,284,285,284,1,2,1,1,0,58,58,57,57
Kern,32,2022-07-25,1930,1930,1929,1,15241,15256,15247,9,82,3,3,12,2385,2385,2382,2382
Kings,32,2022-07-25,571,571,571,0,3888,3892,3889,3,15,1,1,0,458,458,457,457
Lake,32,2022-07-25,128,128,128,0,1041,1041,1040,1,5,1,1,2,143,143,142,142
Lassen,32,2022-07-25,53,53,53,0,1071,1071,1070,1,1,0,0,0,63,63,63,63
Los Angeles,32,2022-07-25,37132,37167,37160,7,334178,334495,334428,67,1152,121,121,134,32710,32710,32589,32589
Madera,32,2022-07-25,539,539,539,0,3829,3834,3831,3,11,1,1,5,372,372,371,371
Marin,32,2022-07-25,489,489,489,0,5418,5423,5419,4,26,2,2,2,251,251,249,249
Mariposa,32,2022-07-25,40,40,40,0,232,233,232,1,0,0,0,0,29,29,29,29
Mendocino,32,2022-07-25,196,196,196,0,1426,1426,1424,2,6,0,0,0,133,133,133,133
Merced,32,2022-07-25,731,731,731,0,3917,3922,3920,2,22,2,2,2,843,843,841,841
Modoc,32,2022-07-25,5,5,5,0,28,29,28,1,0,1,1,0,11,11,10,10
Mono,32,2022-07-25,15,15,15,0,85,86,85,1,0,0,0,0,7,7,7,7
Monterey,32,2022-07-25,927,927,926,1,7143,7150,7141,9,39,1,1,3,758,758,757,757
Napa,32,2022-07-25,298,298,298,0,2946,2948,2946,2,6,3,3,0,155,155,152,152
Nevada,32,2022-07-25,116,116,116,0,1316,1316,1315,1,3,1,1,0,135,135,134,134
Orange,32,2022-07-25,8072,8079,8075,4,58193,58248,58221,27,306,37,37,35,7327,7327,7290,7290
Placer,32,2022-07-25,606,606,605,1,5086,5091,5087,4,77,5,5,11,651,651,646,646
Plumas,32,2022-07-25,25,25,25,0,188,189,188,1,0,0,0,0,13,13,13,13
Riverside,32,2022-07-25,7518,7525,7520,5,45941,45986,45957,29,259,16,16,27,6563,6563,6547,6547
Sacramento,32,2022-07-25,3633,3637,3635,2,29837,29864,29844,20,207,18,18,32,3223,3223,3205,3205
San Benito,32,2022-07-25,200,200,200,0,1836,1836,1835,1,0,1,1,0,99,99,98,98
San Bernardino,32,2022-07-25,7100,7107,7103,4,52149,52199,52173,26,214,30,30,23,7965,7965,7935,7935
San Diego,32,2022-07-25,11893,11905,11902,3,76181,76255,76239,16,393,19,19,41,5474,5474,5455,5455
San Francisco,32,2022-07-25,2297,2297,2294,3,24269,24293,24259,34,126,9,9,24,975,975,966,966
San Joaquin,32,2022-07-25,1838,1838,1837,1,16572,16587,16575,12,73,5,5,9,2295,2295,2290,2290
San Luis Obispo,32,2022-07-25,539,539,539,0,4382,4387,4384,3,16,4,4,1,511,511,507,507
San Mateo,32,2022-07-25,2030,2030,2029,1,21689,21710,21700,10,57,1,1,7,739,739,738,738
Santa Barbara,32,2022-07-25,1178,1178,1177,1,8770,8779,8773,6,37,4,4,3,715,715,711,711
Santa Clara,32,2022-07-25,5771,5778,5777,1,50882,50933,50922,11,238,16,16,26,2451,2451,2435,2435
Santa Cruz,32,2022-07-25,831,831,831,0,7664,7671,7667,4,23,0,0,0,268,268,268,268
Shasta,32,2022-07-25,306,306,306,0,3079,3082,3080,2,38,2,2,6,583,583,581,581
Siskiyou,32,2022-07-25,36,36,36,0,333,334,333,1,1,0,0,0,86,86,86,86
Solano,32,2022-07-25,1204,1204,1203,1,9486,9495,9489,6,56,0,0,5,455,455,455,455
Sonoma,32,2022-07-25,1066,1066,1065,1,8654,8662,8657,5,48,2,2,4,508,508,506,506
Stanislaus,32,2022-07-25,1377,1377,1376,1,8161,8169,8161,8,104,8,8,11,1737,1737,1729,1729
Sutter,32,2022-07-25,220,220,220,0,1723,1723,1722,1,0,0,0,0,228,228,228,228
Tehama,32,2022-07-25,104,104,104,0,920,920,919,1,5,2,2,0,214,214,212,212
Trinity,32,2022-07-25,12,12,12,0,102,103,102,1,0,0,0,0,20,20,20,20
Tulare,32,2022-07-25,1145,1145,1144,1,8045,8051,8043,8,42,2,2,2,1522,1522,1520,1520
Tuolumne,32,2022-07-25,200,200,200,0,1150,1150,1149,1,5,1,1,0,196,196,195,195
Ventura,32,2022-07-25,2153,2153,2152,1,18389,18407,18399,8,76,5,5,8,1546,1546,1541,1541
Yolo,32,2022-07-25,414,414,414,0,4390,4395,4393,2,4,3,3,1,379,379,376,376
Yuba,32,2022-07-25,175,175,175,0,1282,1282,1281,1,15,0,0,0,129,129,129,129
Alameda,33,2022-08-01,3824,3829,3828,1,37194,37234,37219,15,176,5,5,21,1951,1951,1946,1946
Amador,33,2022-08-01,53,53,53,0,1133,1133,1132,1,3,1,1,0,88,88,87,87
Butte,33,2022-08-01,368,368,368,0,2841,2844,2843,1,33,2,2,3,455,455,453,453
Calaveras,33,2022-08-01,68,68,68,0,573,574,573,1,2,1,1,2,132,132,131,131
Colusa,33,2022-08-01,26,26,26,0,362,363,362,1,7,0,0,0,22,22,22,22
Contra Costa,33,2022-08-01,2625,2626,2624,2,21020,21042,21028,14,86,13,13,15,1415,1415,1402,1402
Del Norte,33,2022-08-01,53,53,53,0,476,477,476,1,4,0,0,2,53,53,53,53
El Dorado,33,2022-08-01,232,232,232,0,2456,2457,2456,1,4,3,3,2,232,232,229,229
Fresno,33,2022-08-01,2999,3002,3000,2,18294,18314,18303,11,231,10,10,16,2830,2830,2820,2820
Glenn,33,2022-08-01,28,28,28,0,251,252,251,1,0,0,0,0,56,56,56,56
Humboldt,33,2022-08-01,224,224,224,0,1880,1880,1879,1,12,0,0,3,156,156,156,156
Imperial,33,2022-08-01,636,636,636,0,3526,3531,3529,2,22,5,5,3,957,957,952,952
Inyo,33,2022-08-01,20,20,20,0,280,281,280,1,2,0,0,0,58,58,58,58
Kern,33,2022-08-01,1729,1729,1728,1,15102,15119,15112,7,81,6,6,17,2391,2391,2385,2385
Kings,33,2022-08-01,624,624,624,0,4044,4049,4047,2,6,0,0,1,458,458,458,458
Lake,33,2022-08-01,125,125,125,0,994,994,993,1,7,0,0,2,143,143,143,143
Lassen,33,2022-08-01,103,103,103,0,947,948,947,1,0,0,0,0,63,63,63,63
Los Angeles,33,2022-08-01,30610,30643,30638,5,308972,309296,309248,48,1105,130,130,137,32840,32840,32710,32710
Madera,33,2022-08-01,463,463,463,0,3482,3486,3484,2,10,0,0,7,372,372,372,372
Marin,33,2022-08-01,411,411,411,0,5134,5139,5136,3,32,1,1,4,252,252,251,251
Mariposa,33,2022-08-01,22,22,22,0,225,226,225,1,0,0,0,0,29,29,29,29
Mendocino,33,2022-08-01,174,174,174,0,1257,1257,1256,1,6,1,1,1,134,134,133,133
Merced,33,2022-08-01,643,643,643,0,3567,3572,3570,2,22,6,6,2,849,849,843,843
Modoc,33,2022-08-01,16,16,16,0,31,32,31,1,0,0,0,0,11,11,11,11
Mono,33,2022-08-01,9,9,9,0,67,68,67,1,0,0,0,0,7,7,7,7
Monterey,33,2022-08-01,928,928,927,1,6429,6435,6429,6,33,2,2,1,760,760,758,758
Napa,33,2022-08-01,287,287,287,0,2853,2856,2855,1,8,0,0,2,155,155,155,155
Nevada,33,2022-08-01,125,125,125,0,1404,1404,1403,1,12,0,0,0,135,135,135,135
Orange,33,2022-08-01,6554,6561,6559,2,52468,52524,52505,19,246,34,34,49,7361,7361,7327,7327
Placer,33,2022-08-01,588,588,588,0,4744,4749,4746,3,71,1,1,11,652,652,651,651
Plumas,33,2022-08-01,23,23,23,0,162,163,162,1,0,0,0,0,13,13,13,13
Riverside,33,2022-08-01,6128,6135,6132,3,42292,42334,42313,21,200,5,5,23,6568,6568,6563,6563
Sacramento,33,2022-08-01,3097,3100,3098,2,27845,27875,27860,15,179,18,18,26,3241,3241,3223,3223
San Benito,33,2022-08-01,173,173,173,0,1562,1562,1561,1,2,1,1,0,100,100,99,99
San Bernardino,33,2022-08-01,6071,6078,6076,2,48925,48975,48956,19,184,26,26,23,7991,7991,7965,7965
San Diego,33,2022-08-01,9366,9376,9374,2,68651,68722,68711,11,396,16,16,46,5490,5490,5474,5474
San Francisco,33,2022-08-01,1814,1814,1812,2,21993,22017,21993,24,105,13,13,20,988,988,975,975
San Joaquin,33,2022-08-01,1735,1735,1734,1,16114,16131,16122,9,69,7,7,11,2302,2302,2295,2295
San Luis Obispo,33,2022-08-01,578,578,578,0,4141,4146,4144,2,14,3,3,0,514,514,511,511
San Mateo,33,2022-08-01,1774,1774,1773,1,20333,20354,20347,7,67,1,1,3,740,740,739,739
Santa Barbara,33,2022-08-01,1119,1119,1118,1,7779,7787,7783,4,40,1,1,3,716,716,715,715
Santa Clara,33,2022-08-01,4827,4834,4833,1,45490,45538,45530,8,230,19,19,36,2470,2470,2451,2451
Santa Cruz,33,2022-08-01,748,748,748,0,6877,6884,6881,3,20,1,1,3,269,269,268,268
Shasta,33,2022-08-01,247,247,247,0,2968,2971,2969,2,34,2,2,7,585,585,583,583
Siskiyou,33,2022-08-01,29,29,29,0,298,299,298,1,2,0,0,0,86,86,86,86
Solano,33,2022-08-01,1146,1146,1145,1,9147,9157,9152,5,53,0,0,4,455,455,455,455
Sonoma,33,2022-08-01,921,921,921,0,8186,8194,8190,4,46,3,3,3,511,511,508,508
Stanislaus,33,2022-08-01,1233,1233,1232,1,7721,7729,7723,6,115,6,6,8,1743,1743,1737,1737
Sutter,33,2022-08-01,230,230,230,0,1634,1635,1634,1,0,3,3,0,231,231,228,228
Tehama,33,2022-08-01,88,88,88,0,757,757,756,1,4,0,0,0,214,214,214,214
Trinity,33,2022-08-01,11,11,11,0,71,72,71,1,0,1,1,0,21,21,20,20
Tulare,33,2022-08-01,1034,1034,1033,1,7478,7485,7479,6,46,1,1,3,1523,1523,1522,1522
Tuolumne,33,2022-08-01,144,144,144,0,1111,1111,1110,1,4,0,0,1,196,196,196,196
Ventura,33,2022-08-01,1808,1808,1807,1,16970,16988,16982,6,75,10,10,10,1556,1556,1546,1546
Yolo,33,2022-08-01,332,332,332,0,4177,4181,4179,2,3,3,3,1,382,382,379,379
Yuba,33,2022-08-01,158,158,158,0,1215,1215,1214,1,10,0,0,3,129,129,129,129
Alameda,34,2022-08-08,3320,3325,3324,1,35425,35464,35453,11,133,11,11,20,1962,1962,1951,1951
Amador,34,2022-08-08,50,50,50,0,852,853,852,1,3,0,0,1,88,88,88,88
Butte,34,2022-08-08,333,333,333,0,2494,2497,2496,1,33,1,1,1,456,456,455,455
Calaveras,34,2022-08-08,57,57,57,0,559,560,559,1,1,1,1,0,133,133,132,132
Colusa,34,2022-08-08,15,15,15,0,362,363,362,1,0,0,0,0,22,22,22,22
Contra Costa,34,2022-08-08,2173,2173,2172,1,19800,19823,19813,10,102,4,4,14,1419,1419,1415,1415
Del Norte,34,2022-08-08,49,49,49,0,498,499,498,1,4,1,1,1,54,54,53,53
El Dorado,34,2022-08-08,191,191,191,0,2317,2319,2318,1,4,0,0,2,232,232,232,232
Fresno,34,2022-08-08,2420,2420,2419,1,17743,17764,17755,9,207,9,9,25,2839,2839,2830,2830
Glenn,34,2022-08-08,22,22,22,0,249,250,249,1,0,0,0,0,56,56,56,56
Humboldt,34,2022-08-08,208,208,208,0,1920,1920,1919,1,12,1,1,2,157,157,156,156
Imperial,34,2022-08-08,548,548,548,0,3279,3283,3282,1,16,2,2,2,959,959,957,957
Inyo,34,2022-08-08,8,8,8,0,276,277,276,1,1,0,0,1,58,58,58,58
Kern,34,2022-08-08,1339,1339,1339,0,13982,13997,13992,5,61,6,6,16,2397,2397,2391,2391
Kings,34,2022-08-08,467,467,467,0,3326,3331,3330,1,20,1,1,2,459,459,458,458
Lake,34,2022-08-08,106,106,106,0,893,894,893,1,4,0,0,1,143,143,143,143
Lassen,34,2022-08-08,132,132,132,0,1023,1024,1023,1,1,1,1,0,64,64,63,63
Los Angeles,34,2022-08-08,25795,25823,25820,3,293425,293750,293715,35,1030,129,129,121,32969,32969,32840,32840
Madera,34,2022-08-08,380,380,380,0,3175,3179,3177,2,16,0,0,3,372,372,372,372
Marin,34,2022-08-08,361,361,361,0,4485,4490,4488,2,26,2,2,2,254,254,252,252
Mariposa,34,2022-08-08,28,28,28,0,197,198,197,1,0,0,0,0,29,29,29,29
Mendocino,34,2022-08-08,132,132,132,0,1128,1128,1127,1,3,1,1,1,135,135,134,134
Merced,34,2022-08-08,538,538,538,0,3397,3402,3401,1,17,1,1,5,850,850,849,849
Modoc,34,2022-08-08,2,2,2,0,22,23,22,1,0,0,0,0,11,11,11,11
Mono,34,2022-08-08,10,10,10,0,85,86,85,1,0,0,0,0,7,7,7,7
Monterey,34,2022-08-08,733,733,732,1,5773,5779,5775,4,28,1,1,0,761,761,760,760
Napa,34,2022-08-08,262,262,262,0,2628,2631,2630,1,10,2,2,3,157,157,155,155
Nevada,34,2022-08-08,93,93,93,0,1290,1290,1289,1,4,0,0,0,135,135,135,135
Orange,34,2022-08-08,5477,5484,5482,2,49032,49087,49073,14,242,29,29,40,7390,7390,7361,7361
Placer,34,2022-08-08,513,513,513,0,4519,4524,4522,2,65,3,3,9,655,655,652,652
Plumas,34,2022-08-08,23,23,23,0,190,191,190,1,1,0,0,0,13,13,13,13
Riverside,34,2022-08-08,5568,5575,5573,2,40853,40898,40882,16,174,13,13,13,6581,6581,6568,6568
Sacramento,34,2022-08-08,2626,2627,2626,1,26973,27004,26993,11,156,17,17,20,3258,3258,3241,3241
San Benito,34,2022-08-08,185,185,185,0,1433,1434,1433,1,1,0,0,0,100,100,100,100
San Bernardino,34,2022-08-08,5112,5119,5117,2,46298,46349,46335,14,204,20,20,15,8011,8011,7991,7991
San Diego,34,2022-08-08,7270,7278,7277,1,64801,64873,64865,8,337,12,12,30,5502,5502,5490,5490
San Francisco,34,2022-08-08,1495,1495,1494,1,20638,20662,20645,17,94,11,11,21,999,999,988,988
San Joaquin,34,2022-08-08,1523,1523,1522,1,15717,15734,15727,7,55,7,7,12,2309,2309,2302,2302
San Luis Obispo,34,2022-08-08,509,509,509,0,3614,3619,3618,1,14,0,0,2,514,514,514,514
San Mateo,34,2022-08-08,1527,1527,1527,0,18587,18608,18603,5,60,0,0,5,740,740,740,740
Santa Barbara,34,2022-08-08,964,964,964,0,7525,7535,7532,3,46,3,3,4,719,719,716,716
Santa Clara,34,2022-08-08,4184,4191,4190,1,41197,41245,41239,6,203,18,18,40,2488,2488,2470,2470
Santa Cruz,34,2022-08-08,619,619,619,0,6060,6067,6065,2,28,1,1,0,270,270,269,269
Shasta,34,2022-08-08,198,198,198,0,2833,2836,2835,1,33,2,2,3,587,587,585,585
Siskiyou,34,2022-08-08,28,28,28,0,291,292,291,1,0,1,1,0,87,87,86,86
Solano,34,2022-08-08,883,883,883,0,7970,7978,7975,3,54,0,0,9,455,455,455,455
Sonoma,34,2022-08-08,840,840,840,0,7727,7736,7733,3,34,4,4,3,515,515,511,511
Stanislaus,34,2022-08-08,1035,1035,1034,1,7176,7184,7180,4,90,7,7,11,1750,1750,1743,1743
Sutter,34,2022-08-08,222,222,222,0,1552,1553,1552,1,0,0,0,0,231,231,231,231
Tehama,34,2022-08-08,78,78,78,0,681,682,681,1,0,0,0,1,214,214,214,214
Trinity,34,2022-08-08,5,5,5,0,71,72,71,1,0,0,0,0,21,21,21,21
Tulare,34,2022-08-08,886,886,885,1,7339,7347,7343,4,46,4,4,3,1527,1527,1523,1523
Tuolumne,34,2022-08-08,118,118,118,0,1054,1054,1053,1,4,2,2,0,198,198,196,196
Ventura,34,2022-08-08,1503,1503,1503,0,15933,15951,15947,4,67,7,7,7,1563,1563,1556,1556
Yolo,34,2022-08-08,287,287,287,0,3882,3886,3885,1,4,1,1,3,383,383,382,382
Yuba,34,2022-08-08,136,136,136,0,1086,1087,1086,1,6,1,1,0,130,130,129,129
Alameda,35,2022-08-15,2595,2597,2596,1,33885,33925,33917,8,105,9,9,22,1971,1971,1962,1962
Amador,35,2022-08-15,47,47,47,0,848,849,848,1,2,0,0,0,88,88,88,88
Butte,35,2022-08-15,262,262,262,0,2245,2248,2247,1,19,0,0,2,456,456,456,456
Calaveras,35,2022-08-15,46,46,46,0,528,529,528,1,0,0,0,0,133,133,133,133
Colusa,35,2022-08-15,16,16,16,0,359,360,359,1,1,0,0,0,22,22,22,22
Contra Costa,35,2022-08-15,1777,1777,1776,1,18971,18994,18986,8,72,7,7,9,1426,1426,1419,1419
Del Norte,35,2022-08-15,53,53,53,0,499,500,499,1,2,0,0,1,54,54,54,54
El Dorado,35,2022-08-15,178,178,178,0,2304,2306,2305,1,5,0,0,3,232,232,232,232
Fresno,35,2022-08-15,1871,1871,1870,1,16163,16181,16175,6,170,7,7,17,2846,2846,2839,2839
Glenn,35,2022-08-15,15,15,15,0,225,226,225,1,3,0,0,0,56,56,56,56
Humboldt,35,2022-08-15,179,179,179,0,1587,1588,1587,1,16,0,0,2,157,157,157,157
Imperial,35,2022-08-15,365,365,365,0,3101,3106,3105,1,11,0,0,2,959,959,959,959
Inyo,35,2022-08-15,14,14,14,0,238,239,238,1,2,1,1,0,59,59,58,58
Kern,35,2022-08-15,1238,1238,1238,0,13701,13716,13712,4,59,7,7,16,2404,2404,2397,2397
Kings,35,2022-08-15,332,332,332,0,3235,3240,3239,1,9,0,0,1,459,459,459,459
Lake,35,2022-08-15,104,104,104,0,1028,1029,1028,1,3,1,1,2,144,144,143,143
Lassen,35,2022-08-15,59,59,59,0,898,899,898,1,0,0,0,0,64,64,64,64
Los Angeles,35,2022-08-15,20955,20980,20978,2,289579,289921,289894,27,905,110,110,117,33079,33079,32969,32969
Madera,35,2022-08-15,305,305,305,0,2954,2958,2957,1,12,0,0,3,372,372,372,372
Marin,35,2022-08-15,295,295,295,0,4114,4119,4117,2,15,0,0,0,254,254,254,254
Mariposa,35,2022-08-15,15,15,15,0,192,193,192,1,0,0,0,0,29,29,29,29
Mendocino,35,2022-08-15,104,104,104,0,996,996,995,1,7,0,0,3,135,135,135,135
Merced,35,2022-08-15,453,453,453,0,3427,3432,3431,1,12,2,2,1,852,852,850,850
Modoc,35,2022-08-15,4,4,4,0,23,24,23,1,0,0,0,0,11,11,11,11
Mono,35,2022-08-15,4,4,4,0,61,62,61,1,0,0,0,0,7,7,7,7
Monterey,35,2022-08-15,662,662,662,0,5824,5830,5827,3,30,0,0,1,761,761,761,761
Napa,35,2022-08-15,212,212,212,0,2291,2293,2292,1,13,0,0,0,157,157,157,157
Nevada,35,2022-08-15,98,98,98,0,1209,1210,1209,1,7,0,0,0,135,135,135,135
Orange,35,2022-08-15,4683,4689,4688,1,43771,43823,43813,10,270,31,31,44,7421,7421,7390,7390
Placer,35,2022-08-15,411,411,411,0,4469,4475,4473,2,61,1,1,11,656,656,655,655
Plumas,35,2022-08-15,17,17,17,0,184,185,184,1,0,0,0,0,13,13,13,13
Riverside,35,2022-08-15,4600,4607,4606,1,38263,38308,38297,11,143,16,16,22,6597,6597,6581,6581
Sacramento,35,2022-08-15,2359,2360,2359,1,25434,25466,25458,8,149,12,12,22,3270,3270,3258,3258
San Benito,35,2022-08-15,138,138,138,0,1336,1337,1336,1,3,1,1,1,101,101,100,100
San Bernardino,35,2022-08-15,4738,4744,4743,1,44509,44560,44549,11,144,15,15,22,8026,8026,8011,8011
San Diego,35,2022-08-15,5503,5510,5509,1,59795,59866,59860,6,288,14,14,34,5516,5516,5502,5502
San Francisco,35,2022-08-15,1267,1267,1266,1,19590,19614,19601,13,103,15,15,11,1014,1014,999,999
San Joaquin,35,2022-08-15,1444,1444,1443,1,15217,15234,15229,5,64,8,8,8,2317,2317,2309,2309
San Luis Obispo,35,2022-08-15,325,325,325,0,3302,3307,3306,1,15,4,4,3,518,518,514,514
San Mateo,35,2022-08-15,1236,1236,1236,0,17463,17483,17479,4,56,1,1,5,741,741,740,740
Santa Barbara,35,2022-08-15,831,831,831,0,7130,7139,7137,2,44,1,1,4,720,720,719,719
Santa Clara,35,2022-08-15,3398,3403,3403,0,40109,40156,40152,4,200,9,9,24,2497,2497,2488,2488
Santa Cruz,35,2022-08-15,492,492,492,0,7545,7554,7552,2,23,3,3,1,273,273,270,270
Shasta,35,2022-08-15,194,194,194,0,2788,2791,2790,1,19,1,1,1,588,588,587,587
Siskiyou,35,2022-08-15,19,19,19,0,284,285,284,1,3,1,1,1,88,88,87,87
Solano,35,2022-08-15,662,662,662,0,7461,7471,7469,2,45,0,0,10,455,455,455,455
Sonoma,35,2022-08-15,632,632,632,0,7289,7298,7296,2,39,2,2,2,517,517,515,515
Stanislaus,35,2022-08-15,940,940,940,0,7659,7667,7663,4,99,9,9,11,1759,1759,1750,1750
Sutter,35,2022-08-15,197,197,197,0,1587,1589,1588,1,0,1,1,0,232,232,231,231
Tehama,35,2022-08-15,61,61,61,0,645,646,645,1,1,0,0,0,214,214,214,214
Trinity,35,2022-08-15,8,8,8,0,58,59,58,1,0,0,0,0,21,21,21,21
Tulare,35,2022-08-15,738,738,738,0,7348,7356,7353,3,32,3,3,1,1530,1530,1527,1527
Tuolumne,35,2022-08-15,110,110,110,0,991,992,991,1,1,0,0,0,198,198,198,198
Ventura,35,2022-08-15,1494,1494,1494,0,15264,15282,15279,3,70,6,6,7,1569,1569,1563,1563
Yolo,35,2022-08-15,264,264,264,0,3539,3543,3542,1,2,4,4,1,387,387,383,383
Yuba,35,2022-08-15,128,128,128,0,1080,1081,1080,1,9,0,0,0,130,130,130,130
Alameda,36,2022-08-22,2265,2266,2266,0,33318,33360,33354,6,117,7,7,21,1978,1978,1971,1971
Amador,36,2022-08-22,49,49,49,0,817,818,817,1,2,1,1,0,89,89,88,88
Butte,36,2022-08-22,222,222,222,0,2131,2134,2133,1,17,1,1,2,457,457,456,456
Calaveras,36,2022-08-22,43,43,43,0,572,573,572,1,1,0,0,0,133,133,133,133
Colusa,36,2022-08-22,16,16,16,0,394,395,394,1,0,0,0,0,22,22,22,22
Contra Costa,36,2022-08-22,1530,1530,1530,0,18846,18869,18863,6,56,5,5,9,1431,1431,1426,1426
Del Norte,36,2022-08-22,32,32,32,0,462,463,462,1,3,1,1,0,55,55,54,54
El Dorado,36,2022-08-22,152,152,152,0,2220,2222,2221,1,4,1,1,0,233,233,232,232
Fresno,36,2022-08-22,1597,1597,1597,0,15770,15790,15785,5,162,6,6,14,2852,2852,2846,2846
Glenn,36,2022-08-22,23,23,23,0,227,228,227,1,1,0,0,0,56,56,56,56
Humboldt,36,2022-08-22,151,151,151,0,1679,1680,1679,1,6,1,1,3,158,158,157,157
Imperial,36,2022-08-22,291,291,291,0,2844,2847,2846,1,15,0,0,0,959,959,959,959
Inyo,36,2022-08-22,8,8,8,0,214,215,214,1,0,0,0,0,59,59,59,59
Kern,36,2022-08-22,999,999,999,0,13976,13993,13990,3,69,6,6,10,2410,2410,2404,2404
Kings,36,2022-08-22,369,369,369,0,3636,3641,3640,1,10,2,2,0,461,461,459,459
Lake,36,2022-08-22,104,104,104,0,884,885,884,1,5,0,0,0,144,144,144,144
Lassen,36,2022-08-22,37,37,37,0,834,835,834,1,0,0,0,0,64,64,64,64
Los Angeles,36,2022-08-22,18497,18519,18518,1,276850,277188,277168,20,811,122,122,104,33201,33201,33079,33079
Madera,36,2022-08-22,300,300,300,0,2613,2617,2616,1,14,2,2,4,374,374,372,372
Marin,36,2022-08-22,250,250,250,0,3968,3973,3972,1,17,0,0,3,254,254,254,254
Mariposa,36,2022-08-22,14,14,14,0,172,173,172,1,0,0,0,0,29,29,29,29
Mendocino,36,2022-08-22,121,121,121,0,1145,1146,1145,1,3,0,0,2,135,135,135,135
Merced,36,2022-08-22,447,447,447,0,3660,3665,3664,1,12,4,4,1,856,856,852,852
Modoc,36,2022-08-22,6,6,6,0,27,28,27,1,0,0,0,0,11,11,11,11
Mono,36,2022-08-22,4,4,4,0,63,64,63,1,0,0,0,0,7,7,7,7
Monterey,36,2022-08-22,548,548,548,0,5928,5935,5932,3,27,1,1,2,762,762,761,761
Napa,36,2022-08-22,127,127,127,0,2010,2012,2011,1,5,2,2,1,159,159,157,157
Nevada,36,2022-08-22,84,84,84,0,1180,1181,1180,1,6,0,0,0,135,135,135,135
Orange,36,2022-08-22,3926,3931,3930,1,41465,41516,41509,7,224,21,21,35,7442,7442,7421,7421
Placer,36,2022-08-22,384,384,384,0,4307,4313,4312,1,61,1,1,14,657,657,656,656
Plumas,36,2022-08-22,20,20,20,0,175,176,175,1,1,0,0,0,13,13,13,13
Riverside,36,2022-08-22,4421,4428,4427,1,37725,37770,37761,9,142,14,14,19,6611,6611,6597,6597
Sacramento,36,2022-08-22,2089,2089,2088,1,25029,25060,25054,6,144,15,15,25,3285,3285,3270,3270
San Benito,36,2022-08-22,101,101,101,0,1268,1269,1268,1,1,1,1,1,102,102,101,101
San Bernardino,36,2022-08-22,4696,4703,4702,1,44669,44724,44716,8,160,18,18,22,8044,8044,8026,8026
San Diego,36,2022-08-22,4782,4788,4788,0,57816,57886,57882,4,287,6,6,28,5522,5522,5516,5516
San Francisco,36,2022-08-22,1097,1097,1096,1,18878,18901,18891,10,81,16,16,12,1030,1030,1014,1014
San Joaquin,36,2022-08-22,1195,1195,1195,0,15725,15744,15740,4,56,1,1,8,2318,2318,2317,2317
San Luis Obispo,36,2022-08-22,259,259,259,0,3090,3095,3094,1,16,1,1,0,519,519,518,518
San Mateo,36,2022-08-22,1028,1028,1028,0,17321,17341,17338,3,42,0,0,2,741,741,741,741
Santa Barbara,36,2022-08-22,736,736,736,0,7443,7452,7450,2,37,1,1,2,721,721,720,720
Santa Clara,36,2022-08-22,3079,3084,3084,0,40561,40609,40606,3,173,10,10,27,2507,2507,2497,2497
Santa Cruz,36,2022-08-22,502,502,502,0,11965,11979,11977,2,13,0,0,0,273,273,273,273
Shasta,36,2022-08-22,174,174,174,0,2760,2763,2762,1,10,2,2,2,590,590,588,588
Siskiyou,36,2022-08-22,25,25,25,0,249,250,249,1,4,1,1,2,89,89,88,88
Solano,36,2022-08-22,535,535,535,0,7222,7231,7229,2,35,0,0,12,455,455,455,455
Sonoma,36,2022-08-22,606,606,606,0,7374,7384,7382,2,42,2,2,1,519,519,517,517
Stanislaus,36,2022-08-22,894,894,894,0,7652,7662,7659,3,79,7,7,16,1766,1766,1759,1759
Sutter,36,2022-08-22,187,187,187,0,1657,1659,1658,1,0,0,0,0,232,232,232,232
Tehama,36,2022-08-22,53,53,53,0,629,630,629,1,1,0,0,0,214,214,214,214
Trinity,36,2022-08-22,10,10,10,0,63,64,63,1,0,0,0,0,21,21,21,21
Tulare,36,2022-08-22,731,731,731,0,6804,6812,6810,2,33,4,4,1,1534,1534,1530,1530
Tuolumne,36,2022-08-22,106,106,106,0,1018,1019,1018,1,0,1,1,0,199,199,198,198
Ventura,36,2022-08-22,1319,1319,1319,0,15002,15020,15018,2,59,4,4,9,1573,1573,1569,1569
Yolo,36,2022-08-22,200,200,200,0,3493,3497,3496,1,10,1,1,1,388,388,387,387
Yuba,36,2022-08-22,127,127,127,0,1106,1107,1106,1,13,0,0,3,130,130,130,130
Alameda,37,2022-08-29,2003,2003,2003,0,34351,34396,34391,5,99,10,10,20,1988,1988,1978,1978
Amador,37,2022-08-29,46,46,46,0,804,805,804,1,2,1,1,0,90,90,89,89
Butte,37,2022-08-29,236,236,236,0,2173,2175,2174,1,18,0,0,3,457,457,457,457
Calaveras,37,2022-08-29,59,59,59,0,593,594,593,1,1,0,0,0,133,133,133,133
Colusa,37,2022-08-29,11,11,11,0,329,330,329,1,3,0,0,0,22,22,22,22
Contra Costa,37,2022-08-29,1361,1361,1361,0,18808,18833,18828,5,44,5,5,7,1436,1436,1431,1431
Del Norte,37,2022-08-29,28,28,28,0,432,433,432,1,5,0,0,1,55,55,55,55
El Dorado,37,2022-08-29,142,142,142,0,1947,1949,1948,1,1,0,0,1,233,233,233,233
Fresno,37,2022-08-29,1419,1419,1419,0,15723,15743,15739,4,159,3,3,15,2855,2855,2852,2852
Glenn,37,2022-08-29,22,22,22,0,220,221,220,1,1,0,0,0,56,56,56,56
Humboldt,37,2022-08-29,122,122,122,0,1664,1665,1664,1,4,0,0,0,158,158,158,158
Imperial,37,2022-08-29,294,294,294,0,2936,2941,2940,1,14,1,1,2,960,960,959,959
Inyo,37,2022-08-29,8,8,8,0,176,177,176,1,0,0,0,0,59,59,59,59
Kern,37,2022-08-29,906,906,906,0,13447,13464,13462,2,50,0,0,8,2410,2410,2410,2410
Kings,37,2022-08-29,314,314,314,0,3490,3495,3494,1,8,0,0,0,461,461,461,461
Lake,37,2022-08-29,93,93,93,0,870,871,870,1,1,1,1,0,145,145,144,144
Lassen,37,2022-08-29,28,28,28,0,772,773,772,1,0,0,0,0,64,64,64,64
Los Angeles,37,2022-08-29,15574,15594,15593,1,273811,274154,274138,16,753,87,87,83,33288,33288,33201,33201
Madera,37,2022-08-29,302,302,302,0,3019,3023,3022,1,13,0,0,3,374,374,374,374
Marin,37,2022-08-29,215,215,215,0,3848,3853,3852,1,16,2,2,2,256,256,254,254
Mariposa,37,2022-08-29,25,25,25,0,186,187,186,1,0,0,0,0,29,29,29,29
Mendocino,37,2022-08-29,87,87,87,0,969,970,969,1,2,0,0,1,135,135,135,135
Merced,37,2022-08-29,393,393,393,0,3418,3423,3422,1,11,3,3,0,859,859,856,856
Modoc,37,2022-08-29,1,1,1,0,30,31,30,1,0,0,0,0,11,11,11,11
Mono,37,2022-08-29,2,2,2,0,45,46,45,1,0,0,0,0,7,7,7,7
Monterey,37,2022-08-29,394,394,394,0,5382,5388,5386,2,33,2,2,5,764,764,762,762
Napa,37,2022-08-29,130,130,130,0,2168,2171,2170,1,10,0,0,1,159,159,159,159
Nevada,37,2022-08-29,116,116,116,0,1206,1207,1206,1,6,0,0,0,135,135,135,135
Orange,37,2022-08-29,3064,3069,3069,0,39991,40041,40036,5,195,18,18,25,7460,7460,7442,7442
Placer,37,2022-08-29,370,370,370,0,4217,4223,4222,1,55,1,1,12,658,658,657,657
Plumas,37,2022-08-29,17,17,17,0,159,160,159,1,1,0,0,0,13,13,13,13
Riverside,37,2022-08-29,3677,3682,3681,1,37023,37070,37063,7,124,9,9,11,6620,6620,6611,6611
Sacramento,37,2022-08-29,1881,1881,1881,0,24822,24854,24849,5,137,11,11,20,3296,3296,3285,3285
San Benito,37,2022-08-29,120,120,120,0,1411,1412,1411,1,1,0,0,0,102,102,102,102
San Bernardino,37,2022-08-29,3681,3686,3685,1,42586,42638,42632,6,156,14,14,18,8058,8058,8044,8044
San Diego,37,2022-08-29,3932,3938,3938,0,56925,56997,56994,3,222,12,12,25,5534,5534,5522,5522
San Francisco,37,2022-08-29,872,872,872,0,19155,19179,19171,8,57,7,7,12,1037,1037,1030,1030
San Joaquin,37,2022-08-29,1005,1005,1005,0,14298,14315,14312,3,27,5,5,11,2323,2323,2318,2318
San Luis Obispo,37,2022-08-29,326,326,326,0,3217,3222,3221,1,17,3,3,0,522,522,519,519
San Mateo,37,2022-08-29,872,872,872,0,16902,16923,16921,2,26,0,0,5,741,741,741,741
Santa Barbara,37,2022-08-29,638,638,638,0,7627,7638,7637,1,24,1,1,3,722,722,721,721
Santa Clara,37,2022-08-29,2357,2359,2359,0,40002,40053,40050,3,135,5,5,24,2512,2512,2507,2507
Santa Cruz,37,2022-08-29,384,384,384,0,12684,12701,12699,2,16,0,0,1,273,273,273,273
Shasta,37,2022-08-29,132,132,132,0,2578,2581,2580,1,19,1,1,1,591,591,590,590
Siskiyou,37,2022-08-29,24,24,24,0,249,250,249,1,0,1,1,0,90,90,89,89
Solano,37,2022-08-29,550,550,550,0,7291,7299,7298,1,33,2,2,8,457,457,455,455
Sonoma,37,2022-08-29,487,487,487,0,7108,7117,7116,1,37,1,1,4,520,520,519,519
Stanislaus,37,2022-08-29,850,850,850,0,8085,8095,8093,2,79,7,7,6,1773,1773,1766,1766
Sutter,37,2022-08-29,169,169,169,0,1638,1640,1639,1,0,0,0,0,232,232,232,232
Tehama,37,2022-08-29,67,67,67,0,738,739,738,1,4,0,0,1,214,214,214,214
Trinity,37,2022-08-29,9,9,9,0,56,57,56,1,0,0,0,0,21,21,21,21
Tulare,37,2022-08-29,682,682,682,0,7395,7403,7401,2,42,0,0,1,1534,1534,1534,1534
Tuolumne,37,2022-08-29,90,90,90,0,856,857,856,1,1,0,0,0,199,199,199,199
Ventura,37,2022-08-29,1021,1021,1021,0,14607,14625,14623,2,71,6,6,7,1579,1579,1573,1573
Yolo,37,2022-08-29,204,204,204,0,3717,3722,3721,1,5,0,0,3,388,388,388,388
Yuba,37,2022-08-29,135,135,135,0,1176,1177,1176,1,14,0,0,1,130,130,130,130
Alameda,38,2022-09-05,1468,1468,1468,0,28345,28382,28379,3,89,3,3,16,1991,1991,1988,1988
Amador,38,2022-09-05,44,44,44,0,748,749,748,1,3,0,0,2,90,90,90,90
Butte,38,2022-09-05,193,193,193,0,2125,2129,2128,1,14,2,2,2,459,459,457,457
Calaveras,38,2022-09-05,22,22,22,0,452,453,452,1,0,0,0,0,133,133,133,133
Colusa,38,2022-09-05,8,8,8,0,197,198,197,1,2,0,0,0,22,22,22,22
Contra Costa,38,2022-09-05,954,954,954,0,15436,15457,15454,3,62,5,5,9,1441,1441,1436,1436
Del Norte,38,2022-09-05,9,9,9,0,347,348,347,1,1,0,0,1,55,55,55,55
El Dorado,38,2022-09-05,91,91,91,0,1524,1525,1524,1,3,1,1,3,234,234,233,233
Fresno,38,2022-09-05,1087,1087,1087,0,13046,13064,13062,2,162,10,10,16,2865,2865,2855,2855
Glenn,38,2022-09-05,11,11,11,0,188,189,188,1,1,0,0,0,56,56,56,56
Humboldt,38,2022-09-05,110,110,110,0,1295,1296,1295,1,9,1,1,2,159,159,158,158
Imperial,38,2022-09-05,235,235,235,0,2522,2526,2525,1,8,1,1,2,961,961,960,960
Inyo,38,2022-09-05,12,12,12,0,139,140,139,1,0,0,0,1,59,59,59,59
Kern,38,2022-09-05,739,739,739,0,11391,11406,11404,2,50,5,5,8,2415,2415,2410,2410
Kings,38,2022-09-05,229,229,229,0,2869,2873,2872,1,8,0,0,0,461,461,461,461
Lake,38,2022-09-05,62,62,62,0,655,656,655,1,1,3,3,1,148,148,145,145
Lassen,38,2022-09-05,19,19,19,0,633,634,633,1,0,0,0,0,64,64,64,64
Los Angeles,38,2022-09-05,10706,10719,10719,0,224284,224575,224565,10,695,96,96,91,33384,33384,33288,33288
Madera,38,2022-09-05,206,206,206,0,2506,2510,2509,1,12,0,0,4,374,374,374,374
Marin,38,2022-09-05,191,191,191,0,3557,3562,3561,1,12,0,0,1,256,256,256,256
Mariposa,38,2022-09-05,16,16,16,0,166,167,166,1,0,0,0,0,29,29,29,29
Mendocino,38,2022-09-05,57,57,57,0,828,829,828,1,2,1,1,1,136,136,135,135
Merced,38,2022-09-05,251,251,251,0,2640,2645,2644,1,12,2,2,1,861,861,859,859
Modoc,38,2022-09-05,3,3,3,0,17,18,17,1,0,0,0,0,11,11,11,11
Mono,38,2022-09-05,4,4,4,0,52,53,52,1,1,0,0,0,7,7,7,7
Monterey,38,2022-09-05,245,245,245,0,4379,4384,4383,1,24,4,4,0,768,768,764,764
Napa,38,2022-09-05,102,102,102,0,1727,1728,1727,1,6,1,1,2,160,160,159,159
Nevada,38,2022-09-05,81,81,81,0,899,900,899,1,3,0,0,0,135,135,135,135
Orange,38,2022-09-05,2259,2262,2262,0,32860,32902,32898,4,169,13,13,34,7473,7473,7460,7460
Placer,38,2022-09-05,238,238,238,0,3479,3484,3483,1,36,0,0,4,658,658,658,658
Plumas,38,2022-09-05,9,9,9,0,130,131,130,1,0,0,0,0,13,13,13,13
Riverside,38,2022-09-05,2432,2435,2435,0,28763,28802,28798,4,99,7,7,14,6627,6627,6620,6620
Sacramento,38,2022-09-05,1273,1273,1273,0,19822,19848,19845,3,139,12,12,22,3308,3308,3296,3296
San Benito,38,2022-09-05,65,65,65,0,1088,1089,1088,1,0,0,0,2,102,102,102,102
San Bernardino,38,2022-09-05,2368,2371,2371,0,34559,34604,34600,4,122,14,14,19,8072,8072,8058,8058
San Diego,38,2022-09-05,2802,2806,2806,0,48507,48570,48568,2,212,15,15,25,5549,5549,5534,5534
San Francisco,38,2022-09-05,680,680,680,0,15741,15761,15756,5,52,9,9,9,1046,1046,1037,1037
San Joaquin,38,2022-09-05,831,831,831,0,11954,11970,11968,2,43,4,4,10,2327,2327,2323,2323
San Luis Obispo,38,2022-09-05,176,176,176,0,2677,2682,2681,1,7,2,2,1,524,524,522,522
San Mateo,38,2022-09-05,632,632,632,0,13669,13687,13686,1,23,1,1,2,742,742,741,741
Santa Barbara,38,2022-09-05,485,485,485,0,6633,6643,6642,1,39,4,4,3,726,726,722,722
Santa Clara,38,2022-09-05,1930,1931,1931,0,33401,33444,33442,2,127,11,11,20,2523,2523,2512,2512
Santa Cruz,38,2022-09-05,282,282,282,0,10222,10235,10234,1,16,0,0,0,273,273,273,273
Shasta,38,2022-09-05,105,105,105,0,2023,2026,2025,1,15,0,0,0,591,591,591,591
Siskiyou,38,2022-09-05,30,30,30,0,216,217,216,1,0,0,0,0,90,90,90,90
Solano,38,2022-09-05,368,368,368,0,5960,5968,5967,1,34,1,1,11,458,458,457,457
Sonoma,38,2022-09-05,367,367,367,0,6007,6015,6014,1,40,0,0,2,520,520,520,520
Stanislaus,38,2022-09-05,548,548,548,0,6351,6359,6358,1,69,5,5,4,1778,1778,1773,1773
Sutter,38,2022-09-05,118,118,118,0,1482,1484,1483,1,0,0,0,0,232,232,232,232
Tehama,38,2022-09-05,50,50,50,0,581,582,581,1,2,1,1,0,215,215,214,214
Trinity,38,2022-09-05,4,4,4,0,51,52,51,1,0,0,0,0,21,21,21,21
Tulare,38,2022-09-05,430,430,430,0,5179,5186,5185,1,37,2,2,1,1536,1536,1534,1534
Tuolumne,38,2022-09-05,68,68,68,0,737,738,737,1,1,0,0,0,199,199,199,199
Ventura,38,2022-09-05,864,864,864,0,12316,12332,12331,1,48,8,8,1,1587,1587,1579,1579
Yolo,38,2022-09-05,140,140,140,0,2908,2913,2912,1,1,3,3,2,391,391,388,388
Yuba,38,2022-09-05,88,88,88,0,977,978,977,1,14,1,1,1,131,131,130,130
Alameda,39,2022-09-12,1639,1639,1639,0,32247,32292,32289,3,94,4,4,16,1995,1995,1991,1991
Amador,39,2022-09-12,32,32,32,0,874,875,874,1,3,0,0,2,90,90,90,90
Butte,39,2022-09-12,196,196,196,0,2469,2474,2473,1,15,3,3,2,462,462,459,459
Calaveras,39,2022-09-12,14,14,14,0,501,502,501,1,1,0,0,0,133,133,133,133
Colusa,39,2022-09-12,17,17,17,0,414,415,414,1,0,0,0,0,22,22,22,22
Contra Costa,39,2022-09-12,979,979,979,0,17344,17368,17365,3,59,6,6,12,1447,1447,1441,1441
Del Norte,39,2022-09-12,34,34,34,0,595,596,595,1,1,0,0,1,55,55,55,55
El Dorado,39,2022-09-12,104,104,104,0,1904,1906,1905,1,3,0,0,1,234,234,234,234
Fresno,39,2022-09-12,906,906,906,0,14660,14680,14678,2,155,6,6,15,2871,2871,2865,2865
Glenn,39,2022-09-12,15,15,15,0,208,209,208,1,0,0,0,0,56,56,56,56
Humboldt,39,2022-09-12,113,113,113,0,1653,1654,1653,1,6,0,0,5,159,159,159,159
Imperial,39,2022-09-12,259,259,259,0,3288,3294,3293,1,10,0,0,2,961,961,961,961
Inyo,39,2022-09-12,15,15,15,0,194,195,194,1,0,1,1,0,60,60,59,59
Kern,39,2022-09-12,646,646,646,0,12995,13013,13012,1,45,7,7,13,2422,2422,2415,2415
Kings,39,2022-09-12,229,229,229,0,3172,3178,3177,1,6,1,1,0,462,462,461,461
Lake,39,2022-09-12,48,48,48,0,882,883,882,1,3,0,0,1,148,148,148,148
Lassen,39,2022-09-12,20,20,20,0,917,918,917,1,0,0,0,0,64,64,64,64
Los Angeles,39,2022-09-12,11028,11041,11041,0,284797,285177,285167,10,652,84,84,83,33468,33468,33384,33384
Madera,39,2022-09-12,242,242,242,0,2923,2929,2928,1,8,0,0,3,374,374,374,374
Marin,39,2022-09-12,174,174,174,0,3915,3920,3919,1,12,2,2,2,258,258,256,256
Mariposa,39,2022-09-12,16,16,16,0,192,193,192,1,0,0,0,0,29,29,29,29
Mendocino,39,2022-09-12,58,58,58,0,952,953,952,1,2,0,0,1,136,136,136,136
Merced,39,2022-09-12,237,237,237,0,3317,3323,3322,1,6,2,2,1,863,863,861,861
Modoc,39,2022-09-12,2,2,2,0,22,23,22,1,0,0,0,0,11,11,11,11
Mono,39,2022-09-12,7,7,7,0,77,78,77,1,0,0,0,0,7,7,7,7
Monterey,39,2022-09-12,229,229,229,0,5128,5134,5133,1,22,1,1,1,769,769,768,768
Napa,39,2022-09-12,120,120,120,0,2257,2261,2260,1,10,0,0,1,160,160,160,160
Nevada,39,2022-09-12,61,61,61,0,1179,1180,1179,1,2,1,1,0,136,136,135,135
Orange,39,2022-09-12,2171,2173,2173,0,37313,37362,37359,3,159,28,28,22,7501,7501,7473,7473
Placer,39,2022-09-12,240,240,240,0,4091,4097,4096,1,38,0,0,5,658,658,658,658
Plumas,39,2022-09-12,22,22,22,0,194,195,194,1,1,0,0,0,13,13,13,13
Riverside,39,2022-09-12,2264,2266,2266,0,33156,33200,33196,4,124,5,5,12,6632,6632,6627,6627
Sacramento,39,2022-09-12,1301,1301,1301,0,23561,23594,23591,3,119,15,15,15,3323,3323,3308,3308
San Benito,39,2022-09-12,96,96,96,0,1508,1510,1509,1,1,0,0,1,102,102,102,102
San Bernardino,39,2022-09-12,1952,1953,1953,0,38932,38985,38982,3,92,14,14,26,8086,8086,8072,8072
San Diego,39,2022-09-12,3034,3039,3039,0,56060,56134,56132,2,194,7,7,24,5556,5556,5549,5549
San Francisco,39,2022-09-12,815,815,815,0,17436,17459,17455,4,58,8,8,15,1054,1054,1046,1046
San Joaquin,39,2022-09-12,645,645,645,0,14282,14300,14298,2,35,6,6,9,2333,2333,2327,2327
San Luis Obispo,39,2022-09-12,187,187,187,0,3219,3225,3224,1,10,0,0,1,524,524,524,524
San Mateo,39,2022-09-12,671,671,671,0,14330,14348,14347,1,20,1,1,2,743,743,742,742
Santa Barbara,39,2022-09-12,329,329,329,0,7232,7242,7241,1,27,1,1,2,727,727,726,726
Santa Clara,39,2022-09-12,1923,1923,1923,0,38437,38488,38486,2,144,8,8,28,2531,2531,2523,2523
Santa Cruz,39,2022-09-12,272,272,272,0,13349,13367,13366,1,15,0,0,0,273,273,273,273
Shasta,39,2022-09-12,182,182,182,0,2592,2596,2595,1,26,1,1,2,592,592,591,591
Siskiyou,39,2022-09-12,27,27,27,0,289,290,289,1,1,0,0,0,90,90,90,90
Solano,39,2022-09-12,414,414,414,0,6739,6747,6746,1,32,0,0,4,458,458,458,458
Sonoma,39,2022-09-12,400,400,400,0,7022,7032,7031,1,39,3,3,1,523,523,520,520
Stanislaus,39,2022-09-12,447,447,447,0,7744,7755,7754,1,73,1,1,4,1779,1779,1778,1778
Sutter,39,2022-09-12,118,118,118,0,1531,1533,1532,1,0,0,0,0,232,232,232,232
Tehama,39,2022-09-12,48,48,48,0,699,700,699,1,2,0,0,0,215,215,215,215
Trinity,39,2022-09-12,2,2,2,0,74,75,74,1,0,0,0,0,21,21,21,21
Tulare,39,2022-09-12,369,369,369,0,6906,6914,6913,1,39,4,4,0,1540,1540,1536,1536
Tuolumne,39,2022-09-12,60,60,60,0,810,811,810,1,2,0,0,1,199,199,199,199
Ventura,39,2022-09-12,842,842,842,0,14808,14828,14827,1,49,1,1,7,1588,1588,1587,1587
Yolo,39,2022-09-12,143,143,143,0,3457,3464,3463,1,1,2,2,3,393,393,391,391
Yuba,39,2022-09-12,93,93,93,0,1164,1165,1164,1,6,1,1,0,132,132,131,131
Alameda,40,2022-09-19,1248,1248,1248,0,29339,29380,29378,2,80,2,2,7,1997,1997,1995,1995
Amador,40,2022-09-19,33,33,33,0,760,761,760,1,1,3,3,1,93,93,90,90
Butte,40,2022-09-19,121,121,121,0,2122,2126,2125,1,18,0,0,1,462,462,462,462
Calaveras,40,2022-09-19,28,28,28,0,477,478,477,1,0,0,0,0,133,133,133,133
Colusa,40,2022-09-19,13,13,13,0,289,290,289,1,3,0,0,0,22,22,22,22
Contra Costa,40,2022-09-19,826,826,826,0,16784,16808,16806,2,52,8,8,8,1455,1455,1447,1447
Del Norte,40,2022-09-19,22,22,22,0,479,480,479,1,2,0,0,0,55,55,55,55
El Dorado,40,2022-09-19,79,79,79,0,1617,1619,1618,1,3,0,0,0,234,234,234,234
Fresno,40,2022-09-19,604,604,604,0,13290,13309,13308,1,110,7,7,14,2878,2878,2871,2871
Glenn,40,2022-09-19,14,14,14,0,201,202,201,1,2,0,0,0,56,56,56,56
Humboldt,40,2022-09-19,105,105,105,0,1458,1459,1458,1,8,0,0,3,159,159,159,159
Imperial,40,2022-09-19,150,150,150,0,2868,2874,2873,1,11,0,0,2,961,961,961,961
Inyo,40,2022-09-19,8,8,8,0,169,170,169,1,0,0,0,0,60,60,60,60
Kern,40,2022-09-19,445,445,445,0,11650,11665,11664,1,34,2,2,6,2424,2424,2422,2422
Kings,40,2022-09-19,137,137,137,0,2642,2647,2646,1,7,2,2,0,464,464,462,462
Lake,40,2022-09-19,37,37,37,0,903,904,903,1,0,1,1,0,149,149,148,148
Lassen,40,2022-09-19,7,7,7,0,704,705,704,1,0,0,0,0,64,64,64,64
Los Angeles,40,2022-09-19,8554,8566,8566,0,256865,257220,257213,7,564,66,66,69,33534,33534,33468,33468
Madera,40,2022-09-19,109,109,109,0,2692,2697,2696,1,9,1,1,2,375,375,374,374
Marin,40,2022-09-19,137,137,137,0,3703,3709,3708,1,6,0,0,0,258,258,258,258
Mariposa,40,2022-09-19,12,12,12,0,170,171,170,1,0,1,1,0,30,30,29,29
Mendocino,40,2022-09-19,43,43,43,0,928,929,928,1,0,0,0,1,136,136,136,136
Merced,40,2022-09-19,170,170,170,0,2914,2920,2919,1,8,3,3,1,866,866,863,863
Modoc,40,2022-09-19,2,2,2,0,17,18,17,1,0,0,0,0,11,11,11,11
Mono,40,2022-09-19,4,4,4,0,63,64,63,1,0,0,0,0,7,7,7,7
Monterey,40,2022-09-19,162,162,162,0,4265,4270,4269,1,14,1,1,2,770,770,769,769
Napa,40,2022-09-19,103,103,103,0,1779,1781,1780,1,4,0,0,0,160,160,160,160
Nevada,40,2022-09-19,66,66,66,0,1111,1112,1111,1,2,1,1,0,137,137,136,136
Orange,40,2022-09-19,1805,1805,1805,0,34587,34635,34633,2,129,16,16,19,7517,7517,7501,7501
Placer,40,2022-09-19,223,223,223,0,3845,3852,3851,1,51,1,1,4,659,659,658,658
Plumas,40,2022-09-19,22,22,22,0,183,184,183,1,1,0,0,0,13,13,13,13
Riverside,40,2022-09-19,1428,1428,1428,0,29210,29252,29250,2,68,4,4,19,6636,6636,6632,6632
Sacramento,40,2022-09-19,1042,1042,1042,0,21424,21455,21453,2,102,8,8,17,3331,3331,3323,3323
San Benito,40,2022-09-19,54,54,54,0,1232,1233,1232,1,0,0,0,0,102,102,102,102
San Bernardino,40,2022-09-19,1486,1486,1486,0,32840,32886,32884,2,83,7,7,19,8093,8093,8086,8086
San Diego,40,2022-09-19,2563,2567,2567,0,56232,56309,56307,2,175,9,9,19,5565,5565,5556,5556
San Francisco,40,2022-09-19,695,695,695,0,16847,16871,16868,3,43,9,9,11,1063,1063,1054,1054
San Joaquin,40,2022-09-19,460,460,460,0,12860,12877,12876,1,35,5,5,2,2338,2338,2333,2333
San Luis Obispo,40,2022-09-19,155,155,155,0,2766,2772,2771,1,8,0,0,0,524,524,524,524
San Mateo,40,2022-09-19,607,607,607,0,13735,13753,13752,1,20,0,0,2,743,743,743,743
Santa Barbara,40,2022-09-19,269,269,269,0,6792,6803,6802,1,34,2,2,0,729,729,727,727
Santa Clara,40,2022-09-19,1450,1450,1450,0,37368,37420,37419,1,137,7,7,21,2538,2538,2531,2531
Santa Cruz,40,2022-09-19,148,148,148,0,12323,12341,12340,1,5,0,0,1,273,273,273,273
Shasta,40,2022-09-19,102,102,102,0,2113,2117,2116,1,21,0,0,3,592,592,592,592
Siskiyou,40,2022-09-19,21,21,21,0,233,234,233,1,2,1,1,0,91,91,90,90
Solano,40,2022-09-19,274,274,274,0,6125,6132,6131,1,24,1,1,5,459,459,458,458
Sonoma,40,2022-09-19,317,317,317,0,6360,6369,6368,1,27,3,3,1,526,526,523,523
Stanislaus,40,2022-09-19,333,333,333,0,6290,6299,6298,1,57,4,4,4,1783,1783,1779,1779
Sutter,40,2022-09-19,73,73,73,0,1388,1390,1389,1,0,0,0,0,232,232,232,232
Tehama,40,2022-09-19,35,35,35,0,599,600,599,1,2,1,1,0,216,216,215,215
Trinity,40,2022-09-19,3,3,3,0,53,54,53,1,0,0,0,0,21,21,21,21
Tulare,40,2022-09-19,234,234,234,0,5732,5740,5739,1,32,1,1,0,1541,1541,1540,1540
Tuolumne,40,2022-09-19,58,58,58,0,717,718,717,1,0,0,0,0,199,199,199,199
Ventura,40,2022-09-19,616,616,616,0,13384,13402,13401,1,42,2,2,6,1590,1590,1588,1588
Yolo,40,2022-09-19,83,83,83,0,3743,3750,3749,1,2,3,3,2,396,396,393,393
Yuba,40,2022-09-19,60,60,60,0,1029,1030,1029,1,3,0,0,0,132,132,132,132
Alameda,41,2022-09-26,1154,1154,1154,0,27840,27882,27881,1,77,1,1,4,1998,1998,1997,1997
Amador,41,2022-09-26,27,27,27,0,721,722,721,1,1,0,0,1,93,93,93,93
Butte,41,2022-09-26,90,90,90,0,1798,1801,1800,1,23,0,0,1,462,462,462,462
Calaveras,41,2022-09-26,20,20,20,0,390,391,390,1,2,1,1,0,134,134,133,133
Colusa,41,2022-09-26,7,7,7,0,299,300,299,1,1,0,0,0,22,22,22,22
Contra Costa,41,2022-09-26,777,777,777,0,16349,16373,16372,1,48,5,5,7,1460,1460,1455,1455
Del Norte,41,2022-09-26,22,22,22,0,469,470,469,1,2,0,0,0,55,55,55,55
El Dorado,41,2022-09-26,86,86,86,0,1580,1581,1580,1,5,0,0,0,234,234,234,234
Fresno,41,2022-09-26,517,517,517,0,12130,12147,12146,1,84,3,3,13,2881,2881,2878,2878
Glenn,41,2022-09-26,7,7,7,0,176,177,176,1,2,0,0,0,56,56,56,56
Humboldt,41,2022-09-26,97,97,97,0,1312,1313,1312,1,10,2,2,0,161,161,159,159
Imperial,41,2022-09-26,115,115,115,0,2630,2636,2635,1,4,1,1,1,962,962,961,961
Inyo,41,2022-09-26,5,5,5,0,165,166,165,1,0,0,0,0,60,60,60,60
Kern,41,2022-09-26,357,357,357,0,10880,10897,10896,1,32,3,3,7,2427,2427,2424,2424
Kings,41,2022-09-26,107,107,107,0,2621,2626,2625,1,2,0,0,0,464,464,464,464
Lake,41,2022-09-26,26,26,26,0,815,816,815,1,0,0,0,0,149,149,149,149
Lassen,41,2022-09-26,13,13,13,0,533,534,533,1,0,0,0,0,64,64,64,64
Los Angeles,41,2022-09-26,7722,7734,7734,0,241361,241714,241709,5,443,63,63,53,33597,33597,33534,33534
Madera,41,2022-09-26,84,84,84,0,2231,2235,2234,1,8,0,0,2,375,375,375,375
Marin,41,2022-09-26,173,173,173,0,3659,3665,3664,1,10,0,0,0,258,258,258,258
Mariposa,41,2022-09-26,4,4,4,0,155,156,155,1,0,0,0,0,30,30,30,30
Mendocino,41,2022-09-26,41,41,41,0,852,853,852,1,1,0,0,0,136,136,136,136
Merced,41,2022-09-26,127,127,127,0,2855,2861,2860,1,10,1,1,0,867,867,866,866
Modoc,41,2022-09-26,0,0,0,0,13,14,13,1,0,0,0,0,11,11,11,11
Mono,41,2022-09-26,1,1,1,0,60,61,60,1,0,0,0,0,7,7,7,7
Monterey,41,2022-09-26,135,135,135,0,4055,4060,4059,1,14,0,0,2,770,770,770,770
Napa,41,2022-09-26,87,87,87,0,1966,1970,1969,1,5,1,1,1,161,161,160,160
Nevada,41,2022-09-26,49,49,49,0,1077,1078,1077,1,1,0,0,0,137,137,137,137
Orange,41,2022-09-26,1738,1738,1738,0,31562,31608,31606,2,117,19,19,23,7536,7536,7517,7517
Placer,41,2022-09-26,209,209,209,0,3611,3618,3617,1,42,1,1,4,660,660,659,659
Plumas,41,2022-09-26,21,21,21,0,151,152,151,1,1,0,0,0,13,13,13,13
Riverside,41,2022-09-26,1289,1289,1289,0,25897,25935,25933,2,55,8,8,15,6644,6644,6636,6636
Sacramento,41,2022-09-26,931,931,931,0,19275,19302,19301,1,106,11,11,20,3342,3342,3331,3331
San Benito,41,2022-09-26,50,50,50,0,1160,1161,1160,1,0,1,1,2,103,103,102,102
San Bernardino,41,2022-09-26,1241,1241,1241,0,28103,28145,28143,2,75,6,6,12,8099,8099,8093,8093
San Diego,41,2022-09-26,2483,2488,2488,0,51220,51295,51294,1,201,7,7,15,5572,5572,5565,5565
San Francisco,41,2022-09-26,677,677,677,0,16224,16248,16246,2,45,2,2,9,1065,1065,1063,1063
San Joaquin,41,2022-09-26,409,409,409,0,11086,11102,11101,1,35,1,1,3,2339,2339,2338,2338
San Luis Obispo,41,2022-09-26,131,131,131,0,2521,2527,2526,1,7,1,1,0,525,525,524,524
San Mateo,41,2022-09-26,617,617,617,0,13188,13207,13206,1,25,0,0,1,743,743,743,743
Santa Barbara,41,2022-09-26,259,259,259,0,6381,6393,6392,1,22,2,2,0,731,731,729,729
Santa Clara,41,2022-09-26,1401,1401,1401,0,36178,36230,36229,1,113,10,10,17,2548,2548,2538,2538
Santa Cruz,41,2022-09-26,225,225,225,0,12508,12526,12525,1,13,0,0,0,273,273,273,273
Shasta,41,2022-09-26,76,76,76,0,1740,1743,1742,1,14,1,1,3,593,593,592,592
Siskiyou,41,2022-09-26,18,18,18,0,183,184,183,1,1,2,2,0,93,93,91,91
Solano,41,2022-09-26,310,310,310,0,5725,5734,5733,1,23,1,1,2,460,460,459,459
Sonoma,41,2022-09-26,292,292,292,0,6334,6345,6344,1,31,1,1,2,527,527,526,526
Stanislaus,41,2022-09-26,261,261,261,0,5814,5823,5822,1,46,2,2,3,1785,1785,1783,1783
Sutter,41,2022-09-26,68,68,68,0,1147,1148,1147,1,0,0,0,0,232,232,232,232
Tehama,41,2022-09-26,36,36,36,0,550,551,550,1,1,2,2,0,218,218,216,216
Trinity,41,2022-09-26,3,3,3,0,44,45,44,1,0,0,0,0,21,21,21,21
Tulare,41,2022-09-26,168,168,168,0,5096,5102,5101,1,18,3,3,2,1544,1544,1541,1541
Tuolumne,41,2022-09-26,44,44,44,0,689,690,689,1,1,0,0,0,199,199,199,199
Ventura,41,2022-09-26,557,557,557,0,11600,11616,11615,1,33,4,4,1,1594,1594,1590,1590
Yolo,41,2022-09-26,130,130,130,0,3986,3993,3992,1,2,3,3,3,399,399,396,396
Yuba,41,2022-09-26,41,41,41,0,933,934,933,1,6,0,0,1,132,132,132,132
Alameda,42,2022-10-03,1145,1145,1145,0,26322,26362,26361,1,54,3,3,5,2001,2001,1998,1998
Amador,42,2022-10-03,14,14,14,0,691,692,691,1,0,0,0,1,93,93,93,93
Butte,42,2022-10-03,67,67,67,0,1754,1757,1756,1,11,2,2,2,464,464,462,462
Calaveras,42,2022-10-03,19,19,19,0,337,338,337,1,1,0,0,0,134,134,134,134
Colusa,42,2022-10-03,7,7,7,0,188,189,188,1,0,0,0,0,22,22,22,22
Contra Costa,42,2022-10-03,740,740,740,0,15785,15809,15808,1,34,3,3,6,1463,1463,1460,1460
Del Norte,42,2022-10-03,12,12,12,0,382,383,382,1,1,0,0,1,55,55,55,55
El Dorado,42,2022-10-03,80,80,80,0,1450,1452,1451,1,3,0,0,1,234,234,234,234
Fresno,42,2022-10-03,462,462,462,0,11227,11245,11244,1,77,2,2,11,2883,2883,2881,2881
Glenn,42,2022-10-03,7,7,7,0,155,156,155,1,0,0,0,0,56,56,56,56
Humboldt,42,2022-10-03,78,78,78,0,1159,1160,1159,1,6,0,0,1,161,161,161,161
Imperial,42,2022-10-03,141,141,141,0,2565,2571,2570,1,6,0,0,0,962,962,962,962
Inyo,42,2022-10-03,5,5,5,0,159,160,159,1,0,0,0,1,60,60,60,60
Kern,42,2022-10-03,295,295,295,0,10110,10126,10125,1,24,4,4,5,2431,2431,2427,2427
Kings,42,2022-10-03,87,87,87,0,2416,2421,2420,1,2,0,0,0,464,464,464,464
Lake,42,2022-10-03,35,35,35,0,759,760,759,1,3,1,1,0,150,150,149,149
Lassen,42,2022-10-03,7,7,7,0,530,531,530,1,2,0,0,0,64,64,64,64
Los Angeles,42,2022-10-03,7019,7031,7031,0,221742,222077,222073,4,439,49,49,69,33646,33646,33597,33597
Madera,42,2022-10-03,65,65,65,0,1565,1567,1566,1,6,0,0,2,375,375,375,375
Marin,42,2022-10-03,191,191,191,0,3475,3481,3480,1,6,0,0,2,258,258,258,258
Mariposa,42,2022-10-03,5,5,5,0,131,132,131,1,0,0,0,0,30,30,30,30
Mendocino,42,2022-10-03,50,50,50,0,778,779,778,1,4,0,0,0,136,136,136,136
Merced,42,2022-10-03,109,109,109,0,2610,2616,2615,1,5,3,3,1,870,870,867,867
Modoc,42,2022-10-03,2,2,2,0,14,15,14,1,0,0,0,0,11,11,11,11
Mono,42,2022-10-03,4,4,4,0,69,70,69,1,0,0,0,0,7,7,7,7
Monterey,42,2022-10-03,111,111,111,0,3794,3800,3799,1,11,1,1,1,771,771,770,770
Napa,42,2022-10-03,89,89,89,0,1701,1703,1702,1,4,0,0,2,161,161,161,161
Nevada,42,2022-10-03,51,51,51,0,954,955,954,1,1,0,0,4,137,137,137,137
Orange,42,2022-10-03,1579,1579,1579,0,28375,28419,28418,1,131,22,22,16,7558,7558,7536,7536
Placer,42,2022-10-03,208,208,208,0,3350,3357,3356,1,41,2,2,3,662,662,660,660
Plumas,42,2022-10-03,12,12,12,0,107,108,107,1,1,0,0,0,13,13,13,13
Riverside,42,2022-10-03,1146,1146,1146,0,22159,22193,22192,1,59,7,7,12,6651,6651,6644,6644
Sacramento,42,2022-10-03,924,924,924,0,18205,18232,18231,1,88,12,12,19,3354,3354,3342,3342
San Benito,42,2022-10-03,34,34,34,0,1105,1106,1105,1,0,0,0,0,103,103,103,103
San Bernardino,42,2022-10-03,1243,1243,1243,0,25069,25108,25107,1,77,4,4,7,8103,8103,8099,8099
San Diego,42,2022-10-03,2086,2089,2089,0,46925,46996,46995,1,162,9,9,18,5581,5581,5572,5572
San Francisco,42,2022-10-03,656,656,656,0,15385,15408,15406,2,44,3,3,9,1068,1068,1065,1065
San Joaquin,42,2022-10-03,343,343,343,0,9930,9945,9944,1,25,4,4,3,2343,2343,2339,2339
San Luis Obispo,42,2022-10-03,150,150,150,0,2383,2388,2387,1,2,1,1,1,526,526,525,525
San Mateo,42,2022-10-03,560,560,560,0,12421,12441,12440,1,22,0,0,2,743,743,743,743
Santa Barbara,42,2022-10-03,254,254,254,0,6290,6302,6301,1,15,0,0,2,731,731,731,731
Santa Clara,42,2022-10-03,1436,1436,1436,0,32449,32498,32497,1,109,6,6,20,2554,2554,2548,2548
Santa Cruz,42,2022-10-03,227,227,227,0,11231,11248,11247,1,10,0,0,1,273,273,273,273
Shasta,42,2022-10-03,56,56,56,0,1444,1447,1446,1,10,0,0,2,593,593,593,593
Siskiyou,42,2022-10-03,10,10,10,0,204,205,204,1,0,0,0,0,93,93,93,93
Solano,42,2022-10-03,251,251,251,0,5361,5369,5368,1,17,0,0,2,460,460,460,460
Sonoma,42,2022-10-03,322,322,322,0,5934,5945,5944,1,17,0,0,3,527,527,527,527
Stanislaus,42,2022-10-03,200,200,200,0,5355,5365,5364,1,49,1,1,6,1786,1786,1785,1785
Sutter,42,2022-10-03,56,56,56,0,1109,1110,1109,1,0,2,2,0,234,234,232,232
Tehama,42,2022-10-03,20,20,20,0,526,527,526,1,1,0,0,0,218,218,218,218
Trinity,42,2022-10-03,1,1,1,0,43,44,43,1,0,0,0,0,21,21,21,21
Tulare,42,2022-10-03,164,164,164,0,5054,5061,5060,1,19,4,4,1,1548,1548,1544,1544
Tuolumne,42,2022-10-03,26,26,26,0,622,623,622,1,0,1,1,0,200,200,199,199
Ventura,42,2022-10-03,479,479,479,0,10442,10459,10458,1,41,2,2,2,1596,1596,1594,1594
Yolo,42,2022-10-03,123,123,123,0,2988,2993,2992,1,3,2,2,2,401,401,399,399
Yuba,42,2022-10-03,35,35,35,0,802,803,802,1,4,0,0,1,132,132,132,132
Alameda,43,2022-10-10,1161,1161,1161,0,28033,28078,28077,1,45,2,2,7,2003,2003,2001,2001
Amador,43,2022-10-10,15,15,15,0,801,802,801,1,0,0,0,2,93,93,93,93
Butte,43,2022-10-10,65,65,65,0,1754,1756,1755,1,12,3,3,1,466,466,463,463
Calaveras,43,2022-10-10,15,15,15,0,374,375,374,1,0,1,1,0,135,135,134,134
Colusa,43,2022-10-10,1,1,1,0,120,121,120,1,1,0,0,0,22,22,22,22
Contra Costa,43,2022-10-10,774,774,774,0,16875,16903,16902,1,31,9,9,6,1470,1470,1461,1461
Del Norte,43,2022-10-10,10,10,10,0,492,493,492,1,1,0,0,1,55,55,55,55
El Dorado,43,2022-10-10,81,81,81,0,1751,1752,1751,1,7,0,0,4,234,234,234,234
Fresno,43,2022-10-10,482,482,482,0,12484,12504,12503,1,60,3,3,9,2886,2886,2883,2883
Glenn,43,2022-10-10,10,10,10,0,226,227,226,1,1,0,0,0,56,56,56,56
Humboldt,43,2022-10-10,98,98,98,0,1420,1421,1420,1,7,1,1,0,162,162,161,161
Imperial,43,2022-10-10,203,203,203,0,2962,2969,2968,1,7,0,0,0,962,962,962,962
Inyo,43,2022-10-10,4,4,4,0,124,125,124,1,0,0,0,0,60,60,60,60
Kern,43,2022-10-10,338,338,338,0,11848,11868,11867,1,24,2,2,2,2433,2433,2431,2431
Kings,43,2022-10-10,102,102,102,0,2751,2757,2756,1,1,1,1,0,465,465,464,464
Lake,43,2022-10-10,33,33,33,0,920,921,920,1,1,0,0,0,150,150,150,150
Lassen,43,2022-10-10,3,3,3,0,573,574,573,1,0,0,0,0,64,64,64,64
Los Angeles,43,2022-10-10,6754,6765,6765,0,228397,228755,228752,3,436,71,71,51,33709,33709,33638,33638
Madera,43,2022-10-10,68,68,68,0,1718,1719,1718,1,7,1,1,2,376,376,375,375
Marin,43,2022-10-10,207,207,207,0,3779,3786,3785,1,9,0,0,0,258,258,258,258
Mariposa,43,2022-10-10,9,9,9,0,128,129,128,1,0,0,0,0,30,30,30,30
Mendocino,43,2022-10-10,32,32,32,0,975,976,975,1,1,0,0,2,136,136,136,136
Merced,43,2022-10-10,111,111,111,0,2790,2796,2795,1,8,1,1,3,871,871,870,870
Modoc,43,2022-10-10,5,5,5,0,12,13,12,1,0,0,0,0,11,11,11,11
Mono,43,2022-10-10,1,1,1,0,55,56,55,1,0,0,0,0,7,7,7,7
Monterey,43,2022-10-10,108,108,108,0,4372,4379,4378,1,9,0,0,1,771,771,771,771
Napa,43,2022-10-10,78,78,78,0,1766,1767,1766,1,3,0,0,2,161,161,161,161
Nevada,43,2022-10-10,42,42,42,0,981,982,981,1,1,0,0,1,137,137,137,137
Orange,43,2022-10-10,1524,1524,1524,0,30120,30168,30167,1,129,14,14,19,7570,7570,7556,7556
Placer,43,2022-10-10,187,187,187,0,3823,3831,3830,1,24,0,0,7,662,662,662,662
Plumas,43,2022-10-10,20,20,20,0,106,107,106,1,0,0,0,0,13,13,13,13
Riverside,43,2022-10-10,1195,1195,1195,0,24021,24058,24057,1,56,5,5,4,6656,6656,6651,6651
Sacramento,43,2022-10-10,959,959,959,0,20477,20509,20508,1,81,5,5,16,3359,3359,3354,3354
San Benito,43,2022-10-10,35,35,35,0,1269,1270,1269,1,3,0,0,0,103,103,103,103
San Bernardino,43,2022-10-10,1112,1112,1112,0,27423,27468,27467,1,66,0,0,13,8103,8103,8103,8103
San Diego,43,2022-10-10,1991,1992,1992,0,51616,51697,51696,1,130,7,7,21,5586,5586,5579,5579
San Francisco,43,2022-10-10,691,691,691,0,16131,16157,16156,1,37,2,2,9,1070,1070,1068,1068
San Joaquin,43,2022-10-10,433,433,433,0,11586,11604,11603,1,17,2,2,8,2345,2345,2343,2343
San Luis Obispo,43,2022-10-10,88,88,88,0,2569,2574,2573,1,2,2,2,0,528,528,526,526
San Mateo,43,2022-10-10,668,668,668,0,13748,13770,13769,1,19,0,0,0,743,743,743,743
Santa Barbara,43,2022-10-10,242,242,242,0,7845,7859,7858,1,20,1,1,1,732,732,731,731
Santa Clara,43,2022-10-10,1456,1456,1456,0,34357,34412,34411,1,107,5,5,18,2559,2559,2554,2554
Santa Cruz,43,2022-10-10,338,338,338,0,12284,12305,12304,1,9,0,0,1,273,273,273,273
Shasta,43,2022-10-10,99,99,99,0,1294,1295,1294,1,13,3,3,1,596,596,593,593
Siskiyou,43,2022-10-10,9,9,9,0,244,245,244,1,0,1,1,0,94,94,93,93
Solano,43,2022-10-10,333,333,333,0,6279,6289,6288,1,23,0,0,4,460,460,460,460
Sonoma,43,2022-10-10,287,287,287,0,6773,6786,6785,1,15,1,1,3,528,528,527,527
Stanislaus,43,2022-10-10,208,208,208,0,5928,5940,5939,1,51,7,7,7,1791,1791,1784,1784
Sutter,43,2022-10-10,58,58,58,0,1127,1128,1127,1,0,1,1,0,235,235,234,234
Tehama,43,2022-10-10,21,21,21,0,567,568,567,1,1,0,0,0,218,218,218,218
Trinity,43,2022-10-10,1,1,1,0,53,54,53,1,0,0,0,0,21,21,21,21
Tulare,43,2022-10-10,166,166,166,0,4981,4988,4987,1,16,1,1,1,1549,1549,1548,1548
Tuolumne,43,2022-10-10,36,36,36,0,660,661,660,1,1,1,1,0,201,201,200,200
Ventura,43,2022-10-10,438,438,438,0,10998,11017,11016,1,41,4,4,1,1599,1599,1595,1595
Yolo,43,2022-10-10,126,126,126,0,3099,3105,3104,1,4,2,2,0,403,403,401,401
Yuba,43,2022-10-10,23,23,23,0,924,925,924,1,0,0,0,0,132,132,132,132
Alameda,44,2022-10-17,944,944,944,0,24697,24737,24736,1,60,3,3,8,2006,2006,2003,2003
Amador,44,2022-10-17,15,15,15,0,592,593,592,1,1,0,0,0,93,93,93,93
Butte,44,2022-10-17,76,76,76,0,1426,1427,1426,1,13,0,0,0,466,466,466,466
Calaveras,44,2022-10-17,19,19,19,0,306,307,306,1,0,0,0,0,135,135,135,135
Colusa,44,2022-10-17,4,4,4,0,80,81,80,1,0,0,0,0,22,22,22,22
Contra Costa,44,2022-10-17,675,675,675,0,14551,14576,14575,1,30,4,4,6,1474,1474,1470,1470
Del Norte,44,2022-10-17,11,11,11,0,381,382,381,1,1,0,0,0,55,55,55,55
El Dorado,44,2022-10-17,89,89,89,0,1381,1382,1381,1,2,0,0,1,234,234,234,234
Fresno,44,2022-10-17,350,350,350,0,10209,10226,10225,1,62,2,2,11,2888,2888,2886,2886
Glenn,44,2022-10-17,6,6,6,0,141,142,141,1,1,0,0,0,56,56,56,56
Humboldt,44,2022-10-17,70,70,70,0,1147,1148,1147,1,1,0,0,0,162,162,162,162
Imperial,44,2022-10-17,117,117,117,0,2322,2328,2327,1,5,0,0,0,962,962,962,962
Inyo,44,2022-10-17,6,6,6,0,123,124,123,1,1,0,0,0,60,60,60,60
Kern,44,2022-10-17,238,238,238,0,9714,9730,9729,1,32,0,0,1,2433,2433,2433,2433
Kings,44,2022-10-17,70,70,70,0,2320,2325,2324,1,2,1,1,0,466,466,465,465
Lake,44,2022-10-17,25,25,25,0,774,775,774,1,1,0,0,0,150,150,150,150
Lassen,44,2022-10-17,7,7,7,0,513,514,513,1,1,0,0,0,64,64,64,64
Los Angeles,44,2022-10-17,5088,5096,5096,0,189701,190008,190006,2,350,42,42,53,33751,33751,33709,33709
Madera,44,2022-10-17,59,59,59,0,1467,1468,1467,1,3,0,0,2,376,376,376,376
Marin,44,2022-10-17,132,132,132,0,3096,3102,3101,1,8,0,0,1,258,258,258,258
Mariposa,44,2022-10-17,6,6,6,0,119,120,119,1,0,0,0,0,30,30,30,30
Mendocino,44,2022-10-17,48,48,48,0,743,744,743,1,2,0,0,0,136,136,136,136
Merced,44,2022-10-17,129,129,129,0,2344,2350,2349,1,15,0,0,2,871,871,871,871
Modoc,44,2022-10-17,1,1,1,0,7,8,7,1,0,0,0,0,11,11,11,11
Mono,44,2022-10-17,6,6,6,0,42,43,42,1,1,0,0,0,7,7,7,7
Monterey,44,2022-10-17,125,125,125,0,3552,3559,3558,1,12,1,1,1,772,772,771,771
Napa,44,2022-10-17,60,60,60,0,1416,1418,1417,1,2,0,0,1,161,161,161,161
Nevada,44,2022-10-17,49,49,49,0,780,781,780,1,0,0,0,5,137,137,137,137
Orange,44,2022-10-17,1136,1136,1136,0,25139,25180,25179,1,91,21,21,18,7591,7591,7570,7570
Placer,44,2022-10-17,149,149,149,0,2932,2939,2938,1,32,0,0,3,662,662,662,662
Plumas,44,2022-10-17,11,11,11,0,98,99,98,1,0,0,0,0,13,13,13,13
Riverside,44,2022-10-17,898,898,898,0,20799,20833,20832,1,66,2,2,2,6658,6658,6656,6656
Sacramento,44,2022-10-17,871,871,871,0,16205,16231,16230,1,84,11,11,14,3370,3370,3359,3359
San Benito,44,2022-10-17,28,28,28,0,882,883,882,1,0,1,1,0,104,104,103,103
San Bernardino,44,2022-10-17,835,835,835,0,23470,23508,23507,1,63,1,1,9,8104,8104,8103,8103
San Diego,44,2022-10-17,1649,1650,1650,0,43737,43807,43806,1,117,8,8,24,5594,5594,5586,5586
San Francisco,44,2022-10-17,568,568,568,0,14501,14525,14524,1,34,3,3,13,1073,1073,1070,1070
San Joaquin,44,2022-10-17,352,352,352,0,9075,9090,9089,1,8,2,2,8,2347,2347,2345,2345
San Luis Obispo,44,2022-10-17,109,109,109,0,2131,2136,2135,1,4,1,1,0,529,529,528,528
San Mateo,44,2022-10-17,551,551,551,0,11333,11352,11351,1,21,0,0,1,743,743,743,743
Santa Barbara,44,2022-10-17,182,182,182,0,5626,5637,5636,1,18,0,0,2,732,732,732,732
Santa Clara,44,2022-10-17,1170,1170,1170,0,28717,28765,28764,1,93,5,5,16,2564,2564,2559,2559
Santa Cruz,44,2022-10-17,284,284,284,0,10291,10308,10307,1,7,1,1,0,274,274,273,273
Shasta,44,2022-10-17,82,82,82,0,1105,1106,1105,1,12,0,0,2,596,596,596,596
Siskiyou,44,2022-10-17,12,12,12,0,181,182,181,1,2,1,1,0,95,95,94,94
Solano,44,2022-10-17,266,266,266,0,4852,4861,4860,1,25,1,1,3,461,461,460,460
Sonoma,44,2022-10-17,246,246,246,0,5371,5380,5379,1,20,1,1,1,529,529,528,528
Stanislaus,44,2022-10-17,222,222,222,0,5295,5305,5304,1,45,1,1,5,1792,1792,1791,1791
Sutter,44,2022-10-17,40,40,40,0,910,911,910,1,0,0,0,0,235,235,235,235
Tehama,44,2022-10-17,21,21,21,0,397,398,397,1,0,0,0,0,218,218,218,218
Trinity,44,2022-10-17,0,0,0,0,34,35,34,1,0,0,0,0,21,21,21,21
Tulare,44,2022-10-17,137,137,137,0,4271,4278,4277,1,11,1,1,1,1550,1550,1549,1549
Tuolumne,44,2022-10-17,33,33,33,0,620,621,620,1,2,0,0,0,201,201,201,201
Ventura,44,2022-10-17,376,376,376,0,9350,9367,9366,1,32,3,3,1,1602,1602,1599,1599
Yolo,44,2022-10-17,102,102,102,0,2211,2216,2215,1,3,2,2,3,405,405,403,403
Yuba,44,2022-10-17,44,44,44,0,767,768,767,1,1,0,0,0,132,132,132,132
Alameda,45,2022-10-24,955,955,955,0,23426,23465,23464,1,46,5,5,10,2011,2011,2006,2006
Amador,45,2022-10-24,18,18,18,0,635,636,635,1,2,0,0,0,93,93,93,93
Butte,45,2022-10-24,68,68,68,0,1405,1407,1406,1,10,1,1,1,467,467,466,466
Calaveras,45,2022-10-24,20,20,20,0,322,323,322,1,0,0,0,0,135,135,135,135
Colusa,45,2022-10-24,3,3,3,0,95,96,95,1,0,0,0,0,22,22,22,22
Contra Costa,45,2022-10-24,625,625,625,0,13921,13944,13943,1,37,5,5,5,1479,1479,1474,1474
Del Norte,45,2022-10-24,6,6,6,0,361,362,361,1,0,0,0,1,55,55,55,55
El Dorado,45,2022-10-24,91,91,91,0,1520,1522,1521,1,1,0,0,0,234,234,234,234
Fresno,45,2022-10-24,380,380,380,0,9763,9779,9778,1,63,0,0,6,2888,2888,2888,2888
Glenn,45,2022-10-24,9,9,9,0,148,149,148,1,0,0,0,0,56,56,56,56
Humboldt,45,2022-10-24,69,69,69,0,1150,1151,1150,1,7,0,0,2,162,162,162,162
Imperial,45,2022-10-24,96,96,96,0,2344,2350,2349,1,8,1,1,0,963,963,962,962
Inyo,45,2022-10-24,8,8,8,0,273,274,273,1,0,0,0,0,60,60,60,60
Kern,45,2022-10-24,279,279,279,0,9715,9732,9731,1,24,2,2,2,2435,2435,2433,2433
Kings,45,2022-10-24,88,88,88,0,2341,2346,2345,1,8,0,0,0,466,466,466,466
Lake,45,2022-10-24,22,22,22,0,643,644,643,1,1,1,1,1,151,151,150,150
Lassen,45,2022-10-24,16,16,16,0,484,485,484,1,1,0,0,0,64,64,64,64
Los Angeles,45,2022-10-24,5334,5342,5342,0,187330,187640,187638,2,332,54,54,43,33805,33805,33751,33751
Madera,45,2022-10-24,61,61,61,0,1388,1389,1388,1,4,0,0,2,376,376,376,376
Marin,45,2022-10-24,138,138,138,0,3081,3087,3086,1,12,1,1,2,259,259,258,258
Mariposa,45,2022-10-24,12,12,12,0,121,122,121,1,0,0,0,0,30,30,30,30
Mendocino,45,2022-10-24,42,42,42,0,771,772,771,1,2,0,0,0,136,136,136,136
Merced,45,2022-10-24,88,88,88,0,2410,2416,2415,1,7,3,3,3,874,874,871,871
Modoc,45,2022-10-24,1,1,1,0,13,14,13,1,0,0,0,0,11,11,11,11
Mono,45,2022-10-24,3,3,3,0,64,65,64,1,0,1,1,0,8,8,7,7
Monterey,45,2022-10-24,131,131,131,0,3719,3726,3725,1,18,0,0,0,772,772,772,772
Napa,45,2022-10-24,51,51,51,0,1467,1469,1468,1,3,0,0,0,161,161,161,161
Nevada,45,2022-10-24,38,38,38,0,784,785,784,1,6,0,0,0,137,137,137,137
Orange,45,2022-10-24,1160,1160,1160,0,26001,26043,26042,1,84,12,12,14,7603,7603,7591,7591
Placer,45,2022-10-24,192,192,192,0,3034,3041,3040,1,39,0,0,6,662,662,662,662
Plumas,45,2022-10-24,12,12,12,0,91,92,91,1,0,0,0,0,13,13,13,13
Riverside,45,2022-10-24,933,933,933,0,20178,20212,20211,1,53,0,0,6,6658,6658,6658,6658
Sacramento,45,2022-10-24,816,816,816,0,15315,15340,15339,1,84,5,5,19,3375,3375,3370,3370
San Benito,45,2022-10-24,41,41,41,0,845,846,845,1,0,0,0,1,104,104,104,104
San Bernardino,45,2022-10-24,805,805,805,0,21612,21647,21646,1,39,3,3,10,8107,8107,8104,8104
San Diego,45,2022-10-24,1684,1685,1685,0,42143,42212,42211,1,83,5,5,18,5599,5599,5594,5594
San Francisco,45,2022-10-24,511,511,511,0,13947,13970,13969,1,35,1,1,5,1074,1074,1073,1073
San Joaquin,45,2022-10-24,273,273,273,0,8498,8513,8512,1,13,2,2,3,2349,2349,2347,2347
San Luis Obispo,45,2022-10-24,89,89,89,0,2055,2060,2059,1,2,0,0,0,529,529,529,529
San Mateo,45,2022-10-24,472,472,472,0,11148,11167,11166,1,19,0,0,2,743,743,743,743
Santa Barbara,45,2022-10-24,164,164,164,0,5730,5741,5740,1,19,2,2,4,734,734,732,732
Santa Clara,45,2022-10-24,1211,1211,1211,0,29387,29437,29436,1,92,3,3,9,2567,2567,2564,2564
Santa Cruz,45,2022-10-24,240,240,240,0,10204,10221,10220,1,14,1,1,0,275,275,274,274
Shasta,45,2022-10-24,76,76,76,0,984,985,984,1,5,0,0,2,596,596,596,596
Siskiyou,45,2022-10-24,12,12,12,0,171,172,171,1,0,0,0,0,95,95,95,95
Solano,45,2022-10-24,239,239,239,0,5029,5037,5036,1,20,0,0,1,461,461,461,461
Sonoma,45,2022-10-24,242,242,242,0,5438,5447,5446,1,23,0,0,1,529,529,529,529
Stanislaus,45,2022-10-24,199,199,199,0,4852,4862,4861,1,40,3,3,3,1795,1795,1792,1792
Sutter,45,2022-10-24,28,28,28,0,881,882,881,1,0,0,0,0,235,235,235,235
Tehama,45,2022-10-24,36,36,36,0,406,407,406,1,1,0,0,0,218,218,218,218
Trinity,45,2022-10-24,1,1,1,0,35,36,35,1,0,0,0,0,21,21,21,21
Tulare,45,2022-10-24,110,110,110,0,4345,4352,4351,1,16,1,1,1,1551,1551,1550,1550
Tuolumne,45,2022-10-24,33,33,33,0,625,626,625,1,1,1,1,0,202,202,201,201
Ventura,45,2022-10-24,294,294,294,0,9024,9040,9039,1,40,3,3,6,1605,1605,1602,1602
Yolo,45,2022-10-24,91,91,91,0,2048,2051,2050,1,5,1,1,0,406,406,405,405
Yuba,45,2022-10-24,51,51,51,0,799,800,799,1,5,0,0,1,132,132,132,132
Alameda,46,2022-10-31,1059,1059,1059,0,23015,23054,23053,1,57,4,4,4,2015,2015,2011,2011
Amador,46,2022-10-31,18,18,18,0,578,579,578,1,2,1,1,0,94,94,93,93
Butte,46,2022-10-31,82,82,82,0,1458,1460,1459,1,11,0,0,3,467,467,467,467
Calaveras,46,2022-10-31,13,13,13,0,257,258,257,1,0,0,0,0,135,135,135,135
Colusa,46,2022-10-31,11,11,11,0,95,96,95,1,0,0,0,0,22,22,22,22
Contra Costa,46,2022-10-31,746,746,746,0,13903,13928,13927,1,37,6,6,7,1485,1485,1479,1479
Del Norte,46,2022-10-31,16,16,16,0,357,358,357,1,1,0,0,0,55,55,55,55
El Dorado,46,2022-10-31,100,100,100,0,1406,1407,1406,1,2,0,0,0,234,234,234,234
Fresno,46,2022-10-31,427,427,427,0,10498,10517,10516,1,57,5,5,8,2893,2893,2888,2888
Glenn,46,2022-10-31,16,16,16,0,156,157,156,1,1,0,0,0,56,56,56,56
Humboldt,46,2022-10-31,44,44,44,0,1021,1022,1021,1,6,0,0,2,162,162,162,162
Imperial,46,2022-10-31,126,126,126,0,2784,2790,2789,1,7,0,0,0,963,963,963,963
Inyo,46,2022-10-31,7,7,7,0,242,243,242,1,0,0,0,0,60,60,60,60
Kern,46,2022-10-31,341,341,341,0,9872,9890,9889,1,20,2,2,2,2437,2437,2435,2435
Kings,46,2022-10-31,118,118,118,0,2461,2467,2466,1,3,0,0,1,466,466,466,466
Lake,46,2022-10-31,30,30,30,0,752,753,752,1,1,0,0,1,151,151,151,151
Lassen,46,2022-10-31,19,19,19,0,522,523,522,1,1,0,0,0,64,64,64,64
Los Angeles,46,2022-10-31,6227,6238,6238,0,192573,192901,192899,2,344,37,37,44,33842,33842,33805,33805
Madera,46,2022-10-31,54,54,54,0,1433,1435,1434,1,3,0,0,2,376,376,376,376
Marin,46,2022-10-31,137,137,137,0,3509,3516,3515,1,10,1,1,1,260,260,259,259
Mariposa,46,2022-10-31,8,8,8,0,126,127,126,1,0,0,0,0,30,30,30,30
Mendocino,46,2022-10-31,23,23,23,0,709,710,709,1,1,0,0,2,136,136,136,136
Merced,46,2022-10-31,114,114,114,0,2140,2146,2145,1,5,1,1,0,875,875,874,874
Modoc,46,2022-10-31,1,1,1,0,13,14,13,1,0,0,0,0,11,11,11,11
Mono,46,2022-10-31,1,1,1,0,85,86,85,1,1,0,0,0,8,8,8,8
Monterey,46,2022-10-31,149,149,149,0,3696,3704,3703,1,18,2,2,0,774,774,772,772
Napa,46,2022-10-31,54,54,54,0,1505,1507,1506,1,2,0,0,0,161,161,161,161
Nevada,46,2022-10-31,38,38,38,0,775,776,775,1,6,0,0,0,137,137,137,137
Orange,46,2022-10-31,1189,1189,1189,0,27140,27185,27184,1,91,14,14,14,7617,7617,7603,7603
Placer,46,2022-10-31,151,151,151,0,2755,2762,2761,1,40,0,0,5,662,662,662,662
Plumas,46,2022-10-31,5,5,5,0,87,88,87,1,0,0,0,0,13,13,13,13
Riverside,46,2022-10-31,1049,1049,1049,0,19559,19593,19592,1,64,5,5,5,6663,6663,6658,6658
Sacramento,46,2022-10-31,754,754,754,0,14141,14164,14163,1,80,8,8,16,3383,3383,3375,3375
San Benito,46,2022-10-31,33,33,33,0,745,746,745,1,1,0,0,1,104,104,104,104
San Bernardino,46,2022-10-31,1048,1048,1048,0,22481,22520,22519,1,64,2,2,11,8109,8109,8107,8107
San Diego,46,2022-10-31,1772,1773,1773,0,42850,42924,42923,1,109,5,5,13,5604,5604,5599,5599
San Francisco,46,2022-10-31,621,621,621,0,14642,14668,14667,1,45,3,3,3,1077,1077,1074,1074
San Joaquin,46,2022-10-31,332,332,332,0,8598,8613,8612,1,21,6,6,3,2355,2355,2349,2349
San Luis Obispo,46,2022-10-31,81,81,81,0,2014,2019,2018,1,1,1,1,0,530,530,529,529
San Mateo,46,2022-10-31,521,521,521,0,11581,11601,11600,1,30,0,0,2,743,743,743,743
Santa Barbara,46,2022-10-31,181,181,181,0,6036,6048,6047,1,20,1,1,6,735,735,734,734
Santa Clara,46,2022-10-31,1288,1288,1288,0,30978,31033,31032,1,85,3,3,16,2570,2570,2567,2567
Santa Cruz,46,2022-10-31,188,188,188,0,9957,9975,9974,1,7,0,0,0,275,275,275,275
Shasta,46,2022-10-31,66,66,66,0,830,831,830,1,6,2,2,1,598,598,596,596
Siskiyou,46,2022-10-31,17,17,17,0,216,217,216,1,1,1,1,0,96,96,95,95
Solano,46,2022-10-31,310,310,310,0,5255,5266,5265,1,16,0,0,4,461,461,461,461
Sonoma,46,2022-10-31,206,206,206,0,5598,5610,5609,1,24,0,0,3,529,529,529,529
Stanislaus,46,2022-10-31,235,235,235,0,4831,4840,4839,1,49,1,1,8,1796,1796,1795,1795
Sutter,46,2022-10-31,55,55,55,0,902,903,902,1,0,0,0,0,235,235,235,235
Tehama,46,2022-10-31,26,26,26,0,395,396,395,1,1,0,0,0,218,218,218,218
Trinity,46,2022-10-31,18,18,18,0,73,74,73,1,5,0,0,0,21,21,21,21
Tulare,46,2022-10-31,153,153,153,0,3679,3686,3685,1,12,0,0,0,1551,1551,1551,1551
Tuolumne,46,2022-10-31,27,27,27,0,518,519,518,1,3,0,0,0,202,202,202,202
Ventura,46,2022-10-31,378,378,378,0,9550,9567,9566,1,24,2,2,2,1607,1607,1605,1605
Yolo,46,2022-10-31,82,82,82,0,1832,1836,1835,1,3,0,0,1,406,406,406,406
Yuba,46,2022-10-31,46,46,46,0,776,777,776,1,3,1,1,0,133,133,132,132
Alameda,47,2022-11-07,1342,1342,1342,0,24522,24565,24564,1,58,4,4,11,2019,2019,2015,2015
Amador,47,2022-11-07,32,32,32,0,685,686,685,1,3,0,0,0,94,94,94,94
Butte,47,2022-11-07,118,118,118,0,1370,1371,1370,1,11,0,0,2,467,467,467,467
Calaveras,47,2022-11-07,16,16,16,0,334,335,334,1,0,0,0,0,135,135,135,135
Colusa,47,2022-11-07,2,2,2,0,102,103,102,1,0,0,0,0,22,22,22,22
Contra Costa,47,2022-11-07,880,880,880,0,15676,15703,15702,1,43,3,3,4,1488,1488,1485,1485
Del Norte,47,2022-11-07,10,10,10,0,400,401,400,1,0,0,0,0,55,55,55,55
El Dorado,47,2022-11-07,108,108,108,0,1598,1601,1600,1,7,2,2,0,236,236,234,234
Fresno,47,2022-11-07,599,599,599,0,10716,10737,10736,1,61,3,3,9,2896,2896,2893,2893
Glenn,47,2022-11-07,29,29,29,0,131,132,131,1,0,0,0,0,56,56,56,56
Humboldt,47,2022-11-07,85,85,85,0,1025,1026,1025,1,9,0,0,2,162,162,162,162
Imperial,47,2022-11-07,210,210,210,0,3708,3714,3713,1,7,0,0,0,963,963,963,963
Inyo,47,2022-11-07,19,19,19,0,267,268,267,1,0,0,0,0,60,60,60,60
Kern,47,2022-11-07,478,478,478,0,10745,10764,10763,1,29,1,1,5,2438,2438,2437,2437
Kings,47,2022-11-07,148,148,148,0,2457,2463,2462,1,7,1,1,0,467,467,466,466
Lake,47,2022-11-07,51,51,51,0,795,796,795,1,3,0,0,1,151,151,151,151
Lassen,47,2022-11-07,10,10,10,0,451,452,451,1,0,0,0,0,64,64,64,64
Los Angeles,47,2022-11-07,8115,8129,8129,0,192446,192783,192781,2,387,55,55,53,33897,33897,33842,33842
Madera,47,2022-11-07,78,78,78,0,1612,1614,1613,1,3,0,0,4,376,376,376,376
Marin,47,2022-11-07,152,152,152,0,3369,3375,3374,1,9,0,0,0,260,260,260,260
Mariposa,47,2022-11-07,14,14,14,0,121,122,121,1,0,0,0,0,30,30,30,30
Mendocino,47,2022-11-07,37,37,37,0,819,820,819,1,4,1,1,0,137,137,136,136
Merced,47,2022-11-07,142,142,142,0,2592,2598,2597,1,9,4,4,0,879,879,875,875
Modoc,47,2022-11-07,2,2,2,0,6,7,6,1,0,0,0,0,11,11,11,11
Mono,47,2022-11-07,3,3,3,0,96,97,96,1,0,0,0,0,8,8,8,8
Monterey,47,2022-11-07,218,218,218,0,3934,3943,3942,1,18,1,1,0,775,775,774,774
Napa,47,2022-11-07,77,77,77,0,1757,1761,1760,1,6,0,0,0,161,161,161,161
Nevada,47,2022-11-07,60,60,60,0,744,745,744,1,3,0,0,1,137,137,137,137
Orange,47,2022-11-07,1286,1286,1286,0,28967,29017,29016,1,94,11,11,20,7628,7628,7617,7617
Placer,47,2022-11-07,231,231,231,0,3353,3360,3359,1,53,2,2,7,664,664,662,662
Plumas,47,2022-11-07,5,5,5,0,69,70,69,1,0,0,0,0,13,13,13,13
Riverside,47,2022-11-07,1508,1509,1509,0,21693,21731,21730,1,71,2,2,5,6665,6665,6663,6663
Sacramento,47,2022-11-07,1122,1122,1122,0,16054,16080,16079,1,90,8,8,9,3391,3391,3383,3383
San Benito,47,2022-11-07,43,43,43,0,924,925,924,1,1,0,0,0,104,104,104,104
San Bernardino,47,2022-11-07,1463,1464,1464,0,24064,24106,24105,1,76,2,2,17,8111,8111,8109,8109
San Diego,47,2022-11-07,2157,2161,2161,0,45689,45769,45768,1,117,8,8,24,5612,5612,5604,5604
San Francisco,47,2022-11-07,716,716,716,0,14906,14932,14931,1,42,2,2,8,1079,1079,1077,1077
San Joaquin,47,2022-11-07,481,481,481,0,8814,8830,8829,1,24,2,2,3,2357,2357,2355,2355
San Luis Obispo,47,2022-11-07,131,131,131,0,2272,2278,2277,1,4,0,0,2,530,530,530,530
San Mateo,47,2022-11-07,582,582,582,0,12353,12375,12374,1,27,0,0,3,743,743,743,743
Santa Barbara,47,2022-11-07,225,225,225,0,6672,6685,6684,1,18,1,1,2,736,736,735,735
Santa Clara,47,2022-11-07,1675,1676,1676,0,31525,31581,31580,1,76,7,7,19,2577,2577,2570,2570
Santa Cruz,47,2022-11-07,282,282,282,0,11333,11354,11353,1,8,0,0,0,275,275,275,275
Shasta,47,2022-11-07,97,97,97,0,1058,1059,1058,1,11,1,1,3,599,599,598,598
Siskiyou,47,2022-11-07,15,15,15,0,295,296,295,1,1,0,0,0,96,96,96,96
Solano,47,2022-11-07,384,384,384,0,5513,5524,5523,1,22,2,2,3,463,463,461,461
Sonoma,47,2022-11-07,249,249,249,0,5933,5945,5944,1,11,2,2,2,531,531,529,529
Stanislaus,47,2022-11-07,300,300,300,0,4932,4941,4940,1,42,2,2,9,1798,1798,1796,1796
Sutter,47,2022-11-07,86,86,86,0,958,959,958,1,0,0,0,0,235,235,235,235
Tehama,47,2022-11-07,47,47,47,0,472,473,472,1,2,0,0,0,218,218,218,218
Trinity,47,2022-11-07,2,2,2,0,34,35,34,1,0,0,0,0,21,21,21,21
Tulare,47,2022-11-07,160,160,160,0,4366,4374,4373,1,14,0,0,0,1551,1551,1551,1551
Tuolumne,47,2022-11-07,83,83,83,0,682,683,682,1,2,0,0,0,202,202,202,202
Ventura,47,2022-11-07,448,448,448,0,10373,10391,10390,1,36,2,2,1,1609,1609,1607,1607
Yolo,47,2022-11-07,173,173,173,0,2238,2243,2242,1,3,3,3,0,409,409,406,406
Yuba,47,2022-11-07,47,47,47,0,902,903,902,1,3,0,0,2,133,133,133,133
Alameda,48,2022-11-14,1511,1512,1512,0,24309,24351,24350,1,77,3,3,9,2022,2022,2019,2019
Amador,48,2022-11-14,20,20,20,0,656,657,656,1,2,0,0,0,94,94,94,94
Butte,48,2022-11-14,120,120,120,0,1380,1382,1381,1,20,0,0,1,467,467,467,467
Calaveras,48,2022-11-14,30,30,30,0,341,342,341,1,0,0,0,0,135,135,135,135
Colusa,48,2022-11-14,11,11,11,0,100,101,100,1,1,0,0,0,22,22,22,22
Contra Costa,48,2022-11-14,968,968,968,0,15963,15991,15990,1,56,1,1,5,1489,1489,1488,1488
Del Norte,48,2022-11-14,20,20,20,0,429,430,429,1,1,0,0,0,55,55,55,55
El Dorado,48,2022-11-14,143,143,143,0,1591,1594,1593,1,7,0,0,1,236,236,236,236
Fresno,48,2022-11-14,772,772,772,0,11276,11296,11295,1,72,8,8,13,2904,2904,2896,2896
Glenn,48,2022-11-14,20,20,20,0,160,161,160,1,0,0,0,0,56,56,56,56
Humboldt,48,2022-11-14,84,84,84,0,1105,1106,1105,1,6,0,0,0,162,162,162,162
Imperial,48,2022-11-14,251,251,251,0,3221,3227,3226,1,4,0,0,1,963,963,963,963
Inyo,48,2022-11-14,11,11,11,0,543,544,543,1,0,0,0,0,60,60,60,60
Kern,48,2022-11-14,470,470,470,0,10704,10724,10723,1,26,1,1,6,2439,2439,2438,2438
Kings,48,2022-11-14,201,201,201,0,2624,2629,2628,1,6,2,2,0,469,469,467,467
Lake,48,2022-11-14,54,54,54,0,803,804,803,1,2,0,0,1,151,151,151,151
Lassen,48,2022-11-14,35,35,35,0,544,545,544,1,0,1,1,0,65,65,64,64
Los Angeles,48,2022-11-14,9434,9452,9452,0,197407,197763,197761,2,477,49,49,75,33946,33946,33897,33897
Madera,48,2022-11-14,95,95,95,0,1714,1717,1716,1,4,0,0,3,376,376,376,376
Marin,48,2022-11-14,175,175,175,0,3569,3576,3575,1,8,0,0,2,260,260,260,260
Mariposa,48,2022-11-14,18,18,18,0,137,138,137,1,0,0,0,0,30,30,30,30
Mendocino,48,2022-11-14,39,39,39,0,908,909,908,1,3,0,0,1,137,137,137,137
Merced,48,2022-11-14,186,186,186,0,2639,2645,2644,1,6,0,0,0,879,879,879,879
Modoc,48,2022-11-14,3,3,3,0,11,12,11,1,0,0,0,0,11,11,11,11
Mono,48,2022-11-14,10,10,10,0,122,123,122,1,0,0,0,0,8,8,8,8
Monterey,48,2022-11-14,200,200,200,0,4157,4166,4165,1,20,1,1,1,776,776,775,775
Napa,48,2022-11-14,105,105,105,0,1919,1923,1922,1,5,0,0,0,161,161,161,161
Nevada,48,2022-11-14,65,65,65,0,797,798,797,1,3,0,0,2,137,137,137,137
Orange,48,2022-11-14,1619,1620,1620,0,27194,27244,27243,1,118,8,8,21,7636,7636,7628,7628
Placer,48,2022-11-14,320,320,320,0,3855,3863,3862,1,54,1,1,5,665,665,664,664
Plumas,48,2022-11-14,4,4,4,0,80,81,80,1,0,0,0,0,13,13,13,13
Riverside,48,2022-11-14,1662,1663,1663,0,22496,22537,22536,1,95,4,4,10,6669,6669,6665,6665
Sacramento,48,2022-11-14,1214,1214,1214,0,16983,17014,17013,1,82,7,7,18,3398,3398,3391,3391
San Benito,48,2022-11-14,42,42,42,0,979,980,979,1,1,0,0,0,104,104,104,104
San Bernardino,48,2022-11-14,1817,1818,1818,0,24234,24278,24277,1,83,0,0,14,8111,8111,8111,8111
San Diego,48,2022-11-14,2456,2461,2461,0,43913,43991,43990,1,124,8,8,21,5620,5620,5612,5612
San Francisco,48,2022-11-14,717,717,717,0,13762,13786,13785,1,52,7,7,5,1086,1086,1079,1079
San Joaquin,48,2022-11-14,609,609,609,0,9500,9518,9517,1,20,0,0,5,2357,2357,2357,2357
San Luis Obispo,48,2022-11-14,120,120,120,0,2201,2206,2205,1,6,0,0,1,530,530,530,530
San Mateo,48,2022-11-14,662,662,662,0,11419,11439,11438,1,27,0,0,2,743,743,743,743
Santa Barbara,48,2022-11-14,192,192,192,0,5891,5903,5902,1,15,1,1,2,737,737,736,736
Santa Clara,48,2022-11-14,1773,1774,1774,0,30789,30847,30846,1,117,3,3,14,2580,2580,2577,2577
Santa Cruz,48,2022-11-14,249,249,249,0,9607,9625,9624,1,11,1,1,0,276,276,275,275
Shasta,48,2022-11-14,107,107,107,0,1073,1075,1074,1,10,1,1,2,600,600,599,599
Siskiyou,48,2022-11-14,27,27,27,0,397,398,397,1,2,0,0,0,96,96,96,96
Solano,48,2022-11-14,438,438,438,0,5428,5439,5438,1,26,0,0,3,463,463,463,463
Sonoma,48,2022-11-14,270,270,270,0,6037,6049,6048,1,23,1,1,0,532,532,531,531
Stanislaus,48,2022-11-14,328,328,328,0,5224,5234,5233,1,48,0,0,10,1798,1798,1798,1798
Sutter,48,2022-11-14,95,95,95,0,1183,1185,1184,1,0,0,0,0,235,235,235,235
Tehama,48,2022-11-14,49,49,49,0,574,575,574,1,1,0,0,0,218,218,218,218
Trinity,48,2022-11-14,11,11,11,0,52,53,52,1,0,2,2,0,23,23,21,21
Tulare,48,2022-11-14,311,311,311,0,4283,4291,4290,1,16,0,0,1,1551,1551,1551,1551
Tuolumne,48,2022-11-14,77,77,77,0,695,696,695,1,2,0,0,0,202,202,202,202
Ventura,48,2022-11-14,572,572,572,0,10638,10658,10657,1,28,1,1,4,1610,1610,1609,1609
Yolo,48,2022-11-14,152,152,152,0,2164,2169,2168,1,2,6,6,0,415,415,409,409
Yuba,48,2022-11-14,60,60,60,0,987,988,987,1,6,0,0,1,133,133,133,133
Alameda,49,2022-11-21,1743,1745,1745,0,25497,25545,25544,1,82,8,8,16,2030,2030,2022,2022
Amador,49,2022-11-21,28,28,28,0,833,834,833,1,2,0,0,0,94,94,94,94
Butte,49,2022-11-21,143,143,143,0,1328,1330,1329,1,21,0,0,1,467,467,467,467
Calaveras,49,2022-11-21,40,40,40,0,421,422,421,1,2,0,0,0,135,135,135,135
Colusa,49,2022-11-21,9,9,9,0,110,111,110,1,0,0,0,0,22,22,22,22
Contra Costa,49,2022-11-21,1029,1029,1029,0,16521,16553,16552,1,52,3,3,8,1492,1492,1489,1489
Del Norte,49,2022-11-21,18,18,18,0,489,490,489,1,4,0,0,0,55,55,55,55
El Dorado,49,2022-11-21,186,186,186,0,1830,1835,1834,1,10,0,0,1,236,236,236,236
Fresno,49,2022-11-21,1070,1070,1070,0,12149,12172,12171,1,114,5,5,9,2909,2909,2904,2904
Glenn,49,2022-11-21,21,21,21,0,214,215,214,1,0,0,0,0,56,56,56,56
Humboldt,49,2022-11-21,126,126,126,0,1174,1175,1174,1,4,1,1,1,163,163,162,162
Imperial,49,2022-11-21,280,280,280,0,3122,3129,3128,1,3,1,1,1,964,964,963,963
Inyo,49,2022-11-21,29,29,29,0,405,406,405,1,0,1,1,0,61,61,60,60
Kern,49,2022-11-21,506,506,506,0,10333,10353,10352,1,54,3,3,10,2442,2442,2439,2439
Kings,49,2022-11-21,295,295,295,0,2780,2786,2785,1,4,2,2,1,471,471,469,469
Lake,49,2022-11-21,55,55,55,0,929,930,929,1,0,1,1,1,152,152,151,151
Lassen,49,2022-11-21,34,34,34,0,541,542,541,1,0,0,0,0,65,65,65,65
Los Angeles,49,2022-11-21,13238,13264,13264,0,200584,200962,200960,2,648,69,69,93,34015,34015,33946,33946
Madera,49,2022-11-21,168,168,168,0,1861,1866,1865,1,11,0,0,1,376,376,376,376
Marin,49,2022-11-21,179,179,179,0,3353,3360,3359,1,8,0,0,0,260,260,260,260
Mariposa,49,2022-11-21,19,19,19,0,170,171,170,1,0,0,0,0,30,30,30,30
Mendocino,49,2022-11-21,39,39,39,0,890,891,890,1,4,0,0,1,137,137,137,137
Merced,49,2022-11-21,269,269,269,0,2931,2937,2936,1,9,2,2,4,881,881,879,879
Modoc,49,2022-11-21,8,8,8,0,13,14,13,1,0,0,0,0,11,11,11,11
Mono,49,2022-11-21,3,3,3,0,107,108,107,1,0,0,0,0,8,8,8,8
Monterey,49,2022-11-21,226,226,226,0,4446,4456,4455,1,17,1,1,0,777,777,776,776
Napa,49,2022-11-21,146,146,146,0,2040,2046,2045,1,4,0,0,1,161,161,161,161
Nevada,49,2022-11-21,92,92,92,0,935,936,935,1,2,0,0,2,137,137,137,137
Orange,49,2022-11-21,2240,2245,2245,0,28654,28709,28708,1,170,14,14,32,7650,7650,7636,7636
Placer,49,2022-11-21,362,362,362,0,4079,4087,4086,1,53,0,0,6,665,665,665,665
Plumas,49,2022-11-21,7,7,7,0,104,105,104,1,1,0,0,0,13,13,13,13
Riverside,49,2022-11-21,2181,2186,2186,0,24561,24607,24606,1,110,7,7,9,6676,6676,6669,6669
Sacramento,49,2022-11-21,1553,1554,1554,0,19058,19094,19093,1,105,3,3,18,3401,3401,3398,3398
San Benito,49,2022-11-21,64,64,64,0,1157,1159,1158,1,2,0,0,0,104,104,104,104
San Bernardino,49,2022-11-21,2391,2397,2397,0,26916,26967,26966,1,89,1,1,19,8112,8112,8111,8111
San Diego,49,2022-11-21,3174,3180,3180,0,44135,44219,44218,1,198,3,3,26,5623,5623,5620,5620
San Francisco,49,2022-11-21,958,958,958,0,15162,15191,15190,1,54,5,5,7,1091,1091,1086,1086
San Joaquin,49,2022-11-21,765,765,765,0,11080,11102,11101,1,36,1,1,5,2358,2358,2357,2357
San Luis Obispo,49,2022-11-21,170,170,170,0,2352,2358,2357,1,4,1,1,0,531,531,530,530
San Mateo,49,2022-11-21,759,759,759,0,12399,12423,12422,1,36,0,0,1,743,743,743,743
Santa Barbara,49,2022-11-21,321,321,321,0,6109,6121,6120,1,15,3,3,3,740,740,737,737
Santa Clara,49,2022-11-21,2210,2215,2215,0,34651,34716,34715,1,119,10,10,23,2590,2590,2580,2580
Santa Cruz,49,2022-11-21,286,286,286,0,9527,9546,9545,1,12,0,0,2,276,276,276,276
Shasta,49,2022-11-21,98,98,98,0,1056,1057,1056,1,14,2,2,1,602,602,600,600
Siskiyou,49,2022-11-21,24,24,24,0,342,343,342,1,1,0,0,0,96,96,96,96
Solano,49,2022-11-21,490,490,490,0,5667,5680,5679,1,32,1,1,5,464,464,463,463
Sonoma,49,2022-11-21,328,328,328,0,5783,5796,5795,1,22,0,0,4,532,532,532,532
Stanislaus,49,2022-11-21,445,445,445,0,5972,5985,5984,1,51,0,0,10,1798,1798,1798,1798
Sutter,49,2022-11-21,91,91,91,0,1143,1145,1144,1,0,0,0,0,235,235,235,235
Tehama,49,2022-11-21,74,74,74,0,673,674,673,1,3,0,0,2,218,218,218,218
Trinity,49,2022-11-21,5,5,5,0,51,52,51,1,0,0,0,0,23,23,23,23
Tulare,49,2022-11-21,431,431,431,0,5505,5516,5515,1,23,0,0,1,1551,1551,1551,1551
Tuolumne,49,2022-11-21,96,96,96,0,766,767,766,1,3,1,1,0,203,203,202,202
Ventura,49,2022-11-21,728,728,728,0,10731,10753,10752,1,43,1,1,2,1611,1611,1610,1610
Yolo,49,2022-11-21,132,132,132,0,2247,2253,2252,1,7,4,4,2,419,419,415,415
Yuba,49,2022-11-21,70,70,70,0,1027,1028,1027,1,10,0,0,1,133,133,133,133
Alameda,50,2022-11-28,2278,2284,2284,0,22324,22369,22368,1,103,5,5,13,2035,2035,2030,2030
Amador,50,2022-11-28,32,32,32,0,757,758,757,1,5,1,1,1,95,95,94,94
Butte,50,2022-11-28,204,204,204,0,1476,1480,1479,1,41,0,0,1,467,467,467,467
Calaveras,50,2022-11-28,32,32,32,0,402,403,402,1,3,0,0,0,135,135,135,135
Colusa,50,2022-11-28,14,14,14,0,184,185,184,1,0,0,0,0,22,22,22,22
Contra Costa,50,2022-11-28,1471,1472,1472,0,15542,15572,15571,1,67,4,4,8,1496,1496,1492,1492
Del Norte,50,2022-11-28,33,33,33,0,458,459,458,1,1,1,1,0,56,56,55,55
El Dorado,50,2022-11-28,185,185,185,0,1549,1551,1550,1,13,1,1,1,237,237,236,236
Fresno,50,2022-11-28,1322,1323,1323,0,11709,11732,11731,1,136,6,6,19,2915,2915,2909,2909
Glenn,50,2022-11-28,17,17,17,0,194,195,194,1,3,0,0,0,56,56,56,56
Humboldt,50,2022-11-28,118,118,118,0,1045,1047,1046,1,10,0,0,0,163,163,163,163
Imperial,50,2022-11-28,379,379,379,0,2792,2798,2797,1,6,1,1,1,965,965,964,964
Inyo,50,2022-11-28,34,34,34,0,376,377,376,1,2,0,0,0,61,61,61,61
Kern,50,2022-11-28,599,599,599,0,9537,9557,9556,1,60,5,5,6,2447,2447,2442,2442
Kings,50,2022-11-28,246,246,246,0,2545,2550,2549,1,10,0,0,0,471,471,471,471
Lake,50,2022-11-28,49,49,49,0,848,849,848,1,1,0,0,0,152,152,152,152
Lassen,50,2022-11-28,27,27,27,0,493,494,493,1,0,0,0,0,65,65,65,65
Los Angeles,50,2022-11-28,18975,19012,19012,0,185224,185593,185591,2,918,90,90,122,34105,34105,34015,34015
Madera,50,2022-11-28,162,162,162,0,1627,1631,1630,1,13,0,0,2,376,376,376,376
Marin,50,2022-11-28,298,298,298,0,3071,3079,3078,1,19,0,0,1,260,260,260,260
Mariposa,50,2022-11-28,23,23,23,0,136,137,136,1,0,0,0,0,30,30,30,30
Mendocino,50,2022-11-28,49,49,49,0,726,727,726,1,5,0,0,2,137,137,137,137
Merced,50,2022-11-28,349,349,349,0,2552,2558,2557,1,18,5,5,2,886,886,881,881
Modoc,50,2022-11-28,5,5,5,0,10,11,10,1,0,0,0,0,11,11,11,11
Mono,50,2022-11-28,4,4,4,0,94,95,94,1,0,0,0,0,8,8,8,8
Monterey,50,2022-11-28,283,283,283,0,3893,3901,3900,1,26,1,1,0,778,778,777,777
Napa,50,2022-11-28,140,140,140,0,1882,1886,1885,1,6,0,0,3,161,161,161,161
Nevada,50,2022-11-28,118,118,118,0,1008,1010,1009,1,9,0,0,0,137,137,137,137
Orange,50,2022-11-28,3190,3197,3197,0,26616,26670,26669,1,221,17,17,34,7667,7667,7650,7650
Placer,50,2022-11-28,391,391,391,0,3786,3794,3793,1,69,3,3,5,668,668,665,665
Plumas,50,2022-11-28,6,6,6,0,143,144,143,1,0,0,0,0,13,13,13,13
Riverside,50,2022-11-28,3237,3244,3244,0,23436,23481,23480,1,188,12,12,22,6688,6688,6676,6676
Sacramento,50,2022-11-28,1816,1819,1819,0,18077,18113,18112,1,126,9,9,14,3410,3410,3401,3401
San Benito,50,2022-11-28,131,131,131,0,1223,1226,1225,1,1,0,0,0,104,104,104,104
San Bernardino,50,2022-11-28,3368,3375,3375,0,26028,26079,26078,1,146,1,1,20,8113,8113,8112,8112
San Diego,50,2022-11-28,4099,4107,4107,0,32004,32070,32069,1,259,8,8,27,5631,5631,5623,5623
San Francisco,50,2022-11-28,1171,1172,1172,0,12783,12808,12807,1,67,6,6,8,1097,1097,1091,1091
San Joaquin,50,2022-11-28,993,994,994,0,10948,10971,10970,1,50,3,3,11,2361,2361,2358,2358
San Luis Obispo,50,2022-11-28,179,179,179,0,2249,2253,2252,1,9,3,3,1,534,534,531,531
San Mateo,50,2022-11-28,1116,1117,1117,0,11095,11116,11115,1,42,1,1,3,744,744,743,743
Santa Barbara,50,2022-11-28,466,466,466,0,5212,5224,5223,1,27,2,2,5,742,742,740,740
Santa Clara,50,2022-11-28,2941,2947,2947,0,28323,28380,28379,1,159,9,9,22,2599,2599,2590,2590
Santa Cruz,50,2022-11-28,371,371,371,0,6668,6683,6682,1,20,0,0,2,276,276,276,276
Shasta,50,2022-11-28,99,99,99,0,1010,1012,1011,1,16,2,2,3,604,604,602,602
Siskiyou,50,2022-11-28,27,27,27,0,277,278,277,1,2,0,0,0,96,96,96,96
Solano,50,2022-11-28,592,592,592,0,5187,5199,5198,1,34,2,2,7,466,466,464,464
Sonoma,50,2022-11-28,453,453,453,0,5012,5023,5022,1,48,2,2,3,534,534,532,532
Stanislaus,50,2022-11-28,523,523,523,0,5363,5374,5373,1,77,3,3,4,1801,1801,1798,1798
Sutter,50,2022-11-28,83,83,83,0,1120,1121,1120,1,0,0,0,0,235,235,235,235
Tehama,50,2022-11-28,70,70,70,0,632,633,632,1,6,0,0,3,218,218,218,218
Trinity,50,2022-11-28,3,3,3,0,60,61,60,1,0,0,0,0,23,23,23,23
Tulare,50,2022-11-28,512,512,512,0,4932,4943,4942,1,34,0,0,0,1551,1551,1551,1551
Tuolumne,50,2022-11-28,72,72,72,0,676,677,676,1,4,0,0,0,203,203,203,203
Ventura,50,2022-11-28,966,966,966,0,10618,10640,10639,1,58,2,2,2,1613,1613,1611,1611
Yolo,50,2022-11-28,169,169,169,0,2034,2038,2037,1,3,4,4,1,423,423,419,419
Yuba,50,2022-11-28,92,92,92,0,927,928,927,1,12,0,0,0,133,133,133,133
Alameda,51,2022-12-05,2835,2842,2842,0,29280,29341,29340,1,126,7,7,13,2042,2042,2035,2035
Amador,51,2022-12-05,41,41,41,0,812,814,813,1,3,0,0,2,95,95,95,95
Butte,51,2022-12-05,239,239,239,0,1887,1892,1891,1,38,7,7,5,474,474,467,467
Calaveras,51,2022-12-05,45,45,45,0,485,486,485,1,0,0,0,0,135,135,135,135
Colusa,51,2022-12-05,13,13,13,0,206,207,206,1,4,0,0,0,22,22,22,22
Contra Costa,51,2022-12-05,1780,1785,1785,0,19308,19348,19347,1,78,0,0,11,1496,1496,1496,1496
Del Norte,51,2022-12-05,39,39,39,0,566,567,566,1,2,0,0,0,56,56,56,56
El Dorado,51,2022-12-05,182,182,182,0,1577,1583,1582,1,14,1,1,0,238,238,237,237
Fresno,51,2022-12-05,1549,1552,1552,0,14300,14330,14329,1,177,6,6,17,2921,2921,2915,2915
Glenn,51,2022-12-05,24,24,24,0,232,233,232,1,2,0,0,0,56,56,56,56
Humboldt,51,2022-12-05,141,141,141,0,1086,1087,1086,1,17,1,1,2,164,164,163,163
Imperial,51,2022-12-05,587,587,587,0,3398,3406,3405,1,18,2,2,5,967,967,965,965
Inyo,51,2022-12-05,26,26,26,0,333,334,333,1,1,1,1,0,62,62,61,61
Kern,51,2022-12-05,819,819,819,0,10832,10856,10855,1,55,1,1,10,2448,2448,2447,2447
Kings,51,2022-12-05,294,294,294,0,3048,3055,3054,1,8,0,0,0,471,471,471,471
Lake,51,2022-12-05,64,64,64,0,831,832,831,1,2,0,0,0,152,152,152,152
Lassen,51,2022-12-05,14,14,14,0,444,445,444,1,0,0,0,0,65,65,65,65
Los Angeles,51,2022-12-05,22486,22532,22532,0,245215,245725,245722,3,1119,111,111,151,34216,34216,34105,34105
Madera,51,2022-12-05,205,205,205,0,1983,1989,1988,1,12,0,0,3,376,376,376,376
Marin,51,2022-12-05,312,312,312,0,3509,3517,3516,1,14,0,0,2,260,260,260,260
Mariposa,51,2022-12-05,19,19,19,0,174,175,174,1,0,0,0,0,30,30,30,30
Mendocino,51,2022-12-05,47,47,47,0,797,798,797,1,6,1,1,2,138,138,137,137
Merced,51,2022-12-05,352,352,352,0,3212,3219,3218,1,23,2,2,2,888,888,886,886
Modoc,51,2022-12-05,12,12,12,0,13,14,13,1,0,0,0,0,11,11,11,11
Mono,51,2022-12-05,9,9,9,0,91,92,91,1,0,0,0,0,8,8,8,8
Monterey,51,2022-12-05,271,271,271,0,4389,4399,4398,1,34,1,1,0,779,779,778,778
Napa,51,2022-12-05,161,161,161,0,2342,2348,2347,1,7,0,0,0,161,161,161,161
Nevada,51,2022-12-05,115,115,115,0,1126,1129,1128,1,8,0,0,2,137,137,137,137
Orange,51,2022-12-05,4356,4365,4365,0,34731,34804,34803,1,301,22,22,48,7689,7689,7667,7667
Placer,51,2022-12-05,396,396,396,0,4059,4068,4067,1,72,1,1,4,669,669,668,668
Plumas,51,2022-12-05,22,22,22,0,185,186,185,1,1,0,0,0,13,13,13,13
Riverside,51,2022-12-05,4047,4054,4054,0,27545,27600,27599,1,186,13,13,25,6701,6701,6688,6688
Sacramento,51,2022-12-05,2157,2162,2162,0,21272,21315,21314,1,128,9,9,28,3419,3419,3410,3410
San Benito,51,2022-12-05,217,217,217,0,1484,1488,1487,1,6,1,1,3,105,105,104,104
San Bernardino,51,2022-12-05,4126,4134,4134,0,28694,28755,28754,1,167,0,0,34,8113,8113,8113,8113
San Diego,51,2022-12-05,5693,5705,5705,0,44791,44884,44883,1,302,14,14,30,5645,5645,5631,5631
San Francisco,51,2022-12-05,1493,1495,1495,0,16004,16037,16036,1,77,7,7,7,1104,1104,1097,1097
San Joaquin,51,2022-12-05,1122,1122,1122,0,12640,12667,12666,1,70,9,9,16,2370,2370,2361,2361
San Luis Obispo,51,2022-12-05,206,206,206,0,2662,2668,2667,1,15,3,3,1,537,537,534,534
San Mateo,51,2022-12-05,1259,1259,1259,0,13631,13660,13659,1,56,1,1,1,745,745,744,744
Santa Barbara,51,2022-12-05,521,521,521,0,6765,6781,6780,1,38,1,1,9,743,743,742,742
Santa Clara,51,2022-12-05,3530,3537,3537,0,35818,35894,35893,1,207,12,12,26,2611,2611,2599,2599
Santa Cruz,51,2022-12-05,471,471,471,0,12742,12768,12767,1,22,0,0,3,276,276,276,276
Shasta,51,2022-12-05,132,132,132,0,1108,1110,1109,1,23,0,0,5,604,604,604,604
Siskiyou,51,2022-12-05,22,22,22,0,309,310,309,1,2,0,0,0,96,96,96,96
Solano,51,2022-12-05,646,646,646,0,6617,6631,6630,1,33,1,1,7,467,467,466,466
Sonoma,51,2022-12-05,510,510,510,0,5883,5896,5895,1,35,5,5,1,539,539,534,534
Stanislaus,51,2022-12-05,640,640,640,0,6731,6746,6745,1,76,1,1,7,1802,1802,1801,1801
Sutter,51,2022-12-05,96,96,96,0,1173,1175,1174,1,0,1,1,0,236,236,235,235
Tehama,51,2022-12-05,93,93,93,0,817,818,817,1,9,2,2,0,220,220,218,218
Trinity,51,2022-12-05,3,3,3,0,39,40,39,1,0,0,0,0,23,23,23,23
Tulare,51,2022-12-05,528,528,528,0,5951,5965,5964,1,35,0,0,1,1551,1551,1551,1551
Tuolumne,51,2022-12-05,107,107,107,0,852,853,852,1,2,0,0,0,203,203,203,203
Ventura,51,2022-12-05,1102,1102,1102,0,12190,12216,12215,1,71,2,2,6,1615,1615,1613,1613
Yolo,51,2022-12-05,215,215,215,0,2651,2657,2656,1,2,1,1,3,424,424,423,423
Yuba,51,2022-12-05,82,82,82,0,1038,1039,1038,1,11,0,0,1,133,133,133,133
Alameda,52,2022-12-12,2694,2701,2701,0,29594,29660,29659,1,147,10,10,20,2052,2052,2042,2042
Amador,52,2022-12-12,32,32,32,0,790,791,790,1,3,0,0,0,95,95,95,95
Butte,52,2022-12-12,182,182,182,0,1836,1841,1840,1,39,2,2,2,476,476,474,474
Calaveras,52,2022-12-12,41,41,41,0,454,455,454,1,1,0,0,0,135,135,135,135
Colusa,52,2022-12-12,12,12,12,0,272,273,272,1,1,0,0,0,22,22,22,22
Contra Costa,52,2022-12-12,1736,1741,1741,0,18441,18480,18479,1,78,11,11,4,1507,1507,1496,1496
Del Norte,52,2022-12-12,34,34,34,0,534,535,534,1,3,0,0,0,56,56,56,56
El Dorado,52,2022-12-12,146,146,146,0,1410,1413,1412,1,8,1,1,3,239,239,238,238
Fresno,52,2022-12-12,1485,1488,1488,0,13859,13889,13888,1,186,12,12,18,2933,2933,2921,2921
Glenn,52,2022-12-12,17,17,17,0,230,231,230,1,6,0,0,0,56,56,56,56
Humboldt,52,2022-12-12,110,110,110,0,1014,1015,1014,1,13,1,1,2,165,165,164,164
Imperial,52,2022-12-12,455,455,455,0,2942,2948,2947,1,27,3,3,3,970,970,967,967
Inyo,52,2022-12-12,22,22,22,0,303,304,303,1,1,0,0,0,62,62,62,62
Kern,52,2022-12-12,955,955,955,0,11016,11040,11039,1,55,3,3,4,2451,2451,2448,2448
Kings,52,2022-12-12,256,256,256,0,2855,2862,2861,1,8,2,2,0,473,473,471,471
Lake,52,2022-12-12,56,56,56,0,761,762,761,1,3,0,0,1,152,152,152,152
Lassen,52,2022-12-12,15,15,15,0,423,424,423,1,0,0,0,0,65,65,65,65
Los Angeles,52,2022-12-12,17589,17627,17627,0,227749,228246,228243,3,1113,158,158,154,34374,34374,34216,34216
Madera,52,2022-12-12,212,212,212,0,2174,2180,2179,1,15,0,0,2,376,376,376,376
Marin,52,2022-12-12,315,315,315,0,3620,3628,3627,1,24,0,0,2,260,260,260,260
Mariposa,52,2022-12-12,18,18,18,0,123,124,123,1,0,0,0,0,30,30,30,30
Mendocino,52,2022-12-12,53,53,53,0,657,658,657,1,7,1,1,0,139,139,138,138
Merced,52,2022-12-12,318,318,318,0,3325,3331,3330,1,14,0,0,2,888,888,888,888
Modoc,52,2022-12-12,5,5,5,0,10,11,10,1,0,0,0,0,11,11,11,11
Mono,52,2022-12-12,9,9,9,0,122,123,122,1,0,0,0,0,8,8,8,8
Monterey,52,2022-12-12,263,263,263,0,4259,4270,4269,1,25,3,3,2,782,782,779,779
Napa,52,2022-12-12,162,162,162,0,2173,2179,2178,1,9,1,1,0,162,162,161,161
Nevada,52,2022-12-12,90,90,90,0,969,970,969,1,5,0,0,2,137,137,137,137
Orange,52,2022-12-12,3496,3503,3503,0,31467,31535,31534,1,300,35,35,48,7724,7724,7689,7689
Placer,52,2022-12-12,332,332,332,0,3892,3901,3900,1,73,5,5,6,674,674,669,669
Plumas,52,2022-12-12,7,7,7,0,186,187,186,1,2,0,0,0,13,13,13,13
Riverside,52,2022-12-12,3340,3347,3347,0,24681,24734,24733,1,204,20,20,25,6721,6721,6701,6701
Sacramento,52,2022-12-12,1824,1829,1829,0,20160,20203,20202,1,173,7,7,31,3426,3426,3419,3419
San Benito,52,2022-12-12,125,125,125,0,1329,1332,1331,1,2,2,2,2,107,107,105,105
San Bernardino,52,2022-12-12,3603,3610,3610,0,26990,27049,27048,1,226,4,4,36,8117,8117,8113,8113
San Diego,52,2022-12-12,4849,4860,4860,0,40660,40748,40747,1,331,15,15,45,5660,5660,5645,5645
San Francisco,52,2022-12-12,1427,1429,1429,0,16807,16845,16844,1,103,7,7,12,1111,1111,1104,1104
San Joaquin,52,2022-12-12,1002,1002,1002,0,12713,12741,12740,1,68,6,6,19,2376,2376,2370,2370
San Luis Obispo,52,2022-12-12,231,231,231,0,2650,2656,2655,1,10,1,1,0,538,538,537,537
San Mateo,52,2022-12-12,1171,1171,1171,0,12499,12526,12525,1,59,1,1,3,746,746,745,745
Santa Barbara,52,2022-12-12,512,512,512,0,5768,5781,5780,1,36,2,2,6,745,745,743,743
Santa Clara,52,2022-12-12,3260,3267,3267,0,35164,35241,35240,1,198,19,19,30,2630,2630,2611,2611
Santa Cruz,52,2022-12-12,578,578,578,0,12943,12971,12970,1,29,0,0,1,276,276,276,276
Shasta,52,2022-12-12,106,106,106,0,1154,1156,1155,1,22,0,0,5,604,604,604,604
Siskiyou,52,2022-12-12,15,15,15,0,245,246,245,1,2,0,0,0,96,96,96,96
Solano,52,2022-12-12,635,635,635,0,6178,6193,6192,1,42,2,2,7,469,469,467,467
Sonoma,52,2022-12-12,556,556,556,0,5592,5605,5604,1,41,2,2,7,541,541,539,539
Stanislaus,52,2022-12-12,593,593,593,0,6385,6400,6399,1,104,8,8,12,1810,1810,1802,1802
Sutter,52,2022-12-12,114,114,114,0,1156,1158,1157,1,0,0,0,0,236,236,236,236
Tehama,52,2022-12-12,78,78,78,0,774,775,774,1,6,1,1,0,221,221,220,220
Trinity,52,2022-12-12,3,3,3,0,45,46,45,1,0,0,0,0,23,23,23,23
Tulare,52,2022-12-12,442,442,442,0,5892,5907,5906,1,27,2,2,2,1553,1553,1551,1551
Tuolumne,52,2022-12-12,133,133,133,0,936,937,936,1,5,0,0,0,203,203,203,203
Ventura,52,2022-12-12,915,915,915,0,10660,10685,10684,1,72,4,4,7,1619,1619,1615,1615
Yolo,52,2022-12-12,210,210,210,0,2300,2306,2305,1,5,2,2,2,426,426,424,424
Yuba,52,2022-12-12,75,75,75,0,948,949,948,1,13,0,0,0,133,133,133,133
Alameda,53,2022-12-19,2351,2358,2358,0,27042,27105,27104,1,144,8,8,19,2060,2060,2052,2052
Amador,53,2022-12-19,42,42,42,0,807,808,807,1,6,0,0,0,95,95,95,95
Butte,53,2022-12-19,128,128,128,0,1639,1643,1642,1,34,3,3,2,479,479,476,476
Calaveras,53,2022-12-19,29,29,29,0,441,442,441,1,1,1,1,0,136,136,135,135
Colusa,53,2022-12-19,12,12,12,0,214,215,214,1,1,0,0,0,22,22,22,22
Contra Costa,53,2022-12-19,1715,1719,1719,0,17365,17403,17402,1,95,6,6,7,1513,1513,1507,1507
Del Norte,53,2022-12-19,39,39,39,0,553,554,553,1,3,0,0,0,56,56,56,56
El Dorado,53,2022-12-19,160,160,160,0,1632,1638,1637,1,9,1,1,2,240,240,239,239
Fresno,53,2022-12-19,1180,1180,1180,0,12896,12927,12926,1,212,7,7,22,2940,2940,2933,2933
Glenn,53,2022-12-19,21,21,21,0,205,206,205,1,6,0,0,0,56,56,56,56
Humboldt,53,2022-12-19,118,118,118,0,945,946,945,1,9,0,0,1,165,165,165,165
Imperial,53,2022-12-19,262,262,262,0,2546,2552,2551,1,16,1,1,0,971,971,970,970
Inyo,53,2022-12-19,12,12,12,0,324,325,324,1,1,0,0,0,62,62,62,62
Kern,53,2022-12-19,940,940,940,0,10707,10733,10732,1,60,3,3,5,2454,2454,2451,2451
Kings,53,2022-12-19,229,229,229,0,2770,2776,2775,1,6,4,4,1,477,477,473,473
Lake,53,2022-12-19,70,70,70,0,794,795,794,1,4,1,1,0,153,153,152,152
Lassen,53,2022-12-19,8,8,8,0,466,467,466,1,0,0,0,0,65,65,65,65
Los Angeles,53,2022-12-19,15305,15340,15340,0,204323,204790,204788,2,1096,129,129,155,34503,34503,34374,34374
Madera,53,2022-12-19,186,186,186,0,1891,1897,1896,1,10,0,0,1,376,376,376,376
Marin,53,2022-12-19,268,268,268,0,3234,3241,3240,1,17,0,0,0,260,260,260,260
Mariposa,53,2022-12-19,25,25,25,0,133,134,133,1,0,0,0,0,30,30,30,30
Mendocino,53,2022-12-19,66,66,66,0,755,756,755,1,4,0,0,0,139,139,139,139
Merced,53,2022-12-19,262,262,262,0,2773,2780,2779,1,15,2,2,2,890,890,888,888
Modoc,53,2022-12-19,8,8,8,0,21,22,21,1,0,0,0,0,11,11,11,11
Mono,53,2022-12-19,11,11,11,0,121,122,121,1,1,0,0,0,8,8,8,8
Monterey,53,2022-12-19,232,232,232,0,3880,3891,3890,1,13,1,1,1,783,783,782,782
Napa,53,2022-12-19,181,181,181,0,2094,2101,2100,1,8,0,0,0,162,162,162,162
Nevada,53,2022-12-19,72,72,72,0,883,884,883,1,5,0,0,2,137,137,137,137
Orange,53,2022-12-19,3306,3313,3313,0,30251,30320,30319,1,296,34,34,51,7758,7758,7724,7724
Placer,53,2022-12-19,364,364,364,0,3845,3854,3853,1,90,2,2,10,676,676,674,674
Plumas,53,2022-12-19,7,7,7,0,188,189,188,1,0,0,0,0,13,13,13,13
Riverside,53,2022-12-19,3165,3172,3172,0,22874,22926,22925,1,177,21,21,22,6742,6742,6721,6721
Sacramento,53,2022-12-19,1739,1744,1744,0,19757,19802,19801,1,210,15,15,22,3441,3441,3426,3426
San Benito,53,2022-12-19,105,105,105,0,1136,1139,1138,1,0,4,4,1,111,111,107,107
San Bernardino,53,2022-12-19,3214,3221,3221,0,25080,25138,25137,1,200,4,4,38,8121,8121,8117,8117
San Diego,53,2022-12-19,4854,4866,4866,0,39403,39493,39492,1,381,16,16,45,5676,5676,5660,5660
San Francisco,53,2022-12-19,1227,1228,1228,0,15734,15771,15770,1,106,11,11,17,1122,1122,1111,1111
San Joaquin,53,2022-12-19,851,851,851,0,12996,13026,13025,1,58,11,11,19,2387,2387,2376,2376
San Luis Obispo,53,2022-12-19,242,242,242,0,2423,2429,2428,1,17,1,1,0,539,539,538,538
San Mateo,53,2022-12-19,958,958,958,0,11890,11918,11917,1,62,1,1,5,747,747,746,746
Santa Barbara,53,2022-12-19,470,470,470,0,5251,5264,5263,1,35,4,4,5,749,749,745,745
Santa Clara,53,2022-12-19,2838,2845,2845,0,32503,32578,32577,1,205,17,17,30,2647,2647,2630,2630
Santa Cruz,53,2022-12-19,260,260,260,0,11209,11234,11233,1,31,0,0,1,276,276,276,276
Shasta,53,2022-12-19,109,109,109,0,1126,1128,1127,1,24,2,2,4,606,606,604,604
Siskiyou,53,2022-12-19,15,15,15,0,258,259,258,1,2,0,0,0,96,96,96,96
Solano,53,2022-12-19,639,639,639,0,6177,6192,6191,1,41,0,0,6,469,469,469,469
Sonoma,53,2022-12-19,478,478,478,0,5425,5438,5437,1,38,1,1,4,542,542,541,541
Stanislaus,53,2022-12-19,474,474,474,0,6000,6013,6012,1,94,1,1,12,1811,1811,1810,1810
Sutter,53,2022-12-19,81,81,81,0,1074,1076,1075,1,0,1,1,0,237,237,236,236
Tehama,53,2022-12-19,68,68,68,0,676,677,676,1,6,1,1,0,222,222,221,221
Trinity,53,2022-12-19,2,2,2,0,31,32,31,1,0,0,0,0,23,23,23,23
Tulare,53,2022-12-19,467,467,467,0,5382,5395,5394,1,53,5,5,1,1558,1558,1553,1553
Tuolumne,53,2022-12-19,88,88,88,0,841,842,841,1,2,1,1,1,204,204,203,203
Ventura,53,2022-12-19,937,937,937,0,9969,9993,9992,1,81,4,4,9,1623,1623,1619,1619
Yolo,53,2022-12-19,172,172,172,0,1967,1973,1972,1,5,4,4,0,430,430,426,426
Yuba,53,2022-12-19,81,81,81,0,900,901,900,1,7,1,1,0,134,134,133,133
Alameda,54,2022-12-26,1971,1976,1976,0,20711,20761,20760,1,150,10,10,17,2070,2070,2060,2060
Amador,54,2022-12-26,44,44,44,0,759,761,760,1,5,1,1,0,96,96,95,95
Butte,54,2022-12-26,95,95,95,0,1296,1300,1299,1,33,0,0,1,479,479,479,479
Calaveras,54,2022-12-26,24,24,24,0,367,368,367,1,0,1,1,0,137,137,136,136
Colusa,54,2022-12-26,14,14,14,0,150,151,150,1,0,0,0,0,22,22,22,22
Contra Costa,54,2022-12-26,1453,1458,1458,0,13768,13801,13800,1,89,11,11,11,1524,1524,1513,1513
Del Norte,54,2022-12-26,33,33,33,0,420,421,420,1,3,0,0,0,56,56,56,56
El Dorado,54,2022-12-26,152,152,152,0,1317,1322,1321,1,7,1,1,0,241,241,240,240
Fresno,54,2022-12-26,1089,1090,1090,0,10692,10719,10718,1,186,10,10,33,2950,2950,2940,2940
Glenn,54,2022-12-26,12,12,12,0,196,197,196,1,0,0,0,0,56,56,56,56
Humboldt,54,2022-12-26,83,83,83,0,631,632,631,1,5,2,2,2,167,167,165,165
Imperial,54,2022-12-26,234,234,234,0,2165,2171,2170,1,67,2,2,0,973,973,971,971
Inyo,54,2022-12-26,13,13,13,0,158,159,158,1,1,0,0,0,62,62,62,62
Kern,54,2022-12-26,702,702,702,0,8863,8886,8885,1,51,9,9,8,2463,2463,2454,2454
Kings,54,2022-12-26,200,200,200,0,2296,2302,2301,1,5,0,0,2,477,477,477,477
Lake,54,2022-12-26,58,58,58,0,601,602,601,1,3,0,0,1,153,153,153,153
Lassen,54,2022-12-26,27,27,27,0,485,486,485,1,0,0,0,0,65,65,65,65
Los Angeles,54,2022-12-26,13506,13539,13539,0,134751,135076,135074,2,1032,169,169,164,34672,34672,34503,34503
Madera,54,2022-12-26,166,166,166,0,1565,1571,1570,1,6,0,0,1,376,376,376,376
Marin,54,2022-12-26,214,214,214,0,2555,2562,2561,1,29,0,0,2,260,260,260,260
Mariposa,54,2022-12-26,22,22,22,0,105,106,105,1,0,0,0,0,30,30,30,30
Mendocino,54,2022-12-26,75,75,75,0,646,647,646,1,10,0,0,0,139,139,139,139
Merced,54,2022-12-26,212,212,212,0,1968,1974,1973,1,17,5,5,3,895,895,890,890
Modoc,54,2022-12-26,4,4,4,0,11,12,11,1,0,0,0,0,11,11,11,11
Mono,54,2022-12-26,10,10,10,0,83,84,83,1,0,0,0,0,8,8,8,8
Monterey,54,2022-12-26,190,190,190,0,2966,2974,2973,1,21,5,5,0,788,788,783,783
Napa,54,2022-12-26,142,142,142,0,1720,1725,1724,1,12,0,0,0,162,162,162,162
Nevada,54,2022-12-26,66,66,66,0,751,752,751,1,9,0,0,1,137,137,137,137
Orange,54,2022-12-26,3286,3293,3293,0,25032,25093,25092,1,274,39,39,31,7797,7797,7758,7758
Placer,54,2022-12-26,291,291,291,0,3048,3055,3054,1,87,2,2,12,678,678,676,676
Plumas,54,2022-12-26,10,10,10,0,123,124,123,1,0,0,0,0,13,13,13,13
Riverside,54,2022-12-26,2934,2940,2940,0,18672,18718,18717,1,194,12,12,18,6754,6754,6742,6742
Sacramento,54,2022-12-26,1392,1396,1396,0,14559,14594,14593,1,179,14,14,25,3455,3455,3441,3441
San Benito,54,2022-12-26,106,106,106,0,810,812,811,1,1,0,0,1,111,111,111,111
San Bernardino,54,2022-12-26,2956,2962,2962,0,20248,20297,20296,1,210,7,7,26,8128,8128,8121,8121
San Diego,54,2022-12-26,4607,4619,4619,0,28935,29004,29003,1,395,26,26,45,5702,5702,5676,5676
San Francisco,54,2022-12-26,1030,1031,1031,0,11832,11860,11859,1,90,20,20,15,1142,1142,1122,1122
San Joaquin,54,2022-12-26,750,750,750,0,10081,10106,10105,1,60,8,8,10,2395,2395,2387,2387
San Luis Obispo,54,2022-12-26,212,212,212,0,1973,1979,1978,1,20,3,3,0,542,542,539,539
San Mateo,54,2022-12-26,844,844,844,0,8983,9006,9005,1,55,0,0,6,747,747,747,747
Santa Barbara,54,2022-12-26,485,485,485,0,4098,4109,4108,1,40,0,0,4,749,749,749,749
Santa Clara,54,2022-12-26,2339,2344,2344,0,24217,24276,24275,1,179,9,9,35,2656,2656,2647,2647
Santa Cruz,54,2022-12-26,221,221,221,0,4642,4654,4653,1,25,0,0,2,276,276,276,276
Shasta,54,2022-12-26,100,100,100,0,923,924,923,1,18,1,1,1,607,607,606,606
Siskiyou,54,2022-12-26,17,17,17,0,266,267,266,1,1,0,0,0,96,96,96,96
Solano,54,2022-12-26,648,648,648,0,5238,5252,5251,1,59,2,2,7,471,471,469,469
Sonoma,54,2022-12-26,455,455,455,0,4248,4260,4259,1,39,1,1,4,543,543,542,542
Stanislaus,54,2022-12-26,451,451,451,0,4900,4913,4912,1,96,10,10,5,1821,1821,1811,1811
Sutter,54,2022-12-26,128,128,128,0,928,930,929,1,0,0,0,0,237,237,237,237
Tehama,54,2022-12-26,47,47,47,0,607,608,607,1,2,3,3,0,225,225,222,222
Trinity,54,2022-12-26,3,3,3,0,39,40,39,1,0,0,0,0,23,23,23,23
Tulare,54,2022-12-26,443,443,443,0,3936,3945,3944,1,41,7,7,3,1565,1565,1558,1558
Tuolumne,54,2022-12-26,93,93,93,0,758,759,758,1,6,2,2,2,206,206,204,204
Ventura,54,2022-12-26,888,888,888,0,7867,7888,7887,1,71,16,16,11,1639,1639,1623,1623
Yolo,54,2022-12-26,141,141,141,0,1613,1618,1617,1,9,2,2,1,432,432,430,430
Yuba,54,2022-12-26,99,99,99,0,754,755,754,1,14,0,0,0,134,134,134,134
Alameda,55,2023-01-02,1856,1861,1861,0,20044,20095,20094,1,175,13,13,19,2083,2083,2070,2070
Amador,55,2023-01-02,34,34,34,0,677,678,677,1,3,1,1,0,97,97,96,96
Butte,55,2023-01-02,99,99,99,0,1326,1330,1329,1,35,3,3,2,482,482,479,479
Calaveras,55,2023-01-02,33,33,33,0,361,362,361,1,0,2,2,0,139,139,137,137
Colusa,55,2023-01-02,5,5,5,0,94,95,94,1,0,0,0,0,22,22,22,22
Contra Costa,55,2023-01-02,1388,1391,1391,0,14064,14099,14098,1,89,5,5,13,1529,1529,1524,1524
Del Norte,55,2023-01-02,32,32,32,0,408,409,408,1,3,0,0,2,56,56,56,56
El Dorado,55,2023-01-02,147,147,147,0,1408,1414,1413,1,7,1,1,2,242,242,241,241
Fresno,55,2023-01-02,1066,1068,1068,0,11366,11395,11394,1,195,16,16,28,2966,2966,2950,2950
Glenn,55,2023-01-02,12,12,12,0,190,191,190,1,0,0,0,0,56,56,56,56
Humboldt,55,2023-01-02,50,50,50,0,618,619,618,1,2,0,0,2,167,167,167,167
Imperial,55,2023-01-02,205,205,205,0,2031,2036,2035,1,11,0,0,1,973,973,973,973
Inyo,55,2023-01-02,16,16,16,0,226,227,226,1,1,0,0,0,62,62,62,62
Kern,55,2023-01-02,892,892,892,0,9786,9811,9810,1,66,3,3,8,2466,2466,2463,2463
Kings,55,2023-01-02,187,187,187,0,2165,2171,2170,1,4,2,2,1,479,479,477,477
Lake,55,2023-01-02,47,47,47,0,604,605,604,1,3,1,1,0,154,154,153,153
Lassen,55,2023-01-02,13,13,13,0,490,491,490,1,0,0,0,0,65,65,65,65
Los Angeles,55,2023-01-02,13400,13434,13434,0,138308,138658,138656,2,1091,145,145,154,34817,34817,34672,34672
Madera,55,2023-01-02,153,153,153,0,1654,1659,1658,1,7,0,0,0,376,376,376,376
Marin,55,2023-01-02,225,225,225,0,2407,2414,2413,1,24,0,0,2,260,260,260,260
Mariposa,55,2023-01-02,15,15,15,0,94,95,94,1,0,0,0,0,30,30,30,30
Mendocino,55,2023-01-02,59,59,59,0,687,688,687,1,6,1,1,3,140,140,139,139
Merced,55,2023-01-02,193,193,193,0,2014,2020,2019,1,8,2,2,4,897,897,895,895
Modoc,55,2023-01-02,9,9,9,0,14,15,14,1,0,0,0,0,11,11,11,11
Mono,55,2023-01-02,10,10,10,0,66,67,66,1,0,0,0,0,8,8,8,8
Monterey,55,2023-01-02,216,216,216,0,3046,3055,3054,1,27,0,0,0,788,788,788,788
Napa,55,2023-01-02,124,124,124,0,1677,1682,1681,1,8,1,1,1,163,163,162,162
Nevada,55,2023-01-02,54,54,54,0,722,723,722,1,8,0,0,2,137,137,137,137
Orange,55,2023-01-02,3294,3303,3303,0,25269,25333,25332,1,312,38,38,28,7835,7835,7797,7797
Placer,55,2023-01-02,304,304,304,0,3244,3254,3253,1,108,1,1,8,679,679,678,678
Plumas,55,2023-01-02,12,12,12,0,145,146,145,1,1,1,1,0,14,14,13,13
Riverside,55,2023-01-02,3121,3128,3128,0,20089,20139,20138,1,223,9,9,31,6763,6763,6754,6754
Sacramento,55,2023-01-02,1519,1523,1523,0,15309,15349,15348,1,201,19,19,26,3474,3474,3455,3455
San Benito,55,2023-01-02,58,58,58,0,793,796,795,1,1,0,0,1,111,111,111,111
San Bernardino,55,2023-01-02,2872,2879,2879,0,20968,21020,21019,1,183,3,3,31,8131,8131,8128,8128
San Diego,55,2023-01-02,4633,4644,4644,0,29622,29698,29697,1,401,25,25,43,5727,5727,5702,5702
San Francisco,55,2023-01-02,885,886,886,0,10187,10214,10213,1,77,11,11,15,1153,1153,1142,1142
San Joaquin,55,2023-01-02,754,754,754,0,10420,10448,10447,1,62,6,6,12,2401,2401,2395,2395
San Luis Obispo,55,2023-01-02,210,210,210,0,1995,2001,2000,1,17,6,6,0,548,548,542,542
San Mateo,55,2023-01-02,743,743,743,0,8038,8060,8059,1,50,0,0,9,747,747,747,747
Santa Barbara,55,2023-01-02,433,433,433,0,4044,4056,4055,1,47,1,1,5,750,750,749,749
Santa Clara,55,2023-01-02,2447,2452,2452,0,23436,23496,23495,1,200,17,17,32,2673,2673,2656,2656
Santa Cruz,55,2023-01-02,171,171,171,0,3009,3017,3016,1,27,0,0,0,276,276,276,276
Shasta,55,2023-01-02,100,100,100,0,947,949,948,1,20,1,1,1,608,608,607,607
Siskiyou,55,2023-01-02,15,15,15,0,268,269,268,1,1,0,0,0,96,96,96,96
Solano,55,2023-01-02,639,639,639,0,5301,5315,5314,1,60,3,3,11,474,474,471,471
Sonoma,55,2023-01-02,427,427,427,0,4259,4272,4271,1,56,0,0,2,543,543,543,543
Stanislaus,55,2023-01-02,475,475,475,0,5023,5036,5035,1,88,6,6,8,1827,1827,1821,1821
Sutter,55,2023-01-02,97,97,97,0,889,891,890,1,0,0,0,0,237,237,237,237
Tehama,55,2023-01-02,54,54,54,0,621,622,621,1,2,5,5,0,230,230,225,225
Trinity,55,2023-01-02,4,4,4,0,41,42,41,1,0,0,0,0,23,23,23,23
Tulare,55,2023-01-02,477,477,477,0,4719,4732,4731,1,52,3,3,6,1568,1568,1565,1565
Tuolumne,55,2023-01-02,66,66,66,0,662,663,662,1,5,1,1,0,207,207,206,206
Ventura,55,2023-01-02,902,903,903,0,7466,7486,7485,1,87,10,10,13,1649,1649,1639,1639
Yolo,55,2023-01-02,134,134,134,0,1525,1531,1530,1,4,3,3,1,435,435,432,432
Yuba,55,2023-01-02,80,80,80,0,730,731,730,1,19,0,0,1,134,134,134,134
Alameda,56,2023-01-09,1495,1500,1500,0,23524,23588,23587,1,149,11,11,11,2094,2094,2083,2083
Amador,56,2023-01-09,28,28,28,0,706,707,706,1,2,0,0,0,97,97,97,97
Butte,56,2023-01-09,88,88,88,0,1206,1209,1208,1,39,3,3,3,485,485,482,482
Calaveras,56,2023-01-09,19,19,19,0,342,343,342,1,0,0,0,1,139,139,139,139
Colusa,56,2023-01-09,8,8,8,0,92,93,92,1,0,0,0,0,22,22,22,22
Contra Costa,56,2023-01-09,1055,1056,1056,0,15390,15432,15431,1,85,6,6,11,1535,1535,1529,1529
Del Norte,56,2023-01-09,17,17,17,0,367,368,367,1,5,0,0,2,56,56,56,56
El Dorado,56,2023-01-09,87,87,87,0,1453,1458,1457,1,4,0,0,0,242,242,242,242
Fresno,56,2023-01-09,806,806,806,0,11482,11513,11512,1,171,7,7,23,2973,2973,2966,2966
Glenn,56,2023-01-09,8,8,8,0,185,186,185,1,0,0,0,0,56,56,56,56
Humboldt,56,2023-01-09,60,60,60,0,709,710,709,1,7,0,0,4,167,167,167,167
Imperial,56,2023-01-09,161,161,161,0,2439,2445,2444,1,12,2,2,2,975,975,973,973
Inyo,56,2023-01-09,10,10,10,0,205,206,205,1,0,0,0,0,62,62,62,62
Kern,56,2023-01-09,620,620,620,0,10590,10620,10619,1,73,4,4,8,2470,2470,2466,2466
Kings,56,2023-01-09,183,183,183,0,2315,2322,2321,1,9,0,0,0,479,479,479,479
Lake,56,2023-01-09,44,44,44,0,622,623,622,1,3,1,1,0,155,155,154,154
Lassen,56,2023-01-09,19,19,19,0,506,507,506,1,2,0,0,0,65,65,65,65
Los Angeles,56,2023-01-09,10175,10203,10203,0,190004,190519,190517,2,965,140,140,136,34957,34957,34817,34817
Madera,56,2023-01-09,100,100,100,0,1645,1651,1650,1,8,0,0,1,376,376,376,376
Marin,56,2023-01-09,145,145,145,0,2560,2567,2566,1,18,0,0,3,260,260,260,260
Mariposa,56,2023-01-09,9,9,9,0,106,107,106,1,0,1,1,0,31,31,30,30
Mendocino,56,2023-01-09,40,40,40,0,645,646,645,1,10,2,2,3,142,142,140,140
Merced,56,2023-01-09,185,185,185,0,2157,2163,2162,1,11,1,1,1,898,898,897,897
Modoc,56,2023-01-09,8,8,8,0,14,15,14,1,0,0,0,0,11,11,11,11
Mono,56,2023-01-09,12,12,12,0,78,79,78,1,0,0,0,0,8,8,8,8
Monterey,56,2023-01-09,170,170,170,0,3129,3138,3137,1,20,4,4,3,792,792,788,788
Napa,56,2023-01-09,132,132,132,0,1879,1885,1884,1,9,0,0,3,163,163,163,163
Nevada,56,2023-01-09,42,42,42,0,760,761,760,1,6,0,0,0,137,137,137,137
Orange,56,2023-01-09,2472,2479,2479,0,28030,28107,28106,1,267,39,39,34,7874,7874,7835,7835
Placer,56,2023-01-09,260,260,260,0,3405,3415,3414,1,89,0,0,6,679,679,679,679
Plumas,56,2023-01-09,5,5,5,0,89,90,89,1,1,0,0,0,14,14,14,14
Riverside,56,2023-01-09,2002,2008,2008,0,21237,21294,21293,1,186,18,18,26,6781,6781,6763,6763
Sacramento,56,2023-01-09,1023,1025,1025,0,15636,15679,15678,1,178,16,16,28,3490,3490,3474,3474
San Benito,56,2023-01-09,51,51,51,0,817,819,818,1,1,0,0,2,111,111,111,111
San Bernardino,56,2023-01-09,1758,1763,1763,0,20710,20768,20767,1,179,6,6,36,8137,8137,8131,8131
San Diego,56,2023-01-09,3594,3605,3605,0,35162,35258,35257,1,397,27,27,40,5754,5754,5727,5727
San Francisco,56,2023-01-09,790,790,790,0,12778,12812,12811,1,75,7,7,17,1160,1160,1153,1153
San Joaquin,56,2023-01-09,590,590,590,0,10966,10996,10995,1,51,10,10,12,2411,2411,2401,2401
San Luis Obispo,56,2023-01-09,186,186,186,0,2148,2154,2153,1,12,3,3,0,551,551,548,548
San Mateo,56,2023-01-09,614,614,614,0,9706,9732,9731,1,47,0,0,5,747,747,747,747
Santa Barbara,56,2023-01-09,367,367,367,0,4500,4513,4512,1,39,3,3,1,753,753,750,750
Santa Clara,56,2023-01-09,1977,1982,1982,0,28631,28710,28709,1,182,13,13,28,2686,2686,2673,2673
Santa Cruz,56,2023-01-09,152,152,152,0,4069,4081,4080,1,27,0,0,1,276,276,276,276
Shasta,56,2023-01-09,60,60,60,0,890,892,891,1,17,0,0,2,608,608,608,608
Siskiyou,56,2023-01-09,20,20,20,0,233,234,233,1,0,0,0,0,96,96,96,96
Solano,56,2023-01-09,402,402,402,0,5191,5206,5205,1,54,1,1,6,475,475,474,474
Sonoma,56,2023-01-09,283,283,283,0,4755,4769,4768,1,31,3,3,4,546,546,543,543
Stanislaus,56,2023-01-09,303,303,303,0,5231,5246,5245,1,87,6,6,8,1833,1833,1827,1827
Sutter,56,2023-01-09,62,62,62,0,872,874,873,1,0,0,0,0,237,237,237,237
Tehama,56,2023-01-09,28,28,28,0,492,493,492,1,1,2,2,0,232,232,230,230
Trinity,56,2023-01-09,3,3,3,0,30,31,30,1,0,0,0,0,23,23,23,23
Tulare,56,2023-01-09,334,334,334,0,5104,5120,5119,1,53,5,5,2,1573,1573,1568,1568
Tuolumne,56,2023-01-09,74,74,74,0,655,656,655,1,2,1,1,0,208,208,207,207
Ventura,56,2023-01-09,662,662,662,0,9382,9408,9407,1,65,5,5,12,1654,1654,1649,1649
Yolo,56,2023-01-09,108,108,108,0,1666,1672,1671,1,2,2,2,1,437,437,435,435
Yuba,56,2023-01-09,48,48,48,0,735,736,735,1,21,0,0,1,134,134,134,134
Alameda,57,2023-01-16,868,868,868,0,19185,19241,19240,1,105,4,4,11,2098,2098,2094,2094
Amador,57,2023-01-16,20,20,20,0,585,587,586,1,4,0,0,0,97,97,97,97
Butte,57,2023-01-16,59,59,59,0,1163,1168,1167,1,21,1,1,0,486,486,485,485
Calaveras,57,2023-01-16,10,10,10,0,311,312,311,1,2,0,0,1,139,139,139,139
Colusa,57,2023-01-16,7,7,7,0,86,87,86,1,1,0,0,0,22,22,22,22
Contra Costa,57,2023-01-16,614,614,614,0,12114,12149,12148,1,61,5,5,11,1540,1540,1535,1535
Del Norte,57,2023-01-16,10,10,10,0,303,304,303,1,3,2,2,1,58,58,56,56
El Dorado,57,2023-01-16,61,61,61,0,978,982,981,1,2,1,1,1,243,243,242,242
Fresno,57,2023-01-16,463,463,463,0,9744,9773,9772,1,162,7,7,13,2980,2980,2973,2973
Glenn,57,2023-01-16,3,3,3,0,163,164,163,1,0,0,0,0,56,56,56,56
Humboldt,57,2023-01-16,38,38,38,0,500,501,500,1,9,1,1,2,168,168,167,167
Imperial,57,2023-01-16,127,127,127,0,2067,2074,2073,1,10,2,2,2,977,977,975,975
Inyo,57,2023-01-16,11,11,11,0,199,200,199,1,0,0,0,0,62,62,62,62
Kern,57,2023-01-16,386,386,386,0,8285,8309,8308,1,55,4,4,13,2474,2474,2470,2470
Kings,57,2023-01-16,126,126,126,0,1982,1990,1989,1,5,2,2,0,481,481,479,479
Lake,57,2023-01-16,23,23,23,0,576,577,576,1,2,1,1,1,156,156,155,155
Lassen,57,2023-01-16,6,6,6,0,441,442,441,1,0,0,0,0,65,65,65,65
Los Angeles,57,2023-01-16,6126,6144,6144,0,148585,149018,149016,2,855,145,145,113,35102,35102,34957,34957
Madera,57,2023-01-16,67,67,67,0,1350,1357,1356,1,4,0,0,2,376,376,376,376
Marin,57,2023-01-16,125,125,125,0,2138,2145,2144,1,20,0,0,1,260,260,260,260
Mariposa,57,2023-01-16,11,11,11,0,97,98,97,1,0,0,0,0,31,31,31,31
Mendocino,57,2023-01-16,25,25,25,0,499,500,499,1,6,0,0,0,142,142,142,142
Merced,57,2023-01-16,120,120,120,0,1691,1697,1696,1,12,3,3,5,901,901,898,898
Modoc,57,2023-01-16,2,2,2,0,9,10,9,1,0,0,0,0,11,11,11,11
Mono,57,2023-01-16,6,6,6,0,68,69,68,1,0,0,0,0,8,8,8,8
Monterey,57,2023-01-16,112,112,112,0,2603,2612,2611,1,20,3,3,2,795,795,792,792
Napa,57,2023-01-16,63,63,63,0,1512,1518,1517,1,5,0,0,0,163,163,163,163
Nevada,57,2023-01-16,25,25,25,0,565,566,565,1,4,0,0,0,137,137,137,137
Orange,57,2023-01-16,1476,1481,1481,0,24166,24236,24235,1,245,39,39,32,7913,7913,7874,7874
Placer,57,2023-01-16,163,163,163,0,2641,2649,2648,1,68,0,0,6,679,679,679,679
Plumas,57,2023-01-16,2,2,2,0,74,75,74,1,1,0,0,0,14,14,14,14
Riverside,57,2023-01-16,1217,1222,1222,0,17174,17224,17223,1,169,14,14,36,6795,6795,6781,6781
Sacramento,57,2023-01-16,573,573,573,0,12429,12467,12466,1,149,19,19,23,3509,3509,3490,3490
San Benito,57,2023-01-16,28,28,28,0,468,469,468,1,0,1,1,0,112,112,111,111
San Bernardino,57,2023-01-16,993,995,995,0,16760,16809,16808,1,148,2,2,35,8139,8139,8137,8137
San Diego,57,2023-01-16,2065,2072,2072,0,28671,28756,28755,1,327,15,15,39,5769,5769,5754,5754
San Francisco,57,2023-01-16,439,439,439,0,10155,10185,10184,1,75,2,2,12,1162,1162,1160,1160
San Joaquin,57,2023-01-16,356,356,356,0,8794,8821,8820,1,42,8,8,11,2419,2419,2411,2411
San Luis Obispo,57,2023-01-16,108,108,108,0,1777,1783,1782,1,12,2,2,3,553,553,551,551
San Mateo,57,2023-01-16,401,401,401,0,7746,7770,7769,1,37,0,0,3,747,747,747,747
Santa Barbara,57,2023-01-16,242,242,242,0,3919,3933,3932,1,34,2,2,0,755,755,753,753
Santa Clara,57,2023-01-16,1102,1105,1105,0,24094,24166,24165,1,106,17,17,16,2703,2703,2686,2686
Santa Cruz,57,2023-01-16,171,171,171,0,6498,6518,6517,1,23,0,0,1,276,276,276,276
Shasta,57,2023-01-16,41,41,41,0,691,692,691,1,13,3,3,2,611,611,608,608
Siskiyou,57,2023-01-16,6,6,6,0,208,209,208,1,0,0,0,0,96,96,96,96
Solano,57,2023-01-16,222,222,222,0,3711,3723,3722,1,49,0,0,6,475,475,475,475
Sonoma,57,2023-01-16,189,189,189,0,3774,3787,3786,1,26,5,5,2,551,551,546,546
Stanislaus,57,2023-01-16,206,206,206,0,4384,4397,4396,1,72,3,3,3,1836,1836,1833,1833
Sutter,57,2023-01-16,47,47,47,0,717,719,718,1,0,0,0,0,237,237,237,237
Tehama,57,2023-01-16,16,16,16,0,370,371,370,1,1,0,0,0,232,232,232,232
Trinity,57,2023-01-16,3,3,3,0,23,24,23,1,0,0,0,0,23,23,23,23
Tulare,57,2023-01-16,264,264,264,0,4115,4129,4128,1,45,4,4,2,1577,1577,1573,1573
Tuolumne,57,2023-01-16,44,44,44,0,548,549,548,1,1,2,2,0,210,210,208,208
Ventura,57,2023-01-16,413,413,413,0,7844,7868,7867,1,53,4,4,12,1658,1658,1654,1654
Yolo,57,2023-01-16,74,74,74,0,1251,1255,1254,1,2,2,2,0,439,439,437,437
Yuba,57,2023-01-16,38,38,38,0,595,596,595,1,9,0,0,2,134,134,134,134
Alameda,58,2023-01-23,743,743,743,0,21295,21361,21360,1,100,10,10,9,2108,2108,2098,2098
Amador,58,2023-01-23,34,34,34,0,590,591,590,1,1,1,1,0,98,98,97,97
Butte,58,2023-01-23,44,44,44,0,1085,1089,1088,1,13,1,1,0,487,487,486,486
Calaveras,58,2023-01-23,15,15,15,0,280,281,280,1,0,0,0,0,139,139,139,139
Colusa,58,2023-01-23,10,10,10,0,142,143,142,1,0,0,0,0,22,22,22,22
Contra Costa,58,2023-01-23,516,516,516,0,13315,13356,13355,1,61,7,7,6,1547,1547,1540,1540
Del Norte,58,2023-01-23,22,22,22,0,359,360,359,1,1,0,0,0,58,58,58,58
El Dorado,58,2023-01-23,40,40,40,0,1082,1086,1085,1,2,0,0,0,243,243,243,243
Fresno,58,2023-01-23,449,449,449,0,10114,10148,10147,1,117,5,5,19,2985,2985,2980,2980
Glenn,58,2023-01-23,4,4,4,0,154,155,154,1,0,0,0,0,56,56,56,56
Humboldt,58,2023-01-23,35,35,35,0,556,557,556,1,9,1,1,4,169,169,168,168
Imperial,58,2023-01-23,85,85,85,0,2255,2261,2260,1,10,0,0,1,977,977,977,977
Inyo,58,2023-01-23,6,6,6,0,165,166,165,1,0,1,1,0,63,63,62,62
Kern,58,2023-01-23,313,313,313,0,9390,9421,9420,1,34,5,5,8,2479,2479,2474,2474
Kings,58,2023-01-23,107,107,107,0,1985,1991,1990,1,6,0,0,0,481,481,481,481
Lake,58,2023-01-23,29,29,29,0,581,582,581,1,2,3,3,2,159,159,156,156
Lassen,58,2023-01-23,5,5,5,0,465,466,465,1,0,0,0,0,65,65,65,65
Los Angeles,58,2023-01-23,5608,5626,5626,0,169946,170479,170477,2,665,110,110,96,35212,35212,35102,35102
Madera,58,2023-01-23,51,51,51,0,1433,1440,1439,1,6,0,0,2,376,376,376,376
Marin,58,2023-01-23,108,108,108,0,2351,2358,2357,1,18,0,0,3,260,260,260,260
Mariposa,58,2023-01-23,7,7,7,0,105,106,105,1,0,0,0,0,31,31,31,31
Mendocino,58,2023-01-23,21,21,21,0,546,547,546,1,4,0,0,0,142,142,142,142
Merced,58,2023-01-23,126,126,126,0,1925,1931,1930,1,9,2,2,3,903,903,901,901
Modoc,58,2023-01-23,1,1,1,0,11,12,11,1,1,0,0,0,11,11,11,11
Mono,58,2023-01-23,5,5,5,0,73,74,73,1,0,0,0,0,8,8,8,8
Monterey,58,2023-01-23,107,107,107,0,2756,2767,2766,1,15,1,1,2,796,796,795,795
Napa,58,2023-01-23,77,77,77,0,1505,1511,1510,1,4,0,0,1,163,163,163,163
Nevada,58,2023-01-23,20,20,20,0,600,601,600,1,3,0,0,2,137,137,137,137
Orange,58,2023-01-23,1176,1181,1181,0,24114,24189,24188,1,177,27,27,27,7940,7940,7913,7913
Placer,58,2023-01-23,139,139,139,0,2732,2741,2740,1,42,1,1,7,680,680,679,679
Plumas,58,2023-01-23,5,5,5,0,91,92,91,1,1,0,0,0,14,14,14,14
Riverside,58,2023-01-23,1013,1016,1016,0,16233,16284,16283,1,111,15,15,22,6810,6810,6795,6795
Sacramento,58,2023-01-23,598,598,598,0,13723,13767,13766,1,134,9,9,21,3518,3518,3509,3509
San Benito,58,2023-01-23,27,27,27,0,564,565,564,1,0,0,0,0,112,112,112,112
San Bernardino,58,2023-01-23,1030,1033,1033,0,19085,19145,19144,1,127,1,1,33,8140,8140,8139,8139
San Diego,58,2023-01-23,2031,2038,2038,0,33285,33390,33389,1,236,11,11,37,5780,5780,5769,5769
San Francisco,58,2023-01-23,449,449,449,0,11286,11323,11322,1,58,6,6,5,1168,1168,1162,1162
San Joaquin,58,2023-01-23,243,243,243,0,8416,8443,8442,1,29,4,4,8,2423,2423,2419,2419
San Luis Obispo,58,2023-01-23,110,110,110,0,1951,1957,1956,1,8,3,3,2,556,556,553,553
San Mateo,58,2023-01-23,352,352,352,0,8734,8763,8762,1,21,0,0,0,747,747,747,747
Santa Barbara,58,2023-01-23,209,209,209,0,4241,4254,4253,1,28,2,2,4,757,757,755,755
Santa Clara,58,2023-01-23,1019,1020,1020,0,24696,24775,24774,1,119,5,5,23,2708,2708,2703,2703
Santa Cruz,58,2023-01-23,122,122,122,0,9483,9514,9513,1,16,0,0,0,276,276,276,276
Shasta,58,2023-01-23,22,22,22,0,755,757,756,1,6,1,1,1,612,612,611,611
Siskiyou,58,2023-01-23,6,6,6,0,178,179,178,1,0,0,0,0,96,96,96,96
Solano,58,2023-01-23,228,228,228,0,4219,4233,4232,1,33,0,0,2,475,475,475,475
Sonoma,58,2023-01-23,199,199,199,0,4276,4290,4289,1,26,0,0,4,551,551,551,551
Stanislaus,58,2023-01-23,181,181,181,0,4333,4347,4346,1,57,2,2,6,1838,1838,1836,1836
Sutter,58,2023-01-23,41,41,41,0,780,782,781,1,0,1,1,0,238,238,237,237
Tehama,58,2023-01-23,15,15,15,0,341,342,341,1,1,0,0,0,232,232,232,232
Trinity,58,2023-01-23,4,4,4,0,31,32,31,1,0,1,1,0,24,24,23,23
Tulare,58,2023-01-23,221,221,221,0,4167,4181,4180,1,27,3,3,5,1580,1580,1577,1577
Tuolumne,58,2023-01-23,36,36,36,0,484,485,484,1,0,1,1,1,211,211,210,210
Ventura,58,2023-01-23,368,368,368,0,8587,8615,8614,1,57,5,5,3,1663,1663,1658,1658
Yolo,58,2023-01-23,85,85,85,0,1371,1377,1376,1,2,3,3,0,442,442,439,439
Yuba,58,2023-01-23,30,30,30,0,725,726,725,1,3,0,0,0,134,134,134,134
Alameda,59,2023-01-30,848,850,850,0,18460,18525,18524,1,85,3,3,4,2111,2111,2108,2108
Amador,59,2023-01-30,24,24,24,0,620,622,621,1,3,0,0,0,98,98,98,98
Butte,59,2023-01-30,57,57,57,0,1128,1134,1133,1,13,2,2,2,489,489,487,487
Calaveras,59,2023-01-30,16,16,16,0,318,319,318,1,0,1,1,0,140,140,139,139
Colusa,59,2023-01-30,7,7,7,0,169,170,169,1,0,0,0,0,22,22,22,22
Contra Costa,59,2023-01-30,664,664,664,0,12412,12454,12453,1,38,9,9,6,1556,1556,1547,1547
Del Norte,59,2023-01-30,31,31,31,0,382,383,382,1,1,1,1,0,59,59,58,58
El Dorado,59,2023-01-30,61,61,61,0,1190,1195,1194,1,4,2,2,0,245,245,243,243
Fresno,59,2023-01-30,448,448,448,0,9879,9916,9915,1,117,8,8,10,2993,2993,2985,2985
Glenn,59,2023-01-30,2,2,2,0,156,157,156,1,0,0,0,0,56,56,56,56
Humboldt,59,2023-01-30,29,29,29,0,565,566,565,1,6,0,0,1,169,169,169,169
Imperial,59,2023-01-30,104,104,104,0,2068,2077,2076,1,7,1,1,0,978,978,977,977
Inyo,59,2023-01-30,10,10,10,0,202,203,202,1,1,0,0,0,63,63,63,63
Kern,59,2023-01-30,294,294,294,0,8979,9011,9010,1,36,1,1,8,2480,2480,2479,2479
Kings,59,2023-01-30,136,136,136,0,2211,2220,2219,1,7,1,1,1,482,482,481,481
Lake,59,2023-01-30,26,26,26,0,555,556,555,1,5,2,2,1,161,161,159,159
Lassen,59,2023-01-30,4,4,4,0,490,491,490,1,0,0,0,0,65,65,65,65
Los Angeles,59,2023-01-30,5795,5815,5815,0,152335,152865,152863,2,633,109,109,72,35321,35321,35212,35212
Madera,59,2023-01-30,48,48,48,0,1479,1486,1485,1,7,0,0,0,376,376,376,376
Marin,59,2023-01-30,102,102,102,0,2159,2166,2165,1,19,0,0,1,260,260,260,260
Mariposa,59,2023-01-30,5,5,5,0,106,107,106,1,0,0,0,0,31,31,31,31
Mendocino,59,2023-01-30,24,24,24,0,518,519,518,1,2,0,0,1,142,142,142,142
Merced,59,2023-01-30,137,137,137,0,1801,1808,1807,1,11,0,0,3,903,903,903,903
Modoc,59,2023-01-30,0,0,0,0,8,9,8,1,1,0,0,0,11,11,11,11
Mono,59,2023-01-30,2,2,2,0,68,69,68,1,0,0,0,0,8,8,8,8
Monterey,59,2023-01-30,155,155,155,0,2846,2857,2856,1,8,1,1,1,797,797,796,796
Napa,59,2023-01-30,72,72,72,0,1370,1376,1375,1,4,0,0,0,163,163,163,163
Nevada,59,2023-01-30,29,29,29,0,591,592,591,1,2,0,0,1,137,137,137,137
Orange,59,2023-01-30,1204,1209,1209,0,22809,22888,22887,1,136,15,15,25,7955,7955,7940,7940
Placer,59,2023-01-30,170,170,170,0,2707,2717,2716,1,49,2,2,3,682,682,680,680
Plumas,59,2023-01-30,3,3,3,0,75,76,75,1,0,0,0,0,14,14,14,14
Riverside,59,2023-01-30,1071,1075,1075,0,16022,16077,16076,1,84,6,6,17,6816,6816,6810,6810
Sacramento,59,2023-01-30,667,667,667,0,13388,13436,13435,1,117,8,8,13,3526,3526,3518,3518
San Benito,59,2023-01-30,30,30,30,0,563,564,563,1,0,0,0,0,112,112,112,112
San Bernardino,59,2023-01-30,931,934,934,0,17220,17281,17280,1,140,0,0,19,8140,8140,8140,8140
San Diego,59,2023-01-30,1860,1866,1866,0,30199,30304,30303,1,202,12,12,32,5792,5792,5780,5780
San Francisco,59,2023-01-30,473,473,473,0,10902,10941,10940,1,51,2,2,4,1170,1170,1168,1168
San Joaquin,59,2023-01-30,305,305,305,0,7667,7694,7693,1,22,4,4,5,2427,2427,2423,2423
San Luis Obispo,59,2023-01-30,140,140,140,0,1912,1920,1919,1,13,5,5,0,561,561,556,556
San Mateo,59,2023-01-30,432,432,432,0,8646,8678,8677,1,25,0,0,3,747,747,747,747
Santa Barbara,59,2023-01-30,227,227,227,0,4267,4282,4281,1,25,1,1,2,758,758,757,757
Santa Clara,59,2023-01-30,1178,1183,1183,0,23647,23729,23728,1,132,6,6,14,2714,2714,2708,2708
Santa Cruz,59,2023-01-30,133,133,133,0,9330,9364,9363,1,12,0,0,0,276,276,276,276
Shasta,59,2023-01-30,18,18,18,0,665,667,666,1,7,0,0,0,612,612,612,612
Siskiyou,59,2023-01-30,6,6,6,0,195,196,195,1,0,0,0,0,96,96,96,96
Solano,59,2023-01-30,236,236,236,0,4173,4188,4187,1,40,0,0,1,475,475,475,475
Sonoma,59,2023-01-30,159,159,159,0,3597,3610,3609,1,23,1,1,1,552,552,551,551
Stanislaus,59,2023-01-30,230,230,230,0,4130,4144,4143,1,43,2,2,3,1840,1840,1838,1838
Sutter,59,2023-01-30,36,36,36,0,611,613,612,1,0,1,1,0,239,239,238,238
Tehama,59,2023-01-30,8,8,8,0,317,318,317,1,1,1,1,0,233,233,232,232
Trinity,59,2023-01-30,7,7,7,0,26,27,26,1,0,0,0,0,24,24,24,24
Tulare,59,2023-01-30,260,260,260,0,4019,4035,4034,1,28,3,3,3,1583,1583,1580,1580
Tuolumne,59,2023-01-30,45,45,45,0,600,602,601,1,3,0,0,0,211,211,211,211
Ventura,59,2023-01-30,363,363,363,0,8131,8161,8160,1,46,7,7,8,1670,1670,1663,1663
Yolo,59,2023-01-30,87,87,87,0,1298,1305,1304,1,2,1,1,0,443,443,442,442
Yuba,59,2023-01-30,32,32,32,0,656,657,656,1,3,0,0,1,134,134,134,134
Alameda,60,2023-02-06,1108,1113,1113,0,18266,18338,18337,1,86,4,4,9,2115,2115,2111,2111
Amador,60,2023-02-06,29,29,29,0,637,639,638,1,1,0,0,0,98,98,98,98
Butte,60,2023-02-06,84,84,84,0,1209,1216,1215,1,20,0,0,1,489,489,489,489
Calaveras,60,2023-02-06,14,14,14,0,323,324,323,1,0,0,0,0,140,140,140,140
Colusa,60,2023-02-06,6,6,6,0,184,185,184,1,0,0,0,0,22,22,22,22
Contra Costa,60,2023-02-06,715,717,717,0,11857,11903,11902,1,50,2,2,9,1558,1558,1556,1556
Del Norte,60,2023-02-06,58,58,58,0,394,395,394,1,0,0,0,0,59,59,59,59
El Dorado,60,2023-02-06,59,59,59,0,1133,1138,1137,1,3,0,0,0,245,245,245,245
Fresno,60,2023-02-06,514,514,514,0,9046,9083,9082,1,89,4,4,15,2997,2997,2993,2993
Glenn,60,2023-02-06,10,10,10,0,170,171,170,1,0,0,0,0,56,56,56,56
Humboldt,60,2023-02-06,56,56,56,0,566,567,566,1,6,1,1,0,170,170,169,169
Imperial,60,2023-02-06,124,124,124,0,2097,2106,2105,1,7,1,1,0,979,979,978,978
Inyo,60,2023-02-06,9,9,9,0,210,211,210,1,0,0,0,0,63,63,63,63
Kern,60,2023-02-06,325,325,325,0,8604,8639,8638,1,34,2,2,4,2482,2482,2480,2480
Kings,60,2023-02-06,127,127,127,0,2056,2066,2065,1,3,0,0,1,482,482,482,482
Lake,60,2023-02-06,25,25,25,0,561,562,561,1,5,1,1,0,162,162,161,161
Lassen,60,2023-02-06,6,6,6,0,445,447,446,1,0,0,0,0,65,65,65,65
Los Angeles,60,2023-02-06,5907,5930,5930,0,142522,143085,143083,2,609,89,89,83,35410,35410,35321,35321
Madera,60,2023-02-06,55,55,55,0,1308,1315,1314,1,4,1,1,0,377,377,376,376
Marin,60,2023-02-06,144,144,144,0,2133,2142,2141,1,13,0,0,3,260,260,260,260
Mariposa,60,2023-02-06,2,2,2,0,105,106,105,1,0,0,0,0,31,31,31,31
Mendocino,60,2023-02-06,31,31,31,0,513,515,514,1,4,0,0,2,142,142,142,142
Merced,60,2023-02-06,166,166,166,0,1890,1899,1898,1,12,0,0,0,903,903,903,903
Modoc,60,2023-02-06,2,2,2,0,6,7,6,1,0,0,0,0,11,11,11,11
Mono,60,2023-02-06,4,4,4,0,93,94,93,1,0,0,0,0,8,8,8,8
Monterey,60,2023-02-06,227,227,227,0,2941,2955,2954,1,22,3,3,1,800,800,797,797
Napa,60,2023-02-06,110,110,110,0,1404,1411,1410,1,4,0,0,3,163,163,163,163
Nevada,60,2023-02-06,32,32,32,0,572,574,573,1,4,0,0,0,137,137,137,137
Orange,60,2023-02-06,1315,1321,1321,0,22395,22483,22482,1,154,24,24,20,7979,7979,7955,7955
Placer,60,2023-02-06,164,164,164,0,2656,2668,2667,1,41,0,0,4,682,682,682,682
Plumas,60,2023-02-06,2,2,2,0,72,73,72,1,0,1,1,0,15,15,14,14
Riverside,60,2023-02-06,1128,1133,1133,0,15536,15598,15597,1,89,5,5,14,6821,6821,6816,6816
Sacramento,60,2023-02-06,732,733,733,0,13190,13242,13241,1,96,5,5,19,3531,3531,3526,3526
San Benito,60,2023-02-06,50,50,50,0,538,539,538,1,1,0,0,0,112,112,112,112
San Bernardino,60,2023-02-06,1081,1087,1087,0,17441,17510,17509,1,152,0,0,17,8140,8140,8140,8140
San Diego,60,2023-02-06,1873,1881,1881,0,30143,30263,30262,1,230,11,11,23,5803,5803,5792,5792
San Francisco,60,2023-02-06,573,573,573,0,10544,10585,10584,1,58,3,3,2,1173,1173,1170,1170
San Joaquin,60,2023-02-06,435,435,435,0,6939,6966,6965,1,32,1,1,3,2428,2428,2427,2427
San Luis Obispo,60,2023-02-06,150,150,150,0,1906,1913,1912,1,7,1,1,0,562,562,561,561
San Mateo,60,2023-02-06,530,530,530,0,8197,8232,8231,1,42,0,0,1,747,747,747,747
Santa Barbara,60,2023-02-06,239,239,239,0,4366,4385,4384,1,21,1,1,0,759,759,758,758
Santa Clara,60,2023-02-06,1303,1309,1309,0,23495,23588,23587,1,123,11,11,23,2725,2725,2714,2714
Santa Cruz,60,2023-02-06,232,232,232,0,10398,10442,10441,1,11,0,0,0,276,276,276,276
Shasta,60,2023-02-06,24,24,24,0,660,663,662,1,9,0,0,0,612,612,612,612
Siskiyou,60,2023-02-06,11,11,11,0,221,222,221,1,0,0,0,0,96,96,96,96
Solano,60,2023-02-06,288,288,288,0,3852,3868,3867,1,41,0,0,5,475,475,475,475
Sonoma,60,2023-02-06,268,268,268,0,3566,3582,3581,1,17,3,3,1,555,555,552,552
Stanislaus,60,2023-02-06,277,277,277,0,3928,3944,3943,1,54,1,1,6,1841,1841,1840,1840
Sutter,60,2023-02-06,50,50,50,0,706,708,707,1,0,0,0,0,239,239,239,239
Tehama,60,2023-02-06,17,17,17,0,344,345,344,1,2,0,0,0,233,233,233,233
Trinity,60,2023-02-06,1,1,1,0,19,20,19,1,0,0,0,0,24,24,24,24
Tulare,60,2023-02-06,271,271,271,0,4386,4404,4403,1,28,2,2,3,1585,1585,1583,1583
Tuolumne,60,2023-02-06,48,48,48,0,555,556,555,1,1,0,0,0,211,211,211,211
Ventura,60,2023-02-06,326,326,326,0,6937,6964,6963,1,39,1,1,5,1671,1671,1670,1670
Yolo,60,2023-02-06,79,79,79,0,1254,1261,1260,1,4,1,1,2,444,444,443,443
Yuba,60,2023-02-06,22,22,22,0,623,625,624,1,3,0,0,1,134,134,134,134
Alameda,61,2023-02-13,1120,1126,1126,0,17646,17723,17722,1,90,2,2,8,2117,2117,2115,2115
Amador,61,2023-02-13,19,19,19,0,497,498,497,1,0,0,0,0,98,98,98,98
Butte,61,2023-02-13,87,87,87,0,1252,1258,1257,1,25,1,1,2,490,490,489,489
Calaveras,61,2023-02-13,14,14,14,0,296,297,296,1,0,0,0,0,140,140,140,140
Colusa,61,2023-02-13,8,8,8,0,136,137,136,1,0,0,0,0,22,22,22,22
Contra Costa,61,2023-02-13,700,702,702,0,11539,11590,11589,1,44,2,2,10,1560,1560,1558,1558
Del Norte,61,2023-02-13,19,19,19,0,299,300,299,1,2,0,0,0,59,59,59,59
El Dorado,61,2023-02-13,65,65,65,0,1101,1107,1106,1,2,0,0,0,245,245,245,245
Fresno,61,2023-02-13,471,471,471,0,8745,8784,8783,1,106,4,4,7,3001,3001,2997,2997
Glenn,61,2023-02-13,11,11,11,0,175,176,175,1,5,0,0,0,56,56,56,56
Humboldt,61,2023-02-13,40,40,40,0,578,580,579,1,7,0,0,1,170,170,170,170
Imperial,61,2023-02-13,142,142,142,0,1855,1865,1864,1,3,1,1,5,980,980,979,979
Inyo,61,2023-02-13,5,5,5,0,200,201,200,1,0,0,0,0,63,63,63,63
Kern,61,2023-02-13,327,327,327,0,8271,8308,8307,1,37,2,2,6,2484,2484,2482,2482
Kings,61,2023-02-13,88,88,88,0,1900,1910,1909,1,6,1,1,0,483,483,482,482
Lake,61,2023-02-13,20,20,20,0,567,568,567,1,2,0,0,0,162,162,162,162
Lassen,61,2023-02-13,5,5,5,0,361,362,361,1,0,0,0,0,65,65,65,65
Los Angeles,61,2023-02-13,5915,5942,5942,0,130447,131019,131018,1,613,78,78,67,35488,35488,35410,35410
Madera,61,2023-02-13,60,60,60,0,1238,1246,1245,1,7,0,0,2,377,377,377,377
Marin,61,2023-02-13,143,143,143,0,1931,1940,1939,1,19,0,0,3,260,260,260,260
Mariposa,61,2023-02-13,3,3,3,0,102,103,102,1,0,0,0,0,31,31,31,31
Mendocino,61,2023-02-13,28,28,28,0,538,540,539,1,3,2,2,1,144,144,142,142
Merced,61,2023-02-13,167,167,167,0,1861,1870,1869,1,8,0,0,0,903,903,903,903
Modoc,61,2023-02-13,0,0,0,0,2,3,2,1,0,0,0,0,11,11,11,11
Mono,61,2023-02-13,1,1,1,0,66,67,66,1,0,0,0,0,8,8,8,8
Monterey,61,2023-02-13,224,224,224,0,2492,2505,2504,1,25,3,3,1,803,803,800,800
Napa,61,2023-02-13,92,92,92,0,1364,1371,1370,1,4,1,1,0,164,164,163,163
Nevada,61,2023-02-13,37,37,37,0,596,598,597,1,4,0,0,1,137,137,137,137
Orange,61,2023-02-13,1395,1402,1402,0,20635,20724,20723,1,161,13,13,21,7992,7992,7979,7979
Placer,61,2023-02-13,161,161,161,0,2613,2626,2625,1,35,0,0,6,682,682,682,682
Plumas,61,2023-02-13,3,3,3,0,80,81,80,1,1,0,0,0,15,15,15,15
Riverside,61,2023-02-13,1091,1097,1097,0,16098,16168,16167,1,93,8,8,16,6829,6829,6821,6821
Sacramento,61,2023-02-13,810,814,814,0,13050,13106,13105,1,113,5,5,19,3536,3536,3531,3531
San Benito,61,2023-02-13,43,43,43,0,566,567,566,1,1,0,0,0,112,112,112,112
San Bernardino,61,2023-02-13,1021,1027,1027,0,16940,17016,17015,1,134,0,0,18,8140,8140,8140,8140
San Diego,61,2023-02-13,2025,2034,2034,0,29305,29434,29433,1,218,5,5,25,5808,5808,5803,5803
San Francisco,61,2023-02-13,593,594,594,0,10691,10739,10738,1,59,3,3,5,1176,1176,1173,1173
San Joaquin,61,2023-02-13,456,456,456,0,6984,7015,7014,1,28,1,1,3,2429,2429,2428,2428
San Luis Obispo,61,2023-02-13,133,133,133,0,1683,1692,1691,1,4,1,1,4,563,563,562,562
San Mateo,61,2023-02-13,522,523,523,0,8199,8236,8235,1,29,0,0,5,747,747,747,747
Santa Barbara,61,2023-02-13,188,188,188,0,3937,3956,3955,1,16,1,1,5,760,760,759,759
Santa Clara,61,2023-02-13,1369,1376,1376,0,23148,23250,23249,1,114,10,10,25,2735,2735,2725,2725
Santa Cruz,61,2023-02-13,206,206,206,0,9624,9666,9665,1,19,0,0,0,276,276,276,276
Shasta,61,2023-02-13,33,33,33,0,674,678,677,1,7,0,0,0,612,612,612,612
Siskiyou,61,2023-02-13,11,11,11,0,199,200,199,1,0,0,0,0,96,96,96,96
Solano,61,2023-02-13,260,260,260,0,3774,3792,3791,1,28,0,0,3,475,475,475,475
Sonoma,61,2023-02-13,230,230,230,0,3423,3439,3438,1,32,1,1,1,556,556,555,555
Stanislaus,61,2023-02-13,268,268,268,0,3820,3837,3836,1,47,1,1,9,1842,1842,1841,1841
Sutter,61,2023-02-13,46,46,46,0,658,660,659,1,0,1,1,0,240,240,239,239
Tehama,61,2023-02-13,16,16,16,0,346,347,346,1,1,2,2,0,235,235,233,233
Trinity,61,2023-02-13,1,1,1,0,26,27,26,1,0,0,0,0,24,24,24,24
Tulare,61,2023-02-13,247,247,247,0,4116,4135,4134,1,29,3,3,1,1588,1588,1585,1585
Tuolumne,61,2023-02-13,37,37,37,0,508,510,509,1,2,0,0,0,211,211,211,211
Ventura,61,2023-02-13,316,316,316,0,6666,6697,6696,1,29,5,5,6,1676,1676,1671,1671
Yolo,61,2023-02-13,75,75,75,0,1247,1254,1253,1,3,0,0,1,444,444,444,444
Yuba,61,2023-02-13,31,31,31,0,643,646,645,1,8,0,0,0,134,134,134,134
Alameda,62,2023-02-20,1019,1026,1026,0,15455,15531,15530,1,79,3,3,5,2120,2120,2117,2117
Amador,62,2023-02-20,25,25,25,0,497,498,497,1,1,0,0,1,98,98,98,98
Butte,62,2023-02-20,43,43,43,0,1051,1057,1056,1,7,2,2,1,492,492,490,490
Calaveras,62,2023-02-20,17,17,17,0,289,290,289,1,0,0,0,1,140,140,140,140
Colusa,62,2023-02-20,12,12,12,0,92,93,92,1,0,0,0,0,22,22,22,22
Contra Costa,62,2023-02-20,664,666,666,0,10001,10053,10052,1,57,5,5,6,1565,1565,1560,1560
Del Norte,62,2023-02-20,11,11,11,0,258,259,258,1,2,0,0,0,59,59,59,59
El Dorado,62,2023-02-20,51,51,51,0,976,982,981,1,2,1,1,1,246,246,245,245
Fresno,62,2023-02-20,455,455,455,0,8236,8277,8276,1,84,5,5,17,3006,3006,3001,3001
Glenn,62,2023-02-20,5,5,5,0,146,147,146,1,5,0,0,0,56,56,56,56
Humboldt,62,2023-02-20,35,35,35,0,576,578,577,1,7,0,0,1,170,170,170,170
Imperial,62,2023-02-20,122,122,122,0,1780,1789,1788,1,8,0,0,0,980,980,980,980
Inyo,62,2023-02-20,6,6,6,0,162,163,162,1,0,0,0,0,63,63,63,63
Kern,62,2023-02-20,400,400,400,0,7472,7511,7510,1,29,3,3,5,2487,2487,2484,2484
Kings,62,2023-02-20,77,77,77,0,1639,1648,1647,1,5,1,1,0,484,484,483,483
Lake,62,2023-02-20,19,19,19,0,483,484,483,1,2,1,1,1,163,163,162,162
Lassen,62,2023-02-20,1,1,1,0,327,328,327,1,0,0,0,0,65,65,65,65
Los Angeles,62,2023-02-20,5657,5685,5685,0,118512,119089,119088,1,601,81,81,76,35569,35569,35488,35488
Madera,62,2023-02-20,61,61,61,0,1089,1097,1096,1,3,0,0,2,377,377,377,377
Marin,62,2023-02-20,153,153,153,0,1856,1867,1866,1,13,0,0,2,260,260,260,260
Mariposa,62,2023-02-20,6,6,6,0,121,122,121,1,0,0,0,0,31,31,31,31
Mendocino,62,2023-02-20,25,25,25,0,489,490,489,1,3,0,0,0,144,144,144,144
Merced,62,2023-02-20,122,122,122,0,1754,1764,1763,1,19,0,0,1,903,903,903,903
Modoc,62,2023-02-20,1,1,1,0,15,16,15,1,0,0,0,0,11,11,11,11
Mono,62,2023-02-20,2,2,2,0,67,68,67,1,0,0,0,0,8,8,8,8
Monterey,62,2023-02-20,157,157,157,0,2320,2333,2332,1,22,0,0,0,803,803,803,803
Napa,62,2023-02-20,78,78,78,0,1085,1092,1091,1,3,1,1,1,165,165,164,164
Nevada,62,2023-02-20,28,28,28,0,611,614,613,1,7,1,1,1,138,138,137,137
Orange,62,2023-02-20,1348,1355,1355,0,19441,19537,19536,1,158,20,20,21,8012,8012,7992,7992
Placer,62,2023-02-20,162,162,162,0,2423,2437,2436,1,48,1,1,3,683,683,682,682
Plumas,62,2023-02-20,8,8,8,0,75,76,75,1,0,0,0,0,15,15,15,15
Riverside,62,2023-02-20,991,996,996,0,15220,15295,15294,1,92,8,8,9,6837,6837,6829,6829
Sacramento,62,2023-02-20,731,735,735,0,11557,11613,11612,1,103,13,13,16,3549,3549,3536,3536
San Benito,62,2023-02-20,28,28,28,0,476,477,476,1,1,2,2,0,114,114,112,112
San Bernardino,62,2023-02-20,903,909,909,0,15187,15263,15262,1,117,0,0,27,8140,8140,8140,8140
San Diego,62,2023-02-20,1763,1771,1771,0,25420,25544,25543,1,201,7,7,25,5815,5815,5808,5808
San Francisco,62,2023-02-20,591,591,591,0,9941,9989,9988,1,79,0,0,7,1176,1176,1176,1176
San Joaquin,62,2023-02-20,413,413,413,0,7385,7422,7421,1,30,1,1,7,2430,2430,2429,2429
San Luis Obispo,62,2023-02-20,96,96,96,0,1435,1443,1442,1,11,0,0,0,563,563,563,563
San Mateo,62,2023-02-20,467,467,467,0,7435,7471,7470,1,44,0,0,3,747,747,747,747
Santa Barbara,62,2023-02-20,206,206,206,0,3629,3647,3646,1,18,0,0,5,760,760,760,760
Santa Clara,62,2023-02-20,1214,1221,1221,0,19520,19616,19615,1,111,13,13,26,2748,2748,2735,2735
Santa Cruz,62,2023-02-20,136,136,136,0,6262,6294,6293,1,20,0,0,2,276,276,276,276
Shasta,62,2023-02-20,18,18,18,0,728,733,732,1,2,0,0,0,612,612,612,612
Siskiyou,62,2023-02-20,14,14,14,0,198,199,198,1,0,0,0,0,96,96,96,96
Solano,62,2023-02-20,229,229,229,0,3264,3280,3279,1,26,0,0,3,475,475,475,475
Sonoma,62,2023-02-20,265,265,265,0,3201,3218,3217,1,24,1,1,4,557,557,556,556
Stanislaus,62,2023-02-20,265,265,265,0,3644,3664,3663,1,55,0,0,4,1842,1842,1842,1842
Sutter,62,2023-02-20,38,38,38,0,539,540,539,1,0,1,1,0,241,241,240,240
Tehama,62,2023-02-20,13,13,13,0,279,280,279,1,0,0,0,0,235,235,235,235
Trinity,62,2023-02-20,0,0,0,0,30,31,30,1,0,0,0,0,24,24,24,24
Tulare,62,2023-02-20,214,214,214,0,3795,3814,3813,1,23,0,0,0,1588,1588,1588,1588
Tuolumne,62,2023-02-20,32,32,32,0,446,447,446,1,0,0,0,0,211,211,211,211
Ventura,62,2023-02-20,283,283,283,0,5625,5653,5652,1,30,4,4,7,1680,1680,1676,1676
Yolo,62,2023-02-20,87,87,87,0,1282,1290,1289,1,1,2,2,1,446,446,444,444
Yuba,62,2023-02-20,25,25,25,0,507,508,507,1,6,0,0,0,134,134,134,134
Alameda,63,2023-02-27,1127,1134,1134,0,18651,18750,18749,1,96,5,5,9,2125,2125,2120,2120
Amador,63,2023-02-27,19,19,19,0,521,524,523,1,1,0,0,1,98,98,98,98
Butte,63,2023-02-27,56,56,56,0,949,955,954,1,8,1,1,1,493,493,492,492
Calaveras,63,2023-02-27,15,15,15,0,306,307,306,1,1,0,0,0,140,140,140,140
Colusa,63,2023-02-27,12,12,12,0,85,86,85,1,0,0,0,0,22,22,22,22
Contra Costa,63,2023-02-27,721,726,726,0,11451,11512,11511,1,63,4,4,11,1569,1569,1565,1565
Del Norte,63,2023-02-27,7,7,7,0,288,289,288,1,0,0,0,0,59,59,59,59
El Dorado,63,2023-02-27,61,61,61,0,1039,1045,1044,1,2,1,1,0,247,247,246,246
Fresno,63,2023-02-27,468,469,469,0,9006,9054,9053,1,93,2,2,7,3008,3008,3006,3006
Glenn,63,2023-02-27,4,4,4,0,144,145,144,1,1,0,0,0,56,56,56,56
Humboldt,63,2023-02-27,29,29,29,0,490,491,490,1,4,0,0,1,170,170,170,170
Imperial,63,2023-02-27,174,174,174,0,1832,1843,1842,1,13,0,0,0,980,980,980,980
Inyo,63,2023-02-27,4,4,4,0,156,157,156,1,0,0,0,0,63,63,63,63
Kern,63,2023-02-27,400,400,400,0,8254,8298,8297,1,42,3,3,7,2490,2490,2487,2487
Kings,63,2023-02-27,61,61,61,0,1687,1698,1697,1,4,1,1,0,485,485,484,484
Lake,63,2023-02-27,21,21,21,0,465,466,465,1,2,1,1,1,164,164,163,163
Lassen,63,2023-02-27,3,3,3,0,352,353,352,1,0,0,0,0,65,65,65,65
Los Angeles,63,2023-02-27,5363,5390,5390,0,134722,135429,135427,2,573,72,72,75,35641,35641,35569,35569
Madera,63,2023-02-27,62,62,62,0,1187,1195,1194,1,7,0,0,1,377,377,377,377
Marin,63,2023-02-27,145,145,145,0,1966,1978,1977,1,16,0,0,3,260,260,260,260
Mariposa,63,2023-02-27,7,7,7,0,97,98,97,1,0,0,0,0,31,31,31,31
Mendocino,63,2023-02-27,21,21,21,0,492,494,493,1,5,1,1,1,145,145,144,144
Merced,63,2023-02-27,124,124,124,0,1887,1898,1897,1,19,0,0,1,903,903,903,903
Modoc,63,2023-02-27,1,1,1,0,8,9,8,1,0,0,0,0,11,11,11,11
Mono,63,2023-02-27,5,5,5,0,52,53,52,1,0,0,0,0,8,8,8,8
Monterey,63,2023-02-27,182,182,182,0,2579,2593,2592,1,30,2,2,1,805,805,803,803
Napa,63,2023-02-27,79,79,79,0,1317,1323,1322,1,7,2,2,4,167,167,165,165
Nevada,63,2023-02-27,25,25,25,0,566,568,567,1,2,0,0,0,138,138,138,138
Orange,63,2023-02-27,1208,1215,1215,0,19661,19766,19765,1,161,21,21,21,8033,8033,8012,8012
Placer,63,2023-02-27,178,178,178,0,2568,2582,2581,1,44,0,0,7,683,683,683,683
Plumas,63,2023-02-27,3,3,3,0,88,89,88,1,0,0,0,0,15,15,15,15
Riverside,63,2023-02-27,914,919,919,0,15470,15552,15551,1,76,7,7,15,6844,6844,6837,6837
Sacramento,63,2023-02-27,928,933,933,0,12781,12849,12848,1,121,6,6,19,3555,3555,3549,3549
San Benito,63,2023-02-27,29,29,29,0,473,475,474,1,2,0,0,0,114,114,114,114
San Bernardino,63,2023-02-27,868,873,873,0,16332,16420,16419,1,111,0,0,24,8140,8140,8140,8140
San Diego,63,2023-02-27,1811,1821,1821,0,27629,27775,27774,1,210,8,8,21,5823,5823,5815,5815
San Francisco,63,2023-02-27,654,658,658,0,11656,11716,11715,1,76,6,6,8,1182,1182,1176,1176
San Joaquin,63,2023-02-27,417,418,418,0,7526,7567,7566,1,33,3,3,3,2433,2433,2430,2430
San Luis Obispo,63,2023-02-27,83,83,83,0,1670,1681,1680,1,11,2,2,0,565,565,563,563
San Mateo,63,2023-02-27,480,480,480,0,7513,7554,7553,1,43,0,0,4,747,747,747,747
Santa Barbara,63,2023-02-27,176,176,176,0,3562,3582,3581,1,18,2,2,8,762,762,760,760
Santa Clara,63,2023-02-27,1333,1340,1340,0,21605,21720,21719,1,126,12,12,26,2760,2760,2748,2748
Santa Cruz,63,2023-02-27,160,160,160,0,8755,8802,8801,1,7,0,0,1,276,276,276,276
Shasta,63,2023-02-27,37,37,37,0,656,660,659,1,9,0,0,1,612,612,612,612
Siskiyou,63,2023-02-27,11,11,11,0,235,236,235,1,0,0,0,0,96,96,96,96
Solano,63,2023-02-27,297,297,297,0,3682,3702,3701,1,30,0,0,8,475,475,475,475
Sonoma,63,2023-02-27,213,213,213,0,3410,3429,3428,1,33,1,1,5,558,558,557,557
Stanislaus,63,2023-02-27,244,244,244,0,3842,3865,3864,1,58,0,0,3,1842,1842,1842,1842
Sutter,63,2023-02-27,46,46,46,0,503,505,504,1,0,0,0,0,241,241,241,241
Tehama,63,2023-02-27,14,14,14,0,267,268,267,1,2,0,0,1,235,235,235,235
Trinity,63,2023-02-27,0,0,0,0,20,21,20,1,0,0,0,0,24,24,24,24
Tulare,63,2023-02-27,215,215,215,0,4010,4032,4031,1,22,3,3,2,1591,1591,1588,1588
Tuolumne,63,2023-02-27,40,40,40,0,472,474,473,1,0,0,0,1,211,211,211,211
Ventura,63,2023-02-27,275,275,275,0,5917,5948,5947,1,35,2,2,7,1682,1682,1680,1680
Yolo,63,2023-02-27,92,92,92,0,1370,1379,1378,1,3,2,2,1,448,448,446,446
Yuba,63,2023-02-27,36,36,36,0,508,510,509,1,0,0,0,0,134,134,134,134
Alameda,64,2023-03-06,927,934,934,0,16598,16699,16698,1,96,4,4,12,2129,2129,2125,2125
Amador,64,2023-03-06,14,14,14,0,461,463,462,1,0,0,0,0,98,98,98,98
Butte,64,2023-03-06,37,37,37,0,591,596,595,1,5,1,1,0,494,494,493,493
Calaveras,64,2023-03-06,19,19,19,0,269,270,269,1,0,2,2,0,142,142,140,140
Colusa,64,2023-03-06,13,13,13,0,161,162,161,1,0,0,0,0,22,22,22,22
Contra Costa,64,2023-03-06,694,698,698,0,10264,10327,10326,1,64,3,3,8,1572,1572,1569,1569
Del Norte,64,2023-03-06,6,6,6,0,253,254,253,1,1,2,2,1,61,61,59,59
El Dorado,64,2023-03-06,52,52,52,0,955,961,960,1,2,0,0,0,247,247,247,247
Fresno,64,2023-03-06,391,392,392,0,7976,8025,8024,1,77,5,5,16,3013,3013,3008,3008
Glenn,64,2023-03-06,4,4,4,0,163,165,164,1,0,0,0,0,56,56,56,56
Humboldt,64,2023-03-06,23,23,23,0,491,493,492,1,1,0,0,1,170,170,170,170
Imperial,64,2023-03-06,168,168,168,0,1612,1623,1622,1,9,0,0,0,980,980,980,980
Inyo,64,2023-03-06,4,4,4,0,136,137,136,1,1,0,0,0,63,63,63,63
Kern,64,2023-03-06,327,328,328,0,7773,7822,7821,1,35,3,3,4,2493,2493,2490,2490
Kings,64,2023-03-06,65,65,65,0,1566,1576,1575,1,1,0,0,0,485,485,485,485
Lake,64,2023-03-06,19,19,19,0,487,491,490,1,1,0,0,0,164,164,164,164
Lassen,64,2023-03-06,4,4,4,0,306,307,306,1,1,0,0,0,65,65,65,65
Los Angeles,64,2023-03-06,4598,4627,4627,0,123686,124435,124434,1,509,67,67,60,35708,35708,35641,35641
Madera,64,2023-03-06,82,82,82,0,1146,1154,1153,1,5,0,0,0,377,377,377,377
Marin,64,2023-03-06,140,140,140,0,1776,1788,1787,1,21,0,0,2,260,260,260,260
Mariposa,64,2023-03-06,0,0,0,0,69,70,69,1,0,0,0,0,31,31,31,31
Mendocino,64,2023-03-06,26,26,26,0,448,451,450,1,7,0,0,1,145,145,145,145
Merced,64,2023-03-06,147,147,147,0,1730,1742,1741,1,14,0,0,2,903,903,903,903
Modoc,64,2023-03-06,1,1,1,0,9,10,9,1,0,0,0,0,11,11,11,11
Mono,64,2023-03-06,5,5,5,0,56,57,56,1,0,0,0,0,8,8,8,8
Monterey,64,2023-03-06,145,145,145,0,2158,2173,2172,1,29,4,4,3,809,809,805,805
Napa,64,2023-03-06,52,52,52,0,1056,1063,1062,1,9,1,1,2,168,168,167,167
Nevada,64,2023-03-06,18,18,18,0,484,487,486,1,2,0,0,0,138,138,138,138
Orange,64,2023-03-06,994,1001,1001,0,18929,19044,19043,1,111,18,18,18,8051,8051,8033,8033
Placer,64,2023-03-06,172,172,172,0,2461,2476,2475,1,62,0,0,5,683,683,683,683
Plumas,64,2023-03-06,1,1,1,0,68,69,68,1,0,0,0,0,15,15,15,15
Riverside,64,2023-03-06,881,888,888,0,14025,14109,14108,1,78,3,3,8,6847,6847,6844,6844
Sacramento,64,2023-03-06,859,865,865,0,11808,11880,11879,1,113,6,6,6,3561,3561,3555,3555
San Benito,64,2023-03-06,16,16,16,0,466,468,467,1,1,0,0,0,114,114,114,114
San Bernardino,64,2023-03-06,745,752,752,0,15032,15125,15124,1,99,0,0,18,8140,8140,8140,8140
San Diego,64,2023-03-06,1410,1419,1419,0,25377,25532,25531,1,179,12,12,13,5835,5835,5823,5823
San Francisco,64,2023-03-06,599,603,603,0,10727,10791,10790,1,73,5,5,11,1187,1187,1182,1182
San Joaquin,64,2023-03-06,380,381,381,0,6840,6882,6881,1,42,1,1,8,2434,2434,2433,2433
San Luis Obispo,64,2023-03-06,92,92,92,0,1309,1318,1317,1,9,4,4,0,569,569,565,565
San Mateo,64,2023-03-06,424,425,425,0,7228,7272,7271,1,28,0,0,3,747,747,747,747
Santa Barbara,64,2023-03-06,149,149,149,0,3681,3704,3703,1,18,2,2,1,764,764,762,762
Santa Clara,64,2023-03-06,1079,1086,1086,0,21012,21138,21137,1,133,10,10,32,2770,2770,2760,2760
Santa Cruz,64,2023-03-06,133,133,133,0,5125,5157,5156,1,20,0,0,0,276,276,276,276
Shasta,64,2023-03-06,24,24,24,0,633,638,637,1,5,0,0,2,612,612,612,612
Siskiyou,64,2023-03-06,6,6,6,0,223,224,223,1,1,0,0,0,96,96,96,96
Solano,64,2023-03-06,255,255,255,0,3341,3362,3361,1,34,0,0,5,475,475,475,475
Sonoma,64,2023-03-06,210,210,210,0,3228,3249,3248,1,23,0,0,2,558,558,558,558
Stanislaus,64,2023-03-06,259,259,259,0,3555,3578,3577,1,67,0,0,9,1842,1842,1842,1842
Sutter,64,2023-03-06,35,35,35,0,593,597,596,1,0,0,0,0,241,241,241,241
Tehama,64,2023-03-06,12,12,12,0,252,253,252,1,5,0,0,1,235,235,235,235
Trinity,64,2023-03-06,2,2,2,0,18,19,18,1,0,0,0,0,24,24,24,24
Tulare,64,2023-03-06,208,208,208,0,3264,3285,3284,1,29,0,0,3,1591,1591,1591,1591
Tuolumne,64,2023-03-06,37,37,37,0,401,402,401,1,1,0,0,0,211,211,211,211
Ventura,64,2023-03-06,252,252,252,0,4975,5006,5005,1,42,2,2,5,1684,1684,1682,1682
Yolo,64,2023-03-06,64,64,64,0,1261,1271,1270,1,4,1,1,0,449,449,448,448
Yuba,64,2023-03-06,38,38,38,0,509,513,512,1,7,0,0,0,134,134,134,134
Alameda,65,2023-03-13,860,867,867,0,15337,15447,15446,1,76,2,2,18,2131,2131,2129,2129
Amador,65,2023-03-13,13,13,13,0,380,381,380,1,5,0,0,1,98,98,98,98
Butte,65,2023-03-13,38,38,38,0,603,609,608,1,9,1,1,1,495,495,494,494
Calaveras,65,2023-03-13,14,14,14,0,243,244,243,1,0,0,0,0,142,142,142,142
Colusa,65,2023-03-13,4,4,4,0,159,161,160,1,0,1,1,0,23,23,22,22
Contra Costa,65,2023-03-13,583,588,588,0,9868,9941,9940,1,44,2,2,7,1574,1574,1572,1572
Del Norte,65,2023-03-13,8,8,8,0,256,257,256,1,1,0,0,0,61,61,61,61
El Dorado,65,2023-03-13,47,47,47,0,898,906,905,1,1,0,0,0,247,247,247,247
Fresno,65,2023-03-13,384,385,385,0,7769,7825,7824,1,79,0,0,10,3013,3013,3013,3013
Glenn,65,2023-03-13,10,10,10,0,141,143,142,1,0,0,0,0,56,56,56,56
Humboldt,65,2023-03-13,28,28,28,0,506,510,509,1,4,0,0,1,170,170,170,170
Imperial,65,2023-03-13,215,215,215,0,2037,2052,2051,1,12,1,1,0,981,981,980,980
Inyo,65,2023-03-13,0,0,0,0,259,262,261,1,0,0,0,0,63,63,63,63
Kern,65,2023-03-13,336,337,337,0,7639,7695,7694,1,52,0,0,12,2493,2493,2493,2493
Kings,65,2023-03-13,60,60,60,0,1438,1449,1448,1,1,0,0,0,485,485,485,485
Lake,65,2023-03-13,11,11,11,0,410,413,412,1,1,0,0,0,164,164,164,164
Lassen,65,2023-03-13,6,6,6,0,335,337,336,1,0,0,0,0,65,65,65,65
Los Angeles,65,2023-03-13,3874,3903,3903,0,121078,121942,121941,1,418,70,72,56,35778,35780,35708,35708
Madera,65,2023-03-13,50,50,50,0,1154,1163,1162,1,6,0,0,0,377,377,377,377
Marin,65,2023-03-13,99,99,99,0,1720,1733,1732,1,21,0,0,1,260,260,260,260
Mariposa,65,2023-03-13,5,5,5,0,93,94,93,1,0,0,0,0,31,31,31,31
Mendocino,65,2023-03-13,18,18,18,0,458,462,461,1,6,0,0,1,145,145,145,145
Merced,65,2023-03-13,102,102,102,0,1560,1574,1573,1,12,0,0,2,903,903,903,903
Modoc,65,2023-03-13,1,1,1,0,12,13,12,1,0,0,0,0,11,11,11,11
Mono,65,2023-03-13,1,1,1,0,50,51,50,1,0,0,0,0,8,8,8,8
Monterey,65,2023-03-13,72,72,72,0,1810,1824,1823,1,27,0,0,2,809,809,809,809
Napa,65,2023-03-13,55,55,55,0,940,946,945,1,4,3,3,2,171,171,168,168
Nevada,65,2023-03-13,18,18,18,0,478,482,481,1,4,0,0,0,138,138,138,138
Orange,65,2023-03-13,913,920,920,0,18189,18321,18320,1,129,28,28,21,8079,8079,8051,8051
Placer,65,2023-03-13,168,168,168,0,2134,2150,2149,1,66,0,0,8,683,683,683,683
Plumas,65,2023-03-13,5,5,5,0,64,65,64,1,0,0,0,0,15,15,15,15
Riverside,65,2023-03-13,905,912,912,0,14843,14950,14949,1,79,7,7,14,6854,6854,6847,6847
Sacramento,65,2023-03-13,710,715,715,0,10743,10820,10819,1,105,7,7,21,3568,3568,3561,3561
San Benito,65,2023-03-13,13,13,13,0,412,415,414,1,0,0,0,0,114,114,114,114
San Bernardino,65,2023-03-13,708,714,714,0,14751,14858,14857,1,94,0,0,20,8140,8140,8140,8140
San Diego,65,2023-03-13,1316,1326,1326,0,23811,23982,23981,1,177,10,10,13,5845,5845,5835,5835
San Francisco,65,2023-03-13,550,555,555,0,9412,9479,9478,1,73,3,3,14,1190,1190,1187,1187
San Joaquin,65,2023-03-13,374,375,375,0,6830,6880,6879,1,34,4,4,6,2438,2438,2434,2434
San Luis Obispo,65,2023-03-13,78,78,78,0,1326,1335,1334,1,9,0,0,0,569,569,569,569
San Mateo,65,2023-03-13,371,371,371,0,6701,6749,6748,1,24,0,0,5,747,747,747,747
Santa Barbara,65,2023-03-13,149,149,149,0,3416,3442,3441,1,12,0,0,1,764,764,764,764
Santa Clara,65,2023-03-13,1043,1050,1050,0,20757,20906,20905,1,139,12,12,20,2782,2782,2770,2770
Santa Cruz,65,2023-03-13,109,109,109,0,3217,3242,3241,1,21,0,0,1,276,276,276,276
Shasta,65,2023-03-13,27,27,27,0,586,592,591,1,6,0,0,1,612,612,612,612
Siskiyou,65,2023-03-13,10,10,10,0,159,160,159,1,0,0,0,0,96,96,96,96
Solano,65,2023-03-13,229,229,229,0,3081,3105,3104,1,27,0,0,4,475,475,475,475
Sonoma,65,2023-03-13,193,193,193,0,2820,2841,2840,1,41,3,3,4,561,561,558,558
Stanislaus,65,2023-03-13,194,194,194,0,3459,3486,3485,1,52,0,0,4,1842,1842,1842,1842
Sutter,65,2023-03-13,27,27,27,0,518,522,521,1,0,0,0,0,241,241,241,241
Tehama,65,2023-03-13,17,17,17,0,230,231,230,1,1,0,0,0,235,235,235,235
Trinity,65,2023-03-13,0,0,0,0,22,23,22,1,0,0,0,0,24,24,24,24
Tulare,65,2023-03-13,164,164,164,0,3268,3293,3292,1,31,3,3,2,1594,1594,1591,1591
Tuolumne,65,2023-03-13,18,18,18,0,368,370,369,1,2,0,0,0,211,211,211,211
Ventura,65,2023-03-13,230,230,230,0,4369,4400,4399,1,25,4,4,5,1688,1688,1684,1684
Yolo,65,2023-03-13,72,72,72,0,1078,1087,1086,1,2,1,1,0,450,450,449,449
Yuba,65,2023-03-13,34,34,34,0,473,477,476,1,7,0,0,0,134,134,134,134
Alameda,66,2023-03-20,765,772,772,0,15001,15126,15125,1,69,7,7,10,2138,2138,2131,2131
Amador,66,2023-03-20,17,17,17,0,409,412,411,1,3,0,0,1,98,98,98,98
Butte,66,2023-03-20,44,44,44,0,502,507,506,1,5,1,1,3,496,496,495,495
Calaveras,66,2023-03-20,9,9,9,0,252,253,252,1,0,0,0,0,142,142,142,142
Colusa,66,2023-03-20,4,4,4,0,153,155,154,1,0,0,0,0,23,23,23,23
Contra Costa,66,2023-03-20,436,440,440,0,9513,9592,9591,1,31,6,6,8,1580,1580,1574,1574
Del Norte,66,2023-03-20,2,2,2,0,224,225,224,1,0,0,0,1,61,61,61,61
El Dorado,66,2023-03-20,46,46,46,0,854,862,861,1,2,0,0,0,247,247,247,247
Fresno,66,2023-03-20,371,371,371,0,7786,7852,7851,1,66,2,2,16,3015,3015,3013,3013
Glenn,66,2023-03-20,4,4,4,0,132,134,133,1,0,0,0,0,56,56,56,56
Humboldt,66,2023-03-20,21,21,21,0,481,487,486,1,4,0,0,2,170,170,170,170
Imperial,66,2023-03-20,158,158,158,0,1640,1655,1654,1,9,0,0,1,981,981,981,981
Inyo,66,2023-03-20,10,10,10,0,281,283,282,1,0,0,0,0,63,63,63,63
Kern,66,2023-03-20,203,203,203,0,7655,7719,7718,1,29,2,2,8,2495,2495,2493,2493
Kings,66,2023-03-20,40,40,40,0,1449,1463,1462,1,1,1,1,0,486,486,485,485
Lake,66,2023-03-20,12,12,12,0,405,411,410,1,2,0,0,0,164,164,164,164
Lassen,66,2023-03-20,4,4,4,0,313,315,314,1,0,0,0,0,65,65,65,65
Los Angeles,66,2023-03-20,3213,3240,3240,0,110149,111062,111061,1,397,60,62,44,35838,35842,35778,35780
Madera,66,2023-03-20,54,54,54,0,1126,1136,1135,1,4,0,0,0,377,377,377,377
Marin,66,2023-03-20,88,88,88,0,1523,1537,1536,1,25,0,0,2,260,260,260,260
Mariposa,66,2023-03-20,2,2,2,0,91,92,91,1,0,0,0,0,31,31,31,31
Mendocino,66,2023-03-20,11,11,11,0,426,430,429,1,2,0,0,0,145,145,145,145
Merced,66,2023-03-20,104,104,104,0,1595,1610,1609,1,6,0,0,2,903,903,903,903
Modoc,66,2023-03-20,1,1,1,0,10,11,10,1,0,0,0,0,11,11,11,11
Mono,66,2023-03-20,4,4,4,0,54,55,54,1,0,0,0,0,8,8,8,8
Monterey,66,2023-03-20,59,59,59,0,1447,1460,1459,1,21,0,0,1,809,809,809,809
Napa,66,2023-03-20,30,30,30,0,905,912,911,1,3,1,1,1,172,172,171,171
Nevada,66,2023-03-20,17,17,17,0,459,465,464,1,4,0,0,0,138,138,138,138
Orange,66,2023-03-20,744,751,751,0,16591,16729,16728,1,115,11,11,25,8090,8090,8079,8079
Placer,66,2023-03-20,124,124,124,0,2148,2167,2166,1,58,0,0,8,683,683,683,683
Plumas,66,2023-03-20,2,2,2,0,53,54,53,1,0,0,0,0,15,15,15,15
Riverside,66,2023-03-20,591,597,597,0,12570,12675,12674,1,57,1,1,7,6855,6855,6854,6854
Sacramento,66,2023-03-20,491,496,496,0,9948,10031,10030,1,85,4,4,16,3572,3572,3568,3568
San Benito,66,2023-03-20,41,41,41,0,556,561,560,1,0,1,1,0,115,115,114,114
San Bernardino,66,2023-03-20,525,530,530,0,14449,14570,14569,1,77,0,0,12,8140,8140,8140,8140
San Diego,66,2023-03-20,1120,1130,1130,0,22962,23152,23151,1,139,10,10,13,5855,5855,5845,5845
San Francisco,66,2023-03-20,418,421,421,0,8556,8627,8626,1,63,4,4,8,1194,1194,1190,1190
San Joaquin,66,2023-03-20,287,288,288,0,6247,6300,6299,1,28,6,6,5,2444,2444,2438,2438
San Luis Obispo,66,2023-03-20,48,48,48,0,1160,1170,1169,1,9,1,1,0,570,570,569,569
San Mateo,66,2023-03-20,309,310,310,0,6319,6372,6371,1,24,0,0,1,747,747,747,747
Santa Barbara,66,2023-03-20,111,111,111,0,3112,3139,3138,1,15,1,1,1,765,765,764,764
Santa Clara,66,2023-03-20,791,798,798,0,17208,17352,17351,1,151,8,8,22,2790,2790,2782,2782
Santa Cruz,66,2023-03-20,121,121,121,0,3051,3077,3076,1,9,0,0,1,276,276,276,276
Shasta,66,2023-03-20,18,18,18,0,579,585,584,1,2,0,0,3,612,612,612,612
Siskiyou,66,2023-03-20,4,4,4,0,163,164,163,1,0,0,0,0,96,96,96,96
Solano,66,2023-03-20,185,185,185,0,2905,2931,2930,1,26,1,1,5,476,476,475,475
Sonoma,66,2023-03-20,184,184,184,0,2730,2754,2753,1,33,0,0,1,561,561,561,561
Stanislaus,66,2023-03-20,200,200,200,0,3329,3357,3356,1,48,0,0,6,1842,1842,1842,1842
Sutter,66,2023-03-20,38,38,38,0,488,494,493,1,0,0,0,0,241,241,241,241
Tehama,66,2023-03-20,14,14,14,0,218,219,218,1,2,1,1,0,236,236,235,235
Trinity,66,2023-03-20,0,0,0,0,17,18,17,1,0,0,0,0,24,24,24,24
Tulare,66,2023-03-20,120,120,120,0,2687,2710,2709,1,25,1,1,0,1595,1595,1594,1594
Tuolumne,66,2023-03-20,15,15,15,0,391,394,393,1,0,0,0,0,211,211,211,211
Ventura,66,2023-03-20,176,176,176,0,4150,4185,4184,1,39,4,4,2,1692,1692,1688,1688
Yolo,66,2023-03-20,54,54,54,0,1092,1102,1101,1,6,0,0,1,450,450,450,450
Yuba,66,2023-03-20,18,18,18,0,462,467,466,1,7,0,0,0,134,134,134,134
Alameda,67,2023-03-27,593,600,600,0,13523,13654,13653,1,91,3,3,9,2141,2141,2138,2138
Amador,67,2023-03-27,10,10,10,0,368,372,371,1,3,0,0,1,98,98,98,98
Butte,67,2023-03-27,31,31,31,0,504,510,509,1,8,1,1,0,497,497,496,496
Calaveras,67,2023-03-27,12,12,12,0,254,256,255,1,0,1,1,0,143,143,142,142
Colusa,67,2023-03-27,4,4,4,0,163,166,165,1,0,0,0,0,23,23,23,23
Contra Costa,67,2023-03-27,397,402,402,0,8949,9037,9036,1,33,1,1,6,1581,1581,1580,1580
Del Norte,67,2023-03-27,6,6,6,0,206,207,206,1,0,0,0,1,61,61,61,61
El Dorado,67,2023-03-27,35,35,35,0,791,801,800,1,2,0,0,0,247,247,247,247
Fresno,67,2023-03-27,251,251,251,0,7276,7348,7347,1,59,1,1,5,3016,3016,3015,3015
Glenn,67,2023-03-27,6,6,6,0,134,136,135,1,0,0,0,0,56,56,56,56
Humboldt,67,2023-03-27,13,13,13,0,456,462,461,1,5,1,1,1,171,171,170,170
Imperial,67,2023-03-27,151,151,151,0,1688,1705,1704,1,10,0,0,1,981,981,981,981
Inyo,67,2023-03-27,10,10,10,0,224,227,226,1,0,0,0,0,63,63,63,63
Kern,67,2023-03-27,186,186,186,0,7002,7072,7071,1,29,1,1,3,2496,2496,2495,2495
Kings,67,2023-03-27,38,38,38,0,1321,1335,1334,1,2,0,0,1,486,486,486,486
Lake,67,2023-03-27,13,13,13,0,350,355,354,1,2,1,1,0,165,165,164,164
Lassen,67,2023-03-27,7,7,7,0,324,327,326,1,0,0,0,0,65,65,65,65
Los Angeles,67,2023-03-27,2437,2461,2461,0,103964,104975,104974,1,348,32,32,46,35870,35874,35838,35842
Madera,67,2023-03-27,34,34,34,0,977,987,986,1,5,0,0,0,377,377,377,377
Marin,67,2023-03-27,77,77,77,0,1290,1303,1302,1,18,0,0,1,260,260,260,260
Mariposa,67,2023-03-27,0,0,0,0,74,75,74,1,0,0,0,0,31,31,31,31
Mendocino,67,2023-03-27,15,15,15,0,412,416,415,1,1,0,0,1,145,145,145,145
Merced,67,2023-03-27,93,93,93,0,1619,1635,1634,1,6,0,0,2,903,903,903,903
Modoc,67,2023-03-27,0,0,0,0,5,6,5,1,0,0,0,0,11,11,11,11
Mono,67,2023-03-27,1,1,1,0,49,50,49,1,0,0,0,0,8,8,8,8
Monterey,67,2023-03-27,51,51,51,0,1706,1723,1722,1,19,0,0,0,809,809,809,809
Napa,67,2023-03-27,42,42,42,0,888,897,896,1,3,0,0,1,172,172,172,172
Nevada,67,2023-03-27,24,24,24,0,473,479,478,1,3,0,0,0,138,138,138,138
Orange,67,2023-03-27,635,642,642,0,15723,15877,15876,1,112,16,16,19,8106,8106,8090,8090
Placer,67,2023-03-27,104,104,104,0,1894,1913,1912,1,43,0,0,6,683,683,683,683
Plumas,67,2023-03-27,1,1,1,0,56,57,56,1,0,0,0,0,15,15,15,15
Riverside,67,2023-03-27,548,554,554,0,11412,11524,11523,1,41,5,5,6,6860,6860,6855,6855
Sacramento,67,2023-03-27,443,448,448,0,9629,9724,9723,1,79,9,9,11,3581,3581,3572,3572
San Benito,67,2023-03-27,25,25,25,0,754,761,760,1,1,0,0,0,115,115,115,115
San Bernardino,67,2023-03-27,426,429,429,0,12868,12994,12993,1,67,0,0,12,8140,8140,8140,8140
San Diego,67,2023-03-27,884,893,893,0,20783,20986,20985,1,137,6,6,7,5861,5861,5855,5855
San Francisco,67,2023-03-27,371,373,373,0,8197,8278,8277,1,45,3,3,5,1197,1197,1194,1194
San Joaquin,67,2023-03-27,246,247,247,0,6474,6537,6536,1,23,4,4,11,2448,2448,2444,2444
San Luis Obispo,67,2023-03-27,39,39,39,0,1142,1154,1153,1,4,0,0,0,570,570,570,570
San Mateo,67,2023-03-27,270,271,271,0,5736,5793,5792,1,29,0,0,1,747,747,747,747
Santa Barbara,67,2023-03-27,88,88,88,0,3236,3267,3266,1,9,0,0,2,765,765,765,765
Santa Clara,67,2023-03-27,697,704,704,0,16446,16606,16605,1,100,7,7,14,2797,2797,2790,2790
Santa Cruz,67,2023-03-27,128,128,128,0,2972,3002,3001,1,8,0,0,1,276,276,276,276
Shasta,67,2023-03-27,16,16,16,0,539,545,544,1,2,0,0,3,612,612,612,612
Siskiyou,67,2023-03-27,1,1,1,0,150,151,150,1,0,0,0,0,96,96,96,96
Solano,67,2023-03-27,169,169,169,0,2686,2714,2713,1,23,0,0,4,476,476,476,476
Sonoma,67,2023-03-27,156,156,156,0,2421,2446,2445,1,29,2,2,4,563,563,561,561
Stanislaus,67,2023-03-27,151,151,151,0,2749,2776,2775,1,39,0,0,6,1842,1842,1842,1842
Sutter,67,2023-03-27,37,37,37,0,423,429,428,1,0,0,0,0,241,241,241,241
Tehama,67,2023-03-27,5,5,5,0,196,197,196,1,2,1,1,0,237,237,236,236
Trinity,67,2023-03-27,0,0,0,0,24,25,24,1,0,0,0,0,24,24,24,24
Tulare,67,2023-03-27,102,102,102,0,2732,2760,2759,1,25,0,0,1,1595,1595,1595,1595
Tuolumne,67,2023-03-27,8,8,8,0,311,314,313,1,1,0,0,0,211,211,211,211
Ventura,67,2023-03-27,146,146,146,0,4103,4144,4143,1,25,4,4,2,1696,1696,1692,1692
Yolo,67,2023-03-27,60,60,60,0,1112,1122,1121,1,6,1,1,1,451,451,450,450
Yuba,67,2023-03-27,13,13,13,0,419,425,424,1,1,0,0,1,134,134,134,134
Alameda,68,2023-04-03,575,582,582,0,12562,12704,12703,1,58,3,3,9,2144,2144,2141,2141
Amador,68,2023-04-03,16,16,16,0,297,302,301,1,2,0,0,0,98,98,98,98
Butte,68,2023-04-03,22,22,22,0,466,473,472,1,7,1,1,0,498,498,497,497
Calaveras,68,2023-04-03,5,5,5,0,212,213,212,1,0,0,0,0,143,143,143,143
Colusa,68,2023-04-03,9,9,9,0,174,177,176,1,2,0,0,0,23,23,23,23
Contra Costa,68,2023-04-03,393,399,399,0,8759,8857,8856,1,37,3,3,4,1584,1584,1581,1581
Del Norte,68,2023-04-03,5,5,5,0,195,196,195,1,0,0,0,0,61,61,61,61
El Dorado,68,2023-04-03,65,65,65,0,755,765,764,1,4,0,0,0,247,247,247,247
Fresno,68,2023-04-03,276,278,278,0,7116,7196,7195,1,54,4,4,12,3020,3020,3016,3016
Glenn,68,2023-04-03,6,6,6,0,127,129,128,1,0,0,0,0,56,56,56,56
Humboldt,68,2023-04-03,20,20,20,0,453,459,458,1,5,0,0,0,171,171,171,171
Imperial,68,2023-04-03,189,190,190,0,1521,1539,1538,1,14,0,0,1,981,981,981,981
Inyo,68,2023-04-03,2,2,2,0,139,142,141,1,0,0,0,0,63,63,63,63
Kern,68,2023-04-03,157,157,157,0,5657,5722,5721,1,28,2,2,1,2498,2498,2496,2496
Kings,68,2023-04-03,35,35,35,0,1023,1035,1034,1,5,1,1,0,487,487,486,486
Lake,68,2023-04-03,16,16,16,0,348,354,353,1,0,0,0,0,165,165,165,165
Lassen,68,2023-04-03,3,3,3,0,173,174,173,1,0,0,0,0,65,65,65,65
Los Angeles,68,2023-04-03,2438,2465,2465,0,97936,99027,99026,1,318,41,44,40,35911,35918,35870,35874
Madera,68,2023-04-03,38,38,38,0,867,878,877,1,1,0,0,0,377,377,377,377
Marin,68,2023-04-03,105,105,105,0,1245,1260,1259,1,16,0,0,0,260,260,260,260
Mariposa,68,2023-04-03,6,6,6,0,71,72,71,1,0,0,0,0,31,31,31,31
Mendocino,68,2023-04-03,14,14,14,0,363,368,367,1,3,1,1,1,146,146,145,145
Merced,68,2023-04-03,74,74,74,0,1210,1224,1223,1,6,0,0,0,903,903,903,903
Modoc,68,2023-04-03,4,4,4,0,12,13,12,1,0,0,0,0,11,11,11,11
Mono,68,2023-04-03,2,2,2,0,40,41,40,1,0,0,0,0,8,8,8,8
Monterey,68,2023-04-03,59,59,59,0,1666,1688,1687,1,16,3,3,1,812,812,809,809
Napa,68,2023-04-03,40,40,40,0,804,815,814,1,8,2,2,1,174,174,172,172
Nevada,68,2023-04-03,56,56,56,0,438,445,444,1,4,1,1,0,139,139,138,138
Orange,68,2023-04-03,663,670,670,0,15434,15608,15607,1,93,14,14,14,8120,8120,8106,8106
Placer,68,2023-04-03,103,103,103,0,1881,1904,1903,1,39,0,0,5,683,683,683,683
Plumas,68,2023-04-03,2,2,2,0,57,58,57,1,0,0,0,0,15,15,15,15
Riverside,68,2023-04-03,456,462,462,0,11140,11266,11265,1,61,2,2,8,6862,6862,6860,6860
Sacramento,68,2023-04-03,523,530,530,0,9242,9347,9346,1,70,2,2,16,3583,3583,3581,3581
San Benito,68,2023-04-03,24,24,24,0,554,561,560,1,0,0,0,0,115,115,115,115
San Bernardino,68,2023-04-03,470,477,477,0,11967,12102,12101,1,54,0,0,12,8140,8140,8140,8140
San Diego,68,2023-04-03,772,780,780,0,19838,20061,20060,1,128,6,6,10,5867,5867,5861,5861
San Francisco,68,2023-04-03,334,338,338,0,6982,7059,7058,1,37,4,4,9,1201,1201,1197,1197
San Joaquin,68,2023-04-03,222,222,222,0,5919,5987,5986,1,31,4,4,8,2452,2452,2448,2448
San Luis Obispo,68,2023-04-03,45,45,45,0,969,981,980,1,5,4,4,0,574,574,570,570
San Mateo,68,2023-04-03,256,257,257,0,5683,5747,5746,1,29,0,0,0,747,747,747,747
Santa Barbara,68,2023-04-03,95,95,95,0,2637,2668,2667,1,16,0,0,1,765,765,765,765
Santa Clara,68,2023-04-03,663,671,671,0,16060,16241,16240,1,70,3,3,15,2800,2800,2797,2797
Santa Cruz,68,2023-04-03,127,127,127,0,2472,2501,2500,1,15,0,0,0,276,276,276,276
Shasta,68,2023-04-03,21,21,21,0,515,522,521,1,1,0,0,1,612,612,612,612
Siskiyou,68,2023-04-03,2,2,2,0,93,94,93,1,0,0,0,0,96,96,96,96
Solano,68,2023-04-03,125,125,125,0,2354,2381,2380,1,20,0,0,2,476,476,476,476
Sonoma,68,2023-04-03,137,137,137,0,2087,2111,2110,1,27,2,2,0,565,565,563,563
Stanislaus,68,2023-04-03,117,117,117,0,2676,2706,2705,1,33,0,0,4,1842,1842,1842,1842
Sutter,68,2023-04-03,33,33,33,0,401,408,407,1,0,0,0,0,241,241,241,241
Tehama,68,2023-04-03,10,10,10,0,191,192,191,1,0,0,0,0,237,237,237,237
Trinity,68,2023-04-03,0,0,0,0,11,12,11,1,0,0,0,0,24,24,24,24
Tulare,68,2023-04-03,95,95,95,0,2624,2654,2653,1,19,0,0,1,1595,1595,1595,1595
Tuolumne,68,2023-04-03,6,6,6,0,250,253,252,1,1,0,0,0,211,211,211,211
Ventura,68,2023-04-03,144,144,144,0,3520,3561,3560,1,22,4,4,0,1700,1700,1696,1696
Yolo,68,2023-04-03,53,53,53,0,990,1002,1001,1,3,1,1,0,452,452,451,451
Yuba,68,2023-04-03,23,23,23,0,399,405,404,1,1,0,0,0,134,134,134,134
Alameda,69,2023-04-10,541,548,548,0,11228,11370,11369,1,58,3,3,10,2147,2147,2144,2144
Amador,69,2023-04-10,11,11,11,0,207,209,208,1,1,0,0,0,98,98,98,98
Butte,69,2023-04-10,19,19,19,0,439,446,445,1,4,0,0,0,498,498,498,498
Calaveras,69,2023-04-10,11,11,11,0,188,189,188,1,0,0,0,0,143,143,143,143
Colusa,69,2023-04-10,1,1,1,0,99,101,100,1,1,0,0,0,23,23,23,23
Contra Costa,69,2023-04-10,417,424,424,0,8336,8442,8441,1,42,0,0,2,1584,1584,1584,1584
Del Norte,69,2023-04-10,2,2,2,0,123,124,123,1,0,1,1,0,62,62,61,61
El Dorado,69,2023-04-10,40,40,40,0,667,677,676,1,3,0,0,1,247,247,247,247
Fresno,69,2023-04-10,270,273,273,0,6210,6289,6288,1,63,1,1,3,3021,3021,3020,3020
Glenn,69,2023-04-10,2,2,2,0,131,133,132,1,1,0,0,0,56,56,56,56
Humboldt,69,2023-04-10,16,16,16,0,430,436,435,1,4,0,0,0,171,171,171,171
Imperial,69,2023-04-10,149,149,149,0,1309,1327,1326,1,7,1,1,3,982,982,981,981
Inyo,69,2023-04-10,5,5,5,0,212,216,215,1,0,0,0,0,63,63,63,63
Kern,69,2023-04-10,155,156,156,0,4989,5053,5052,1,28,0,0,2,2498,2498,2498,2498
Kings,69,2023-04-10,44,44,44,0,872,885,884,1,4,0,0,0,487,487,487,487
Lake,69,2023-04-10,14,14,14,0,300,305,304,1,0,0,0,0,165,165,165,165
Lassen,69,2023-04-10,0,0,0,0,116,117,116,1,0,0,0,0,65,65,65,65
Los Angeles,69,2023-04-10,2442,2471,2471,0,88955,90077,90076,1,299,43,50,35,35954,35968,35911,35918
Madera,69,2023-04-10,85,85,85,0,888,900,899,1,0,0,0,0,377,377,377,377
Marin,69,2023-04-10,99,99,99,0,1187,1203,1202,1,12,0,0,2,260,260,260,260
Mariposa,69,2023-04-10,4,4,4,0,64,65,64,1,0,0,0,0,31,31,31,31
Mendocino,69,2023-04-10,14,14,14,0,351,356,355,1,2,0,0,1,146,146,146,146
Merced,69,2023-04-10,53,53,53,0,1492,1512,1511,1,5,0,0,1,903,903,903,903
Modoc,69,2023-04-10,1,1,1,0,6,7,6,1,0,0,0,0,11,11,11,11
Mono,69,2023-04-10,1,1,1,0,45,46,45,1,0,0,0,0,8,8,8,8
Monterey,69,2023-04-10,53,53,53,0,1331,1349,1348,1,12,0,0,1,812,812,812,812
Napa,69,2023-04-10,33,33,33,0,676,685,684,1,5,1,1,0,175,175,174,174
Nevada,69,2023-04-10,43,43,43,0,354,358,357,1,3,0,0,0,139,139,139,139
Orange,69,2023-04-10,519,526,526,0,15261,15453,15452,1,87,11,11,15,8131,8131,8120,8120
Placer,69,2023-04-10,103,103,103,0,1626,1648,1647,1,32,0,0,7,683,683,683,683
Plumas,69,2023-04-10,4,4,4,0,39,40,39,1,0,0,0,0,15,15,15,15
Riverside,69,2023-04-10,402,408,408,0,11128,11270,11269,1,53,1,1,6,6863,6863,6862,6862
Sacramento,69,2023-04-10,451,457,457,0,8134,8237,8236,1,74,5,5,13,3588,3588,3583,3583
San Benito,69,2023-04-10,22,22,22,0,464,471,470,1,2,1,1,0,116,116,115,115
San Bernardino,69,2023-04-10,482,489,489,0,11904,12054,12053,1,71,0,0,11,8140,8140,8140,8140
San Diego,69,2023-04-10,847,858,858,0,20904,21168,21167,1,114,3,3,17,5870,5870,5867,5867
San Francisco,69,2023-04-10,298,301,301,0,6333,6413,6412,1,39,8,8,6,1209,1209,1201,1201
San Joaquin,69,2023-04-10,183,183,183,0,5722,5795,5794,1,22,3,3,10,2455,2455,2452,2452
San Luis Obispo,69,2023-04-10,60,60,60,0,937,950,949,1,3,1,1,1,575,575,574,574
San Mateo,69,2023-04-10,225,226,226,0,5309,5378,5377,1,21,0,0,1,747,747,747,747
Santa Barbara,69,2023-04-10,99,99,99,0,2785,2820,2819,1,16,0,0,3,765,765,765,765
Santa Clara,69,2023-04-10,630,638,638,0,15874,16075,16074,1,95,6,6,14,2806,2806,2800,2800
Santa Cruz,69,2023-04-10,103,103,103,0,1751,1773,1772,1,17,0,0,0,276,276,276,276
Shasta,69,2023-04-10,25,25,25,0,500,507,506,1,3,0,0,1,612,612,612,612
Siskiyou,69,2023-04-10,7,7,7,0,102,103,102,1,0,0,0,0,96,96,96,96
Solano,69,2023-04-10,137,137,137,0,2039,2067,2066,1,20,0,0,2,476,476,476,476
Sonoma,69,2023-04-10,130,130,130,0,1991,2017,2016,1,18,2,2,2,567,567,565,565
Stanislaus,69,2023-04-10,129,129,129,0,2423,2454,2453,1,25,0,0,2,1842,1842,1842,1842
Sutter,69,2023-04-10,30,30,30,0,419,427,426,1,0,0,0,0,241,241,241,241
Tehama,69,2023-04-10,8,8,8,0,173,175,174,1,1,0,0,0,237,237,237,237
Trinity,69,2023-04-10,2,2,2,0,13,14,13,1,0,0,0,0,24,24,24,24
Tulare,69,2023-04-10,92,92,92,0,2391,2421,2420,1,17,0,0,0,1595,1595,1595,1595
Tuolumne,69,2023-04-10,5,5,5,0,203,205,204,1,0,0,0,0,211,211,211,211
Ventura,69,2023-04-10,141,141,141,0,3294,3337,3336,1,22,0,0,0,1700,1700,1700,1700
Yolo,69,2023-04-10,62,62,62,0,950,963,962,1,3,0,0,1,452,452,452,452
Yuba,69,2023-04-10,23,23,23,0,389,397,396,1,3,0,0,0,134,134,134,134
Alameda,70,2023-04-17,572,580,580,0,11553,11719,11718,1,61,3,3,8,2150,2150,2147,2147
Amador,70,2023-04-17,13,13,13,0,209,212,211,1,1,0,0,0,98,98,98,98
Butte,70,2023-04-17,36,36,36,0,458,466,465,1,8,0,0,0,498,498,498,498
Calaveras,70,2023-04-17,8,8,8,0,207,210,209,1,0,0,0,0,143,143,143,143
Colusa,70,2023-04-17,2,2,2,0,44,45,44,1,0,1,1,0,24,24,23,23
Contra Costa,70,2023-04-17,404,410,410,0,7880,7994,7993,1,34,2,2,1,1586,1586,1584,1584
Del Norte,70,2023-04-17,1,1,1,0,108,109,108,1,0,0,0,0,62,62,62,62
El Dorado,70,2023-04-17,43,43,43,0,651,662,661,1,1,0,0,0,247,247,247,247
Fresno,70,2023-04-17,239,243,243,0,6332,6423,6422,1,59,3,3,4,3024,3024,3021,3021
Glenn,70,2023-04-17,7,7,7,0,119,121,120,1,0,0,0,0,56,56,56,56
Humboldt,70,2023-04-17,7,7,7,0,342,348,347,1,1,0,0,0,171,171,171,171
Imperial,70,2023-04-17,176,177,177,0,1208,1226,1225,1,10,0,0,1,982,982,982,982
Inyo,70,2023-04-17,4,4,4,0,121,123,122,1,0,0,0,0,63,63,63,63
Kern,70,2023-04-17,128,128,128,0,4184,4246,4245,1,18,0,0,6,2498,2498,2498,2498
Kings,70,2023-04-17,42,42,42,0,818,831,830,1,1,0,0,0,487,487,487,487
Lake,70,2023-04-17,14,14,14,0,282,288,287,1,1,0,0,0,165,165,165,165
Lassen,70,2023-04-17,3,3,3,0,93,94,93,1,0,0,0,0,65,65,65,65
Los Angeles,70,2023-04-17,2207,2238,2238,0,95414,96780,96779,1,292,39,44,27,35993,36012,35954,35968
Madera,70,2023-04-17,56,56,56,0,867,881,880,1,0,0,0,0,377,377,377,377
Marin,70,2023-04-17,67,67,67,0,968,983,982,1,16,0,0,2,260,260,260,260
Mariposa,70,2023-04-17,2,2,2,0,49,50,49,1,0,0,0,0,31,31,31,31
Mendocino,70,2023-04-17,22,22,22,0,309,315,314,1,2,1,1,2,147,147,146,146
Merced,70,2023-04-17,65,65,65,0,1496,1519,1518,1,8,0,0,0,903,903,903,903
Modoc,70,2023-04-17,1,1,1,0,5,6,5,1,1,0,0,0,11,11,11,11
Mono,70,2023-04-17,1,1,1,0,37,38,37,1,0,0,0,0,8,8,8,8
Monterey,70,2023-04-17,45,45,45,0,1674,1700,1699,1,16,0,0,0,812,812,812,812
Napa,70,2023-04-17,34,34,34,0,730,741,740,1,4,0,0,1,175,175,175,175
Nevada,70,2023-04-17,22,22,22,0,326,332,331,1,4,0,0,0,139,139,139,139
Orange,70,2023-04-17,525,532,532,0,15472,15695,15694,1,91,10,10,9,8141,8141,8131,8131
Placer,70,2023-04-17,95,95,95,0,1529,1552,1551,1,45,1,1,4,684,684,683,683
Plumas,70,2023-04-17,4,4,4,0,52,53,52,1,0,0,0,0,15,15,15,15
Riverside,70,2023-04-17,374,381,381,0,11428,11593,11592,1,55,1,1,4,6864,6864,6863,6863
Sacramento,70,2023-04-17,496,503,503,0,8304,8424,8423,1,73,3,3,10,3591,3591,3588,3588
San Benito,70,2023-04-17,15,15,15,0,490,499,498,1,0,0,0,0,116,116,116,116
San Bernardino,70,2023-04-17,456,464,464,0,11961,12133,12132,1,64,0,0,10,8140,8140,8140,8140
San Diego,70,2023-04-17,837,850,850,0,19891,20176,20175,1,115,2,2,13,5872,5872,5870,5870
San Francisco,70,2023-04-17,308,313,313,0,9625,9763,9762,1,44,2,2,8,1211,1211,1209,1209
San Joaquin,70,2023-04-17,183,185,185,0,8304,8424,8423,1,18,1,1,3,2456,2456,2455,2455
San Luis Obispo,70,2023-04-17,59,59,59,0,887,900,899,1,8,0,0,0,575,575,575,575
San Mateo,70,2023-04-17,192,193,193,0,5617,5698,5697,1,18,0,0,4,747,747,747,747
Santa Barbara,70,2023-04-17,123,123,123,0,2747,2787,2786,1,18,1,1,1,766,766,765,765
Santa Clara,70,2023-04-17,604,612,612,0,22528,22851,22850,1,75,4,4,17,2810,2810,2806,2806
Santa Cruz,70,2023-04-17,93,93,93,0,2325,2360,2359,1,21,0,0,0,276,276,276,276
Shasta,70,2023-04-17,26,26,26,0,495,503,502,1,4,0,0,1,612,612,612,612
Siskiyou,70,2023-04-17,8,8,8,0,80,81,80,1,0,0,0,1,96,96,96,96
Solano,70,2023-04-17,165,165,165,0,2028,2058,2057,1,29,0,0,2,476,476,476,476
Sonoma,70,2023-04-17,163,164,164,0,2218,2251,2250,1,31,1,1,3,568,568,567,567
Stanislaus,70,2023-04-17,116,116,116,0,2911,2954,2953,1,27,0,0,5,1842,1842,1842,1842
Sutter,70,2023-04-17,17,17,17,0,277,282,281,1,0,0,0,0,241,241,241,241
Tehama,70,2023-04-17,13,13,13,0,164,167,166,1,3,0,0,0,237,237,237,237
Trinity,70,2023-04-17,1,1,1,0,15,16,15,1,0,0,0,0,24,24,24,24
Tulare,70,2023-04-17,99,99,99,0,2293,2325,2324,1,14,1,1,1,1596,1596,1595,1595
Tuolumne,70,2023-04-17,6,6,6,0,225,230,229,1,0,0,0,0,211,211,211,211
Ventura,70,2023-04-17,119,119,119,0,3343,3392,3391,1,18,2,2,1,1702,1702,1700,1700
Yolo,70,2023-04-17,51,51,51,0,820,832,831,1,3,1,1,0,453,453,452,452
Yuba,70,2023-04-17,15,15,15,0,282,289,288,1,4,0,0,0,134,134,134,134
Alameda,71,2023-04-24,557,565,565,0,10591,10767,10766,1,67,3,3,5,2153,2153,2150,2150
Amador,71,2023-04-24,15,15,15,0,194,198,197,1,0,1,1,0,99,99,98,98
Butte,71,2023-04-24,29,29,29,0,495,505,504,1,11,1,1,1,499,499,498,498
Calaveras,71,2023-04-24,7,7,7,0,199,203,202,1,0,0,0,0,143,143,143,143
Colusa,71,2023-04-24,0,0,0,0,40,41,40,1,0,0,0,0,24,24,24,24
Contra Costa,71,2023-04-24,351,357,357,0,7478,7603,7602,1,37,5,6,4,1591,1592,1586,1586
Del Norte,71,2023-04-24,5,5,5,0,109,111,110,1,0,0,0,0,62,62,62,62
El Dorado,71,2023-04-24,39,39,39,0,626,638,637,1,5,0,0,1,247,247,247,247
Fresno,71,2023-04-24,240,244,244,0,6075,6177,6176,1,63,3,3,7,3027,3027,3024,3024
Glenn,71,2023-04-24,3,3,3,0,103,105,104,1,0,0,0,0,56,56,56,56
Humboldt,71,2023-04-24,9,9,9,0,277,284,283,1,0,0,0,0,171,171,171,171
Imperial,71,2023-04-24,119,119,119,0,1090,1109,1108,1,7,1,1,0,983,983,982,982
Inyo,71,2023-04-24,5,5,5,0,154,157,156,1,0,0,0,0,63,63,63,63
Kern,71,2023-04-24,84,84,84,0,3767,3830,3829,1,16,1,1,4,2499,2499,2498,2498
Kings,71,2023-04-24,32,32,32,0,780,793,792,1,1,0,0,0,487,487,487,487
Lake,71,2023-04-24,14,14,14,0,347,354,353,1,0,0,0,1,165,165,165,165
Lassen,71,2023-04-24,0,0,0,0,112,113,112,1,0,0,0,0,65,65,65,65
Los Angeles,71,2023-04-24,1925,1955,1955,0,93267,94809,94808,1,224,32,37,27,36025,36049,35993,36012
Madera,71,2023-04-24,33,33,33,0,800,815,814,1,2,0,0,0,377,377,377,377
Marin,71,2023-04-24,65,65,65,0,961,978,977,1,11,0,0,1,260,260,260,260
Mariposa,71,2023-04-24,5,5,5,0,53,54,53,1,0,0,0,0,31,31,31,31
Mendocino,71,2023-04-24,9,9,9,0,267,273,272,1,3,0,0,0,147,147,147,147
Merced,71,2023-04-24,50,50,50,0,1249,1271,1270,1,7,0,0,0,903,903,903,903
Modoc,71,2023-04-24,4,4,4,0,10,11,10,1,0,0,0,0,11,11,11,11
Mono,71,2023-04-24,2,2,2,0,44,45,44,1,0,0,0,0,8,8,8,8
Monterey,71,2023-04-24,64,64,64,0,1708,1737,1736,1,14,1,1,2,813,813,812,812
Napa,71,2023-04-24,25,25,25,0,712,724,723,1,4,0,0,1,175,175,175,175
Nevada,71,2023-04-24,37,37,37,0,291,297,296,1,1,0,0,1,139,139,139,139
Orange,71,2023-04-24,504,511,511,0,14197,14432,14431,1,88,13,15,11,8154,8156,8141,8141
Placer,71,2023-04-24,105,105,105,0,1460,1485,1484,1,33,1,1,2,685,685,684,684
Plumas,71,2023-04-24,4,4,4,0,77,78,77,1,1,0,0,0,15,15,15,15
Riverside,71,2023-04-24,322,328,328,0,11489,11680,11679,1,49,2,2,5,6866,6866,6864,6864
Sacramento,71,2023-04-24,494,502,502,0,8237,8375,8374,1,64,3,3,10,3594,3594,3591,3591
San Benito,71,2023-04-24,11,11,11,0,391,399,398,1,1,0,0,0,116,116,116,116
San Bernardino,71,2023-04-24,383,390,390,0,10827,11006,11005,1,132,0,0,15,8140,8140,8140,8140
San Diego,71,2023-04-24,704,716,716,0,18880,19194,19193,1,95,5,5,10,5877,5877,5872,5872
San Francisco,71,2023-04-24,337,343,343,0,8602,8745,8744,1,63,2,2,6,1213,1213,1211,1211
San Joaquin,71,2023-04-24,159,160,160,0,8593,8737,8736,1,18,0,0,1,2456,2456,2456,2456
San Luis Obispo,71,2023-04-24,41,41,41,0,820,834,833,1,10,1,1,0,576,576,575,575
San Mateo,71,2023-04-24,197,199,199,0,5055,5140,5139,1,19,0,0,1,747,747,747,747
Santa Barbara,71,2023-04-24,93,93,93,0,2842,2890,2889,1,11,1,1,2,767,767,766,766
Santa Clara,71,2023-04-24,575,584,584,0,19982,20314,20313,1,82,4,4,17,2814,2814,2810,2810
Santa Cruz,71,2023-04-24,59,59,59,0,1763,1794,1793,1,24,0,0,1,276,276,276,276
Shasta,71,2023-04-24,18,18,18,0,420,428,427,1,2,0,0,0,612,612,612,612
Siskiyou,71,2023-04-24,7,7,7,0,93,94,93,1,3,0,0,0,96,96,96,96
Solano,71,2023-04-24,139,139,139,0,2093,2129,2128,1,18,0,0,6,476,476,476,476
Sonoma,71,2023-04-24,156,156,156,0,2047,2082,2081,1,29,1,1,2,569,569,568,568
Stanislaus,71,2023-04-24,107,107,107,0,2776,2822,2821,1,22,0,0,2,1842,1842,1842,1842
Sutter,71,2023-04-24,25,25,25,0,292,298,297,1,0,0,0,0,241,241,241,241
Tehama,71,2023-04-24,6,6,6,0,160,162,161,1,0,0,0,0,237,237,237,237
Trinity,71,2023-04-24,1,1,1,0,13,14,13,1,0,0,0,0,24,24,24,24
Tulare,71,2023-04-24,77,77,77,0,2219,2258,2257,1,17,2,2,0,1598,1598,1596,1596
Tuolumne,71,2023-04-24,5,5,5,0,177,179,178,1,0,0,0,0,211,211,211,211
Ventura,71,2023-04-24,142,143,143,0,3140,3194,3193,1,18,0,0,2,1702,1702,1702,1702
Yolo,71,2023-04-24,37,37,37,0,877,892,891,1,1,1,1,0,454,454,453,453
Yuba,71,2023-04-24,16,16,16,0,273,278,277,1,5,0,0,0,134,134,134,134
Alameda,72,2023-05-01,453,462,462,0,9520,9708,9707,1,60,1,1,5,2154,2154,2153,2153
Amador,72,2023-05-01,7,7,7,0,161,165,164,1,2,0,0,0,99,99,99,99
Butte,72,2023-05-01,26,26,26,0,395,405,404,1,18,0,0,0,499,499,499,499
Calaveras,72,2023-05-01,1,1,1,0,177,181,180,1,0,0,0,1,143,143,143,143
Colusa,72,2023-05-01,4,4,4,0,48,49,48,1,0,0,0,0,24,24,24,24
Contra Costa,72,2023-05-01,346,353,353,0,7070,7210,7209,1,34,4,4,5,1595,1596,1591,1592
Del Norte,72,2023-05-01,1,1,1,0,85,86,85,1,0,0,0,0,62,62,62,62
El Dorado,72,2023-05-01,39,39,39,0,618,632,631,1,3,0,0,1,247,247,247,247
Fresno,72,2023-05-01,261,268,268,0,5947,6066,6065,1,62,3,3,6,3030,3030,3027,3027
Glenn,72,2023-05-01,6,6,6,0,115,118,117,1,1,0,0,0,56,56,56,56
Humboldt,72,2023-05-01,13,13,13,0,242,249,248,1,0,0,0,0,171,171,171,171
Imperial,72,2023-05-01,100,100,100,0,1151,1174,1173,1,12,0,0,0,983,983,983,983
Inyo,72,2023-05-01,11,11,11,0,165,168,167,1,1,0,0,0,63,63,63,63
Kern,72,2023-05-01,85,85,85,0,3961,4040,4039,1,10,1,1,3,2500,2500,2499,2499
Kings,72,2023-05-01,28,28,28,0,664,679,678,1,0,0,0,0,487,487,487,487
Lake,72,2023-05-01,8,8,8,0,287,294,293,1,1,0,0,0,165,165,165,165
Lassen,72,2023-05-01,3,3,3,0,96,97,96,1,0,0,0,0,65,65,65,65
Los Angeles,72,2023-05-01,1919,1957,1957,0,90921,92715,92714,1,249,36,45,28,36061,36094,36025,36049
Madera,72,2023-05-01,49,49,49,0,787,804,803,1,2,0,0,0,377,377,377,377
Marin,72,2023-05-01,68,68,68,0,866,884,883,1,9,0,0,1,260,260,260,260
Mariposa,72,2023-05-01,0,0,0,0,68,69,68,1,0,0,0,0,31,31,31,31
Mendocino,72,2023-05-01,10,10,10,0,227,232,231,1,1,0,0,0,147,147,147,147
Merced,72,2023-05-01,44,44,44,0,837,854,853,1,2,0,0,1,903,903,903,903
Modoc,72,2023-05-01,3,3,3,0,6,7,6,1,0,0,0,0,11,11,11,11
Mono,72,2023-05-01,1,1,1,0,30,31,30,1,0,0,0,0,8,8,8,8
Monterey,72,2023-05-01,56,56,56,0,1565,1598,1597,1,18,0,0,1,813,813,813,813
Napa,72,2023-05-01,31,31,31,0,663,678,677,1,1,1,1,0,176,176,175,175
Nevada,72,2023-05-01,27,27,27,0,244,251,250,1,6,0,0,0,139,139,139,139
Orange,72,2023-05-01,428,436,436,0,14322,14607,14606,1,60,8,9,12,8162,8165,8154,8156
Placer,72,2023-05-01,96,96,96,0,1455,1485,1484,1,45,0,0,0,685,685,685,685
Plumas,72,2023-05-01,5,5,5,0,45,46,45,1,0,0,0,0,15,15,15,15
Riverside,72,2023-05-01,290,297,297,0,10620,10830,10829,1,47,1,1,8,6867,6867,6866,6866
Sacramento,72,2023-05-01,509,519,519,0,7476,7625,7624,1,73,5,6,5,3599,3600,3594,3594
San Benito,72,2023-05-01,12,12,12,0,359,368,367,1,0,0,0,0,116,116,116,116
San Bernardino,72,2023-05-01,361,369,369,0,11286,11511,11510,1,54,0,0,12,8140,8140,8140,8140
San Diego,72,2023-05-01,576,587,587,0,17794,18146,18145,1,90,0,0,7,5877,5877,5877,5877
San Francisco,72,2023-05-01,255,261,261,0,7461,7608,7607,1,38,6,7,4,1219,1220,1213,1213
San Joaquin,72,2023-05-01,151,154,154,0,7670,7823,7822,1,15,1,1,2,2457,2457,2456,2456
San Luis Obispo,72,2023-05-01,38,38,38,0,777,793,792,1,3,2,2,0,578,578,576,576
San Mateo,72,2023-05-01,200,204,204,0,4737,4831,4830,1,15,0,0,2,747,747,747,747
Santa Barbara,72,2023-05-01,75,75,75,0,2301,2347,2346,1,16,1,1,1,768,768,767,767
Santa Clara,72,2023-05-01,576,587,587,0,16824,17155,17154,1,95,1,1,15,2815,2815,2814,2814
Santa Cruz,72,2023-05-01,53,53,53,0,1586,1618,1617,1,14,0,0,1,276,276,276,276
Shasta,72,2023-05-01,7,7,7,0,404,413,412,1,3,0,0,1,612,612,612,612
Siskiyou,72,2023-05-01,9,9,9,0,111,112,111,1,3,1,1,0,97,97,96,96
Solano,72,2023-05-01,85,85,85,0,1777,1812,1811,1,19,0,0,4,476,476,476,476
Sonoma,72,2023-05-01,103,103,103,0,1905,1944,1943,1,12,2,2,1,571,571,569,569
Stanislaus,72,2023-05-01,91,91,91,0,2278,2324,2323,1,24,0,0,4,1842,1842,1842,1842
Sutter,72,2023-05-01,15,15,15,0,222,227,226,1,0,0,0,0,241,241,241,241
Tehama,72,2023-05-01,10,10,10,0,149,152,151,1,0,0,0,0,237,237,237,237
Trinity,72,2023-05-01,2,2,2,0,10,11,10,1,0,0,0,0,24,24,24,24
Tulare,72,2023-05-01,69,69,69,0,1896,1934,1933,1,9,0,0,0,1598,1598,1598,1598
Tuolumne,72,2023-05-01,14,14,14,0,195,200,199,1,1,0,0,0,211,211,211,211
Ventura,72,2023-05-01,110,110,110,0,2819,2876,2875,1,15,0,0,1,1702,1702,1702,1702
Yolo,72,2023-05-01,44,44,44,0,869,887,886,1,3,0,0,1,454,454,454,454
Yuba,72,2023-05-01,19,19,19,0,257,263,262,1,3,0,0,0,134,134,134,134
Alameda,73,2023-05-08,435,445,445,0,8786,9009,9008,1,53,0,0,6,2154,2154,2154,2154
Amador,73,2023-05-08,7,7,7,0,156,161,160,1,1,0,0,0,99,99,99,99
Butte,73,2023-05-08,28,28,28,0,501,515,514,1,9,0,0,0,499,499,499,499
Calaveras,73,2023-05-08,7,7,7,0,172,178,177,1,1,0,0,0,143,143,143,143
Colusa,73,2023-05-08,2,2,2,0,37,38,37,1,1,0,0,0,24,24,24,24
Contra Costa,73,2023-05-08,237,244,244,0,6100,6254,6253,1,39,3,4,11,1598,1600,1595,1596
Del Norte,73,2023-05-08,6,6,6,0,87,88,87,1,1,0,0,0,62,62,62,62
El Dorado,73,2023-05-08,30,30,30,0,519,534,533,1,0,0,0,0,247,247,247,247
Fresno,73,2023-05-08,205,212,212,0,5255,5388,5387,1,61,2,2,7,3032,3032,3030,3030
Glenn,73,2023-05-08,5,5,5,0,122,125,124,1,1,0,0,0,56,56,56,56
Humboldt,73,2023-05-08,12,12,12,0,240,248,247,1,0,0,0,0,171,171,171,171
Imperial,73,2023-05-08,87,88,88,0,1033,1060,1059,1,8,1,2,1,984,985,983,983
Inyo,73,2023-05-08,3,3,3,0,150,154,153,1,0,0,0,0,63,63,63,63
Kern,73,2023-05-08,91,92,92,0,3604,3695,3694,1,8,1,1,3,2501,2501,2500,2500
Kings,73,2023-05-08,33,33,33,0,667,684,683,1,0,0,0,1,487,487,487,487
Lake,73,2023-05-08,10,10,10,0,266,273,272,1,1,0,0,0,165,165,165,165
Lassen,73,2023-05-08,7,7,7,0,89,90,89,1,0,0,0,0,65,65,65,65
Los Angeles,73,2023-05-08,1844,1890,1890,0,77026,78956,78955,1,225,29,43,25,36090,36137,36061,36094
Madera,73,2023-05-08,30,30,30,0,674,693,692,1,0,0,0,0,377,377,377,377
Marin,73,2023-05-08,53,53,53,0,783,804,803,1,12,0,0,2,260,260,260,260
Mariposa,73,2023-05-08,0,0,0,0,54,55,54,1,0,0,0,0,31,31,31,31
Mendocino,73,2023-05-08,7,7,7,0,249,256,255,1,0,0,0,0,147,147,147,147
Merced,73,2023-05-08,38,38,38,0,1093,1122,1121,1,4,0,0,0,903,903,903,903
Modoc,73,2023-05-08,10,10,10,0,11,12,11,1,0,0,0,0,11,11,11,11
Mono,73,2023-05-08,0,0,0,0,42,43,42,1,0,0,0,0,8,8,8,8
Monterey,73,2023-05-08,47,47,47,0,1599,1640,1639,1,15,1,1,0,814,814,813,813
Napa,73,2023-05-08,46,46,46,0,618,634,633,1,0,0,0,0,176,176,176,176
Nevada,73,2023-05-08,21,21,21,0,238,245,244,1,4,0,0,0,139,139,139,139
Orange,73,2023-05-08,463,475,475,0,13516,13856,13855,1,71,9,12,10,8171,8177,8162,8165
Placer,73,2023-05-08,116,119,119,0,1341,1376,1375,1,29,0,0,2,685,685,685,685
Plumas,73,2023-05-08,6,6,6,0,48,49,48,1,0,0,0,0,15,15,15,15
Riverside,73,2023-05-08,279,287,287,0,10318,10575,10574,1,37,0,0,4,6867,6867,6867,6867
Sacramento,73,2023-05-08,349,357,357,0,6790,6963,6962,1,56,1,1,9,3600,3601,3599,3600
San Benito,73,2023-05-08,10,10,10,0,323,332,331,1,1,0,0,0,116,116,116,116
San Bernardino,73,2023-05-08,270,278,278,0,10068,10321,10320,1,49,0,0,10,8140,8140,8140,8140
San Diego,73,2023-05-08,538,553,553,0,17311,17746,17745,1,88,3,4,12,5880,5881,5877,5877
San Francisco,73,2023-05-08,227,234,234,0,6068,6221,6220,1,42,2,2,5,1221,1222,1219,1220
San Joaquin,73,2023-05-08,179,185,185,0,7605,7799,7798,1,14,0,0,2,2457,2457,2457,2457
San Luis Obispo,73,2023-05-08,45,45,45,0,796,818,817,1,8,0,0,0,578,578,578,578
San Mateo,73,2023-05-08,201,207,207,0,4187,4294,4293,1,21,0,0,2,747,747,747,747
Santa Barbara,73,2023-05-08,79,79,79,0,1697,1739,1738,1,10,1,2,1,769,770,768,768
Santa Clara,73,2023-05-08,484,496,496,0,13630,13975,13974,1,94,1,1,11,2816,2816,2815,2815
Santa Cruz,73,2023-05-08,68,68,68,0,1486,1525,1524,1,10,0,0,0,276,276,276,276
Shasta,73,2023-05-08,17,17,17,0,386,398,397,1,4,0,0,1,612,612,612,612
Siskiyou,73,2023-05-08,8,8,8,0,109,112,111,1,1,0,0,0,97,97,97,97
Solano,73,2023-05-08,83,84,84,0,1549,1589,1588,1,11,0,0,2,476,476,476,476
Sonoma,73,2023-05-08,85,85,85,0,1662,1705,1704,1,15,0,0,1,571,571,571,571
Stanislaus,73,2023-05-08,77,77,77,0,2609,2677,2676,1,25,0,0,2,1842,1842,1842,1842
Sutter,73,2023-05-08,12,12,12,0,284,292,291,1,0,0,0,0,241,241,241,241
Tehama,73,2023-05-08,14,14,14,0,145,148,147,1,2,0,0,0,237,237,237,237
Trinity,73,2023-05-08,0,0,0,0,7,8,7,1,0,0,0,0,24,24,24,24
Tulare,73,2023-05-08,56,56,56,0,1747,1792,1791,1,10,1,1,0,1599,1599,1598,1598
Tuolumne,73,2023-05-08,11,11,11,0,221,227,226,1,0,0,0,0,211,211,211,211
Ventura,73,2023-05-08,101,103,103,0,2594,2660,2659,1,10,1,1,0,1703,1703,1702,1702
Yolo,73,2023-05-08,32,32,32,0,649,667,666,1,3,0,0,0,454,454,454,454
Yuba,73,2023-05-08,14,14,14,0,249,256,255,1,2,0,0,1,134,134,134,134
Alameda,74,2023-05-12,288,297,297,0,5319,5490,5489,1,44,1,2,7,2155,2156,2154,2154
Amador,74,2023-05-12,1,1,1,0,89,94,93,1,0,0,0,0,99,99,99,99
Butte,74,2023-05-12,47,49,49,0,389,401,400,1,14,0,0,0,499,499,499,499
Calaveras,74,2023-05-12,4,4,4,0,95,100,99,1,1,0,0,0,143,143,143,143
Colusa,74,2023-05-12,3,3,3,0,30,31,30,1,1,0,0,0,24,24,24,24
Contra Costa,74,2023-05-12,180,186,186,0,3765,3886,3885,1,34,1,2,4,1599,1602,1598,1600
Del Norte,74,2023-05-12,2,2,2,0,59,62,61,1,0,0,0,0,62,62,62,62
El Dorado,74,2023-05-12,22,22,22,0,365,376,375,1,0,0,0,1,247,247,247,247
Fresno,74,2023-05-12,102,106,106,0,3162,3265,3264,1,49,0,0,6,3032,3032,3032,3032
Glenn,74,2023-05-12,2,2,2,0,31,32,31,1,1,0,0,0,56,56,56,56
Humboldt,74,2023-05-12,8,8,8,0,191,197,196,1,1,0,0,0,171,171,171,171
Imperial,74,2023-05-12,46,47,47,0,694,718,717,1,10,0,0,1,984,985,984,985
Inyo,74,2023-05-12,5,5,5,0,103,107,106,1,0,0,0,0,63,63,63,63
Kern,74,2023-05-12,88,90,90,0,2464,2545,2544,1,7,0,0,5,2501,2501,2501,2501
Kings,74,2023-05-12,23,23,23,0,368,380,379,1,2,0,0,0,487,487,487,487
Lake,74,2023-05-12,11,11,11,0,185,193,192,1,1,0,0,0,165,165,165,165
Lassen,74,2023-05-12,4,4,4,0,70,74,73,1,0,0,0,0,65,65,65,65
Los Angeles,74,2023-05-12,1176,1214,1214,0,52880,54565,54564,1,222,12,22,31,36102,36159,36090,36137
Madera,74,2023-05-12,18,18,18,0,437,452,451,1,2,0,0,0,377,377,377,377
Marin,74,2023-05-12,44,44,44,0,495,512,511,1,7,0,0,0,260,260,260,260
Mariposa,74,2023-05-12,0,0,0,0,21,22,21,1,0,0,0,0,31,31,31,31
Mendocino,74,2023-05-12,1,1,1,0,147,153,152,1,2,0,0,1,147,147,147,147
Merced,74,2023-05-12,32,32,32,0,919,950,949,1,3,0,0,0,903,903,903,903
Modoc,74,2023-05-12,3,3,3,0,4,5,4,1,0,0,0,0,11,11,11,11
Mono,74,2023-05-12,0,0,0,0,24,25,24,1,0,0,0,0,8,8,8,8
Monterey,74,2023-05-12,23,23,23,0,888,917,916,1,12,0,0,1,814,814,814,814
Napa,74,2023-05-12,22,22,22,0,471,487,486,1,3,0,0,0,176,176,176,176
Nevada,74,2023-05-12,10,10,10,0,154,159,158,1,5,0,0,1,139,139,139,139
Orange,74,2023-05-12,272,280,280,0,8117,8377,8376,1,56,2,4,11,8173,8181,8171,8177
Placer,74,2023-05-12,46,47,47,0,785,811,810,1,35,0,0,3,685,685,685,685
Plumas,74,2023-05-12,2,2,2,0,19,20,19,1,0,0,0,0,15,15,15,15
Riverside,74,2023-05-12,194,200,200,0,6522,6733,6732,1,33,0,0,9,6867,6867,6867,6867
Sacramento,74,2023-05-12,267,275,275,0,4225,4362,4361,1,65,0,0,5,3600,3601,3600,3601
San Benito,74,2023-05-12,8,8,8,0,206,213,212,1,1,0,0,0,116,116,116,116
San Bernardino,74,2023-05-12,195,201,201,0,7071,7300,7299,1,49,0,0,13,8140,8140,8140,8140
San Diego,74,2023-05-12,348,360,360,0,11336,11700,11699,1,79,0,0,16,5880,5881,5880,5881
San Francisco,74,2023-05-12,109,113,113,0,4509,4655,4654,1,30,1,2,6,1222,1224,1221,1222
San Joaquin,74,2023-05-12,115,119,119,0,5151,5319,5318,1,12,0,0,1,2457,2457,2457,2457
San Luis Obispo,74,2023-05-12,23,23,23,0,491,508,507,1,5,0,0,0,578,578,578,578
San Mateo,74,2023-05-12,107,111,111,0,2454,2533,2532,1,20,0,0,0,747,747,747,747
Santa Barbara,74,2023-05-12,45,45,45,0,789,816,815,1,8,0,0,1,769,770,769,770
Santa Clara,74,2023-05-12,314,324,324,0,11085,11443,11442,1,87,2,4,16,2818,2820,2816,2816
Santa Cruz,74,2023-05-12,29,29,29,0,843,871,870,1,14,0,0,0,276,276,276,276
Shasta,74,2023-05-12,10,10,10,0,286,296,295,1,2,0,0,1,612,612,612,612
Siskiyou,74,2023-05-12,7,7,7,0,42,43,42,1,1,0,0,0,97,97,97,97
Solano,74,2023-05-12,48,48,48,0,936,967,966,1,16,0,0,3,476,476,476,476
Sonoma,74,2023-05-12,66,69,69,0,1064,1100,1099,1,17,0,0,2,571,571,571,571
Stanislaus,74,2023-05-12,73,76,76,0,1722,1779,1778,1,24,0,0,2,1842,1842,1842,1842
Sutter,74,2023-05-12,17,17,17,0,188,195,194,1,0,0,0,0,241,241,241,241
Tehama,74,2023-05-12,8,8,8,0,86,91,90,1,1,0,0,0,237,237,237,237
Trinity,74,2023-05-12,1,1,1,0,6,7,6,1,0,0,0,0,24,24,24,24
Tulare,74,2023-05-12,21,21,21,0,874,903,902,1,7,0,0,0,1599,1599,1599,1599
Tuolumne,74,2023-05-12,3,3,3,0,107,112,111,1,3,0,0,0,211,211,211,211
Ventura,74,2023-05-12,66,67,67,0,1643,1697,1696,1,9,0,0,1,1703,1703,1703,1703
Yolo,74,2023-05-12,24,24,24,0,370,383,382,1,3,0,0,0,454,454,454,454
Yuba,74,2023-05-12,13,13,13,0,140,145,144,1,1,0,0,2,134,134,134,134
Alameda,75,2023-05-19,58,62,62,0,923,982,981,1,149,0,0,18,2156,2159,2156,2159
Amador,75,2023-05-19,1,1,1,0,22,24,23,1,0,0,0,0,99,99,99,99
Butte,75,2023-05-19,2,2,2,0,28,31,30,1,24,0,0,0,499,499,499,499
Calaveras,75,2023-05-19,0,0,0,0,11,13,12,1,0,0,0,0,143,143,143,143
Colusa,75,2023-05-19,0,0,0,0,3,4,3,1,0,0,0,0,24,24,24,24
Contra Costa,75,2023-05-19,35,37,37,0,739,787,786,1,49,0,0,10,1599,1602,1599,1602
Del Norte,75,2023-05-19,1,1,1,0,12,14,13,1,0,0,0,0,62,62,62,62
El Dorado,75,2023-05-19,3,3,3,0,37,40,39,1,4,0,0,0,247,247,247,247
Fresno,75,2023-05-19,28,30,30,0,558,594,593,1,153,0,0,14,3032,3032,3032,3032
Glenn,75,2023-05-19,1,1,1,0,8,10,9,1,0,0,0,0,56,56,56,56
Humboldt,75,2023-05-19,0,0,0,0,44,48,47,1,1,0,0,1,171,171,171,171
Imperial,75,2023-05-19,7,7,7,0,104,112,111,1,25,0,0,4,984,985,984,985
Inyo,75,2023-05-19,0,0,0,0,15,17,16,1,0,0,0,0,63,63,63,63
Kern,75,2023-05-19,4,4,4,0,230,246,245,1,22,0,0,2,2501,2501,2501,2501
Kings,75,2023-05-19,2,2,2,0,50,54,53,1,5,0,0,0,487,487,487,487
Lake,75,2023-05-19,0,0,0,0,36,39,38,1,2,0,0,2,165,165,165,165
Lassen,75,2023-05-19,1,1,1,0,16,18,17,1,2,0,0,0,65,65,65,65
Los Angeles,75,2023-05-19,178,189,189,0,5047,5367,5366,1,564,0,0,58,36116,36196,36116,36196
Madera,75,2023-05-19,2,2,2,0,67,72,71,1,1,0,0,0,377,377,377,377
Marin,75,2023-05-19,15,16,16,0,114,122,121,1,30,0,0,2,260,260,260,260
Mariposa,75,2023-05-19,0,0,0,0,7,8,7,1,0,0,0,0,31,31,31,31
Mendocino,75,2023-05-19,2,2,2,0,32,35,34,1,4,0,0,0,147,147,147,147
Merced,75,2023-05-19,1,1,1,0,129,138,137,1,18,0,0,1,903,903,903,903
Modoc,75,2023-05-19,0,0,0,0,0,1,0,1,0,0,0,0,11,11,11,11
Mono,75,2023-05-19,0,0,0,0,7,8,7,1,0,0,0,0,8,8,8,8
Monterey,75,2023-05-19,0,0,0,0,169,181,180,1,42,0,0,3,816,819,816,819
Napa,75,2023-05-19,1,1,1,0,47,51,50,1,1,0,0,0,176,176,176,176
Nevada,75,2023-05-19,0,0,0,0,18,20,19,1,19,0,0,0,139,139,139,139
Orange,75,2023-05-19,52,55,55,0,1255,1335,1334,1,146,1,4,9,8177,8192,8176,8188
Placer,75,2023-05-19,14,15,15,0,153,164,163,1,117,0,0,10,685,685,685,685
Plumas,75,2023-05-19,0,0,0,0,3,4,3,1,2,0,0,0,15,15,15,15
Riverside,75,2023-05-19,29,31,31,0,788,839,838,1,113,0,0,14,6867,6867,6867,6867
Sacramento,75,2023-05-19,46,49,49,0,701,746,745,1,175,0,0,15,3601,3604,3601,3604
San Benito,75,2023-05-19,0,0,0,0,35,38,37,1,1,0,0,0,116,116,116,116
San Bernardino,75,2023-05-19,27,29,29,0,924,983,982,1,129,0,0,22,8140,8140,8140,8140
San Diego,75,2023-05-19,70,74,74,0,1713,1822,1821,1,174,0,0,11,5882,5887,5882,5887
San Francisco,75,2023-05-19,24,26,26,0,768,817,816,1,99,0,0,4,1223,1227,1223,1227
San Joaquin,75,2023-05-19,17,18,18,0,1149,1223,1222,1,37,0,0,0,2457,2457,2457,2457
San Luis Obispo,75,2023-05-19,5,5,5,0,96,103,102,1,17,0,0,0,579,582,579,582
San Mateo,75,2023-05-19,23,24,24,0,342,365,364,1,58,0,0,9,747,747,747,747
Santa Barbara,75,2023-05-19,16,17,17,0,158,169,168,1,18,0,0,0,769,770,769,770
Santa Clara,75,2023-05-19,78,83,83,0,1831,1948,1947,1,269,0,0,33,2819,2823,2819,2823
Santa Cruz,75,2023-05-19,5,5,5,0,158,169,168,1,18,0,0,0,276,276,276,276
Shasta,75,2023-05-19,1,1,1,0,25,28,27,1,11,0,0,5,612,612,612,612
Siskiyou,75,2023-05-19,0,0,0,0,7,8,7,1,0,0,0,0,97,97,97,97
Solano,75,2023-05-19,9,10,10,0,209,223,222,1,36,0,0,10,476,476,476,476
Sonoma,75,2023-05-19,13,14,14,0,177,189,188,1,31,0,0,5,573,578,573,578
Stanislaus,75,2023-05-19,16,17,17,0,308,328,327,1,76,0,0,4,1842,1842,1842,1842
Sutter,75,2023-05-19,6,6,6,0,41,45,44,1,0,0,0,0,241,241,241,241
Tehama,75,2023-05-19,2,2,2,0,7,8,7,1,9,0,0,0,237,237,237,237
Trinity,75,2023-05-19,0,0,0,0,2,3,2,1,0,0,0,0,24,24,24,24
Tulare,75,2023-05-19,5,5,5,0,55,59,58,1,18,0,0,0,1599,1599,1599,1599
Tuolumne,75,2023-05-19,1,1,1,0,24,27,26,1,0,0,0,0,211,211,211,211
Ventura,75,2023-05-19,17,18,18,0,340,362,361,1,30,0,0,4,1703,1703,1703,1703
Yolo,75,2023-05-19,1,1,1,0,68,73,72,1,4,0,0,0,454,454,454,454
Yuba,75,2023-05-19,3,3,3,0,23,25,24,1,10,0,0,3,134,134,134,134
Alameda,76,2023-05-25,51,64,64,0,927,1156,1155,1,330,0,0,39,2156,2159,2156,2159
Amador,76,2023-05-25,1,1,1,0,12,16,15,1,0,0,0,0,99,99,99,99
Butte,76,2023-05-25,2,2,2,0,45,57,56,1,55,0,0,0,499,499,499,499
Calaveras,76,2023-05-25,0,0,0,0,23,30,29,1,4,0,0,0,143,143,143,143
Colusa,76,2023-05-25,0,0,0,0,2,3,2,1,2,0,0,0,24,24,24,24
Contra Costa,76,2023-05-25,27,34,34,0,604,754,753,1,146,0,0,14,1599,1602,1599,1602
Del Norte,76,2023-05-25,0,0,0,0,9,12,11,1,4,0,0,4,62,62,62,62
El Dorado,76,2023-05-25,2,2,2,0,39,50,49,1,6,0,0,2,247,247,247,247
Fresno,76,2023-05-25,17,21,21,0,354,442,441,1,231,0,0,22,3032,3032,3032,3032
Glenn,76,2023-05-25,0,0,0,0,5,7,6,1,0,0,0,0,56,56,56,56
Humboldt,76,2023-05-25,1,1,1,0,24,31,30,1,13,0,0,1,171,171,171,171
Imperial,76,2023-05-25,2,2,2,0,126,158,157,1,21,0,0,5,984,985,984,985
Inyo,76,2023-05-25,0,0,0,0,3,5,4,1,0,0,0,0,63,63,63,63
Kern,76,2023-05-25,6,7,7,0,414,517,516,1,44,0,0,0,2501,2501,2501,2501
Kings,76,2023-05-25,4,5,5,0,63,80,79,1,6,0,0,0,487,487,487,487
Lake,76,2023-05-25,2,2,2,0,36,46,45,1,8,0,0,0,166,171,166,171
Lassen,76,2023-05-25,0,0,0,0,11,15,14,1,3,0,0,0,65,65,65,65
Los Angeles,76,2023-05-25,133,166,166,0,308,385,384,1,1197,0,0,126,36128,36295,36128,36295
Madera,76,2023-05-25,2,2,2,0,55,70,69,1,3,0,0,0,377,377,377,377
Marin,76,2023-05-25,6,7,7,0,96,121,120,1,51,0,0,11,260,260,260,260
Mendocino,76,2023-05-25,1,1,1,0,21,27,26,1,9,0,0,0,147,147,147,147
Merced,76,2023-05-25,0,0,0,0,110,138,137,1,42,0,0,0,903,903,903,903
Modoc,76,2023-05-25,0,0,0,0,0,1,0,1,0,0,0,0,11,11,11,11
Mono,76,2023-05-25,0,0,0,0,3,5,4,1,0,0,0,0,8,8,8,8
Monterey,76,2023-05-25,6,7,7,0,191,239,238,1,74,0,0,6,816,819,816,819
Napa,76,2023-05-25,1,1,1,0,50,63,62,1,4,0,0,3,176,176,176,176
Nevada,76,2023-05-25,0,0,0,0,17,22,21,1,24,0,0,1,139,139,139,139
Orange,76,2023-05-25,53,66,66,0,1095,1365,1364,1,249,0,0,19,8179,8203,8179,8203
Placer,76,2023-05-25,11,14,14,0,156,195,194,1,262,0,0,15,685,685,685,685
Plumas,76,2023-05-25,1,1,1,0,8,11,10,1,0,0,0,0,15,15,15,15
Riverside,76,2023-05-25,18,22,22,0,657,820,819,1,185,0,0,19,6869,6882,6869,6882
Sacramento,76,2023-05-25,31,39,39,0,740,923,922,1,349,0,0,35,3601,3604,3601,3604
San Benito,76,2023-05-25,1,1,1,0,43,55,54,1,3,0,0,1,116,116,116,116
San Bernardino,76,2023-05-25,20,25,25,0,672,838,837,1,183,0,0,45,8140,8140,8140,8140
San Diego,76,2023-05-25,54,67,67,0,1985,2475,2474,1,336,0,0,31,5883,5892,5883,5892
San Francisco,76,2023-05-25,33,41,41,0,552,689,688,1,228,0,0,32,1224,1238,1224,1238
San Joaquin,76,2023-05-25,20,25,25,0,776,968,967,1,73,0,0,8,2457,2457,2457,2457
San Luis Obispo,76,2023-05-25,1,1,1,0,44,56,55,1,24,0,0,1,579,582,579,582
San Mateo,76,2023-05-25,21,26,26,0,363,453,452,1,93,0,0,3,747,747,747,747
Santa Barbara,76,2023-05-25,5,6,6,0,95,119,118,1,50,0,0,0,769,770,769,770
Santa Clara,76,2023-05-25,45,56,56,0,982,1225,1224,1,362,0,0,42,2819,2823,2819,2823
Santa Cruz,76,2023-05-25,8,10,10,0,152,190,189,1,40,1,14,0,277,290,276,276
Shasta,76,2023-05-25,0,0,0,0,26,33,32,1,29,0,0,5,612,612,612,612
Siskiyou,76,2023-05-25,0,0,0,0,6,8,7,1,1,0,0,0,97,97,97,97
Solano,76,2023-05-25,10,12,12,0,180,225,224,1,77,0,0,16,476,476,476,476
Sonoma,76,2023-05-25,16,20,20,0,169,212,211,1,65,0,0,9,573,578,573,578
Stanislaus,76,2023-05-25,7,9,9,0,213,266,265,1,118,0,0,13,1842,1842,1842,1842
Sutter,76,2023-05-25,3,4,4,0,29,37,36,1,0,0,0,0,241,241,241,241
Tehama,76,2023-05-25,0,0,0,0,3,5,4,1,15,0,0,0,237,237,237,237
Trinity,76,2023-05-25,0,0,0,0,1,2,1,1,0,0,0,0,24,24,24,24
Tulare,76,2023-05-25,2,2,2,0,53,67,66,1,16,0,0,1,1599,1599,1599,1599
Tuolumne,76,2023-05-25,0,0,0,0,24,31,30,1,9,0,0,0,211,211,211,211
Ventura,76,2023-05-25,20,25,25,0,333,416,415,1,90,0,0,5,1703,1703,1703,1703
Yolo,76,2023-05-25,1,1,1,0,63,80,79,1,21,0,0,6,454,454,454,454
Yuba,76,2023-05-25,6,7,7,0,22,28,27,1,18,0,0,0,134,134,134,134
California,1,2021-12-20,84327,84327,47199,37128,2163410,2163424,1234392,929032,2585,503,503,932,77302,77302,76799,76799
California,2,2021-12-27,242046,242046,151978,90068,1954364,1954375,1192635,761740,3348,496,496,1030,77798,77798,77302,77302
California,3,2022-01-03,550100,550101,369588,180513,2956483,2956511,1966523,989988,6125,592,592,1280,78390,78390,77798,77798
California,4,2022-01-10,867700,867706,620126,247580,4666388,4666450,3353795,1312655,10002,947,947,1813,79337,79337,78390,78390
California,5,2022-01-17,662099,662103,493310,168793,3984024,3984081,3022223,961858,12343,1433,1433,2311,80770,80770,79337,79337
California,6,2022-01-24,527695,527698,412784,114914,3989014,3989071,3193394,795677,12648,1779,1779,2600,82549,82549,80770,80770
California,7,2022-01-31,270460,270460,219792,50668,3154923,3154964,2636046,518918,10873,1910,1910,2494,84459,84459,82549,82549
California,8,2022-02-07,149372,149372,125825,23547,2670337,2670375,2318189,352186,8405,1784,1784,2007,86243,86243,84459,84459
California,9,2022-02-14,85818,85818,74809,11009,2322966,2323009,2079804,243205,6407,1439,1439,1564,87682,87682,86243,86243
California,10,2022-02-21,48079,48079,43053,5026,1850833,1850874,1692111,158763,4557,1012,1012,1098,88694,88694,87682,87682
California,11,2022-02-28,32652,32652,29944,2708,2098717,2098777,1961849,136928,3357,696,696,772,89390,89390,88694,88694
California,12,2022-03-07,22981,22981,21472,1509,1819631,1819687,1725096,94591,2435,502,502,581,89892,89892,89390,89390
California,13,2022-03-14,16993,16993,16116,877,1725487,1725543,1655201,70342,1844,361,361,419,90253,90253,89892,89892
California,14,2022-03-21,14639,14639,14058,581,1646442,1646499,1593795,52704,1537,252,252,313,90505,90505,90253,90253
California,15,2022-03-28,15478,15478,14997,481,1463342,1463399,1425797,37602,1150,183,183,264,90688,90688,90505,90505
California,16,2022-04-04,17687,17687,17271,416,1525119,1525202,1495667,29535,943,144,144,211,90832,90832,90688,90688
California,17,2022-04-11,21519,21519,21127,392,1343354,1343435,1322591,20844,905,124,124,148,90956,90956,90832,90832
California,18,2022-04-18,26882,26882,26492,390,1131743,1131817,1116925,14892,823,113,113,141,91069,91069,90956,90956
California,19,2022-04-25,37282,37282,36854,428,1622843,1622987,1608130,14857,838,93,93,112,91162,91162,91069,91069
California,20,2022-05-02,48968,48968,48533,435,1701868,1702051,1689822,12229,950,85,85,143,91247,91247,91162,91162
California,21,2022-05-09,63383,63383,62938,445,1770731,1770939,1760902,10037,1050,84,84,153,91331,91331,91247,91247
California,22,2022-05-16,80363,80364,79912,452,1840251,1840506,1832259,8247,1345,119,119,182,91450,91450,91331,91331
California,23,2022-05-23,97958,97963,97543,420,1870718,1871080,1864486,6594,1714,117,117,217,91567,91567,91450,91450
California,24,2022-05-30,90626,90633,90323,310,1499356,1499696,1495445,4251,1918,152,152,272,91719,91719,91567,91567
California,25,2022-06-06,120662,120678,120360,318,1939498,1940083,1935987,4096,2305,139,139,276,91858,91858,91719,91719
California,26,2022-06-13,105341,105360,105143,217,1406973,1407548,1405065,2483,2471,180,180,291,92038,92038,91858,91858
California,27,2022-06-20,101507,101538,101376,162,1026974,1027499,1025908,1591,2552,211,211,310,92249,92249,92038,92038
California,28,2022-06-27,115605,115654,115516,138,1044193,1044806,1043554,1252,3006,219,219,339,92468,92468,92249,92249
California,29,2022-07-04,108388,108441,108339,102,837132,837692,836886,806,3167,271,271,393,92739,92739,92468,92468
California,30,2022-07-11,141490,141572,141472,100,1082785,1083598,1082807,791,3824,297,297,453,93036,93036,92739,92739
California,31,2022-07-18,129893,129977,129904,73,993235,994059,993495,564,4148,295,295,528,93331,93331,93036,93036
California,32,2022-07-25,117751,117839,117791,48,948826,949730,949306,424,4310,359,359,516,93690,93690,93331,93331
California,33,2022-08-01,99401,99484,99451,33,875903,876818,876505,313,4119,361,361,535,94051,94051,93690,93690
California,34,2022-08-08,83586,83656,83636,20,825635,826562,826330,232,3754,337,337,474,94388,94388,94051,94051
California,35,2022-08-15,69147,69206,69194,12,794595,795540,795358,182,3363,302,302,448,94690,94690,94388,94388
California,36,2022-08-22,61568,61621,61615,6,778906,779863,779717,146,3087,289,289,418,94979,94979,94690,94690
California,37,2022-08-29,51947,51990,51987,3,769330,770306,770185,121,2752,219,219,351,95198,95198,94979,94979
California,38,2022-09-05,36797,36824,36824,0,631260,632098,632009,89,2525,248,248,350,95446,95446,95198,95198
California,39,2022-09-12,36507,36530,36530,0,756011,757039,756954,85,2422,224,224,346,95670,95670,95446,95446
California,40,2022-09-19,27855,27871,27871,0,690269,691246,691175,71,2041,182,182,272,95852,95852,95670,95670
California,41,2022-09-26,25535,25552,25552,0,641898,642856,642792,64,1818,169,169,230,96021,96021,95852,95852
California,42,2022-10-03,23498,23513,23513,0,588090,589007,588947,60,1647,150,150,247,96171,96171,96021,96021
California,43,2022-10-10,23554,23566,23566,0,628783,629794,629736,58,1537,159,159,228,96312,96312,96153,96153
California,44,2022-10-17,18799,18808,18808,0,524244,525119,525062,57,1397,119,119,218,96431,96431,96312,96312
California,45,2022-10-24,18667,18676,18676,0,514519,515389,515332,57,1324,117,117,190,96548,96548,96431,96431
California,46,2022-10-31,20811,20823,20823,0,523960,524885,524828,57,1401,114,114,191,96662,96662,96548,96548
California,47,2022-11-07,27033,27054,27054,0,548922,549901,549844,57,1525,132,132,231,96794,96794,96662,96662
California,48,2022-11-14,31004,31032,31032,0,550767,551776,551719,57,1775,117,117,260,96911,96911,96794,96794
California,49,2022-11-21,40452,40508,40508,0,576913,578028,577971,57,2268,154,154,330,97065,97065,96911,96911
California,50,2022-11-28,54582,54668,54668,0,518893,519943,519886,57,3153,209,209,379,97274,97274,97065,97065
California,51,2022-12-05,66473,66584,66584,0,659858,661252,661194,58,3715,247,247,493,97521,97521,97274,97274
California,52,2022-12-12,56914,57013,57013,0,622089,623456,623398,58,3944,353,353,527,97874,97874,97521,97521
California,53,2022-12-19,51143,51235,51235,0,575820,577153,577096,57,3997,329,329,523,98203,98203,97874,97874
California,54,2022-12-26,45787,45872,45872,0,421326,422368,422311,57,3906,410,410,510,98613,98613,98203,98203
California,55,2023-01-02,45466,45555,45555,0,425566,426670,426613,57,4077,365,365,528,98978,98978,98613,98613
California,56,2023-01-09,33954,34024,34024,0,508230,509626,509569,57,3672,349,349,487,99327,99327,98978,98978
California,57,2023-01-16,20413,20453,20453,0,411396,412630,412573,57,3075,325,325,425,99652,99652,99327,99327
California,58,2023-01-23,18547,18584,18584,0,453945,455388,455331,57,2400,248,248,369,99900,99900,99652,99652
California,59,2023-01-30,19441,19486,19486,0,420837,422327,422270,57,2214,218,218,266,100118,100118,99900,99900
California,60,2023-02-06,21438,21500,21500,0,406112,407742,407685,57,2231,179,179,280,100297,100297,100118,100118
California,61,2023-02-13,21398,21474,21474,0,385708,387424,387368,56,2223,157,157,287,100454,100454,100297,100297
California,62,2023-02-20,19792,19866,19866,0,346303,348021,347965,56,2159,177,177,292,100631,100631,100454,100454
California,63,2023-02-27,19958,20042,20042,0,382730,384770,384713,57,2220,170,170,310,100801,100801,100631,100631
California,64,2023-03-06,17317,17408,17408,0,349021,351163,351107,56,2074,156,156,262,100957,100957,100801,100801
California,65,2023-03-13,15539,15630,15630,0,334668,337097,337041,56,1939,162,164,278,101119,101121,100957,100957
California,66,2023-03-20,12478,12561,12561,0,308976,311577,311521,56,1701,134,136,237,101253,101257,101119,101121
California,67,2023-03-27,10306,10383,10383,0,290177,293037,292981,56,1498,100,100,196,101353,101357,101253,101257
California,68,2023-04-03,10151,10242,10242,0,271575,274660,274604,56,1363,108,111,176,101461,101468,101353,101357
California,69,2023-04-10,9744,9840,9840,0,254263,257509,257453,56,1312,91,98,173,101552,101566,101461,101468
California,70,2023-04-17,9384,9493,9493,0,272795,276750,276694,56,1316,79,84,149,101631,101650,101552,101566
California,71,2023-04-24,8452,8559,8559,0,259594,263935,263879,56,1278,84,92,148,101715,101742,101631,101650
California,72,2023-05-01,7803,7932,7932,0,244521,249392,249336,56,1149,74,86,133,101789,101828,101715,101742
California,73,2023-05-08,7125,7285,7285,0,217566,223074,223018,56,1057,56,77,131,101845,101905,101789,101828
California,74,2023-05-12,4596,4728,4728,0,144886,149577,149521,56,999,19,36,150,101864,101941,101845,101905
California,75,2023-05-19,822,871,871,0,19833,21139,21083,56,2713,1,4,273,101893,102023,101892,102019
California,76,2023-05-25,651,805,805,0,12990,16242,16187,55,5173,1,14,540,101882,102153,101881,102139
