county,time,date,cases,est_cases,est_omicron_cases,est_other_cases,tests,est_tests,est_omicron_tests,est_other_tests,hospitalizations,deaths,est_deaths,icu,cum_deaths,cum_est_deaths,prev_cum_deaths,prev_cum_est_deaths
Alameda,1,2021-12-21,3654,3654,1776,1878,90633,90633,43422,47211,47,10,10,15,1549,1549,1539,1539
Amador,1,2021-12-21,59,59,22,37,1680,1680,607,1073,3,0,0,2,70,70,70,70
Butte,1,2021-12-21,231,231,124,107,4367,4367,2326,2041,22,5,5,4,361,361,356,356
Calaveras,1,2021-12-21,62,62,25,37,1492,1492,583,909,1,2,2,0,92,92,90,90
Colusa,1,2021-12-21,9,9,4,5,407,407,177,230,2,0,0,0,21,21,21,21
Contra Costa,1,2021-12-21,2070,2070,744,1326,44532,44532,15755,28777,31,2,2,7,1080,1080,1078,1078
Del Norte,1,2021-12-21,17,17,7,10,1361,1361,576,785,0,0,0,0,42,42,42,42
El Dorado,1,2021-12-21,275,275,110,165,4616,4616,1833,2783,4,3,3,2,179,179,176,176
Fresno,1,2021-12-21,1148,1148,424,724,24675,24675,9046,15629,126,20,20,46,2423,2423,2403,2403
Glenn,1,2021-12-21,22,22,9,13,483,483,197,286,0,0,0,0,41,41,41,41
Humboldt,1,2021-12-21,177,177,75,102,3777,3777,1571,2206,13,1,1,1,121,121,120,120
Imperial,1,2021-12-21,616,616,243,373,5704,5704,2239,3465,41,9,9,28,818,818,809,809
Inyo,1,2021-12-21,33,33,15,18,375,375,165,210,2,1,1,0,49,49,48,48
Kern,1,2021-12-21,1000,1000,442,558,25041,25041,10994,14047,82,24,24,28,2026,2026,2002,2002
Kings,1,2021-12-21,243,243,96,147,6691,6691,2634,4057,13,6,6,3,389,389,383,383
Lake,1,2021-12-21,40,40,14,26,1264,1264,459,805,0,0,0,0,116,116,116,116
Lassen,1,2021-12-21,12,12,6,6,2416,2416,1125,1291,1,0,0,0,54,54,54,54
Los Angeles,1,2021-12-21,40348,40348,28442,11906,944115,944133,655645,288488,604,110,110,166,27385,27385,27275,27275
Madera,1,2021-12-21,159,159,58,101,5536,5536,2008,3528,8,2,2,6,335,335,333,333
Marin,1,2021-12-21,721,721,275,446,12774,12774,4785,7989,6,1,1,1,256,256,255,255
Mariposa,1,2021-12-21,28,28,10,18,504,504,180,324,0,0,0,0,21,21,21,21
Mendocino,1,2021-12-21,90,90,27,63,2807,2807,856,1951,2,2,2,3,103,103,101,101
Merced,1,2021-12-21,340,340,148,192,5489,5489,2374,3115,11,6,6,12,694,694,688,688
Modoc,1,2021-12-21,4,4,2,2,72,72,32,40,3,0,0,0,6,6,6,6
Mono,1,2021-12-21,53,53,15,38,442,442,119,323,1,0,0,0,4,4,4,4
Monterey,1,2021-12-21,526,526,141,385,13365,13365,3561,9804,19,3,3,8,643,643,640,640
Napa,1,2021-12-21,302,302,142,160,5221,5221,2417,2804,2,1,1,2,108,108,107,107
Nevada,1,2021-12-21,182,182,68,114,3032,3032,1123,1909,3,0,0,2,110,110,110,110
Orange,1,2021-12-21,6011,6011,3034,2977,104749,104749,52164,52585,158,28,28,57,6024,6024,5996,5996
Placer,1,2021-12-21,626,626,220,406,11473,11473,3980,7493,54,5,5,24,501,501,496,496
Plumas,1,2021-12-21,15,15,6,9,507,507,198,309,0,0,0,0,12,12,12,12
Riverside,1,2021-12-21,6474,6474,2777,3697,81323,81323,34541,46782,253,39,39,83,5585,5585,5546,5546
Sacramento,1,2021-12-21,2441,2441,1001,1440,53423,53423,21699,31724,112,23,23,39,2492,2492,2469,2469
San Benito,1,2021-12-21,126,126,59,67,2004,2004,920,1084,2,4,4,2,82,82,78,78
San Bernardino,1,2021-12-21,5972,5972,2889,3083,83900,83900,40140,43760,289,69,69,116,6520,6520,6451,6451
San Diego,1,2021-12-21,11092,11092,7688,3404,159752,159754,109986,49768,263,30,30,100,4484,4484,4454,4454
San Francisco,1,2021-12-21,3778,3778,966,2812,61074,61074,15290,45784,25,3,3,12,693,693,690,690
San Joaquin,1,2021-12-21,1079,1079,417,662,23835,23835,9127,14708,47,14,14,22,1977,1977,1963,1963
San Luis Obispo,1,2021-12-21,490,490,221,269,10627,10627,4749,5878,11,2,2,6,371,371,369,369
San Mateo,1,2021-12-21,1949,1949,984,965,51401,51401,25497,25904,9,1,1,5,602,602,601,601
Santa Barbara,1,2021-12-21,913,913,386,527,15948,15948,6657,9291,19,7,7,13,570,570,563,563
Santa Clara,1,2021-12-21,3648,3648,2484,1164,116100,116100,78116,37984,76,9,9,43,1980,1980,1971,1971
Santa Cruz,1,2021-12-21,430,430,198,232,17074,17074,7756,9318,9,1,1,5,230,230,229,229
Shasta,1,2021-12-21,163,163,67,96,5595,5595,2289,3306,27,6,6,8,449,449,443,443
Siskiyou,1,2021-12-21,17,17,8,9,360,360,170,190,2,2,2,0,63,63,61,61
Solano,1,2021-12-21,548,548,235,313,14654,14654,6217,8437,19,2,2,7,389,389,387,387
Sonoma,1,2021-12-21,848,848,369,479,20359,20359,8754,11605,19,1,1,4,420,420,419,419
Stanislaus,1,2021-12-21,679,679,219,460,12209,12209,3908,8301,87,15,15,23,1436,1436,1421,1421
Sutter,1,2021-12-21,139,139,59,80,2228,2228,937,1291,0,1,1,0,193,193,192,192
Tehama,1,2021-12-21,48,48,16,32,1311,1311,433,878,6,0,0,3,165,165,165,165
Trinity,1,2021-12-21,1,1,0,1,107,107,35,72,0,1,1,0,19,19,18,18
Tulare,1,2021-12-21,440,440,140,300,12168,12168,3868,8300,36,18,18,10,1309,1309,1291,1291
Tuolumne,1,2021-12-21,100,100,37,63,1992,1992,730,1262,8,0,0,0,150,150,150,150
Ventura,1,2021-12-21,2328,2328,1219,1109,38438,38438,19874,18564,63,11,11,14,1218,1218,1207,1207
Yolo,1,2021-12-21,371,371,169,202,24396,24396,10962,13434,4,1,1,1,295,295,294,294
Yuba,1,2021-12-21,98,98,43,55,1878,1878,821,1057,7,0,0,4,102,102,102,102
Alameda,2,2021-12-28,9229,9229,5059,4170,90330,90330,48977,41353,106,11,11,15,1560,1560,1549,1549
Amador,2,2021-12-28,106,106,45,61,1450,1450,610,840,2,0,0,3,70,70,70,70
Butte,2,2021-12-28,614,614,368,246,4737,4737,2825,1912,32,1,1,3,362,362,361,361
Calaveras,2,2021-12-28,115,115,53,62,1002,1002,459,543,1,1,1,1,93,93,92,92
Colusa,2,2021-12-28,37,37,19,18,256,256,128,128,2,0,0,0,21,21,21,21
Contra Costa,2,2021-12-28,6776,6776,2854,3922,49452,49452,20479,28973,36,4,4,20,1084,1084,1080,1080
Del Norte,2,2021-12-28,32,32,16,16,1561,1561,763,798,0,0,0,1,42,42,42,42
El Dorado,2,2021-12-28,612,612,284,328,4372,4372,2006,2366,7,1,1,4,180,180,179,179
Fresno,2,2021-12-28,2936,2936,1278,1658,26504,26504,11402,15102,124,13,13,42,2436,2436,2423,2423
Glenn,2,2021-12-28,55,55,26,29,464,464,218,246,0,1,1,0,42,42,41,41
Humboldt,2,2021-12-28,573,573,277,296,3631,3631,1747,1884,9,1,1,0,122,122,121,121
Imperial,2,2021-12-28,1009,1009,464,545,6313,6313,2883,3430,32,11,11,26,829,829,818,818
Inyo,2,2021-12-28,135,135,68,67,476,476,238,238,0,1,1,0,50,50,49,49
Kern,2,2021-12-28,2439,2439,1247,1192,24301,24301,12334,11967,77,17,17,37,2043,2043,2026,2026
Kings,2,2021-12-28,616,616,285,331,6085,6085,2802,3283,20,1,1,3,390,390,389,389
Lake,2,2021-12-28,85,85,37,48,1211,1211,511,700,0,1,1,0,117,117,116,116
Lassen,2,2021-12-28,25,25,13,12,2380,2380,1256,1124,1,0,0,0,54,54,54,54
Los Angeles,2,2021-12-28,121019,121021,91261,29760,771025,771039,578282,192757,1053,121,121,198,27506,27506,27385,27385
Madera,2,2021-12-28,432,432,187,245,4731,4731,2030,2701,5,1,1,3,336,336,335,335
Marin,2,2021-12-28,1780,1780,780,1000,17303,17303,7498,9805,6,0,0,1,256,256,256,256
Mariposa,2,2021-12-28,42,42,18,24,495,495,203,292,0,0,0,0,21,21,21,21
Mendocino,2,2021-12-28,207,207,76,131,2582,2582,932,1650,4,0,0,2,103,103,103,103
Merced,2,2021-12-28,828,828,416,412,5713,5713,2849,2864,11,7,7,9,701,701,694,694
Modoc,2,2021-12-28,5,5,3,2,37,37,19,18,1,0,0,0,6,6,6,6
Mono,2,2021-12-28,163,163,53,110,414,414,134,280,1,0,0,0,4,4,4,4
Monterey,2,2021-12-28,1212,1212,393,819,13915,13915,4452,9463,17,3,3,11,646,646,643,643
Napa,2,2021-12-28,997,997,531,466,7743,7743,4097,3646,6,0,0,1,108,108,108,108
Nevada,2,2021-12-28,265,265,115,150,1733,1733,736,997,2,1,1,0,111,111,110,110
Orange,2,2021-12-28,23971,23971,13635,10336,148175,148177,83588,64589,304,32,32,72,6056,6056,6024,6024
Placer,2,2021-12-28,1498,1498,616,882,11639,11639,4754,6885,67,4,4,26,505,505,501,501
Plumas,2,2021-12-28,17,17,8,9,305,305,137,168,0,0,0,0,12,12,12,12
Riverside,2,2021-12-28,16826,16826,8300,8526,96584,96584,47319,49265,345,54,54,86,5639,5639,5585,5585
Sacramento,2,2021-12-28,6660,6660,3171,3489,56777,56777,26734,30043,145,22,22,44,2514,2514,2492,2492
San Benito,2,2021-12-28,391,391,206,185,2449,2449,1278,1171,0,2,2,3,84,84,82,82
San Bernardino,2,2021-12-28,18861,18861,10358,8503,96297,96297,52311,43986,385,67,67,139,6587,6587,6520,6520
San Diego,2,2021-12-28,34105,34105,25385,8720,189393,189397,140218,49179,325,30,30,102,4514,4514,4484,4484
San Francisco,2,2021-12-28,7548,7548,2286,5262,68404,68404,20481,47923,43,2,2,11,695,695,693,693
San Joaquin,2,2021-12-28,3031,3031,1371,1660,24711,24711,11062,13649,66,11,11,23,1988,1988,1977,1977
San Luis Obispo,2,2021-12-28,1484,1484,767,717,12184,12184,6239,5945,17,1,1,7,372,372,371,371
San Mateo,2,2021-12-28,6264,6264,3540,2724,58809,58809,32912,25897,19,1,1,6,603,603,602,602
Santa Barbara,2,2021-12-28,2717,2717,1326,1391,17134,17134,8289,8845,37,6,6,9,576,576,570,570
Santa Clara,2,2021-12-28,11095,11095,8125,2970,112759,112759,82076,30683,97,10,10,40,1990,1990,1980,1980
Santa Cruz,2,2021-12-28,1157,1157,609,548,12837,12837,6687,6150,10,1,1,2,231,231,230,230
Shasta,2,2021-12-28,303,303,144,159,4662,4662,2206,2456,30,4,4,15,453,453,449,449
Siskiyou,2,2021-12-28,29,29,16,13,390,390,209,181,0,0,0,0,63,63,63,63
Solano,2,2021-12-28,1906,1906,945,961,19015,19015,9285,9730,25,6,6,6,395,395,389,389
Sonoma,2,2021-12-28,2302,2302,1147,1155,22891,22891,11317,11574,20,2,2,5,422,422,420,420
Stanislaus,2,2021-12-28,1578,1578,607,971,12460,12460,4758,7702,92,14,14,17,1450,1450,1436,1436
Sutter,2,2021-12-28,259,259,126,133,2224,2224,1077,1147,0,2,2,0,195,195,193,193
Tehama,2,2021-12-28,111,111,44,67,1123,1123,439,684,4,2,2,3,167,167,165,165
Trinity,2,2021-12-28,4,4,2,2,85,85,33,52,0,0,0,0,19,19,19,19
Tulare,2,2021-12-28,990,990,376,614,12064,12064,4566,7498,39,9,9,9,1318,1318,1309,1309
Tuolumne,2,2021-12-28,195,195,84,111,1660,1660,708,952,8,0,0,1,150,150,150,150
Ventura,2,2021-12-28,7299,7299,4293,3006,43947,43947,25646,18301,77,7,7,17,1225,1225,1218,1218
Yolo,2,2021-12-28,1016,1016,530,486,23457,23457,12073,11384,10,0,0,3,295,295,295,295
Yuba,2,2021-12-28,210,210,107,103,1631,1631,820,811,7,1,1,6,103,103,102,102
Alameda,3,2022-01-04,21123,21123,12815,8308,133457,133459,80870,52589,164,6,6,35,1566,1566,1560,1560
Amador,3,2022-01-04,255,255,125,130,2493,2493,1207,1286,5,1,1,2,71,71,70,70
Butte,3,2022-01-04,1370,1370,900,470,7734,7734,5069,2665,35,0,0,5,362,362,362,362
Calaveras,3,2022-01-04,267,267,140,127,1682,1682,883,799,1,2,2,2,95,95,93,93
Colusa,3,2022-01-04,47,47,26,21,465,465,263,202,5,0,0,0,21,21,21,21
Contra Costa,3,2022-01-04,14808,14808,7067,7741,75393,75393,35931,39462,98,9,9,21,1093,1093,1084,1084
Del Norte,3,2022-01-04,97,97,53,44,2177,2177,1190,987,0,0,0,0,42,42,42,42
El Dorado,3,2022-01-04,1518,1518,794,724,6652,6652,3471,3181,9,5,5,6,185,185,180,180
Fresno,3,2022-01-04,7844,7844,3873,3971,41758,41758,20500,21258,185,19,19,47,2455,2455,2436,2436
Glenn,3,2022-01-04,99,99,52,47,639,639,339,300,0,1,1,0,43,43,42,42
Humboldt,3,2022-01-04,977,977,532,445,5777,5777,3134,2643,12,2,2,4,124,124,122,122
Imperial,3,2022-01-04,2270,2270,1183,1087,10155,10155,5264,4891,38,16,16,28,845,845,829,829
Inyo,3,2022-01-04,306,306,172,134,788,788,443,345,3,1,1,0,51,51,50,50
Kern,3,2022-01-04,7182,7182,4106,3076,40382,40382,23023,17359,111,15,15,33,2058,2058,2043,2043
Kings,3,2022-01-04,1276,1276,668,608,9093,9093,4743,4350,16,3,3,3,393,393,390,390
Lake,3,2022-01-04,300,300,148,152,2131,2131,1042,1089,2,0,0,1,117,117,117,117
Lassen,3,2022-01-04,73,73,43,30,3180,3180,1872,1308,1,0,0,0,54,54,54,54
Los Angeles,3,2022-01-04,228684,228688,181930,46758,1239297,1239320,986275,253045,2131,158,158,330,27664,27664,27506,27506
Madera,3,2022-01-04,1006,1006,495,511,7509,7509,3692,3817,17,3,3,6,339,339,336,336
Marin,3,2022-01-04,2572,2572,1281,1291,18319,18319,9076,9243,18,1,1,2,257,257,256,256
Mariposa,3,2022-01-04,130,130,63,67,745,745,356,389,0,1,1,0,22,22,21,21
Mendocino,3,2022-01-04,535,535,227,308,3961,3961,1671,2290,6,1,1,2,104,104,103,103
Merced,3,2022-01-04,2026,2026,1142,884,9606,9606,5378,4228,21,10,10,12,711,711,701,701
Modoc,3,2022-01-04,16,16,9,7,85,85,49,36,0,0,0,0,6,6,6,6
Mono,3,2022-01-04,195,195,75,120,521,521,201,320,1,0,0,0,4,4,4,4
Monterey,3,2022-01-04,2997,2997,1138,1859,23902,23902,9049,14853,40,5,5,10,651,651,646,646
Napa,3,2022-01-04,2105,2105,1244,861,12605,12605,7429,5176,11,1,1,4,109,109,108,108
Nevada,3,2022-01-04,744,744,368,376,3586,3586,1772,1814,9,2,2,2,113,113,111,111
Orange,3,2022-01-04,49322,49322,30706,18616,240087,240091,149425,90666,557,46,46,116,6102,6102,6056,6056
Placer,3,2022-01-04,3345,3345,1572,1773,16261,16261,7624,8637,108,13,13,23,518,518,505,505
Plumas,3,2022-01-04,72,72,37,35,568,568,292,276,1,0,0,0,12,12,12,12
Riverside,3,2022-01-04,35962,35962,19840,16122,147661,147663,81243,66420,605,57,57,108,5696,5696,5639,5639
Sacramento,3,2022-01-04,17293,17293,9262,8031,90329,90329,48177,42152,236,28,28,55,2542,2542,2514,2514
San Benito,3,2022-01-04,783,783,456,327,3625,3625,2109,1516,3,1,1,2,85,85,84,84
San Bernardino,3,2022-01-04,36791,36791,22222,14569,144145,144149,86863,57286,581,97,97,162,6684,6684,6587,6587
San Diego,3,2022-01-04,66971,66971,52604,14367,272108,272112,213674,58438,576,39,39,141,4553,4553,4514,4514
San Francisco,3,2022-01-04,12502,12502,4475,8027,91147,91147,32479,58668,91,5,5,23,700,700,695,695
San Joaquin,3,2022-01-04,8378,8378,4281,4097,42847,42847,21868,20979,94,14,14,25,2002,2002,1988,1988
San Luis Obispo,3,2022-01-04,2838,2838,1631,1207,16663,16663,9534,7129,23,5,5,7,377,377,372,372
San Mateo,3,2022-01-04,11818,11818,7363,4455,89490,89490,55704,33786,41,4,4,6,607,607,603,603
Santa Barbara,3,2022-01-04,6006,6006,3285,2721,31405,31405,17168,14237,55,5,5,9,581,581,576,576
Santa Clara,3,2022-01-04,26129,26129,20290,5839,190183,190186,147620,42566,226,10,10,60,2000,2000,1990,1990
Santa Cruz,3,2022-01-04,2928,2928,1720,1208,26680,26680,15707,10973,13,4,4,3,235,235,231,231
Shasta,3,2022-01-04,719,719,387,332,6676,6676,3575,3101,38,2,2,14,455,455,453,453
Siskiyou,3,2022-01-04,92,92,55,37,671,671,403,268,1,1,1,1,64,64,63,63
Solano,3,2022-01-04,4640,4640,2552,2088,28434,28434,15612,12822,54,2,2,9,397,397,395,395
Sonoma,3,2022-01-04,5661,5661,3165,2496,36584,36584,20409,16175,28,9,9,6,431,431,422,422
Stanislaus,3,2022-01-04,3876,3876,1715,2161,19953,19953,8804,11149,131,10,10,18,1460,1460,1450,1450
Sutter,3,2022-01-04,649,649,357,292,3474,3474,1905,1569,0,2,2,0,197,197,195,195
Tehama,3,2022-01-04,274,274,125,149,1682,1682,766,916,3,1,1,2,168,168,167,167
Trinity,3,2022-01-04,19,19,8,11,141,141,63,78,0,0,0,0,19,19,19,19
Tulare,3,2022-01-04,2569,2569,1129,1440,16648,16648,7266,9382,60,5,5,7,1323,1323,1318,1318
Tuolumne,3,2022-01-04,482,482,239,243,2902,2902,1431,1471,12,3,3,1,153,153,150,150
Ventura,3,2022-01-04,13754,13754,8825,4929,65917,65917,42300,23617,142,11,11,27,1236,1236,1225,1225
Yolo,3,2022-01-04,2717,2717,1579,1138,34519,34519,19970,14549,8,4,4,4,299,299,295,295
Yuba,3,2022-01-04,545,545,308,237,2577,2577,1455,1122,16,1,1,6,104,104,103,103
Alameda,4,2022-01-11,30137,30137,19831,10306,192149,192154,126646,65508,280,16,16,45,1582,1582,1566,1566
Amador,4,2022-01-11,430,430,235,195,3309,3309,1816,1493,5,1,1,4,72,72,71,71
Butte,4,2022-01-11,2040,2040,1440,600,10381,10381,7326,3055,58,2,2,5,364,364,362,362
Calaveras,4,2022-01-11,560,560,325,235,2460,2460,1424,1036,0,0,0,2,95,95,95,95
Colusa,4,2022-01-11,125,125,78,47,724,724,449,275,4,0,0,0,21,21,21,21
Contra Costa,4,2022-01-11,19187,19187,10242,8945,100411,100411,53626,46785,179,15,15,27,1108,1108,1093,1093
Del Norte,4,2022-01-11,180,180,109,71,4311,4311,2608,1703,4,0,0,0,42,42,42,42
El Dorado,4,2022-01-11,2365,2365,1375,990,9577,9577,5559,4018,13,4,4,3,189,189,185,185
Fresno,4,2022-01-11,15522,15522,8564,6958,61996,61996,34151,27845,301,12,12,55,2467,2467,2455,2455
Glenn,4,2022-01-11,249,249,147,102,1020,1020,601,419,2,0,0,0,43,43,43,43
Humboldt,4,2022-01-11,1432,1432,859,573,8732,8732,5239,3493,16,4,4,2,128,128,124,124
Imperial,4,2022-01-11,3720,3720,2144,1576,14020,14020,8073,5947,62,7,7,24,852,852,845,845
Inyo,4,2022-01-11,393,393,243,150,1381,1381,852,529,4,1,1,0,52,52,51,51
Kern,4,2022-01-11,12517,12517,7833,4684,58953,58953,36889,22064,193,30,30,40,2088,2088,2058,2058
Kings,4,2022-01-11,2702,2702,1575,1127,13576,13576,7891,5685,34,1,1,2,394,394,393,393
Lake,4,2022-01-11,485,485,266,219,2687,2687,1470,1217,1,3,3,1,120,120,117,117
Lassen,4,2022-01-11,216,216,140,76,3496,3496,2254,1242,1,0,0,0,54,54,54,54
Los Angeles,4,2022-01-11,313825,313831,260128,53703,1916517,1916557,1590063,326494,3376,305,305,536,27969,27969,27664,27664
Madera,4,2022-01-11,2069,2069,1137,932,10343,10343,5677,4666,26,1,1,6,340,340,339,339
Marin,4,2022-01-11,2837,2837,1578,1259,20332,20332,11288,9044,17,3,3,5,260,260,257,257
Mariposa,4,2022-01-11,197,197,106,91,1174,1174,629,545,0,0,0,0,22,22,22,22
Mendocino,4,2022-01-11,898,898,432,466,5681,5681,2723,2958,9,2,2,1,106,106,104,104
Merced,4,2022-01-11,4137,4137,2550,1587,14839,14839,9138,5701,37,11,11,11,722,722,711,711
Modoc,4,2022-01-11,11,11,7,4,105,105,67,38,0,0,0,0,6,6,6,6
Mono,4,2022-01-11,241,241,105,136,801,801,348,453,0,1,1,0,5,5,4,4
Monterey,4,2022-01-11,5108,5108,2226,2882,31713,31713,13758,17955,51,3,3,12,654,654,651,651
Napa,4,2022-01-11,2525,2525,1627,898,14528,14528,9379,5149,13,1,1,9,110,110,109,109
Nevada,4,2022-01-11,1252,1252,693,559,5359,5359,2964,2395,9,2,2,3,115,115,113,113
Orange,4,2022-01-11,57773,57773,38985,18788,311731,311736,210539,101197,902,103,103,169,6205,6205,6102,6102
Placer,4,2022-01-11,5235,5235,2764,2471,22613,22613,11947,10666,183,8,8,32,526,526,518,518
Plumas,4,2022-01-11,157,157,90,67,832,832,473,359,6,0,0,0,12,12,12,12
Riverside,4,2022-01-11,48043,48043,29219,18824,187080,187085,113789,73296,787,83,83,156,5779,5779,5696,5696
Sacramento,4,2022-01-11,26875,26875,15839,11036,120864,120866,71361,49505,382,45,45,82,2587,2587,2542,2542
San Benito,4,2022-01-11,1049,1049,671,378,4632,4632,2963,1669,4,1,1,3,86,86,85,85
San Bernardino,4,2022-01-11,50172,50172,32988,17184,191801,191806,126144,65662,829,117,117,195,6801,6801,6684,6684
San Diego,4,2022-01-11,79339,79339,65159,14180,321344,321350,264026,57324,899,73,73,167,4626,4626,4553,4553
San Francisco,4,2022-01-11,14085,14085,5760,8325,112763,112763,46203,66560,173,14,14,38,714,714,700,700
San Joaquin,4,2022-01-11,14889,14889,8452,6437,65661,65661,37284,28377,172,15,15,46,2017,2017,2002,2002
San Luis Obispo,4,2022-01-11,4345,4345,2728,1617,22106,22106,13906,8200,32,4,4,9,381,381,377,377
San Mateo,4,2022-01-11,14953,14953,10106,4847,112864,112864,76293,36571,99,6,6,15,613,613,607,607
Santa Barbara,4,2022-01-11,8334,8334,5014,3320,47252,47252,28444,18808,86,10,10,12,591,591,581,581
Santa Clara,4,2022-01-11,36465,36465,29660,6805,274530,274535,223332,51203,371,25,25,71,2025,2025,2000,2000
Santa Cruz,4,2022-01-11,4577,4577,2931,1646,44128,44128,28309,15819,32,2,2,2,237,237,235,235
Shasta,4,2022-01-11,1078,1078,641,437,8788,8788,5224,3564,39,7,7,12,462,462,455,455
Siskiyou,4,2022-01-11,126,126,83,43,1028,1028,673,355,3,0,0,1,64,64,64,64
Solano,4,2022-01-11,6664,6664,4039,2625,36000,36000,21857,14143,108,8,8,14,405,405,397,397
Sonoma,4,2022-01-11,8721,8721,5349,3372,47002,47002,28906,18096,73,7,7,7,438,438,431,431
Stanislaus,4,2022-01-11,7103,7103,3554,3549,30025,30025,15024,15001,169,11,11,23,1471,1471,1460,1460
Sutter,4,2022-01-11,1332,1332,807,525,5167,5167,3130,2037,0,3,3,0,200,200,197,197
Tehama,4,2022-01-11,554,554,284,270,2613,2613,1339,1274,17,2,2,2,170,170,168,168
Trinity,4,2022-01-11,37,37,19,18,275,275,138,137,0,0,0,0,19,19,19,19
Tulare,4,2022-01-11,6009,6009,2998,3011,25914,25914,12870,13044,70,11,11,11,1334,1334,1323,1323
Tuolumne,4,2022-01-11,794,794,438,356,4224,4224,2325,1899,7,2,2,2,155,155,153,153
Ventura,4,2022-01-11,16946,16946,11739,5207,86312,86312,59826,26486,233,26,26,32,1262,1262,1236,1236
Yolo,4,2022-01-11,3667,3667,2319,1348,47474,47474,29991,17483,10,6,6,2,305,305,299,299
Yuba,4,2022-01-11,1137,1137,706,431,4297,4297,2666,1631,33,0,0,7,104,104,104,104
Alameda,5,2022-01-18,24304,24304,17295,7009,173323,173328,123432,49896,371,37,37,68,1619,1619,1582,1582
Amador,5,2022-01-18,487,487,295,192,3367,3367,2032,1335,13,1,1,3,73,73,72,72
Butte,5,2022-01-18,2114,2114,1594,520,9450,9450,7126,2324,60,8,8,4,372,372,364,364
Calaveras,5,2022-01-18,597,597,380,217,2714,2714,1727,987,4,2,2,2,97,97,95,95
Colusa,5,2022-01-18,155,155,104,51,768,768,516,252,3,0,0,0,21,21,21,21
Contra Costa,5,2022-01-18,16258,16258,9668,6590,88974,88975,52875,36100,233,24,24,45,1132,1132,1108,1108
Del Norte,5,2022-01-18,228,228,151,77,3983,3983,2625,1358,0,0,0,1,42,42,42,42
El Dorado,5,2022-01-18,1671,1671,1064,607,7631,7631,4866,2765,8,4,4,5,193,193,189,189
Fresno,5,2022-01-18,18823,18823,11490,7333,67266,67266,41044,26222,416,30,30,73,2497,2497,2467,2467
Glenn,5,2022-01-18,301,301,194,107,1098,1098,709,389,1,2,2,0,45,45,43,43
Humboldt,5,2022-01-18,1109,1109,729,380,8238,8238,5403,2835,16,1,1,4,129,129,128,128
Imperial,5,2022-01-18,3373,3373,2138,1235,12888,12888,8163,4725,75,13,13,28,865,865,852,852
Inyo,5,2022-01-18,294,294,196,98,954,954,638,316,1,1,1,0,53,53,52,52
Kern,5,2022-01-18,11662,11662,7921,3741,52378,52378,35602,16776,251,29,29,54,2117,2117,2088,2088
Kings,5,2022-01-18,3712,3712,2374,1338,16600,16600,10581,6019,43,5,5,1,399,399,394,394
Lake,5,2022-01-18,643,643,391,252,3532,3532,2147,1385,1,1,1,3,121,121,120,120
Lassen,5,2022-01-18,339,339,237,102,3795,3795,2649,1146,0,0,0,0,54,54,54,54
Los Angeles,5,2022-01-18,212149,212155,182732,29423,1635547,1635590,1408943,226647,4099,521,521,700,28490,28490,27969,27969
Madera,5,2022-01-18,2605,2605,1588,1017,11429,11429,6963,4466,33,7,7,12,347,347,340,340
Marin,5,2022-01-18,2333,2333,1434,899,17918,17918,11012,6906,37,4,4,6,264,264,260,260
Mariposa,5,2022-01-18,148,148,88,60,1102,1102,654,448,0,0,0,0,22,22,22,22
Mendocino,5,2022-01-18,972,972,526,446,5026,5026,2715,2311,24,3,3,3,109,109,106,106
Merced,5,2022-01-18,3993,3993,2675,1318,13716,13716,9206,4510,48,17,17,13,739,739,722,722
Modoc,5,2022-01-18,16,16,11,5,102,102,70,32,0,1,1,0,7,7,6,6
Mono,5,2022-01-18,155,155,75,80,706,706,345,361,0,0,0,0,5,5,5,5
Monterey,5,2022-01-18,6068,6068,3006,3062,30331,30331,15078,15253,89,8,8,14,662,662,654,654
Napa,5,2022-01-18,1909,1909,1333,576,12147,12147,8498,3649,20,2,2,5,112,112,110,110
Nevada,5,2022-01-18,1210,1210,739,471,5382,5382,3289,2093,24,0,0,1,115,115,115,115
Orange,5,2022-01-18,38673,38673,28086,10587,247087,247093,179509,67584,1025,112,112,207,6317,6317,6205,6205
Placer,5,2022-01-18,4206,4206,2476,1730,19367,19367,11405,7962,174,12,12,38,538,538,526,526
Plumas,5,2022-01-18,205,205,128,77,824,824,517,307,3,0,0,0,12,12,12,12
Riverside,5,2022-01-18,39805,39805,26431,13374,167608,167613,111406,56207,949,110,110,160,5889,5889,5779,5779
Sacramento,5,2022-01-18,21025,21025,13621,7404,101301,101302,65698,35604,496,60,60,92,2647,2647,2587,2587
San Benito,5,2022-01-18,898,898,624,274,4316,4316,2994,1322,4,2,2,4,88,88,86,86
San Bernardino,5,2022-01-18,36446,36446,25862,10584,165057,165062,117248,47814,969,152,152,232,6953,6953,6801,6801
San Diego,5,2022-01-18,60179,60179,51468,8711,262111,262118,224157,37961,1093,109,109,196,4735,4735,4626,4626
San Francisco,5,2022-01-18,11094,11094,5228,5866,95779,95780,45179,50601,225,12,12,37,726,726,714,714
San Joaquin,5,2022-01-18,12879,12879,8065,4814,61084,61084,38294,22790,229,23,23,58,2040,2040,2017,2017
San Luis Obispo,5,2022-01-18,3944,3944,2698,1246,21462,21462,14678,6784,45,11,11,13,392,392,381,381
San Mateo,5,2022-01-18,11812,11812,8574,3238,96700,96701,70247,26454,101,11,11,30,624,624,613,613
Santa Barbara,5,2022-01-18,6916,6916,4560,2356,42025,42025,27721,14304,126,10,10,14,601,601,591,591
Santa Clara,5,2022-01-18,28092,28092,23803,4289,235864,235869,199932,35937,457,30,30,83,2055,2055,2025,2025
Santa Cruz,5,2022-01-18,4119,4119,2866,1253,38714,38714,26849,11865,27,3,3,3,240,240,237,237
Shasta,5,2022-01-18,1430,1430,931,499,9546,9546,6213,3333,58,8,8,15,470,470,462,462
Siskiyou,5,2022-01-18,164,164,116,48,877,877,617,260,1,1,1,1,65,65,64,64
Solano,5,2022-01-18,6435,6435,4258,2177,35672,35672,23643,12029,119,4,4,24,409,409,405,405
Sonoma,5,2022-01-18,7586,7586,5082,2504,43173,43173,28935,14238,86,7,7,19,445,445,438,438
Stanislaus,5,2022-01-18,7299,7299,4084,3215,29106,29106,16312,12794,234,15,15,39,1486,1486,1471,1471
Sutter,5,2022-01-18,1214,1214,802,412,4867,4867,3224,1643,0,3,3,0,203,203,200,200
Tehama,5,2022-01-18,625,625,357,268,2453,2453,1404,1049,15,5,5,2,175,175,170,170
Trinity,5,2022-01-18,50,50,28,22,278,278,156,122,0,1,1,0,20,20,19,19
Tulare,5,2022-01-18,7737,7737,4313,3424,27766,27766,15470,12296,103,17,17,13,1351,1351,1334,1334
Tuolumne,5,2022-01-18,901,901,548,353,3925,3925,2387,1538,15,8,8,2,163,163,155,155
Ventura,5,2022-01-18,11490,11490,8535,2955,66889,66889,49688,17201,290,44,44,63,1306,1306,1262,1262
Yolo,5,2022-01-18,2746,2746,1889,857,40187,40187,27612,12575,18,2,2,6,307,307,305,305
Yuba,5,2022-01-18,1012,1012,684,328,3753,3753,2540,1213,43,2,2,8,106,106,104,104
Alameda,6,2022-01-25,17549,17549,13323,4226,160906,160911,122400,38511,377,39,39,70,1658,1658,1619,1619
Amador,6,2022-01-25,481,481,315,166,4009,4009,2625,1384,12,0,0,4,73,73,73,73
Butte,6,2022-01-25,1745,1745,1388,357,9170,9170,7311,1859,87,8,8,9,380,380,372,372
Calaveras,6,2022-01-25,473,473,326,147,2192,2192,1515,677,3,2,2,2,99,99,97,97
Colusa,6,2022-01-25,173,173,125,48,876,876,632,244,7,0,0,0,21,21,21,21
Contra Costa,6,2022-01-25,12221,12221,7971,4250,80948,80950,52893,28057,209,24,24,74,1156,1156,1132,1132
Del Norte,6,2022-01-25,357,357,255,102,3863,3863,2751,1112,4,0,0,2,42,42,42,42
El Dorado,6,2022-01-25,1319,1319,909,410,7054,7054,4883,2171,20,4,4,7,197,197,193,193
Fresno,6,2022-01-25,16231,16231,10794,5437,66147,66147,44100,22047,499,39,39,82,2536,2536,2497,2497
Glenn,6,2022-01-25,236,236,165,71,889,889,623,266,3,0,0,0,45,45,45,45
Humboldt,6,2022-01-25,820,820,582,238,7159,7159,5085,2074,25,3,3,3,132,132,129,129
Imperial,6,2022-01-25,3474,3474,2390,1084,12821,12821,8842,3979,74,17,17,29,882,882,865,865
Inyo,6,2022-01-25,126,126,91,35,611,611,443,168,3,0,0,0,53,53,53,53
Kern,6,2022-01-25,9326,9326,6800,2526,50287,50287,36770,13517,274,51,51,57,2168,2168,2117,2117
Kings,6,2022-01-25,3746,3746,2585,1161,17227,17227,11916,5311,39,3,3,4,402,402,399,399
Lake,6,2022-01-25,706,706,469,237,3201,3201,2130,1071,8,2,2,4,123,123,121,121
Lassen,6,2022-01-25,409,409,305,104,3647,3647,2726,921,6,0,0,0,54,54,54,54
Los Angeles,6,2022-01-25,142198,142203,126212,15991,1548123,1548177,1375843,172334,3754,616,616,780,29106,29106,28490,28490
Madera,6,2022-01-25,2499,2499,1658,841,11274,11274,7500,3774,51,6,6,11,353,353,347,347
Marin,6,2022-01-25,1685,1685,1130,555,16606,16606,11147,5459,34,5,5,10,269,269,264,264
Mariposa,6,2022-01-25,133,133,87,46,907,907,592,315,0,0,0,0,22,22,22,22
Mendocino,6,2022-01-25,798,798,476,322,4419,4419,2647,1772,21,2,2,3,111,111,109,109
Merced,6,2022-01-25,3041,3041,2198,843,12220,12220,8853,3367,57,8,8,10,747,747,739,739
Modoc,6,2022-01-25,13,13,10,3,107,107,79,28,2,0,0,0,7,7,7,7
Mono,6,2022-01-25,84,84,46,38,400,400,221,179,1,0,0,0,5,5,5,5
Monterey,6,2022-01-25,4828,4828,2692,2136,30402,30402,16959,13443,90,8,8,19,670,670,662,662
Napa,6,2022-01-25,1511,1511,1128,383,11356,11356,8499,2857,21,5,5,5,117,117,112,112
Nevada,6,2022-01-25,942,942,629,313,4601,4601,3080,1521,27,3,3,5,118,118,115,115
Orange,6,2022-01-25,23374,23374,18026,5348,219694,219699,169895,49804,907,187,187,179,6504,6504,6317,6317
Placer,6,2022-01-25,3409,3409,2203,1206,17777,17777,11512,6265,198,9,9,49,547,547,538,538
Plumas,6,2022-01-25,201,201,136,65,812,812,551,261,5,0,0,0,12,12,12,12
Riverside,6,2022-01-25,28824,28824,20639,8185,150240,150245,107792,42453,903,116,116,171,6005,6005,5889,5889
Sacramento,6,2022-01-25,15760,15760,11060,4700,92681,92685,65158,27527,559,71,71,98,2718,2718,2647,2647
San Benito,6,2022-01-25,711,711,528,183,3762,3762,2800,962,5,0,0,3,88,88,88,88
San Bernardino,6,2022-01-25,24504,24504,18552,5952,141978,141983,107766,34217,972,175,175,230,7128,7128,6953,6953
San Diego,6,2022-01-25,44876,44876,39590,5286,236488,236494,208874,27620,1052,132,132,224,4867,4867,4735,4735
San Francisco,6,2022-01-25,7423,7423,3955,3468,84501,84504,45156,39348,235,20,20,36,746,746,726,726
San Joaquin,6,2022-01-25,9519,9519,6474,3045,53878,53878,36785,17093,251,35,35,72,2075,2075,2040,2040
San Luis Obispo,6,2022-01-25,3204,3204,2352,852,20184,20184,14834,5350,43,10,10,12,402,402,392,392
San Mateo,6,2022-01-25,7504,7504,5791,1713,89617,89621,69298,20323,134,20,20,27,644,644,624,624
Santa Barbara,6,2022-01-25,5973,5973,4251,1722,41620,41620,29680,11940,126,16,16,18,617,617,601,601
Santa Clara,6,2022-01-25,21092,21092,18491,2601,222819,222824,195469,27355,419,52,52,87,2107,2107,2055,2055
Santa Cruz,6,2022-01-25,5074,5074,3769,1305,49506,49506,36822,12684,37,2,2,4,242,242,240,240
Shasta,6,2022-01-25,1390,1390,977,413,9629,9629,6787,2842,79,6,6,10,476,476,470,470
Siskiyou,6,2022-01-25,128,128,96,32,735,735,551,184,5,3,3,2,68,68,65,65
Solano,6,2022-01-25,4768,4768,3414,1354,31299,31299,22451,8848,143,14,14,28,423,423,409,409
Sonoma,6,2022-01-25,6334,6334,4566,1768,40467,40467,29252,11215,87,8,8,20,453,453,445,445
Stanislaus,6,2022-01-25,5817,5817,3593,2224,26600,26600,16490,10110,277,23,23,48,1509,1509,1486,1486
Sutter,6,2022-01-25,953,953,678,275,4724,4724,3372,1352,0,2,2,0,205,205,203,203
Tehama,6,2022-01-25,523,523,329,194,2505,2505,1580,925,18,4,4,5,179,179,175,175
Trinity,6,2022-01-25,59,59,36,23,314,314,195,119,0,0,0,0,20,20,20,20
Tulare,6,2022-01-25,7002,7002,4302,2700,27935,27935,17209,10726,145,9,9,13,1360,1360,1351,1351
Tuolumne,6,2022-01-25,935,935,623,312,3640,3640,2427,1213,17,1,1,3,164,164,163,163
Ventura,6,2022-01-25,8319,8319,6539,1780,64200,64200,50561,13639,279,29,29,66,1335,1335,1306,1306
Yolo,6,2022-01-25,2061,2061,1521,540,38866,38866,28697,10169,17,12,12,5,319,319,307,307
Yuba,6,2022-01-25,821,821,596,225,3543,3543,2577,966,49,3,3,9,109,109,106,106
Alameda,7,2022-02-01,9885,9885,7926,1959,132323,132328,106264,26064,325,52,52,78,1710,1710,1658,1658
Amador,7,2022-02-01,351,351,250,101,3373,3373,2399,974,14,2,2,4,75,75,73,73
Butte,7,2022-02-01,1108,1108,924,184,7399,7399,6178,1221,76,6,6,6,386,386,380,380
Calaveras,7,2022-02-01,252,252,187,65,1840,1840,1364,476,3,7,7,2,106,106,99,99
Colusa,7,2022-02-01,96,96,74,22,683,683,526,157,8,0,0,0,21,21,21,21
Contra Costa,7,2022-02-01,6593,6593,4653,1940,65710,65712,46452,19260,212,42,42,51,1198,1198,1156,1156
Del Norte,7,2022-02-01,289,289,219,70,3898,3898,2954,944,4,2,2,1,44,44,42,42
El Dorado,7,2022-02-01,683,683,507,176,5891,5891,4381,1510,14,2,2,5,199,199,197,197
Fresno,7,2022-02-01,10140,10140,7282,2858,52825,52825,38021,14804,506,40,40,100,2576,2576,2536,2536
Glenn,7,2022-02-01,186,186,139,47,740,740,555,185,2,2,2,0,47,47,45,45
Humboldt,7,2022-02-01,562,562,427,135,5689,5689,4318,1371,19,3,3,2,135,135,132,132
Imperial,7,2022-02-01,1873,1873,1381,492,10621,10621,7850,2771,73,16,16,24,898,898,882,882
Inyo,7,2022-02-01,60,60,46,14,471,471,364,107,5,3,3,0,56,56,53,53
Kern,7,2022-02-01,5120,5120,3975,1145,40295,40295,31337,8958,237,41,41,50,2209,2209,2168,2168
Kings,7,2022-02-01,2174,2174,1611,563,13380,13380,9927,3453,49,6,6,5,408,408,402,402
Lake,7,2022-02-01,442,442,317,125,3024,3024,2163,861,6,4,4,5,127,127,123,123
Lassen,7,2022-02-01,258,258,203,55,3420,3420,2703,717,7,2,2,0,56,56,54,54
Los Angeles,7,2022-02-01,66276,66277,60343,5934,1265957,1266007,1153816,112191,2816,668,668,699,29774,29774,29106,29106
Madera,7,2022-02-01,1521,1521,1090,431,8937,8937,6421,2516,47,7,7,7,360,360,353,353
Marin,7,2022-02-01,955,955,690,265,13236,13236,9584,3652,27,6,6,8,275,275,269,269
Mariposa,7,2022-02-01,86,86,61,25,804,804,567,237,0,2,2,0,24,24,22,22
Mendocino,7,2022-02-01,426,426,279,147,3293,3293,2167,1126,14,3,3,4,114,114,111,111
Merced,7,2022-02-01,1909,1909,1469,440,9811,9811,7563,2248,47,12,12,12,759,759,747,747
Modoc,7,2022-02-01,12,12,9,3,74,74,58,16,1,0,0,0,7,7,7,7
Mono,7,2022-02-01,45,45,28,17,329,329,202,127,0,0,0,0,5,5,5,5
Monterey,7,2022-02-01,3150,3150,1942,1208,25621,25621,15847,9774,87,11,11,12,681,681,670,670
Napa,7,2022-02-01,989,989,783,206,9073,9073,7191,1882,20,7,7,4,124,124,117,117
Nevada,7,2022-02-01,518,518,373,145,3676,3676,2649,1027,26,1,1,7,119,119,118,118
Orange,7,2022-02-01,10758,10758,8746,2012,170944,170949,139247,31702,685,159,159,161,6663,6663,6504,6504
Placer,7,2022-02-01,2020,2020,1414,606,14476,14476,10160,4316,147,24,24,46,571,571,547,547
Plumas,7,2022-02-01,118,118,86,32,698,698,508,190,0,1,1,0,13,13,12,12
Riverside,7,2022-02-01,14032,14032,10717,3315,115415,115420,88353,27067,743,116,116,167,6121,6121,6005,6005
Sacramento,7,2022-02-01,9069,9069,6807,2262,73839,73842,55542,18300,501,91,91,102,2809,2809,2718,2718
San Benito,7,2022-02-01,431,431,339,92,3210,3210,2532,678,5,2,2,3,90,90,88,88
San Bernardino,7,2022-02-01,12007,12007,9612,2395,111751,111756,89605,22151,721,183,183,193,7311,7311,7128,7128
San Diego,7,2022-02-01,22095,22095,20017,2078,174859,174865,158580,16285,912,106,106,217,4973,4973,4867,4867
San Francisco,7,2022-02-01,3493,3493,2072,1421,65135,65136,38693,26443,202,25,25,48,771,771,746,746
San Joaquin,7,2022-02-01,5144,5144,3769,1375,41082,41082,30181,10901,212,37,37,75,2112,2112,2075,2075
San Luis Obispo,7,2022-02-01,1764,1764,1377,387,14986,14986,11695,3291,42,16,16,9,418,418,402,402
San Mateo,7,2022-02-01,3870,3870,3145,725,72298,72302,58835,13467,136,7,7,21,651,651,644,644
Santa Barbara,7,2022-02-01,3329,3329,2532,797,34189,34189,26058,8131,100,20,20,13,637,637,617,617
Santa Clara,7,2022-02-01,12629,12629,11380,1249,203216,203223,183216,20007,409,44,44,90,2151,2151,2107,2107
Santa Cruz,7,2022-02-01,3017,3017,2373,644,50184,50185,39556,10629,38,6,6,6,248,248,242,242
Shasta,7,2022-02-01,846,846,637,209,7974,7974,6010,1964,64,16,16,9,492,492,476,476
Siskiyou,7,2022-02-01,127,127,101,26,752,752,598,154,10,3,3,1,71,71,68,68
Solano,7,2022-02-01,3837,3837,2935,902,29011,29011,22204,6807,126,6,6,29,429,429,423,423
Sonoma,7,2022-02-01,3108,3108,2388,720,30295,30295,23345,6950,76,11,11,15,464,464,453,453
Stanislaus,7,2022-02-01,3456,3456,2337,1119,21616,21616,14653,6963,260,39,39,52,1548,1548,1509,1509
Sutter,7,2022-02-01,583,583,443,140,3740,3740,2855,885,0,5,5,0,210,210,205,205
Tehama,7,2022-02-01,370,370,254,116,1997,1997,1373,624,17,2,2,5,181,181,179,179
Trinity,7,2022-02-01,39,39,26,13,194,194,131,63,0,0,0,0,20,20,20,20
Tulare,7,2022-02-01,4243,4243,2848,1395,21717,21717,14613,7104,151,23,23,20,1383,1383,1360,1360
Tuolumne,7,2022-02-01,679,679,486,193,3152,3152,2263,889,18,2,2,2,166,166,164,164
Ventura,7,2022-02-01,4112,4112,3393,719,49832,49832,41176,8656,249,33,33,47,1368,1368,1335,1335
Yolo,7,2022-02-01,1221,1221,956,265,36455,36455,28552,7903,17,6,6,6,325,325,319,319
Yuba,7,2022-02-01,480,480,371,109,2779,2779,2151,628,74,3,3,12,112,112,109,109
Alameda,8,2022-02-08,5333,5333,4473,860,113312,113317,95120,18197,189,46,46,41,1756,1756,1710,1710
Amador,8,2022-02-08,180,180,137,43,2767,2767,2098,669,14,3,3,4,78,78,75,75
Butte,8,2022-02-08,695,695,601,94,6205,6205,5377,828,81,8,8,11,394,394,386,386
Calaveras,8,2022-02-08,169,169,133,36,1420,1420,1117,303,3,0,0,2,106,106,106,106
Colusa,8,2022-02-08,72,72,58,14,549,549,446,103,1,0,0,0,21,21,21,21
Contra Costa,8,2022-02-08,3779,3779,2854,925,52184,52184,39431,12753,146,31,31,48,1229,1229,1198,1198
Del Norte,8,2022-02-08,293,293,235,58,3961,3961,3167,794,7,0,0,1,44,44,44,44
El Dorado,8,2022-02-08,384,384,303,81,4931,4931,3890,1041,18,3,3,5,202,202,199,199
Fresno,8,2022-02-08,5771,5771,4421,1350,41262,41262,31679,9583,454,51,51,86,2627,2627,2576,2576
Glenn,8,2022-02-08,85,85,67,18,569,569,451,118,3,3,3,0,50,50,47,47
Humboldt,8,2022-02-08,452,452,363,89,4812,4812,3861,951,20,1,1,3,136,136,135,135
Imperial,8,2022-02-08,994,994,779,215,7540,7540,5916,1624,50,13,13,25,911,911,898,898
Inyo,8,2022-02-08,32,32,26,6,440,440,358,82,3,0,0,0,56,56,56,56
Kern,8,2022-02-08,3166,3166,2585,581,33677,33677,27543,6134,179,33,33,43,2242,2242,2209,2209
Kings,8,2022-02-08,1180,1180,928,252,9756,9756,7690,2066,51,15,15,4,423,423,408,408
Lake,8,2022-02-08,324,324,247,77,2647,2647,2021,626,14,1,1,5,128,128,127,127
Lassen,8,2022-02-08,127,127,105,22,3056,3056,2534,522,5,1,1,0,57,57,56,56
Los Angeles,8,2022-02-08,33549,33549,31168,2381,1139436,1139485,1059282,80203,2069,618,618,528,30392,30392,29774,29774
Madera,8,2022-02-08,969,969,740,229,7989,7989,6120,1869,27,2,2,9,362,362,360,360
Marin,8,2022-02-08,597,597,459,138,11104,11104,8558,2546,31,6,6,7,281,281,275,275
Mariposa,8,2022-02-08,46,46,35,11,539,539,406,133,0,0,0,0,24,24,24,24
Mendocino,8,2022-02-08,319,319,227,92,2761,2761,1966,795,12,2,2,5,116,116,114,114
Merced,8,2022-02-08,1053,1053,854,199,7856,7856,6385,1471,46,14,14,12,773,773,759,759
Modoc,8,2022-02-08,26,26,21,5,238,238,195,43,4,0,0,0,7,7,7,7
Mono,8,2022-02-08,32,32,21,11,246,246,165,81,0,0,0,0,5,5,5,5
Monterey,8,2022-02-08,2023,2023,1360,663,21603,21603,14594,7009,66,9,9,15,690,690,681,681
Napa,8,2022-02-08,662,662,549,113,7572,7572,6290,1282,18,6,6,2,130,130,124,124
Nevada,8,2022-02-08,316,316,242,74,3102,3102,2384,718,28,3,3,3,122,122,119,119
Orange,8,2022-02-08,5843,5843,4958,885,150456,150461,127829,22632,493,122,122,124,6785,6785,6663,6663
Placer,8,2022-02-08,1172,1172,878,294,11694,11694,8786,2908,160,18,18,31,589,589,571,571
Plumas,8,2022-02-08,77,77,59,18,508,508,393,115,1,0,0,0,13,13,13,13
Riverside,8,2022-02-08,7267,7267,5860,1407,90327,90332,72936,17396,497,98,98,124,6219,6219,6121,6121
Sacramento,8,2022-02-08,5469,5469,4343,1126,61604,61605,49020,12585,386,68,68,93,2877,2877,2809,2809
San Benito,8,2022-02-08,291,291,241,50,2554,2554,2114,440,5,0,0,4,90,90,90,90
San Bernardino,8,2022-02-08,6198,6198,5193,1005,86473,86478,72539,13939,510,141,141,152,7452,7452,7311,7311
San Diego,8,2022-02-08,12439,12439,11512,927,147610,147615,136689,10926,748,111,111,173,5084,5084,4973,4973
San Francisco,8,2022-02-08,2345,2345,1532,813,55096,55096,35975,19121,165,25,25,43,796,796,771,771
San Joaquin,8,2022-02-08,2970,2970,2312,658,35756,35756,27901,7855,163,38,38,60,2150,2150,2112,2112
San Luis Obispo,8,2022-02-08,1120,1120,918,202,11797,11797,9673,2124,26,12,12,7,430,430,418,418
San Mateo,8,2022-02-08,2240,2240,1899,341,60670,60672,51507,9165,79,19,19,17,670,670,651,651
Santa Barbara,8,2022-02-08,1964,1964,1573,391,27671,27671,22179,5492,72,15,15,16,652,652,637,637
Santa Clara,8,2022-02-08,7294,7294,6719,575,172044,172049,158596,13453,352,32,32,68,2183,2183,2151,2151
Santa Cruz,8,2022-02-08,1737,1737,1436,301,37891,37891,31399,6492,34,2,2,4,250,250,248,248
Shasta,8,2022-02-08,637,637,507,130,6703,6703,5344,1359,68,16,16,11,508,508,492,492
Siskiyou,8,2022-02-08,86,86,72,14,653,653,543,110,12,1,1,0,72,72,71,71
Solano,8,2022-02-08,1789,1789,1442,347,22120,22120,17847,4273,74,5,5,26,434,434,429,429
Sonoma,8,2022-02-08,1890,1890,1531,359,26335,26335,21376,4959,51,8,8,15,472,472,464,464
Stanislaus,8,2022-02-08,2224,2224,1618,606,18124,18124,13223,4901,233,38,38,41,1586,1586,1548,1548
Sutter,8,2022-02-08,313,313,251,62,3177,3177,2557,620,0,5,5,0,215,215,210,210
Tehama,8,2022-02-08,261,261,192,69,1544,1544,1140,404,15,4,4,5,185,185,181,181
Trinity,8,2022-02-08,17,17,12,5,132,132,96,36,0,0,0,0,20,20,20,20
Tulare,8,2022-02-08,2431,2431,1760,671,17176,17176,12466,4710,128,28,28,21,1411,1411,1383,1383
Tuolumne,8,2022-02-08,306,306,234,72,2529,2529,1939,590,11,2,2,2,168,168,166,166
Ventura,8,2022-02-08,2476,2476,2126,350,41200,41200,35421,5779,189,44,44,45,1412,1412,1368,1368
Yolo,8,2022-02-08,812,812,668,144,30260,30260,24892,5368,6,14,14,4,339,339,325,325
Yuba,8,2022-02-08,317,317,258,59,2371,2371,1932,439,34,3,3,13,115,115,112,112
Alameda,9,2022-02-15,3117,3117,2710,407,98453,98458,85705,12753,190,35,35,45,1791,1791,1756,1756
Amador,9,2022-02-15,96,96,77,19,2290,2290,1835,455,7,3,3,3,81,81,78,78
Butte,9,2022-02-15,430,430,383,47,5229,5229,4667,562,61,13,13,8,407,407,394,394
Calaveras,9,2022-02-15,70,70,58,12,1144,1144,943,201,4,3,3,3,109,109,106,106
Colusa,9,2022-02-15,27,27,23,4,399,399,337,62,6,0,0,0,21,21,21,21
Contra Costa,9,2022-02-15,2206,2206,1761,445,44492,44492,35556,8936,108,19,19,37,1248,1248,1229,1229
Del Norte,9,2022-02-15,192,192,161,31,3351,3351,2800,551,6,0,0,3,44,44,44,44
El Dorado,9,2022-02-15,233,233,192,41,4283,4283,3541,742,18,2,2,3,204,204,202,202
Fresno,9,2022-02-15,3473,3473,2804,669,33186,33186,26851,6335,362,32,32,67,2659,2659,2627,2627
Glenn,9,2022-02-15,55,55,45,10,490,490,407,83,3,1,1,0,51,51,50,50
Humboldt,9,2022-02-15,296,296,248,48,4038,4038,3385,653,21,0,0,2,136,136,136,136
Imperial,9,2022-02-15,545,545,448,97,5648,5648,4649,999,44,11,11,17,922,922,911,911
Inyo,9,2022-02-15,25,25,21,4,373,373,316,57,2,0,0,0,56,56,56,56
Kern,9,2022-02-15,1884,1884,1604,280,26993,26993,23004,3989,142,31,31,40,2273,2273,2242,2242
Kings,9,2022-02-15,695,695,573,122,7357,7357,6083,1274,39,6,6,5,429,429,423,423
Lake,9,2022-02-15,247,247,199,48,2193,2193,1765,428,9,2,2,4,130,130,128,128
Lassen,9,2022-02-15,147,147,126,21,2652,2652,2280,372,2,2,2,0,59,59,57,57
Los Angeles,9,2022-02-15,19573,19573,18472,1101,1038938,1038985,981041,57944,1447,436,436,388,30828,30828,30392,30392
Madera,9,2022-02-15,563,563,454,109,6405,6405,5178,1227,29,2,2,8,364,364,362,362
Marin,9,2022-02-15,352,352,286,66,10093,10093,8196,1897,23,5,5,6,286,286,281,281
Mariposa,9,2022-02-15,26,26,21,5,420,420,335,85,0,0,0,0,24,24,24,24
Mendocino,9,2022-02-15,176,176,134,42,2357,2357,1792,565,16,1,1,7,117,117,116,116
Merced,9,2022-02-15,705,705,597,108,6597,6597,5590,1007,36,12,12,10,785,785,773,773
Modoc,9,2022-02-15,18,18,15,3,118,118,100,18,0,0,0,0,7,7,7,7
Mono,9,2022-02-15,9,9,6,3,156,156,113,43,0,0,0,0,5,5,5,5
Monterey,9,2022-02-15,1145,1145,831,314,16275,16275,11838,4437,54,12,12,12,702,702,690,690
Napa,9,2022-02-15,374,374,323,51,6282,6282,5420,862,10,2,2,1,132,132,130,130
Nevada,9,2022-02-15,152,152,123,29,2517,2517,2040,477,17,3,3,4,125,125,122,122
Orange,9,2022-02-15,3751,3751,3294,457,131327,131332,115426,15906,336,104,104,79,6889,6889,6785,6785
Placer,9,2022-02-15,539,539,428,111,9890,9890,7865,2025,106,12,12,24,601,601,589,589
Plumas,9,2022-02-15,34,34,28,6,411,411,335,76,1,0,0,0,13,13,13,13
Riverside,9,2022-02-15,4215,4215,3549,666,72125,72129,60821,11308,379,81,81,93,6300,6300,6219,6219
Sacramento,9,2022-02-15,3177,3177,2644,533,52420,52420,43689,8731,340,52,52,58,2929,2929,2877,2877
San Benito,9,2022-02-15,143,143,123,20,2082,2082,1791,291,0,1,1,3,91,91,90,90
San Bernardino,9,2022-02-15,3326,3326,2888,438,70564,70568,61367,9201,342,109,109,119,7561,7561,7452,7452
San Diego,9,2022-02-15,7327,7327,6893,434,122336,122341,115173,7168,557,88,88,131,5172,5172,5084,5084
San Francisco,9,2022-02-15,1456,1456,1029,427,47047,47047,33303,13744,127,24,24,40,820,820,796,796
San Joaquin,9,2022-02-15,1840,1840,1505,335,29846,29846,24472,5374,136,36,36,47,2186,2186,2150,2150
San Luis Obispo,9,2022-02-15,737,737,629,108,9859,9859,8419,1440,25,12,12,5,442,442,430,430
San Mateo,9,2022-02-15,1223,1223,1074,149,53965,53965,47386,6579,54,14,14,11,684,684,670,670
Santa Barbara,9,2022-02-15,1015,1015,852,163,23633,23633,19846,3787,66,11,11,12,663,663,652,652
Santa Clara,9,2022-02-15,4221,4221,3957,264,153536,153541,144020,9521,288,30,30,56,2213,2213,2183,2183
Santa Cruz,9,2022-02-15,928,928,798,130,29982,29982,25813,4169,22,3,3,4,253,253,250,250
Shasta,9,2022-02-15,438,438,365,73,5789,5789,4832,957,70,9,9,14,517,517,508,508
Siskiyou,9,2022-02-15,68,68,59,9,530,530,458,72,7,1,1,3,73,73,72,72
Solano,9,2022-02-15,1124,1124,946,178,18833,18833,15862,2971,75,2,2,21,436,436,434,434
Sonoma,9,2022-02-15,1017,1017,860,157,20784,20784,17602,3182,50,6,6,8,478,478,472,472
Stanislaus,9,2022-02-15,1283,1283,993,290,14438,14438,11196,3242,191,32,32,44,1618,1618,1586,1586
Sutter,9,2022-02-15,225,225,189,36,2777,2777,2335,442,0,2,2,0,217,217,215,215
Tehama,9,2022-02-15,161,161,126,35,1391,1391,1090,301,18,4,4,5,189,189,185,185
Trinity,9,2022-02-15,21,21,16,5,183,183,142,41,0,0,0,0,20,20,20,20
Tulare,9,2022-02-15,1325,1325,1021,304,14779,14779,11412,3367,105,25,25,16,1436,1436,1411,1411
Tuolumne,9,2022-02-15,173,173,140,33,2168,2168,1752,416,15,4,4,1,172,172,168,168
Ventura,9,2022-02-15,1372,1372,1216,156,34655,34655,30734,3921,146,31,31,24,1443,1443,1412,1412
Yolo,9,2022-02-15,428,428,366,62,26297,26297,22495,3802,8,5,5,1,344,344,339,339
Yuba,9,2022-02-15,203,203,172,31,2035,2035,1728,307,23,0,0,10,115,115,115,115
Alameda,10,2022-02-22,1777,1777,1591,186,74833,74837,66984,7853,130,27,27,24,1818,1818,1791,1791
Amador,10,2022-02-22,61,61,51,10,1959,1959,1640,319,5,3,3,3,84,84,81,81
Butte,10,2022-02-22,244,244,223,21,4483,4483,4099,384,55,11,11,5,418,418,407,407
Calaveras,10,2022-02-22,39,39,33,6,883,883,758,125,2,5,5,0,114,114,109,109
Colusa,10,2022-02-22,25,25,22,3,364,364,318,46,7,0,0,0,21,21,21,21
Contra Costa,10,2022-02-22,1249,1249,1044,205,34210,34210,28580,5630,68,18,18,26,1266,1266,1248,1248
Del Norte,10,2022-02-22,124,124,108,16,2783,2783,2411,372,9,0,0,2,44,44,44,44
El Dorado,10,2022-02-22,147,147,126,21,3554,3554,3053,501,7,1,1,6,205,205,204,204
Fresno,10,2022-02-22,1846,1846,1557,289,26766,26766,22604,4162,268,25,25,58,2684,2684,2659,2659
Glenn,10,2022-02-22,28,28,24,4,412,412,356,56,1,1,1,0,52,52,51,51
Humboldt,10,2022-02-22,196,196,170,26,3296,3296,2863,433,22,3,3,1,139,139,136,136
Imperial,10,2022-02-22,382,382,327,55,5005,5005,4289,716,33,7,7,9,929,929,922,922
Inyo,10,2022-02-22,12,12,11,1,324,324,284,40,0,0,0,0,56,56,56,56
Kern,10,2022-02-22,1135,1135,999,136,23932,23932,21075,2857,97,20,20,26,2293,2293,2273,2273
Kings,10,2022-02-22,414,414,355,59,6604,6604,5675,929,32,5,5,5,434,434,429,429
Lake,10,2022-02-22,170,170,143,27,2037,2037,1712,325,8,5,5,1,135,135,130,130
Lassen,10,2022-02-22,109,109,96,13,2170,2170,1924,246,1,0,0,0,59,59,59,59
Los Angeles,10,2022-02-22,11023,11023,10535,488,888919,888962,849737,39225,935,326,326,269,31154,31154,30828,30828
Madera,10,2022-02-22,289,289,243,46,4765,4765,4013,752,31,4,4,8,368,368,364,364
Marin,10,2022-02-22,188,188,159,29,8615,8615,7285,1330,13,3,3,3,289,289,286,286
Mariposa,10,2022-02-22,19,19,16,3,357,357,298,59,0,1,1,0,25,25,24,24
Mendocino,10,2022-02-22,113,113,91,22,1940,1940,1557,383,8,2,2,2,119,119,117,117
Merced,10,2022-02-22,394,394,345,49,5270,5270,4621,649,25,9,9,6,794,794,785,785
Modoc,10,2022-02-22,5,5,4,1,58,58,51,7,1,0,0,0,7,7,7,7
Mono,10,2022-02-22,7,7,5,2,163,163,125,38,0,1,1,0,6,6,5,5
Monterey,10,2022-02-22,703,703,542,161,13574,13574,10503,3071,41,6,6,6,708,708,702,702
Napa,10,2022-02-22,209,209,186,23,5071,5071,4510,561,7,4,4,3,136,136,132,132
Nevada,10,2022-02-22,94,94,79,15,2080,2080,1758,322,14,2,2,5,127,127,125,125
Orange,10,2022-02-22,2316,2316,2090,226,110312,110317,99533,10784,263,72,72,68,6961,6961,6889,6889
Placer,10,2022-02-22,312,312,260,52,8652,8652,7203,1449,94,7,7,14,608,608,601,601
Plumas,10,2022-02-22,22,22,19,3,341,341,289,52,0,0,0,0,13,13,13,13
Riverside,10,2022-02-22,2261,2261,1973,288,62776,62779,54832,7947,268,48,48,62,6348,6348,6300,6300
Sacramento,10,2022-02-22,1772,1772,1530,242,43699,43700,37792,5908,234,33,33,42,2962,2962,2929,2929
San Benito,10,2022-02-22,93,93,82,11,1815,1815,1609,206,0,0,0,1,91,91,91,91
San Bernardino,10,2022-02-22,1724,1724,1542,182,60766,60769,54398,6371,240,76,76,78,7637,7637,7561,7561
San Diego,10,2022-02-22,4268,4268,4068,200,99664,99669,95042,4627,462,55,55,100,5227,5227,5172,5172
San Francisco,10,2022-02-22,969,969,733,236,40281,40281,30421,9860,101,11,11,27,831,831,820,820
San Joaquin,10,2022-02-22,952,952,811,141,25264,25264,21574,3690,92,25,25,25,2211,2211,2186,2186
San Luis Obispo,10,2022-02-22,423,423,373,50,8120,8120,7165,955,10,14,14,3,456,456,442,442
San Mateo,10,2022-02-22,624,624,562,62,40985,40985,36939,4046,45,8,8,7,692,692,684,684
Santa Barbara,10,2022-02-22,541,541,470,71,20070,20070,17475,2595,38,2,2,9,665,665,663,663
Santa Clara,10,2022-02-22,2309,2309,2195,114,110175,110180,104688,5492,220,26,26,55,2239,2239,2213,2213
Santa Cruz,10,2022-02-22,541,541,480,61,24500,24500,21735,2765,18,2,2,5,255,255,253,253
Shasta,10,2022-02-22,222,222,192,30,4934,4934,4273,661,53,10,10,1,527,527,517,517
Siskiyou,10,2022-02-22,45,45,40,5,465,465,414,51,5,5,5,0,78,78,73,73
Solano,10,2022-02-22,609,609,531,78,14743,14743,12865,1878,49,5,5,14,441,441,436,436
Sonoma,10,2022-02-22,601,601,526,75,16473,16473,14429,2044,35,2,2,7,480,480,478,478
Stanislaus,10,2022-02-22,661,661,538,123,12663,12663,10333,2330,172,25,25,26,1643,1643,1618,1618
Sutter,10,2022-02-22,117,117,102,15,2143,2143,1868,275,0,2,2,0,219,219,217,217
Tehama,10,2022-02-22,87,87,71,16,1171,1171,963,208,7,10,10,2,199,199,189,189
Trinity,10,2022-02-22,13,13,11,2,192,192,156,36,0,0,0,0,20,20,20,20
Tulare,10,2022-02-22,663,663,538,125,11224,11224,9131,2093,78,17,17,11,1453,1453,1436,1436
Tuolumne,10,2022-02-22,89,89,75,14,1653,1653,1393,260,5,6,6,3,178,178,172,172
Ventura,10,2022-02-22,848,848,771,77,28167,28167,25621,2546,104,25,25,19,1468,1468,1443,1443
Yolo,10,2022-02-22,266,266,235,31,21872,21872,19320,2552,3,4,4,1,348,348,344,344
Yuba,10,2022-02-22,123,123,108,15,1704,1704,1498,206,17,1,1,6,116,116,115,115
Alameda,11,2022-03-01,1415,1415,1298,117,76363,76368,70041,6327,117,14,14,23,1832,1832,1818,1818
Amador,11,2022-03-01,56,56,49,7,1973,1973,1714,259,8,1,1,1,85,85,84,84
Butte,11,2022-03-01,164,164,153,11,4141,4141,3859,282,43,4,4,3,422,422,418,418
Calaveras,11,2022-03-01,35,35,31,4,1200,1200,1063,137,0,3,3,0,117,117,114,114
Colusa,11,2022-03-01,9,9,8,1,398,398,358,40,7,0,0,0,21,21,21,21
Contra Costa,11,2022-03-01,811,811,703,108,33258,33258,28862,4396,46,17,17,16,1283,1283,1266,1266
Del Norte,11,2022-03-01,71,71,64,7,2638,2638,2354,284,4,3,3,1,47,47,44,44
El Dorado,11,2022-03-01,87,87,77,10,3516,3516,3119,397,3,2,2,6,207,207,205,205
Fresno,11,2022-03-01,1193,1193,1043,150,24518,24518,21447,3071,187,27,27,43,2711,2711,2684,2684
Glenn,11,2022-03-01,17,17,15,2,407,407,363,44,1,0,0,0,52,52,52,52
Humboldt,11,2022-03-01,129,129,116,13,2846,2846,2549,297,9,1,1,1,140,140,139,139
Imperial,11,2022-03-01,231,231,205,26,4585,4585,4061,524,15,7,7,10,936,936,929,929
Inyo,11,2022-03-01,7,7,6,1,367,367,331,36,0,0,0,0,56,56,56,56
Kern,11,2022-03-01,691,691,625,66,23179,23179,20972,2207,74,13,13,16,2306,2306,2293,2293
Kings,11,2022-03-01,220,220,195,25,5641,5641,5002,639,16,6,6,3,440,440,434,434
Lake,11,2022-03-01,100,100,87,13,1837,1837,1601,236,0,1,1,1,136,136,135,135
Lassen,11,2022-03-01,93,93,85,8,2122,2122,1931,191,1,3,3,0,62,62,59,59
Los Angeles,11,2022-03-01,7610,7610,7346,264,978699,978754,944747,34007,750,212,212,157,31366,31366,31154,31154
Madera,11,2022-03-01,178,178,155,23,4331,4331,3784,547,16,0,0,5,368,368,368,368
Marin,11,2022-03-01,161,161,141,20,7567,7567,6636,931,14,3,3,4,292,292,289,289
Mariposa,11,2022-03-01,29,29,25,4,342,342,296,46,0,1,1,0,26,26,25,25
Mendocino,11,2022-03-01,66,66,55,11,1811,1811,1521,290,10,2,2,3,121,121,119,119
Merced,11,2022-03-01,270,270,243,27,4784,4784,4315,469,11,8,8,18,802,802,794,794
Modoc,11,2022-03-01,5,5,4,1,55,55,50,5,0,0,0,0,7,7,7,7
Mono,11,2022-03-01,4,4,3,1,152,152,123,29,0,0,0,0,6,6,6,6
Monterey,11,2022-03-01,329,329,268,61,12949,12949,10550,2399,24,8,8,5,716,716,708,708
Napa,11,2022-03-01,182,182,166,16,5301,5301,4834,467,8,2,2,4,138,138,136,136
Nevada,11,2022-03-01,66,66,58,8,1947,1947,1704,243,9,1,1,1,128,128,127,127
Orange,11,2022-03-01,1595,1595,1471,124,121476,121481,112046,9435,180,46,46,37,7007,7007,6961,6961
Placer,11,2022-03-01,226,226,195,31,7986,7986,6909,1077,59,5,5,16,613,613,608,608
Plumas,11,2022-03-01,20,20,17,3,355,355,311,44,0,0,0,0,13,13,13,13
Riverside,11,2022-03-01,1508,1508,1354,154,59456,59460,53432,6028,178,40,40,33,6388,6388,6348,6348
Sacramento,11,2022-03-01,1050,1050,936,114,42588,42589,37977,4612,162,21,21,28,2983,2983,2962,2962
San Benito,11,2022-03-01,47,47,43,4,1678,1678,1527,151,0,0,0,1,91,91,91,91
San Bernardino,11,2022-03-01,1120,1120,1027,93,58270,58275,53422,4853,141,58,58,47,7695,7695,7637,7637
San Diego,11,2022-03-01,2807,2807,2704,103,98817,98822,95237,3585,342,35,35,75,5262,5262,5227,5227
San Francisco,11,2022-03-01,816,816,653,163,39193,39193,31350,7843,72,15,15,15,846,846,831,831
San Joaquin,11,2022-03-01,601,601,530,71,23532,23532,20767,2765,54,10,10,18,2221,2221,2211,2211
San Luis Obispo,11,2022-03-01,348,348,315,33,7780,7780,7053,727,12,4,4,1,460,460,456,456
San Mateo,11,2022-03-01,602,602,555,47,41494,41496,38296,3200,38,3,3,7,695,695,692,692
Santa Barbara,11,2022-03-01,336,336,301,35,19894,19894,17836,2058,41,5,5,10,670,670,665,665
Santa Clara,11,2022-03-01,1679,1679,1614,65,107686,107692,103598,4094,194,19,19,44,2258,2258,2239,2239
Santa Cruz,11,2022-03-01,404,404,368,36,26812,26812,24415,2397,19,1,1,3,256,256,255,255
Shasta,11,2022-03-01,147,147,131,16,4751,4751,4243,508,40,11,11,8,538,538,527,527
Siskiyou,11,2022-03-01,17,17,16,1,434,434,396,38,2,1,1,1,79,79,78,78
Solano,11,2022-03-01,450,450,404,46,15073,15073,13539,1534,46,3,3,18,444,444,441,441
Sonoma,11,2022-03-01,409,409,369,40,15899,15899,14334,1565,21,4,4,5,484,484,480,480
Stanislaus,11,2022-03-01,427,427,363,64,12161,12161,10345,1816,115,13,13,19,1656,1656,1643,1643
Sutter,11,2022-03-01,95,95,85,10,2193,2193,1967,226,0,2,2,0,221,221,219,219
Tehama,11,2022-03-01,59,59,51,8,1218,1218,1043,175,6,1,1,2,200,200,199,199
Trinity,11,2022-03-01,4,4,3,1,103,103,87,16,0,0,0,0,20,20,20,20
Tulare,11,2022-03-01,416,416,352,64,10871,10871,9219,1652,66,14,14,8,1467,1467,1453,1453
Tuolumne,11,2022-03-01,68,68,59,9,1429,1429,1249,180,9,3,3,1,181,181,178,178
Ventura,11,2022-03-01,493,493,458,35,28167,28167,26147,2020,64,7,7,12,1475,1475,1468,1468
Yolo,11,2022-03-01,200,200,181,19,24690,24690,22393,2297,7,5,5,5,353,353,348,348
Yuba,11,2022-03-01,71,71,64,7,1677,1677,1514,163,8,1,1,5,117,117,116,116
Alameda,12,2022-03-08,1080,1080,1009,71,72158,72163,67413,4750,79,13,13,16,1845,1845,1832,1832
Amador,12,2022-03-08,72,72,64,8,1421,1421,1273,148,6,1,1,1,86,86,85,85
Butte,12,2022-03-08,94,94,89,5,3741,3741,3541,200,27,4,4,3,426,426,422,422
Calaveras,12,2022-03-08,26,26,24,2,1075,1075,977,98,1,2,2,0,119,119,117,117
Colusa,12,2022-03-08,8,8,7,1,355,355,327,28,5,0,0,0,21,21,21,21
Contra Costa,12,2022-03-08,622,622,556,66,30706,30706,27445,3261,37,5,5,12,1288,1288,1283,1283
Del Norte,12,2022-03-08,49,49,45,4,1730,1730,1584,146,3,0,0,2,47,47,47,47
El Dorado,12,2022-03-08,73,73,66,7,3150,3150,2866,284,4,3,3,3,210,210,207,207
Fresno,12,2022-03-08,749,749,673,76,21948,21948,19752,2196,137,19,19,26,2730,2730,2711,2711
Glenn,12,2022-03-08,18,18,16,2,389,389,355,34,2,1,1,0,53,53,52,52
Humboldt,12,2022-03-08,79,79,72,7,2997,2997,2746,251,9,3,3,3,143,143,140,140
Imperial,12,2022-03-08,117,117,106,11,4659,4659,4236,423,15,2,2,9,938,938,936,936
Inyo,12,2022-03-08,12,12,11,1,261,261,240,21,0,0,0,0,56,56,56,56
Kern,12,2022-03-08,405,405,374,31,20343,20343,18802,1541,64,13,13,13,2319,2319,2306,2306
Kings,12,2022-03-08,191,191,174,17,4824,4824,4388,436,16,4,4,1,444,444,440,440
Lake,12,2022-03-08,64,64,57,7,1720,1720,1542,178,0,2,2,0,138,138,136,136
Lassen,12,2022-03-08,40,40,37,3,1659,1659,1541,118,1,0,0,0,62,62,62,62
Los Angeles,12,2022-03-08,5170,5170,5029,141,866756,866817,843255,23562,544,156,156,122,31522,31522,31366,31366
Madera,12,2022-03-08,117,117,105,12,3905,3905,3510,395,16,1,1,3,369,369,368,368
Marin,12,2022-03-08,166,166,150,16,7371,7371,6640,731,12,1,1,1,293,293,292,292
Mariposa,12,2022-03-08,9,9,8,1,274,274,244,30,0,1,1,0,27,27,26,26
Mendocino,12,2022-03-08,63,63,55,8,1590,1590,1383,207,7,0,0,0,121,121,121,121
Merced,12,2022-03-08,169,169,156,13,4382,4382,4038,344,17,7,7,4,809,809,802,802
Modoc,12,2022-03-08,0,0,0,0,47,47,43,4,1,0,0,0,7,7,7,7
Mono,12,2022-03-08,2,2,2,0,140,140,118,22,1,0,0,0,6,6,6,6
Monterey,12,2022-03-08,210,210,179,31,11086,11086,9427,1659,18,5,5,2,721,721,716,716
Napa,12,2022-03-08,201,201,187,14,4774,4774,4440,334,4,1,1,2,139,139,138,138
Nevada,12,2022-03-08,51,51,46,5,1640,1640,1476,164,5,1,1,0,129,129,128,128
Orange,12,2022-03-08,1175,1175,1103,72,105281,105287,98824,6463,130,25,25,29,7032,7032,7007,7007
Placer,12,2022-03-08,162,162,144,18,7689,7689,6855,834,52,4,4,10,617,617,613,613
Plumas,12,2022-03-08,7,7,6,1,267,267,241,26,0,0,0,0,13,13,13,13
Riverside,12,2022-03-08,916,916,842,74,53050,53055,48773,4282,123,24,24,24,6412,6412,6388,6388
Sacramento,12,2022-03-08,734,734,670,64,39502,39504,36094,3410,119,21,21,22,3004,3004,2983,2983
San Benito,12,2022-03-08,42,42,39,3,1512,1512,1404,108,0,2,2,2,93,93,91,91
San Bernardino,12,2022-03-08,712,712,665,47,54142,54147,50575,3572,99,40,40,36,7735,7735,7695,7695
San Diego,12,2022-03-08,2291,2291,2225,66,97722,97728,94950,2778,214,28,28,58,5290,5290,5262,5262
San Francisco,12,2022-03-08,651,651,545,106,36620,36620,30626,5994,59,6,6,10,852,852,846,846
San Joaquin,12,2022-03-08,406,406,368,38,21004,21004,19039,1965,25,11,11,16,2232,2232,2221,2221
San Luis Obispo,12,2022-03-08,229,229,212,17,7323,7323,6780,543,6,4,4,1,464,464,460,460
San Mateo,12,2022-03-08,507,507,476,31,39122,39125,36717,2408,31,2,2,3,697,697,695,695
Santa Barbara,12,2022-03-08,198,198,182,16,17478,17478,16040,1438,17,6,6,8,676,676,670,670
Santa Clara,12,2022-03-08,1383,1383,1341,42,110155,110163,106827,3336,137,12,12,38,2270,2270,2258,2258
Santa Cruz,12,2022-03-08,315,315,292,23,23921,23921,22223,1698,12,0,0,6,256,256,256,256
Shasta,12,2022-03-08,128,128,117,11,5038,5038,4607,431,22,7,7,3,545,545,538,538
Siskiyou,12,2022-03-08,13,13,12,1,396,396,368,28,1,2,2,0,81,81,79,79
Solano,12,2022-03-08,340,340,312,28,13651,13651,12543,1108,50,2,2,10,446,446,444,444
Sonoma,12,2022-03-08,298,298,274,24,14872,14872,13705,1167,21,2,2,7,486,486,484,484
Stanislaus,12,2022-03-08,251,251,221,30,10664,10664,9384,1280,85,8,8,12,1664,1664,1656,1656
Sutter,12,2022-03-08,79,79,72,7,1933,1933,1774,159,0,1,1,0,222,222,221,221
Tehama,12,2022-03-08,32,32,28,4,1064,1064,940,124,4,2,2,1,202,202,200,200
Trinity,12,2022-03-08,6,6,5,1,120,120,105,15,0,0,0,0,20,20,20,20
Tulare,12,2022-03-08,291,291,255,36,10284,10284,9027,1257,37,11,11,3,1478,1478,1467,1467
Tuolumne,12,2022-03-08,44,44,40,4,1250,1250,1124,126,2,0,0,1,181,181,181,181
Ventura,12,2022-03-08,384,384,362,22,26663,26663,25150,1513,44,4,4,9,1479,1479,1475,1475
Yolo,12,2022-03-08,147,147,136,11,22241,22241,20601,1640,3,2,2,2,355,355,353,353
Yuba,12,2022-03-08,51,51,47,4,1517,1517,1400,117,12,0,0,2,117,117,117,117
Alameda,13,2022-03-15,782,782,741,41,68350,68355,64804,3551,62,10,10,8,1855,1855,1845,1845
Amador,13,2022-03-15,34,34,31,3,1389,1389,1273,116,4,0,0,0,86,86,86,86
Butte,13,2022-03-15,83,83,79,4,3368,3368,3225,143,22,1,1,0,427,427,426,426
Calaveras,13,2022-03-15,14,14,13,1,887,887,822,65,0,0,0,1,119,119,119,119
Colusa,13,2022-03-15,5,5,5,0,248,248,232,16,2,0,0,0,21,21,21,21
Contra Costa,13,2022-03-15,559,559,512,47,28721,28721,26292,2429,18,6,6,11,1294,1294,1288,1288
Del Norte,13,2022-03-15,33,33,31,2,1408,1408,1314,94,3,2,2,1,49,49,47,47
El Dorado,13,2022-03-15,44,44,41,3,2931,2931,2721,210,4,1,1,0,211,211,210,210
Fresno,13,2022-03-15,507,507,466,41,20730,20730,19076,1654,116,7,7,19,2737,2737,2730,2730
Glenn,13,2022-03-15,10,10,9,1,345,345,321,24,1,0,0,0,53,53,53,53
Humboldt,13,2022-03-15,50,50,47,3,2537,2537,2367,170,3,1,1,2,144,144,143,143
Imperial,13,2022-03-15,63,63,58,5,4180,4180,3876,304,6,2,2,6,940,940,938,938
Inyo,13,2022-03-15,4,4,4,0,162,162,152,10,0,0,0,0,56,56,56,56
Kern,13,2022-03-15,272,272,255,17,20608,20608,19373,1235,39,12,12,10,2331,2331,2319,2319
Kings,13,2022-03-15,144,144,133,11,4751,4751,4410,341,14,1,1,1,445,445,444,444
Lake,13,2022-03-15,39,39,36,3,1532,1532,1405,127,3,1,1,0,139,139,138,138
Lassen,13,2022-03-15,4,4,4,0,1542,1542,1455,87,0,0,0,0,62,62,62,62
Los Angeles,13,2022-03-15,3894,3894,3811,83,845962,846029,828015,18014,409,108,108,90,31630,31630,31522,31522
Madera,13,2022-03-15,49,49,45,4,3537,3537,3252,285,10,0,0,1,369,369,369,369
Marin,13,2022-03-15,161,161,148,13,6449,6449,5943,506,6,1,1,0,294,294,293,293
Mariposa,13,2022-03-15,9,9,8,1,237,237,217,20,0,0,0,0,27,27,27,27
Mendocino,13,2022-03-15,33,33,30,3,1393,1393,1248,145,4,2,2,1,123,123,121,121
Merced,13,2022-03-15,113,113,106,7,4053,4053,3801,252,20,1,1,3,810,810,809,809
Modoc,13,2022-03-15,4,4,4,0,58,58,54,4,0,0,0,0,7,7,7,7
Mono,13,2022-03-15,3,3,3,0,103,103,90,13,0,0,0,0,6,6,6,6
Monterey,13,2022-03-15,137,137,120,17,10177,10177,8955,1222,13,3,3,1,724,724,721,721
Napa,13,2022-03-15,109,109,103,6,3951,3951,3732,219,5,1,1,3,140,140,139,139
Nevada,13,2022-03-15,45,45,41,4,1577,1577,1452,125,3,0,0,0,129,129,129,129
Orange,13,2022-03-15,793,793,755,38,101289,101296,96385,4911,104,31,31,29,7063,7063,7032,7032
Placer,13,2022-03-15,137,137,125,12,7184,7184,6561,623,46,1,1,4,618,618,617,617
Plumas,13,2022-03-15,4,4,4,0,297,297,273,24,0,0,0,0,13,13,13,13
Riverside,13,2022-03-15,749,749,701,48,53613,53618,50195,3423,84,11,11,16,6423,6423,6412,6412
Sacramento,13,2022-03-15,570,570,531,39,34640,34642,32264,2378,118,17,17,21,3021,3021,3004,3004
San Benito,13,2022-03-15,35,35,33,2,1449,1449,1367,82,0,0,0,1,93,93,93,93
San Bernardino,13,2022-03-15,552,552,523,29,50997,51002,48344,2658,75,23,23,30,7758,7758,7735,7735
San Diego,13,2022-03-15,1803,1803,1763,40,92997,93004,90922,2082,177,17,17,42,5307,5307,5290,5290
San Francisco,13,2022-03-15,587,587,510,77,34378,34379,29833,4546,35,6,6,10,858,858,852,852
San Joaquin,13,2022-03-15,256,256,237,19,17775,17775,16439,1336,22,5,5,8,2237,2237,2232,2232
San Luis Obispo,13,2022-03-15,145,145,136,9,6744,6744,6349,395,7,9,9,1,473,473,464,464
San Mateo,13,2022-03-15,438,438,417,21,35258,35261,33544,1717,30,0,0,3,697,697,697,697
Santa Barbara,13,2022-03-15,194,194,181,13,16529,16529,15444,1085,19,5,5,1,681,681,676,676
Santa Clara,13,2022-03-15,1173,1173,1145,28,97869,97876,95552,2324,107,11,11,29,2281,2281,2270,2270
Santa Cruz,13,2022-03-15,227,227,214,13,21900,21900,20667,1233,10,3,3,3,259,259,256,256
Shasta,13,2022-03-15,89,89,83,6,4638,4638,4321,317,20,6,6,2,551,551,545,545
Siskiyou,13,2022-03-15,10,10,9,1,380,380,359,21,2,2,2,0,83,83,81,81
Solano,13,2022-03-15,213,213,199,14,12245,12245,11457,788,31,1,1,5,447,447,446,446
Sonoma,13,2022-03-15,219,219,205,14,13029,13029,12217,812,9,2,2,4,488,488,486,486
Stanislaus,13,2022-03-15,212,212,191,21,9171,9171,8286,885,80,11,11,15,1675,1675,1664,1664
Sutter,13,2022-03-15,36,36,34,2,1626,1626,1519,107,0,1,1,0,223,223,222,222
Tehama,13,2022-03-15,14,14,13,1,977,977,886,91,2,3,3,0,205,205,202,202
Trinity,13,2022-03-15,1,1,1,0,98,98,88,10,0,0,0,0,20,20,20,20
Tulare,13,2022-03-15,163,163,147,16,9031,9031,8145,886,32,1,1,6,1479,1479,1478,1478
Tuolumne,13,2022-03-15,17,17,16,1,1250,1250,1150,100,3,0,0,1,181,181,181,181
Ventura,13,2022-03-15,328,328,313,15,24384,24384,23292,1092,40,7,7,6,1486,1486,1479,1479
Yolo,13,2022-03-15,111,111,104,7,21808,21808,20538,1270,1,3,3,2,358,358,355,355
Yuba,13,2022-03-15,40,40,38,2,1350,1350,1267,83,6,0,0,3,117,117,117,117
Alameda,14,2022-03-22,835,835,801,34,64535,64540,61887,2653,55,5,5,4,1860,1860,1855,1855
Amador,14,2022-03-22,27,27,25,2,1435,1435,1340,95,2,0,0,0,86,86,86,86
Butte,14,2022-03-22,76,76,73,3,3150,3150,3045,105,19,0,0,1,427,427,427,427
Calaveras,14,2022-03-22,8,8,8,0,630,630,594,36,0,0,0,0,119,119,119,119
Colusa,14,2022-03-22,2,2,2,0,229,229,217,12,0,0,0,0,21,21,21,21
Contra Costa,14,2022-03-22,438,438,409,29,26226,26226,24457,1769,36,6,6,5,1300,1300,1294,1294
Del Norte,14,2022-03-22,14,14,13,1,1177,1177,1115,62,0,0,0,0,49,49,49,49
El Dorado,14,2022-03-22,51,51,48,3,2806,2806,2647,159,2,2,2,0,213,213,211,211
Fresno,14,2022-03-22,323,323,303,20,18991,18991,17789,1202,91,12,12,13,2749,2749,2737,2737
Glenn,14,2022-03-22,7,7,7,0,376,376,355,21,0,0,0,0,53,53,53,53
Humboldt,14,2022-03-22,34,34,32,2,2561,2561,2427,134,6,1,1,2,145,145,144,144
Imperial,14,2022-03-22,61,61,57,4,3986,3986,3757,229,5,3,3,3,943,943,940,940
Inyo,14,2022-03-22,2,2,2,0,155,155,147,8,0,0,0,0,56,56,56,56
Kern,14,2022-03-22,204,204,194,10,19072,19072,18171,901,31,6,6,8,2337,2337,2331,2331
Kings,14,2022-03-22,75,75,71,4,4377,4377,4129,248,7,1,1,1,446,446,445,445
Lake,14,2022-03-22,17,17,16,1,1349,1349,1260,89,0,0,0,0,139,139,139,139
Lassen,14,2022-03-22,11,11,10,1,1437,1437,1373,64,0,0,0,0,62,62,62,62
Los Angeles,14,2022-03-22,4358,4358,4286,72,807408,807477,794002,13475,324,73,73,54,31703,31703,31630,31630
Madera,14,2022-03-22,39,39,36,3,3357,3357,3142,215,9,1,1,1,370,370,369,369
Marin,14,2022-03-22,149,149,140,9,6286,6286,5894,392,6,1,1,0,295,295,294,294
Mariposa,14,2022-03-22,7,7,7,0,205,205,191,14,0,0,0,0,27,27,27,27
Mendocino,14,2022-03-22,31,31,28,3,1519,1519,1393,126,3,0,0,1,123,123,123,123
Merced,14,2022-03-22,80,80,76,4,3650,3650,3470,180,14,5,5,2,815,815,810,810
Modoc,14,2022-03-22,3,3,3,0,59,59,56,3,0,0,0,0,7,7,7,7
Mono,14,2022-03-22,3,3,3,0,138,138,124,14,0,0,0,0,6,6,6,6
Monterey,14,2022-03-22,186,186,168,18,9564,9564,8639,925,23,0,0,2,724,724,724,724
Napa,14,2022-03-22,49,49,47,2,3398,3398,3250,148,5,1,1,3,141,141,140,140
Nevada,14,2022-03-22,20,20,19,1,1481,1481,1388,93,2,0,0,0,129,129,129,129
Orange,14,2022-03-22,773,773,744,29,93893,93901,90308,3593,97,14,14,26,7077,7077,7063,7063
Placer,14,2022-03-22,114,114,106,8,6320,6320,5885,435,36,3,3,8,621,621,618,618
Plumas,14,2022-03-22,2,2,2,0,249,249,234,15,0,0,0,0,13,13,13,13
Riverside,14,2022-03-22,560,560,532,28,49498,49503,46982,2521,66,12,12,15,6435,6435,6423,6423
Sacramento,14,2022-03-22,470,470,445,25,32560,32562,30797,1765,90,9,9,12,3030,3030,3021,3021
San Benito,14,2022-03-22,20,20,19,1,1373,1373,1312,61,0,1,1,0,94,94,93,93
San Bernardino,14,2022-03-22,475,475,455,20,47308,47313,45353,1960,41,20,20,28,7778,7778,7758,7758
San Diego,14,2022-03-22,1294,1294,1271,23,81250,81255,79826,1429,132,15,15,39,5322,5322,5307,5307
San Francisco,14,2022-03-22,764,764,684,80,33158,33161,29640,3521,32,3,3,7,861,861,858,858
San Joaquin,14,2022-03-22,207,207,195,12,15323,15323,14416,907,18,7,7,6,2244,2244,2237,2237
San Luis Obispo,14,2022-03-22,104,104,99,5,5973,5973,5695,278,4,4,4,0,477,477,473,473
San Mateo,14,2022-03-22,454,454,437,17,34856,34860,33526,1334,31,1,1,3,698,698,697,697
Santa Barbara,14,2022-03-22,139,139,132,7,12707,12707,12032,675,16,6,6,2,687,687,681,681
Santa Clara,14,2022-03-22,1169,1169,1147,22,94153,94160,92406,1754,100,6,6,24,2287,2287,2281,2281
Santa Cruz,14,2022-03-22,182,182,174,8,19876,19876,18993,883,8,0,0,2,259,259,259,259
Shasta,14,2022-03-22,42,42,40,2,4039,4039,3821,218,9,5,5,2,556,556,551,551
Siskiyou,14,2022-03-22,4,4,4,0,341,341,326,15,1,0,0,1,83,83,83,83
Solano,14,2022-03-22,166,166,158,8,11458,11458,10876,582,22,1,1,5,448,448,447,447
Sonoma,14,2022-03-22,238,238,226,12,10821,10821,10277,544,13,1,1,1,489,489,488,488
Stanislaus,14,2022-03-22,142,142,131,11,8251,8251,7618,633,55,10,10,9,1685,1685,1675,1675
Sutter,14,2022-03-22,31,31,29,2,1536,1536,1457,79,0,1,1,0,224,224,223,223
Tehama,14,2022-03-22,12,12,11,1,913,913,845,68,2,0,0,0,205,205,205,205
Trinity,14,2022-03-22,0,0,0,0,105,105,97,8,0,0,0,0,20,20,20,20
Tulare,14,2022-03-22,102,102,94,8,8142,8142,7507,635,25,4,4,2,1483,1483,1479,1479
Tuolumne,14,2022-03-22,18,18,17,1,1128,1128,1056,72,2,0,0,0,181,181,181,181
Ventura,14,2022-03-22,306,306,295,11,22593,22593,21794,799,30,3,3,5,1489,1489,1486,1486
Yolo,14,2022-03-22,106,106,101,5,20236,20236,19295,941,1,0,0,1,358,358,358,358
Yuba,14,2022-03-22,33,33,31,2,1308,1308,1244,64,4,0,0,1,117,117,117,117
Alameda,15,2022-03-29,855,855,828,27,58638,58643,56757,1886,41,4,4,3,1864,1864,1860,1860
Amador,15,2022-03-29,6,6,6,0,1320,1320,1251,69,3,0,0,0,86,86,86,86
Butte,15,2022-03-29,70,70,68,2,2834,2834,2760,74,9,0,0,1,427,427,427,427
Calaveras,15,2022-03-29,14,14,13,1,589,589,563,26,0,0,0,0,119,119,119,119
Colusa,15,2022-03-29,4,4,4,0,203,203,195,8,0,0,0,0,21,21,21,21
Contra Costa,15,2022-03-29,550,550,521,29,25139,25140,23804,1336,22,0,0,6,1300,1300,1300,1300
Del Norte,15,2022-03-29,17,17,16,1,1012,1012,970,42,1,0,0,0,49,49,49,49
El Dorado,15,2022-03-29,56,56,54,2,2808,2808,2683,125,0,0,0,0,213,213,213,213
Fresno,15,2022-03-29,254,254,241,13,17641,17641,16758,883,75,5,5,19,2754,2754,2749,2749
Glenn,15,2022-03-29,7,7,7,0,311,311,298,13,0,0,0,0,53,53,53,53
Humboldt,15,2022-03-29,18,18,17,1,2545,2545,2440,105,3,0,0,3,145,145,145,145
Imperial,15,2022-03-29,60,60,57,3,3476,3476,3319,157,5,1,1,3,944,944,943,943
Inyo,15,2022-03-29,4,4,4,0,186,186,179,7,0,0,0,0,56,56,56,56
Kern,15,2022-03-29,137,137,132,5,17930,17930,17262,668,22,2,2,7,2339,2339,2337,2337
Kings,15,2022-03-29,56,56,53,3,4273,4273,4082,191,4,2,2,0,448,448,446,446
Lake,15,2022-03-29,10,10,9,1,1016,1016,963,53,0,0,0,0,139,139,139,139
Lassen,15,2022-03-29,3,3,3,0,1264,1264,1220,44,0,0,0,0,62,62,62,62
Los Angeles,15,2022-03-29,4486,4486,4428,58,725631,725705,716198,9507,274,55,55,51,31758,31758,31703,31703
Madera,15,2022-03-29,22,22,21,1,3335,3335,3166,169,3,0,0,1,370,370,370,370
Marin,15,2022-03-29,161,161,153,8,5922,5922,5632,290,2,0,0,0,295,295,295,295
Mariposa,15,2022-03-29,5,5,5,0,185,185,175,10,0,1,1,0,28,28,27,27
Mendocino,15,2022-03-29,25,25,23,2,1289,1289,1204,85,0,1,1,0,124,124,123,123
Merced,15,2022-03-29,62,62,60,2,3394,3394,3263,131,6,1,1,2,816,816,815,815
Modoc,15,2022-03-29,2,2,2,0,42,42,40,2,0,0,0,0,7,7,7,7
Mono,15,2022-03-29,1,1,1,0,144,144,133,11,0,0,0,0,6,6,6,6
Monterey,15,2022-03-29,134,134,124,10,8344,8344,7696,648,12,2,2,0,726,726,724,724
Napa,15,2022-03-29,68,68,66,2,3307,3307,3194,113,3,2,2,1,143,143,141,141
Nevada,15,2022-03-29,25,25,24,1,1447,1447,1375,72,1,1,1,0,130,130,129,129
Orange,15,2022-03-29,794,794,770,24,90606,90615,87896,2719,85,10,10,17,7087,7087,7077,7077
Placer,15,2022-03-29,108,108,102,6,6245,6245,5906,339,32,3,3,5,624,624,621,621
Plumas,15,2022-03-29,4,4,4,0,248,248,236,12,0,0,0,0,13,13,13,13
Riverside,15,2022-03-29,541,541,520,21,43324,43329,41597,1732,44,9,9,10,6444,6444,6435,6435
Sacramento,15,2022-03-29,433,433,414,19,32606,32610,31219,1391,62,6,6,17,3036,3036,3030,3030
San Benito,15,2022-03-29,8,8,8,0,1352,1352,1305,47,0,0,0,0,94,94,94,94
San Bernardino,15,2022-03-29,539,539,522,17,41945,41950,40595,1355,42,17,17,19,7795,7795,7778,7778
San Diego,15,2022-03-29,1339,1339,1321,18,70190,70197,69232,965,107,9,9,27,5331,5331,5322,5322
San Francisco,15,2022-03-29,817,817,749,68,32011,32016,29298,2718,24,4,4,4,865,865,861,861
San Joaquin,15,2022-03-29,194,194,185,9,17942,17942,17101,841,18,3,3,4,2247,2247,2244,2244
San Luis Obispo,15,2022-03-29,96,96,93,3,5864,5864,5650,214,5,0,0,1,477,477,477,477
San Mateo,15,2022-03-29,539,539,523,16,32458,32462,31480,982,28,3,3,3,701,701,698,698
Santa Barbara,15,2022-03-29,147,147,141,6,11791,11791,11318,473,12,0,0,5,687,687,687,687
Santa Clara,15,2022-03-29,1243,1243,1225,18,95944,95952,94560,1392,85,10,10,18,2297,2297,2287,2287
Santa Cruz,15,2022-03-29,142,142,137,5,20021,20022,19329,693,4,0,0,2,259,259,259,259
Shasta,15,2022-03-29,29,29,28,1,3787,3787,3626,161,4,3,3,4,559,559,556,556
Siskiyou,15,2022-03-29,6,6,6,0,286,286,276,10,0,0,0,0,83,83,83,83
Solano,15,2022-03-29,169,169,162,7,10926,10926,10490,436,18,0,0,6,448,448,448,448
Sonoma,15,2022-03-29,263,263,253,10,9353,9353,8994,359,11,1,1,1,490,490,489,489
Stanislaus,15,2022-03-29,96,96,90,6,8449,8449,7938,511,33,2,2,2,1687,1687,1685,1685
Sutter,15,2022-03-29,28,28,27,1,1387,1387,1330,57,0,0,0,0,224,224,224,224
Tehama,15,2022-03-29,9,9,8,1,771,771,726,45,0,2,2,0,207,207,205,205
Trinity,15,2022-03-29,0,0,0,0,71,71,67,4,0,0,0,0,20,20,20,20
Tulare,15,2022-03-29,73,73,68,5,7905,7905,7418,487,16,6,6,0,1489,1489,1483,1483
Tuolumne,15,2022-03-29,7,7,7,0,1000,1000,949,51,1,1,1,0,182,182,181,181
Ventura,15,2022-03-29,303,303,295,8,21240,21240,20651,589,22,6,6,3,1495,1495,1489,1489
Yolo,15,2022-03-29,105,105,101,4,22742,22743,21935,808,3,2,2,0,360,360,358,358
Yuba,15,2022-03-29,24,24,23,1,1151,1151,1107,44,3,2,2,1,119,119,117,117
Alameda,16,2022-04-05,1133,1133,1105,28,53917,53922,52551,1371,39,3,3,4,1867,1867,1864,1864
Amador,16,2022-04-05,2,2,2,0,1079,1079,1035,44,1,0,0,0,86,86,86,86
Butte,16,2022-04-05,33,33,32,1,2443,2443,2393,50,6,2,2,1,429,429,427,427
Calaveras,16,2022-04-05,8,8,8,0,580,580,559,21,0,0,0,0,119,119,119,119
Colusa,16,2022-04-05,3,3,3,0,204,204,198,6,0,0,0,0,21,21,21,21
Contra Costa,16,2022-04-05,565,565,542,23,22112,22113,21179,934,20,1,1,6,1301,1301,1300,1300
Del Norte,16,2022-04-05,6,6,6,0,1128,1128,1091,37,0,0,0,1,49,49,49,49
El Dorado,16,2022-04-05,47,47,45,2,2669,2669,2575,94,0,1,1,1,214,214,213,213
Fresno,16,2022-04-05,178,178,171,7,16496,16496,15846,650,58,3,3,11,2757,2757,2754,2754
Glenn,16,2022-04-05,3,3,3,0,284,284,274,10,0,0,0,0,53,53,53,53
Humboldt,16,2022-04-05,30,30,29,1,2348,2348,2271,77,6,0,0,2,145,145,145,145
Imperial,16,2022-04-05,33,33,32,1,3448,3448,3325,123,4,0,0,2,944,944,944,944
Inyo,16,2022-04-05,8,8,8,0,187,187,181,6,0,0,0,0,56,56,56,56
Kern,16,2022-04-05,149,149,145,4,16895,16895,16401,494,14,2,2,5,2341,2341,2339,2339
Kings,16,2022-04-05,40,40,39,1,4120,4120,3975,145,4,0,0,1,448,448,448,448
Lake,16,2022-04-05,17,17,16,1,1014,1014,973,41,0,0,0,0,139,139,139,139
Lassen,16,2022-04-05,5,5,5,0,1283,1283,1248,35,0,0,0,0,62,62,62,62
Los Angeles,16,2022-04-05,5686,5686,5629,57,771616,771708,763815,7893,250,42,42,42,31800,31800,31758,31758
Madera,16,2022-04-05,27,27,26,1,3164,3164,3037,127,2,0,0,1,370,370,370,370
Marin,16,2022-04-05,159,159,153,6,6104,6104,5865,239,4,0,0,1,295,295,295,295
Mariposa,16,2022-04-05,7,7,7,0,246,246,236,10,0,0,0,0,28,28,28,28
Mendocino,16,2022-04-05,29,29,27,2,1189,1189,1127,62,1,0,0,0,124,124,124,124
Merced,16,2022-04-05,59,59,57,2,3231,3231,3133,98,4,2,2,0,818,818,816,816
Modoc,16,2022-04-05,3,3,3,0,46,46,45,1,0,0,0,0,7,7,7,7
Mono,16,2022-04-05,1,1,1,0,127,127,119,8,0,0,0,0,6,6,6,6
Monterey,16,2022-04-05,110,110,103,7,7347,7347,6896,451,11,3,3,0,729,729,726,726
Napa,16,2022-04-05,86,86,84,2,3070,3070,2987,83,2,0,0,1,143,143,143,143
Nevada,16,2022-04-05,32,32,31,1,1463,1463,1406,57,2,1,1,0,131,131,130,130
Orange,16,2022-04-05,1034,1034,1010,24,73873,73881,72114,1767,56,17,17,11,7104,7104,7087,7087
Placer,16,2022-04-05,118,118,113,5,6523,6523,6242,281,19,2,2,5,626,626,624,624
Plumas,16,2022-04-05,4,4,4,0,248,248,238,10,0,0,0,0,13,13,13,13
Riverside,16,2022-04-05,684,684,663,21,38311,38316,37117,1199,40,3,3,7,6447,6447,6444,6444
Sacramento,16,2022-04-05,455,455,440,15,32798,32803,31702,1101,58,11,11,10,3047,3047,3036,3036
San Benito,16,2022-04-05,16,16,16,0,1161,1161,1129,32,0,0,0,0,94,94,94,94
San Bernardino,16,2022-04-05,669,669,652,17,41792,41797,40737,1060,27,12,12,14,7807,7807,7795,7795
San Diego,16,2022-04-05,1625,1625,1608,17,68277,68286,67558,728,80,8,8,30,5339,5339,5331,5331
San Francisco,16,2022-04-05,1061,1061,991,70,28671,28675,26753,1922,19,5,5,4,870,870,865,865
San Joaquin,16,2022-04-05,222,222,214,8,15676,15677,15104,573,8,2,2,5,2249,2249,2247,2247
San Luis Obispo,16,2022-04-05,97,97,94,3,5232,5232,5082,150,3,2,2,1,479,479,477,477
San Mateo,16,2022-04-05,746,746,729,17,30285,30289,29577,712,13,3,3,1,704,704,701,701
Santa Barbara,16,2022-04-05,204,204,198,6,15223,15223,14733,490,8,2,2,1,689,689,687,687
Santa Clara,16,2022-04-05,1532,1532,1515,17,84903,84913,83946,967,85,1,1,17,2298,2298,2297,2297
Santa Cruz,16,2022-04-05,224,224,218,6,13622,13622,13238,384,7,0,0,1,259,259,259,259
Shasta,16,2022-04-05,31,31,30,1,3305,3305,3194,111,4,0,0,2,559,559,559,559
Siskiyou,16,2022-04-05,1,1,1,0,304,304,296,8,0,0,0,0,83,83,83,83
Solano,16,2022-04-05,191,191,185,6,9875,9875,9565,310,19,1,1,4,449,449,448,448
Sonoma,16,2022-04-05,338,338,328,10,10789,10789,10460,329,5,0,0,1,490,490,490,490
Stanislaus,16,2022-04-05,122,122,116,6,7800,7800,7430,370,23,3,3,4,1690,1690,1687,1687
Sutter,16,2022-04-05,21,21,20,1,1324,1324,1282,42,0,0,0,0,224,224,224,224
Tehama,16,2022-04-05,8,8,8,0,778,778,742,36,0,0,0,0,207,207,207,207
Trinity,16,2022-04-05,1,1,1,0,84,84,80,4,0,0,0,0,20,20,20,20
Tulare,16,2022-04-05,45,45,43,2,7693,7693,7319,374,13,4,4,0,1493,1493,1489,1489
Tuolumne,16,2022-04-05,17,17,16,1,1122,1122,1078,44,0,1,1,0,183,183,182,182
Ventura,16,2022-04-05,300,300,293,7,19527,19527,19100,427,17,6,6,4,1501,1501,1495,1495
Yolo,16,2022-04-05,100,100,97,3,23990,23992,23301,691,0,0,0,0,360,360,360,360
Yuba,16,2022-04-05,13,13,13,0,1062,1062,1030,32,4,0,0,1,119,119,119,119
Alameda,17,2022-04-12,1555,1555,1525,30,51902,51909,50887,1022,52,6,6,4,1873,1873,1867,1867
Amador,17,2022-04-12,9,9,9,0,1101,1101,1065,36,1,0,0,0,86,86,86,86
Butte,17,2022-04-12,40,40,39,1,2293,2293,2256,37,5,0,0,1,429,429,429,429
Calaveras,17,2022-04-12,17,17,17,0,647,647,629,18,0,0,0,0,119,119,119,119
Colusa,17,2022-04-12,7,7,7,0,206,206,201,5,0,0,0,0,21,21,21,21
Contra Costa,17,2022-04-12,780,780,755,25,21848,21850,21136,714,21,1,1,4,1302,1302,1301,1301
Del Norte,17,2022-04-12,10,10,10,0,1032,1032,1006,26,0,0,0,0,49,49,49,49
El Dorado,17,2022-04-12,56,56,54,2,2494,2494,2425,69,1,0,0,0,214,214,214,214
Fresno,17,2022-04-12,200,200,194,6,15000,15000,14532,468,53,3,3,6,2760,2760,2757,2757
Glenn,17,2022-04-12,2,2,2,0,259,259,252,7,0,0,0,0,53,53,53,53
Humboldt,17,2022-04-12,53,53,52,1,2325,2325,2265,60,6,1,1,2,146,146,145,145
Imperial,17,2022-04-12,28,28,27,1,3433,3433,3337,96,3,1,1,1,945,945,944,944
Inyo,17,2022-04-12,4,4,4,0,176,176,172,4,0,0,0,0,56,56,56,56
Kern,17,2022-04-12,137,137,134,3,15632,15632,15270,362,16,2,2,6,2343,2343,2341,2341
Kings,17,2022-04-12,29,29,28,1,3970,3970,3859,111,4,0,0,0,448,448,448,448
Lake,17,2022-04-12,18,18,17,1,806,806,780,26,0,0,0,1,139,139,139,139
Lassen,17,2022-04-12,1,1,1,0,1294,1294,1266,28,1,0,0,0,62,62,62,62
Los Angeles,17,2022-04-12,6895,6895,6841,54,610988,611068,606093,4975,221,47,47,35,31847,31847,31800,31800
Madera,17,2022-04-12,32,32,31,1,2960,2960,2867,93,5,0,0,1,370,370,370,370
Marin,17,2022-04-12,255,255,247,8,5659,5659,5487,172,6,0,0,1,295,295,295,295
Mariposa,17,2022-04-12,7,7,7,0,231,231,223,8,0,0,0,0,28,28,28,28
Mendocino,17,2022-04-12,30,30,29,1,1114,1114,1068,46,2,0,0,0,124,124,124,124
Merced,17,2022-04-12,67,67,65,2,3204,3204,3128,76,5,2,2,1,820,820,818,818
Modoc,17,2022-04-12,0,0,0,0,37,37,36,1,0,0,0,0,7,7,7,7
Mono,17,2022-04-12,10,10,10,0,174,174,165,9,0,0,0,0,6,6,6,6
Monterey,17,2022-04-12,112,112,107,5,6791,6791,6461,330,9,1,1,0,730,730,729,729
Napa,17,2022-04-12,121,121,118,3,2778,2778,2719,59,1,0,0,0,143,143,143,143
Nevada,17,2022-04-12,45,45,44,1,1394,1394,1351,43,2,0,0,1,131,131,131,131
Orange,17,2022-04-12,1206,1206,1184,22,68605,68612,67371,1241,65,7,7,13,7111,7111,7104,7104
Placer,17,2022-04-12,138,138,133,5,5412,5412,5227,185,18,1,1,2,627,627,626,626
Plumas,17,2022-04-12,8,8,8,0,231,231,224,7,0,0,0,0,13,13,13,13
Riverside,17,2022-04-12,764,764,745,19,37795,37800,36871,929,42,6,6,7,6453,6453,6447,6447
Sacramento,17,2022-04-12,516,516,502,14,29059,29064,28297,767,46,9,9,4,3056,3056,3047,3047
San Benito,17,2022-04-12,14,14,14,0,1207,1207,1181,26,0,0,0,0,94,94,94,94
San Bernardino,17,2022-04-12,928,928,910,18,41993,41998,41163,835,36,6,6,6,7813,7813,7807,7807
San Diego,17,2022-04-12,1841,1841,1826,15,73684,73694,73077,617,84,2,2,22,5341,5341,5339,5339
San Francisco,17,2022-04-12,1210,1210,1146,64,30217,30222,28615,1607,20,2,2,4,872,872,870,870
San Joaquin,17,2022-04-12,233,233,226,7,15213,15214,14776,438,7,0,0,6,2249,2249,2249,2249
San Luis Obispo,17,2022-04-12,120,120,117,3,4836,4836,4727,109,1,0,0,0,479,479,479,479
San Mateo,17,2022-04-12,910,910,893,17,29211,29216,28675,541,8,1,1,3,705,705,704,704
Santa Barbara,17,2022-04-12,307,307,299,8,14954,14954,14576,378,5,2,2,0,691,691,689,689
Santa Clara,17,2022-04-12,1738,1738,1723,15,81176,81186,80466,720,68,5,5,14,2303,2303,2298,2298
Santa Cruz,17,2022-04-12,376,376,368,8,13462,13464,13183,281,4,1,1,1,260,260,259,259
Shasta,17,2022-04-12,20,20,19,1,2969,2969,2890,79,3,1,1,1,560,560,559,559
Siskiyou,17,2022-04-12,1,1,1,0,347,347,340,7,0,0,0,0,83,83,83,83
Solano,17,2022-04-12,231,231,225,6,9477,9477,9243,234,14,0,0,1,449,449,449,449
Sonoma,17,2022-04-12,430,430,420,10,11034,11034,10771,263,11,1,1,2,491,491,490,490
Stanislaus,17,2022-04-12,138,138,133,5,7692,7692,7404,288,12,1,1,4,1691,1691,1690,1690
Sutter,17,2022-04-12,20,20,19,1,1224,1224,1193,31,0,1,1,0,225,225,224,224
Tehama,17,2022-04-12,8,8,8,0,738,738,711,27,1,0,0,0,207,207,207,207
Trinity,17,2022-04-12,0,0,0,0,81,81,78,3,0,0,0,0,20,20,20,20
Tulare,17,2022-04-12,60,60,58,2,7543,7543,7252,291,9,2,2,0,1495,1495,1493,1493
Tuolumne,17,2022-04-12,18,18,17,1,1021,1021,989,32,1,0,0,0,183,183,183,183
Ventura,17,2022-04-12,342,342,336,6,17550,17550,17250,300,12,1,1,2,1502,1502,1501,1501
Yolo,17,2022-04-12,153,153,150,3,18600,18600,18187,413,1,0,0,0,360,360,360,360
Yuba,17,2022-04-12,15,15,15,0,999,999,975,24,2,0,0,0,119,119,119,119
Alameda,18,2022-04-19,1876,1876,1847,29,53113,53120,52296,824,46,4,4,4,1877,1877,1873,1873
Amador,18,2022-04-19,12,12,12,0,1217,1217,1186,31,0,0,0,1,86,86,86,86
Butte,18,2022-04-19,38,38,38,0,2300,2300,2271,29,6,2,2,0,431,431,429,429
Calaveras,18,2022-04-19,17,17,17,0,598,598,585,13,0,1,1,0,120,120,119,119
Colusa,18,2022-04-19,2,2,2,0,154,154,151,3,0,0,0,0,21,21,21,21
Contra Costa,18,2022-04-19,1117,1117,1088,29,24716,24721,24079,642,24,1,1,4,1303,1303,1302,1302
Del Norte,18,2022-04-19,17,17,17,0,1013,1013,993,20,0,0,0,0,49,49,49,49
El Dorado,18,2022-04-19,71,71,69,2,2512,2512,2458,54,1,0,0,0,214,214,214,214
Fresno,18,2022-04-19,268,268,262,6,14390,14390,14042,348,36,5,5,5,2765,2765,2760,2760
Glenn,18,2022-04-19,3,3,3,0,278,278,272,6,0,0,0,0,53,53,53,53
Humboldt,18,2022-04-19,121,121,119,2,2133,2133,2091,42,3,1,1,2,147,147,146,146
Imperial,18,2022-04-19,56,56,55,1,3250,3250,3179,71,2,0,0,1,945,945,945,945
Inyo,18,2022-04-19,2,2,2,0,174,174,171,3,0,0,0,0,56,56,56,56
Kern,18,2022-04-19,170,170,167,3,14903,14904,14639,265,9,1,1,6,2344,2344,2343,2343
Kings,18,2022-04-19,45,45,44,1,3844,3844,3761,83,1,1,1,1,449,449,448,448
Lake,18,2022-04-19,19,19,19,0,790,790,770,20,3,1,1,0,140,140,139,139
Lassen,18,2022-04-19,1,1,1,0,1366,1366,1343,23,0,0,0,0,62,62,62,62
Los Angeles,18,2022-04-19,8892,8892,8838,54,559662,559750,556388,3362,202,35,35,28,31882,31882,31847,31847
Madera,18,2022-04-19,24,24,23,1,2637,2637,2572,65,4,0,0,2,370,370,370,370
Marin,18,2022-04-19,327,327,319,8,6062,6062,5916,146,7,0,0,0,295,295,295,295
Mariposa,18,2022-04-19,19,19,19,0,253,253,246,7,0,0,0,0,28,28,28,28
Mendocino,18,2022-04-19,66,66,64,2,1312,1312,1269,43,2,1,1,0,125,125,124,124
Merced,18,2022-04-19,67,67,66,1,2999,2999,2943,56,2,2,2,0,822,822,820,820
Modoc,18,2022-04-19,2,2,2,0,42,42,41,1,0,0,0,0,7,7,7,7
Mono,18,2022-04-19,9,9,9,0,127,127,122,5,0,0,0,0,6,6,6,6
Monterey,18,2022-04-19,212,212,204,8,6725,6725,6470,255,2,1,1,0,731,731,730,730
Napa,18,2022-04-19,183,183,180,3,3091,3091,3040,51,1,0,0,0,143,143,143,143
Nevada,18,2022-04-19,47,47,46,1,1285,1285,1254,31,3,0,0,0,131,131,131,131
Orange,18,2022-04-19,1533,1533,1511,22,79363,79375,78232,1143,51,6,6,15,7117,7117,7111,7111
Placer,18,2022-04-19,173,173,168,5,5046,5046,4913,133,24,0,0,3,627,627,627,627
Plumas,18,2022-04-19,4,4,4,0,230,230,224,6,0,0,0,0,13,13,13,13
Riverside,18,2022-04-19,1020,1020,1001,19,37369,37374,36655,719,41,6,6,6,6459,6459,6453,6453
Sacramento,18,2022-04-19,773,773,757,16,28602,28607,28019,588,47,8,8,9,3064,3064,3056,3056
San Benito,18,2022-04-19,29,29,29,0,1171,1171,1151,20,0,0,0,0,94,94,94,94
San Bernardino,18,2022-04-19,1119,1119,1102,17,40136,40141,39518,623,31,4,4,11,7817,7817,7813,7813
San Diego,18,2022-04-19,2190,2190,2176,14,67414,67425,66986,439,84,11,11,16,5352,5352,5341,5341
San Francisco,18,2022-04-19,1528,1528,1465,63,31046,31051,29750,1301,22,2,2,5,874,874,872,872
San Joaquin,18,2022-04-19,269,269,263,6,15073,15075,14736,339,11,1,1,4,2250,2250,2249,2249
San Luis Obispo,18,2022-04-19,186,186,183,3,4983,4983,4895,88,2,2,2,1,481,481,479,479
San Mateo,18,2022-04-19,1196,1196,1179,17,31209,31214,30763,451,12,2,2,2,707,707,705,705
Santa Barbara,18,2022-04-19,321,321,315,6,14672,14672,14381,291,8,0,0,0,691,691,691,691
Santa Clara,18,2022-04-19,2339,2339,2323,16,69406,69416,68935,481,65,3,3,17,2306,2306,2303,2303
Santa Cruz,18,2022-04-19,448,448,441,7,12617,12619,12414,205,3,1,1,0,261,261,260,260
Shasta,18,2022-04-19,33,33,32,1,2968,2968,2907,61,3,1,1,2,561,561,560,560
Siskiyou,18,2022-04-19,9,9,9,0,317,317,312,5,0,0,0,0,83,83,83,83
Solano,18,2022-04-19,291,291,285,6,9407,9407,9225,182,6,1,1,2,450,450,449,449
Sonoma,18,2022-04-19,534,534,524,10,11317,11318,11106,212,13,1,1,4,492,492,491,491
Stanislaus,18,2022-04-19,156,156,151,5,7587,7587,7363,224,20,0,0,2,1691,1691,1691,1691
Sutter,18,2022-04-19,23,23,23,0,1194,1194,1171,23,0,0,0,0,225,225,225,225
Tehama,18,2022-04-19,10,10,10,0,682,682,662,20,2,0,0,0,207,207,207,207
Trinity,18,2022-04-19,1,1,1,0,79,79,77,2,0,0,0,0,20,20,20,20
Tulare,18,2022-04-19,82,82,80,2,6756,6756,6553,203,10,0,0,0,1495,1495,1495,1495
Tuolumne,18,2022-04-19,30,30,29,1,1067,1067,1041,26,0,0,0,0,183,183,183,183
Ventura,18,2022-04-19,399,399,394,5,16795,16797,16575,222,9,4,4,0,1506,1506,1502,1502
Yolo,18,2022-04-19,238,238,234,4,18136,18138,17821,317,1,1,1,0,361,361,360,360
Yuba,18,2022-04-19,34,34,33,1,1055,1055,1036,19,0,0,0,0,119,119,119,119
Alameda,19,2022-04-26,2665,2665,2633,32,63802,63816,63047,769,44,6,6,6,1883,1883,1877,1877
Amador,19,2022-04-26,28,28,27,1,1307,1307,1281,26,0,0,0,0,86,86,86,86
Butte,19,2022-04-26,78,78,77,1,2548,2548,2523,25,4,1,1,1,432,432,431,431
Calaveras,19,2022-04-26,33,33,32,1,692,692,680,12,1,0,0,0,120,120,120,120
Colusa,19,2022-04-26,2,2,2,0,214,214,211,3,0,0,0,0,21,21,21,21
Contra Costa,19,2022-04-26,1540,1540,1509,31,27853,27858,27294,564,28,3,3,3,1306,1306,1303,1303
Del Norte,19,2022-04-26,26,26,26,0,1107,1107,1090,17,1,0,0,0,49,49,49,49
El Dorado,19,2022-04-26,108,108,106,2,2646,2646,2601,45,0,0,0,0,214,214,214,214
Fresno,19,2022-04-26,385,385,378,7,15884,15886,15584,302,31,2,2,3,2767,2767,2765,2765
Glenn,19,2022-04-26,4,4,4,0,282,282,277,5,0,0,0,0,53,53,53,53
Humboldt,19,2022-04-26,181,181,178,3,2869,2869,2824,45,3,0,0,2,147,147,147,147
Imperial,19,2022-04-26,73,73,72,1,3545,3545,3485,60,4,0,0,1,945,945,945,945
Inyo,19,2022-04-26,7,7,7,0,193,193,190,3,0,0,0,0,56,56,56,56
Kern,19,2022-04-26,250,250,246,4,18038,18042,17789,253,15,2,2,4,2346,2346,2344,2344
Kings,19,2022-04-26,58,58,57,1,4506,4506,4429,77,2,0,0,1,449,449,449,449
Lake,19,2022-04-26,20,20,20,0,937,937,919,18,0,0,0,0,140,140,140,140
Lassen,19,2022-04-26,2,2,2,0,1545,1545,1525,20,0,0,0,0,62,62,62,62
Los Angeles,19,2022-04-26,11925,11927,11870,57,900949,901131,896773,4358,207,29,29,28,31911,31911,31882,31882
Madera,19,2022-04-26,50,50,49,1,2930,2930,2874,56,2,0,0,1,370,370,370,370
Marin,19,2022-04-26,330,330,324,6,6488,6488,6366,122,5,0,0,0,295,295,295,295
Mariposa,19,2022-04-26,7,7,7,0,223,223,218,5,0,0,0,0,28,28,28,28
Mendocino,19,2022-04-26,48,48,47,1,1226,1226,1195,31,0,1,1,0,126,126,125,125
Merced,19,2022-04-26,101,101,100,1,3105,3105,3060,45,5,0,0,0,822,822,822,822
Modoc,19,2022-04-26,0,0,0,0,36,36,35,1,0,0,0,0,7,7,7,7
Mono,19,2022-04-26,3,3,3,0,86,86,83,3,0,0,0,0,6,6,6,6
Monterey,19,2022-04-26,288,288,279,9,8134,8134,7891,243,6,1,1,0,732,732,731,731
Napa,19,2022-04-26,214,214,211,3,3338,3338,3295,43,4,0,0,0,143,143,143,143
Nevada,19,2022-04-26,48,48,47,1,1416,1416,1389,27,2,0,0,0,131,131,131,131
Orange,19,2022-04-26,2107,2107,2084,23,87804,87823,86835,988,55,7,7,13,7124,7124,7117,7117
Placer,19,2022-04-26,240,240,235,5,6074,6074,5948,126,22,0,0,5,627,627,627,627
Plumas,19,2022-04-26,4,4,4,0,231,231,227,4,0,0,0,0,13,13,13,13
Riverside,19,2022-04-26,1359,1359,1339,20,40834,40841,40226,615,34,4,4,6,6463,6463,6459,6459
Sacramento,19,2022-04-26,1034,1034,1017,17,31992,31998,31481,517,49,5,5,8,3069,3069,3064,3064
San Benito,19,2022-04-26,35,35,35,0,1102,1102,1087,15,0,0,0,0,94,94,94,94
San Bernardino,19,2022-04-26,1313,1313,1297,16,42833,42840,42318,522,32,12,12,7,7829,7829,7817,7817
San Diego,19,2022-04-26,3220,3220,3204,16,74120,74134,73756,378,91,2,2,11,5354,5354,5352,5352
San Francisco,19,2022-04-26,2044,2044,1977,67,32611,32616,31544,1072,27,1,1,3,875,875,874,874
San Joaquin,19,2022-04-26,413,413,406,7,15006,15008,14743,265,11,0,0,3,2250,2250,2250,2250
San Luis Obispo,19,2022-04-26,229,229,226,3,5037,5037,4968,69,5,0,0,0,481,481,481,481
San Mateo,19,2022-04-26,1580,1580,1562,18,34247,34254,33869,385,15,2,2,5,709,709,707,707
Santa Barbara,19,2022-04-26,361,361,355,6,15245,15248,15012,236,11,2,2,2,693,693,691,691
Santa Clara,19,2022-04-26,3343,3343,3325,18,82755,82772,82330,442,70,4,4,10,2310,2310,2306,2306
Santa Cruz,19,2022-04-26,511,511,504,7,20812,20816,20544,272,6,0,0,0,261,261,261,261
Shasta,19,2022-04-26,54,54,53,1,3355,3355,3301,54,1,0,0,1,561,561,561,561
Siskiyou,19,2022-04-26,6,6,6,0,318,318,314,4,0,0,0,0,83,83,83,83
Solano,19,2022-04-26,532,532,524,8,11005,11007,10841,166,13,0,0,2,450,450,450,450
Sonoma,19,2022-04-26,698,698,688,10,11968,11970,11795,175,20,0,0,2,492,492,492,492
Stanislaus,19,2022-04-26,257,257,251,6,8055,8055,7869,186,23,4,4,1,1695,1695,1691,1691
Sutter,19,2022-04-26,40,40,39,1,1346,1346,1325,21,0,2,2,0,227,227,225,225
Tehama,19,2022-04-26,13,13,13,0,697,697,681,16,1,0,0,0,207,207,207,207
Trinity,19,2022-04-26,2,2,2,0,65,65,63,2,0,0,0,0,20,20,20,20
Tulare,19,2022-04-26,103,103,101,2,6948,6948,6784,164,10,2,2,0,1497,1497,1495,1495
Tuolumne,19,2022-04-26,46,46,45,1,1123,1123,1102,21,2,0,0,0,183,183,183,183
Ventura,19,2022-04-26,623,623,617,6,19242,19247,19048,199,14,0,0,2,1506,1506,1506,1506
Yolo,19,2022-04-26,277,277,273,4,19192,19197,18934,263,0,0,0,0,361,361,361,361
Yuba,19,2022-04-26,32,32,32,0,1065,1065,1050,15,1,0,0,0,119,119,119,119
Alameda,20,2022-05-03,3502,3502,3469,33,67814,67832,67188,644,44,3,3,5,1886,1886,1883,1883
Amador,20,2022-05-03,19,19,19,0,1366,1366,1345,21,1,0,0,0,86,86,86,86
Butte,20,2022-05-03,98,98,97,1,2394,2394,2376,18,4,2,2,0,434,434,432,432
Calaveras,20,2022-05-03,21,21,21,0,720,720,710,10,0,0,0,0,120,120,120,120
Colusa,20,2022-05-03,2,2,2,0,191,191,189,2,0,0,0,0,21,21,21,21
Contra Costa,20,2022-05-03,1987,1987,1956,31,29245,29251,28787,464,35,2,2,5,1308,1308,1306,1306
Del Norte,20,2022-05-03,41,41,40,1,1239,1239,1224,15,0,0,0,0,49,49,49,49
El Dorado,20,2022-05-03,142,142,140,2,2778,2778,2741,37,2,1,1,0,215,215,214,214
Fresno,20,2022-05-03,524,524,516,8,16771,16776,16526,250,40,4,4,4,2771,2771,2767,2767
Glenn,20,2022-05-03,6,6,6,0,250,250,247,3,0,0,0,0,53,53,53,53
Humboldt,20,2022-05-03,278,278,275,3,3107,3107,3069,38,5,0,0,2,147,147,147,147
Imperial,20,2022-05-03,116,116,114,2,3662,3662,3613,49,1,0,0,1,945,945,945,945
Inyo,20,2022-05-03,3,3,3,0,185,185,183,2,0,0,0,0,56,56,56,56
Kern,20,2022-05-03,334,334,330,4,17922,17927,17730,197,15,1,1,5,2347,2347,2346,2346
Kings,20,2022-05-03,67,67,66,1,4891,4891,4826,65,3,0,0,0,449,449,449,449
Lake,20,2022-05-03,30,30,30,0,991,991,976,15,1,0,0,0,140,140,140,140
Lassen,20,2022-05-03,9,9,9,0,1663,1663,1646,17,0,0,0,0,62,62,62,62
Los Angeles,20,2022-05-03,15458,15462,15404,58,913344,913574,910115,3459,221,26,26,27,31937,31937,31911,31911
Madera,20,2022-05-03,79,79,78,1,3385,3385,3334,51,5,0,0,0,370,370,370,370
Marin,20,2022-05-03,489,489,482,7,6788,6788,6689,99,13,0,0,0,295,295,295,295
Mariposa,20,2022-05-03,12,12,12,0,224,224,220,4,0,0,0,0,28,28,28,28
Mendocino,20,2022-05-03,68,68,67,1,1268,1268,1243,25,1,0,0,0,126,126,126,126
Merced,20,2022-05-03,149,149,147,2,3275,3275,3238,37,5,4,4,0,826,826,822,822
Modoc,20,2022-05-03,1,1,1,0,37,38,37,1,0,0,0,0,7,7,7,7
Mono,20,2022-05-03,8,8,8,0,112,112,109,3,0,0,0,0,6,6,6,6
Monterey,20,2022-05-03,394,394,385,9,8806,8808,8603,205,10,1,1,0,733,733,732,732
Napa,20,2022-05-03,227,227,225,2,3475,3475,3440,35,1,0,0,0,143,143,143,143
Nevada,20,2022-05-03,92,92,91,1,1567,1567,1544,23,1,0,0,0,131,131,131,131
Orange,20,2022-05-03,2785,2785,2761,24,87410,87433,86663,770,67,5,5,12,7129,7129,7124,7124
Placer,20,2022-05-03,327,327,322,5,6476,6476,6371,105,20,0,0,4,627,627,627,627
Plumas,20,2022-05-03,7,7,7,0,260,260,256,4,0,0,0,0,13,13,13,13
Riverside,20,2022-05-03,2177,2177,2152,25,43769,43781,43266,515,33,3,3,5,6466,6466,6463,6463
Sacramento,20,2022-05-03,1537,1537,1518,19,34244,34252,33820,432,48,4,4,12,3073,3073,3069,3069
San Benito,20,2022-05-03,55,55,54,1,1348,1348,1334,14,0,0,0,0,94,94,94,94
San Bernardino,20,2022-05-03,1547,1547,1532,15,44357,44370,43949,421,36,5,5,7,7834,7834,7829,7829
San Diego,20,2022-05-03,4308,4308,4291,17,75883,75901,75601,300,87,3,3,13,5357,5357,5354,5354
San Francisco,20,2022-05-03,2499,2499,2435,64,36201,36211,35274,937,42,3,3,10,878,878,875,875
San Joaquin,20,2022-05-03,577,577,569,8,15056,15059,14850,209,14,1,1,2,2251,2251,2250,2250
San Luis Obispo,20,2022-05-03,253,253,250,3,5102,5102,5047,55,4,2,2,0,483,483,481,481
San Mateo,20,2022-05-03,1870,1870,1854,16,35876,35885,35568,317,19,2,2,4,711,711,709,709
Santa Barbara,20,2022-05-03,480,480,474,6,15499,15504,15316,188,9,0,0,2,693,693,693,693
Santa Clara,20,2022-05-03,4626,4626,4607,19,99065,99089,98672,417,85,6,6,16,2316,2316,2310,2310
Santa Cruz,20,2022-05-03,662,662,655,7,22231,22236,22008,228,1,1,1,0,262,262,261,261
Shasta,20,2022-05-03,75,75,74,1,3407,3407,3364,43,6,0,0,1,561,561,561,561
Siskiyou,20,2022-05-03,12,12,12,0,325,325,322,3,1,0,0,0,83,83,83,83
Solano,20,2022-05-03,647,647,639,8,11963,11965,11824,141,18,0,0,0,450,450,450,450
Sonoma,20,2022-05-03,955,955,944,11,13164,13166,13016,150,18,1,1,4,493,493,492,492
Stanislaus,20,2022-05-03,297,297,292,5,8222,8224,8075,149,21,0,0,1,1695,1695,1695,1695
Sutter,20,2022-05-03,51,51,50,1,1427,1427,1410,17,0,0,0,0,227,227,227,227
Tehama,20,2022-05-03,22,22,22,0,703,703,691,12,0,0,0,0,207,207,207,207
Trinity,20,2022-05-03,1,1,1,0,86,86,84,2,0,0,0,0,20,20,20,20
Tulare,20,2022-05-03,159,159,156,3,7342,7342,7206,136,9,3,3,0,1500,1500,1497,1497
Tuolumne,20,2022-05-03,90,90,89,1,1294,1294,1275,19,4,1,1,0,184,184,183,183
Ventura,20,2022-05-03,797,797,791,6,20058,20063,19901,162,15,4,4,0,1510,1510,1506,1506
Yolo,20,2022-05-03,367,367,363,4,19030,19035,18831,204,0,1,1,0,362,362,361,361
Yuba,20,2022-05-03,41,41,41,0,1124,1124,1111,13,2,0,0,0,119,119,119,119
Alameda,21,2022-05-10,4291,4291,4259,32,72591,72614,72076,538,53,8,8,4,1894,1894,1886,1886
Amador,21,2022-05-10,28,28,28,0,1575,1575,1556,19,1,0,0,0,86,86,86,86
Butte,21,2022-05-10,118,118,117,1,2449,2449,2434,15,7,0,0,0,434,434,434,434
Calaveras,21,2022-05-10,38,38,38,0,709,709,702,7,0,0,0,0,120,120,120,120
Colusa,21,2022-05-10,5,5,5,0,214,214,212,2,0,0,0,0,21,21,21,21
Contra Costa,21,2022-05-10,2615,2615,2583,32,31252,31264,30876,388,48,4,4,9,1312,1312,1308,1308
Del Norte,21,2022-05-10,53,53,52,1,1366,1366,1353,13,0,0,0,1,49,49,49,49
El Dorado,21,2022-05-10,187,187,185,2,2954,2954,2923,31,3,0,0,0,215,215,215,215
Fresno,21,2022-05-10,790,790,781,9,17841,17846,17638,208,38,1,1,1,2772,2772,2771,2771
Glenn,21,2022-05-10,8,8,8,0,236,236,234,2,0,0,0,0,53,53,53,53
Humboldt,21,2022-05-10,273,273,270,3,3125,3125,3095,30,7,0,0,2,147,147,147,147
Imperial,21,2022-05-10,152,152,150,2,3730,3730,3691,39,0,0,0,1,945,945,945,945
Inyo,21,2022-05-10,28,28,28,0,221,221,219,2,0,0,0,0,56,56,56,56
Kern,21,2022-05-10,480,480,476,4,18936,18942,18779,163,17,2,2,3,2349,2349,2347,2347
Kings,21,2022-05-10,105,105,104,1,4962,4962,4910,52,0,0,0,0,449,449,449,449
Lake,21,2022-05-10,34,34,34,0,1054,1054,1041,13,0,0,0,0,140,140,140,140
Lassen,21,2022-05-10,7,7,7,0,1662,1662,1649,13,0,0,0,0,62,62,62,62
Los Angeles,21,2022-05-10,18750,18756,18701,55,927937,928235,925496,2739,225,33,33,24,31970,31970,31937,31937
Madera,21,2022-05-10,147,147,145,2,3786,3786,3741,45,3,0,0,0,370,370,370,370
Marin,21,2022-05-10,702,702,694,8,7824,7826,7736,90,10,0,0,1,295,295,295,295
Mariposa,21,2022-05-10,32,32,32,0,336,336,332,4,0,0,0,0,28,28,28,28
Mendocino,21,2022-05-10,85,85,84,1,1242,1242,1223,19,1,1,1,0,127,127,126,126
Merced,21,2022-05-10,206,206,204,2,3521,3521,3490,31,5,1,1,0,827,827,826,826
Modoc,21,2022-05-10,1,1,1,0,43,44,43,1,0,0,0,0,7,7,7,7
Mono,21,2022-05-10,9,9,9,0,109,109,107,2,0,0,0,0,6,6,6,6
Monterey,21,2022-05-10,454,454,446,8,9324,9326,9155,171,11,0,0,0,733,733,733,733
Napa,21,2022-05-10,245,245,243,2,3242,3242,3216,26,1,0,0,0,143,143,143,143
Nevada,21,2022-05-10,112,112,111,1,1654,1654,1635,19,4,0,0,1,131,131,131,131
Orange,21,2022-05-10,3665,3665,3640,25,91742,91772,91140,632,77,8,8,13,7137,7137,7129,7129
Placer,21,2022-05-10,542,542,535,7,6902,6903,6815,88,27,0,0,2,627,627,627,627
Plumas,21,2022-05-10,22,22,22,0,277,277,274,3,0,0,0,0,13,13,13,13
Riverside,21,2022-05-10,2501,2501,2478,23,44962,44976,44562,414,50,4,4,7,6470,6470,6466,6466
Sacramento,21,2022-05-10,2383,2383,2360,23,36626,36640,36278,362,61,4,4,13,3077,3077,3073,3073
San Benito,21,2022-05-10,81,81,80,1,1440,1440,1428,12,0,0,0,0,94,94,94,94
San Bernardino,21,2022-05-10,1990,1990,1975,15,46762,46776,46429,347,39,7,7,5,7841,7841,7834,7834
San Diego,21,2022-05-10,5332,5332,5316,16,87961,87990,87717,273,96,3,3,14,5360,5360,5357,5357
San Francisco,21,2022-05-10,3174,3174,3110,64,38692,38705,37921,784,58,7,7,3,885,885,878,878
San Joaquin,21,2022-05-10,839,839,830,9,16954,16959,16776,183,12,1,1,2,2252,2252,2251,2251
San Luis Obispo,21,2022-05-10,290,290,288,2,5351,5351,5306,45,0,0,0,1,483,483,483,483
San Mateo,21,2022-05-10,2417,2417,2400,17,37897,37911,37650,261,28,2,2,1,713,713,711,711
Santa Barbara,21,2022-05-10,667,667,661,6,15455,15460,15314,146,11,0,0,3,693,693,693,693
Santa Clara,21,2022-05-10,5849,5849,5830,19,105975,106008,105659,349,95,3,3,26,2319,2319,2316,2316
Santa Cruz,21,2022-05-10,744,744,738,6,24266,24274,24079,195,2,0,0,0,262,262,262,262
Shasta,21,2022-05-10,101,101,100,1,3371,3371,3338,33,9,0,0,0,561,561,561,561
Siskiyou,21,2022-05-10,15,15,15,0,297,297,295,2,0,0,0,0,83,83,83,83
Solano,21,2022-05-10,938,938,929,9,12531,12536,12420,116,24,0,0,2,450,450,450,450
Sonoma,21,2022-05-10,1259,1259,1248,11,14336,14341,14213,128,17,1,1,1,494,494,493,493
Stanislaus,21,2022-05-10,483,483,476,7,9060,9062,8934,128,24,1,1,3,1696,1696,1695,1695
Sutter,21,2022-05-10,67,67,66,1,1591,1591,1576,15,0,0,0,0,227,227,227,227
Tehama,21,2022-05-10,25,25,25,0,699,699,689,10,1,0,0,1,207,207,207,207
Trinity,21,2022-05-10,3,3,3,0,70,70,69,1,0,0,0,0,20,20,20,20
Tulare,21,2022-05-10,210,210,207,3,7667,7669,7558,111,13,1,1,1,1501,1501,1500,1500
Tuolumne,21,2022-05-10,73,73,72,1,1483,1483,1466,17,1,2,2,0,186,186,184,184
Ventura,21,2022-05-10,1205,1205,1197,8,21654,21660,21523,137,14,1,1,3,1511,1511,1510,1510
Yolo,21,2022-05-10,524,524,520,4,20316,20322,20153,169,3,0,0,0,362,362,362,362
Yuba,21,2022-05-10,81,81,80,1,1213,1213,1202,11,2,0,0,0,119,119,119,119
Alameda,22,2022-05-17,5221,5221,5191,30,76152,76184,75744,440,71,7,7,4,1901,1901,1894,1894
Amador,22,2022-05-17,58,58,57,1,1661,1661,1645,16,0,0,0,0,86,86,86,86
Butte,22,2022-05-17,239,239,238,1,2716,2716,2703,13,9,2,2,0,436,436,434,434
Calaveras,22,2022-05-17,43,43,43,0,784,784,778,6,0,1,1,2,121,121,120,120
Colusa,22,2022-05-17,6,6,6,0,222,222,220,2,0,0,0,0,21,21,21,21
Contra Costa,22,2022-05-17,3662,3662,3627,35,33934,33949,33620,329,52,5,5,7,1317,1317,1312,1312
Del Norte,22,2022-05-17,179,179,178,1,1929,1929,1914,15,0,1,1,0,50,50,49,49
El Dorado,22,2022-05-17,293,293,291,2,3108,3108,3083,25,6,1,1,0,216,216,215,215
Fresno,22,2022-05-17,1247,1247,1236,11,19492,19501,19324,177,41,2,2,6,2774,2774,2772,2772
Glenn,22,2022-05-17,18,18,18,0,260,260,258,2,0,0,0,0,53,53,53,53
Humboldt,22,2022-05-17,269,269,267,2,3104,3104,3081,23,11,1,1,4,148,148,147,147
Imperial,22,2022-05-17,237,237,235,2,4427,4427,4391,36,3,0,0,1,945,945,945,945
Inyo,22,2022-05-17,20,20,20,0,242,242,240,2,1,0,0,0,56,56,56,56
Kern,22,2022-05-17,742,742,737,5,20139,20147,20012,135,18,2,2,3,2351,2351,2349,2349
Kings,22,2022-05-17,239,239,237,2,5589,5590,5544,46,0,1,1,0,450,450,449,449
Lake,22,2022-05-17,74,74,73,1,1214,1214,1203,11,2,0,0,0,140,140,140,140
Lassen,22,2022-05-17,24,24,24,0,1737,1737,1726,11,1,0,0,0,62,62,62,62
Los Angeles,22,2022-05-17,22493,22502,22451,51,936914,937313,935155,2158,308,36,36,55,32006,32006,31970,31970
Madera,22,2022-05-17,198,198,196,2,3599,3599,3566,33,4,0,0,1,370,370,370,370
Marin,22,2022-05-17,863,863,855,8,8473,8477,8401,76,15,0,0,0,295,295,295,295
Mariposa,22,2022-05-17,19,19,19,0,331,331,328,3,0,0,0,0,28,28,28,28
Mendocino,22,2022-05-17,114,114,113,1,1400,1400,1383,17,2,1,1,2,128,128,127,127
Merced,22,2022-05-17,345,345,343,2,4048,4048,4020,28,5,1,1,1,828,828,827,827
Modoc,22,2022-05-17,4,4,4,0,43,44,43,1,0,0,0,0,7,7,7,7
Mono,22,2022-05-17,12,12,12,0,116,116,114,2,0,0,0,0,6,6,6,6
Monterey,22,2022-05-17,529,529,521,8,9549,9554,9417,137,5,2,2,1,735,735,733,733
Napa,22,2022-05-17,300,300,298,2,3801,3801,3778,23,3,0,0,0,143,143,143,143
Nevada,22,2022-05-17,137,137,136,1,1837,1837,1820,17,2,0,0,0,131,131,131,131
Orange,22,2022-05-17,4761,4761,4736,25,96049,96090,95574,516,98,8,8,14,7145,7145,7137,7137
Placer,22,2022-05-17,791,791,783,8,7812,7815,7737,78,43,2,2,2,629,629,627,627
Plumas,22,2022-05-17,49,49,49,0,251,251,249,2,1,0,0,0,13,13,13,13
Riverside,22,2022-05-17,3570,3570,3545,25,48996,49017,48665,352,69,1,1,7,6471,6471,6470,6470
Sacramento,22,2022-05-17,3381,3381,3355,26,40712,40730,40416,314,94,8,8,12,3085,3085,3077,3077
San Benito,22,2022-05-17,109,109,108,1,1531,1531,1521,10,1,0,0,0,94,94,94,94
San Bernardino,22,2022-05-17,2607,2607,2592,15,49235,49255,48969,286,40,6,6,6,7847,7847,7841,7841
San Diego,22,2022-05-17,7234,7236,7219,17,97154,97197,96962,235,98,5,5,22,5365,5365,5360,5360
San Francisco,22,2022-05-17,3556,3556,3500,56,39575,39592,38964,628,66,4,4,10,889,889,885,885
San Joaquin,22,2022-05-17,1296,1296,1285,11,19575,19582,19417,165,19,2,2,2,2254,2254,2252,2252
San Luis Obispo,22,2022-05-17,476,476,473,3,6298,6300,6259,41,5,0,0,0,483,483,483,483
San Mateo,22,2022-05-17,2896,2896,2881,15,41143,41162,40941,221,42,1,1,1,714,714,713,713
Santa Barbara,22,2022-05-17,928,928,921,7,17227,17234,17107,127,15,0,0,3,693,693,693,693
Santa Clara,22,2022-05-17,7389,7391,7372,19,113177,113225,112934,291,118,9,9,17,2328,2328,2319,2319
Santa Cruz,22,2022-05-17,746,746,741,5,17217,17224,17112,112,5,0,0,0,262,262,262,262
Shasta,22,2022-05-17,146,146,145,1,3839,3839,3809,30,5,0,0,1,561,561,561,561
Siskiyou,22,2022-05-17,20,20,20,0,377,377,375,2,0,0,0,0,83,83,83,83
Solano,22,2022-05-17,1381,1381,1371,10,14404,14409,14305,104,29,0,0,3,450,450,450,450
Sonoma,22,2022-05-17,1612,1612,1601,11,15556,15562,15453,109,23,0,0,4,494,494,494,494
Stanislaus,22,2022-05-17,798,798,789,9,10267,10272,10158,114,35,1,1,4,1697,1697,1696,1696
Sutter,22,2022-05-17,110,110,109,1,1777,1777,1764,13,0,0,0,0,227,227,227,227
Tehama,22,2022-05-17,44,44,44,0,841,841,832,9,0,1,1,1,208,208,207,207
Trinity,22,2022-05-17,6,6,6,0,78,78,77,1,0,0,0,0,20,20,20,20
Tulare,22,2022-05-17,429,429,424,5,8473,8476,8380,96,17,0,0,0,1501,1501,1501,1501
Tuolumne,22,2022-05-17,164,164,163,1,1522,1522,1508,14,1,0,0,0,186,186,186,186
Ventura,22,2022-05-17,1666,1666,1658,8,23972,23982,23864,118,28,2,2,3,1513,1513,1511,1511
Yolo,22,2022-05-17,714,714,709,5,22229,22239,22094,145,0,0,0,1,362,362,362,362
Yuba,22,2022-05-17,137,137,136,1,1368,1368,1359,9,4,0,0,0,119,119,119,119
Alameda,23,2022-05-24,5535,5537,5512,25,77236,77277,76929,348,91,5,5,5,1906,1906,1901,1901
Amador,23,2022-05-24,103,103,102,1,1492,1492,1481,11,1,1,1,1,87,87,86,86
Butte,23,2022-05-24,274,274,273,1,2768,2768,2758,10,9,1,1,0,437,437,436,436
Calaveras,23,2022-05-24,53,53,53,0,712,712,707,5,0,1,1,0,122,122,121,121
Colusa,23,2022-05-24,7,7,7,0,220,220,219,1,0,0,0,0,21,21,21,21
Contra Costa,23,2022-05-24,3929,3929,3899,30,35276,35294,35026,268,62,13,13,8,1330,1330,1317,1317
Del Norte,23,2022-05-24,59,59,59,0,1262,1262,1255,7,2,0,0,0,50,50,50,50
El Dorado,23,2022-05-24,383,383,381,2,3514,3514,3492,22,4,2,2,2,218,218,216,216
Fresno,23,2022-05-24,1735,1735,1723,12,21960,21973,21817,156,56,1,1,10,2775,2775,2774,2774
Glenn,23,2022-05-24,25,25,25,0,275,275,273,2,0,0,0,0,53,53,53,53
Humboldt,23,2022-05-24,226,226,225,1,2887,2887,2870,17,12,1,1,3,149,149,148,148
Imperial,23,2022-05-24,322,322,320,2,4727,4729,4699,30,6,0,0,1,945,945,945,945
Inyo,23,2022-05-24,26,26,26,0,213,213,212,1,0,0,0,0,56,56,56,56
Kern,23,2022-05-24,1072,1072,1066,6,21304,21317,21206,111,25,0,0,6,2351,2351,2351,2351
Kings,23,2022-05-24,249,249,247,2,5626,5629,5593,36,4,0,0,0,450,450,450,450
Lake,23,2022-05-24,108,108,107,1,1163,1163,1154,9,0,0,0,2,140,140,140,140
Lassen,23,2022-05-24,44,44,44,0,1773,1773,1764,9,0,0,0,0,62,62,62,62
Los Angeles,23,2022-05-24,28735,28749,28698,51,950453,950951,949245,1706,358,35,35,52,32041,32041,32006,32006
Madera,23,2022-05-24,216,216,214,2,3767,3767,3740,27,2,0,0,2,370,370,370,370
Marin,23,2022-05-24,776,776,771,5,8772,8777,8715,62,11,0,0,1,295,295,295,295
Mariposa,23,2022-05-24,33,33,33,0,336,336,333,3,0,0,0,0,28,28,28,28
Mendocino,23,2022-05-24,146,146,145,1,1661,1661,1645,16,2,1,1,1,129,129,128,128
Merced,23,2022-05-24,416,416,414,2,4228,4229,4206,23,5,0,0,0,828,828,828,828
Modoc,23,2022-05-24,3,3,3,0,39,40,39,1,0,0,0,0,7,7,7,7
Mono,23,2022-05-24,11,11,11,0,161,161,159,2,0,0,0,0,6,6,6,6
Monterey,23,2022-05-24,689,689,681,8,9422,9427,9321,106,16,0,0,1,735,735,735,735
Napa,23,2022-05-24,348,348,346,2,4008,4008,3989,19,3,0,0,0,143,143,143,143
Nevada,23,2022-05-24,166,166,165,1,1923,1923,1909,14,1,0,0,0,131,131,131,131
Orange,23,2022-05-24,5814,5816,5792,24,95449,95498,95098,400,111,11,11,18,7156,7156,7145,7145
Placer,23,2022-05-24,916,916,909,7,7941,7946,7884,62,44,2,2,5,631,631,629,629
Plumas,23,2022-05-24,39,39,39,0,268,268,266,2,1,0,0,0,13,13,13,13
Riverside,23,2022-05-24,4471,4471,4446,25,52695,52722,52426,296,84,6,6,9,6477,6477,6471,6471
Sacramento,23,2022-05-24,3977,3977,3953,24,40936,40956,40709,247,123,8,8,15,3093,3093,3085,3085
San Benito,23,2022-05-24,185,185,184,1,1650,1650,1642,8,0,0,0,0,94,94,94,94
San Bernardino,23,2022-05-24,3493,3493,3477,16,50910,50936,50706,230,52,4,4,8,7851,7851,7847,7847
San Diego,23,2022-05-24,9020,9025,9008,17,104102,104157,103960,197,145,5,5,22,5370,5370,5365,5365
San Francisco,23,2022-05-24,3471,3471,3428,43,41225,41246,40733,513,79,9,9,9,898,898,889,889
San Joaquin,23,2022-05-24,1542,1542,1532,10,20610,20622,20486,136,24,2,2,4,2256,2256,2254,2254
San Luis Obispo,23,2022-05-24,712,712,708,4,7323,7328,7290,38,10,3,3,0,486,486,483,483
San Mateo,23,2022-05-24,3189,3189,3176,13,39551,39571,39405,166,36,0,0,1,714,714,714,714
Santa Barbara,23,2022-05-24,1154,1154,1147,7,17901,17911,17807,104,17,1,1,2,694,694,693,693
Santa Clara,23,2022-05-24,7888,7893,7877,16,110778,110837,110615,222,137,7,7,19,2335,2335,2328,2328
Santa Cruz,23,2022-05-24,529,529,526,3,7877,7882,7843,39,17,0,0,0,262,262,262,262
Shasta,23,2022-05-24,185,185,184,1,3619,3620,3598,22,5,1,1,4,562,562,561,561
Siskiyou,23,2022-05-24,40,40,40,0,374,374,372,2,1,0,0,0,83,83,83,83
Solano,23,2022-05-24,1525,1525,1516,9,14860,14868,14784,84,29,1,1,6,451,451,450,450
Sonoma,23,2022-05-24,1415,1415,1407,8,16637,16645,16554,91,37,2,2,2,496,496,494,494
Stanislaus,23,2022-05-24,869,869,861,8,10548,10553,10462,91,40,2,2,3,1699,1699,1697,1697
Sutter,23,2022-05-24,167,167,166,1,2029,2029,2017,12,0,1,1,0,228,228,227,227
Tehama,23,2022-05-24,54,54,54,0,841,841,834,7,1,0,0,0,208,208,208,208
Trinity,23,2022-05-24,3,3,3,0,94,94,93,1,0,0,0,0,20,20,20,20
Tulare,23,2022-05-24,599,599,594,5,9397,9402,9319,83,27,0,0,0,1501,1501,1501,1501
Tuolumne,23,2022-05-24,127,127,126,1,1539,1539,1528,11,0,1,1,0,187,187,186,186
Ventura,23,2022-05-24,1917,1917,1910,7,23796,23810,23718,92,37,1,1,1,1514,1514,1513,1513
Yolo,23,2022-05-24,729,729,725,4,22180,22192,22079,113,3,1,1,0,363,363,362,362
Yuba,23,2022-05-24,154,154,153,1,1431,1431,1423,8,7,0,0,1,119,119,119,119
Alameda,24,2022-05-31,5352,5356,5337,19,64235,64275,64047,228,86,3,3,12,1909,1909,1906,1906
Amador,24,2022-05-31,71,71,71,0,1179,1179,1172,7,0,0,0,0,87,87,87,87
Butte,24,2022-05-31,305,305,304,1,2924,2924,2916,8,23,0,0,2,437,437,437,437
Calaveras,24,2022-05-31,56,56,56,0,644,644,641,3,0,0,0,0,122,122,122,122
Colusa,24,2022-05-31,14,14,14,0,191,191,190,1,0,0,0,0,21,21,21,21
Contra Costa,24,2022-05-31,3424,3425,3405,20,31340,31358,31172,186,63,4,4,9,1334,1334,1330,1330
Del Norte,24,2022-05-31,49,49,49,0,1042,1042,1037,5,0,1,1,0,51,51,50,50
El Dorado,24,2022-05-31,327,327,325,2,3006,3007,2992,15,8,1,1,1,219,219,218,218
Fresno,24,2022-05-31,1792,1792,1782,10,19984,19996,19885,111,77,6,6,6,2781,2781,2775,2775
Glenn,24,2022-05-31,28,28,28,0,311,311,310,1,3,0,0,0,53,53,53,53
Humboldt,24,2022-05-31,208,208,207,1,2448,2448,2437,11,11,0,0,3,149,149,149,149
Imperial,24,2022-05-31,370,370,368,2,4400,4401,4379,22,2,1,1,1,946,946,945,945
Inyo,24,2022-05-31,20,20,20,0,154,154,153,1,0,0,0,0,56,56,56,56
Kern,24,2022-05-31,1141,1141,1136,5,19181,19194,19115,79,38,0,0,4,2351,2351,2351,2351
Kings,24,2022-05-31,338,338,336,2,4747,4750,4726,24,2,0,0,1,450,450,450,450
Lake,24,2022-05-31,99,99,98,1,1040,1040,1034,6,1,0,0,0,140,140,140,140
Lassen,24,2022-05-31,58,58,58,0,1815,1815,1808,7,1,0,0,0,62,62,62,62
Los Angeles,24,2022-05-31,27933,27949,27910,39,816626,817120,815969,1151,449,42,42,53,32083,32083,32041,32041
Madera,24,2022-05-31,260,260,259,1,3411,3412,3393,19,3,0,0,0,370,370,370,370
Marin,24,2022-05-31,635,635,632,3,7296,7300,7260,40,11,3,3,2,298,298,295,295
Mariposa,24,2022-05-31,60,60,60,0,324,324,322,2,0,0,0,0,28,28,28,28
Mendocino,24,2022-05-31,162,162,161,1,1284,1284,1274,10,3,0,0,1,129,129,129,129
Merced,24,2022-05-31,384,384,382,2,3713,3714,3698,16,8,0,0,2,828,828,828,828
Modoc,24,2022-05-31,6,6,6,0,46,47,46,1,0,0,0,0,7,7,7,7
Mono,24,2022-05-31,9,9,9,0,97,97,96,1,0,0,0,0,6,6,6,6
Monterey,24,2022-05-31,616,616,611,5,8174,8179,8107,72,19,2,2,0,737,737,735,735
Napa,24,2022-05-31,345,345,344,1,3333,3334,3321,13,6,0,0,2,143,143,143,143
Nevada,24,2022-05-31,193,193,192,1,1757,1757,1747,10,4,2,2,0,133,133,131,131
Orange,24,2022-05-31,6116,6120,6100,20,78595,78643,78381,262,120,12,12,19,7168,7168,7156,7156
Placer,24,2022-05-31,740,740,735,5,6152,6156,6118,38,61,0,0,9,631,631,631,631
Plumas,24,2022-05-31,38,38,38,0,209,209,208,1,1,0,0,0,13,13,13,13
Riverside,24,2022-05-31,4144,4145,4127,18,46344,46372,46168,204,96,4,4,8,6481,6481,6477,6477
Sacramento,24,2022-05-31,4047,4048,4029,19,35035,35057,34892,165,147,9,9,15,3102,3102,3093,3093
San Benito,24,2022-05-31,181,181,180,1,1466,1466,1460,6,0,0,0,0,94,94,94,94
San Bernardino,24,2022-05-31,3673,3674,3661,13,46335,46364,46200,164,61,5,5,9,7856,7856,7851,7851
San Diego,24,2022-05-31,8961,8966,8953,13,89183,89237,89105,132,169,10,10,24,5380,5380,5370,5370
San Francisco,24,2022-05-31,3220,3220,3189,31,34543,34563,34226,337,85,8,8,11,906,906,898,898
San Joaquin,24,2022-05-31,1525,1525,1517,8,17435,17447,17356,91,33,2,2,11,2258,2258,2256,2256
San Luis Obispo,24,2022-05-31,714,714,711,3,5893,5896,5872,24,11,1,1,0,487,487,486,486
San Mateo,24,2022-05-31,2854,2854,2845,9,32951,32970,32861,109,37,4,4,1,718,718,714,714
Santa Barbara,24,2022-05-31,1053,1053,1048,5,14983,14993,14925,68,26,1,1,3,695,695,694,694
Santa Clara,24,2022-05-31,7201,7205,7194,11,87703,87756,87618,138,161,9,9,19,2344,2344,2335,2335
Santa Cruz,24,2022-05-31,561,561,559,2,6726,6730,6704,26,6,1,1,1,263,263,262,262
Shasta,24,2022-05-31,149,149,148,1,3456,3457,3441,16,4,3,3,3,565,565,562,562
Siskiyou,24,2022-05-31,48,48,48,0,373,373,372,1,1,0,0,0,83,83,83,83
Solano,24,2022-05-31,1260,1260,1254,6,12301,12307,12253,54,34,0,0,4,451,451,451,451
Sonoma,24,2022-05-31,1258,1258,1253,5,12679,12685,12630,55,36,2,2,4,498,498,496,496
Stanislaus,24,2022-05-31,851,851,845,6,8962,8967,8906,61,56,2,2,0,1701,1701,1699,1699
Sutter,24,2022-05-31,157,157,156,1,1768,1768,1760,8,0,0,0,0,228,228,228,228
Tehama,24,2022-05-31,66,66,66,0,813,813,808,5,3,0,0,0,208,208,208,208
Trinity,24,2022-05-31,8,8,8,0,89,89,88,1,0,0,0,0,20,20,20,20
Tulare,24,2022-05-31,635,635,631,4,8086,8091,8035,56,17,0,0,0,1501,1501,1501,1501
Tuolumne,24,2022-05-31,123,123,122,1,1425,1425,1417,8,3,0,0,0,187,187,187,187
Ventura,24,2022-05-31,1723,1723,1718,5,21118,21131,21067,64,40,1,1,1,1515,1515,1514,1514
Yolo,24,2022-05-31,664,664,661,3,18786,18797,18722,75,5,0,0,0,363,363,363,363
Yuba,24,2022-05-31,142,142,141,1,1360,1360,1354,6,8,0,0,1,119,119,119,119
Alameda,25,2022-06-07,5999,6004,5987,17,66870,66917,66733,184,105,4,4,14,1913,1913,1909,1909
Amador,25,2022-06-07,150,150,149,1,1688,1688,1680,8,1,0,0,0,87,87,87,87
Butte,25,2022-06-07,440,440,439,1,3544,3544,3536,8,24,1,1,1,438,438,437,437
Calaveras,25,2022-06-07,75,75,75,0,686,686,683,3,0,2,2,0,124,124,122,122
Colusa,25,2022-06-07,21,21,21,0,332,332,331,1,10,0,0,0,21,21,21,21
Contra Costa,25,2022-06-07,4048,4050,4031,19,32838,32860,32708,152,99,11,11,8,1345,1345,1334,1334
Del Norte,25,2022-06-07,54,54,54,0,959,959,956,3,3,0,0,0,51,51,51,51
El Dorado,25,2022-06-07,382,382,381,1,3394,3395,3382,13,6,0,0,5,219,219,219,219
Fresno,25,2022-06-07,2404,2404,2394,10,21222,21236,21144,92,92,3,3,8,2784,2784,2781,2781
Glenn,25,2022-06-07,44,44,44,0,311,311,310,1,5,0,0,0,53,53,53,53
Humboldt,25,2022-06-07,245,245,244,1,2880,2880,2870,10,14,1,1,2,150,150,149,149
Imperial,25,2022-06-07,458,458,456,2,4496,4499,4481,18,4,0,0,0,946,946,946,946
Inyo,25,2022-06-07,19,19,19,0,208,208,207,1,1,0,0,0,56,56,56,56
Kern,25,2022-06-07,1613,1613,1608,5,21717,21732,21663,69,28,1,1,7,2352,2352,2351,2351
Kings,25,2022-06-07,359,359,358,1,5255,5260,5240,20,11,0,0,1,450,450,450,450
Lake,25,2022-06-07,127,127,126,1,1128,1128,1123,5,4,0,0,3,140,140,140,140
Lassen,25,2022-06-07,65,65,65,0,2215,2215,2208,7,2,0,0,0,62,62,62,62
Los Angeles,25,2022-06-07,33438,33461,33425,36,952213,952876,951829,1047,491,41,41,64,32124,32124,32083,32083
Madera,25,2022-06-07,366,366,364,2,4445,4448,4429,19,7,0,0,2,370,370,370,370
Marin,25,2022-06-07,738,738,735,3,7378,7383,7351,32,13,3,3,3,301,301,298,298
Mariposa,25,2022-06-07,44,44,44,0,406,406,404,2,0,0,0,0,28,28,28,28
Mendocino,25,2022-06-07,191,191,190,1,1688,1688,1678,10,7,1,1,2,130,130,129,129
Merced,25,2022-06-07,555,555,553,2,4169,4171,4157,14,17,0,0,0,828,828,828,828
Modoc,25,2022-06-07,10,10,10,0,31,32,31,1,1,0,0,0,7,7,7,7
Mono,25,2022-06-07,15,15,15,0,102,102,101,1,0,0,0,0,6,6,6,6
Monterey,25,2022-06-07,955,955,948,7,9204,9209,9146,63,15,2,2,1,739,739,737,737
Napa,25,2022-06-07,558,558,556,2,4020,4021,4009,12,7,1,1,0,144,144,143,143
Nevada,25,2022-06-07,227,227,226,1,1990,1990,1981,9,5,0,0,0,133,133,133,133
Orange,25,2022-06-07,7285,7290,7271,19,71433,71483,71301,182,161,12,12,18,7180,7180,7168,7168
Placer,25,2022-06-07,846,846,842,4,7353,7358,7323,35,65,0,0,7,631,631,631,631
Plumas,25,2022-06-07,41,41,41,0,322,322,321,1,0,0,0,0,13,13,13,13
Riverside,25,2022-06-07,5138,5142,5124,18,52971,53009,52827,182,94,5,5,7,6486,6486,6481,6481
Sacramento,25,2022-06-07,4774,4778,4760,18,40227,40255,40107,148,145,15,15,22,3117,3117,3102,3102
San Benito,25,2022-06-07,259,259,258,1,1929,1929,1923,6,3,0,0,0,94,94,94,94
San Bernardino,25,2022-06-07,4931,4934,4920,14,52386,52423,52279,144,76,6,6,18,7862,7862,7856,7856
San Diego,25,2022-06-07,10296,10303,10291,12,93675,93740,93632,108,188,7,7,25,5387,5387,5380,5380
San Francisco,25,2022-06-07,3384,3384,3358,26,35946,35971,35697,274,81,2,2,11,908,908,906,906
San Joaquin,25,2022-06-07,2119,2119,2110,9,21127,21141,21055,86,44,5,5,8,2263,2263,2258,2258
San Luis Obispo,25,2022-06-07,803,803,800,3,6770,6775,6754,21,18,1,1,1,488,488,487,487
San Mateo,25,2022-06-07,3017,3017,3009,8,34095,34118,34030,88,37,2,2,3,720,720,718,718
Santa Barbara,25,2022-06-07,1167,1167,1163,4,13135,13145,13098,47,20,1,1,5,696,696,695,695
Santa Clara,25,2022-06-07,8213,8220,8210,10,95863,95929,95812,117,159,6,6,33,2350,2350,2344,2344
Santa Cruz,25,2022-06-07,913,913,910,3,9537,9544,9516,28,21,1,1,2,264,264,263,263
Shasta,25,2022-06-07,206,206,205,1,3652,3654,3641,13,12,2,2,2,567,567,565,565
Siskiyou,25,2022-06-07,42,42,42,0,387,387,386,1,2,0,0,0,83,83,83,83
Solano,25,2022-06-07,1695,1695,1689,6,14179,14190,14141,49,30,2,2,5,453,453,451,451
Sonoma,25,2022-06-07,1591,1591,1586,5,12791,12800,12757,43,36,1,1,2,499,499,498,498
Stanislaus,25,2022-06-07,1181,1181,1175,6,10049,10055,10001,54,60,1,1,4,1702,1702,1701,1701
Sutter,25,2022-06-07,197,197,196,1,1804,1804,1798,6,0,0,0,0,228,228,228,228
Tehama,25,2022-06-07,79,79,79,0,979,979,974,5,2,0,0,0,208,208,208,208
Trinity,25,2022-06-07,8,8,8,0,105,105,104,1,0,0,0,0,20,20,20,20
Tulare,25,2022-06-07,839,839,834,5,10165,10171,10116,55,23,0,0,0,1501,1501,1501,1501
Tuolumne,25,2022-06-07,118,118,117,1,1555,1555,1548,7,2,0,0,1,187,187,187,187
Ventura,25,2022-06-07,1907,1907,1903,4,22753,22769,22715,54,39,3,3,3,1518,1518,1515,1515
Yolo,25,2022-06-07,798,798,796,2,19809,19824,19762,62,2,1,1,1,364,364,363,363
Yuba,25,2022-06-07,202,202,201,1,1484,1484,1479,5,9,0,0,1,119,119,119,119
Alameda,26,2022-06-14,5017,5022,5011,11,54716,54758,54641,117,109,7,7,19,1920,1920,1913,1913
Amador,26,2022-06-14,85,85,85,0,1310,1310,1305,5,1,0,0,0,87,87,87,87
Butte,26,2022-06-14,408,408,407,1,3496,3499,3493,6,25,4,4,0,442,442,438,438
Calaveras,26,2022-06-14,76,76,76,0,644,644,642,2,0,0,0,0,124,124,124,124
Colusa,26,2022-06-14,11,11,11,0,255,255,254,1,13,0,0,0,21,21,21,21
Contra Costa,26,2022-06-14,3338,3338,3326,12,27722,27742,27642,100,81,7,7,10,1352,1352,1345,1345
Del Norte,26,2022-06-14,83,83,83,0,672,672,670,2,3,0,0,1,51,51,51,51
El Dorado,26,2022-06-14,327,327,326,1,3324,3325,3315,10,6,3,3,0,222,222,219,219
Fresno,26,2022-06-14,2402,2402,2394,8,20567,20582,20513,69,113,3,3,16,2787,2787,2784,2784
Glenn,26,2022-06-14,28,28,28,0,323,323,322,1,4,0,0,0,53,53,53,53
Humboldt,26,2022-06-14,277,277,276,1,2324,2324,2318,6,13,0,0,3,150,150,150,150
Imperial,26,2022-06-14,473,473,472,1,4541,4545,4531,14,5,1,1,0,947,947,946,946
Inyo,26,2022-06-14,13,13,13,0,186,187,186,1,0,0,0,0,56,56,56,56
Kern,26,2022-06-14,1551,1551,1547,4,21196,21212,21159,53,40,1,1,8,2353,2353,2352,2352
Kings,26,2022-06-14,366,366,365,1,5121,5126,5111,15,3,1,1,0,451,451,450,450
Lake,26,2022-06-14,143,143,143,0,1228,1228,1224,4,0,0,0,1,140,140,140,140
Lassen,26,2022-06-14,75,75,75,0,1815,1815,1811,4,1,0,0,0,62,62,62,62
Los Angeles,26,2022-06-14,28933,28955,28930,25,575864,576299,575799,500,541,52,52,65,32176,32176,32124,32124
Madera,26,2022-06-14,380,380,379,1,3965,3967,3954,13,8,0,0,1,370,370,370,370
Marin,26,2022-06-14,668,668,666,2,6746,6751,6728,23,18,1,1,2,302,302,301,301
Mariposa,26,2022-06-14,49,49,49,0,345,345,344,1,0,0,0,0,28,28,28,28
Mendocino,26,2022-06-14,158,158,157,1,1517,1517,1510,7,6,0,0,1,130,130,130,130
Merced,26,2022-06-14,517,517,516,1,4080,4082,4071,11,9,1,1,3,829,829,828,828
Modoc,26,2022-06-14,6,6,6,0,34,35,34,1,1,1,1,0,8,8,7,7
Mono,26,2022-06-14,18,18,18,0,98,98,97,1,0,1,1,0,7,7,6,6
Monterey,26,2022-06-14,834,834,830,4,8521,8527,8481,46,26,2,2,0,741,741,739,739
Napa,26,2022-06-14,440,440,439,1,3892,3896,3887,9,5,1,1,1,145,145,144,144
Nevada,26,2022-06-14,189,189,188,1,1821,1821,1815,6,10,0,0,1,133,133,133,133
Orange,26,2022-06-14,7152,7159,7145,14,65345,65395,65265,130,170,14,14,15,7194,7194,7180,7180
Placer,26,2022-06-14,769,769,766,3,6703,6708,6683,25,77,2,2,6,633,633,631,631
Plumas,26,2022-06-14,32,32,32,0,247,247,246,1,0,0,0,0,13,13,13,13
Riverside,26,2022-06-14,4998,5003,4990,13,47182,47219,47093,126,107,3,3,11,6489,6489,6486,6486
Sacramento,26,2022-06-14,4084,4087,4075,12,36910,36938,36832,106,187,12,12,23,3129,3129,3117,3117
San Benito,26,2022-06-14,179,179,179,0,1679,1679,1675,4,0,0,0,1,94,94,94,94
San Bernardino,26,2022-06-14,4702,4707,4697,10,48381,48417,48313,104,92,7,7,21,7869,7869,7862,7862
San Diego,26,2022-06-14,9529,9536,9527,9,83127,83191,83116,75,196,10,10,22,5397,5397,5387,5387
San Francisco,26,2022-06-14,3049,3049,3031,18,30874,30897,30714,183,72,9,9,14,917,917,908,908
San Joaquin,26,2022-06-14,1800,1800,1794,6,18968,18982,18922,60,32,4,4,4,2267,2267,2263,2263
San Luis Obispo,26,2022-06-14,655,655,653,2,6079,6084,6069,15,27,5,5,0,493,493,488,488
San Mateo,26,2022-06-14,2590,2590,2585,5,28426,28447,28390,57,44,2,2,4,722,722,720,720
Santa Barbara,26,2022-06-14,883,883,881,2,8978,8983,8958,25,26,1,1,5,697,697,696,696
Santa Clara,26,2022-06-14,6806,6813,6807,6,71567,71623,71555,68,188,15,15,17,2365,2365,2350,2350
Santa Cruz,26,2022-06-14,825,825,823,2,9767,9773,9750,23,20,1,1,1,265,265,264,264
Shasta,26,2022-06-14,218,218,217,1,3410,3412,3402,10,8,2,2,0,569,569,567,567
Siskiyou,26,2022-06-14,44,44,44,0,373,373,372,1,0,0,0,0,83,83,83,83
Solano,26,2022-06-14,1635,1635,1631,4,12543,12553,12519,34,34,0,0,4,453,453,453,453
Sonoma,26,2022-06-14,1352,1352,1348,4,11656,11665,11635,30,37,3,3,3,502,502,499,499
Stanislaus,26,2022-06-14,1111,1111,1106,5,9481,9488,9449,39,57,2,2,9,1704,1704,1702,1702
Sutter,26,2022-06-14,191,191,190,1,1905,1905,1900,5,0,0,0,0,228,228,228,228
Tehama,26,2022-06-14,95,95,95,0,997,997,993,4,4,0,0,0,208,208,208,208
Trinity,26,2022-06-14,11,11,11,0,91,92,91,1,0,0,0,0,20,20,20,20
Tulare,26,2022-06-14,841,841,837,4,9270,9276,9237,39,24,2,2,1,1503,1503,1501,1501
Tuolumne,26,2022-06-14,152,152,151,1,1399,1399,1394,5,1,0,0,0,187,187,187,187
Ventura,26,2022-06-14,1920,1920,1916,4,20257,20272,20235,37,43,3,3,4,1521,1521,1518,1518
Yolo,26,2022-06-14,748,748,746,2,13229,13238,13206,32,1,1,1,0,365,365,364,364
Yuba,26,2022-06-14,163,163,163,0,1446,1446,1442,4,10,0,0,1,119,119,119,119
Alameda,27,2022-06-21,5026,5031,5023,8,47973,48013,47933,80,111,13,13,11,1933,1933,1920,1920
Amador,27,2022-06-21,107,107,107,0,1276,1276,1273,3,4,0,0,0,87,87,87,87
Butte,27,2022-06-21,406,406,405,1,3545,3548,3543,5,29,4,4,1,446,446,442,442
Calaveras,27,2022-06-21,72,72,72,0,625,625,624,1,0,0,0,0,124,124,124,124
Colusa,27,2022-06-21,17,17,17,0,190,191,190,1,12,1,1,0,22,22,21,21
Contra Costa,27,2022-06-21,3371,3373,3364,9,25756,25777,25705,72,80,9,9,11,1361,1361,1352,1352
Del Norte,27,2022-06-21,82,82,82,0,587,587,586,1,3,1,1,1,52,52,51,51
El Dorado,27,2022-06-21,371,371,370,1,3115,3116,3109,7,6,2,2,1,224,224,222,222
Fresno,27,2022-06-21,2534,2534,2527,7,19613,19629,19577,52,100,2,2,15,2789,2789,2787,2787
Glenn,27,2022-06-21,41,41,41,0,318,318,317,1,2,0,0,0,53,53,53,53
Humboldt,27,2022-06-21,268,268,267,1,2262,2262,2257,5,10,1,1,2,151,151,150,150
Imperial,27,2022-06-21,635,635,634,1,3837,3841,3832,9,7,0,0,0,947,947,947,947
Inyo,27,2022-06-21,19,19,19,0,188,189,188,1,0,0,0,0,56,56,56,56
Kern,27,2022-06-21,1680,1680,1677,3,19902,19919,19880,39,44,5,5,9,2358,2358,2353,2353
Kings,27,2022-06-21,428,428,427,1,4781,4786,4775,11,13,1,1,0,452,452,451,451
Lake,27,2022-06-21,117,117,117,0,1258,1258,1255,3,2,0,0,1,140,140,140,140
Lassen,27,2022-06-21,40,40,40,0,1146,1146,1144,2,0,0,0,0,62,62,62,62
Los Angeles,27,2022-06-21,28367,28391,28372,19,353465,353765,353532,233,612,63,63,67,32239,32239,32176,32176
Madera,27,2022-06-21,335,335,334,1,4171,4174,4163,11,3,0,0,1,370,370,370,370
Marin,27,2022-06-21,689,689,687,2,6445,6451,6434,17,15,0,0,1,302,302,302,302
Mariposa,27,2022-06-21,53,53,53,0,327,327,326,1,0,0,0,0,28,28,28,28
Mendocino,27,2022-06-21,184,184,183,1,1588,1588,1582,6,2,0,0,0,130,130,130,130
Merced,27,2022-06-21,558,558,557,1,4057,4061,4053,8,6,2,2,1,831,831,829,829
Modoc,27,2022-06-21,5,5,5,0,36,37,36,1,0,0,0,0,8,8,8,8
Mono,27,2022-06-21,5,5,5,0,79,80,79,1,1,0,0,0,7,7,7,7
Monterey,27,2022-06-21,907,907,903,4,8878,8885,8848,37,39,1,1,4,742,742,741,741
Napa,27,2022-06-21,369,369,368,1,3154,3156,3150,6,4,1,1,1,146,146,145,145
Nevada,27,2022-06-21,164,164,164,0,1621,1621,1617,4,6,1,1,1,134,134,133,133
Orange,27,2022-06-21,7104,7111,7100,11,59330,59381,59289,92,169,10,10,20,7204,7204,7194,7194
Placer,27,2022-06-21,697,697,695,2,6139,6144,6126,18,65,3,3,8,636,636,633,633
Plumas,27,2022-06-21,39,39,39,0,254,254,253,1,0,0,0,0,13,13,13,13
Riverside,27,2022-06-21,5156,5161,5150,11,43384,43422,43332,90,111,8,8,12,6497,6497,6489,6489
Sacramento,27,2022-06-21,3957,3960,3951,9,35205,35235,35156,79,160,11,11,19,3140,3140,3129,3129
San Benito,27,2022-06-21,192,192,192,0,1601,1601,1598,3,0,1,1,2,95,95,94,94
San Bernardino,27,2022-06-21,4633,4638,4630,8,47431,47473,47394,79,109,12,12,18,7881,7881,7869,7869
San Diego,27,2022-06-21,9981,9989,9982,7,78998,79065,79010,55,202,10,10,20,5407,5407,5397,5397
San Francisco,27,2022-06-21,3141,3142,3128,14,28643,28667,28534,133,83,13,13,18,930,930,917,917
San Joaquin,27,2022-06-21,1733,1733,1729,4,18169,18184,18139,45,42,6,6,5,2273,2273,2267,2267
San Luis Obispo,27,2022-06-21,602,602,601,1,5737,5742,5731,11,26,6,6,0,499,499,493,493
San Mateo,27,2022-06-21,2691,2691,2687,4,26221,26243,26202,41,35,2,2,2,724,724,722,722
Santa Barbara,27,2022-06-21,990,990,988,2,8688,8696,8677,19,35,2,2,5,699,699,697,697
Santa Clara,27,2022-06-21,6988,6995,6990,5,63003,63057,63010,47,161,7,7,17,2372,2372,2365,2365
Santa Cruz,27,2022-06-21,853,853,851,2,9107,9114,9097,17,21,1,1,0,266,266,265,265
Shasta,27,2022-06-21,265,265,264,1,3416,3419,3411,8,7,0,0,1,569,569,569,569
Siskiyou,27,2022-06-21,70,70,70,0,394,394,393,1,3,1,1,0,84,84,83,83
Solano,27,2022-06-21,1511,1511,1508,3,12222,12233,12208,25,46,0,0,6,453,453,453,453
Sonoma,27,2022-06-21,1381,1381,1378,3,10554,10563,10541,22,31,1,1,4,503,503,502,502
Stanislaus,27,2022-06-21,1056,1056,1053,3,8661,8668,8640,28,73,4,4,8,1708,1708,1704,1704
Sutter,27,2022-06-21,200,200,200,0,1875,1876,1872,4,0,0,0,0,228,228,228,228
Tehama,27,2022-06-21,93,93,93,0,903,903,900,3,3,0,0,0,208,208,208,208
Trinity,27,2022-06-21,13,13,13,0,111,112,111,1,0,0,0,0,20,20,20,20
Tulare,27,2022-06-21,882,882,879,3,8427,8433,8405,28,30,8,8,1,1511,1511,1503,1503
Tuolumne,27,2022-06-21,154,154,154,0,1575,1575,1571,4,4,0,0,1,187,187,187,187
Ventura,27,2022-06-21,1879,1879,1876,3,18693,18709,18682,27,53,1,1,4,1522,1522,1521,1521
Yolo,27,2022-06-21,704,704,703,1,11232,11243,11222,21,4,2,2,2,367,367,365,365
Yuba,27,2022-06-21,157,157,157,0,1388,1388,1385,3,16,1,1,4,120,120,119,119
Alameda,28,2022-06-28,5514,5520,5513,7,47454,47500,47438,62,124,8,8,13,1941,1941,1933,1933
Amador,28,2022-06-28,93,93,93,0,1249,1249,1246,3,3,0,0,2,87,87,87,87
Butte,28,2022-06-28,394,394,394,0,3351,3355,3351,4,34,2,2,0,448,448,446,446
Calaveras,28,2022-06-28,75,75,75,0,568,568,567,1,0,2,2,0,126,126,124,124
Colusa,28,2022-06-28,31,31,31,0,280,281,280,1,5,0,0,0,22,22,22,22
Contra Costa,28,2022-06-28,3608,3611,3603,8,25619,25645,25589,56,81,9,9,6,1370,1370,1361,1361
Del Norte,28,2022-06-28,149,149,149,0,669,669,668,1,3,1,1,1,53,53,52,52
El Dorado,28,2022-06-28,422,422,421,1,3214,3217,3211,6,6,0,0,1,224,224,224,224
Fresno,28,2022-06-28,2810,2811,2805,6,19408,19427,19387,40,143,2,2,18,2791,2791,2789,2789
Glenn,28,2022-06-28,30,30,30,0,285,285,284,1,1,0,0,0,53,53,53,53
Humboldt,28,2022-06-28,248,248,248,0,2098,2098,2094,4,9,0,0,3,151,151,151,151
Imperial,28,2022-06-28,709,709,708,1,3865,3869,3862,7,6,0,0,4,947,947,947,947
Inyo,28,2022-06-28,38,38,38,0,328,328,327,1,0,0,0,0,56,56,56,56
Kern,28,2022-06-28,1888,1888,1885,3,17076,17092,17066,26,56,8,8,7,2366,2366,2358,2358
Kings,28,2022-06-28,476,476,475,1,3893,3897,3890,7,8,0,0,0,452,452,452,452
Lake,28,2022-06-28,119,119,119,0,1077,1077,1075,2,0,1,1,0,141,141,140,140
Lassen,28,2022-06-28,55,55,55,0,916,916,915,1,2,0,0,0,62,62,62,62
Los Angeles,28,2022-06-28,33554,33585,33568,17,355687,356028,355845,183,702,71,71,77,32310,32310,32239,32239
Madera,28,2022-06-28,417,417,416,1,4226,4230,4221,9,11,0,0,1,370,370,370,370
Marin,28,2022-06-28,664,664,663,1,6055,6061,6049,12,19,1,1,2,303,303,302,302
Mariposa,28,2022-06-28,50,50,50,0,309,309,308,1,0,0,0,0,28,28,28,28
Mendocino,28,2022-06-28,154,154,154,0,1428,1428,1424,4,6,1,1,2,131,131,130,130
Merced,28,2022-06-28,630,630,629,1,3893,3898,3892,6,16,2,2,0,833,833,831,831
Modoc,28,2022-06-28,11,11,11,0,31,32,31,1,1,0,0,0,8,8,8,8
Mono,28,2022-06-28,25,25,25,0,110,111,110,1,0,0,0,0,7,7,7,7
Monterey,28,2022-06-28,937,937,934,3,8139,8147,8120,27,46,2,2,2,744,744,742,742
Napa,28,2022-06-28,393,393,392,1,3314,3318,3313,5,4,2,2,3,148,148,146,146
Nevada,28,2022-06-28,194,194,194,0,1573,1573,1570,3,6,0,0,3,134,134,134,134
Orange,28,2022-06-28,7685,7692,7683,9,59654,59711,59639,72,190,18,18,23,7222,7222,7204,7204
Placer,28,2022-06-28,803,803,801,2,6055,6060,6046,14,88,4,4,5,640,640,636,636
Plumas,28,2022-06-28,49,49,49,0,241,242,241,1,2,0,0,0,13,13,13,13
Riverside,28,2022-06-28,6407,6414,6404,10,44969,45012,44939,73,142,10,10,14,6507,6507,6497,6497
Sacramento,28,2022-06-28,4183,4188,4181,7,34407,34440,34380,60,169,13,13,18,3153,3153,3140,3140
San Benito,28,2022-06-28,230,230,230,0,1692,1692,1690,2,0,0,0,1,95,95,95,95
San Bernardino,28,2022-06-28,5932,5939,5931,8,47650,47696,47634,62,127,13,13,26,7894,7894,7881,7881
San Diego,28,2022-06-28,10804,10814,10808,6,78697,78773,78730,43,264,9,9,36,5416,5416,5407,5407
San Francisco,28,2022-06-28,3206,3208,3197,11,28449,28476,28373,103,99,6,6,20,936,936,930,930
San Joaquin,28,2022-06-28,1911,1911,1907,4,17749,17766,17732,34,39,2,2,6,2275,2275,2273,2273
San Luis Obispo,28,2022-06-28,656,656,655,1,5628,5633,5625,8,31,2,2,0,501,501,499,499
San Mateo,28,2022-06-28,2860,2861,2858,3,26352,26377,26345,32,44,2,2,1,726,726,724,724
Santa Barbara,28,2022-06-28,1150,1150,1148,2,9635,9644,9628,16,26,3,3,3,702,702,699,699
Santa Clara,28,2022-06-28,7762,7769,7765,4,60869,60927,60892,35,211,12,12,19,2384,2384,2372,2372
Santa Cruz,28,2022-06-28,858,858,857,1,9378,9388,9375,13,18,1,1,2,267,267,266,266
Shasta,28,2022-06-28,343,343,342,1,3257,3260,3254,6,22,0,0,2,569,569,569,569
Siskiyou,28,2022-06-28,60,60,60,0,357,358,357,1,5,1,1,0,85,85,84,84
Solano,28,2022-06-28,1593,1593,1590,3,12368,12379,12359,20,46,0,0,4,453,453,453,453
Sonoma,28,2022-06-28,1322,1322,1320,2,9920,9930,9914,16,26,2,2,6,505,505,503,503
Stanislaus,28,2022-06-28,1251,1251,1248,3,8648,8657,8635,22,103,2,2,8,1710,1710,1708,1708
Sutter,28,2022-06-28,206,206,206,0,1853,1854,1851,3,0,0,0,0,228,228,228,228
Tehama,28,2022-06-28,100,100,100,0,894,894,892,2,2,0,0,1,208,208,208,208
Trinity,28,2022-06-28,21,21,21,0,145,146,145,1,2,0,0,0,20,20,20,20
Tulare,28,2022-06-28,939,939,937,2,7843,7850,7830,20,33,0,0,2,1511,1511,1511,1511
Tuolumne,28,2022-06-28,171,171,171,0,1455,1455,1452,3,2,4,4,1,191,191,187,187
Ventura,28,2022-06-28,2134,2134,2132,2,18429,18446,18425,21,67,3,3,1,1525,1525,1522,1522
Yolo,28,2022-06-28,758,758,757,1,10264,10275,10260,15,6,1,1,1,368,368,367,367
Yuba,28,2022-06-28,174,174,174,0,1374,1374,1372,2,8,1,1,2,121,121,120,120
Alameda,29,2022-07-05,5044,5050,5045,5,41062,41106,41064,42,130,12,12,15,1953,1953,1941,1941
Amador,29,2022-07-05,64,64,64,0,1484,1485,1482,3,3,0,0,1,87,87,87,87
Butte,29,2022-07-05,340,340,340,0,2583,2586,2584,2,25,2,2,1,450,450,448,448
Calaveras,29,2022-07-05,77,77,77,0,500,500,499,1,1,2,2,0,128,128,126,126
Colusa,29,2022-07-05,21,21,21,0,155,156,155,1,4,0,0,0,22,22,22,22
Contra Costa,29,2022-07-05,3353,3356,3350,6,22517,22541,22503,38,83,11,11,10,1381,1381,1370,1370
Del Norte,29,2022-07-05,152,152,152,0,614,614,613,1,3,0,0,0,53,53,53,53
El Dorado,29,2022-07-05,326,326,326,0,2595,2597,2593,4,9,1,1,0,225,225,224,224
Fresno,29,2022-07-05,2640,2641,2637,4,16594,16612,16585,27,163,6,6,17,2797,2797,2791,2791
Glenn,29,2022-07-05,26,26,26,0,168,169,168,1,1,0,0,0,53,53,53,53
Humboldt,29,2022-07-05,224,224,224,0,1738,1739,1737,2,10,2,2,3,153,153,151,151
Imperial,29,2022-07-05,770,770,769,1,3439,3442,3437,5,19,1,1,2,948,948,947,947
Inyo,29,2022-07-05,36,36,36,0,321,322,321,1,0,0,0,0,56,56,56,56
Kern,29,2022-07-05,1883,1883,1881,2,14626,14642,14625,17,66,4,4,11,2370,2370,2366,2366
Kings,29,2022-07-05,500,500,499,1,3462,3465,3460,5,9,0,0,0,452,452,452,452
Lake,29,2022-07-05,101,101,101,0,847,847,846,1,4,1,1,0,142,142,141,141
Lassen,29,2022-07-05,30,30,30,0,604,604,603,1,4,0,0,0,62,62,62,62
Los Angeles,29,2022-07-05,34554,34591,34577,14,305360,305680,305557,123,831,86,86,89,32396,32396,32310,32310
Madera,29,2022-07-05,370,370,369,1,3221,3224,3219,5,9,0,0,1,370,370,370,370
Marin,29,2022-07-05,618,618,617,1,5302,5307,5299,8,28,1,1,2,304,304,303,303
Mariposa,29,2022-07-05,37,37,37,0,228,229,228,1,0,0,0,0,28,28,28,28
Mendocino,29,2022-07-05,170,170,170,0,1183,1183,1180,3,10,2,2,2,133,133,131,131
Merced,29,2022-07-05,617,617,616,1,3305,3309,3305,4,16,2,2,2,835,835,833,833
Modoc,29,2022-07-05,13,13,13,0,34,35,34,1,0,0,0,0,8,8,8,8
Mono,29,2022-07-05,23,23,23,0,91,92,91,1,1,0,0,0,7,7,7,7
Monterey,29,2022-07-05,886,886,884,2,6646,6652,6635,17,32,2,2,3,746,746,744,744
Napa,29,2022-07-05,339,339,339,0,2868,2871,2868,3,9,0,0,1,148,148,148,148
Nevada,29,2022-07-05,189,189,189,0,1412,1412,1410,2,8,0,0,0,134,134,134,134
Orange,29,2022-07-05,7474,7482,7475,7,52800,52855,52805,50,215,27,27,34,7249,7249,7222,7222
Placer,29,2022-07-05,867,867,865,2,5191,5195,5186,9,72,3,3,7,643,643,640,640
Plumas,29,2022-07-05,45,45,45,0,199,200,199,1,3,0,0,0,13,13,13,13
Riverside,29,2022-07-05,6889,6897,6888,9,40645,40688,40636,52,149,5,5,21,6512,6512,6507,6507
Sacramento,29,2022-07-05,3638,3642,3637,5,28273,28303,28264,39,171,19,19,29,3172,3172,3153,3153
San Benito,29,2022-07-05,212,212,212,0,1338,1338,1337,1,2,0,0,0,95,95,95,95
San Bernardino,29,2022-07-05,6563,6571,6564,7,45478,45526,45480,46,154,12,12,22,7906,7906,7894,7894
San Diego,29,2022-07-05,10303,10315,10311,4,69291,69363,69334,29,296,9,9,45,5425,5425,5416,5416
San Francisco,29,2022-07-05,2964,2967,2959,8,24667,24693,24623,70,98,10,10,19,946,946,936,936
San Joaquin,29,2022-07-05,1743,1743,1740,3,15489,15507,15484,23,41,7,7,4,2282,2282,2275,2275
San Luis Obispo,29,2022-07-05,690,690,689,1,4367,4371,4366,5,20,0,0,0,501,501,501,501
San Mateo,29,2022-07-05,2646,2647,2644,3,21788,21812,21791,21,41,2,2,3,728,728,726,726
Santa Barbara,29,2022-07-05,1094,1094,1093,1,8157,8165,8154,11,29,4,4,4,706,706,702,702
Santa Clara,29,2022-07-05,6875,6883,6880,3,52637,52693,52669,24,203,16,16,36,2400,2400,2384,2384
Santa Cruz,29,2022-07-05,761,761,760,1,7466,7472,7464,8,23,0,0,0,267,267,267,267
Shasta,29,2022-07-05,296,296,296,0,2787,2789,2785,4,18,5,5,3,574,574,569,569
Siskiyou,29,2022-07-05,30,30,30,0,310,311,310,1,1,0,0,1,85,85,85,85
Solano,29,2022-07-05,1387,1387,1385,2,10139,10150,10137,13,48,0,0,6,453,453,453,453
Sonoma,29,2022-07-05,1189,1189,1188,1,8501,8511,8500,11,38,2,2,0,507,507,505,505
Stanislaus,29,2022-07-05,1229,1229,1227,2,7239,7247,7233,14,92,7,7,17,1717,1717,1710,1710
Sutter,29,2022-07-05,236,236,236,0,1530,1531,1529,2,0,0,0,0,228,228,228,228
Tehama,29,2022-07-05,136,136,136,0,815,815,813,2,4,1,1,0,209,209,208,208
Trinity,29,2022-07-05,20,20,20,0,134,135,134,1,2,0,0,0,20,20,20,20
Tulare,29,2022-07-05,1004,1004,1002,2,6919,6925,6911,14,38,5,5,1,1516,1516,1511,1511
Tuolumne,29,2022-07-05,173,173,173,0,941,941,939,2,7,0,0,0,191,191,191,191
Ventura,29,2022-07-05,2039,2040,2038,2,16153,16170,16156,14,73,3,3,3,1528,1528,1525,1525
Yolo,29,2022-07-05,503,503,502,1,6848,6854,6846,8,6,2,2,1,370,370,368,368
Yuba,29,2022-07-05,179,179,179,0,1124,1124,1123,1,10,0,0,1,121,121,121,121
Alameda,30,2022-07-12,5562,5569,5565,4,45375,45425,45389,36,138,7,7,21,1960,1960,1953,1953
Amador,30,2022-07-12,87,87,87,0,1415,1415,1413,2,1,0,0,0,87,87,87,87
Butte,30,2022-07-12,446,446,446,0,3164,3167,3165,2,25,2,2,5,452,452,450,450
Calaveras,30,2022-07-12,84,84,84,0,551,551,550,1,0,1,1,1,129,129,128,128
Colusa,30,2022-07-12,26,26,26,0,479,480,479,1,1,0,0,0,22,22,22,22
Contra Costa,30,2022-07-12,3451,3456,3451,5,24557,24585,24552,33,85,11,11,15,1392,1392,1381,1381
Del Norte,30,2022-07-12,172,172,172,0,660,660,659,1,6,0,0,2,53,53,53,53
El Dorado,30,2022-07-12,357,357,357,0,2917,2921,2918,3,9,2,2,3,227,227,225,225
Fresno,30,2022-07-12,3693,3698,3693,5,21078,21101,21075,26,170,8,8,13,2805,2805,2797,2797
Glenn,30,2022-07-12,40,40,40,0,365,366,365,1,0,0,0,0,53,53,53,53
Humboldt,30,2022-07-12,279,279,279,0,2066,2066,2064,2,10,1,1,3,154,154,153,153
Imperial,30,2022-07-12,1067,1067,1066,1,4532,4537,4532,5,17,3,3,1,951,951,948,948
Inyo,30,2022-07-12,39,39,39,0,358,359,358,1,0,1,1,0,57,57,56,56
Kern,30,2022-07-12,2364,2365,2363,2,16649,16668,16653,15,73,2,2,9,2372,2372,2370,2370
Kings,30,2022-07-12,731,731,730,1,4380,4385,4380,5,12,4,4,1,456,456,452,452
Lake,30,2022-07-12,139,139,139,0,1031,1031,1030,1,0,0,0,1,142,142,142,142
Lassen,30,2022-07-12,58,58,58,0,804,804,803,1,0,1,1,0,63,63,62,62
Los Angeles,30,2022-07-12,41992,42038,42025,13,360943,361343,361230,113,1047,103,103,123,32499,32499,32396,32396
Madera,30,2022-07-12,525,525,524,1,3994,3999,3994,5,11,0,0,3,370,370,370,370
Marin,30,2022-07-12,575,575,574,1,5744,5750,5743,7,12,2,2,4,306,306,304,304
Mariposa,30,2022-07-12,50,50,50,0,258,259,258,1,0,0,0,0,28,28,28,28
Mendocino,30,2022-07-12,193,193,193,0,1345,1345,1343,2,3,0,0,1,133,133,133,133
Merced,30,2022-07-12,760,760,759,1,4026,4031,4027,4,15,5,5,2,840,840,835,835
Modoc,30,2022-07-12,26,26,26,0,52,53,52,1,0,0,0,0,8,8,8,8
Mono,30,2022-07-12,9,9,9,0,95,96,95,1,0,0,0,0,7,7,7,7
Monterey,30,2022-07-12,1072,1072,1070,2,7656,7666,7651,15,43,6,6,3,752,752,746,746
Napa,30,2022-07-12,371,371,371,0,3391,3396,3393,3,14,1,1,1,149,149,148,148
Nevada,30,2022-07-12,196,196,196,0,1682,1682,1680,2,9,0,0,2,134,134,134,134
Orange,30,2022-07-12,9573,9585,9578,7,62674,62744,62698,46,274,19,19,27,7268,7268,7249,7249
Placer,30,2022-07-12,719,719,718,1,5645,5651,5643,8,75,2,2,7,645,645,643,643
Plumas,30,2022-07-12,64,64,64,0,275,276,275,1,0,0,0,0,13,13,13,13
Riverside,30,2022-07-12,9003,9013,9004,9,49992,50048,49999,49,223,15,15,13,6527,6527,6512,6512
Sacramento,30,2022-07-12,3972,3977,3973,4,33105,33143,33108,35,197,20,20,25,3192,3192,3172,3172
San Benito,30,2022-07-12,217,217,217,0,1608,1608,1607,1,2,0,0,0,95,95,95,95
San Bernardino,30,2022-07-12,8221,8230,8223,7,55346,55407,55363,44,200,17,17,28,7923,7923,7906,7906
San Diego,30,2022-07-12,13416,13431,13427,4,83108,83200,83173,27,353,13,13,45,5438,5438,5425,5425
San Francisco,30,2022-07-12,2801,2803,2797,6,26790,26820,26761,59,106,12,12,24,958,958,946,946
San Joaquin,30,2022-07-12,2117,2117,2115,2,18719,18738,18716,22,56,6,6,17,2288,2288,2282,2282
San Luis Obispo,30,2022-07-12,674,674,673,1,4968,4973,4968,5,18,3,3,0,504,504,501,501
San Mateo,30,2022-07-12,2658,2660,2658,2,24663,24690,24672,18,33,5,5,6,733,733,728,728
Santa Barbara,30,2022-07-12,1311,1311,1310,1,9067,9078,9069,9,43,4,4,5,710,710,706,706
Santa Clara,30,2022-07-12,6974,6981,6979,2,57110,57174,57154,20,211,10,10,41,2410,2410,2400,2400
Santa Cruz,30,2022-07-12,983,983,982,1,8806,8817,8809,8,20,0,0,1,267,267,267,267
Shasta,30,2022-07-12,307,307,307,0,3271,3275,3272,3,26,3,3,6,577,577,574,574
Siskiyou,30,2022-07-12,29,29,29,0,360,361,360,1,3,1,1,1,86,86,85,85
Solano,30,2022-07-12,1493,1493,1492,1,10856,10867,10856,11,42,1,1,5,454,454,453,453
Sonoma,30,2022-07-12,1200,1200,1199,1,9521,9532,9523,9,39,0,0,6,507,507,507,507
Stanislaus,30,2022-07-12,1428,1428,1426,2,8587,8598,8585,13,99,8,8,8,1725,1725,1717,1717
Sutter,30,2022-07-12,284,284,284,0,1822,1823,1821,2,0,0,0,0,228,228,228,228
Tehama,30,2022-07-12,122,122,122,0,910,910,909,1,8,0,0,1,209,209,209,209
Trinity,30,2022-07-12,32,32,32,0,116,117,116,1,1,0,0,0,20,20,20,20
Tulare,30,2022-07-12,1336,1336,1334,2,8868,8878,8864,14,45,3,3,2,1519,1519,1516,1516
Tuolumne,30,2022-07-12,251,251,251,0,1217,1217,1215,2,7,0,0,0,191,191,191,191
Ventura,30,2022-07-12,2476,2477,2475,2,19309,19330,19317,13,89,8,8,6,1536,1536,1528,1528
Yolo,30,2022-07-12,475,475,475,0,4908,4913,4909,4,8,3,3,2,373,373,370,370
Yuba,30,2022-07-12,215,215,215,0,1347,1347,1346,1,9,0,0,0,121,121,121,121
Alameda,31,2022-07-19,4771,4777,4774,3,43007,43057,43031,26,148,11,11,23,1971,1971,1960,1960
Amador,31,2022-07-19,92,92,92,0,1372,1373,1372,1,4,0,0,1,87,87,87,87
Butte,31,2022-07-19,345,345,345,0,2945,2949,2948,1,29,0,0,1,452,452,452,452
Calaveras,31,2022-07-19,73,73,73,0,543,544,543,1,0,0,0,1,129,129,129,129
Colusa,31,2022-07-19,22,22,22,0,348,349,348,1,3,0,0,0,22,22,22,22
Contra Costa,31,2022-07-19,3046,3051,3048,3,22925,22952,22928,24,83,6,6,18,1398,1398,1392,1392
Del Norte,31,2022-07-19,148,148,148,0,685,685,684,1,9,0,0,1,53,53,53,53
El Dorado,31,2022-07-19,274,274,274,0,2597,2600,2598,2,11,0,0,2,227,227,227,227
Fresno,31,2022-07-19,3623,3628,3624,4,20985,21010,20990,20,201,11,11,18,2816,2816,2805,2805
Glenn,31,2022-07-19,33,33,33,0,273,274,273,1,2,0,0,0,53,53,53,53
Humboldt,31,2022-07-19,277,277,277,0,2003,2004,2002,2,11,0,0,3,154,154,154,154
Imperial,31,2022-07-19,1030,1030,1029,1,4508,4513,4509,4,24,0,0,2,951,951,951,951
Inyo,31,2022-07-19,31,31,31,0,328,329,328,1,1,0,0,0,57,57,57,57
Kern,31,2022-07-19,2297,2298,2296,2,16170,16189,16177,12,86,10,10,13,2382,2382,2372,2372
Kings,31,2022-07-19,665,665,664,1,4133,4138,4134,4,18,1,1,0,457,457,456,456
Lake,31,2022-07-19,128,128,128,0,1008,1008,1007,1,4,0,0,0,142,142,142,142
Lassen,31,2022-07-19,75,75,75,0,1289,1289,1288,1,0,0,0,0,63,63,63,63
Los Angeles,31,2022-07-19,41540,41589,41579,10,352298,352714,352628,86,1191,107,107,137,32606,32606,32499,32499
Madera,31,2022-07-19,548,548,547,1,3699,3704,3700,4,7,0,0,2,370,370,370,370
Marin,31,2022-07-19,508,508,508,0,5411,5417,5412,5,17,0,0,5,306,306,306,306
Mariposa,31,2022-07-19,42,42,42,0,259,260,259,1,0,1,1,0,29,29,28,28
Mendocino,31,2022-07-19,175,175,175,0,1488,1488,1486,2,6,0,0,2,133,133,133,133
Merced,31,2022-07-19,749,749,748,1,3940,3945,3942,3,13,1,1,0,841,841,840,840
Modoc,31,2022-07-19,8,8,8,0,34,35,34,1,1,1,1,0,9,9,8,8
Mono,31,2022-07-19,11,11,11,0,80,81,80,1,2,0,0,0,7,7,7,7
Monterey,31,2022-07-19,980,980,978,2,7209,7218,7207,11,42,6,6,4,758,758,752,752
Napa,31,2022-07-19,303,303,303,0,3029,3033,3031,2,7,2,2,2,151,151,149,149
Nevada,31,2022-07-19,132,132,132,0,1345,1345,1344,1,8,0,0,0,134,134,134,134
Orange,31,2022-07-19,8766,8778,8773,5,59479,59550,59516,34,260,25,25,47,7293,7293,7268,7268
Placer,31,2022-07-19,662,662,661,1,5214,5220,5214,6,94,1,1,7,646,646,645,645
Plumas,31,2022-07-19,58,58,58,0,262,263,262,1,0,0,0,0,13,13,13,13
Riverside,31,2022-07-19,8096,8105,8099,6,47737,47792,47755,37,231,18,18,20,6545,6545,6527,6527
Sacramento,31,2022-07-19,3620,3625,3622,3,30713,30749,30724,25,175,14,14,30,3206,3206,3192,3192
San Benito,31,2022-07-19,202,202,202,0,1585,1585,1584,1,0,1,1,0,96,96,95,95
San Bernardino,31,2022-07-19,7879,7889,7884,5,53350,53413,53380,33,230,13,13,38,7936,7936,7923,7923
San Diego,31,2022-07-19,13020,13036,13033,3,79370,79463,79443,20,401,17,17,46,5455,5455,5438,5438
San Francisco,31,2022-07-19,2483,2485,2481,4,25554,25584,25540,44,117,8,8,25,966,966,958,958
San Joaquin,31,2022-07-19,2005,2005,2003,2,17709,17729,17713,16,72,3,3,15,2291,2291,2288,2288
San Luis Obispo,31,2022-07-19,547,547,547,0,4682,4687,4684,3,18,3,3,1,507,507,504,504
San Mateo,31,2022-07-19,2261,2261,2260,1,22893,22920,22907,13,28,0,0,8,733,733,733,733
Santa Barbara,31,2022-07-19,1287,1287,1286,1,9290,9302,9295,7,55,3,3,2,713,713,710,710
Santa Clara,31,2022-07-19,6107,6114,6112,2,54185,54249,54234,15,206,16,16,34,2426,2426,2410,2410
Santa Cruz,31,2022-07-19,873,873,872,1,7348,7358,7353,5,24,1,1,4,268,268,267,267
Shasta,31,2022-07-19,313,313,313,0,3146,3150,3147,3,39,2,2,2,579,579,577,577
Siskiyou,31,2022-07-19,32,32,32,0,337,338,337,1,3,0,0,0,86,86,86,86
Solano,31,2022-07-19,1267,1267,1266,1,9561,9572,9565,7,49,1,1,6,455,455,454,454
Sonoma,31,2022-07-19,1039,1039,1038,1,8726,8738,8731,7,43,0,0,4,507,507,507,507
Stanislaus,31,2022-07-19,1394,1394,1392,2,8292,8302,8292,10,109,5,5,12,1730,1730,1725,1725
Sutter,31,2022-07-19,244,244,244,0,1699,1700,1699,1,0,0,0,0,228,228,228,228
Tehama,31,2022-07-19,117,117,117,0,910,910,909,1,5,2,2,1,211,211,209,209
Trinity,31,2022-07-19,20,20,20,0,110,111,110,1,0,0,0,0,20,20,20,20
Tulare,31,2022-07-19,1193,1193,1192,1,8085,8093,8083,10,47,0,0,0,1519,1519,1519,1519
Tuolumne,31,2022-07-19,235,235,235,0,1168,1168,1167,1,6,4,4,0,195,195,191,191
Ventura,31,2022-07-19,2311,2312,2311,1,19211,19233,19223,10,86,5,5,6,1541,1541,1536,1536
Yolo,31,2022-07-19,433,433,433,0,4682,4687,4684,3,1,3,3,0,376,376,373,373
Yuba,31,2022-07-19,212,212,212,0,1323,1323,1322,1,20,0,0,0,121,121,121,121
Alameda,32,2022-07-26,4390,4397,4395,2,39969,40017,39998,19,148,12,12,23,1983,1983,1971,1971
Amador,32,2022-07-26,88,88,88,0,1182,1182,1181,1,3,1,1,1,88,88,87,87
Butte,32,2022-07-26,365,365,365,0,2880,2884,2883,1,24,1,1,2,453,453,452,452
Calaveras,32,2022-07-26,82,82,82,0,544,545,544,1,3,2,2,1,131,131,129,129
Colusa,32,2022-07-26,25,25,25,0,379,380,379,1,1,0,0,0,22,22,22,22
Contra Costa,32,2022-07-26,2844,2847,2845,2,21669,21696,21678,18,104,5,5,16,1403,1403,1398,1398
Del Norte,32,2022-07-26,64,64,64,0,535,536,535,1,6,0,0,0,53,53,53,53
El Dorado,32,2022-07-26,257,257,257,0,2447,2449,2447,2,7,1,1,0,228,228,227,227
Fresno,32,2022-07-26,3362,3367,3364,3,20080,20104,20089,15,216,7,7,25,2823,2823,2816,2816
Glenn,32,2022-07-26,37,37,37,0,273,274,273,1,0,0,0,0,53,53,53,53
Humboldt,32,2022-07-26,222,222,222,0,1927,1927,1926,1,15,2,2,4,156,156,154,154
Imperial,32,2022-07-26,826,826,825,1,4164,4169,4166,3,19,2,2,7,953,953,951,951
Inyo,32,2022-07-26,16,16,16,0,286,287,286,1,2,1,1,0,58,58,57,57
Kern,32,2022-07-26,1910,1910,1909,1,15454,15473,15464,9,90,2,2,16,2384,2384,2382,2382
Kings,32,2022-07-26,600,600,600,0,3891,3896,3893,3,9,1,1,0,458,458,457,457
Lake,32,2022-07-26,127,127,127,0,1066,1066,1065,1,3,1,1,1,143,143,142,142
Lassen,32,2022-07-26,56,56,56,0,1037,1037,1036,1,1,0,0,0,63,63,63,63
Los Angeles,32,2022-07-26,36144,36187,36180,7,327268,327668,327606,62,1143,124,124,137,32730,32730,32606,32606
Madera,32,2022-07-26,520,520,520,0,3904,3909,3906,3,11,1,1,5,371,371,370,370
Marin,32,2022-07-26,482,482,482,0,5625,5631,5627,4,30,2,2,2,308,308,306,306
Mariposa,32,2022-07-26,35,35,35,0,216,217,216,1,0,0,0,0,29,29,29,29
Mendocino,32,2022-07-26,206,206,206,0,1412,1412,1411,1,5,0,0,0,133,133,133,133
Merced,32,2022-07-26,723,723,723,0,3830,3835,3833,2,18,3,3,2,844,844,841,841
Modoc,32,2022-07-26,9,9,9,0,27,28,27,1,1,0,0,0,9,9,9,9
Mono,32,2022-07-26,16,16,16,0,85,86,85,1,0,0,0,0,7,7,7,7
Monterey,32,2022-07-26,925,925,924,1,6923,6931,6923,8,39,0,0,2,758,758,758,758
Napa,32,2022-07-26,303,303,303,0,2901,2905,2904,1,4,3,3,2,154,154,151,151
Nevada,32,2022-07-26,114,114,114,0,1325,1325,1324,1,5,1,1,1,135,135,134,134
Orange,32,2022-07-26,7828,7839,7836,3,56885,56955,56930,25,302,35,35,39,7328,7328,7293,7293
Placer,32,2022-07-26,602,602,601,1,5074,5079,5075,4,80,5,5,11,651,651,646,646
Plumas,32,2022-07-26,22,22,22,0,177,178,177,1,0,0,0,0,13,13,13,13
Riverside,32,2022-07-26,7323,7332,7328,4,45912,45967,45939,28,240,14,14,33,6559,6559,6545,6545
Sacramento,32,2022-07-26,3547,3552,3550,2,29321,29357,29338,19,192,16,16,33,3222,3222,3206,3206
San Benito,32,2022-07-26,194,194,194,0,1848,1849,1848,1,1,1,1,0,97,97,96,96
San Bernardino,32,2022-07-26,7008,7016,7013,3,52041,52104,52079,25,217,27,27,20,7963,7963,7936,7936
San Diego,32,2022-07-26,11355,11369,11367,2,74433,74523,74508,15,389,23,23,48,5478,5478,5455,5455
San Francisco,32,2022-07-26,2194,2195,2192,3,23937,23967,23935,32,120,11,11,28,977,977,966,966
San Joaquin,32,2022-07-26,1797,1797,1796,1,16261,16281,16269,12,77,5,5,7,2296,2296,2291,2291
San Luis Obispo,32,2022-07-26,547,547,547,0,4297,4302,4300,2,17,5,5,1,512,512,507,507
San Mateo,32,2022-07-26,2029,2029,2028,1,21802,21829,21819,10,58,1,1,10,734,734,733,733
Santa Barbara,32,2022-07-26,1175,1175,1174,1,8537,8549,8544,5,38,2,2,3,715,715,713,713
Santa Clara,32,2022-07-26,5687,5694,5693,1,50141,50204,50193,11,243,16,16,25,2442,2442,2426,2426
Santa Cruz,32,2022-07-26,804,804,804,0,7754,7765,7761,4,23,0,0,0,268,268,268,268
Shasta,32,2022-07-26,310,310,310,0,3012,3015,3013,2,30,2,2,7,581,581,579,579
Siskiyou,32,2022-07-26,35,35,35,0,340,341,340,1,3,0,0,0,86,86,86,86
Solano,32,2022-07-26,1216,1216,1215,1,9569,9580,9574,6,50,0,0,6,455,455,455,455
Sonoma,32,2022-07-26,1046,1046,1045,1,8623,8635,8630,5,53,2,2,4,509,509,507,507
Stanislaus,32,2022-07-26,1353,1353,1352,1,8018,8029,8022,7,109,11,11,12,1741,1741,1730,1730
Sutter,32,2022-07-26,234,234,234,0,1689,1690,1689,1,0,0,0,0,228,228,228,228
Tehama,32,2022-07-26,99,99,99,0,913,913,912,1,5,2,2,0,213,213,211,211
Trinity,32,2022-07-26,12,12,12,0,100,101,100,1,1,0,0,0,20,20,20,20
Tulare,32,2022-07-26,1160,1160,1159,1,8027,8036,8028,8,45,2,2,1,1521,1521,1519,1519
Tuolumne,32,2022-07-26,183,183,183,0,1115,1115,1114,1,4,1,1,1,196,196,195,195
Ventura,32,2022-07-26,2078,2079,2078,1,18025,18046,18039,7,83,7,7,6,1548,1548,1541,1541
Yolo,32,2022-07-26,408,408,408,0,4507,4512,4510,2,2,4,4,1,380,380,376,376
Yuba,32,2022-07-26,178,178,178,0,1274,1274,1273,1,11,0,0,0,121,121,121,121
Alameda,33,2022-08-02,3762,3767,3766,1,36168,36214,36200,14,161,8,8,25,1991,1991,1983,1983
Amador,33,2022-08-02,47,47,47,0,1148,1148,1147,1,3,0,0,1,88,88,88,88
Butte,33,2022-08-02,350,350,350,0,2695,2698,2697,1,31,2,2,1,455,455,453,453
Calaveras,33,2022-08-02,60,60,60,0,583,584,583,1,2,2,2,1,133,133,131,131
Colusa,33,2022-08-02,28,28,28,0,365,366,365,1,5,0,0,0,22,22,22,22
Contra Costa,33,2022-08-02,2539,2542,2540,2,20532,20558,20545,13,91,13,13,16,1416,1416,1403,1403
Del Norte,33,2022-08-02,50,50,50,0,476,477,476,1,5,0,0,0,53,53,53,53
El Dorado,33,2022-08-02,220,220,220,0,2442,2445,2444,1,5,3,3,1,231,231,228,228
Fresno,33,2022-08-02,2861,2866,2864,2,18141,18162,18151,11,218,6,6,19,2829,2829,2823,2823
Glenn,33,2022-08-02,28,28,28,0,246,247,246,1,1,0,0,0,53,53,53,53
Humboldt,33,2022-08-02,224,224,224,0,1912,1913,1912,1,13,0,0,3,156,156,156,156
Imperial,33,2022-08-02,630,630,630,0,3545,3550,3548,2,16,4,4,3,957,957,953,953
Inyo,33,2022-08-02,22,22,22,0,271,272,271,1,0,0,0,0,58,58,58,58
Kern,33,2022-08-02,1677,1677,1676,1,14918,14936,14929,7,70,7,7,14,2391,2391,2384,2384
Kings,33,2022-08-02,581,581,581,0,3896,3901,3899,2,9,0,0,1,458,458,458,458
Lake,33,2022-08-02,134,134,134,0,961,961,960,1,5,0,0,1,143,143,143,143
Lassen,33,2022-08-02,116,116,116,0,1002,1004,1003,1,0,0,0,0,63,63,63,63
Los Angeles,33,2022-08-02,29505,29542,29538,4,305900,306287,306242,45,1135,128,128,138,32858,32858,32730,32730
Madera,33,2022-08-02,459,459,459,0,3317,3321,3319,2,8,0,0,9,371,371,371,371
Marin,33,2022-08-02,391,391,391,0,4994,5000,4997,3,29,1,1,3,309,309,308,308
Mariposa,33,2022-08-02,24,24,24,0,228,229,228,1,0,0,0,0,29,29,29,29
Mendocino,33,2022-08-02,159,159,159,0,1224,1224,1223,1,7,1,1,2,134,134,133,133
Merced,33,2022-08-02,643,643,643,0,3607,3612,3610,2,22,5,5,3,849,849,844,844
Modoc,33,2022-08-02,11,11,11,0,31,32,31,1,1,0,0,0,9,9,9,9
Mono,33,2022-08-02,8,8,8,0,71,72,71,1,0,0,0,0,7,7,7,7
Monterey,33,2022-08-02,917,917,916,1,6292,6300,6294,6,33,3,3,0,761,761,758,758
Napa,33,2022-08-02,295,295,295,0,2682,2687,2686,1,12,1,1,1,155,155,154,154
Nevada,33,2022-08-02,125,125,125,0,1343,1343,1342,1,10,0,0,2,135,135,135,135
Orange,33,2022-08-02,6264,6271,6269,2,51503,51567,51549,18,237,35,35,37,7363,7363,7328,7328
Placer,33,2022-08-02,573,573,573,0,4696,4702,4699,3,61,1,1,11,652,652,651,651
Plumas,33,2022-08-02,21,21,21,0,183,184,183,1,0,0,0,0,13,13,13,13
Riverside,33,2022-08-02,6055,6062,6059,3,41898,41951,41931,20,198,6,6,25,6565,6565,6559,6559
Sacramento,33,2022-08-02,3005,3010,3008,2,27611,27645,27631,14,189,19,19,25,3241,3241,3222,3222
San Benito,33,2022-08-02,164,164,164,0,1403,1403,1402,1,0,1,1,0,98,98,97,97
San Bernardino,33,2022-08-02,5836,5843,5841,2,48334,48396,48378,18,185,26,26,21,7989,7989,7963,7963
San Diego,33,2022-08-02,9012,9024,9023,1,68486,68573,68562,11,375,12,12,53,5490,5490,5478,5478
San Francisco,33,2022-08-02,1754,1755,1753,2,21512,21539,21517,22,99,11,11,22,988,988,977,977
San Joaquin,33,2022-08-02,1713,1713,1712,1,16117,16138,16129,9,67,6,6,9,2302,2302,2296,2296
San Luis Obispo,33,2022-08-02,572,572,572,0,4048,4053,4051,2,17,2,2,0,514,514,512,512
San Mateo,33,2022-08-02,1696,1696,1695,1,19964,19991,19984,7,68,1,1,4,735,735,734,734
Santa Barbara,33,2022-08-02,1099,1099,1098,1,7882,7892,7888,4,34,1,1,4,716,716,715,715
Santa Clara,33,2022-08-02,4719,4726,4725,1,44610,44665,44658,7,241,17,17,37,2459,2459,2442,2442
Santa Cruz,33,2022-08-02,733,733,733,0,6526,6533,6530,3,27,1,1,3,269,269,268,268
Shasta,33,2022-08-02,223,223,223,0,2975,2979,2978,1,34,1,1,5,582,582,581,581
Siskiyou,33,2022-08-02,32,32,32,0,295,296,295,1,1,1,1,0,87,87,86,86
Solano,33,2022-08-02,1081,1081,1080,1,8894,8906,8902,4,47,0,0,7,455,455,455,455
Sonoma,33,2022-08-02,931,931,931,0,8128,8140,8136,4,45,4,4,4,513,513,509,509
Stanislaus,33,2022-08-02,1209,1209,1208,1,7452,7462,7457,5,104,2,2,9,1743,1743,1741,1741
Sutter,33,2022-08-02,241,241,241,0,1645,1646,1645,1,0,3,3,0,231,231,228,228
Tehama,33,2022-08-02,88,88,88,0,669,670,669,1,2,0,0,0,213,213,213,213
Trinity,33,2022-08-02,10,10,10,0,80,81,80,1,0,1,1,0,21,21,20,20
Tulare,33,2022-08-02,1000,1000,999,1,7237,7246,7241,5,44,2,2,5,1523,1523,1521,1521
Tuolumne,33,2022-08-02,144,144,144,0,1096,1096,1095,1,6,0,0,2,196,196,196,196
Ventura,33,2022-08-02,1757,1757,1756,1,16937,16959,16954,5,76,8,8,12,1556,1556,1548,1548
Yolo,33,2022-08-02,320,320,320,0,4072,4077,4075,2,2,2,2,2,382,382,380,380
Yuba,33,2022-08-02,145,145,145,0,1171,1171,1170,1,11,0,0,2,121,121,121,121
Alameda,34,2022-08-09,3113,3118,3117,1,35420,35466,35456,10,132,13,13,21,2004,2004,1991,1991
Amador,34,2022-08-09,49,49,49,0,819,820,819,1,2,0,0,1,88,88,88,88
Butte,34,2022-08-09,330,330,330,0,2479,2482,2481,1,24,1,1,2,456,456,455,455
Calaveras,34,2022-08-09,59,59,59,0,559,560,559,1,2,0,0,0,133,133,133,133
Colusa,34,2022-08-09,11,11,11,0,352,353,352,1,0,0,0,0,22,22,22,22
Contra Costa,34,2022-08-09,2158,2159,2158,1,19757,19782,19772,10,90,5,5,20,1421,1421,1416,1416
Del Norte,34,2022-08-09,52,52,52,0,495,496,495,1,4,1,1,0,54,54,53,53
El Dorado,34,2022-08-09,193,193,193,0,2326,2328,2327,1,4,0,0,3,231,231,231,231
Fresno,34,2022-08-09,2329,2332,2331,1,17311,17334,17326,8,186,10,10,26,2839,2839,2829,2829
Glenn,34,2022-08-09,20,20,20,0,248,249,248,1,0,0,0,0,53,53,53,53
Humboldt,34,2022-08-09,215,215,215,0,1816,1816,1815,1,15,1,1,2,157,157,156,156
Imperial,34,2022-08-09,495,495,495,0,3122,3127,3126,1,15,2,2,2,959,959,957,957
Inyo,34,2022-08-09,5,5,5,0,263,264,263,1,0,1,1,1,59,59,58,58
Kern,34,2022-08-09,1359,1359,1359,0,13873,13892,13887,5,69,6,6,14,2397,2397,2391,2391
Kings,34,2022-08-09,434,434,434,0,3258,3263,3262,1,16,1,1,2,459,459,458,458
Lake,34,2022-08-09,98,98,98,0,899,900,899,1,2,0,0,2,143,143,143,143
Lassen,34,2022-08-09,125,125,125,0,1071,1072,1071,1,1,0,0,0,63,63,63,63
Los Angeles,34,2022-08-09,24692,24725,24722,3,291199,291579,291545,34,983,128,128,122,32986,32986,32858,32858
Madera,34,2022-08-09,355,355,355,0,3064,3069,3068,1,19,0,0,3,371,371,371,371
Marin,34,2022-08-09,364,364,364,0,4355,4361,4359,2,23,2,2,4,311,311,309,309
Mariposa,34,2022-08-09,28,28,28,0,180,181,180,1,0,0,0,0,29,29,29,29
Mendocino,34,2022-08-09,122,122,122,0,1058,1058,1057,1,3,1,1,1,135,135,134,134
Merced,34,2022-08-09,496,496,496,0,3339,3344,3343,1,14,1,1,7,850,850,849,849
Modoc,34,2022-08-09,3,3,3,0,23,24,23,1,1,0,0,0,9,9,9,9
Mono,34,2022-08-09,9,9,9,0,81,82,81,1,0,0,0,0,7,7,7,7
Monterey,34,2022-08-09,694,694,693,1,5836,5842,5838,4,31,0,0,0,761,761,761,761
Napa,34,2022-08-09,245,245,245,0,2672,2677,2676,1,10,1,1,2,156,156,155,155
Nevada,34,2022-08-09,99,99,99,0,1308,1308,1307,1,1,0,0,0,135,135,135,135
Orange,34,2022-08-09,5361,5368,5367,1,48288,48351,48338,13,236,32,32,50,7395,7395,7363,7363
Placer,34,2022-08-09,505,505,505,0,4525,4531,4529,2,66,3,3,10,655,655,652,652
Plumas,34,2022-08-09,22,22,22,0,181,182,181,1,0,0,0,0,13,13,13,13
Riverside,34,2022-08-09,5358,5365,5363,2,40203,40255,40240,15,167,14,14,15,6579,6579,6565,6565
Sacramento,34,2022-08-09,2586,2591,2590,1,26784,26820,26810,10,162,17,17,21,3258,3258,3241,3241
San Benito,34,2022-08-09,193,193,193,0,1426,1427,1426,1,2,1,1,0,99,99,98,98
San Bernardino,34,2022-08-09,5025,5032,5031,1,45791,45851,45838,13,188,19,19,17,8008,8008,7989,7989
San Diego,34,2022-08-09,6935,6944,6943,1,63638,63721,63713,8,300,12,12,26,5502,5502,5490,5490
San Francisco,34,2022-08-09,1463,1463,1462,1,20454,20482,20465,17,104,13,13,20,1001,1001,988,988
San Joaquin,34,2022-08-09,1515,1515,1514,1,15654,15674,15667,7,61,6,6,9,2308,2308,2302,2302
San Luis Obispo,34,2022-08-09,476,476,476,0,3508,3513,3512,1,14,1,1,2,515,515,514,514
San Mateo,34,2022-08-09,1449,1449,1449,0,18254,18278,18273,5,60,0,0,4,735,735,735,735
Santa Barbara,34,2022-08-09,923,923,923,0,7278,7288,7285,3,45,3,3,5,719,719,716,716
Santa Clara,34,2022-08-09,4019,4026,4025,1,40956,41009,41004,5,188,17,17,35,2476,2476,2459,2459
Santa Cruz,34,2022-08-09,589,589,589,0,6056,6063,6061,2,28,1,1,0,270,270,269,269
Shasta,34,2022-08-09,202,202,202,0,2903,2906,2905,1,24,2,2,4,584,584,582,582
Siskiyou,34,2022-08-09,24,24,24,0,288,289,288,1,0,0,0,0,87,87,87,87
Solano,34,2022-08-09,845,845,845,0,7709,7719,7716,3,47,0,0,10,455,455,455,455
Sonoma,34,2022-08-09,783,783,783,0,7528,7539,7536,3,37,3,3,3,516,516,513,513
Stanislaus,34,2022-08-09,984,984,983,1,7201,7211,7207,4,93,7,7,12,1750,1750,1743,1743
Sutter,34,2022-08-09,204,204,204,0,1563,1564,1563,1,0,0,0,0,231,231,231,231
Tehama,34,2022-08-09,72,72,72,0,698,699,698,1,0,0,0,1,213,213,213,213
Trinity,34,2022-08-09,4,4,4,0,59,60,59,1,0,0,0,0,21,21,21,21
Tulare,34,2022-08-09,851,851,851,0,7293,7301,7297,4,48,3,3,5,1526,1526,1523,1523
Tuolumne,34,2022-08-09,107,107,107,0,1051,1052,1051,1,1,2,2,0,198,198,196,196
Ventura,34,2022-08-09,1493,1493,1493,0,15693,15713,15709,4,78,8,8,6,1564,1564,1556,1556
Yolo,34,2022-08-09,290,290,290,0,3852,3857,3856,1,6,1,1,1,383,383,382,382
Yuba,34,2022-08-09,136,136,136,0,1098,1099,1098,1,7,1,1,0,122,122,121,121
Alameda,35,2022-08-16,2515,2519,2518,1,33949,33995,33987,8,106,9,9,21,2013,2013,2004,2004
Amador,35,2022-08-16,53,53,53,0,906,907,906,1,3,0,0,0,88,88,88,88
Butte,35,2022-08-16,231,231,231,0,2204,2208,2207,1,20,0,0,2,456,456,456,456
Calaveras,35,2022-08-16,43,43,43,0,527,528,527,1,0,0,0,0,133,133,133,133
Colusa,35,2022-08-16,19,19,19,0,377,378,377,1,0,0,0,0,22,22,22,22
Contra Costa,35,2022-08-16,1687,1687,1686,1,18851,18876,18869,7,56,7,7,10,1428,1428,1421,1421
Del Norte,35,2022-08-16,50,50,50,0,508,509,508,1,2,0,0,0,54,54,54,54
El Dorado,35,2022-08-16,182,182,182,0,2288,2290,2289,1,4,0,0,3,231,231,231,231
Fresno,35,2022-08-16,1814,1814,1813,1,16246,16268,16262,6,172,6,6,14,2845,2845,2839,2839
Glenn,35,2022-08-16,17,17,17,0,228,229,228,1,2,0,0,0,53,53,53,53
Humboldt,35,2022-08-16,161,161,161,0,1619,1620,1619,1,12,0,0,2,157,157,157,157
Imperial,35,2022-08-16,351,351,351,0,3218,3223,3222,1,10,0,0,0,959,959,959,959
Inyo,35,2022-08-16,14,14,14,0,258,259,258,1,3,0,0,0,59,59,59,59
Kern,35,2022-08-16,1166,1166,1166,0,13746,13765,13761,4,56,7,7,16,2404,2404,2397,2397
Kings,35,2022-08-16,346,346,346,0,3287,3292,3291,1,9,0,0,1,459,459,459,459
Lake,35,2022-08-16,99,99,99,0,1006,1007,1006,1,3,1,1,2,144,144,143,143
Lassen,35,2022-08-16,47,47,47,0,829,830,829,1,0,0,0,0,63,63,63,63
Los Angeles,35,2022-08-16,20713,20742,20740,2,287700,288085,288059,26,886,114,114,123,33100,33100,32986,32986
Madera,35,2022-08-16,302,302,302,0,2867,2871,2870,1,9,0,0,3,371,371,371,371
Marin,35,2022-08-16,283,283,283,0,4022,4027,4026,1,13,0,0,2,311,311,311,311
Mariposa,35,2022-08-16,12,12,12,0,187,188,187,1,0,0,0,0,29,29,29,29
Mendocino,35,2022-08-16,109,109,109,0,998,999,998,1,7,0,0,3,135,135,135,135
Merced,35,2022-08-16,454,454,454,0,3460,3465,3464,1,14,3,3,3,853,853,850,850
Modoc,35,2022-08-16,7,7,7,0,23,24,23,1,0,0,0,0,9,9,9,9
Mono,35,2022-08-16,6,6,6,0,66,67,66,1,0,0,0,0,7,7,7,7
Monterey,35,2022-08-16,674,674,674,0,6015,6023,6020,3,37,0,0,2,761,761,761,761
Napa,35,2022-08-16,201,201,201,0,2197,2200,2199,1,12,0,0,0,156,156,156,156
Nevada,35,2022-08-16,95,95,95,0,1182,1183,1182,1,5,0,0,1,135,135,135,135
Orange,35,2022-08-16,4548,4555,4554,1,42636,42693,42684,9,269,27,27,45,7422,7422,7395,7395
Placer,35,2022-08-16,411,411,411,0,4426,4432,4430,2,64,1,1,11,656,656,655,655
Plumas,35,2022-08-16,18,18,18,0,174,175,174,1,0,0,0,0,13,13,13,13
Riverside,35,2022-08-16,4590,4597,4596,1,37702,37753,37742,11,143,15,15,24,6594,6594,6579,6579
Sacramento,35,2022-08-16,2357,2360,2359,1,25183,25217,25209,8,157,12,12,22,3270,3270,3258,3258
San Benito,35,2022-08-16,128,128,128,0,1316,1317,1316,1,3,0,0,1,99,99,99,99
San Bernardino,35,2022-08-16,4740,4747,4746,1,44369,44428,44418,10,158,17,17,25,8025,8025,8008,8008
San Diego,35,2022-08-16,5252,5259,5258,1,58876,58954,58948,6,275,13,13,35,5515,5515,5502,5502
San Francisco,35,2022-08-16,1225,1225,1224,1,19616,19643,19631,12,106,16,16,11,1017,1017,1001,1001
San Joaquin,35,2022-08-16,1386,1386,1386,0,15150,15170,15165,5,63,7,7,7,2315,2315,2308,2308
San Luis Obispo,35,2022-08-16,297,297,297,0,3287,3292,3291,1,17,4,4,2,519,519,515,515
San Mateo,35,2022-08-16,1222,1222,1222,0,17509,17532,17528,4,52,1,1,4,736,736,735,735
Santa Barbara,35,2022-08-16,795,795,795,0,7154,7165,7163,2,40,2,2,4,721,721,719,719
Santa Clara,35,2022-08-16,3313,3318,3318,0,40318,40373,40369,4,181,8,8,27,2484,2484,2476,2476
Santa Cruz,35,2022-08-16,497,497,497,0,8512,8523,8521,2,20,3,3,3,273,273,270,270
Shasta,35,2022-08-16,188,188,188,0,2711,2714,2713,1,18,0,0,2,584,584,584,584
Siskiyou,35,2022-08-16,19,19,19,0,280,281,280,1,3,0,0,1,87,87,87,87
Solano,35,2022-08-16,630,630,630,0,7379,7389,7387,2,49,0,0,11,455,455,455,455
Sonoma,35,2022-08-16,610,610,610,0,7223,7234,7232,2,31,3,3,2,519,519,516,516
Stanislaus,35,2022-08-16,957,957,957,0,7675,7686,7683,3,105,10,10,10,1760,1760,1750,1750
Sutter,35,2022-08-16,193,193,193,0,1553,1555,1554,1,0,1,1,0,232,232,231,231
Tehama,35,2022-08-16,58,58,58,0,649,650,649,1,1,0,0,0,213,213,213,213
Trinity,35,2022-08-16,11,11,11,0,61,62,61,1,0,0,0,0,21,21,21,21
Tulare,35,2022-08-16,730,730,730,0,7240,7249,7246,3,32,3,3,1,1529,1529,1526,1526
Tuolumne,35,2022-08-16,110,110,110,0,981,982,981,1,1,0,0,0,198,198,198,198
Ventura,35,2022-08-16,1501,1501,1501,0,15194,15214,15211,3,76,4,4,4,1568,1568,1564,1564
Yolo,35,2022-08-16,244,244,244,0,3455,3460,3459,1,3,4,4,2,387,387,383,383
Yuba,35,2022-08-16,127,127,127,0,1099,1100,1099,1,9,0,0,0,122,122,122,122
Alameda,36,2022-08-23,2246,2249,2249,0,33743,33789,33783,6,110,12,12,16,2025,2025,2013,2013
Amador,36,2022-08-23,42,42,42,0,813,814,813,1,2,1,1,1,89,89,88,88
Butte,36,2022-08-23,248,248,248,0,2103,2107,2106,1,18,1,1,1,457,457,456,456
Calaveras,36,2022-08-23,52,52,52,0,590,591,590,1,0,0,0,0,133,133,133,133
Colusa,36,2022-08-23,15,15,15,0,366,367,366,1,0,0,0,0,22,22,22,22
Contra Costa,36,2022-08-23,1496,1496,1496,0,18687,18713,18707,6,50,5,5,10,1433,1433,1428,1428
Del Norte,36,2022-08-23,28,28,28,0,466,467,466,1,2,1,1,0,55,55,54,54
El Dorado,36,2022-08-23,143,143,143,0,2108,2110,2109,1,5,1,1,0,232,232,231,231
Fresno,36,2022-08-23,1529,1529,1529,0,15616,15638,15634,4,162,6,6,15,2851,2851,2845,2845
Glenn,36,2022-08-23,16,16,16,0,204,205,204,1,1,0,0,0,53,53,53,53
Humboldt,36,2022-08-23,150,150,150,0,1728,1730,1729,1,5,1,1,4,158,158,157,157
Imperial,36,2022-08-23,319,319,319,0,2825,2830,2829,1,14,0,0,1,959,959,959,959
Inyo,36,2022-08-23,9,9,9,0,210,211,210,1,0,0,0,0,59,59,59,59
Kern,36,2022-08-23,962,962,962,0,13864,13883,13880,3,60,5,5,11,2409,2409,2404,2404
Kings,36,2022-08-23,347,347,347,0,3704,3709,3708,1,10,2,2,0,461,461,459,459
Lake,36,2022-08-23,111,111,111,0,883,884,883,1,2,0,0,0,144,144,144,144
Lassen,36,2022-08-23,38,38,38,0,792,793,792,1,0,0,0,0,63,63,63,63
Los Angeles,36,2022-08-23,18007,18032,18031,1,277898,278284,278265,19,844,112,112,106,33212,33212,33100,33100
Madera,36,2022-08-23,299,299,299,0,2661,2665,2664,1,10,2,2,4,373,373,371,371
Marin,36,2022-08-23,238,238,238,0,3958,3963,3962,1,15,0,0,3,311,311,311,311
Mariposa,36,2022-08-23,19,19,19,0,188,189,188,1,0,0,0,0,29,29,29,29
Mendocino,36,2022-08-23,124,124,124,0,1159,1160,1159,1,2,0,0,1,135,135,135,135
Merced,36,2022-08-23,452,452,452,0,3560,3565,3564,1,11,3,3,3,856,856,853,853
Modoc,36,2022-08-23,2,2,2,0,23,24,23,1,0,0,0,0,9,9,9,9
Mono,36,2022-08-23,2,2,2,0,53,54,53,1,0,0,0,0,7,7,7,7
Monterey,36,2022-08-23,512,512,512,0,5739,5748,5745,3,26,2,2,2,763,763,761,761
Napa,36,2022-08-23,129,129,129,0,1980,1983,1982,1,6,2,2,2,158,158,156,156
Nevada,36,2022-08-23,88,88,88,0,1178,1179,1178,1,3,0,0,0,135,135,135,135
Orange,36,2022-08-23,3798,3804,3803,1,41465,41523,41516,7,221,22,22,37,7444,7444,7422,7422
Placer,36,2022-08-23,401,401,401,0,4304,4310,4309,1,62,1,1,11,657,657,656,656
Plumas,36,2022-08-23,17,17,17,0,183,184,183,1,1,0,0,0,13,13,13,13
Riverside,36,2022-08-23,4292,4299,4298,1,38144,38196,38188,8,136,14,14,17,6608,6608,6594,6594
Sacramento,36,2022-08-23,2027,2028,2028,0,24926,24961,24955,6,140,15,15,28,3285,3285,3270,3270
San Benito,36,2022-08-23,108,108,108,0,1302,1303,1302,1,1,1,1,1,100,100,99,99
San Bernardino,36,2022-08-23,4590,4597,4596,1,44623,44685,44677,8,156,15,15,20,8040,8040,8025,8025
San Diego,36,2022-08-23,4627,4634,4634,0,57959,58040,58036,4,283,6,6,25,5521,5521,5515,5515
San Francisco,36,2022-08-23,1067,1067,1066,1,18749,18775,18766,9,90,13,13,13,1030,1030,1017,1017
San Joaquin,36,2022-08-23,1167,1167,1167,0,15172,15193,15189,4,50,2,2,7,2317,2317,2315,2315
San Luis Obispo,36,2022-08-23,274,274,274,0,3144,3149,3148,1,19,0,0,0,519,519,519,519
San Mateo,36,2022-08-23,971,971,971,0,17185,17208,17205,3,41,0,0,0,736,736,736,736
Santa Barbara,36,2022-08-23,760,760,760,0,7578,7589,7587,2,36,0,0,1,721,721,721,721
Santa Clara,36,2022-08-23,2980,2985,2985,0,40634,40690,40687,3,167,8,8,30,2492,2492,2484,2484
Santa Cruz,36,2022-08-23,506,506,506,0,12964,12981,12979,2,17,0,0,0,273,273,273,273
Shasta,36,2022-08-23,166,166,166,0,2751,2755,2754,1,17,2,2,1,586,586,584,584
Siskiyou,36,2022-08-23,26,26,26,0,260,261,260,1,2,1,1,2,88,88,87,87
Solano,36,2022-08-23,511,511,511,0,7172,7182,7180,2,41,0,0,11,455,455,455,455
Sonoma,36,2022-08-23,598,598,598,0,7252,7263,7261,2,30,0,0,4,519,519,519,519
Stanislaus,36,2022-08-23,919,919,919,0,7879,7891,7888,3,81,6,6,16,1766,1766,1760,1760
Sutter,36,2022-08-23,192,192,192,0,1600,1602,1601,1,0,0,0,0,232,232,232,232
Tehama,36,2022-08-23,52,52,52,0,631,632,631,1,1,0,0,0,213,213,213,213
Trinity,36,2022-08-23,12,12,12,0,65,66,65,1,0,0,0,0,21,21,21,21
Tulare,36,2022-08-23,724,724,724,0,6864,6873,6871,2,34,4,4,1,1533,1533,1529,1529
Tuolumne,36,2022-08-23,121,121,121,0,1003,1004,1003,1,1,1,1,0,199,199,198,198
Ventura,36,2022-08-23,1227,1227,1227,0,14832,14852,14850,2,62,4,4,8,1572,1572,1568,1568
Yolo,36,2022-08-23,204,204,204,0,3536,3541,3540,1,7,1,1,1,388,388,387,387
Yuba,36,2022-08-23,131,131,131,0,1050,1051,1050,1,11,0,0,2,122,122,122,122
Alameda,37,2022-08-30,1961,1962,1962,0,34039,34089,34084,5,85,10,10,36,2035,2035,2025,2025
Amador,37,2022-08-30,55,55,55,0,822,823,822,1,2,1,1,0,90,90,89,89
Butte,37,2022-08-30,229,229,229,0,2257,2261,2260,1,22,0,0,3,457,457,457,457
Calaveras,37,2022-08-30,49,49,49,0,575,576,575,1,1,0,0,0,133,133,133,133
Colusa,37,2022-08-30,9,9,9,0,328,329,328,1,1,0,0,0,22,22,22,22
Contra Costa,37,2022-08-30,1286,1286,1286,0,18715,18741,18737,4,48,5,5,9,1438,1438,1433,1433
Del Norte,37,2022-08-30,28,28,28,0,390,391,390,1,5,0,0,1,55,55,55,55
El Dorado,37,2022-08-30,136,136,136,0,1963,1967,1966,1,0,0,0,0,232,232,232,232
Fresno,37,2022-08-30,1405,1405,1405,0,15715,15737,15734,3,162,4,4,16,2855,2855,2851,2851
Glenn,37,2022-08-30,23,23,23,0,231,232,231,1,3,0,0,0,53,53,53,53
Humboldt,37,2022-08-30,126,126,126,0,1563,1564,1563,1,4,0,0,0,158,158,158,158
Imperial,37,2022-08-30,264,264,264,0,2914,2919,2918,1,20,1,1,0,960,960,959,959
Inyo,37,2022-08-30,7,7,7,0,168,169,168,1,0,0,0,0,59,59,59,59
Kern,37,2022-08-30,920,920,920,0,13595,13614,13612,2,57,1,1,6,2410,2410,2409,2409
Kings,37,2022-08-30,332,332,332,0,3480,3485,3484,1,7,0,0,0,461,461,461,461
Lake,37,2022-08-30,83,83,83,0,849,850,849,1,3,3,3,0,147,147,144,144
Lassen,37,2022-08-30,32,32,32,0,811,812,811,1,0,0,0,0,63,63,63,63
Los Angeles,37,2022-08-30,14870,14891,14890,1,276256,276660,276645,15,717,85,85,79,33297,33297,33212,33212
Madera,37,2022-08-30,287,287,287,0,3106,3110,3109,1,15,0,0,5,373,373,373,373
Marin,37,2022-08-30,216,216,216,0,3849,3855,3854,1,18,2,2,1,313,313,311,311
Mariposa,37,2022-08-30,22,22,22,0,175,176,175,1,0,0,0,0,29,29,29,29
Mendocino,37,2022-08-30,80,80,80,0,954,955,954,1,3,0,0,1,135,135,135,135
Merced,37,2022-08-30,377,377,377,0,3427,3432,3431,1,11,3,3,0,859,859,856,856
Modoc,37,2022-08-30,2,2,2,0,34,35,34,1,0,0,0,0,9,9,9,9
Mono,37,2022-08-30,3,3,3,0,51,52,51,1,0,0,0,0,7,7,7,7
Monterey,37,2022-08-30,358,358,358,0,5308,5315,5313,2,28,1,1,4,764,764,763,763
Napa,37,2022-08-30,124,124,124,0,2227,2232,2231,1,9,0,0,0,158,158,158,158
Nevada,37,2022-08-30,114,114,114,0,1214,1216,1215,1,6,0,0,0,135,135,135,135
Orange,37,2022-08-30,2915,2920,2920,0,39781,39839,39834,5,177,18,18,27,7462,7462,7444,7444
Placer,37,2022-08-30,331,331,331,0,4257,4263,4262,1,60,1,1,12,658,658,657,657
Plumas,37,2022-08-30,17,17,17,0,160,161,160,1,0,0,0,0,13,13,13,13
Riverside,37,2022-08-30,3580,3586,3585,1,36754,36808,36802,6,126,10,10,14,6618,6618,6608,6608
Sacramento,37,2022-08-30,1817,1817,1817,0,24434,24469,24464,5,145,13,13,20,3298,3298,3285,3285
San Benito,37,2022-08-30,111,111,111,0,1406,1407,1406,1,0,0,0,0,100,100,100,100
San Bernardino,37,2022-08-30,3523,3528,3528,0,42624,42687,42681,6,152,14,14,17,8054,8054,8040,8040
San Diego,37,2022-08-30,3874,3880,3880,0,56826,56910,56907,3,226,14,14,28,5535,5535,5521,5521
San Francisco,37,2022-08-30,826,826,826,0,18963,18992,18985,7,53,8,8,11,1038,1038,1030,1030
San Joaquin,37,2022-08-30,970,970,970,0,14159,14180,14177,3,43,4,4,7,2321,2321,2317,2317
San Luis Obispo,37,2022-08-30,306,306,306,0,3194,3199,3198,1,18,3,3,0,522,522,519,519
San Mateo,37,2022-08-30,833,833,833,0,16461,16485,16483,2,29,0,0,5,736,736,736,736
Santa Barbara,37,2022-08-30,611,611,611,0,7585,7596,7595,1,31,2,2,2,723,723,721,721
Santa Clara,37,2022-08-30,2319,2323,2323,0,39995,40053,40051,2,146,7,7,26,2499,2499,2492,2492
Santa Cruz,37,2022-08-30,368,368,368,0,12559,12577,12575,2,8,0,0,1,273,273,273,273
Shasta,37,2022-08-30,136,136,136,0,2561,2566,2565,1,19,1,1,0,587,587,586,586
Siskiyou,37,2022-08-30,24,24,24,0,231,232,231,1,1,1,1,0,89,89,88,88
Solano,37,2022-08-30,540,540,540,0,7473,7485,7484,1,38,2,2,8,457,457,455,455
Sonoma,37,2022-08-30,484,484,484,0,7152,7164,7163,1,36,1,1,2,520,520,519,519
Stanislaus,37,2022-08-30,804,804,804,0,8008,8021,8019,2,79,8,8,7,1774,1774,1766,1766
Sutter,37,2022-08-30,163,163,163,0,1649,1651,1650,1,0,0,0,0,232,232,232,232
Tehama,37,2022-08-30,70,70,70,0,730,731,730,1,4,1,1,1,214,214,213,213
Trinity,37,2022-08-30,5,5,5,0,52,53,52,1,0,0,0,0,21,21,21,21
Tulare,37,2022-08-30,644,644,644,0,7161,7171,7169,2,40,0,0,2,1533,1533,1533,1533
Tuolumne,37,2022-08-30,83,83,83,0,844,845,844,1,0,0,0,0,199,199,199,199
Ventura,37,2022-08-30,1007,1007,1007,0,14758,14780,14778,2,59,7,7,6,1579,1579,1572,1572
Yolo,37,2022-08-30,193,193,193,0,3564,3569,3568,1,5,1,1,6,389,389,388,388
Yuba,37,2022-08-30,126,126,126,0,1183,1184,1183,1,10,0,0,0,122,122,122,122
Alameda,38,2022-09-06,1424,1424,1424,0,29344,29389,29386,3,104,2,2,17,2037,2037,2035,2035
Amador,38,2022-09-06,34,34,34,0,675,676,675,1,5,0,0,1,90,90,90,90
Butte,38,2022-09-06,198,198,198,0,2243,2247,2246,1,17,3,3,3,460,460,457,457
Calaveras,38,2022-09-06,24,24,24,0,475,476,475,1,0,0,0,0,133,133,133,133
Colusa,38,2022-09-06,15,15,15,0,292,293,292,1,2,0,0,0,22,22,22,22
Contra Costa,38,2022-09-06,966,966,966,0,15959,15984,15981,3,47,4,4,9,1442,1442,1438,1438
Del Norte,38,2022-09-06,13,13,13,0,402,403,402,1,1,0,0,1,55,55,55,55
El Dorado,38,2022-09-06,98,98,98,0,1670,1672,1671,1,2,1,1,3,233,233,232,232
Fresno,38,2022-09-06,1094,1094,1094,0,13451,13471,13469,2,158,11,11,17,2866,2866,2855,2855
Glenn,38,2022-09-06,12,12,12,0,191,192,191,1,1,0,0,0,53,53,53,53
Humboldt,38,2022-09-06,103,103,103,0,1376,1378,1377,1,14,1,1,1,159,159,158,158
Imperial,38,2022-09-06,245,245,245,0,2631,2636,2635,1,11,1,1,0,961,961,960,960
Inyo,38,2022-09-06,13,13,13,0,170,171,170,1,0,0,0,0,59,59,59,59
Kern,38,2022-09-06,704,704,704,0,11368,11385,11384,1,43,4,4,7,2414,2414,2410,2410
Kings,38,2022-09-06,217,217,217,0,2766,2771,2770,1,6,0,0,3,461,461,461,461
Lake,38,2022-09-06,55,55,55,0,785,786,785,1,6,1,1,0,148,148,147,147
Lassen,38,2022-09-06,22,22,22,0,640,641,640,1,0,0,0,0,63,63,63,63
Los Angeles,38,2022-09-06,10899,10915,10915,0,241599,241965,241955,10,678,100,100,105,33397,33397,33297,33297
Madera,38,2022-09-06,223,223,223,0,2513,2518,2517,1,11,0,0,4,373,373,373,373
Marin,38,2022-09-06,186,186,186,0,3725,3731,3730,1,20,0,0,0,313,313,313,313
Mariposa,38,2022-09-06,17,17,17,0,177,178,177,1,0,0,0,0,29,29,29,29
Mendocino,38,2022-09-06,63,63,63,0,859,860,859,1,4,1,1,2,136,136,135,135
Merced,38,2022-09-06,254,254,254,0,2876,2881,2880,1,9,2,2,2,861,861,859,859
Modoc,38,2022-09-06,3,3,3,0,19,20,19,1,0,0,0,0,9,9,9,9
Mono,38,2022-09-06,5,5,5,0,52,53,52,1,0,0,0,0,7,7,7,7
Monterey,38,2022-09-06,275,275,275,0,4651,4657,4656,1,24,4,4,0,768,768,764,764
Napa,38,2022-09-06,112,112,112,0,1793,1797,1796,1,6,1,1,0,159,159,158,158
Nevada,38,2022-09-06,72,72,72,0,984,985,984,1,3,1,1,0,136,136,135,135
Orange,38,2022-09-06,2298,2301,2301,0,33662,33713,33710,3,182,14,14,31,7476,7476,7462,7462
Placer,38,2022-09-06,251,251,251,0,3549,3555,3554,1,49,0,0,8,658,658,658,658
Plumas,38,2022-09-06,9,9,9,0,140,141,140,1,0,0,0,0,13,13,13,13
Riverside,38,2022-09-06,2374,2378,2378,0,29658,29703,29699,4,123,5,5,14,6623,6623,6618,6618
Sacramento,38,2022-09-06,1290,1290,1290,0,20815,20846,20843,3,140,11,11,25,3309,3309,3298,3298
San Benito,38,2022-09-06,78,78,78,0,1256,1258,1257,1,1,0,0,2,100,100,100,100
San Bernardino,38,2022-09-06,2225,2229,2229,0,35384,35439,35435,4,113,18,18,22,8072,8072,8054,8054
San Diego,38,2022-09-06,2799,2803,2803,0,49558,49633,49631,2,208,12,12,29,5547,5547,5535,5535
San Francisco,38,2022-09-06,739,739,739,0,15994,16018,16013,5,52,8,8,13,1046,1046,1038,1038
San Joaquin,38,2022-09-06,827,827,827,0,12651,12670,12668,2,37,4,4,9,2325,2325,2321,2321
San Luis Obispo,38,2022-09-06,198,198,198,0,2850,2855,2854,1,8,2,2,1,524,524,522,522
San Mateo,38,2022-09-06,644,644,644,0,13829,13851,13850,1,20,1,1,4,737,737,736,736
Santa Barbara,38,2022-09-06,477,477,477,0,6959,6970,6969,1,39,3,3,5,726,726,723,723
Santa Clara,38,2022-09-06,1903,1904,1904,0,35233,35287,35285,2,149,9,9,21,2508,2508,2499,2499
Santa Cruz,38,2022-09-06,274,274,274,0,10433,10449,10448,1,12,0,0,0,273,273,273,273
Shasta,38,2022-09-06,117,117,117,0,2202,2206,2205,1,18,0,0,0,587,587,587,587
Siskiyou,38,2022-09-06,32,32,32,0,233,234,233,1,1,0,0,0,89,89,89,89
Solano,38,2022-09-06,383,383,383,0,6092,6101,6100,1,36,0,0,5,457,457,457,457
Sonoma,38,2022-09-06,361,361,361,0,6224,6234,6233,1,41,1,1,2,521,521,520,520
Stanislaus,38,2022-09-06,525,525,525,0,6712,6724,6723,1,84,4,4,8,1778,1778,1774,1774
Sutter,38,2022-09-06,114,114,114,0,1475,1477,1476,1,0,0,0,0,232,232,232,232
Tehama,38,2022-09-06,49,49,49,0,645,646,645,1,2,0,0,0,214,214,214,214
Trinity,38,2022-09-06,3,3,3,0,50,51,50,1,0,0,0,0,21,21,21,21
Tulare,38,2022-09-06,437,437,437,0,5758,5766,5765,1,35,2,2,2,1535,1535,1533,1533
Tuolumne,38,2022-09-06,72,72,72,0,770,771,770,1,0,0,0,0,199,199,199,199
Ventura,38,2022-09-06,893,893,893,0,12901,12922,12921,1,68,7,7,3,1586,1586,1579,1579
Yolo,38,2022-09-06,139,139,139,0,2837,2842,2841,1,1,3,3,2,392,392,389,389
Yuba,38,2022-09-06,92,92,92,0,1007,1008,1007,1,11,0,0,0,122,122,122,122
Alameda,39,2022-09-13,1561,1561,1561,0,30551,30599,30596,3,86,5,5,21,2042,2042,2037,2037
Amador,39,2022-09-13,36,36,36,0,920,921,920,1,3,1,1,1,91,91,90,90
Butte,39,2022-09-13,168,168,168,0,2337,2342,2341,1,18,2,2,0,462,462,460,460
Calaveras,39,2022-09-13,15,15,15,0,486,487,486,1,0,0,0,0,133,133,133,133
Colusa,39,2022-09-13,11,11,11,0,322,323,322,1,0,0,0,0,22,22,22,22
Contra Costa,39,2022-09-13,922,922,922,0,16682,16709,16707,2,60,6,6,10,1448,1448,1442,1442
Del Norte,39,2022-09-13,32,32,32,0,573,574,573,1,3,0,0,0,55,55,55,55
El Dorado,39,2022-09-13,97,97,97,0,1765,1768,1767,1,4,0,0,2,233,233,233,233
Fresno,39,2022-09-13,800,800,800,0,14107,14128,14126,2,136,6,6,17,2872,2872,2866,2866
Glenn,39,2022-09-13,16,16,16,0,200,201,200,1,0,0,0,0,53,53,53,53
Humboldt,39,2022-09-13,113,113,113,0,1569,1571,1570,1,10,0,0,2,159,159,159,159
Imperial,39,2022-09-13,229,229,229,0,3173,3179,3178,1,12,0,0,1,961,961,961,961
Inyo,39,2022-09-13,15,15,15,0,183,184,183,1,0,1,1,0,60,60,59,59
Kern,39,2022-09-13,587,587,587,0,12698,12717,12716,1,51,7,7,9,2421,2421,2414,2414
Kings,39,2022-09-13,188,188,188,0,3129,3135,3134,1,5,1,1,0,462,462,461,461
Lake,39,2022-09-13,50,50,50,0,789,790,789,1,3,0,0,1,148,148,148,148
Lassen,39,2022-09-13,12,12,12,0,898,899,898,1,0,0,0,0,63,63,63,63
Los Angeles,39,2022-09-13,10121,10136,10136,0,263307,263720,263711,9,628,79,79,89,33476,33476,33397,33397
Madera,39,2022-09-13,198,198,198,0,2894,2900,2899,1,14,0,0,2,373,373,373,373
Marin,39,2022-09-13,165,165,165,0,3683,3689,3688,1,17,2,2,1,315,315,313,313
Mariposa,39,2022-09-13,16,16,16,0,183,184,183,1,0,0,0,0,29,29,29,29
Mendocino,39,2022-09-13,48,48,48,0,916,917,916,1,2,0,0,0,136,136,136,136
Merced,39,2022-09-13,214,214,214,0,3023,3029,3028,1,6,3,3,0,864,864,861,861
Modoc,39,2022-09-13,1,1,1,0,17,18,17,1,0,0,0,0,9,9,9,9
Mono,39,2022-09-13,9,9,9,0,78,79,78,1,0,0,0,0,7,7,7,7
Monterey,39,2022-09-13,195,195,195,0,4683,4689,4688,1,18,1,1,1,769,769,768,768
Napa,39,2022-09-13,113,113,113,0,2118,2122,2121,1,8,0,0,0,159,159,159,159
Nevada,39,2022-09-13,63,63,63,0,1048,1049,1048,1,2,0,0,0,136,136,136,136
Orange,39,2022-09-13,1990,1992,1992,0,35492,35547,35544,3,142,25,25,27,7501,7501,7476,7476
Placer,39,2022-09-13,220,220,220,0,3971,3977,3976,1,50,0,0,7,658,658,658,658
Plumas,39,2022-09-13,24,24,24,0,168,169,168,1,1,0,0,0,13,13,13,13
Riverside,39,2022-09-13,2038,2040,2040,0,31179,31228,31225,3,111,6,6,7,6629,6629,6623,6623
Sacramento,39,2022-09-13,1179,1179,1179,0,22388,22423,22420,3,121,13,13,16,3322,3322,3309,3309
San Benito,39,2022-09-13,83,83,83,0,1309,1311,1310,1,0,0,0,0,100,100,100,100
San Bernardino,39,2022-09-13,1823,1824,1824,0,36502,36559,36556,3,97,9,9,25,8081,8081,8072,8072
San Diego,39,2022-09-13,2893,2898,2898,0,54793,54880,54878,2,197,8,8,24,5555,5555,5547,5547
San Francisco,39,2022-09-13,770,770,770,0,16794,16820,16816,4,55,10,10,10,1056,1056,1046,1046
San Joaquin,39,2022-09-13,600,600,600,0,13887,13909,13907,2,29,7,7,7,2332,2332,2325,2325
San Luis Obispo,39,2022-09-13,162,162,162,0,2956,2962,2961,1,13,0,0,1,524,524,524,524
San Mateo,39,2022-09-13,648,648,648,0,13783,13804,13803,1,27,1,1,1,738,738,737,737
Santa Barbara,39,2022-09-13,279,279,279,0,6742,6753,6752,1,27,2,2,3,728,728,726,726
Santa Clara,39,2022-09-13,1810,1810,1810,0,36005,36062,36061,1,140,7,7,24,2515,2515,2508,2508
Santa Cruz,39,2022-09-13,241,241,241,0,12811,12831,12830,1,13,0,0,0,273,273,273,273
Shasta,39,2022-09-13,171,171,171,0,2358,2363,2362,1,25,1,1,2,588,588,587,587
Siskiyou,39,2022-09-13,24,24,24,0,277,278,277,1,2,0,0,1,89,89,89,89
Solano,39,2022-09-13,372,372,372,0,6340,6350,6349,1,20,0,0,3,457,457,457,457
Sonoma,39,2022-09-13,376,376,376,0,6531,6543,6542,1,29,3,3,1,524,524,521,521
Stanislaus,39,2022-09-13,408,408,408,0,7216,7228,7227,1,63,2,2,5,1780,1780,1778,1778
Sutter,39,2022-09-13,106,106,106,0,1496,1498,1497,1,0,0,0,0,232,232,232,232
Tehama,39,2022-09-13,46,46,46,0,630,631,630,1,2,0,0,0,214,214,214,214
Trinity,39,2022-09-13,3,3,3,0,74,75,74,1,0,0,0,0,21,21,21,21
Tulare,39,2022-09-13,327,327,327,0,6378,6388,6387,1,42,4,4,1,1539,1539,1535,1535
Tuolumne,39,2022-09-13,51,51,51,0,786,787,786,1,1,0,0,0,199,199,199,199
Ventura,39,2022-09-13,775,775,775,0,14057,14079,14078,1,59,2,2,6,1588,1588,1586,1586
Yolo,39,2022-09-13,133,133,133,0,3535,3542,3541,1,4,1,1,1,393,393,392,392
Yuba,39,2022-09-13,85,85,85,0,1119,1120,1119,1,4,0,0,0,122,122,122,122
Alameda,40,2022-09-20,1193,1193,1193,0,28712,28758,28756,2,71,5,5,10,2047,2047,2042,2042
Amador,40,2022-09-20,29,29,29,0,762,763,762,1,1,2,2,1,93,93,91,91
Butte,40,2022-09-20,115,115,115,0,1946,1949,1948,1,18,0,0,2,462,462,462,462
Calaveras,40,2022-09-20,29,29,29,0,450,451,450,1,1,0,0,0,133,133,133,133
Colusa,40,2022-09-20,14,14,14,0,293,294,293,1,3,0,0,0,22,22,22,22
Contra Costa,40,2022-09-20,791,791,791,0,16942,16969,16967,2,54,9,9,7,1457,1457,1448,1448
Del Norte,40,2022-09-20,22,22,22,0,491,492,491,1,2,0,0,0,55,55,55,55
El Dorado,40,2022-09-20,71,71,71,0,1565,1567,1566,1,1,0,0,2,233,233,233,233
Fresno,40,2022-09-20,564,564,564,0,12907,12929,12928,1,109,6,6,11,2878,2878,2872,2872
Glenn,40,2022-09-20,11,11,11,0,195,196,195,1,3,0,0,0,53,53,53,53
Humboldt,40,2022-09-20,102,102,102,0,1459,1460,1459,1,8,0,0,3,159,159,159,159
Imperial,40,2022-09-20,145,145,145,0,2835,2841,2840,1,8,0,0,0,961,961,961,961
Inyo,40,2022-09-20,7,7,7,0,182,183,182,1,0,0,0,0,60,60,60,60
Kern,40,2022-09-20,431,431,431,0,11558,11576,11575,1,34,2,2,7,2423,2423,2421,2421
Kings,40,2022-09-20,134,134,134,0,2635,2641,2640,1,5,2,2,0,464,464,462,462
Lake,40,2022-09-20,34,34,34,0,878,879,878,1,0,0,0,1,148,148,148,148
Lassen,40,2022-09-20,11,11,11,0,637,638,637,1,0,0,0,0,63,63,63,63
Los Angeles,40,2022-09-20,8408,8421,8421,0,255359,255772,255765,7,490,63,63,83,33539,33539,33476,33476
Madera,40,2022-09-20,123,123,123,0,2721,2727,2726,1,5,1,1,3,374,374,373,373
Marin,40,2022-09-20,147,147,147,0,3636,3643,3642,1,4,0,0,0,315,315,315,315
Mariposa,40,2022-09-20,7,7,7,0,171,172,171,1,0,1,1,0,30,30,29,29
Mendocino,40,2022-09-20,39,39,39,0,924,925,924,1,0,0,0,0,136,136,136,136
Merced,40,2022-09-20,145,145,145,0,2869,2875,2874,1,10,2,2,1,866,866,864,864
Modoc,40,2022-09-20,2,2,2,0,16,17,16,1,0,0,0,0,9,9,9,9
Mono,40,2022-09-20,0,0,0,0,64,65,64,1,0,0,0,0,7,7,7,7
Monterey,40,2022-09-20,162,162,162,0,4264,4271,4270,1,17,1,1,3,770,770,769,769
Napa,40,2022-09-20,96,96,96,0,1775,1778,1777,1,4,0,0,0,159,159,159,159
Nevada,40,2022-09-20,63,63,63,0,1157,1159,1158,1,2,0,0,0,136,136,136,136
Orange,40,2022-09-20,1780,1780,1780,0,34059,34114,34112,2,105,16,16,19,7517,7517,7501,7501
Placer,40,2022-09-20,214,214,214,0,3705,3712,3711,1,49,1,1,4,659,659,658,658
Plumas,40,2022-09-20,21,21,21,0,181,182,181,1,1,0,0,0,13,13,13,13
Riverside,40,2022-09-20,1377,1377,1377,0,28919,28967,28965,2,73,4,4,14,6633,6633,6629,6629
Sacramento,40,2022-09-20,1018,1018,1018,0,20956,20989,20987,2,100,9,9,18,3331,3331,3322,3322
San Benito,40,2022-09-20,51,51,51,0,1209,1211,1210,1,0,0,0,0,100,100,100,100
San Bernardino,40,2022-09-20,1399,1399,1399,0,31632,31684,31682,2,86,7,7,19,8088,8088,8081,8081
San Diego,40,2022-09-20,2507,2512,2512,0,55952,56043,56041,2,163,7,7,18,5562,5562,5555,5555
San Francisco,40,2022-09-20,669,669,669,0,16603,16630,16627,3,50,7,7,6,1063,1063,1056,1056
San Joaquin,40,2022-09-20,456,456,456,0,12387,12406,12405,1,30,4,4,2,2336,2336,2332,2332
San Luis Obispo,40,2022-09-20,147,147,147,0,2597,2603,2602,1,6,0,0,0,524,524,524,524
San Mateo,40,2022-09-20,611,611,611,0,13943,13966,13965,1,21,0,0,1,738,738,738,738
Santa Barbara,40,2022-09-20,274,274,274,0,6792,6803,6802,1,31,1,1,0,729,729,728,728
Santa Clara,40,2022-09-20,1428,1428,1428,0,37729,37791,37790,1,127,11,11,17,2526,2526,2515,2515
Santa Cruz,40,2022-09-20,150,150,150,0,12339,12360,12359,1,9,0,0,1,273,273,273,273
Shasta,40,2022-09-20,99,99,99,0,2072,2076,2075,1,20,0,0,4,588,588,588,588
Siskiyou,40,2022-09-20,21,21,21,0,221,222,221,1,2,1,1,1,90,90,89,89
Solano,40,2022-09-20,266,266,266,0,6006,6018,6017,1,30,1,1,4,458,458,457,457
Sonoma,40,2022-09-20,325,325,325,0,6399,6410,6409,1,27,2,2,1,526,526,524,524
Stanislaus,40,2022-09-20,321,321,321,0,6143,6154,6153,1,50,4,4,4,1784,1784,1780,1780
Sutter,40,2022-09-20,79,79,79,0,1263,1264,1263,1,0,0,0,0,232,232,232,232
Tehama,40,2022-09-20,34,34,34,0,594,595,594,1,3,1,1,0,215,215,214,214
Trinity,40,2022-09-20,2,2,2,0,51,52,51,1,0,0,0,0,21,21,21,21
Tulare,40,2022-09-20,207,207,207,0,5422,5430,5429,1,31,1,1,1,1540,1540,1539,1539
Tuolumne,40,2022-09-20,56,56,56,0,696,697,696,1,1,0,0,0,199,199,199,199
Ventura,40,2022-09-20,605,605,605,0,13212,13234,13233,1,36,2,2,5,1590,1590,1588,1588
Yolo,40,2022-09-20,83,83,83,0,3863,3870,3869,1,3,4,4,2,397,397,393,393
Yuba,40,2022-09-20,56,56,56,0,981,982,981,1,5,0,0,0,122,122,122,122
Alameda,41,2022-09-27,1171,1171,1171,0,27562,27607,27606,1,78,1,1,7,2048,2048,2047,2047
Amador,41,2022-09-27,24,24,24,0,730,731,730,1,0,0,0,0,93,93,93,93
Butte,41,2022-09-27,89,89,89,0,1780,1783,1782,1,21,0,0,2,462,462,462,462
Calaveras,41,2022-09-27,18,18,18,0,393,394,393,1,1,1,1,0,134,134,133,133
Colusa,41,2022-09-27,8,8,8,0,282,283,282,1,2,0,0,0,22,22,22,22
Contra Costa,41,2022-09-27,816,816,816,0,16088,16116,16115,1,34,4,4,9,1461,1461,1457,1457
Del Norte,41,2022-09-27,20,20,20,0,434,435,434,1,2,0,0,0,55,55,55,55
El Dorado,41,2022-09-27,95,95,95,0,1591,1594,1593,1,5,0,0,0,233,233,233,233
Fresno,41,2022-09-27,503,503,503,0,11830,11849,11848,1,87,3,3,9,2881,2881,2878,2878
Glenn,41,2022-09-27,6,6,6,0,179,180,179,1,4,0,0,0,53,53,53,53
Humboldt,41,2022-09-27,96,96,96,0,1299,1300,1299,1,4,2,2,0,161,161,159,159
Imperial,41,2022-09-27,117,117,117,0,2585,2591,2590,1,8,1,1,0,962,962,961,961
Inyo,41,2022-09-27,4,4,4,0,163,164,163,1,0,0,0,0,60,60,60,60
Kern,41,2022-09-27,354,354,354,0,10484,10501,10500,1,30,3,3,10,2426,2426,2423,2423
Kings,41,2022-09-27,105,105,105,0,2559,2564,2563,1,2,0,0,0,464,464,464,464
Lake,41,2022-09-27,26,26,26,0,810,811,810,1,1,1,1,1,149,149,148,148
Lassen,41,2022-09-27,8,8,8,0,556,557,556,1,0,0,0,0,63,63,63,63
Los Angeles,41,2022-09-27,7529,7541,7541,0,240167,240565,240560,5,411,69,69,60,33608,33608,33539,33539
Madera,41,2022-09-27,77,77,77,0,1921,1926,1925,1,7,0,0,3,374,374,374,374
Marin,41,2022-09-27,174,174,174,0,3710,3716,3715,1,12,0,0,0,315,315,315,315
Mariposa,41,2022-09-27,5,5,5,0,140,141,140,1,0,0,0,0,30,30,30,30
Mendocino,41,2022-09-27,44,44,44,0,824,825,824,1,3,0,0,0,136,136,136,136
Merced,41,2022-09-27,125,125,125,0,2888,2894,2893,1,13,1,1,0,867,867,866,866
Modoc,41,2022-09-27,2,2,2,0,12,13,12,1,1,0,0,0,9,9,9,9
Mono,41,2022-09-27,3,3,3,0,56,57,56,1,0,0,0,0,7,7,7,7
Monterey,41,2022-09-27,118,118,118,0,3960,3965,3964,1,15,0,0,2,770,770,770,770
Napa,41,2022-09-27,90,90,90,0,1947,1951,1950,1,2,0,0,1,159,159,159,159
Nevada,41,2022-09-27,52,52,52,0,1052,1053,1052,1,3,0,0,0,136,136,136,136
Orange,41,2022-09-27,1715,1716,1716,0,30998,31051,31050,1,113,21,21,22,7538,7538,7517,7517
Placer,41,2022-09-27,223,223,223,0,3640,3647,3646,1,37,1,1,7,660,660,659,659
Plumas,41,2022-09-27,19,19,19,0,147,148,147,1,2,0,0,0,13,13,13,13
Riverside,41,2022-09-27,1257,1257,1257,0,24828,24869,24867,2,54,8,8,10,6641,6641,6633,6633
Sacramento,41,2022-09-27,944,944,944,0,19099,19131,19130,1,102,11,11,16,3342,3342,3331,3331
San Benito,41,2022-09-27,47,47,47,0,1146,1148,1147,1,0,1,1,1,101,101,100,100
San Bernardino,41,2022-09-27,1214,1214,1214,0,27298,27343,27342,1,82,4,4,14,8092,8092,8088,8088
San Diego,41,2022-09-27,2477,2482,2482,0,50236,50319,50318,1,194,9,9,17,5571,5571,5562,5562
San Francisco,41,2022-09-27,688,688,688,0,16360,16388,16386,2,48,3,3,8,1066,1066,1063,1063
San Joaquin,41,2022-09-27,382,382,382,0,10778,10795,10794,1,35,2,2,5,2338,2338,2336,2336
San Luis Obispo,41,2022-09-27,141,141,141,0,2520,2526,2525,1,6,1,1,1,525,525,524,524
San Mateo,41,2022-09-27,609,609,609,0,13024,13044,13043,1,23,0,0,1,738,738,738,738
Santa Barbara,41,2022-09-27,257,257,257,0,6450,6462,6461,1,20,2,2,0,731,731,729,729
Santa Clara,41,2022-09-27,1419,1419,1419,0,35494,35553,35552,1,109,7,7,21,2533,2533,2526,2526
Santa Cruz,41,2022-09-27,234,234,234,0,12180,12200,12199,1,12,0,0,0,273,273,273,273
Shasta,41,2022-09-27,65,65,65,0,1653,1657,1656,1,14,0,0,4,588,588,588,588
Siskiyou,41,2022-09-27,15,15,15,0,186,187,186,1,1,2,2,1,92,92,90,90
Solano,41,2022-09-27,307,307,307,0,5701,5712,5711,1,28,1,1,1,459,459,458,458
Sonoma,41,2022-09-27,303,303,303,0,6249,6261,6260,1,21,1,1,2,527,527,526,526
Stanislaus,41,2022-09-27,245,245,245,0,5764,5773,5772,1,40,1,1,3,1785,1785,1784,1784
Sutter,41,2022-09-27,64,64,64,0,1182,1184,1183,1,0,0,0,0,232,232,232,232
Tehama,41,2022-09-27,34,34,34,0,526,527,526,1,1,2,2,0,217,217,215,215
Trinity,41,2022-09-27,3,3,3,0,42,43,42,1,0,0,0,0,21,21,21,21
Tulare,41,2022-09-27,179,179,179,0,5017,5025,5024,1,19,3,3,2,1543,1543,1540,1540
Tuolumne,41,2022-09-27,40,40,40,0,692,693,692,1,0,0,0,0,199,199,199,199
Ventura,41,2022-09-27,550,550,550,0,11269,11289,11288,1,36,3,3,2,1593,1593,1590,1590
Yolo,41,2022-09-27,140,140,140,0,3799,3806,3805,1,7,2,2,0,399,399,397,397
Yuba,41,2022-09-27,37,37,37,0,944,945,944,1,6,0,0,1,122,122,122,122
Alameda,42,2022-10-04,1141,1141,1141,0,25784,25828,25827,1,56,3,3,6,2051,2051,2048,2048
Amador,42,2022-10-04,15,15,15,0,573,574,573,1,0,0,0,1,93,93,93,93
Butte,42,2022-10-04,70,70,70,0,1780,1785,1784,1,11,2,2,2,464,464,462,462
Calaveras,42,2022-10-04,17,17,17,0,330,331,330,1,1,1,1,0,135,135,134,134
Colusa,42,2022-10-04,4,4,4,0,190,191,190,1,0,0,0,0,22,22,22,22
Contra Costa,42,2022-10-04,720,720,720,0,15568,15594,15593,1,34,5,5,6,1466,1466,1461,1461
Del Norte,42,2022-10-04,12,12,12,0,370,371,370,1,1,0,0,1,55,55,55,55
El Dorado,42,2022-10-04,70,70,70,0,1363,1364,1363,1,4,0,0,1,233,233,233,233
Fresno,42,2022-10-04,448,448,448,0,11229,11247,11246,1,75,1,1,11,2882,2882,2881,2881
Glenn,42,2022-10-04,7,7,7,0,152,153,152,1,0,0,0,0,53,53,53,53
Humboldt,42,2022-10-04,81,81,81,0,1174,1175,1174,1,6,1,1,0,162,162,161,161
Imperial,42,2022-10-04,139,139,139,0,2523,2529,2528,1,7,0,0,0,962,962,962,962
Inyo,42,2022-10-04,6,6,6,0,113,114,113,1,0,0,0,0,60,60,60,60
Kern,42,2022-10-04,294,294,294,0,10199,10218,10217,1,33,4,4,6,2430,2430,2426,2426
Kings,42,2022-10-04,93,93,93,0,2456,2462,2461,1,2,0,0,0,464,464,464,464
Lake,42,2022-10-04,33,33,33,0,733,734,733,1,3,0,0,0,149,149,149,149
Lassen,42,2022-10-04,9,9,9,0,495,496,495,1,2,0,0,0,63,63,63,63
Los Angeles,42,2022-10-04,6861,6873,6873,0,212306,212669,212666,3,436,49,49,65,33657,33657,33608,33608
Madera,42,2022-10-04,54,54,54,0,1543,1545,1544,1,8,1,1,2,375,375,374,374
Marin,42,2022-10-04,189,189,189,0,3428,3434,3433,1,7,0,0,1,315,315,315,315
Mariposa,42,2022-10-04,5,5,5,0,135,136,135,1,0,0,0,0,30,30,30,30
Mendocino,42,2022-10-04,47,47,47,0,803,804,803,1,1,0,0,0,136,136,136,136
Merced,42,2022-10-04,110,110,110,0,2556,2562,2561,1,11,3,3,0,870,870,867,867
Modoc,42,2022-10-04,2,2,2,0,17,18,17,1,1,0,0,0,9,9,9,9
Mono,42,2022-10-04,2,2,2,0,71,72,71,1,0,0,0,0,7,7,7,7
Monterey,42,2022-10-04,109,109,109,0,3847,3853,3852,1,8,1,1,2,771,771,770,770
Napa,42,2022-10-04,86,86,86,0,1691,1694,1693,1,3,0,0,2,159,159,159,159
Nevada,42,2022-10-04,49,49,49,0,935,936,935,1,3,0,0,0,136,136,136,136
Orange,42,2022-10-04,1532,1532,1532,0,27730,27777,27776,1,131,20,20,11,7558,7558,7538,7538
Placer,42,2022-10-04,192,192,192,0,3322,3329,3328,1,38,2,2,2,662,662,660,660
Plumas,42,2022-10-04,13,13,13,0,106,107,106,1,2,0,0,0,13,13,13,13
Riverside,42,2022-10-04,1113,1113,1113,0,21804,21841,21840,1,59,7,7,10,6648,6648,6641,6641
Sacramento,42,2022-10-04,901,901,901,0,17841,17871,17870,1,100,10,10,14,3352,3352,3342,3342
San Benito,42,2022-10-04,34,34,34,0,1127,1129,1128,1,0,0,0,0,101,101,101,101
San Bernardino,42,2022-10-04,1222,1222,1222,0,24909,24952,24951,1,76,4,4,11,8096,8096,8092,8092
San Diego,42,2022-10-04,1983,1987,1987,0,45882,45962,45961,1,159,8,8,18,5579,5579,5571,5571
San Francisco,42,2022-10-04,665,665,665,0,15163,15189,15187,2,51,3,3,6,1069,1069,1066,1066
San Joaquin,42,2022-10-04,340,340,340,0,9688,9704,9703,1,30,3,3,5,2341,2341,2338,2338
San Luis Obispo,42,2022-10-04,134,134,134,0,2393,2399,2398,1,5,2,2,0,527,527,525,525
San Mateo,42,2022-10-04,550,550,550,0,12131,12152,12151,1,21,0,0,2,738,738,738,738
Santa Barbara,42,2022-10-04,255,255,255,0,6328,6341,6340,1,19,0,0,0,731,731,731,731
Santa Clara,42,2022-10-04,1404,1404,1404,0,31089,31143,31142,1,107,6,6,19,2539,2539,2533,2533
Santa Cruz,42,2022-10-04,235,235,235,0,11089,11109,11108,1,13,0,0,0,273,273,273,273
Shasta,42,2022-10-04,54,54,54,0,1319,1321,1320,1,13,0,0,4,588,588,588,588
Siskiyou,42,2022-10-04,10,10,10,0,194,195,194,1,1,1,1,0,93,93,92,92
Solano,42,2022-10-04,266,266,266,0,5362,5372,5371,1,17,0,0,2,459,459,459,459
Sonoma,42,2022-10-04,296,296,296,0,5905,5917,5916,1,12,0,0,6,527,527,527,527
Stanislaus,42,2022-10-04,204,204,204,0,5302,5312,5311,1,47,1,1,8,1786,1786,1785,1785
Sutter,42,2022-10-04,50,50,50,0,1028,1029,1028,1,0,0,0,0,232,232,232,232
Tehama,42,2022-10-04,20,20,20,0,526,527,526,1,1,0,0,0,217,217,217,217
Trinity,42,2022-10-04,1,1,1,0,42,43,42,1,0,0,0,0,21,21,21,21
Tulare,42,2022-10-04,144,144,144,0,4936,4944,4943,1,16,4,4,1,1547,1547,1543,1543
Tuolumne,42,2022-10-04,27,27,27,0,604,605,604,1,0,1,1,0,200,200,199,199
Ventura,42,2022-10-04,458,458,458,0,10239,10257,10256,1,33,3,3,1,1596,1596,1593,1593
Yolo,42,2022-10-04,115,115,115,0,2910,2917,2916,1,1,2,2,1,401,401,399,399
Yuba,42,2022-10-04,32,32,32,0,795,796,795,1,2,0,0,2,122,122,122,122
Alameda,43,2022-10-11,1125,1125,1125,0,28009,28058,28057,1,57,2,2,7,2053,2053,2051,2051
Amador,43,2022-10-11,16,16,16,0,901,902,901,1,1,0,0,1,93,93,93,93
Butte,43,2022-10-11,61,61,61,0,1703,1706,1705,1,13,3,3,0,466,466,463,463
Calaveras,43,2022-10-11,14,14,14,0,360,361,360,1,0,0,0,1,135,135,135,135
Colusa,43,2022-10-11,2,2,2,0,109,110,109,1,0,0,0,0,22,22,22,22
Contra Costa,43,2022-10-11,779,779,779,0,16859,16887,16886,1,28,4,4,6,1468,1468,1464,1464
Del Norte,43,2022-10-11,12,12,12,0,493,494,493,1,1,0,0,0,55,55,55,55
El Dorado,43,2022-10-11,88,88,88,0,1805,1809,1808,1,8,0,0,2,233,233,233,233
Fresno,43,2022-10-11,481,481,481,0,12160,12181,12180,1,64,4,4,10,2886,2886,2882,2882
Glenn,43,2022-10-11,11,11,11,0,221,222,221,1,1,0,0,0,53,53,53,53
Humboldt,43,2022-10-11,102,102,102,0,1418,1419,1418,1,7,0,0,0,162,162,162,162
Imperial,43,2022-10-11,202,202,202,0,2957,2964,2963,1,9,0,0,0,962,962,962,962
Inyo,43,2022-10-11,4,4,4,0,140,141,140,1,0,0,0,0,60,60,60,60
Kern,43,2022-10-11,322,322,322,0,11824,11845,11844,1,27,2,2,5,2432,2432,2430,2430
Kings,43,2022-10-11,93,93,93,0,2607,2613,2612,1,3,1,1,0,465,465,464,464
Lake,43,2022-10-11,33,33,33,0,953,954,953,1,0,0,0,0,149,149,149,149
Lassen,43,2022-10-11,1,1,1,0,566,567,566,1,0,0,0,0,63,63,63,63
Los Angeles,43,2022-10-11,6600,6612,6612,0,229477,229880,229877,3,403,68,68,56,33717,33717,33649,33649
Madera,43,2022-10-11,72,72,72,0,1737,1739,1738,1,8,0,0,1,375,375,375,375
Marin,43,2022-10-11,196,196,196,0,3744,3752,3751,1,11,0,0,0,315,315,315,315
Mariposa,43,2022-10-11,10,10,10,0,125,126,125,1,0,0,0,0,30,30,30,30
Mendocino,43,2022-10-11,38,38,38,0,937,938,937,1,3,0,0,1,136,136,136,136
Merced,43,2022-10-11,115,115,115,0,2756,2762,2761,1,10,1,1,3,871,871,870,870
Modoc,43,2022-10-11,3,3,3,0,10,11,10,1,0,0,0,0,9,9,9,9
Mono,43,2022-10-11,3,3,3,0,51,52,51,1,0,0,0,0,7,7,7,7
Monterey,43,2022-10-11,110,110,110,0,4260,4268,4267,1,11,0,0,1,771,771,771,771
Napa,43,2022-10-11,74,74,74,0,1714,1715,1714,1,4,0,0,2,159,159,159,159
Nevada,43,2022-10-11,39,39,39,0,957,958,957,1,1,0,0,1,136,136,136,136
Orange,43,2022-10-11,1494,1494,1494,0,29824,29875,29874,1,118,14,14,19,7570,7570,7556,7556
Placer,43,2022-10-11,192,192,192,0,3742,3750,3749,1,25,0,0,6,662,662,662,662
Plumas,43,2022-10-11,20,20,20,0,102,103,102,1,0,0,0,0,13,13,13,13
Riverside,43,2022-10-11,1178,1178,1178,0,23890,23932,23931,1,55,4,4,5,6652,6652,6648,6648
Sacramento,43,2022-10-11,937,937,937,0,20098,20133,20132,1,91,9,9,13,3361,3361,3352,3352
San Benito,43,2022-10-11,32,32,32,0,1216,1217,1216,1,4,1,1,0,102,102,101,101
San Bernardino,43,2022-10-11,1086,1086,1086,0,27418,27465,27464,1,70,0,0,10,8096,8096,8096,8096
San Diego,43,2022-10-11,1934,1935,1935,0,51336,51427,51426,1,125,8,8,20,5585,5585,5577,5577
San Francisco,43,2022-10-11,669,669,669,0,16119,16148,16147,1,40,1,1,10,1070,1070,1069,1069
San Joaquin,43,2022-10-11,427,427,427,0,11456,11475,11474,1,15,2,2,7,2343,2343,2341,2341
San Luis Obispo,43,2022-10-11,95,95,95,0,2527,2533,2532,1,1,1,1,0,528,528,527,527
San Mateo,43,2022-10-11,672,672,672,0,13847,13872,13871,1,21,0,0,1,738,738,738,738
Santa Barbara,43,2022-10-11,246,246,246,0,7674,7689,7688,1,13,1,1,2,732,732,731,731
Santa Clara,43,2022-10-11,1445,1445,1445,0,34632,34694,34693,1,117,3,3,15,2542,2542,2539,2539
Santa Cruz,43,2022-10-11,326,326,326,0,11738,11761,11760,1,10,0,0,1,273,273,273,273
Shasta,43,2022-10-11,108,108,108,0,1291,1292,1291,1,16,3,3,1,591,591,588,588
Siskiyou,43,2022-10-11,12,12,12,0,254,255,254,1,1,0,0,0,93,93,93,93
Solano,43,2022-10-11,322,322,322,0,6135,6146,6145,1,21,1,1,2,460,460,459,459
Sonoma,43,2022-10-11,281,281,281,0,6619,6632,6631,1,16,1,1,2,528,528,527,527
Stanislaus,43,2022-10-11,216,216,216,0,5929,5941,5940,1,50,7,7,6,1791,1791,1784,1784
Sutter,43,2022-10-11,65,65,65,0,1112,1113,1112,1,0,0,0,0,232,232,232,232
Tehama,43,2022-10-11,22,22,22,0,564,565,564,1,2,0,0,0,217,217,217,217
Trinity,43,2022-10-11,1,1,1,0,52,53,52,1,0,0,0,0,21,21,21,21
Tulare,43,2022-10-11,164,164,164,0,4950,4959,4958,1,9,1,1,1,1548,1548,1547,1547
Tuolumne,43,2022-10-11,39,39,39,0,667,668,667,1,0,1,1,0,201,201,200,200
Ventura,43,2022-10-11,439,439,439,0,11075,11095,11094,1,44,3,3,0,1598,1598,1595,1595
Yolo,43,2022-10-11,132,132,132,0,2972,2978,2977,1,5,3,3,0,404,404,401,401
Yuba,43,2022-10-11,26,26,26,0,899,900,899,1,2,0,0,0,122,122,122,122
Alameda,44,2022-10-18,944,944,944,0,24244,24289,24288,1,57,6,6,10,2059,2059,2053,2053
Amador,44,2022-10-18,16,16,16,0,579,580,579,1,1,0,0,0,93,93,93,93
Butte,44,2022-10-18,80,80,80,0,1401,1403,1402,1,13,0,0,0,466,466,466,466
Calaveras,44,2022-10-18,23,23,23,0,308,309,308,1,0,0,0,0,135,135,135,135
Colusa,44,2022-10-18,3,3,3,0,93,94,93,1,0,0,0,0,22,22,22,22
Contra Costa,44,2022-10-18,662,662,662,0,14380,14405,14404,1,27,5,5,4,1473,1473,1468,1468
Del Norte,44,2022-10-18,8,8,8,0,403,404,403,1,1,0,0,0,55,55,55,55
El Dorado,44,2022-10-18,87,87,87,0,1370,1373,1372,1,2,0,0,2,233,233,233,233
Fresno,44,2022-10-18,359,359,359,0,10512,10534,10533,1,58,1,1,7,2887,2887,2886,2886
Glenn,44,2022-10-18,8,8,8,0,143,144,143,1,1,0,0,0,53,53,53,53
Humboldt,44,2022-10-18,64,64,64,0,1147,1148,1147,1,2,0,0,1,162,162,162,162
Imperial,44,2022-10-18,117,117,117,0,2322,2328,2327,1,5,1,1,2,963,963,962,962
Inyo,44,2022-10-18,5,5,5,0,109,110,109,1,0,0,0,0,60,60,60,60
Kern,44,2022-10-18,241,241,241,0,9448,9465,9464,1,31,0,0,2,2432,2432,2432,2432
Kings,44,2022-10-18,72,72,72,0,2416,2422,2421,1,2,1,1,0,466,466,465,465
Lake,44,2022-10-18,24,24,24,0,749,750,749,1,1,1,1,0,150,150,149,149
Lassen,44,2022-10-18,9,9,9,0,515,516,515,1,1,0,0,0,63,63,63,63
Los Angeles,44,2022-10-18,5114,5123,5123,0,185754,186089,186087,2,328,42,42,51,33759,33759,33717,33717
Madera,44,2022-10-18,52,52,52,0,1383,1384,1383,1,3,0,0,2,375,375,375,375
Marin,44,2022-10-18,132,132,132,0,3214,3220,3219,1,10,0,0,0,315,315,315,315
Mariposa,44,2022-10-18,6,6,6,0,120,121,120,1,0,0,0,0,30,30,30,30
Mendocino,44,2022-10-18,41,41,41,0,766,767,766,1,0,0,0,0,136,136,136,136
Merced,44,2022-10-18,129,129,129,0,2364,2370,2369,1,14,0,0,3,871,871,871,871
Modoc,44,2022-10-18,1,1,1,0,9,10,9,1,0,0,0,0,9,9,9,9
Mono,44,2022-10-18,4,4,4,0,42,43,42,1,0,0,0,0,7,7,7,7
Monterey,44,2022-10-18,132,132,132,0,3630,3637,3636,1,15,1,1,1,772,772,771,771
Napa,44,2022-10-18,58,58,58,0,1430,1432,1431,1,4,0,0,0,159,159,159,159
Nevada,44,2022-10-18,50,50,50,0,810,811,810,1,5,0,0,1,136,136,136,136
Orange,44,2022-10-18,1117,1117,1117,0,25383,25429,25428,1,91,22,22,13,7592,7592,7570,7570
Placer,44,2022-10-18,154,154,154,0,2951,2958,2957,1,30,0,0,5,662,662,662,662
Plumas,44,2022-10-18,15,15,15,0,99,100,99,1,0,0,0,0,13,13,13,13
Riverside,44,2022-10-18,903,903,903,0,20393,20431,20430,1,75,2,2,8,6654,6654,6652,6652
Sacramento,44,2022-10-18,885,885,885,0,16134,16163,16162,1,89,8,8,16,3369,3369,3361,3361
San Benito,44,2022-10-18,36,36,36,0,922,923,922,1,1,0,0,0,102,102,102,102
San Bernardino,44,2022-10-18,822,822,822,0,22450,22490,22489,1,55,3,3,8,8099,8099,8096,8096
San Diego,44,2022-10-18,1689,1691,1691,0,43980,44059,44058,1,106,6,6,24,5591,5591,5585,5585
San Francisco,44,2022-10-18,563,563,563,0,14408,14434,14433,1,41,3,3,11,1073,1073,1070,1070
San Joaquin,44,2022-10-18,340,340,340,0,8951,8968,8967,1,16,2,2,7,2345,2345,2343,2343
San Luis Obispo,44,2022-10-18,101,101,101,0,2117,2123,2122,1,4,1,1,0,529,529,528,528
San Mateo,44,2022-10-18,529,529,529,0,11306,11328,11327,1,19,0,0,2,738,738,738,738
Santa Barbara,44,2022-10-18,157,157,157,0,5620,5632,5631,1,19,0,0,1,732,732,732,732
Santa Clara,44,2022-10-18,1181,1181,1181,0,28882,28935,28934,1,94,5,5,14,2547,2547,2542,2542
Santa Cruz,44,2022-10-18,298,298,298,0,10842,10863,10862,1,9,1,1,1,274,274,273,273
Shasta,44,2022-10-18,88,88,88,0,1066,1067,1066,1,17,0,0,1,591,591,591,591
Siskiyou,44,2022-10-18,12,12,12,0,183,184,183,1,2,1,1,0,94,94,93,93
Solano,44,2022-10-18,257,257,257,0,4861,4871,4870,1,22,0,0,3,460,460,460,460
Sonoma,44,2022-10-18,250,250,250,0,5429,5442,5441,1,24,1,1,2,529,529,528,528
Stanislaus,44,2022-10-18,210,210,210,0,5184,5195,5194,1,44,1,1,6,1792,1792,1791,1791
Sutter,44,2022-10-18,32,32,32,0,879,880,879,1,0,0,0,0,232,232,232,232
Tehama,44,2022-10-18,21,21,21,0,396,397,396,1,2,0,0,0,217,217,217,217
Trinity,44,2022-10-18,0,0,0,0,38,39,38,1,0,0,0,0,21,21,21,21
Tulare,44,2022-10-18,136,136,136,0,4331,4339,4338,1,12,1,1,1,1549,1549,1548,1548
Tuolumne,44,2022-10-18,36,36,36,0,620,621,620,1,1,0,0,0,201,201,201,201
Ventura,44,2022-10-18,347,347,347,0,9259,9276,9275,1,30,5,5,2,1603,1603,1598,1598
Yolo,44,2022-10-18,102,102,102,0,2193,2198,2197,1,4,1,1,1,405,405,404,404
Yuba,44,2022-10-18,44,44,44,0,771,772,771,1,1,0,0,0,122,122,122,122
Alameda,45,2022-10-25,965,965,965,0,23466,23512,23511,1,42,9,9,9,2068,2068,2059,2059
Amador,45,2022-10-25,16,16,16,0,624,625,624,1,1,0,0,0,93,93,93,93
Butte,45,2022-10-25,67,67,67,0,1421,1423,1422,1,9,1,1,1,467,467,466,466
Calaveras,45,2022-10-25,16,16,16,0,311,312,311,1,0,0,0,1,135,135,135,135
Colusa,45,2022-10-25,5,5,5,0,94,95,94,1,0,0,0,0,22,22,22,22
Contra Costa,45,2022-10-25,638,638,638,0,13853,13879,13878,1,43,6,6,7,1479,1479,1473,1473
Del Norte,45,2022-10-25,11,11,11,0,346,347,346,1,1,0,0,0,55,55,55,55
El Dorado,45,2022-10-25,91,91,91,0,1444,1446,1445,1,0,0,0,0,233,233,233,233
Fresno,45,2022-10-25,377,377,377,0,9664,9683,9682,1,62,0,0,7,2887,2887,2887,2887
Glenn,45,2022-10-25,7,7,7,0,144,145,144,1,0,0,0,0,53,53,53,53
Humboldt,45,2022-10-25,62,62,62,0,1105,1106,1105,1,6,0,0,3,162,162,162,162
Imperial,45,2022-10-25,99,99,99,0,2375,2381,2380,1,8,0,0,0,963,963,963,963
Inyo,45,2022-10-25,9,9,9,0,287,288,287,1,0,0,0,0,60,60,60,60
Kern,45,2022-10-25,285,285,285,0,9937,9957,9956,1,24,2,2,4,2434,2434,2432,2432
Kings,45,2022-10-25,95,95,95,0,2395,2401,2400,1,6,0,0,0,466,466,466,466
Lake,45,2022-10-25,24,24,24,0,640,641,640,1,1,0,0,2,150,150,150,150
Lassen,45,2022-10-25,14,14,14,0,485,486,485,1,1,0,0,0,63,63,63,63
Los Angeles,45,2022-10-25,5441,5451,5451,0,189782,190141,190139,2,328,57,57,40,33816,33816,33759,33759
Madera,45,2022-10-25,61,61,61,0,1503,1505,1504,1,4,0,0,2,375,375,375,375
Marin,45,2022-10-25,149,149,149,0,3070,3077,3076,1,9,2,2,2,317,317,315,315
Mariposa,45,2022-10-25,12,12,12,0,126,127,126,1,0,0,0,0,30,30,30,30
Mendocino,45,2022-10-25,40,40,40,0,743,744,743,1,3,0,0,0,136,136,136,136
Merced,45,2022-10-25,83,83,83,0,2402,2408,2407,1,9,3,3,2,874,874,871,871
Modoc,45,2022-10-25,2,2,2,0,12,13,12,1,0,0,0,0,9,9,9,9
Mono,45,2022-10-25,3,3,3,0,66,67,66,1,0,1,1,0,8,8,7,7
Monterey,45,2022-10-25,129,129,129,0,3700,3708,3707,1,13,0,0,0,772,772,772,772
Napa,45,2022-10-25,46,46,46,0,1465,1467,1466,1,5,0,0,0,159,159,159,159
Nevada,45,2022-10-25,41,41,41,0,776,777,776,1,6,0,0,0,136,136,136,136
Orange,45,2022-10-25,1171,1171,1171,0,26394,26444,26443,1,91,13,13,17,7605,7605,7592,7592
Placer,45,2022-10-25,192,192,192,0,2974,2982,2981,1,44,0,0,3,662,662,662,662
Plumas,45,2022-10-25,8,8,8,0,96,97,96,1,0,0,0,0,13,13,13,13
Riverside,45,2022-10-25,913,913,913,0,20177,20215,20214,1,48,1,1,8,6655,6655,6654,6654
Sacramento,45,2022-10-25,797,797,797,0,15144,15173,15172,1,86,7,7,16,3376,3376,3369,3369
San Benito,45,2022-10-25,35,35,35,0,822,823,822,1,0,0,0,2,102,102,102,102
San Bernardino,45,2022-10-25,839,839,839,0,22268,22311,22310,1,42,1,1,12,8100,8100,8099,8099
San Diego,45,2022-10-25,1656,1659,1659,0,42250,42331,42330,1,90,5,5,21,5596,5596,5591,5591
San Francisco,45,2022-10-25,533,533,533,0,13987,14014,14013,1,37,1,1,7,1074,1074,1073,1073
San Joaquin,45,2022-10-25,280,280,280,0,8715,8733,8732,1,16,2,2,3,2347,2347,2345,2345
San Luis Obispo,45,2022-10-25,86,86,86,0,2074,2080,2079,1,3,1,1,0,530,530,529,529
San Mateo,45,2022-10-25,471,471,471,0,11275,11297,11296,1,23,0,0,2,738,738,738,738
Santa Barbara,45,2022-10-25,167,167,167,0,5805,5817,5816,1,19,2,2,4,734,734,732,732
Santa Clara,45,2022-10-25,1200,1200,1200,0,29447,29503,29502,1,85,3,3,7,2550,2550,2547,2547
Santa Cruz,45,2022-10-25,214,214,214,0,10295,10314,10313,1,14,1,1,0,275,275,274,274
Shasta,45,2022-10-25,69,69,69,0,976,977,976,1,7,0,0,2,591,591,591,591
Siskiyou,45,2022-10-25,11,11,11,0,171,172,171,1,2,0,0,1,94,94,94,94
Solano,45,2022-10-25,249,249,249,0,5149,5160,5159,1,16,0,0,2,460,460,460,460
Sonoma,45,2022-10-25,233,233,233,0,5475,5487,5486,1,31,0,0,1,529,529,529,529
Stanislaus,45,2022-10-25,196,196,196,0,4853,4863,4862,1,43,3,3,5,1795,1795,1792,1792
Sutter,45,2022-10-25,32,32,32,0,886,887,886,1,0,0,0,0,232,232,232,232
Tehama,45,2022-10-25,34,34,34,0,408,409,408,1,1,0,0,0,217,217,217,217
Trinity,45,2022-10-25,2,2,2,0,36,37,36,1,0,0,0,0,21,21,21,21
Tulare,45,2022-10-25,113,113,113,0,4163,4171,4170,1,12,1,1,0,1550,1550,1549,1549
Tuolumne,45,2022-10-25,29,29,29,0,620,621,620,1,1,1,1,0,202,202,201,201
Ventura,45,2022-10-25,301,301,301,0,9197,9214,9213,1,37,1,1,4,1604,1604,1603,1603
Yolo,45,2022-10-25,79,79,79,0,1976,1981,1980,1,5,1,1,0,406,406,405,405
Yuba,45,2022-10-25,54,54,54,0,799,800,799,1,5,0,0,1,122,122,122,122
Alameda,46,2022-11-01,1120,1120,1120,0,23127,23173,23172,1,52,3,3,3,2071,2071,2068,2068
Amador,46,2022-11-01,17,17,17,0,641,642,641,1,2,1,1,0,94,94,93,93
Butte,46,2022-11-01,86,86,86,0,1453,1455,1454,1,8,0,0,1,467,467,467,467
Calaveras,46,2022-11-01,15,15,15,0,275,276,275,1,0,0,0,0,135,135,135,135
Colusa,46,2022-11-01,9,9,9,0,104,105,104,1,0,0,0,0,22,22,22,22
Contra Costa,46,2022-11-01,774,774,774,0,14187,14214,14213,1,33,4,4,6,1483,1483,1479,1479
Del Norte,46,2022-11-01,14,14,14,0,373,374,373,1,2,0,0,0,55,55,55,55
El Dorado,46,2022-11-01,104,104,104,0,1415,1417,1416,1,2,0,0,0,233,233,233,233
Fresno,46,2022-11-01,473,473,473,0,10541,10562,10561,1,60,4,4,10,2891,2891,2887,2887
Glenn,46,2022-11-01,16,16,16,0,157,158,157,1,1,0,0,0,53,53,53,53
Humboldt,46,2022-11-01,50,50,50,0,987,988,987,1,4,0,0,2,162,162,162,162
Imperial,46,2022-11-01,140,140,140,0,2984,2991,2990,1,8,0,0,0,963,963,963,963
Inyo,46,2022-11-01,11,11,11,0,262,263,262,1,0,0,0,0,60,60,60,60
Kern,46,2022-11-01,391,391,391,0,10063,10085,10084,1,25,3,3,2,2437,2437,2434,2434
Kings,46,2022-11-01,123,123,123,0,2402,2408,2407,1,4,0,0,1,466,466,466,466
Lake,46,2022-11-01,40,40,40,0,775,776,775,1,0,0,0,1,150,150,150,150
Lassen,46,2022-11-01,20,20,20,0,510,511,510,1,0,0,0,0,63,63,63,63
Los Angeles,46,2022-11-01,6463,6477,6477,0,191400,191781,191779,2,384,33,33,48,33849,33849,33816,33816
Madera,46,2022-11-01,62,62,62,0,1402,1404,1403,1,5,0,0,1,375,375,375,375
Marin,46,2022-11-01,132,132,132,0,3549,3556,3555,1,13,0,0,0,317,317,317,317
Mariposa,46,2022-11-01,9,9,9,0,124,125,124,1,0,0,0,0,30,30,30,30
Mendocino,46,2022-11-01,27,27,27,0,721,722,721,1,1,0,0,2,136,136,136,136
Merced,46,2022-11-01,119,119,119,0,2183,2189,2188,1,5,3,3,0,877,877,874,874
Modoc,46,2022-11-01,1,1,1,0,11,12,11,1,0,0,0,0,9,9,9,9
Mono,46,2022-11-01,1,1,1,0,95,96,95,1,1,0,0,0,8,8,8,8
Monterey,46,2022-11-01,163,163,163,0,3621,3630,3629,1,17,2,2,0,774,774,772,772
Napa,46,2022-11-01,64,64,64,0,1610,1613,1612,1,1,0,0,1,159,159,159,159
Nevada,46,2022-11-01,33,33,33,0,740,741,740,1,6,0,0,0,136,136,136,136
Orange,46,2022-11-01,1196,1196,1196,0,27747,27803,27802,1,106,12,12,19,7617,7617,7605,7605
Placer,46,2022-11-01,139,139,139,0,2802,2809,2808,1,37,1,1,5,663,663,662,662
Plumas,46,2022-11-01,5,5,5,0,73,74,73,1,1,0,0,0,13,13,13,13
Riverside,46,2022-11-01,1139,1139,1139,0,20150,20190,20189,1,63,4,4,5,6659,6659,6655,6655
Sacramento,46,2022-11-01,787,787,787,0,14125,14154,14153,1,71,5,5,13,3381,3381,3376,3376
San Benito,46,2022-11-01,33,33,33,0,777,778,777,1,1,0,0,0,102,102,102,102
San Bernardino,46,2022-11-01,1121,1122,1122,0,22675,22722,22721,1,64,3,3,12,8103,8103,8100,8100
San Diego,46,2022-11-01,1831,1835,1835,0,42615,42699,42698,1,105,5,5,12,5601,5601,5596,5596
San Francisco,46,2022-11-01,623,623,623,0,14539,14569,14568,1,53,3,3,6,1077,1077,1074,1074
San Joaquin,46,2022-11-01,353,353,353,0,8561,8579,8578,1,25,6,6,3,2353,2353,2347,2347
San Luis Obispo,46,2022-11-01,94,94,94,0,2062,2068,2067,1,1,0,0,0,530,530,530,530
San Mateo,46,2022-11-01,561,561,561,0,11547,11572,11571,1,33,0,0,4,738,738,738,738
Santa Barbara,46,2022-11-01,196,196,196,0,5954,5967,5966,1,18,2,2,5,736,736,734,734
Santa Clara,46,2022-11-01,1346,1347,1347,0,30532,30594,30593,1,86,4,4,12,2554,2554,2550,2550
Santa Cruz,46,2022-11-01,206,206,206,0,9580,9600,9599,1,4,0,0,0,275,275,275,275
Shasta,46,2022-11-01,74,74,74,0,848,849,848,1,6,2,2,1,593,593,591,591
Siskiyou,46,2022-11-01,19,19,19,0,218,219,218,1,1,1,1,0,95,95,94,94
Solano,46,2022-11-01,318,318,318,0,5367,5378,5377,1,12,0,0,5,460,460,460,460
Sonoma,46,2022-11-01,215,215,215,0,5678,5691,5690,1,23,1,1,4,530,530,529,529
Stanislaus,46,2022-11-01,259,259,259,0,4758,4769,4768,1,43,2,2,10,1797,1797,1795,1795
Sutter,46,2022-11-01,65,65,65,0,928,929,928,1,0,0,0,0,232,232,232,232
Tehama,46,2022-11-01,34,34,34,0,396,397,396,1,2,0,0,0,217,217,217,217
Trinity,46,2022-11-01,18,18,18,0,70,71,70,1,5,0,0,0,21,21,21,21
Tulare,46,2022-11-01,149,149,149,0,3748,3756,3755,1,11,0,0,0,1550,1550,1550,1550
Tuolumne,46,2022-11-01,59,59,59,0,553,554,553,1,3,0,0,0,202,202,202,202
Ventura,46,2022-11-01,404,404,404,0,9541,9562,9561,1,25,2,2,4,1606,1606,1604,1604
Yolo,46,2022-11-01,140,140,140,0,2012,2017,2016,1,0,0,0,2,406,406,406,406
Yuba,46,2022-11-01,45,45,45,0,794,795,794,1,1,0,0,0,122,122,122,122
Alameda,47,2022-11-08,1359,1360,1360,0,24473,24524,24523,1,50,8,8,11,2079,2079,2071,2071
Amador,47,2022-11-08,35,35,35,0,622,623,622,1,3,0,0,0,94,94,94,94
Butte,47,2022-11-08,116,116,116,0,1424,1427,1426,1,14,0,0,2,467,467,467,467
Calaveras,47,2022-11-08,20,20,20,0,330,331,330,1,1,0,0,0,135,135,135,135
Colusa,47,2022-11-08,3,3,3,0,99,100,99,1,0,0,0,0,22,22,22,22
Contra Costa,47,2022-11-08,880,880,880,0,15897,15932,15931,1,38,3,3,4,1486,1486,1483,1483
Del Norte,47,2022-11-08,11,11,11,0,406,407,406,1,1,0,0,0,55,55,55,55
El Dorado,47,2022-11-08,107,107,107,0,1618,1622,1621,1,7,2,2,0,235,235,233,233
Fresno,47,2022-11-08,610,610,610,0,10731,10754,10753,1,63,3,3,10,2894,2894,2891,2891
Glenn,47,2022-11-08,30,30,30,0,131,132,131,1,1,0,0,0,53,53,53,53
Humboldt,47,2022-11-08,89,89,89,0,1038,1039,1038,1,7,0,0,2,162,162,162,162
Imperial,47,2022-11-08,213,213,213,0,3681,3689,3688,1,8,0,0,3,963,963,963,963
Inyo,47,2022-11-08,15,15,15,0,356,357,356,1,0,0,0,0,60,60,60,60
Kern,47,2022-11-08,437,437,437,0,10754,10779,10778,1,34,0,0,6,2437,2437,2437,2437
Kings,47,2022-11-08,147,147,147,0,2504,2510,2509,1,5,1,1,1,467,467,466,466
Lake,47,2022-11-08,44,44,44,0,797,798,797,1,3,0,0,1,150,150,150,150
Lassen,47,2022-11-08,13,13,13,0,469,470,469,1,0,0,0,0,63,63,63,63
Los Angeles,47,2022-11-08,8249,8266,8266,0,190615,191013,191011,2,449,54,54,43,33903,33903,33849,33849
Madera,47,2022-11-08,73,73,73,0,1632,1636,1635,1,6,0,0,4,375,375,375,375
Marin,47,2022-11-08,155,155,155,0,3452,3461,3460,1,9,0,0,0,317,317,317,317
Mariposa,47,2022-11-08,16,16,16,0,118,119,118,1,0,0,0,0,30,30,30,30
Mendocino,47,2022-11-08,32,32,32,0,794,795,794,1,4,1,1,0,137,137,136,136
Merced,47,2022-11-08,159,159,159,0,2554,2560,2559,1,7,2,2,1,879,879,877,877
Modoc,47,2022-11-08,1,1,1,0,8,9,8,1,0,0,0,0,9,9,9,9
Mono,47,2022-11-08,5,5,5,0,96,97,96,1,0,0,0,0,8,8,8,8
Monterey,47,2022-11-08,212,212,212,0,3916,3925,3924,1,20,1,1,0,775,775,774,774
Napa,47,2022-11-08,83,83,83,0,1752,1757,1756,1,9,0,0,0,159,159,159,159
Nevada,47,2022-11-08,63,63,63,0,756,757,756,1,5,0,0,2,136,136,136,136
Orange,47,2022-11-08,1330,1331,1331,0,27736,27793,27792,1,95,12,12,20,7629,7629,7617,7617
Placer,47,2022-11-08,255,255,255,0,3500,3509,3508,1,55,1,1,8,664,664,663,663
Plumas,47,2022-11-08,4,4,4,0,71,72,71,1,0,0,0,0,13,13,13,13
Riverside,47,2022-11-08,1544,1546,1546,0,21400,21445,21444,1,71,2,2,8,6661,6661,6659,6659
Sacramento,47,2022-11-08,1151,1151,1151,0,16282,16315,16314,1,88,9,9,9,3390,3390,3381,3381
San Benito,47,2022-11-08,45,45,45,0,904,905,904,1,1,0,0,0,102,102,102,102
San Bernardino,47,2022-11-08,1494,1496,1496,0,23864,23914,23913,1,91,1,1,12,8104,8104,8103,8103
San Diego,47,2022-11-08,2191,2196,2196,0,45335,45430,45429,1,116,8,8,24,5609,5609,5601,5601
San Francisco,47,2022-11-08,714,714,714,0,14881,14912,14911,1,47,2,2,6,1079,1079,1077,1077
San Joaquin,47,2022-11-08,488,488,488,0,8819,8840,8839,1,24,2,2,4,2355,2355,2353,2353
San Luis Obispo,47,2022-11-08,127,127,127,0,2208,2214,2213,1,4,0,0,2,530,530,530,530
San Mateo,47,2022-11-08,575,575,575,0,12274,12301,12300,1,30,0,0,2,738,738,738,738
Santa Barbara,47,2022-11-08,208,208,208,0,6565,6579,6578,1,23,1,1,0,737,737,736,736
Santa Clara,47,2022-11-08,1661,1665,1665,0,31342,31410,31409,1,83,7,7,18,2561,2561,2554,2554
Santa Cruz,47,2022-11-08,290,290,290,0,11577,11603,11602,1,7,1,1,0,276,276,275,275
Shasta,47,2022-11-08,89,89,89,0,1048,1050,1049,1,9,1,1,2,594,594,593,593
Siskiyou,47,2022-11-08,19,19,19,0,321,322,321,1,1,0,0,0,95,95,95,95
Solano,47,2022-11-08,411,411,411,0,5370,5382,5381,1,23,2,2,4,462,462,460,460
Sonoma,47,2022-11-08,248,248,248,0,5934,5947,5946,1,13,1,1,1,531,531,530,530
Stanislaus,47,2022-11-08,287,287,287,0,4920,4932,4931,1,40,1,1,12,1798,1798,1797,1797
Sutter,47,2022-11-08,89,89,89,0,1021,1023,1022,1,0,0,0,0,232,232,232,232
Tehama,47,2022-11-08,42,42,42,0,493,494,493,1,3,0,0,0,217,217,217,217
Trinity,47,2022-11-08,1,1,1,0,41,42,41,1,0,0,0,0,21,21,21,21
Tulare,47,2022-11-08,172,172,172,0,4376,4386,4385,1,14,0,0,0,1550,1550,1550,1550
Tuolumne,47,2022-11-08,59,59,59,0,680,681,680,1,3,0,0,0,202,202,202,202
Ventura,47,2022-11-08,454,454,454,0,10360,10383,10382,1,37,2,2,1,1608,1608,1606,1606
Yolo,47,2022-11-08,137,137,137,0,2210,2216,2215,1,4,4,4,0,410,410,406,406
Yuba,47,2022-11-08,47,47,47,0,937,938,937,1,4,0,0,2,122,122,122,122
Alameda,48,2022-11-15,1546,1549,1549,0,24977,25033,25032,1,68,5,5,10,2084,2084,2079,2079
Amador,48,2022-11-15,16,16,16,0,714,716,715,1,3,0,0,0,94,94,94,94
Butte,48,2022-11-15,129,129,129,0,1327,1331,1330,1,22,0,0,0,467,467,467,467
Calaveras,48,2022-11-15,30,30,30,0,363,364,363,1,0,0,0,0,135,135,135,135
Colusa,48,2022-11-15,10,10,10,0,94,95,94,1,1,0,0,0,22,22,22,22
Contra Costa,48,2022-11-15,974,974,974,0,16154,16189,16188,1,46,1,1,6,1487,1487,1486,1486
Del Norte,48,2022-11-15,17,17,17,0,437,438,437,1,1,0,0,0,55,55,55,55
El Dorado,48,2022-11-15,148,148,148,0,1630,1635,1634,1,6,0,0,1,235,235,235,235
Fresno,48,2022-11-15,798,798,798,0,11414,11440,11439,1,73,9,9,13,2903,2903,2894,2894
Glenn,48,2022-11-15,20,20,20,0,174,175,174,1,0,0,0,0,53,53,53,53
Humboldt,48,2022-11-15,90,90,90,0,1091,1092,1091,1,6,1,1,0,163,163,162,162
Imperial,48,2022-11-15,261,261,261,0,3286,3294,3293,1,0,0,0,6,963,963,963,963
Inyo,48,2022-11-15,12,12,12,0,460,461,460,1,0,0,0,0,60,60,60,60
Kern,48,2022-11-15,483,483,483,0,10710,10735,10734,1,47,2,2,4,2439,2439,2437,2437
Kings,48,2022-11-15,253,253,253,0,2750,2757,2756,1,7,2,2,0,469,469,467,467
Lake,48,2022-11-15,53,53,53,0,843,844,843,1,2,0,0,0,150,150,150,150
Lassen,48,2022-11-15,45,45,45,0,598,599,598,1,0,1,1,0,64,64,63,63
Los Angeles,48,2022-11-15,9837,9858,9858,0,201346,201787,201785,2,514,56,56,75,33959,33959,33903,33903
Madera,48,2022-11-15,104,104,104,0,1751,1756,1755,1,7,0,0,2,375,375,375,375
Marin,48,2022-11-15,178,178,178,0,3427,3435,3434,1,8,0,0,0,317,317,317,317
Mariposa,48,2022-11-15,13,13,13,0,150,151,150,1,0,0,0,0,30,30,30,30
Mendocino,48,2022-11-15,46,46,46,0,1004,1005,1004,1,3,0,0,1,137,137,137,137
Merced,48,2022-11-15,179,179,179,0,2741,2747,2746,1,5,0,0,1,879,879,879,879
Modoc,48,2022-11-15,3,3,3,0,12,13,12,1,1,0,0,0,9,9,9,9
Mono,48,2022-11-15,8,8,8,0,124,125,124,1,0,0,0,0,8,8,8,8
Monterey,48,2022-11-15,208,208,208,0,4315,4327,4326,1,19,2,2,1,777,777,775,775
Napa,48,2022-11-15,108,108,108,0,1891,1897,1896,1,8,0,0,0,159,159,159,159
Nevada,48,2022-11-15,68,68,68,0,837,839,838,1,3,0,0,2,136,136,136,136
Orange,48,2022-11-15,1682,1686,1686,0,27457,27516,27515,1,111,8,8,24,7637,7637,7629,7629
Placer,48,2022-11-15,338,338,338,0,3933,3942,3941,1,55,1,1,8,665,665,664,664
Plumas,48,2022-11-15,4,4,4,0,86,87,86,1,1,0,0,0,13,13,13,13
Riverside,48,2022-11-15,1742,1746,1746,0,23124,23175,23174,1,96,4,4,8,6665,6665,6661,6661
Sacramento,48,2022-11-15,1282,1284,1284,0,17551,17590,17589,1,81,7,7,11,3397,3397,3390,3390
San Benito,48,2022-11-15,43,43,43,0,1027,1029,1028,1,0,0,0,0,102,102,102,102
San Bernardino,48,2022-11-15,1933,1937,1937,0,25000,25054,25053,1,85,0,0,15,8104,8104,8104,8104
San Diego,48,2022-11-15,2677,2684,2684,0,44888,44987,44986,1,138,7,7,23,5616,5616,5609,5609
San Francisco,48,2022-11-15,759,759,759,0,13837,13868,13867,1,48,8,8,7,1087,1087,1079,1079
San Joaquin,48,2022-11-15,642,642,642,0,9841,9864,9863,1,19,1,1,6,2356,2356,2355,2355
San Luis Obispo,48,2022-11-15,128,128,128,0,2248,2253,2252,1,8,0,0,0,530,530,530,530
San Mateo,48,2022-11-15,709,709,709,0,11402,11428,11427,1,29,0,0,2,738,738,738,738
Santa Barbara,48,2022-11-15,230,230,230,0,6103,6118,6117,1,17,1,1,4,738,738,737,737
Santa Clara,48,2022-11-15,1856,1861,1861,0,31446,31516,31515,1,117,3,3,13,2564,2564,2561,2561
Santa Cruz,48,2022-11-15,256,256,256,0,9734,9756,9755,1,10,0,0,0,276,276,276,276
Shasta,48,2022-11-15,118,118,118,0,1136,1139,1138,1,10,1,1,2,595,595,594,594
Siskiyou,48,2022-11-15,22,22,22,0,403,404,403,1,2,0,0,0,95,95,95,95
Solano,48,2022-11-15,425,425,425,0,5534,5547,5546,1,25,0,0,4,462,462,462,462
Sonoma,48,2022-11-15,289,289,289,0,6112,6126,6125,1,27,1,1,1,532,532,531,531
Stanislaus,48,2022-11-15,346,346,346,0,5387,5400,5399,1,44,0,0,12,1798,1798,1798,1798
Sutter,48,2022-11-15,99,99,99,0,1177,1179,1178,1,0,0,0,0,232,232,232,232
Tehama,48,2022-11-15,57,57,57,0,604,605,604,1,2,0,0,0,217,217,217,217
Trinity,48,2022-11-15,12,12,12,0,48,49,48,1,0,1,1,0,22,22,21,21
Tulare,48,2022-11-15,365,365,365,0,4534,4544,4543,1,17,0,0,0,1550,1550,1550,1550
Tuolumne,48,2022-11-15,84,84,84,0,711,712,711,1,0,0,0,0,202,202,202,202
Ventura,48,2022-11-15,600,600,600,0,10787,10812,10811,1,30,1,1,2,1609,1609,1608,1608
Yolo,48,2022-11-15,135,135,135,0,2149,2155,2154,1,3,5,5,1,415,415,410,410
Yuba,48,2022-11-15,61,61,61,0,985,986,985,1,4,0,0,1,122,122,122,122
Alameda,49,2022-11-22,1748,1753,1753,0,24912,24970,24969,1,75,7,7,15,2091,2091,2084,2084
Amador,49,2022-11-22,33,33,33,0,797,798,797,1,0,0,0,1,94,94,94,94
Butte,49,2022-11-22,152,152,152,0,1380,1383,1382,1,28,0,0,1,467,467,467,467
Calaveras,49,2022-11-22,39,39,39,0,430,431,430,1,1,0,0,0,135,135,135,135
Colusa,49,2022-11-22,11,11,11,0,113,114,113,1,0,0,0,0,22,22,22,22
Contra Costa,49,2022-11-22,1056,1056,1056,0,15998,16036,16035,1,47,3,3,6,1490,1490,1487,1487
Del Norte,49,2022-11-22,19,19,19,0,471,472,471,1,1,0,0,1,55,55,55,55
El Dorado,49,2022-11-22,192,192,192,0,1801,1807,1806,1,13,0,0,0,235,235,235,235
Fresno,49,2022-11-22,1095,1095,1095,0,12122,12150,12149,1,116,6,6,11,2909,2909,2903,2903
Glenn,49,2022-11-22,22,22,22,0,212,213,212,1,0,0,0,0,53,53,53,53
Humboldt,49,2022-11-22,121,121,121,0,1192,1195,1194,1,4,0,0,1,163,163,163,163
Imperial,49,2022-11-22,285,285,285,0,2930,2936,2935,1,0,2,2,7,965,965,963,963
Inyo,49,2022-11-22,33,33,33,0,435,436,435,1,0,1,1,0,61,61,60,60
Kern,49,2022-11-22,532,532,532,0,10301,10325,10324,1,51,2,2,9,2441,2441,2439,2439
Kings,49,2022-11-22,254,254,254,0,2651,2657,2656,1,4,2,2,1,471,471,469,469
Lake,49,2022-11-22,57,57,57,0,944,945,944,1,1,1,1,1,151,151,150,150
Lassen,49,2022-11-22,24,24,24,0,487,488,487,1,0,0,0,0,64,64,64,64
Los Angeles,49,2022-11-22,14080,14111,14111,0,193850,194294,194292,2,693,67,67,101,34026,34026,33959,33959
Madera,49,2022-11-22,169,169,169,0,1796,1802,1801,1,8,0,0,1,375,375,375,375
Marin,49,2022-11-22,195,195,195,0,3364,3372,3371,1,8,0,0,1,317,317,317,317
Mariposa,49,2022-11-22,26,26,26,0,170,171,170,1,0,0,0,0,30,30,30,30
Mendocino,49,2022-11-22,37,37,37,0,819,820,819,1,3,0,0,1,137,137,137,137
Merced,49,2022-11-22,282,282,282,0,2825,2831,2830,1,11,2,2,3,881,881,879,879
Modoc,49,2022-11-22,10,10,10,0,11,12,11,1,2,0,0,0,9,9,9,9
Mono,49,2022-11-22,3,3,3,0,110,111,110,1,0,0,0,0,8,8,8,8
Monterey,49,2022-11-22,230,230,230,0,4333,4344,4343,1,21,0,0,0,777,777,777,777
Napa,49,2022-11-22,145,145,145,0,2198,2204,2203,1,3,0,0,1,159,159,159,159
Nevada,49,2022-11-22,105,105,105,0,1000,1002,1001,1,4,0,0,1,136,136,136,136
Orange,49,2022-11-22,2422,2429,2429,0,28481,28547,28546,1,171,16,16,32,7653,7653,7637,7637
Placer,49,2022-11-22,357,357,357,0,4020,4029,4028,1,64,0,0,7,665,665,665,665
Plumas,49,2022-11-22,7,7,7,0,115,116,115,1,0,0,0,0,13,13,13,13
Riverside,49,2022-11-22,2284,2291,2291,0,24513,24569,24568,1,123,8,8,15,6673,6673,6665,6665
Sacramento,49,2022-11-22,1607,1612,1612,0,19282,19325,19324,1,105,2,2,16,3399,3399,3397,3397
San Benito,49,2022-11-22,67,67,67,0,1131,1133,1132,1,2,0,0,0,102,102,102,102
San Bernardino,49,2022-11-22,2508,2515,2515,0,26759,26821,26820,1,94,1,1,21,8105,8105,8104,8104
San Diego,49,2022-11-22,3184,3192,3192,0,41349,41445,41444,1,185,4,4,20,5620,5620,5616,5616
San Francisco,49,2022-11-22,982,982,982,0,15314,15348,15347,1,59,6,6,8,1093,1093,1087,1087
San Joaquin,49,2022-11-22,778,778,778,0,11091,11116,11115,1,34,0,0,5,2356,2356,2356,2356
San Luis Obispo,49,2022-11-22,168,168,168,0,2387,2393,2392,1,3,1,1,0,531,531,530,530
San Mateo,49,2022-11-22,744,744,744,0,12283,12311,12310,1,32,0,0,1,738,738,738,738
Santa Barbara,49,2022-11-22,337,337,337,0,5856,5871,5870,1,19,2,2,4,740,740,738,738
Santa Clara,49,2022-11-22,2283,2290,2290,0,34119,34197,34196,1,123,9,9,22,2573,2573,2564,2564
Santa Cruz,49,2022-11-22,275,275,275,0,8761,8782,8781,1,19,0,0,1,276,276,276,276
Shasta,49,2022-11-22,94,94,94,0,1019,1021,1020,1,17,3,3,2,598,598,595,595
Siskiyou,49,2022-11-22,26,26,26,0,319,320,319,1,0,0,0,0,95,95,95,95
Solano,49,2022-11-22,521,521,521,0,5624,5637,5636,1,32,1,1,9,463,463,462,462
Sonoma,49,2022-11-22,349,349,349,0,5610,5623,5622,1,24,0,0,4,532,532,532,532
Stanislaus,49,2022-11-22,466,466,466,0,6069,6083,6082,1,62,1,1,8,1799,1799,1798,1798
Sutter,49,2022-11-22,85,85,85,0,1100,1102,1101,1,0,0,0,0,232,232,232,232
Tehama,49,2022-11-22,69,69,69,0,660,661,660,1,2,0,0,2,217,217,217,217
Trinity,49,2022-11-22,5,5,5,0,54,55,54,1,0,0,0,0,22,22,22,22
Tulare,49,2022-11-22,419,419,419,0,5415,5429,5428,1,18,0,0,1,1550,1550,1550,1550
Tuolumne,49,2022-11-22,84,84,84,0,729,730,729,1,2,1,1,0,203,203,202,202
Ventura,49,2022-11-22,759,759,759,0,10680,10705,10704,1,40,1,1,2,1610,1610,1609,1609
Yolo,49,2022-11-22,146,146,146,0,2220,2226,2225,1,5,4,4,2,419,419,415,415
Yuba,49,2022-11-22,81,81,81,0,1008,1009,1008,1,3,0,0,1,122,122,122,122
Alameda,50,2022-11-29,2446,2452,2452,0,23575,23631,23630,1,108,6,6,14,2097,2097,2091,2091
Amador,50,2022-11-29,35,35,35,0,815,817,816,1,4,1,1,1,95,95,94,94
Butte,50,2022-11-29,209,209,209,0,1622,1626,1625,1,37,1,1,2,468,468,467,467
Calaveras,50,2022-11-29,36,36,36,0,388,389,388,1,1,0,0,1,135,135,135,135
Colusa,50,2022-11-29,17,17,17,0,191,192,191,1,5,0,0,0,22,22,22,22
Contra Costa,50,2022-11-29,1596,1600,1600,0,16784,16825,16824,1,64,4,4,5,1494,1494,1490,1490
Del Norte,50,2022-11-29,40,40,40,0,493,494,493,1,1,1,1,0,56,56,55,55
El Dorado,50,2022-11-29,190,190,190,0,1612,1616,1615,1,12,1,1,2,236,236,235,235
Fresno,50,2022-11-29,1426,1428,1428,0,12428,12459,12458,1,152,5,5,21,2914,2914,2909,2909
Glenn,50,2022-11-29,18,18,18,0,191,192,191,1,2,0,0,0,53,53,53,53
Humboldt,50,2022-11-29,114,114,114,0,1033,1035,1034,1,13,0,0,0,163,163,163,163
Imperial,50,2022-11-29,470,470,470,0,3029,3037,3036,1,0,0,0,6,965,965,965,965
Inyo,50,2022-11-29,35,35,35,0,350,351,350,1,0,1,1,0,62,62,61,61
Kern,50,2022-11-29,659,659,659,0,9658,9683,9682,1,65,5,5,5,2446,2446,2441,2441
Kings,50,2022-11-29,276,276,276,0,2731,2739,2738,1,12,0,0,0,471,471,471,471
Lake,50,2022-11-29,53,53,53,0,816,817,816,1,0,0,0,0,151,151,151,151
Lassen,50,2022-11-29,24,24,24,0,499,500,499,1,0,0,0,0,64,64,64,64
Los Angeles,50,2022-11-29,20679,20730,20730,0,201214,201703,201701,2,1010,96,96,122,34122,34122,34026,34026
Madera,50,2022-11-29,175,175,175,0,1732,1737,1736,1,10,0,0,2,375,375,375,375
Marin,50,2022-11-29,294,294,294,0,3081,3090,3089,1,22,0,0,0,317,317,317,317
Mariposa,50,2022-11-29,18,18,18,0,132,133,132,1,0,0,0,0,30,30,30,30
Mendocino,50,2022-11-29,48,48,48,0,740,741,740,1,8,0,0,0,137,137,137,137
Merced,50,2022-11-29,370,370,370,0,2734,2742,2741,1,19,6,6,2,887,887,881,881
Modoc,50,2022-11-29,5,5,5,0,11,12,11,1,2,0,0,0,9,9,9,9
Mono,50,2022-11-29,4,4,4,0,89,90,89,1,0,0,0,0,8,8,8,8
Monterey,50,2022-11-29,295,295,295,0,3920,3931,3930,1,28,1,1,0,778,778,777,777
Napa,50,2022-11-29,148,148,148,0,1795,1801,1800,1,8,0,0,3,159,159,159,159
Nevada,50,2022-11-29,123,123,123,0,1061,1064,1063,1,11,0,0,0,136,136,136,136
Orange,50,2022-11-29,3570,3578,3578,0,28412,28480,28479,1,246,15,15,32,7668,7668,7653,7653
Placer,50,2022-11-29,383,383,383,0,3815,3825,3824,1,77,3,3,6,668,668,665,665
Plumas,50,2022-11-29,8,8,8,0,148,149,148,1,0,0,0,0,13,13,13,13
Riverside,50,2022-11-29,3459,3467,3467,0,23726,23783,23782,1,192,12,12,23,6685,6685,6673,6673
Sacramento,50,2022-11-29,1908,1913,1913,0,18485,18531,18530,1,120,11,11,17,3410,3410,3399,3399
San Benito,50,2022-11-29,165,165,165,0,1302,1306,1305,1,4,0,0,0,102,102,102,102
San Bernardino,50,2022-11-29,3564,3572,3572,0,26256,26319,26318,1,155,1,1,21,8106,8106,8105,8105
San Diego,50,2022-11-29,4554,4564,4564,0,34610,34696,34695,1,268,7,7,30,5627,5627,5620,5620
San Francisco,50,2022-11-29,1253,1255,1255,0,12956,12987,12986,1,74,5,5,5,1098,1098,1093,1093
San Joaquin,50,2022-11-29,1054,1055,1055,0,11279,11308,11307,1,55,5,5,6,2361,2361,2356,2356
San Luis Obispo,50,2022-11-29,185,185,185,0,2239,2246,2245,1,14,3,3,0,534,534,531,531
San Mateo,50,2022-11-29,1231,1233,1233,0,11615,11644,11643,1,35,1,1,6,739,739,738,738
Santa Barbara,50,2022-11-29,489,489,489,0,5647,5661,5660,1,25,2,2,3,742,742,740,740
Santa Clara,50,2022-11-29,3132,3139,3139,0,29567,29639,29638,1,173,10,10,25,2583,2583,2573,2573
Santa Cruz,50,2022-11-29,421,421,421,0,7333,7353,7352,1,33,0,0,3,276,276,276,276
Shasta,50,2022-11-29,107,107,107,0,993,995,994,1,17,1,1,2,599,599,598,598
Siskiyou,50,2022-11-29,27,27,27,0,292,293,292,1,1,0,0,0,95,95,95,95
Solano,50,2022-11-29,609,609,609,0,5427,5442,5441,1,33,2,2,6,465,465,463,463
Sonoma,50,2022-11-29,459,459,459,0,5072,5086,5085,1,46,2,2,3,534,534,532,532
Stanislaus,50,2022-11-29,561,561,561,0,5490,5504,5503,1,80,2,2,4,1801,1801,1799,1799
Sutter,50,2022-11-29,82,82,82,0,1184,1187,1186,1,0,0,0,0,232,232,232,232
Tehama,50,2022-11-29,80,80,80,0,651,653,652,1,5,0,0,2,217,217,217,217
Trinity,50,2022-11-29,2,2,2,0,54,55,54,1,0,0,0,0,22,22,22,22
Tulare,50,2022-11-29,511,511,511,0,5085,5100,5099,1,37,0,0,0,1550,1550,1550,1550
Tuolumne,50,2022-11-29,77,77,77,0,722,723,722,1,3,0,0,0,203,203,203,203
Ventura,50,2022-11-29,1035,1037,1037,0,11033,11062,11061,1,57,2,2,3,1612,1612,1610,1610
Yolo,50,2022-11-29,174,174,174,0,2139,2146,2145,1,1,3,3,1,422,422,419,419
Yuba,50,2022-11-29,86,86,86,0,968,970,969,1,9,0,0,0,122,122,122,122
Alameda,51,2022-12-06,2833,2840,2840,0,29225,29298,29297,1,137,8,8,12,2105,2105,2097,2097
Amador,51,2022-12-06,38,38,38,0,762,764,763,1,3,0,0,1,95,95,95,95
Butte,51,2022-12-06,238,238,238,0,1926,1932,1931,1,44,7,7,3,475,475,468,468
Calaveras,51,2022-12-06,42,42,42,0,489,490,489,1,2,0,0,1,135,135,135,135
Colusa,51,2022-12-06,9,9,9,0,249,250,249,1,4,0,0,0,22,22,22,22
Contra Costa,51,2022-12-06,1750,1755,1755,0,19049,19097,19096,1,94,2,2,11,1496,1496,1494,1494
Del Norte,51,2022-12-06,38,38,38,0,540,541,540,1,2,0,0,0,56,56,56,56
El Dorado,51,2022-12-06,167,167,167,0,1445,1450,1449,1,11,1,1,0,237,237,236,236
Fresno,51,2022-12-06,1556,1560,1560,0,14221,14257,14256,1,161,5,5,16,2919,2919,2914,2914
Glenn,51,2022-12-06,23,23,23,0,244,245,244,1,2,0,0,0,53,53,53,53
Humboldt,51,2022-12-06,130,130,130,0,1091,1094,1093,1,16,1,1,2,164,164,163,163
Imperial,51,2022-12-06,546,546,546,0,3186,3194,3193,1,16,2,2,5,967,967,965,965
Inyo,51,2022-12-06,22,22,22,0,327,328,327,1,0,0,0,0,62,62,62,62
Kern,51,2022-12-06,858,859,859,0,10916,10946,10945,1,65,1,1,6,2447,2447,2446,2446
Kings,51,2022-12-06,295,295,295,0,2898,2906,2905,1,6,2,2,0,473,473,471,471
Lake,51,2022-12-06,61,61,61,0,812,813,812,1,2,0,0,0,151,151,151,151
Lassen,51,2022-12-06,18,18,18,0,421,422,421,1,0,0,0,0,64,64,64,64
Los Angeles,51,2022-12-06,21251,21305,21305,0,239519,240130,240127,3,1151,115,115,142,34237,34237,34122,34122
Madera,51,2022-12-06,218,218,218,0,1989,1995,1994,1,11,0,0,3,375,375,375,375
Marin,51,2022-12-06,329,329,329,0,3508,3519,3518,1,16,0,0,2,317,317,317,317
Mariposa,51,2022-12-06,23,23,23,0,157,158,157,1,0,0,0,0,30,30,30,30
Mendocino,51,2022-12-06,52,52,52,0,773,774,773,1,8,1,1,2,138,138,137,137
Merced,51,2022-12-06,344,344,344,0,3243,3253,3252,1,17,1,1,2,888,888,887,887
Modoc,51,2022-12-06,11,11,11,0,11,12,11,1,0,0,0,0,9,9,9,9
Mono,51,2022-12-06,11,11,11,0,99,100,99,1,0,0,0,0,8,8,8,8
Monterey,51,2022-12-06,266,266,266,0,4362,4374,4373,1,28,1,1,3,779,779,778,778
Napa,51,2022-12-06,155,155,155,0,2448,2454,2453,1,12,0,0,0,159,159,159,159
Nevada,51,2022-12-06,98,98,98,0,1073,1076,1075,1,10,0,0,0,136,136,136,136
Orange,51,2022-12-06,4144,4156,4156,0,34337,34425,34424,1,311,30,30,48,7698,7698,7668,7668
Placer,51,2022-12-06,397,397,397,0,4115,4126,4125,1,83,1,1,4,669,669,668,668
Plumas,51,2022-12-06,21,21,21,0,197,198,197,1,1,0,0,0,13,13,13,13
Riverside,51,2022-12-06,3978,3989,3989,0,27056,27124,27123,1,191,13,13,25,6698,6698,6685,6685
Sacramento,51,2022-12-06,2070,2076,2076,0,21102,21156,21155,1,160,7,7,24,3417,3417,3410,3410
San Benito,51,2022-12-06,209,209,209,0,1457,1462,1461,1,6,2,2,3,104,104,102,102
San Bernardino,51,2022-12-06,4060,4071,4071,0,28265,28337,28336,1,192,2,2,32,8108,8108,8106,8106
San Diego,51,2022-12-06,5506,5519,5519,0,44438,44551,44550,1,312,14,14,33,5641,5641,5627,5627
San Francisco,51,2022-12-06,1487,1492,1492,0,16046,16087,16086,1,92,6,6,7,1104,1104,1098,1098
San Joaquin,51,2022-12-06,1105,1105,1105,0,12465,12494,12493,1,69,7,7,6,2368,2368,2361,2361
San Luis Obispo,51,2022-12-06,216,216,216,0,2738,2745,2744,1,16,3,3,0,537,537,534,534
San Mateo,51,2022-12-06,1236,1238,1238,0,13330,13365,13364,1,55,1,1,0,740,740,739,739
Santa Barbara,51,2022-12-06,507,507,507,0,6473,6490,6489,1,45,2,2,6,744,744,742,742
Santa Clara,51,2022-12-06,3484,3492,3492,0,35663,35755,35754,1,194,13,13,26,2596,2596,2583,2583
Santa Cruz,51,2022-12-06,502,502,502,0,12969,13004,13003,1,30,0,0,4,276,276,276,276
Shasta,51,2022-12-06,122,122,122,0,1128,1131,1130,1,19,0,0,3,599,599,599,599
Siskiyou,51,2022-12-06,18,18,18,0,284,285,284,1,0,0,0,0,95,95,95,95
Solano,51,2022-12-06,625,625,625,0,6627,6645,6644,1,29,1,1,11,466,466,465,465
Sonoma,51,2022-12-06,515,515,515,0,6039,6055,6054,1,38,5,5,3,539,539,534,534
Stanislaus,51,2022-12-06,638,638,638,0,6714,6732,6731,1,74,2,2,11,1803,1803,1801,1801
Sutter,51,2022-12-06,105,105,105,0,1206,1208,1207,1,0,1,1,0,233,233,232,232
Tehama,51,2022-12-06,91,91,91,0,826,827,826,1,6,3,3,1,220,220,217,217
Trinity,51,2022-12-06,3,3,3,0,41,42,41,1,0,0,0,0,22,22,22,22
Tulare,51,2022-12-06,542,542,542,0,6158,6175,6174,1,31,0,0,1,1550,1550,1550,1550
Tuolumne,51,2022-12-06,116,116,116,0,869,871,870,1,2,0,0,0,203,203,203,203
Ventura,51,2022-12-06,1059,1059,1059,0,11799,11829,11828,1,68,2,2,3,1614,1614,1612,1612
Yolo,51,2022-12-06,216,216,216,0,2549,2557,2556,1,3,1,1,1,423,423,422,422
Yuba,51,2022-12-06,80,80,80,0,1015,1016,1015,1,13,0,0,0,122,122,122,122
Alameda,52,2022-12-13,2648,2655,2655,0,29137,29216,29215,1,149,10,10,20,2115,2115,2105,2105
Amador,52,2022-12-13,35,35,35,0,767,769,768,1,3,0,0,0,95,95,95,95
Butte,52,2022-12-13,166,166,166,0,1915,1922,1921,1,38,1,1,3,476,476,475,475
Calaveras,52,2022-12-13,39,39,39,0,457,458,457,1,1,0,0,1,135,135,135,135
Colusa,52,2022-12-13,12,12,12,0,231,232,231,1,4,0,0,0,22,22,22,22
Contra Costa,52,2022-12-13,1752,1757,1757,0,18218,18267,18266,1,76,10,10,7,1506,1506,1496,1496
Del Norte,52,2022-12-13,33,33,33,0,535,536,535,1,2,0,0,0,56,56,56,56
El Dorado,52,2022-12-13,154,154,154,0,1593,1599,1598,1,10,2,2,2,239,239,237,237
Fresno,52,2022-12-13,1419,1424,1424,0,13782,13819,13818,1,202,13,13,22,2932,2932,2919,2919
Glenn,52,2022-12-13,22,22,22,0,230,231,230,1,2,0,0,0,53,53,53,53
Humboldt,52,2022-12-13,107,107,107,0,961,963,962,1,13,1,1,2,165,165,164,164
Imperial,52,2022-12-13,410,410,410,0,2872,2880,2879,1,21,3,3,3,970,970,967,967
Inyo,52,2022-12-13,21,21,21,0,308,309,308,1,1,0,0,0,62,62,62,62
Kern,52,2022-12-13,925,926,926,0,10769,10799,10798,1,45,2,2,2,2449,2449,2447,2447
Kings,52,2022-12-13,239,239,239,0,2852,2861,2860,1,5,0,0,0,473,473,473,473
Lake,52,2022-12-13,54,54,54,0,780,781,780,1,4,0,0,2,151,151,151,151
Lassen,52,2022-12-13,10,10,10,0,442,443,442,1,0,0,0,0,64,64,64,64
Los Angeles,52,2022-12-13,17260,17308,17308,0,228306,228929,228926,3,1169,159,159,135,34396,34396,34237,34237
Madera,52,2022-12-13,200,200,200,0,2183,2190,2189,1,11,0,0,1,375,375,375,375
Marin,52,2022-12-13,298,298,298,0,3615,3627,3626,1,21,0,0,1,317,317,317,317
Mariposa,52,2022-12-13,19,19,19,0,134,135,134,1,0,0,0,0,30,30,30,30
Mendocino,52,2022-12-13,53,53,53,0,661,662,661,1,5,1,1,0,139,139,138,138
Merced,52,2022-12-13,321,321,321,0,3238,3248,3247,1,13,0,0,2,888,888,888,888
Modoc,52,2022-12-13,10,10,10,0,15,16,15,1,0,0,0,0,9,9,9,9
Mono,52,2022-12-13,7,7,7,0,117,118,117,1,0,0,0,0,8,8,8,8
Monterey,52,2022-12-13,253,253,253,0,4236,4250,4249,1,20,3,3,4,782,782,779,779
Napa,52,2022-12-13,170,170,170,0,2049,2055,2054,1,9,1,1,0,160,160,159,159
Nevada,52,2022-12-13,96,96,96,0,972,975,974,1,5,0,0,2,136,136,136,136
Orange,52,2022-12-13,3429,3438,3438,0,30915,31000,30999,1,320,30,30,48,7728,7728,7698,7698
Placer,52,2022-12-13,314,314,314,0,3774,3785,3784,1,77,5,5,11,674,674,669,669
Plumas,52,2022-12-13,6,6,6,0,190,191,190,1,3,0,0,0,13,13,13,13
Riverside,52,2022-12-13,3246,3254,3254,0,24428,24494,24493,1,197,21,21,26,6719,6719,6698,6698
Sacramento,52,2022-12-13,1806,1812,1812,0,20091,20147,20146,1,190,8,8,28,3425,3425,3417,3417
San Benito,52,2022-12-13,118,118,118,0,1311,1316,1315,1,2,2,2,2,106,106,104,104
San Bernardino,52,2022-12-13,3541,3551,3551,0,26695,26767,26766,1,239,2,2,36,8110,8110,8108,8108
San Diego,52,2022-12-13,4854,4866,4866,0,40130,40240,40239,1,323,16,16,45,5657,5657,5641,5641
San Francisco,52,2022-12-13,1378,1383,1383,0,16751,16796,16795,1,101,11,11,15,1115,1115,1104,1104
San Joaquin,52,2022-12-13,935,936,936,0,12842,12876,12875,1,82,5,5,19,2373,2373,2368,2368
San Luis Obispo,52,2022-12-13,222,222,222,0,2530,2537,2536,1,12,1,1,0,538,538,537,537
San Mateo,52,2022-12-13,1117,1119,1119,0,12447,12481,12480,1,55,1,1,6,741,741,740,740
Santa Barbara,52,2022-12-13,486,486,486,0,5644,5660,5659,1,39,1,1,8,745,745,744,744
Santa Clara,52,2022-12-13,3242,3251,3251,0,34991,35087,35086,1,194,17,17,35,2613,2613,2596,2596
Santa Cruz,52,2022-12-13,541,541,541,0,12986,13024,13023,1,19,0,0,1,276,276,276,276
Shasta,52,2022-12-13,104,104,104,0,1176,1179,1178,1,23,0,0,5,599,599,599,599
Siskiyou,52,2022-12-13,19,19,19,0,257,258,257,1,1,0,0,1,95,95,95,95
Solano,52,2022-12-13,651,651,651,0,6127,6145,6144,1,46,2,2,6,468,468,466,466
Sonoma,52,2022-12-13,572,572,572,0,5541,5556,5555,1,40,2,2,6,541,541,539,539
Stanislaus,52,2022-12-13,557,557,557,0,6268,6286,6285,1,112,7,7,9,1810,1810,1803,1803
Sutter,52,2022-12-13,106,106,106,0,1147,1149,1148,1,0,0,0,0,233,233,233,233
Tehama,52,2022-12-13,73,73,73,0,757,759,758,1,2,0,0,1,220,220,220,220
Trinity,52,2022-12-13,5,5,5,0,42,43,42,1,0,0,0,0,22,22,22,22
Tulare,52,2022-12-13,423,423,423,0,5630,5647,5646,1,31,3,3,2,1553,1553,1550,1550
Tuolumne,52,2022-12-13,128,128,128,0,901,902,901,1,6,0,0,0,203,203,203,203
Ventura,52,2022-12-13,890,890,890,0,10704,10735,10734,1,69,4,4,10,1618,1618,1614,1614
Yolo,52,2022-12-13,200,200,200,0,2208,2216,2215,1,5,2,2,2,425,425,423,423
Yuba,52,2022-12-13,75,75,75,0,934,936,935,1,7,0,0,0,122,122,122,122
Alameda,53,2022-12-20,2290,2297,2297,0,26769,26848,26847,1,150,15,15,23,2130,2130,2115,2115
Amador,53,2022-12-20,49,49,49,0,869,871,870,1,3,1,1,0,96,96,95,95
Butte,53,2022-12-20,126,126,126,0,1406,1411,1410,1,37,3,3,2,479,479,476,476
Calaveras,53,2022-12-20,28,28,28,0,429,430,429,1,0,2,2,0,137,137,135,135
Colusa,53,2022-12-20,13,13,13,0,204,205,204,1,0,0,0,0,22,22,22,22
Contra Costa,53,2022-12-20,1696,1703,1703,0,17181,17231,17230,1,84,4,4,9,1510,1510,1506,1506
Del Norte,53,2022-12-20,36,36,36,0,543,544,543,1,2,0,0,0,56,56,56,56
El Dorado,53,2022-12-20,165,165,165,0,1490,1496,1495,1,8,0,0,2,239,239,239,239
Fresno,53,2022-12-20,1150,1153,1153,0,12348,12385,12384,1,214,9,9,21,2941,2941,2932,2932
Glenn,53,2022-12-20,17,17,17,0,202,203,202,1,1,0,0,0,53,53,53,53
Humboldt,53,2022-12-20,113,113,113,0,903,905,904,1,9,0,0,2,165,165,165,165
Imperial,53,2022-12-20,257,257,257,0,2571,2578,2577,1,18,2,2,1,972,972,970,970
Inyo,53,2022-12-20,12,12,12,0,290,291,290,1,1,0,0,0,62,62,62,62
Kern,53,2022-12-20,907,909,909,0,10563,10594,10593,1,68,4,4,9,2453,2453,2449,2449
Kings,53,2022-12-20,217,217,217,0,2753,2762,2761,1,8,4,4,0,477,477,473,473
Lake,53,2022-12-20,73,73,73,0,763,764,763,1,6,1,1,0,152,152,151,151
Lassen,53,2022-12-20,14,14,14,0,489,490,489,1,0,0,0,0,64,64,64,64
Los Angeles,53,2022-12-20,15130,15174,15174,0,193729,194296,194294,2,1110,128,128,149,34524,34524,34396,34396
Madera,53,2022-12-20,189,189,189,0,1769,1775,1774,1,10,0,0,1,375,375,375,375
Marin,53,2022-12-20,258,258,258,0,3236,3247,3246,1,20,0,0,0,317,317,317,317
Mariposa,53,2022-12-20,25,25,25,0,132,133,132,1,0,0,0,0,30,30,30,30
Mendocino,53,2022-12-20,70,70,70,0,755,756,755,1,6,0,0,0,139,139,139,139
Merced,53,2022-12-20,237,237,237,0,2627,2636,2635,1,21,3,3,2,891,891,888,888
Modoc,53,2022-12-20,2,2,2,0,17,18,17,1,0,0,0,0,9,9,9,9
Mono,53,2022-12-20,12,12,12,0,113,114,113,1,1,0,0,0,8,8,8,8
Monterey,53,2022-12-20,220,220,220,0,3755,3767,3766,1,18,2,2,0,784,784,782,782
Napa,53,2022-12-20,178,178,178,0,2090,2097,2096,1,6,0,0,1,160,160,160,160
Nevada,53,2022-12-20,63,63,63,0,820,822,821,1,6,0,0,1,136,136,136,136
Orange,53,2022-12-20,3362,3372,3372,0,30123,30210,30209,1,303,38,38,48,7766,7766,7728,7728
Placer,53,2022-12-20,380,380,380,0,3839,3852,3851,1,102,1,1,6,675,675,674,674
Plumas,53,2022-12-20,9,9,9,0,169,170,169,1,1,0,0,0,13,13,13,13
Riverside,53,2022-12-20,3177,3186,3186,0,22636,22703,22702,1,180,21,21,19,6740,6740,6719,6719
Sacramento,53,2022-12-20,1734,1739,1739,0,19112,19168,19167,1,226,14,14,28,3439,3439,3425,3425
San Benito,53,2022-12-20,96,96,96,0,1089,1093,1092,1,0,3,3,1,109,109,106,106
San Bernardino,53,2022-12-20,3197,3206,3206,0,24548,24620,24619,1,217,4,4,27,8114,8114,8110,8110
San Diego,53,2022-12-20,4933,4947,4947,0,38200,38313,38312,1,386,14,14,41,5671,5671,5657,5657
San Francisco,53,2022-12-20,1212,1216,1216,0,15417,15462,15461,1,95,11,11,17,1126,1126,1115,1115
San Joaquin,53,2022-12-20,875,875,875,0,12724,12762,12761,1,66,12,12,14,2385,2385,2373,2373
San Luis Obispo,53,2022-12-20,245,245,245,0,2426,2434,2433,1,15,1,1,1,539,539,538,538
San Mateo,53,2022-12-20,977,979,979,0,11532,11567,11566,1,60,1,1,5,742,742,741,741
Santa Barbara,53,2022-12-20,505,505,505,0,5063,5079,5078,1,44,4,4,5,749,749,745,745
Santa Clara,53,2022-12-20,2722,2730,2730,0,30982,31073,31072,1,179,16,16,35,2629,2629,2613,2613
Santa Cruz,53,2022-12-20,202,202,202,0,10227,10258,10257,1,18,0,0,2,276,276,276,276
Shasta,53,2022-12-20,108,108,108,0,1085,1089,1088,1,17,3,3,3,602,602,599,599
Siskiyou,53,2022-12-20,11,11,11,0,248,249,248,1,0,0,0,1,95,95,95,95
Solano,53,2022-12-20,664,664,664,0,6100,6118,6117,1,43,0,0,7,468,468,468,468
Sonoma,53,2022-12-20,456,456,456,0,5295,5313,5312,1,30,1,1,6,542,542,541,541
Stanislaus,53,2022-12-20,482,482,482,0,5858,5877,5876,1,99,4,4,11,1814,1814,1810,1810
Sutter,53,2022-12-20,92,92,92,0,1002,1004,1003,1,0,1,1,0,234,234,233,233
Tehama,53,2022-12-20,70,70,70,0,707,708,707,1,2,2,2,1,222,222,220,220
Trinity,53,2022-12-20,1,1,1,0,29,30,29,1,0,0,0,0,22,22,22,22
Tulare,53,2022-12-20,474,474,474,0,5205,5222,5221,1,41,6,6,2,1559,1559,1553,1553
Tuolumne,53,2022-12-20,82,82,82,0,846,848,847,1,2,1,1,1,204,204,203,203
Ventura,53,2022-12-20,978,980,980,0,10013,10044,10043,1,82,5,5,11,1623,1623,1618,1618
Yolo,53,2022-12-20,178,178,178,0,2020,2027,2026,1,6,4,4,0,429,429,425,425
Yuba,53,2022-12-20,81,81,81,0,887,889,888,1,8,0,0,0,122,122,122,122
Alameda,54,2022-12-27,1982,1988,1988,0,20676,20742,20741,1,156,8,8,22,2138,2138,2130,2130
Amador,54,2022-12-27,33,33,33,0,635,636,635,1,6,0,0,0,96,96,96,96
Butte,54,2022-12-27,103,103,103,0,1342,1348,1347,1,32,0,0,3,479,479,479,479
Calaveras,54,2022-12-27,28,28,28,0,375,376,375,1,1,0,0,0,137,137,137,137
Colusa,54,2022-12-27,12,12,12,0,156,157,156,1,0,0,0,0,22,22,22,22
Contra Costa,54,2022-12-27,1488,1493,1493,0,13723,13767,13766,1,94,10,10,12,1520,1520,1510,1510
Del Norte,54,2022-12-27,34,34,34,0,405,406,405,1,3,0,0,0,56,56,56,56
El Dorado,54,2022-12-27,152,152,152,0,1412,1418,1417,1,3,2,2,1,241,241,239,239
Fresno,54,2022-12-27,1139,1143,1143,0,11270,11306,11305,1,181,11,11,30,2952,2952,2941,2941
Glenn,54,2022-12-27,9,9,9,0,198,199,198,1,0,0,0,0,53,53,53,53
Humboldt,54,2022-12-27,79,79,79,0,659,660,659,1,4,2,2,1,167,167,165,165
Imperial,54,2022-12-27,237,237,237,0,2094,2102,2101,1,4,1,1,3,973,973,972,972
Inyo,54,2022-12-27,14,14,14,0,208,209,208,1,2,0,0,0,62,62,62,62
Kern,54,2022-12-27,749,750,750,0,8944,8974,8973,1,50,8,8,9,2461,2461,2453,2453
Kings,54,2022-12-27,201,201,201,0,2175,2183,2182,1,4,0,0,1,477,477,477,477
Lake,54,2022-12-27,51,51,51,0,580,581,580,1,3,0,0,2,152,152,152,152
Lassen,54,2022-12-27,24,24,24,0,447,448,447,1,0,0,0,0,64,64,64,64
Los Angeles,54,2022-12-27,13711,13753,13753,0,134628,135054,135052,2,1044,177,177,151,34701,34701,34524,34524
Madera,54,2022-12-27,174,174,174,0,1662,1668,1667,1,5,0,0,1,375,375,375,375
Marin,54,2022-12-27,234,234,234,0,2460,2469,2468,1,29,0,0,3,317,317,317,317
Mariposa,54,2022-12-27,19,19,19,0,95,96,95,1,0,0,0,0,30,30,30,30
Mendocino,54,2022-12-27,73,73,73,0,668,670,669,1,9,0,0,1,139,139,139,139
Merced,54,2022-12-27,213,213,213,0,1987,1993,1992,1,15,4,4,3,895,895,891,891
Modoc,54,2022-12-27,7,7,7,0,14,15,14,1,0,0,0,0,9,9,9,9
Mono,54,2022-12-27,13,13,13,0,84,85,84,1,0,0,0,0,8,8,8,8
Monterey,54,2022-12-27,209,209,209,0,2979,2989,2988,1,20,4,4,1,788,788,784,784
Napa,54,2022-12-27,138,138,138,0,1761,1767,1766,1,13,1,1,0,161,161,160,160
Nevada,54,2022-12-27,73,73,73,0,750,752,751,1,9,0,0,0,136,136,136,136
Orange,54,2022-12-27,3340,3352,3352,0,25180,25260,25259,1,289,31,31,43,7797,7797,7766,7766
Placer,54,2022-12-27,299,299,299,0,3096,3108,3107,1,92,2,2,11,677,677,675,675
Plumas,54,2022-12-27,10,10,10,0,126,127,126,1,0,0,0,0,13,13,13,13
Riverside,54,2022-12-27,3109,3120,3120,0,19455,19516,19515,1,204,9,9,19,6749,6749,6740,6740
Sacramento,54,2022-12-27,1446,1451,1451,0,14990,15036,15035,1,183,17,17,24,3456,3456,3439,3439
San Benito,54,2022-12-27,102,102,102,0,861,864,863,1,1,0,0,1,109,109,109,109
San Bernardino,54,2022-12-27,3041,3052,3052,0,20863,20929,20928,1,199,8,8,31,8122,8122,8114,8114
San Diego,54,2022-12-27,4721,4735,4735,0,29122,29215,29214,1,397,31,31,48,5702,5702,5671,5671
San Francisco,54,2022-12-27,1059,1062,1062,0,11761,11797,11796,1,96,18,18,14,1144,1144,1126,1126
San Joaquin,54,2022-12-27,776,777,777,0,10625,10659,10658,1,66,6,6,12,2391,2391,2385,2385
San Luis Obispo,54,2022-12-27,225,225,225,0,2020,2027,2026,1,20,3,3,0,542,542,539,539
San Mateo,54,2022-12-27,846,847,847,0,8790,8818,8817,1,50,0,0,6,742,742,742,742
Santa Barbara,54,2022-12-27,476,476,476,0,4102,4115,4114,1,41,0,0,5,749,749,749,749
Santa Clara,54,2022-12-27,2453,2461,2461,0,24367,24445,24444,1,177,10,10,37,2639,2639,2629,2629
Santa Cruz,54,2022-12-27,233,233,233,0,4100,4114,4113,1,28,0,0,1,276,276,276,276
Shasta,54,2022-12-27,106,106,106,0,1031,1035,1034,1,19,0,0,0,602,602,602,602
Siskiyou,54,2022-12-27,21,21,21,0,278,279,278,1,2,0,0,0,95,95,95,95
Solano,54,2022-12-27,640,640,640,0,5139,5156,5155,1,59,4,4,8,472,472,468,468
Sonoma,54,2022-12-27,466,466,466,0,4142,4156,4155,1,42,1,1,2,543,543,542,542
Stanislaus,54,2022-12-27,459,459,459,0,5116,5134,5133,1,97,10,10,8,1824,1824,1814,1814
Sutter,54,2022-12-27,120,120,120,0,955,958,957,1,0,0,0,0,234,234,234,234
Tehama,54,2022-12-27,42,42,42,0,613,614,613,1,7,3,3,1,225,225,222,222
Trinity,54,2022-12-27,3,3,3,0,45,46,45,1,0,0,0,0,22,22,22,22
Tulare,54,2022-12-27,462,462,462,0,4174,4189,4188,1,42,6,6,3,1565,1565,1559,1559
Tuolumne,54,2022-12-27,95,95,95,0,733,734,733,1,7,3,3,0,207,207,204,204
Ventura,54,2022-12-27,931,932,932,0,7649,7675,7674,1,72,17,17,12,1640,1640,1623,1623
Yolo,54,2022-12-27,135,135,135,0,1499,1505,1504,1,7,3,3,0,432,432,429,429
Yuba,54,2022-12-27,103,103,103,0,743,744,743,1,18,0,0,0,122,122,122,122
Alameda,55,2023-01-03,1845,1851,1851,0,20507,20579,20578,1,166,15,15,14,2153,2153,2138,2138
Amador,55,2023-01-03,32,32,32,0,688,689,688,1,3,1,1,0,97,97,96,96
Butte,55,2023-01-03,94,94,94,0,1301,1307,1306,1,35,3,3,3,482,482,479,479
Calaveras,55,2023-01-03,31,31,31,0,360,361,360,1,0,2,2,0,139,139,137,137
Colusa,55,2023-01-03,6,6,6,0,86,87,86,1,0,0,0,0,22,22,22,22
Contra Costa,55,2023-01-03,1320,1325,1325,0,14392,14443,14442,1,92,7,7,12,1527,1527,1520,1520
Del Norte,55,2023-01-03,31,31,31,0,396,397,396,1,3,0,0,2,56,56,56,56
El Dorado,55,2023-01-03,135,135,135,0,1403,1409,1408,1,7,0,0,2,241,241,241,241
Fresno,55,2023-01-03,1008,1011,1011,0,10942,10981,10980,1,180,13,13,30,2965,2965,2952,2952
Glenn,55,2023-01-03,13,13,13,0,184,185,184,1,0,0,0,0,53,53,53,53
Humboldt,55,2023-01-03,48,48,48,0,646,648,647,1,5,0,0,1,167,167,167,167
Imperial,55,2023-01-03,188,188,188,0,1980,1988,1987,1,11,1,1,3,974,974,973,973
Inyo,55,2023-01-03,15,15,15,0,235,236,235,1,1,0,0,0,62,62,62,62
Kern,55,2023-01-03,836,839,839,0,9881,9916,9915,1,69,3,3,8,2464,2464,2461,2461
Kings,55,2023-01-03,195,195,195,0,2125,2133,2132,1,6,2,2,1,479,479,477,477
Lake,55,2023-01-03,55,55,55,0,644,646,645,1,2,1,1,1,153,153,152,152
Lassen,55,2023-01-03,13,13,13,0,483,484,483,1,0,0,0,0,64,64,64,64
Los Angeles,55,2023-01-03,12773,12817,12817,0,145806,146319,146317,2,1109,142,142,153,34843,34843,34701,34701
Madera,55,2023-01-03,133,133,133,0,1570,1576,1575,1,8,0,0,0,375,375,375,375
Marin,55,2023-01-03,210,210,210,0,2447,2456,2455,1,19,0,0,4,317,317,317,317
Mariposa,55,2023-01-03,15,15,15,0,102,103,102,1,0,1,1,0,31,31,30,30
Mendocino,55,2023-01-03,51,51,51,0,654,655,654,1,8,1,1,3,140,140,139,139
Merced,55,2023-01-03,193,193,193,0,2063,2071,2070,1,11,2,2,2,897,897,895,895
Modoc,55,2023-01-03,10,10,10,0,14,15,14,1,0,0,0,0,9,9,9,9
Mono,55,2023-01-03,9,9,9,0,69,70,69,1,0,0,0,0,8,8,8,8
Monterey,55,2023-01-03,195,195,195,0,3036,3048,3047,1,25,0,0,0,788,788,788,788
Napa,55,2023-01-03,124,124,124,0,1586,1592,1591,1,7,0,0,1,161,161,161,161
Nevada,55,2023-01-03,46,46,46,0,717,719,718,1,11,0,0,0,136,136,136,136
Orange,55,2023-01-03,3124,3136,3136,0,25334,25422,25421,1,317,35,35,33,7832,7832,7797,7797
Placer,55,2023-01-03,288,288,288,0,3256,3269,3268,1,112,1,1,11,678,678,677,677
Plumas,55,2023-01-03,12,12,12,0,148,149,148,1,1,1,1,0,14,14,13,13
Riverside,55,2023-01-03,2895,2906,2906,0,20149,20220,20219,1,245,12,12,28,6761,6761,6749,6749
Sacramento,55,2023-01-03,1392,1397,1397,0,15261,15315,15314,1,209,22,22,24,3478,3478,3456,3456
San Benito,55,2023-01-03,51,51,51,0,764,767,766,1,0,0,0,1,109,109,109,109
San Bernardino,55,2023-01-03,2607,2616,2616,0,20372,20443,20442,1,180,3,3,31,8125,8125,8122,8122
San Diego,55,2023-01-03,4328,4343,4343,0,29963,30069,30068,1,399,21,21,40,5723,5723,5702,5702
San Francisco,55,2023-01-03,858,860,860,0,10713,10750,10749,1,80,10,10,17,1154,1154,1144,1144
San Joaquin,55,2023-01-03,711,711,711,0,10247,10283,10282,1,71,6,6,14,2397,2397,2391,2391
San Luis Obispo,55,2023-01-03,220,220,220,0,2060,2068,2067,1,12,6,6,0,548,548,542,542
San Mateo,55,2023-01-03,713,715,715,0,8438,8468,8467,1,50,0,0,7,742,742,742,742
Santa Barbara,55,2023-01-03,424,424,424,0,4177,4191,4190,1,42,1,1,8,750,750,749,749
Santa Clara,55,2023-01-03,2377,2386,2386,0,24575,24662,24661,1,205,15,15,32,2654,2654,2639,2639
Santa Cruz,55,2023-01-03,160,160,160,0,2993,3004,3003,1,32,0,0,0,276,276,276,276
Shasta,55,2023-01-03,83,83,83,0,874,877,876,1,14,0,0,1,602,602,602,602
Siskiyou,55,2023-01-03,14,14,14,0,266,267,266,1,2,0,0,0,95,95,95,95
Solano,55,2023-01-03,587,587,587,0,5286,5305,5304,1,63,1,1,10,473,473,472,472
Sonoma,55,2023-01-03,387,387,387,0,4374,4390,4389,1,60,0,0,1,543,543,543,543
Stanislaus,55,2023-01-03,448,448,448,0,5078,5098,5097,1,81,5,5,8,1829,1829,1824,1824
Sutter,55,2023-01-03,91,91,91,0,885,888,887,1,0,0,0,0,234,234,234,234
Tehama,55,2023-01-03,52,52,52,0,584,585,584,1,3,4,4,0,229,229,225,225
Trinity,55,2023-01-03,4,4,4,0,38,39,38,1,0,0,0,0,22,22,22,22
Tulare,55,2023-01-03,449,449,449,0,4712,4730,4729,1,59,2,2,5,1567,1567,1565,1565
Tuolumne,55,2023-01-03,61,61,61,0,648,649,648,1,4,0,0,0,207,207,207,207
Ventura,55,2023-01-03,818,821,821,0,7768,7797,7796,1,84,8,8,11,1648,1648,1640,1640
Yolo,55,2023-01-03,134,134,134,0,1623,1630,1629,1,3,2,2,1,434,434,432,432
Yuba,55,2023-01-03,77,77,77,0,720,723,722,1,18,0,0,1,122,122,122,122
Alameda,56,2023-01-10,1314,1319,1319,0,22349,22439,22438,1,125,12,12,11,2165,2165,2153,2153
Amador,56,2023-01-10,30,30,30,0,755,758,757,1,2,0,0,0,97,97,97,97
Butte,56,2023-01-10,76,76,76,0,1051,1057,1056,1,36,2,2,3,484,484,482,482
Calaveras,56,2023-01-10,17,17,17,0,314,315,314,1,1,0,0,1,139,139,139,139
Colusa,56,2023-01-10,9,9,9,0,91,92,91,1,0,0,0,0,22,22,22,22
Contra Costa,56,2023-01-10,934,938,938,0,14433,14490,14489,1,77,5,5,13,1532,1532,1527,1527
Del Norte,56,2023-01-10,13,13,13,0,379,380,379,1,3,0,0,2,56,56,56,56
El Dorado,56,2023-01-10,74,74,74,0,1333,1339,1338,1,4,0,0,0,241,241,241,241
Fresno,56,2023-01-10,736,737,737,0,11024,11068,11067,1,177,6,6,27,2971,2971,2965,2965
Glenn,56,2023-01-10,7,7,7,0,175,176,175,1,0,0,0,0,53,53,53,53
Humboldt,56,2023-01-10,51,51,51,0,628,629,628,1,6,0,0,5,167,167,167,167
Imperial,56,2023-01-10,144,144,144,0,2542,2554,2553,1,9,1,1,6,975,975,974,974
Inyo,56,2023-01-10,10,10,10,0,188,189,188,1,1,0,0,0,62,62,62,62
Kern,56,2023-01-10,537,537,537,0,10197,10238,10237,1,78,5,5,7,2469,2469,2464,2464
Kings,56,2023-01-10,162,162,162,0,2375,2386,2385,1,7,0,0,0,479,479,479,479
Lake,56,2023-01-10,35,35,35,0,587,588,587,1,3,1,1,0,154,154,153,153
Lassen,56,2023-01-10,17,17,17,0,514,515,514,1,0,0,0,0,64,64,64,64
Los Angeles,56,2023-01-10,9061,9097,9097,0,180860,181579,181577,2,989,139,139,139,34982,34982,34843,34843
Madera,56,2023-01-10,90,90,90,0,1566,1573,1572,1,4,0,0,1,375,375,375,375
Marin,56,2023-01-10,128,128,128,0,2425,2436,2435,1,20,0,0,5,317,317,317,317
Mariposa,56,2023-01-10,5,5,5,0,96,97,96,1,0,0,0,0,31,31,31,31
Mendocino,56,2023-01-10,38,38,38,0,601,603,602,1,10,2,2,0,142,142,140,140
Merced,56,2023-01-10,177,177,177,0,1961,1970,1969,1,12,1,1,2,898,898,897,897
Modoc,56,2023-01-10,4,4,4,0,11,12,11,1,0,0,0,0,9,9,9,9
Mono,56,2023-01-10,11,11,11,0,72,73,72,1,0,0,0,0,8,8,8,8
Monterey,56,2023-01-10,173,173,173,0,2985,2998,2997,1,17,4,4,3,792,792,788,788
Napa,56,2023-01-10,115,115,115,0,1877,1884,1883,1,15,0,0,1,161,161,161,161
Nevada,56,2023-01-10,40,40,40,0,708,710,709,1,7,0,0,0,136,136,136,136
Orange,56,2023-01-10,2182,2190,2190,0,26992,27100,27099,1,264,43,43,36,7875,7875,7832,7832
Placer,56,2023-01-10,246,246,246,0,3261,3274,3273,1,79,0,0,4,678,678,678,678
Plumas,56,2023-01-10,3,3,3,0,68,69,68,1,1,0,0,0,14,14,14,14
Riverside,56,2023-01-10,1754,1761,1761,0,20030,20110,20109,1,168,14,14,27,6775,6775,6761,6761
Sacramento,56,2023-01-10,922,925,925,0,14766,14825,14824,1,173,19,19,28,3497,3497,3478,3478
San Benito,56,2023-01-10,45,45,45,0,731,734,733,1,1,0,0,2,109,109,109,109
San Bernardino,56,2023-01-10,1555,1562,1562,0,19837,19917,19916,1,179,5,5,32,8130,8130,8125,8125
San Diego,56,2023-01-10,3262,3275,3275,0,33829,33966,33965,1,363,27,27,38,5750,5750,5723,5723
San Francisco,56,2023-01-10,694,696,696,0,11699,11745,11744,1,77,6,6,13,1160,1160,1154,1154
San Joaquin,56,2023-01-10,536,536,536,0,10345,10388,10387,1,65,11,11,9,2408,2408,2397,2397
San Luis Obispo,56,2023-01-10,143,143,143,0,1932,1940,1939,1,13,3,3,0,551,551,548,548
San Mateo,56,2023-01-10,538,538,538,0,8993,9030,9029,1,46,0,0,2,742,742,742,742
Santa Barbara,56,2023-01-10,321,321,321,0,4183,4200,4199,1,39,3,3,1,753,753,750,750
Santa Clara,56,2023-01-10,1711,1718,1718,0,28031,28144,28143,1,167,14,14,24,2668,2668,2654,2654
Santa Cruz,56,2023-01-10,158,158,158,0,4212,4231,4230,1,29,0,0,1,276,276,276,276
Shasta,56,2023-01-10,56,56,56,0,818,822,821,1,14,0,0,3,602,602,602,602
Siskiyou,56,2023-01-10,17,17,17,0,221,222,221,1,1,0,0,0,95,95,95,95
Solano,56,2023-01-10,372,372,372,0,4964,4984,4983,1,52,1,1,7,474,474,473,473
Sonoma,56,2023-01-10,256,256,256,0,4481,4500,4499,1,36,3,3,4,546,546,543,543
Stanislaus,56,2023-01-10,283,283,283,0,4796,4817,4816,1,84,4,4,8,1833,1833,1829,1829
Sutter,56,2023-01-10,59,59,59,0,809,811,810,1,0,0,0,0,234,234,234,234
Tehama,56,2023-01-10,26,26,26,0,466,467,466,1,1,2,2,0,231,231,229,229
Trinity,56,2023-01-10,2,2,2,0,29,30,29,1,0,0,0,0,22,22,22,22
Tulare,56,2023-01-10,299,299,299,0,4762,4782,4781,1,52,5,5,3,1572,1572,1567,1567
Tuolumne,56,2023-01-10,75,75,75,0,642,643,642,1,3,1,1,0,208,208,207,207
Ventura,56,2023-01-10,600,600,600,0,9170,9208,9207,1,72,6,6,12,1654,1654,1648,1648
Yolo,56,2023-01-10,95,95,95,0,1615,1623,1622,1,4,2,2,1,436,436,434,434
Yuba,56,2023-01-10,45,45,45,0,726,729,728,1,13,0,0,1,122,122,122,122
Alameda,57,2023-01-17,837,842,842,0,19473,19558,19557,1,96,5,5,16,2170,2170,2165,2165
Amador,57,2023-01-17,23,23,23,0,502,503,502,1,4,0,0,0,97,97,97,97
Butte,57,2023-01-17,62,62,62,0,1254,1260,1259,1,26,1,1,1,485,485,484,484
Calaveras,57,2023-01-17,10,10,10,0,314,315,314,1,2,0,0,1,139,139,139,139
Colusa,57,2023-01-17,6,6,6,0,84,85,84,1,1,0,0,0,22,22,22,22
Contra Costa,57,2023-01-17,585,585,585,0,12340,12394,12393,1,67,4,4,9,1536,1536,1532,1532
Del Norte,57,2023-01-17,11,11,11,0,290,291,290,1,3,2,2,0,58,58,56,56
El Dorado,57,2023-01-17,62,62,62,0,972,978,977,1,3,1,1,1,242,242,241,241
Fresno,57,2023-01-17,440,440,440,0,9865,9910,9909,1,162,7,7,12,2978,2978,2971,2971
Glenn,57,2023-01-17,3,3,3,0,161,162,161,1,0,0,0,0,53,53,53,53
Humboldt,57,2023-01-17,36,36,36,0,537,539,538,1,6,1,1,3,168,168,167,167
Imperial,57,2023-01-17,114,114,114,0,1939,1948,1947,1,8,2,2,6,977,977,975,975
Inyo,57,2023-01-17,10,10,10,0,202,203,202,1,0,1,1,0,63,63,62,62
Kern,57,2023-01-17,390,390,390,0,8384,8422,8421,1,57,3,3,11,2472,2472,2469,2469
Kings,57,2023-01-17,114,114,114,0,1866,1875,1874,1,1,2,2,1,481,481,479,479
Lake,57,2023-01-17,30,30,30,0,576,578,577,1,0,2,2,1,156,156,154,154
Lassen,57,2023-01-17,7,7,7,0,427,428,427,1,0,0,0,0,64,64,64,64
Los Angeles,57,2023-01-17,6133,6160,6160,0,157098,157792,157790,2,854,142,142,104,35124,35124,34982,34982
Madera,57,2023-01-17,61,61,61,0,1399,1407,1406,1,5,0,0,2,375,375,375,375
Marin,57,2023-01-17,122,122,122,0,2106,2116,2115,1,20,0,0,2,317,317,317,317
Mariposa,57,2023-01-17,13,13,13,0,101,102,101,1,0,0,0,0,31,31,31,31
Mendocino,57,2023-01-17,25,25,25,0,521,523,522,1,8,0,0,0,142,142,142,142
Merced,57,2023-01-17,121,121,121,0,1783,1792,1791,1,15,3,3,2,901,901,898,898
Modoc,57,2023-01-17,2,2,2,0,11,12,11,1,0,0,0,0,9,9,9,9
Mono,57,2023-01-17,5,5,5,0,71,72,71,1,0,0,0,0,8,8,8,8
Monterey,57,2023-01-17,108,108,108,0,2668,2681,2680,1,20,3,3,0,795,795,792,792
Napa,57,2023-01-17,71,71,71,0,1505,1512,1511,1,3,0,0,1,161,161,161,161
Nevada,57,2023-01-17,27,27,27,0,604,607,606,1,4,0,0,2,136,136,136,136
Orange,57,2023-01-17,1392,1399,1399,0,24537,24644,24643,1,238,38,38,34,7913,7913,7875,7875
Placer,57,2023-01-17,163,163,163,0,2589,2603,2602,1,62,0,0,7,678,678,678,678
Plumas,57,2023-01-17,2,2,2,0,84,85,84,1,1,0,0,0,14,14,14,14
Riverside,57,2023-01-17,1189,1194,1194,0,16842,16916,16915,1,151,14,14,29,6789,6789,6775,6775
Sacramento,57,2023-01-17,555,555,555,0,12284,12339,12338,1,152,13,13,25,3510,3510,3497,3497
San Benito,57,2023-01-17,30,30,30,0,491,493,492,1,1,1,1,0,110,110,109,109
San Bernardino,57,2023-01-17,1032,1037,1037,0,17663,17741,17740,1,149,2,2,28,8132,8132,8130,8130
San Diego,57,2023-01-17,2057,2066,2066,0,29707,29839,29838,1,306,14,14,34,5764,5764,5750,5750
San Francisco,57,2023-01-17,433,433,433,0,10688,10735,10734,1,71,2,2,13,1162,1162,1160,1160
San Joaquin,57,2023-01-17,335,335,335,0,8525,8563,8562,1,58,8,8,7,2416,2416,2408,2408
San Luis Obispo,57,2023-01-17,120,120,120,0,1910,1920,1919,1,9,2,2,3,553,553,551,551
San Mateo,57,2023-01-17,376,376,376,0,7950,7987,7986,1,36,0,0,2,742,742,742,742
Santa Barbara,57,2023-01-17,245,245,245,0,4124,4144,4143,1,36,2,2,2,755,755,753,753
Santa Clara,57,2023-01-17,1101,1106,1106,0,24628,24737,24736,1,135,14,14,21,2682,2682,2668,2668
Santa Cruz,57,2023-01-17,159,159,159,0,7347,7381,7380,1,26,0,0,0,276,276,276,276
Shasta,57,2023-01-17,40,40,40,0,740,744,743,1,16,3,3,1,605,605,602,602
Siskiyou,57,2023-01-17,6,6,6,0,206,207,206,1,1,0,0,0,95,95,95,95
Solano,57,2023-01-17,205,205,205,0,3764,3781,3780,1,48,0,0,5,474,474,474,474
Sonoma,57,2023-01-17,192,192,192,0,3943,3961,3960,1,29,5,5,3,551,551,546,546
Stanislaus,57,2023-01-17,194,194,194,0,4383,4402,4401,1,66,3,3,8,1836,1836,1833,1833
Sutter,57,2023-01-17,43,43,43,0,710,712,711,1,0,1,1,0,235,235,234,234
Tehama,57,2023-01-17,17,17,17,0,341,342,341,1,1,0,0,0,231,231,231,231
Trinity,57,2023-01-17,3,3,3,0,23,24,23,1,0,0,0,0,22,22,22,22
Tulare,57,2023-01-17,246,246,246,0,4179,4199,4198,1,47,4,4,3,1576,1576,1572,1572
Tuolumne,57,2023-01-17,43,43,43,0,538,540,539,1,0,2,2,0,210,210,208,208
Ventura,57,2023-01-17,398,398,398,0,8052,8090,8089,1,57,3,3,10,1657,1657,1654,1654
Yolo,57,2023-01-17,80,80,80,0,1258,1266,1265,1,2,3,3,0,439,439,436,436
Yuba,57,2023-01-17,32,32,32,0,608,611,610,1,3,0,0,2,122,122,122,122
Alameda,58,2023-01-24,725,730,730,0,20007,20104,20103,1,74,13,13,10,2183,2183,2170,2170
Amador,58,2023-01-24,31,31,31,0,692,695,694,1,1,1,1,0,98,98,97,97
Butte,58,2023-01-24,41,41,41,0,1066,1072,1071,1,14,1,1,3,486,486,485,485
Calaveras,58,2023-01-24,14,14,14,0,283,284,283,1,0,0,0,0,139,139,139,139
Colusa,58,2023-01-24,10,10,10,0,142,143,142,1,1,0,0,0,22,22,22,22
Contra Costa,58,2023-01-24,525,525,525,0,13087,13150,13149,1,44,8,8,10,1544,1544,1536,1536
Del Norte,58,2023-01-24,25,25,25,0,362,363,362,1,1,0,0,0,58,58,58,58
El Dorado,58,2023-01-24,46,46,46,0,1126,1132,1131,1,2,1,1,1,243,243,242,242
Fresno,58,2023-01-24,443,443,443,0,9943,9993,9992,1,116,6,6,21,2984,2984,2978,2978
Glenn,58,2023-01-24,3,3,3,0,157,158,157,1,0,0,0,0,53,53,53,53
Humboldt,58,2023-01-24,29,29,29,0,536,537,536,1,7,1,1,3,169,169,168,168
Imperial,58,2023-01-24,102,102,102,0,2269,2282,2281,1,14,0,0,1,977,977,977,977
Inyo,58,2023-01-24,6,6,6,0,160,161,160,1,0,0,0,0,63,63,63,63
Kern,58,2023-01-24,320,320,320,0,9299,9346,9345,1,35,5,5,7,2477,2477,2472,2472
Kings,58,2023-01-24,127,127,127,0,2103,2115,2114,1,4,1,1,0,482,482,481,481
Lake,58,2023-01-24,25,25,25,0,600,603,602,1,2,1,1,2,157,157,156,156
Lassen,58,2023-01-24,4,4,4,0,485,487,486,1,0,0,0,0,64,64,64,64
Los Angeles,58,2023-01-24,5482,5510,5510,0,160367,161152,161150,2,661,112,112,94,35236,35236,35124,35124
Madera,58,2023-01-24,52,52,52,0,1402,1410,1409,1,6,0,0,2,375,375,375,375
Marin,58,2023-01-24,105,105,105,0,2374,2387,2386,1,14,0,0,2,317,317,317,317
Mariposa,58,2023-01-24,8,8,8,0,108,109,108,1,0,0,0,0,31,31,31,31
Mendocino,58,2023-01-24,18,18,18,0,512,514,513,1,2,0,0,1,142,142,142,142
Merced,58,2023-01-24,120,120,120,0,1842,1852,1851,1,8,2,2,4,903,903,901,901
Modoc,58,2023-01-24,1,1,1,0,7,8,7,1,1,0,0,0,9,9,9,9
Mono,58,2023-01-24,5,5,5,0,72,73,72,1,0,0,0,0,8,8,8,8
Monterey,58,2023-01-24,108,108,108,0,2743,2757,2756,1,13,1,1,1,796,796,795,795
Napa,58,2023-01-24,69,69,69,0,1452,1459,1458,1,5,0,0,0,161,161,161,161
Nevada,58,2023-01-24,22,22,22,0,568,571,570,1,2,0,0,1,136,136,136,136
Orange,58,2023-01-24,1153,1159,1159,0,23356,23470,23469,1,160,25,25,29,7938,7938,7913,7913
Placer,58,2023-01-24,132,132,132,0,2745,2759,2758,1,49,1,1,6,679,679,678,678
Plumas,58,2023-01-24,7,7,7,0,82,83,82,1,1,0,0,0,14,14,14,14
Riverside,58,2023-01-24,988,994,994,0,16163,16242,16241,1,102,13,13,24,6802,6802,6789,6789
Sacramento,58,2023-01-24,613,616,616,0,13580,13648,13647,1,123,9,9,19,3519,3519,3510,3510
San Benito,58,2023-01-24,27,27,27,0,532,534,533,1,0,0,0,0,110,110,110,110
San Bernardino,58,2023-01-24,966,972,972,0,17884,17971,17970,1,130,1,1,62,8133,8133,8132,8132
San Diego,58,2023-01-24,1931,1942,1942,0,32284,32443,32442,1,254,8,8,39,5772,5772,5764,5764
San Francisco,58,2023-01-24,437,437,437,0,10872,10924,10923,1,54,6,6,4,1168,1168,1162,1162
San Joaquin,58,2023-01-24,250,250,250,0,8384,8425,8424,1,33,3,3,10,2419,2419,2416,2416
San Luis Obispo,58,2023-01-24,104,104,104,0,1866,1876,1875,1,6,4,4,0,557,557,553,553
San Mateo,58,2023-01-24,369,369,369,0,8432,8475,8474,1,21,0,0,2,742,742,742,742
Santa Barbara,58,2023-01-24,218,218,218,0,4268,4291,4290,1,28,2,2,4,757,757,755,755
Santa Clara,58,2023-01-24,993,1000,1000,0,23303,23418,23417,1,115,6,6,26,2688,2688,2682,2682
Santa Cruz,58,2023-01-24,108,108,108,0,9413,9461,9460,1,17,0,0,0,276,276,276,276
Shasta,58,2023-01-24,26,26,26,0,743,747,746,1,6,1,1,1,606,606,605,605
Siskiyou,58,2023-01-24,7,7,7,0,183,184,183,1,0,0,0,0,95,95,95,95
Solano,58,2023-01-24,231,231,231,0,4173,4194,4193,1,32,0,0,0,474,474,474,474
Sonoma,58,2023-01-24,186,186,186,0,4092,4112,4111,1,26,0,0,3,551,551,551,551
Stanislaus,58,2023-01-24,182,182,182,0,4188,4210,4209,1,52,2,2,6,1838,1838,1836,1836
Sutter,58,2023-01-24,38,38,38,0,733,738,737,1,0,0,0,0,235,235,235,235
Tehama,58,2023-01-24,15,15,15,0,344,345,344,1,1,0,0,0,231,231,231,231
Trinity,58,2023-01-24,4,4,4,0,28,29,28,1,0,1,1,0,23,23,22,22
Tulare,58,2023-01-24,221,221,221,0,4049,4070,4069,1,32,3,3,3,1579,1579,1576,1576
Tuolumne,58,2023-01-24,40,40,40,0,545,547,546,1,0,1,1,1,211,211,210,210
Ventura,58,2023-01-24,373,373,373,0,8242,8283,8282,1,55,7,7,4,1664,1664,1657,1657
Yolo,58,2023-01-24,81,81,81,0,1271,1279,1278,1,3,2,2,0,441,441,439,439
Yuba,58,2023-01-24,29,29,29,0,722,727,726,1,3,0,0,0,122,122,122,122
Alameda,59,2023-01-31,878,883,883,0,18565,18663,18662,1,81,1,1,6,2184,2184,2183,2183
Amador,59,2023-01-31,28,28,28,0,624,627,626,1,2,0,0,0,98,98,98,98
Butte,59,2023-01-31,55,55,55,0,1099,1105,1104,1,14,2,2,1,488,488,486,486
Calaveras,59,2023-01-31,17,17,17,0,313,314,313,1,0,1,1,0,140,140,139,139
Colusa,59,2023-01-31,7,7,7,0,172,173,172,1,0,0,0,0,22,22,22,22
Contra Costa,59,2023-01-31,679,684,684,0,12221,12286,12285,1,31,7,7,9,1551,1551,1544,1544
Del Norte,59,2023-01-31,37,37,37,0,413,415,414,1,2,1,1,0,59,59,58,58
El Dorado,59,2023-01-31,58,58,58,0,1206,1214,1213,1,3,1,1,0,244,244,243,243
Fresno,59,2023-01-31,446,446,446,0,9855,9909,9908,1,111,8,8,10,2992,2992,2984,2984
Glenn,59,2023-01-31,4,4,4,0,155,156,155,1,0,0,0,0,53,53,53,53
Humboldt,59,2023-01-31,34,34,34,0,552,554,553,1,5,0,0,1,169,169,169,169
Imperial,59,2023-01-31,93,93,93,0,2055,2068,2067,1,7,1,1,1,978,978,977,977
Inyo,59,2023-01-31,11,11,11,0,197,198,197,1,0,0,0,0,63,63,63,63
Kern,59,2023-01-31,295,295,295,0,8887,8935,8934,1,40,3,3,5,2480,2480,2477,2477
Kings,59,2023-01-31,129,129,129,0,2208,2221,2220,1,7,0,0,1,482,482,482,482
Lake,59,2023-01-31,21,21,21,0,511,514,513,1,5,2,2,0,159,159,157,157
Lassen,59,2023-01-31,3,3,3,0,518,521,520,1,0,0,0,0,64,64,64,64
Los Angeles,59,2023-01-31,5871,5901,5901,0,149252,150042,150040,2,667,106,106,80,35342,35342,35236,35236
Madera,59,2023-01-31,48,48,48,0,1482,1491,1490,1,8,0,0,0,375,375,375,375
Marin,59,2023-01-31,114,114,114,0,2206,2220,2219,1,18,0,0,2,317,317,317,317
Mariposa,59,2023-01-31,2,2,2,0,101,102,101,1,0,0,0,0,31,31,31,31
Mendocino,59,2023-01-31,30,30,30,0,511,514,513,1,2,0,0,2,142,142,142,142
Merced,59,2023-01-31,144,144,144,0,1854,1865,1864,1,11,0,0,2,903,903,903,903
Modoc,59,2023-01-31,1,1,1,0,9,10,9,1,0,0,0,0,9,9,9,9
Mono,59,2023-01-31,3,3,3,0,83,84,83,1,0,0,0,0,8,8,8,8
Monterey,59,2023-01-31,165,165,165,0,2841,2857,2856,1,12,3,3,0,799,799,796,796
Napa,59,2023-01-31,81,81,81,0,1358,1366,1365,1,6,0,0,0,161,161,161,161
Nevada,59,2023-01-31,25,25,25,0,586,590,589,1,2,0,0,0,136,136,136,136
Orange,59,2023-01-31,1198,1205,1205,0,22543,22663,22662,1,157,16,16,25,7954,7954,7938,7938
Placer,59,2023-01-31,181,181,181,0,2728,2744,2743,1,51,2,2,6,681,681,679,679
Plumas,59,2023-01-31,1,1,1,0,72,73,72,1,0,1,1,0,15,15,14,14
Riverside,59,2023-01-31,1096,1103,1103,0,15859,15943,15942,1,86,3,3,17,6805,6805,6802,6802
Sacramento,59,2023-01-31,668,672,672,0,13358,13429,13428,1,119,6,6,16,3525,3525,3519,3519
San Benito,59,2023-01-31,30,30,30,0,562,565,564,1,1,0,0,0,110,110,110,110
San Bernardino,59,2023-01-31,930,936,936,0,17565,17658,17657,1,132,0,0,19,8133,8133,8133,8133
San Diego,59,2023-01-31,1872,1883,1883,0,29874,30034,30033,1,235,11,11,29,5783,5783,5772,5772
San Francisco,59,2023-01-31,490,490,490,0,10763,10820,10819,1,50,2,2,4,1170,1170,1168,1168
San Joaquin,59,2023-01-31,309,309,309,0,7468,7508,7507,1,32,4,4,4,2423,2423,2419,2419
San Luis Obispo,59,2023-01-31,135,135,135,0,1907,1918,1917,1,12,5,5,0,562,562,557,557
San Mateo,59,2023-01-31,438,438,438,0,8692,8739,8738,1,29,0,0,1,742,742,742,742
Santa Barbara,59,2023-01-31,219,219,219,0,4311,4335,4334,1,22,2,2,2,759,759,757,757
Santa Clara,59,2023-01-31,1210,1217,1217,0,23619,23744,23743,1,124,7,7,22,2695,2695,2688,2688
Santa Cruz,59,2023-01-31,139,139,139,0,9432,9484,9483,1,11,0,0,0,276,276,276,276
Shasta,59,2023-01-31,17,17,17,0,618,622,621,1,7,0,0,0,606,606,606,606
Siskiyou,59,2023-01-31,7,7,7,0,192,193,192,1,0,0,0,0,95,95,95,95
Solano,59,2023-01-31,240,240,240,0,4077,4099,4098,1,37,0,0,2,474,474,474,474
Sonoma,59,2023-01-31,178,178,178,0,3534,3553,3552,1,22,2,2,1,553,553,551,551
Stanislaus,59,2023-01-31,235,235,235,0,4136,4159,4158,1,44,2,2,6,1840,1840,1838,1838
Sutter,59,2023-01-31,36,36,36,0,639,642,641,1,0,1,1,0,236,236,235,235
Tehama,59,2023-01-31,9,9,9,0,314,315,314,1,1,1,1,0,232,232,231,231
Trinity,59,2023-01-31,7,7,7,0,28,29,28,1,0,0,0,0,23,23,23,23
Tulare,59,2023-01-31,262,262,262,0,4033,4055,4054,1,23,3,3,1,1582,1582,1579,1579
Tuolumne,59,2023-01-31,43,43,43,0,557,560,559,1,3,0,0,0,211,211,211,211
Ventura,59,2023-01-31,342,342,342,0,7608,7648,7647,1,41,5,5,7,1669,1669,1664,1664
Yolo,59,2023-01-31,81,81,81,0,1288,1296,1295,1,3,1,1,0,442,442,441,441
Yuba,59,2023-01-31,29,29,29,0,627,632,631,1,3,0,0,1,122,122,122,122
Alameda,60,2023-02-07,1163,1170,1170,0,18221,18332,18331,1,85,4,4,8,2188,2188,2184,2184
Amador,60,2023-02-07,22,22,22,0,509,512,511,1,1,0,0,0,98,98,98,98
Butte,60,2023-02-07,99,99,99,0,1294,1303,1302,1,21,0,0,1,488,488,488,488
Calaveras,60,2023-02-07,15,15,15,0,333,334,333,1,0,0,0,0,140,140,140,140
Colusa,60,2023-02-07,6,6,6,0,183,184,183,1,0,0,0,0,22,22,22,22
Contra Costa,60,2023-02-07,719,724,724,0,11624,11695,11694,1,46,3,3,8,1554,1554,1551,1551
Del Norte,60,2023-02-07,51,51,51,0,348,349,348,1,0,0,0,0,59,59,59,59
El Dorado,60,2023-02-07,63,63,63,0,1063,1070,1069,1,2,0,0,0,244,244,244,244
Fresno,60,2023-02-07,519,521,521,0,8970,9028,9027,1,87,4,4,16,2996,2996,2992,2992
Glenn,60,2023-02-07,10,10,10,0,171,173,172,1,0,0,0,0,53,53,53,53
Humboldt,60,2023-02-07,55,55,55,0,581,586,585,1,5,1,1,1,170,170,169,169
Imperial,60,2023-02-07,137,137,137,0,2018,2032,2031,1,7,1,1,0,979,979,978,978
Inyo,60,2023-02-07,10,10,10,0,200,201,200,1,0,0,0,0,63,63,63,63
Kern,60,2023-02-07,321,321,321,0,8420,8472,8471,1,26,1,1,4,2481,2481,2480,2480
Kings,60,2023-02-07,120,120,120,0,1920,1933,1932,1,4,0,0,0,482,482,482,482
Lake,60,2023-02-07,28,28,28,0,595,600,599,1,4,1,1,0,160,160,159,159
Lassen,60,2023-02-07,6,6,6,0,362,364,363,1,0,0,0,0,64,64,64,64
Los Angeles,60,2023-02-07,5809,5844,5844,0,138793,139642,139640,2,697,84,84,76,35426,35426,35342,35342
Madera,60,2023-02-07,59,59,59,0,1233,1241,1240,1,5,1,1,0,376,376,375,375
Marin,60,2023-02-07,141,141,141,0,2009,2022,2021,1,9,0,0,2,317,317,317,317
Mariposa,60,2023-02-07,2,2,2,0,106,107,106,1,0,0,0,0,31,31,31,31
Mendocino,60,2023-02-07,32,32,32,0,527,531,530,1,7,1,1,1,143,143,142,142
Merced,60,2023-02-07,171,171,171,0,1878,1892,1891,1,13,0,0,0,903,903,903,903
Modoc,60,2023-02-07,1,1,1,0,5,6,5,1,0,0,0,0,9,9,9,9
Mono,60,2023-02-07,2,2,2,0,79,80,79,1,0,0,0,0,8,8,8,8
Monterey,60,2023-02-07,240,240,240,0,2876,2894,2893,1,22,2,2,2,801,801,799,799
Napa,60,2023-02-07,112,112,112,0,1388,1396,1395,1,4,0,0,2,161,161,161,161
Nevada,60,2023-02-07,30,30,30,0,572,576,575,1,5,0,0,0,136,136,136,136
Orange,60,2023-02-07,1341,1350,1350,0,22012,22147,22146,1,153,20,20,18,7974,7974,7954,7954
Placer,60,2023-02-07,154,154,154,0,2646,2662,2661,1,54,0,0,3,681,681,681,681
Plumas,60,2023-02-07,2,2,2,0,73,74,73,1,0,0,0,0,15,15,15,15
Riverside,60,2023-02-07,1104,1111,1111,0,15447,15540,15539,1,88,6,6,9,6811,6811,6805,6805
Sacramento,60,2023-02-07,742,747,747,0,13159,13240,13239,1,98,4,4,17,3529,3529,3525,3525
San Benito,60,2023-02-07,54,54,54,0,552,555,554,1,1,0,0,0,110,110,110,110
San Bernardino,60,2023-02-07,1082,1089,1089,0,17189,17297,17296,1,136,0,0,21,8133,8133,8133,8133
San Diego,60,2023-02-07,1930,1942,1942,0,30324,30512,30511,1,239,7,7,18,5790,5790,5783,5783
San Francisco,60,2023-02-07,562,565,565,0,10473,10537,10536,1,55,4,4,2,1174,1174,1170,1170
San Joaquin,60,2023-02-07,454,455,455,0,6764,6805,6804,1,47,0,0,3,2423,2423,2423,2423
San Luis Obispo,60,2023-02-07,153,153,153,0,1856,1870,1869,1,8,1,1,0,563,563,562,562
San Mateo,60,2023-02-07,536,539,539,0,8115,8166,8165,1,40,0,0,4,742,742,742,742
Santa Barbara,60,2023-02-07,239,239,239,0,4228,4254,4253,1,23,0,0,1,759,759,759,759
Santa Clara,60,2023-02-07,1300,1308,1308,0,22859,22999,22998,1,125,8,8,24,2703,2703,2695,2695
Santa Cruz,60,2023-02-07,233,233,233,0,10588,10652,10651,1,12,0,0,3,276,276,276,276
Shasta,60,2023-02-07,23,23,23,0,668,673,672,1,5,0,0,0,606,606,606,606
Siskiyou,60,2023-02-07,12,12,12,0,215,216,215,1,0,0,0,0,95,95,95,95
Solano,60,2023-02-07,299,299,299,0,3851,3874,3873,1,40,0,0,4,474,474,474,474
Sonoma,60,2023-02-07,261,261,261,0,3560,3582,3581,1,15,2,2,2,555,555,553,553
Stanislaus,60,2023-02-07,279,279,279,0,3925,3950,3949,1,43,2,2,6,1842,1842,1840,1840
Sutter,60,2023-02-07,52,52,52,0,676,682,681,1,0,0,0,0,236,236,236,236
Tehama,60,2023-02-07,16,16,16,0,352,353,352,1,1,0,0,0,232,232,232,232
Trinity,60,2023-02-07,1,1,1,0,19,20,19,1,0,0,0,0,23,23,23,23
Tulare,60,2023-02-07,269,269,269,0,4390,4418,4417,1,26,2,2,4,1584,1584,1582,1582
Tuolumne,60,2023-02-07,45,45,45,0,508,511,510,1,2,0,0,0,211,211,211,211
Ventura,60,2023-02-07,342,342,342,0,6849,6892,6891,1,41,4,4,5,1673,1673,1669,1669
Yolo,60,2023-02-07,91,91,91,0,1309,1319,1318,1,4,1,1,2,443,443,442,442
Yuba,60,2023-02-07,28,28,28,0,637,642,641,1,4,0,0,1,122,122,122,122
Alameda,61,2023-02-14,1099,1106,1106,0,17569,17694,17693,1,91,3,3,8,2191,2191,2188,2188
Amador,61,2023-02-14,23,23,23,0,503,508,507,1,0,0,0,0,98,98,98,98
Butte,61,2023-02-14,73,73,73,0,1204,1213,1212,1,21,1,1,2,489,489,488,488
Calaveras,61,2023-02-14,11,11,11,0,291,292,291,1,1,0,0,0,140,140,140,140
Colusa,61,2023-02-14,7,7,7,0,140,141,140,1,1,0,0,0,22,22,22,22
Contra Costa,61,2023-02-14,702,708,708,0,11381,11462,11461,1,41,1,1,7,1555,1555,1554,1554
Del Norte,61,2023-02-14,18,18,18,0,291,292,291,1,2,0,0,0,59,59,59,59
El Dorado,61,2023-02-14,63,63,63,0,1065,1074,1073,1,1,0,0,0,244,244,244,244
Fresno,61,2023-02-14,467,471,471,0,8594,8656,8655,1,110,3,3,4,2999,2999,2996,2996
Glenn,61,2023-02-14,10,10,10,0,172,174,173,1,8,0,0,0,53,53,53,53
Humboldt,61,2023-02-14,36,36,36,0,589,595,594,1,6,0,0,1,170,170,170,170
Imperial,61,2023-02-14,124,124,124,0,1770,1784,1783,1,7,1,1,0,980,980,979,979
Inyo,61,2023-02-14,5,5,5,0,205,206,205,1,0,0,0,0,63,63,63,63
Kern,61,2023-02-14,343,343,343,0,8144,8205,8204,1,40,1,1,5,2482,2482,2481,2481
Kings,61,2023-02-14,91,91,91,0,1863,1878,1877,1,4,1,1,0,483,483,482,482
Lake,61,2023-02-14,20,20,20,0,543,548,547,1,2,1,1,0,161,161,160,160
Lassen,61,2023-02-14,5,5,5,0,328,330,329,1,0,0,0,0,64,64,64,64
Los Angeles,61,2023-02-14,5902,5945,5945,0,129243,130170,130169,1,616,83,87,73,35509,35513,35426,35426
Madera,61,2023-02-14,60,60,60,0,1230,1240,1239,1,8,0,0,2,376,376,376,376
Marin,61,2023-02-14,137,137,137,0,1879,1893,1892,1,19,0,0,2,317,317,317,317
Mariposa,61,2023-02-14,5,5,5,0,108,109,108,1,0,0,0,0,31,31,31,31
Mendocino,61,2023-02-14,24,24,24,0,535,540,539,1,3,1,1,1,144,144,143,143
Merced,61,2023-02-14,166,166,166,0,1817,1831,1830,1,6,0,0,1,903,903,903,903
Modoc,61,2023-02-14,0,0,0,0,4,5,4,1,0,0,0,0,9,9,9,9
Mono,61,2023-02-14,1,1,1,0,67,68,67,1,0,0,0,0,8,8,8,8
Monterey,61,2023-02-14,204,204,204,0,2485,2502,2501,1,16,2,2,1,803,803,801,801
Napa,61,2023-02-14,97,97,97,0,1316,1327,1326,1,2,1,1,0,162,162,161,161
Nevada,61,2023-02-14,39,39,39,0,622,628,627,1,5,0,0,1,136,136,136,136
Orange,61,2023-02-14,1389,1399,1399,0,20351,20499,20498,1,154,14,14,26,7988,7988,7974,7974
Placer,61,2023-02-14,169,169,169,0,2636,2657,2656,1,41,0,0,5,681,681,681,681
Plumas,61,2023-02-14,3,3,3,0,83,84,83,1,0,0,0,0,15,15,15,15
Riverside,61,2023-02-14,1088,1096,1096,0,15814,15927,15926,1,96,6,6,12,6817,6817,6811,6811
Sacramento,61,2023-02-14,819,826,826,0,12912,13003,13002,1,115,6,6,19,3535,3535,3529,3529
San Benito,61,2023-02-14,41,41,41,0,556,562,561,1,2,0,0,0,110,110,110,110
San Bernardino,61,2023-02-14,997,1005,1005,0,16655,16776,16775,1,127,0,0,21,8133,8133,8133,8133
San Diego,61,2023-02-14,1938,1951,1951,0,28963,29172,29171,1,212,4,4,30,5794,5794,5790,5790
San Francisco,61,2023-02-14,612,618,618,0,10660,10735,10734,1,58,2,2,6,1176,1176,1174,1174
San Joaquin,61,2023-02-14,457,460,460,0,7000,7051,7050,1,41,1,1,4,2424,2424,2423,2423
San Luis Obispo,61,2023-02-14,135,135,135,0,1623,1637,1636,1,11,0,0,1,563,563,563,563
San Mateo,61,2023-02-14,510,513,513,0,8200,8258,8257,1,36,0,0,4,742,742,742,742
Santa Barbara,61,2023-02-14,194,194,194,0,3919,3948,3947,1,18,1,1,3,760,760,759,759
Santa Clara,61,2023-02-14,1371,1382,1382,0,22716,22880,22879,1,110,10,10,24,2713,2713,2703,2703
Santa Cruz,61,2023-02-14,210,210,210,0,9375,9443,9442,1,16,0,0,0,276,276,276,276
Shasta,61,2023-02-14,33,33,33,0,688,694,693,1,8,0,0,0,606,606,606,606
Siskiyou,61,2023-02-14,10,10,10,0,203,204,203,1,0,0,0,0,95,95,95,95
Solano,61,2023-02-14,255,255,255,0,3680,3707,3706,1,29,0,0,3,474,474,474,474
Sonoma,61,2023-02-14,231,231,231,0,3373,3398,3397,1,36,1,1,1,556,556,555,555
Stanislaus,61,2023-02-14,274,274,274,0,3700,3727,3726,1,50,0,0,8,1842,1842,1842,1842
Sutter,61,2023-02-14,48,48,48,0,596,602,601,1,0,1,1,0,237,237,236,236
Tehama,61,2023-02-14,14,14,14,0,318,319,318,1,1,2,2,0,234,234,232,232
Trinity,61,2023-02-14,1,1,1,0,28,29,28,1,0,0,0,0,23,23,23,23
Tulare,61,2023-02-14,243,243,243,0,4105,4135,4134,1,29,3,3,0,1587,1587,1584,1584
Tuolumne,61,2023-02-14,39,39,39,0,504,508,507,1,3,0,0,0,211,211,211,211
Ventura,61,2023-02-14,301,301,301,0,6606,6655,6654,1,37,2,2,7,1675,1675,1673,1673
Yolo,61,2023-02-14,69,69,69,0,1175,1186,1185,1,1,1,1,0,444,444,443,443
Yuba,61,2023-02-14,27,27,27,0,598,604,603,1,6,0,0,0,122,122,122,122
Alameda,62,2023-02-21,1079,1087,1087,0,16447,16585,16584,1,75,4,4,5,2195,2195,2191,2191
Amador,62,2023-02-21,24,24,24,0,524,531,530,1,1,0,0,1,98,98,98,98
Butte,62,2023-02-21,42,42,42,0,1048,1057,1056,1,9,2,2,1,491,491,489,489
Calaveras,62,2023-02-21,21,21,21,0,298,300,299,1,1,0,0,0,140,140,140,140
Colusa,62,2023-02-21,14,14,14,0,91,92,91,1,0,0,0,0,22,22,22,22
Contra Costa,62,2023-02-21,682,689,689,0,10727,10818,10817,1,52,5,5,10,1560,1560,1555,1555
Del Norte,62,2023-02-21,10,10,10,0,277,279,278,1,2,0,0,0,59,59,59,59
El Dorado,62,2023-02-21,47,47,47,0,1012,1022,1021,1,0,1,1,1,245,245,244,244
Fresno,62,2023-02-21,480,485,485,0,8583,8657,8656,1,95,5,5,19,3004,3004,2999,2999
Glenn,62,2023-02-21,6,6,6,0,150,152,151,1,5,0,0,0,53,53,53,53
Humboldt,62,2023-02-21,31,31,31,0,549,556,555,1,3,0,0,0,170,170,170,170
Imperial,62,2023-02-21,139,139,139,0,1830,1846,1845,1,10,0,0,0,980,980,980,980
Inyo,62,2023-02-21,6,6,6,0,137,138,137,1,0,0,0,0,63,63,63,63
Kern,62,2023-02-21,405,407,407,0,7794,7860,7859,1,38,4,4,5,2486,2486,2482,2482
Kings,62,2023-02-21,72,72,72,0,1682,1697,1696,1,6,1,1,0,484,484,483,483
Lake,62,2023-02-21,17,17,17,0,478,483,482,1,2,0,0,1,161,161,161,161
Lassen,62,2023-02-21,1,1,1,0,372,374,373,1,0,0,0,0,64,64,64,64
Los Angeles,62,2023-02-21,5795,5844,5844,0,123708,124744,124743,1,624,72,76,74,35581,35589,35509,35513
Madera,62,2023-02-21,70,70,70,0,1158,1169,1168,1,5,0,0,2,376,376,376,376
Marin,62,2023-02-21,157,157,157,0,1838,1854,1853,1,13,0,0,3,317,317,317,317
Mariposa,62,2023-02-21,7,7,7,0,121,122,121,1,0,0,0,0,31,31,31,31
Mendocino,62,2023-02-21,25,25,25,0,489,495,494,1,8,0,0,0,144,144,144,144
Merced,62,2023-02-21,115,115,115,0,1850,1867,1866,1,19,0,0,1,903,903,903,903
Modoc,62,2023-02-21,1,1,1,0,14,15,14,1,0,0,0,0,9,9,9,9
Mono,62,2023-02-21,4,4,4,0,57,58,57,1,0,0,0,0,8,8,8,8
Monterey,62,2023-02-21,171,171,171,0,2394,2416,2415,1,28,0,0,0,803,803,803,803
Napa,62,2023-02-21,72,72,72,0,1166,1176,1175,1,6,3,3,0,165,165,162,162
Nevada,62,2023-02-21,29,29,29,0,634,641,640,1,5,1,1,1,137,137,136,136
Orange,62,2023-02-21,1366,1377,1377,0,19469,19632,19631,1,162,16,16,20,8004,8004,7988,7988
Placer,62,2023-02-21,159,159,159,0,2321,2342,2341,1,44,1,1,4,682,682,681,681
Plumas,62,2023-02-21,10,10,10,0,85,86,85,1,1,0,0,0,15,15,15,15
Riverside,62,2023-02-21,989,996,996,0,15824,15956,15955,1,86,8,8,10,6825,6825,6817,6817
Sacramento,62,2023-02-21,767,774,774,0,11804,11903,11902,1,106,14,14,13,3549,3549,3535,3535
San Benito,62,2023-02-21,29,29,29,0,478,483,482,1,1,2,2,0,112,112,110,110
San Bernardino,62,2023-02-21,949,957,957,0,15607,15738,15737,1,119,0,0,20,8133,8133,8133,8133
San Diego,62,2023-02-21,1823,1837,1837,0,25793,26011,26010,1,257,7,7,20,5801,5801,5794,5794
San Francisco,62,2023-02-21,623,630,630,0,10308,10394,10393,1,83,1,1,6,1177,1177,1176,1176
San Joaquin,62,2023-02-21,420,423,423,0,7899,7967,7966,1,43,1,1,3,2425,2425,2424,2424
San Luis Obispo,62,2023-02-21,85,85,85,0,1542,1556,1555,1,12,0,0,0,563,563,563,563
San Mateo,62,2023-02-21,475,480,480,0,7353,7416,7415,1,47,0,0,1,742,742,742,742
Santa Barbara,62,2023-02-21,212,212,212,0,3600,3632,3631,1,18,0,0,3,760,760,760,760
Santa Clara,62,2023-02-21,1273,1284,1284,0,19764,19930,19929,1,108,12,12,32,2725,2725,2713,2713
Santa Cruz,62,2023-02-21,165,165,165,0,6240,6293,6292,1,20,0,0,2,276,276,276,276
Shasta,62,2023-02-21,18,18,18,0,703,709,708,1,3,0,0,0,606,606,606,606
Siskiyou,62,2023-02-21,12,12,12,0,196,197,196,1,0,0,0,0,95,95,95,95
Solano,62,2023-02-21,255,256,256,0,3481,3510,3509,1,26,0,0,1,474,474,474,474
Sonoma,62,2023-02-21,267,267,267,0,3297,3326,3325,1,28,1,1,3,557,557,556,556
Stanislaus,62,2023-02-21,268,268,268,0,3728,3760,3759,1,64,0,0,4,1842,1842,1842,1842
Sutter,62,2023-02-21,38,38,38,0,531,536,535,1,0,1,1,0,238,238,237,237
Tehama,62,2023-02-21,14,14,14,0,290,291,290,1,0,0,0,0,234,234,234,234
Trinity,62,2023-02-21,0,0,0,0,25,26,25,1,0,0,0,0,23,23,23,23
Tulare,62,2023-02-21,227,227,227,0,4068,4103,4102,1,21,0,0,2,1587,1587,1587,1587
Tuolumne,62,2023-02-21,29,29,29,0,499,505,504,1,0,0,0,0,211,211,211,211
Ventura,62,2023-02-21,303,304,304,0,5732,5780,5779,1,34,4,4,8,1679,1679,1675,1675
Yolo,62,2023-02-21,92,92,92,0,1344,1355,1354,1,2,1,1,1,445,445,444,444
Yuba,62,2023-02-21,26,26,26,0,525,531,530,1,3,0,0,1,122,122,122,122
Alameda,63,2023-02-28,1042,1053,1053,0,17651,17824,17823,1,76,5,5,14,2200,2200,2195,2195
Amador,63,2023-02-28,14,14,14,0,487,493,492,1,2,0,0,0,98,98,98,98
Butte,63,2023-02-28,54,54,54,0,815,824,823,1,10,1,1,1,492,492,491,491
Calaveras,63,2023-02-28,12,12,12,0,286,288,287,1,1,0,0,0,140,140,140,140
Colusa,63,2023-02-28,11,11,11,0,78,79,78,1,0,0,0,0,22,22,22,22
Contra Costa,63,2023-02-28,699,706,706,0,10667,10772,10771,1,57,4,4,8,1564,1564,1560,1560
Del Norte,63,2023-02-28,8,8,8,0,274,277,276,1,0,0,0,0,59,59,59,59
El Dorado,63,2023-02-28,60,60,60,0,1002,1013,1012,1,2,1,1,0,246,246,245,245
Fresno,63,2023-02-28,431,436,436,0,8573,8658,8657,1,99,3,3,6,3007,3007,3004,3004
Glenn,63,2023-02-28,4,4,4,0,144,146,145,1,1,0,0,0,53,53,53,53
Humboldt,63,2023-02-28,26,26,26,0,489,495,494,1,2,0,0,0,170,170,170,170
Imperial,63,2023-02-28,178,178,178,0,1773,1791,1790,1,11,0,0,1,980,980,980,980
Inyo,63,2023-02-28,3,3,3,0,177,179,178,1,0,0,0,0,63,63,63,63
Kern,63,2023-02-28,425,429,429,0,7938,8016,8015,1,38,2,2,9,2488,2488,2486,2486
Kings,63,2023-02-28,53,53,53,0,1642,1659,1658,1,4,1,1,0,485,485,484,484
Lake,63,2023-02-28,20,20,20,0,473,478,477,1,2,1,1,0,162,162,161,161
Lassen,63,2023-02-28,3,3,3,0,322,326,325,1,0,0,0,0,64,64,64,64
Los Angeles,63,2023-02-28,5175,5224,5224,0,128352,129609,129608,1,553,76,82,80,35657,35671,35581,35589
Madera,63,2023-02-28,50,50,50,0,1108,1120,1119,1,6,0,0,1,376,376,376,376
Marin,63,2023-02-28,153,153,153,0,1957,1978,1977,1,15,0,0,1,317,317,317,317
Mariposa,63,2023-02-28,4,4,4,0,85,86,85,1,0,0,0,0,31,31,31,31
Mendocino,63,2023-02-28,21,21,21,0,474,481,480,1,4,1,1,2,145,145,144,144
Merced,63,2023-02-28,131,131,131,0,1825,1843,1842,1,14,0,0,2,903,903,903,903
Modoc,63,2023-02-28,1,1,1,0,7,8,7,1,0,0,0,0,9,9,9,9
Mono,63,2023-02-28,3,3,3,0,60,61,60,1,0,0,0,0,8,8,8,8
Monterey,63,2023-02-28,166,166,166,0,2471,2496,2495,1,29,3,3,1,806,806,803,803
Napa,63,2023-02-28,68,68,68,0,1235,1249,1248,1,9,0,0,3,165,165,165,165
Nevada,63,2023-02-28,21,21,21,0,511,518,517,1,2,0,0,0,137,137,137,137
Orange,63,2023-02-28,1156,1168,1168,0,19309,19499,19498,1,158,22,22,22,8026,8026,8004,8004
Placer,63,2023-02-28,174,174,174,0,2607,2633,2632,1,39,0,0,7,682,682,682,682
Plumas,63,2023-02-28,1,1,1,0,72,73,72,1,0,0,0,0,15,15,15,15
Riverside,63,2023-02-28,897,908,908,0,14707,14850,14849,1,85,6,6,14,6831,6831,6825,6825
Sacramento,63,2023-02-28,921,930,930,0,12590,12715,12714,1,114,6,6,16,3555,3555,3549,3549
San Benito,63,2023-02-28,25,25,25,0,462,468,467,1,3,0,0,0,112,112,112,112
San Bernardino,63,2023-02-28,808,816,816,0,15892,16049,16048,1,112,0,0,22,8133,8133,8133,8133
San Diego,63,2023-02-28,1706,1723,1723,0,27069,27336,27335,1,242,6,6,22,5807,5807,5801,5801
San Francisco,63,2023-02-28,635,642,642,0,11409,11521,11520,1,75,6,6,8,1183,1183,1177,1177
San Joaquin,63,2023-02-28,394,397,397,0,7064,7134,7133,1,46,3,3,1,2428,2428,2425,2425
San Luis Obispo,63,2023-02-28,87,87,87,0,1536,1552,1551,1,12,3,3,0,566,566,563,563
San Mateo,63,2023-02-28,468,474,474,0,7444,7518,7517,1,34,0,0,5,742,742,742,742
Santa Barbara,63,2023-02-28,152,152,152,0,3555,3592,3591,1,22,3,3,4,763,763,760,760
Santa Clara,63,2023-02-28,1265,1278,1278,0,22047,22265,22264,1,120,6,6,31,2731,2731,2725,2725
Santa Cruz,63,2023-02-28,121,121,121,0,8475,8558,8557,1,15,0,0,1,276,276,276,276
Shasta,63,2023-02-28,37,37,37,0,676,684,683,1,8,0,0,1,606,606,606,606
Siskiyou,63,2023-02-28,12,12,12,0,232,233,232,1,0,0,0,0,95,95,95,95
Solano,63,2023-02-28,259,261,261,0,3416,3451,3450,1,27,0,0,8,474,474,474,474
Sonoma,63,2023-02-28,216,216,216,0,3299,3333,3332,1,34,1,1,4,558,558,557,557
Stanislaus,63,2023-02-28,245,246,246,0,3755,3792,3791,1,55,0,0,3,1842,1842,1842,1842
Sutter,63,2023-02-28,49,49,49,0,515,521,520,1,0,0,0,0,238,238,238,238
Tehama,63,2023-02-28,14,14,14,0,262,264,263,1,3,0,0,1,234,234,234,234
Trinity,63,2023-02-28,2,2,2,0,24,25,24,1,0,0,0,0,23,23,23,23
Tulare,63,2023-02-28,209,209,209,0,3729,3767,3766,1,25,3,3,2,1590,1590,1587,1587
Tuolumne,63,2023-02-28,50,50,50,0,417,422,421,1,0,0,0,1,211,211,211,211
Ventura,63,2023-02-28,256,257,257,0,5676,5733,5732,1,37,3,3,8,1682,1682,1679,1679
Yolo,63,2023-02-28,90,90,90,0,1363,1377,1376,1,2,3,3,1,448,448,445,445
Yuba,63,2023-02-28,46,46,46,0,508,515,514,1,1,0,0,0,122,122,122,122
Alameda,64,2023-03-07,915,926,926,0,16458,16643,16642,1,88,4,4,11,2204,2204,2200,2200
Amador,64,2023-03-07,16,16,16,0,451,458,457,1,0,0,0,1,98,98,98,98
Butte,64,2023-03-07,40,40,40,0,591,598,597,1,4,1,1,0,493,493,492,492
Calaveras,64,2023-03-07,24,24,24,0,276,280,279,1,0,2,2,0,142,142,140,140
Colusa,64,2023-03-07,13,13,13,0,153,156,155,1,0,0,0,0,22,22,22,22
Contra Costa,64,2023-03-07,690,697,697,0,10084,10198,10197,1,57,3,3,8,1567,1567,1564,1564
Del Norte,64,2023-03-07,4,4,4,0,250,252,251,1,0,1,1,0,60,60,59,59
El Dorado,64,2023-03-07,54,54,54,0,949,961,960,1,2,0,0,0,246,246,246,246
Fresno,64,2023-03-07,395,400,400,0,8246,8338,8337,1,74,4,4,17,3011,3011,3007,3007
Glenn,64,2023-03-07,4,4,4,0,161,163,162,1,0,0,0,0,53,53,53,53
Humboldt,64,2023-03-07,22,22,22,0,485,491,490,1,4,0,0,1,170,170,170,170
Imperial,64,2023-03-07,176,176,176,0,1768,1789,1788,1,1,0,0,7,980,980,980,980
Inyo,64,2023-03-07,2,2,2,0,145,147,146,1,1,0,0,0,63,63,63,63
Kern,64,2023-03-07,286,290,290,0,7688,7776,7775,1,38,3,3,5,2491,2491,2488,2488
Kings,64,2023-03-07,72,72,72,0,1525,1543,1542,1,1,0,0,0,485,485,485,485
Lake,64,2023-03-07,21,21,21,0,465,471,470,1,1,0,0,1,162,162,162,162
Lassen,64,2023-03-07,5,5,5,0,309,312,311,1,0,0,0,0,64,64,64,64
Los Angeles,64,2023-03-07,4300,4350,4350,0,123325,124706,124705,1,583,63,68,62,35720,35739,35657,35671
Madera,64,2023-03-07,81,81,81,0,1182,1196,1195,1,4,0,0,1,376,376,376,376
Marin,64,2023-03-07,128,128,128,0,1730,1751,1750,1,22,0,0,2,317,317,317,317
Mariposa,64,2023-03-07,1,1,1,0,72,73,72,1,0,0,0,0,31,31,31,31
Mendocino,64,2023-03-07,25,25,25,0,454,460,459,1,6,0,0,0,145,145,145,145
Merced,64,2023-03-07,138,138,138,0,1656,1677,1676,1,6,0,0,1,903,903,903,903
Modoc,64,2023-03-07,2,2,2,0,11,12,11,1,0,0,0,0,9,9,9,9
Mono,64,2023-03-07,5,5,5,0,57,58,57,1,0,0,0,0,8,8,8,8
Monterey,64,2023-03-07,134,134,134,0,2053,2077,2076,1,31,3,3,1,809,809,806,806
Napa,64,2023-03-07,53,53,53,0,1043,1056,1055,1,6,1,1,3,166,166,165,165
Nevada,64,2023-03-07,19,19,19,0,465,471,470,1,4,0,0,0,137,137,137,137
Orange,64,2023-03-07,934,945,945,0,18872,19083,19082,1,123,16,17,22,8042,8043,8026,8026
Placer,64,2023-03-07,179,179,179,0,2414,2441,2440,1,62,0,0,8,682,682,682,682
Plumas,64,2023-03-07,1,1,1,0,66,67,66,1,0,0,0,0,15,15,15,15
Riverside,64,2023-03-07,900,910,910,0,14344,14505,14504,1,85,4,4,9,6835,6835,6831,6831
Sacramento,64,2023-03-07,822,831,831,0,11595,11726,11725,1,120,4,4,6,3559,3559,3555,3555
San Benito,64,2023-03-07,14,14,14,0,443,449,448,1,1,0,0,0,112,112,112,112
San Bernardino,64,2023-03-07,751,758,758,0,14811,14978,14977,1,118,0,0,20,8133,8133,8133,8133
San Diego,64,2023-03-07,1373,1387,1387,0,24997,25279,25278,1,212,13,13,15,5820,5820,5807,5807
San Francisco,64,2023-03-07,598,605,605,0,10515,10633,10632,1,71,4,4,10,1187,1187,1183,1183
San Joaquin,64,2023-03-07,392,397,397,0,6860,6938,6937,1,49,1,1,6,2429,2429,2428,2428
San Luis Obispo,64,2023-03-07,85,85,85,0,1299,1313,1312,1,7,3,3,0,569,569,566,566
San Mateo,64,2023-03-07,409,414,414,0,7127,7207,7206,1,27,0,0,3,742,742,742,742
Santa Barbara,64,2023-03-07,151,151,151,0,3684,3726,3725,1,14,1,1,1,764,764,763,763
Santa Clara,64,2023-03-07,1062,1074,1074,0,20395,20625,20624,1,126,8,8,27,2739,2739,2731,2731
Santa Cruz,64,2023-03-07,135,135,135,0,4334,4383,4382,1,19,0,0,0,276,276,276,276
Shasta,64,2023-03-07,25,25,25,0,601,609,608,1,4,0,0,2,606,606,606,606
Siskiyou,64,2023-03-07,5,5,5,0,213,214,213,1,1,0,0,0,95,95,95,95
Solano,64,2023-03-07,262,265,265,0,3378,3418,3417,1,40,0,0,4,474,474,474,474
Sonoma,64,2023-03-07,207,207,207,0,3199,3235,3234,1,24,2,2,3,560,560,558,558
Stanislaus,64,2023-03-07,248,248,248,0,3459,3498,3497,1,60,0,0,10,1842,1842,1842,1842
Sutter,64,2023-03-07,26,26,26,0,570,579,578,1,0,0,0,0,238,238,238,238
Tehama,64,2023-03-07,12,12,12,0,240,242,241,1,5,0,0,0,234,234,234,234
Trinity,64,2023-03-07,0,0,0,0,17,18,17,1,0,0,0,0,23,23,23,23
Tulare,64,2023-03-07,209,209,209,0,3108,3144,3143,1,30,0,0,3,1590,1590,1590,1590
Tuolumne,64,2023-03-07,34,34,34,0,394,401,400,1,0,0,0,0,211,211,211,211
Ventura,64,2023-03-07,250,252,252,0,4866,4922,4921,1,40,1,1,4,1683,1683,1682,1682
Yolo,64,2023-03-07,58,58,58,0,1170,1184,1183,1,2,1,1,1,449,449,448,448
Yuba,64,2023-03-07,30,30,30,0,500,507,506,1,7,0,0,0,122,122,122,122
Alameda,65,2023-03-14,856,867,867,0,15205,15399,15398,1,69,2,2,17,2206,2206,2204,2204
Amador,65,2023-03-14,11,11,11,0,384,392,391,1,4,0,0,1,98,98,98,98
Butte,65,2023-03-14,33,33,33,0,525,533,532,1,7,1,1,2,494,494,493,493
Calaveras,65,2023-03-14,7,7,7,0,230,232,231,1,0,0,0,0,142,142,142,142
Colusa,65,2023-03-14,4,4,4,0,165,168,167,1,0,1,1,0,23,23,22,22
Contra Costa,65,2023-03-14,566,573,573,0,9836,9961,9960,1,39,2,2,5,1569,1569,1567,1567
Del Norte,65,2023-03-14,9,9,9,0,252,256,255,1,2,0,0,0,60,60,60,60
El Dorado,65,2023-03-14,50,50,50,0,906,919,918,1,0,0,0,0,246,246,246,246
Fresno,65,2023-03-14,378,384,384,0,7702,7801,7800,1,86,0,0,10,3011,3011,3011,3011
Glenn,65,2023-03-14,9,9,9,0,136,138,137,1,0,0,0,0,53,53,53,53
Humboldt,65,2023-03-14,28,28,28,0,507,515,514,1,2,0,0,1,170,170,170,170
Imperial,65,2023-03-14,211,211,211,0,1922,1947,1946,1,10,1,1,5,981,981,980,980
Inyo,65,2023-03-14,0,0,0,0,262,266,265,1,0,0,0,0,63,63,63,63
Kern,65,2023-03-14,330,335,335,0,7609,7706,7705,1,44,0,0,11,2491,2491,2491,2491
Kings,65,2023-03-14,60,60,60,0,1490,1510,1509,1,0,0,0,0,485,485,485,485
Lake,65,2023-03-14,11,11,11,0,412,418,417,1,1,0,0,0,162,162,162,162
Lassen,65,2023-03-14,5,5,5,0,335,340,339,1,0,0,0,0,64,64,64,64
Los Angeles,65,2023-03-14,3785,3834,3834,0,118637,120137,120136,1,432,74,82,55,35794,35821,35720,35739
Madera,65,2023-03-14,52,52,52,0,1133,1149,1148,1,6,0,0,0,376,376,376,376
Marin,65,2023-03-14,98,98,98,0,1707,1729,1728,1,23,0,0,1,317,317,317,317
Mariposa,65,2023-03-14,4,4,4,0,90,91,90,1,0,0,0,0,31,31,31,31
Mendocino,65,2023-03-14,17,17,17,0,452,459,458,1,6,0,0,0,145,145,145,145
Merced,65,2023-03-14,97,97,97,0,1486,1505,1504,1,11,0,0,2,903,903,903,903
Modoc,65,2023-03-14,0,0,0,0,11,12,11,1,0,0,0,0,9,9,9,9
Mono,65,2023-03-14,1,1,1,0,45,46,45,1,0,0,0,0,8,8,8,8
Monterey,65,2023-03-14,74,74,74,0,1770,1793,1792,1,24,0,0,0,809,809,809,809
Napa,65,2023-03-14,51,51,51,0,942,955,954,1,5,3,3,1,169,169,166,166
Nevada,65,2023-03-14,19,19,19,0,471,479,478,1,4,0,0,0,137,137,137,137
Orange,65,2023-03-14,886,897,897,0,17696,17921,17920,1,127,30,33,23,8072,8076,8042,8043
Placer,65,2023-03-14,154,154,154,0,2152,2180,2179,1,67,0,0,8,682,682,682,682
Plumas,65,2023-03-14,5,5,5,0,62,63,62,1,0,0,0,0,15,15,15,15
Riverside,65,2023-03-14,863,874,874,0,14604,14790,14789,1,85,5,5,10,6840,6840,6835,6835
Sacramento,65,2023-03-14,685,693,693,0,10417,10549,10548,1,104,6,6,15,3565,3565,3559,3559
San Benito,65,2023-03-14,14,14,14,0,412,419,418,1,0,0,0,0,112,112,112,112
San Bernardino,65,2023-03-14,675,683,683,0,14575,14759,14758,1,95,0,0,27,8133,8133,8133,8133
San Diego,65,2023-03-14,1303,1320,1320,0,23732,24034,24033,1,161,8,8,16,5828,5828,5820,5820
San Francisco,65,2023-03-14,534,541,541,0,9198,9315,9314,1,66,4,4,15,1191,1191,1187,1187
San Joaquin,65,2023-03-14,350,355,355,0,6613,6699,6698,1,45,4,4,5,2433,2433,2429,2429
San Luis Obispo,65,2023-03-14,77,77,77,0,1291,1309,1308,1,8,0,0,0,569,569,569,569
San Mateo,65,2023-03-14,379,384,384,0,6828,6916,6915,1,27,0,0,6,742,742,742,742
Santa Barbara,65,2023-03-14,141,141,141,0,3150,3191,3190,1,13,0,0,1,764,764,764,764
Santa Clara,65,2023-03-14,1029,1041,1041,0,20081,20337,20336,1,143,11,11,20,2750,2750,2739,2739
Santa Cruz,65,2023-03-14,113,113,113,0,3065,3106,3105,1,15,0,0,0,276,276,276,276
Shasta,65,2023-03-14,24,24,24,0,614,623,622,1,7,0,0,1,606,606,606,606
Siskiyou,65,2023-03-14,11,11,11,0,169,170,169,1,0,0,0,0,95,95,95,95
Solano,65,2023-03-14,208,209,209,0,2992,3030,3029,1,28,0,0,5,474,474,474,474
Sonoma,65,2023-03-14,193,193,193,0,2753,2788,2787,1,36,1,1,5,561,561,560,560
Stanislaus,65,2023-03-14,184,184,184,0,3418,3462,3461,1,49,0,0,4,1842,1842,1842,1842
Sutter,65,2023-03-14,31,31,31,0,531,540,539,1,0,0,0,0,238,238,238,238
Tehama,65,2023-03-14,15,15,15,0,229,231,230,1,0,0,0,1,234,234,234,234
Trinity,65,2023-03-14,0,0,0,0,22,23,22,1,0,0,0,0,23,23,23,23
Tulare,65,2023-03-14,146,146,146,0,3204,3246,3245,1,32,3,3,2,1593,1593,1590,1590
Tuolumne,65,2023-03-14,10,10,10,0,370,375,374,1,2,0,0,0,211,211,211,211
Ventura,65,2023-03-14,204,205,205,0,4316,4372,4371,1,28,4,4,2,1687,1687,1683,1683
Yolo,65,2023-03-14,66,66,66,0,1068,1082,1081,1,1,1,1,0,450,450,449,449
Yuba,65,2023-03-14,28,28,28,0,455,463,462,1,6,0,0,0,122,122,122,122
Alameda,66,2023-03-21,719,730,730,0,14506,14717,14716,1,66,7,7,11,2213,2213,2206,2206
Amador,66,2023-03-21,17,17,17,0,385,392,391,1,4,0,0,0,98,98,98,98
Butte,66,2023-03-21,42,42,42,0,523,533,532,1,7,1,1,2,495,495,494,494
Calaveras,66,2023-03-21,10,10,10,0,241,245,244,1,0,0,0,0,142,142,142,142
Colusa,66,2023-03-21,5,5,5,0,156,159,158,1,1,0,0,0,23,23,23,23
Contra Costa,66,2023-03-21,431,438,438,0,9507,9646,9645,1,28,6,6,8,1575,1575,1569,1569
Del Norte,66,2023-03-21,1,1,1,0,201,203,202,1,0,0,0,1,60,60,60,60
El Dorado,66,2023-03-21,38,38,38,0,811,824,823,1,1,0,0,0,246,246,246,246
Fresno,66,2023-03-21,359,366,366,0,7667,7779,7778,1,72,2,2,14,3013,3013,3011,3011
Glenn,66,2023-03-21,4,4,4,0,131,133,132,1,0,0,0,0,53,53,53,53
Humboldt,66,2023-03-21,23,23,23,0,495,504,503,1,2,0,0,2,170,170,170,170
Imperial,66,2023-03-21,149,149,149,0,1663,1689,1688,1,9,0,0,1,981,981,981,981
Inyo,66,2023-03-21,14,14,14,0,261,266,265,1,0,0,0,0,63,63,63,63
Kern,66,2023-03-21,190,191,191,0,7512,7621,7620,1,30,2,2,5,2493,2493,2491,2491
Kings,66,2023-03-21,33,33,33,0,1369,1391,1390,1,0,1,1,0,486,486,485,485
Lake,66,2023-03-21,11,11,11,0,388,394,393,1,1,0,0,0,162,162,162,162
Lassen,66,2023-03-21,5,5,5,0,307,312,311,1,0,0,0,0,64,64,64,64
Los Angeles,66,2023-03-21,3158,3204,3204,0,106602,108138,108137,1,395,53,60,40,35847,35881,35794,35821
Madera,66,2023-03-21,47,47,47,0,1120,1137,1136,1,4,0,0,0,376,376,376,376
Marin,66,2023-03-21,92,92,92,0,1519,1542,1541,1,22,0,0,2,317,317,317,317
Mariposa,66,2023-03-21,2,2,2,0,89,90,89,1,0,0,0,0,31,31,31,31
Mendocino,66,2023-03-21,9,9,9,0,421,428,427,1,3,0,0,0,145,145,145,145
Merced,66,2023-03-21,111,111,111,0,1478,1501,1500,1,9,0,0,2,903,903,903,903
Modoc,66,2023-03-21,1,1,1,0,10,11,10,1,0,0,0,0,9,9,9,9
Mono,66,2023-03-21,4,4,4,0,50,51,50,1,0,0,0,0,8,8,8,8
Monterey,66,2023-03-21,56,56,56,0,1422,1442,1441,1,21,0,0,0,809,809,809,809
Napa,66,2023-03-21,36,36,36,0,886,900,899,1,3,1,1,0,170,170,169,169
Nevada,66,2023-03-21,23,23,23,0,470,478,477,1,3,0,0,0,137,137,137,137
Orange,66,2023-03-21,733,745,745,0,15852,16082,16081,1,107,8,8,22,8080,8084,8072,8076
Placer,66,2023-03-21,126,126,126,0,2070,2101,2100,1,54,0,0,8,682,682,682,682
Plumas,66,2023-03-21,2,2,2,0,57,58,57,1,0,0,0,0,15,15,15,15
Riverside,66,2023-03-21,571,580,580,0,11803,11974,11973,1,57,1,1,7,6841,6841,6840,6840
Sacramento,66,2023-03-21,467,474,474,0,9812,9955,9954,1,94,7,7,16,3572,3572,3565,3565
San Benito,66,2023-03-21,41,41,41,0,633,644,643,1,0,1,1,1,113,113,112,112
San Bernardino,66,2023-03-21,513,520,520,0,13745,13944,13943,1,71,0,0,16,8133,8133,8133,8133
San Diego,66,2023-03-21,1038,1052,1052,0,22048,22367,22366,1,139,8,8,9,5836,5836,5828,5828
San Francisco,66,2023-03-21,385,392,392,0,8271,8390,8389,1,60,4,4,7,1195,1195,1191,1191
San Joaquin,66,2023-03-21,258,263,263,0,5699,5782,5781,1,43,5,6,5,2438,2439,2433,2433
San Luis Obispo,66,2023-03-21,49,49,49,0,1179,1197,1196,1,9,1,1,0,570,570,569,569
San Mateo,66,2023-03-21,282,287,287,0,6110,6200,6199,1,26,0,0,3,742,742,742,742
Santa Barbara,66,2023-03-21,106,106,106,0,3292,3341,3340,1,14,1,1,0,765,765,764,764
Santa Clara,66,2023-03-21,765,776,776,0,16848,17093,17092,1,133,6,6,22,2756,2756,2750,2750
Santa Cruz,66,2023-03-21,129,129,129,0,3019,3064,3063,1,14,0,0,1,276,276,276,276
Shasta,66,2023-03-21,19,19,19,0,542,552,551,1,1,0,0,3,606,606,606,606
Siskiyou,66,2023-03-21,4,4,4,0,155,156,155,1,0,0,0,0,95,95,95,95
Solano,66,2023-03-21,184,185,185,0,2870,2912,2911,1,26,1,1,5,475,475,474,474
Sonoma,66,2023-03-21,177,178,178,0,2728,2768,2767,1,32,0,0,1,561,561,561,561
Stanislaus,66,2023-03-21,204,206,206,0,3155,3202,3201,1,44,0,0,4,1842,1842,1842,1842
Sutter,66,2023-03-21,38,38,38,0,476,484,483,1,0,0,0,0,238,238,238,238
Tehama,66,2023-03-21,14,14,14,0,213,216,215,1,1,1,1,0,235,235,234,234
Trinity,66,2023-03-21,0,0,0,0,17,18,17,1,0,0,0,0,23,23,23,23
Tulare,66,2023-03-21,117,117,117,0,2637,2676,2675,1,25,1,1,1,1594,1594,1593,1593
Tuolumne,66,2023-03-21,14,14,14,0,355,363,362,1,0,0,0,0,211,211,211,211
Ventura,66,2023-03-21,181,181,181,0,4070,4130,4129,1,32,4,4,2,1691,1691,1687,1687
Yolo,66,2023-03-21,64,64,64,0,1136,1154,1153,1,3,0,0,1,450,450,450,450
Yuba,66,2023-03-21,18,18,18,0,467,475,474,1,4,0,0,0,122,122,122,122
Alameda,67,2023-03-28,577,587,587,0,12995,13212,13211,1,71,3,3,10,2216,2216,2213,2213
Amador,67,2023-03-28,11,11,11,0,344,352,351,1,0,0,0,0,98,98,98,98
Butte,67,2023-03-28,29,29,29,0,486,496,495,1,8,1,1,0,496,496,495,495
Calaveras,67,2023-03-28,12,12,12,0,255,261,260,1,0,1,1,0,143,143,142,142
Colusa,67,2023-03-28,3,3,3,0,162,165,164,1,0,0,0,0,23,23,23,23
Contra Costa,67,2023-03-28,378,385,385,0,8900,9050,9049,1,39,1,1,4,1576,1576,1575,1575
Del Norte,67,2023-03-28,6,6,6,0,212,217,216,1,0,0,0,0,60,60,60,60
El Dorado,67,2023-03-28,36,36,36,0,785,799,798,1,2,0,0,0,246,246,246,246
Fresno,67,2023-03-28,239,244,244,0,7098,7218,7217,1,58,2,2,4,3015,3015,3013,3013
Glenn,67,2023-03-28,7,7,7,0,135,137,136,1,0,0,0,0,53,53,53,53
Humboldt,67,2023-03-28,13,13,13,0,460,469,468,1,4,1,1,2,171,171,170,170
Imperial,67,2023-03-28,152,154,154,0,1608,1635,1634,1,8,0,0,1,981,981,981,981
Inyo,67,2023-03-28,6,6,6,0,239,244,243,1,0,0,0,0,63,63,63,63
Kern,67,2023-03-28,188,192,192,0,6893,7009,7008,1,26,1,1,6,2494,2494,2493,2493
Kings,67,2023-03-28,39,39,39,0,1295,1318,1317,1,3,0,0,1,486,486,486,486
Lake,67,2023-03-28,11,11,11,0,359,365,364,1,0,0,0,0,162,162,162,162
Lassen,67,2023-03-28,7,7,7,0,295,302,301,1,0,0,0,0,64,64,64,64
Los Angeles,67,2023-03-28,2424,2465,2465,0,104448,106186,106185,1,334,30,35,48,35877,35916,35847,35881
Madera,67,2023-03-28,32,32,32,0,919,936,935,1,6,0,0,1,376,376,376,376
Marin,67,2023-03-28,73,73,73,0,1254,1274,1273,1,17,0,0,0,317,317,317,317
Mariposa,67,2023-03-28,1,1,1,0,81,82,81,1,0,0,0,0,31,31,31,31
Mendocino,67,2023-03-28,15,15,15,0,406,414,413,1,2,0,0,1,145,145,145,145
Merced,67,2023-03-28,80,80,80,0,1290,1313,1312,1,8,0,0,0,903,903,903,903
Modoc,67,2023-03-28,0,0,0,0,7,8,7,1,1,0,0,0,9,9,9,9
Mono,67,2023-03-28,1,1,1,0,48,49,48,1,0,0,0,0,8,8,8,8
Monterey,67,2023-03-28,61,61,61,0,1719,1749,1748,1,16,1,1,1,810,810,809,809
Napa,67,2023-03-28,45,45,45,0,886,902,901,1,3,1,1,0,171,171,170,170
Nevada,67,2023-03-28,18,18,18,0,448,457,456,1,4,0,0,0,137,137,137,137
Orange,67,2023-03-28,624,635,635,0,15850,16114,16113,1,102,14,16,19,8094,8100,8080,8084
Placer,67,2023-03-28,98,98,98,0,1881,1913,1912,1,33,0,0,4,682,682,682,682
Plumas,67,2023-03-28,1,1,1,0,58,59,58,1,0,0,0,0,15,15,15,15
Riverside,67,2023-03-28,509,517,517,0,11024,11208,11207,1,41,5,5,8,6846,6846,6841,6841
Sacramento,67,2023-03-28,428,435,435,0,9268,9424,9423,1,79,6,6,8,3578,3578,3572,3572
San Benito,67,2023-03-28,20,20,20,0,666,679,678,1,0,0,0,0,113,113,113,113
San Bernardino,67,2023-03-28,412,420,420,0,12196,12401,12400,1,64,0,0,12,8133,8133,8133,8133
San Diego,67,2023-03-28,877,890,890,0,20478,20821,20820,1,139,4,4,7,5840,5840,5836,5836
San Francisco,67,2023-03-28,374,381,381,0,7683,7809,7808,1,47,3,3,3,1198,1198,1195,1195
San Joaquin,67,2023-03-28,248,253,253,0,5584,5678,5677,1,37,2,2,4,2440,2441,2438,2439
San Luis Obispo,67,2023-03-28,37,37,37,0,1106,1126,1125,1,7,0,0,0,570,570,570,570
San Mateo,67,2023-03-28,274,279,279,0,5630,5725,5724,1,25,0,0,2,742,742,742,742
Santa Barbara,67,2023-03-28,88,88,88,0,3111,3164,3163,1,9,0,0,3,765,765,765,765
Santa Clara,67,2023-03-28,668,679,679,0,15613,15875,15874,1,101,4,4,15,2760,2760,2756,2756
Santa Cruz,67,2023-03-28,120,120,120,0,2937,2986,2985,1,19,0,0,1,276,276,276,276
Shasta,67,2023-03-28,16,16,16,0,533,542,541,1,2,0,0,1,606,606,606,606
Siskiyou,67,2023-03-28,0,0,0,0,137,138,137,1,0,0,0,0,95,95,95,95
Solano,67,2023-03-28,170,173,173,0,2588,2632,2631,1,23,0,0,4,475,475,475,475
Sonoma,67,2023-03-28,149,149,149,0,2290,2329,2328,1,26,2,2,2,563,563,561,561
Stanislaus,67,2023-03-28,126,127,127,0,2546,2590,2589,1,35,0,0,1,1842,1842,1842,1842
Sutter,67,2023-03-28,38,38,38,0,393,401,400,1,0,0,0,0,238,238,238,238
Tehama,67,2023-03-28,6,6,6,0,203,206,205,1,1,1,1,0,236,236,235,235
Trinity,67,2023-03-28,0,0,0,0,20,21,20,1,0,0,0,0,23,23,23,23
Tulare,67,2023-03-28,106,106,106,0,2733,2780,2779,1,23,0,0,2,1594,1594,1594,1594
Tuolumne,67,2023-03-28,10,10,10,0,306,314,313,1,0,0,0,0,211,211,211,211
Ventura,67,2023-03-28,140,140,140,0,4171,4241,4240,1,22,5,5,0,1696,1696,1691,1691
Yolo,67,2023-03-28,52,52,52,0,996,1013,1012,1,1,0,0,2,450,450,450,450
Yuba,67,2023-03-28,21,21,21,0,415,423,422,1,2,0,0,0,122,122,122,122
Alameda,68,2023-04-04,571,582,582,0,12219,12462,12461,1,61,3,3,9,2219,2219,2216,2216
Amador,68,2023-04-04,15,15,15,0,271,278,277,1,2,0,0,0,98,98,98,98
Butte,68,2023-04-04,21,21,21,0,463,473,472,1,7,1,1,0,497,497,496,496
Calaveras,68,2023-04-04,5,5,5,0,194,199,198,1,0,0,0,0,143,143,143,143
Colusa,68,2023-04-04,9,9,9,0,166,169,168,1,2,0,0,0,23,23,23,23
Contra Costa,68,2023-04-04,414,422,422,0,8611,8783,8782,1,38,3,3,4,1579,1579,1576,1576
Del Norte,68,2023-04-04,6,6,6,0,197,204,203,1,0,0,0,0,60,60,60,60
El Dorado,68,2023-04-04,63,63,63,0,749,765,764,1,4,0,0,0,246,246,246,246
Fresno,68,2023-04-04,273,280,280,0,6964,7104,7103,1,59,3,3,11,3018,3018,3015,3015
Glenn,68,2023-04-04,5,5,5,0,128,131,130,1,0,0,0,0,53,53,53,53
Humboldt,68,2023-04-04,19,19,19,0,434,444,443,1,4,0,0,0,171,171,171,171
Imperial,68,2023-04-04,182,186,186,0,1477,1507,1506,1,11,0,0,2,981,981,981,981
Inyo,68,2023-04-04,3,3,3,0,146,149,148,1,0,0,0,0,63,63,63,63
Kern,68,2023-04-04,148,150,150,0,5529,5640,5639,1,23,2,2,4,2496,2496,2494,2494
Kings,68,2023-04-04,32,32,32,0,959,980,979,1,4,0,0,0,486,486,486,486
Lake,68,2023-04-04,17,17,17,0,327,334,333,1,0,0,0,0,162,162,162,162
Lassen,68,2023-04-04,2,2,2,0,159,164,163,1,0,0,0,0,64,64,64,64
Los Angeles,68,2023-04-04,2326,2372,2372,0,94251,96125,96124,1,320,44,54,41,35921,35970,35877,35916
Madera,68,2023-04-04,37,37,37,0,870,888,887,1,2,0,0,0,376,376,376,376
Marin,68,2023-04-04,107,107,107,0,1256,1282,1281,1,17,0,0,0,317,317,317,317
Mariposa,68,2023-04-04,6,6,6,0,64,65,64,1,0,0,0,0,31,31,31,31
Mendocino,68,2023-04-04,15,15,15,0,346,354,353,1,3,0,0,1,145,145,145,145
Merced,68,2023-04-04,79,79,79,0,873,891,890,1,5,0,0,1,903,903,903,903
Modoc,68,2023-04-04,5,5,5,0,11,12,11,1,0,0,0,0,9,9,9,9
Mono,68,2023-04-04,2,2,2,0,38,39,38,1,0,0,0,0,8,8,8,8
Monterey,68,2023-04-04,51,51,51,0,1612,1645,1644,1,12,1,1,1,811,811,810,810
Napa,68,2023-04-04,35,35,35,0,790,806,805,1,9,1,1,1,172,172,171,171
Nevada,68,2023-04-04,59,59,59,0,434,443,442,1,1,1,1,0,138,138,137,137
Orange,68,2023-04-04,643,656,656,0,15067,15370,15369,1,89,5,6,12,8099,8106,8094,8100
Placer,68,2023-04-04,121,122,122,0,1826,1863,1862,1,45,0,0,3,682,682,682,682
Plumas,68,2023-04-04,2,2,2,0,50,51,50,1,0,0,0,0,15,15,15,15
Riverside,68,2023-04-04,464,474,474,0,11096,11319,11318,1,62,2,2,10,6848,6848,6846,6846
Sacramento,68,2023-04-04,511,521,521,0,8908,9087,9086,1,70,1,1,17,3579,3579,3578,3578
San Benito,68,2023-04-04,29,29,29,0,555,567,566,1,0,0,0,0,113,113,113,113
San Bernardino,68,2023-04-04,471,480,480,0,12133,12376,12375,1,57,0,0,10,8133,8133,8133,8133
San Diego,68,2023-04-04,767,782,782,0,19468,19859,19858,1,124,4,4,12,5844,5844,5840,5840
San Francisco,68,2023-04-04,322,329,329,0,6693,6826,6825,1,40,2,2,5,1200,1200,1198,1198
San Joaquin,68,2023-04-04,213,219,219,0,4695,4788,4787,1,38,2,2,5,2442,2443,2440,2441
San Luis Obispo,68,2023-04-04,45,45,45,0,915,935,934,1,4,3,3,0,573,573,570,570
San Mateo,68,2023-04-04,249,256,256,0,5565,5677,5676,1,28,0,0,1,742,742,742,742
Santa Barbara,68,2023-04-04,114,115,115,0,2655,2710,2709,1,17,0,0,1,765,765,765,765
Santa Clara,68,2023-04-04,666,680,680,0,15160,15464,15463,1,64,1,1,16,2761,2761,2760,2760
Santa Cruz,68,2023-04-04,127,127,127,0,2189,2234,2233,1,14,0,0,0,276,276,276,276
Shasta,68,2023-04-04,22,22,22,0,520,532,531,1,1,0,0,0,606,606,606,606
Siskiyou,68,2023-04-04,3,3,3,0,96,97,96,1,0,0,0,0,95,95,95,95
Solano,68,2023-04-04,132,133,133,0,2318,2366,2365,1,22,0,0,1,475,475,475,475
Sonoma,68,2023-04-04,134,135,135,0,2112,2155,2154,1,31,2,3,2,565,566,563,563
Stanislaus,68,2023-04-04,127,128,128,0,2515,2566,2565,1,32,0,0,6,1842,1842,1842,1842
Sutter,68,2023-04-04,31,31,31,0,417,427,426,1,0,0,0,0,238,238,238,238
Tehama,68,2023-04-04,10,10,10,0,191,196,195,1,0,0,0,0,236,236,236,236
Trinity,68,2023-04-04,0,0,0,0,12,13,12,1,0,0,0,0,23,23,23,23
Tulare,68,2023-04-04,96,96,96,0,2552,2605,2604,1,20,0,0,1,1594,1594,1594,1594
Tuolumne,68,2023-04-04,3,3,3,0,248,255,254,1,1,0,0,0,211,211,211,211
Ventura,68,2023-04-04,137,139,139,0,3365,3432,3431,1,29,3,4,0,1699,1700,1696,1696
Yolo,68,2023-04-04,59,59,59,0,945,963,962,1,1,1,1,0,451,451,450,450
Yuba,68,2023-04-04,20,20,20,0,389,398,397,1,3,0,0,0,122,122,122,122
Alameda,69,2023-04-11,549,562,562,0,10941,11218,11217,1,59,2,3,11,2221,2222,2219,2219
Amador,69,2023-04-11,9,9,9,0,198,205,204,1,1,0,0,0,98,98,98,98
Butte,69,2023-04-11,21,21,21,0,448,461,460,1,5,0,0,0,497,497,497,497
Calaveras,69,2023-04-11,10,10,10,0,181,189,188,1,0,0,0,0,143,143,143,143
Colusa,69,2023-04-11,0,0,0,0,97,99,98,1,1,0,0,0,23,23,23,23
Contra Costa,69,2023-04-11,409,419,419,0,8040,8246,8245,1,38,0,0,3,1579,1579,1579,1579
Del Norte,69,2023-04-11,2,2,2,0,114,119,118,1,0,0,0,0,60,60,60,60
El Dorado,69,2023-04-11,43,43,43,0,640,657,656,1,2,0,0,1,246,246,246,246
Fresno,69,2023-04-11,274,281,281,0,6379,6544,6543,1,63,2,3,3,3020,3021,3018,3018
Glenn,69,2023-04-11,4,4,4,0,132,135,134,1,1,0,0,0,53,53,53,53
Humboldt,69,2023-04-11,14,14,14,0,424,436,435,1,3,0,0,0,171,171,171,171
Imperial,69,2023-04-11,148,151,151,0,1193,1225,1224,1,6,0,0,2,981,981,981,981
Inyo,69,2023-04-11,4,4,4,0,159,162,161,1,0,0,0,0,63,63,63,63
Kern,69,2023-04-11,163,167,167,0,4813,4937,4936,1,22,0,0,4,2496,2496,2496,2496
Kings,69,2023-04-11,46,46,46,0,899,924,923,1,3,0,0,0,486,486,486,486
Lake,69,2023-04-11,13,13,13,0,279,287,286,1,1,0,0,0,162,162,162,162
Lassen,69,2023-04-11,1,1,1,0,92,94,93,1,0,0,0,0,64,64,64,64
Los Angeles,69,2023-04-11,2451,2513,2513,0,90788,93119,93118,1,300,31,45,38,35952,36015,35921,35970
Madera,69,2023-04-11,80,81,81,0,865,888,887,1,1,0,0,0,376,376,376,376
Marin,69,2023-04-11,92,93,93,0,1130,1161,1160,1,10,0,0,2,317,317,317,317
Mariposa,69,2023-04-11,3,3,3,0,59,60,59,1,0,0,0,0,31,31,31,31
Mendocino,69,2023-04-11,17,17,17,0,371,382,381,1,2,0,0,1,145,145,145,145
Merced,69,2023-04-11,46,46,46,0,763,783,782,1,6,0,0,1,903,903,903,903
Modoc,69,2023-04-11,0,0,0,0,4,5,4,1,0,0,0,0,9,9,9,9
Mono,69,2023-04-11,1,1,1,0,48,49,48,1,0,0,0,0,8,8,8,8
Monterey,69,2023-04-11,51,51,51,0,1297,1331,1330,1,9,0,0,1,811,811,811,811
Napa,69,2023-04-11,34,34,34,0,655,673,672,1,7,0,0,0,172,172,172,172
Nevada,69,2023-04-11,39,39,39,0,336,346,345,1,2,0,0,0,138,138,138,138
Orange,69,2023-04-11,531,544,544,0,15087,15473,15472,1,78,12,18,13,8111,8124,8099,8106
Placer,69,2023-04-11,83,84,84,0,1587,1629,1628,1,33,0,0,7,682,682,682,682
Plumas,69,2023-04-11,4,4,4,0,40,41,40,1,1,0,0,0,15,15,15,15
Riverside,69,2023-04-11,397,406,406,0,10832,11107,11106,1,56,1,1,6,6849,6849,6848,6848
Sacramento,69,2023-04-11,468,480,480,0,7510,7702,7701,1,68,5,6,12,3584,3585,3579,3579
San Benito,69,2023-04-11,18,18,18,0,451,463,462,1,2,0,0,0,113,113,113,113
San Bernardino,69,2023-04-11,479,490,490,0,11023,11304,11303,1,77,0,0,10,8133,8133,8133,8133
San Diego,69,2023-04-11,862,884,884,0,20541,21066,21065,1,105,2,2,14,5846,5846,5844,5844
San Francisco,69,2023-04-11,287,295,295,0,6003,6156,6155,1,41,6,8,6,1206,1208,1200,1200
San Joaquin,69,2023-04-11,166,171,171,0,4627,4744,4743,1,29,0,0,5,2442,2443,2442,2443
San Luis Obispo,69,2023-04-11,64,64,64,0,923,947,946,1,4,1,1,0,574,574,573,573
San Mateo,69,2023-04-11,227,234,234,0,5266,5402,5401,1,21,0,0,2,742,742,742,742
Santa Barbara,69,2023-04-11,92,94,94,0,2813,2885,2884,1,19,0,0,2,765,765,765,765
Santa Clara,69,2023-04-11,599,613,613,0,13279,13616,13615,1,89,3,4,14,2764,2765,2761,2761
Santa Cruz,69,2023-04-11,101,103,103,0,1977,2029,2028,1,13,0,0,1,276,276,276,276
Shasta,69,2023-04-11,23,23,23,0,475,490,489,1,3,0,0,1,606,606,606,606
Siskiyou,69,2023-04-11,7,7,7,0,101,104,103,1,0,0,0,0,95,95,95,95
Solano,69,2023-04-11,126,128,128,0,1977,2029,2028,1,25,0,0,0,475,475,475,475
Sonoma,69,2023-04-11,136,138,138,0,2067,2120,2119,1,32,0,0,1,565,566,565,566
Stanislaus,69,2023-04-11,123,125,125,0,2112,2167,2166,1,25,0,0,3,1842,1842,1842,1842
Sutter,69,2023-04-11,27,27,27,0,402,414,413,1,0,0,0,0,238,238,238,238
Tehama,69,2023-04-11,9,9,9,0,171,175,174,1,1,0,0,0,236,236,236,236
Trinity,69,2023-04-11,2,2,2,0,13,14,13,1,0,0,0,0,23,23,23,23
Tulare,69,2023-04-11,85,86,86,0,2388,2450,2449,1,18,0,0,0,1594,1594,1594,1594
Tuolumne,69,2023-04-11,6,6,6,0,195,202,201,1,0,0,0,0,211,211,211,211
Ventura,69,2023-04-11,145,150,150,0,3368,3456,3455,1,19,1,2,0,1700,1702,1699,1700
Yolo,69,2023-04-11,56,57,57,0,871,893,892,1,2,0,0,0,451,451,451,451
Yuba,69,2023-04-11,22,22,22,0,364,373,372,1,3,0,0,0,122,122,122,122
Alameda,70,2023-04-18,564,585,585,0,10559,10937,10936,1,60,1,2,10,2222,2224,2221,2222
Amador,70,2023-04-18,11,11,11,0,185,193,192,1,1,0,0,0,98,98,98,98
Butte,70,2023-04-18,32,32,32,0,444,461,460,1,9,1,3,0,498,500,497,497
Calaveras,70,2023-04-18,8,8,8,0,176,184,183,1,0,0,0,0,143,143,143,143
Colusa,70,2023-04-18,2,2,2,0,46,47,46,1,0,1,2,0,24,25,23,23
Contra Costa,70,2023-04-18,382,396,396,0,7507,7777,7776,1,35,1,2,2,1580,1581,1579,1579
Del Norte,70,2023-04-18,0,0,0,0,94,99,98,1,0,0,0,0,60,60,60,60
El Dorado,70,2023-04-18,45,45,45,0,623,647,646,1,2,0,0,0,246,246,246,246
Fresno,70,2023-04-18,234,242,242,0,5863,6074,6073,1,64,1,2,3,3021,3023,3020,3021
Glenn,70,2023-04-18,6,6,6,0,111,115,114,1,0,0,0,0,53,53,53,53
Humboldt,70,2023-04-18,8,8,8,0,295,307,306,1,3,0,0,0,171,171,171,171
Imperial,70,2023-04-18,163,169,169,0,1229,1273,1272,1,11,0,0,2,981,981,981,981
Inyo,70,2023-04-18,6,6,6,0,172,178,177,1,0,0,0,0,63,63,63,63
Kern,70,2023-04-18,112,116,116,0,3688,3820,3819,1,12,0,0,6,2496,2496,2496,2496
Kings,70,2023-04-18,40,40,40,0,757,786,785,1,1,0,0,0,486,486,486,486
Lake,70,2023-04-18,14,14,14,0,282,293,292,1,1,0,0,0,162,162,162,162
Lassen,70,2023-04-18,2,2,2,0,73,77,76,1,0,0,0,0,64,64,64,64
Los Angeles,70,2023-04-18,2113,2187,2187,0,93941,97312,97311,1,284,22,43,27,35974,36058,35952,36015
Madera,70,2023-04-18,48,48,48,0,809,839,838,1,1,0,0,0,376,376,376,376
Marin,70,2023-04-18,63,63,63,0,934,967,966,1,14,0,0,2,317,317,317,317
Mariposa,70,2023-04-18,3,3,3,0,51,52,51,1,0,0,0,0,31,31,31,31
Mendocino,70,2023-04-18,17,17,17,0,285,297,296,1,2,0,0,1,145,145,145,145
Merced,70,2023-04-18,57,58,58,0,721,748,747,1,8,0,0,0,903,903,903,903
Modoc,70,2023-04-18,1,1,1,0,6,7,6,1,1,0,0,0,9,9,9,9
Mono,70,2023-04-18,1,1,1,0,35,36,35,1,0,0,0,0,8,8,8,8
Monterey,70,2023-04-18,46,46,46,0,1467,1521,1520,1,15,0,0,0,811,811,811,811
Napa,70,2023-04-18,28,28,28,0,699,724,723,1,7,0,0,0,172,172,172,172
Nevada,70,2023-04-18,24,24,24,0,304,315,314,1,3,0,0,0,138,138,138,138
Orange,70,2023-04-18,507,525,525,0,15260,15806,15805,1,78,6,12,11,8117,8136,8111,8124
Placer,70,2023-04-18,104,106,106,0,1455,1509,1508,1,49,0,0,3,682,682,682,682
Plumas,70,2023-04-18,5,5,5,0,71,73,72,1,0,0,0,0,15,15,15,15
Riverside,70,2023-04-18,370,384,384,0,11558,11971,11970,1,60,1,2,5,6850,6851,6849,6849
Sacramento,70,2023-04-18,473,491,491,0,7447,7715,7714,1,76,2,4,9,3586,3589,3584,3585
San Benito,70,2023-04-18,15,15,15,0,453,470,469,1,0,0,0,0,113,113,113,113
San Bernardino,70,2023-04-18,453,470,470,0,11274,11679,11678,1,67,0,0,15,8133,8133,8133,8133
San Diego,70,2023-04-18,799,828,828,0,18979,19658,19657,1,104,4,9,11,5850,5855,5846,5846
San Francisco,70,2023-04-18,314,326,326,0,6181,6402,6401,1,46,0,0,7,1206,1208,1206,1208
San Joaquin,70,2023-04-18,175,182,182,0,4300,4455,4454,1,28,0,0,2,2442,2443,2442,2443
San Luis Obispo,70,2023-04-18,55,55,55,0,830,861,860,1,7,0,0,0,574,574,574,574
San Mateo,70,2023-04-18,195,203,203,0,4964,5143,5142,1,22,0,0,3,742,742,742,742
Santa Barbara,70,2023-04-18,116,120,120,0,2720,2819,2818,1,18,1,2,1,766,767,765,765
Santa Clara,70,2023-04-18,557,578,578,0,12711,13170,13169,1,84,3,6,13,2767,2771,2764,2765
Santa Cruz,70,2023-04-18,89,92,92,0,1911,1980,1979,1,19,0,0,2,276,276,276,276
Shasta,70,2023-04-18,24,24,24,0,460,479,478,1,4,0,0,1,606,606,606,606
Siskiyou,70,2023-04-18,6,6,6,0,75,78,77,1,1,0,0,0,95,95,95,95
Solano,70,2023-04-18,163,168,168,0,1911,1980,1979,1,29,0,0,2,475,475,475,475
Sonoma,70,2023-04-18,157,164,164,0,2055,2129,2128,1,31,0,0,1,565,566,565,566
Stanislaus,70,2023-04-18,106,110,110,0,2083,2158,2157,1,29,0,0,4,1842,1842,1842,1842
Sutter,70,2023-04-18,23,23,23,0,265,276,275,1,0,0,0,0,238,238,238,238
Tehama,70,2023-04-18,10,10,10,0,155,162,161,1,1,0,0,0,236,236,236,236
Trinity,70,2023-04-18,1,1,1,0,12,13,12,1,0,0,0,0,23,23,23,23
Tulare,70,2023-04-18,91,94,94,0,2190,2269,2268,1,11,1,2,2,1595,1596,1594,1594
Tuolumne,70,2023-04-18,5,5,5,0,184,192,191,1,0,0,0,0,211,211,211,211
Ventura,70,2023-04-18,124,129,129,0,3058,3167,3166,1,20,1,2,0,1701,1704,1700,1702
Yolo,70,2023-04-18,46,46,46,0,758,786,785,1,4,0,0,0,451,451,451,451
Yuba,70,2023-04-18,14,14,14,0,271,282,281,1,2,0,0,0,122,122,122,122
Alameda,71,2023-04-25,541,577,577,0,10020,10707,10706,1,60,1,7,7,2223,2231,2222,2224
Amador,71,2023-04-25,16,16,16,0,185,199,198,1,0,0,0,0,98,98,98,98
Butte,71,2023-04-25,29,30,30,0,461,495,494,1,13,0,0,1,498,500,498,500
Calaveras,71,2023-04-25,5,5,5,0,169,181,180,1,0,0,0,0,143,143,143,143
Colusa,71,2023-04-25,1,1,1,0,45,48,47,1,0,0,0,0,24,25,24,25
Contra Costa,71,2023-04-25,344,368,368,0,7239,7738,7737,1,33,0,0,7,1580,1581,1580,1581
Del Norte,71,2023-04-25,5,5,5,0,118,128,127,1,0,0,0,0,60,60,60,60
El Dorado,71,2023-04-25,37,38,38,0,602,644,643,1,6,0,0,1,246,246,246,246
Fresno,71,2023-04-25,228,243,243,0,6027,6437,6436,1,63,0,0,6,3021,3023,3021,3023
Glenn,71,2023-04-25,3,3,3,0,110,118,117,1,0,0,0,0,53,53,53,53
Humboldt,71,2023-04-25,8,8,8,0,246,264,263,1,0,0,0,0,171,171,171,171
Imperial,71,2023-04-25,111,118,118,0,1053,1125,1124,1,6,0,0,1,981,981,981,981
Inyo,71,2023-04-25,5,5,5,0,141,152,151,1,0,0,0,0,63,63,63,63
Kern,71,2023-04-25,82,89,89,0,3793,4055,4054,1,14,0,0,3,2496,2496,2496,2496
Kings,71,2023-04-25,33,35,35,0,758,813,812,1,0,0,0,0,486,486,486,486
Lake,71,2023-04-25,14,14,14,0,326,350,349,1,1,0,0,0,162,162,162,162
Lassen,71,2023-04-25,2,2,2,0,77,83,82,1,0,0,0,0,64,64,64,64
Los Angeles,71,2023-04-25,1780,1899,1899,0,46478,49063,49062,1,235,16,68,29,35990,36126,35974,36058
Madera,71,2023-04-25,38,40,40,0,771,825,824,1,3,0,0,0,376,376,376,376
Marin,71,2023-04-25,68,72,72,0,967,1032,1031,1,17,0,0,2,317,317,317,317
Mariposa,71,2023-04-25,3,3,3,0,49,53,52,1,0,0,0,0,31,31,31,31
Mendocino,71,2023-04-25,11,11,11,0,260,278,277,1,2,0,0,1,145,145,145,145
Merced,71,2023-04-25,48,50,50,0,679,725,724,1,4,0,0,1,903,903,903,903
Modoc,71,2023-04-25,7,7,7,0,12,13,12,1,0,0,0,0,9,9,9,9
Mono,71,2023-04-25,2,2,2,0,44,46,45,1,0,0,0,0,8,8,8,8
Monterey,71,2023-04-25,62,65,65,0,1406,1505,1504,1,17,0,0,2,811,811,811,811
Napa,71,2023-04-25,27,28,28,0,704,752,751,1,3,0,0,1,172,172,172,172
Nevada,71,2023-04-25,33,35,35,0,300,321,320,1,4,0,0,2,138,138,138,138
Orange,71,2023-04-25,495,529,529,0,14068,15040,15039,1,68,2,7,14,8119,8143,8117,8136
Placer,71,2023-04-25,99,106,106,0,1444,1545,1544,1,35,0,0,2,682,682,682,682
Plumas,71,2023-04-25,3,3,3,0,53,57,56,1,0,0,0,0,15,15,15,15
Riverside,71,2023-04-25,284,303,303,0,11163,11921,11920,1,45,0,0,6,6850,6851,6850,6851
Sacramento,71,2023-04-25,516,552,552,0,7266,7764,7763,1,70,2,7,11,3588,3596,3586,3589
San Benito,71,2023-04-25,12,12,12,0,331,355,354,1,1,0,0,0,113,113,113,113
San Bernardino,71,2023-04-25,368,393,393,0,10425,11139,11138,1,46,0,0,20,8133,8133,8133,8133
San Diego,71,2023-04-25,703,753,753,0,18850,20135,20134,1,90,2,10,11,5852,5865,5850,5855
San Francisco,71,2023-04-25,296,315,315,0,5713,6107,6106,1,61,0,0,8,1206,1208,1206,1208
San Joaquin,71,2023-04-25,169,181,181,0,4210,4490,4489,1,27,0,0,0,2442,2443,2442,2443
San Luis Obispo,71,2023-04-25,36,37,37,0,783,840,839,1,9,0,0,0,574,574,574,574
San Mateo,71,2023-04-25,187,199,199,0,4840,5180,5179,1,20,0,0,1,742,742,742,742
Santa Barbara,71,2023-04-25,84,91,91,0,2770,2957,2956,1,11,1,6,2,767,773,766,767
Santa Clara,71,2023-04-25,504,539,539,0,12275,13124,13123,1,88,1,4,19,2768,2775,2767,2771
Santa Cruz,71,2023-04-25,48,52,52,0,1487,1587,1586,1,21,0,0,1,276,276,276,276
Shasta,71,2023-04-25,13,13,13,0,409,438,437,1,2,0,0,0,606,606,606,606
Siskiyou,71,2023-04-25,8,8,8,0,95,104,103,1,1,0,0,1,95,95,95,95
Solano,71,2023-04-25,133,141,141,0,2005,2142,2141,1,19,0,0,5,475,475,475,475
Sonoma,71,2023-04-25,150,159,159,0,2075,2216,2215,1,24,0,0,1,565,566,565,566
Stanislaus,71,2023-04-25,114,122,122,0,1992,2126,2125,1,19,0,0,2,1842,1842,1842,1842
Sutter,71,2023-04-25,18,18,18,0,286,307,306,1,0,0,0,0,238,238,238,238
Tehama,71,2023-04-25,5,5,5,0,157,169,168,1,0,0,0,0,236,236,236,236
Trinity,71,2023-04-25,1,1,1,0,14,15,14,1,0,0,0,0,23,23,23,23
Tulare,71,2023-04-25,71,76,76,0,2190,2341,2340,1,16,0,0,0,1595,1596,1595,1596
Tuolumne,71,2023-04-25,5,5,5,0,161,172,171,1,0,0,0,0,211,211,211,211
Ventura,71,2023-04-25,125,135,135,0,3047,3251,3250,1,17,0,0,1,1701,1704,1701,1704
Yolo,71,2023-04-25,38,41,41,0,888,951,950,1,2,0,0,0,451,451,451,451
Yuba,71,2023-04-25,19,19,19,0,267,288,287,1,5,0,0,0,122,122,122,122
Alameda,72,2023-05-01,296,476,476,0,5846,9086,9085,1,60,0,0,5,2223,2231,2223,2231
Amador,72,2023-05-01,2,2,2,0,101,165,164,1,2,0,0,0,98,98,98,98
Butte,72,2023-05-01,10,12,12,0,210,326,325,1,18,0,0,0,498,500,498,500
Calaveras,72,2023-05-01,1,1,1,0,106,159,158,1,0,0,0,1,143,143,143,143
Colusa,72,2023-05-01,3,3,3,0,26,38,37,1,0,0,0,0,24,25,24,25
Contra Costa,72,2023-05-01,234,384,384,0,4592,7168,7167,1,34,0,0,5,1580,1581,1580,1581
Del Norte,72,2023-05-01,1,1,1,0,55,94,93,1,0,0,0,0,60,60,60,60
El Dorado,72,2023-05-01,25,38,38,0,397,595,594,1,3,0,0,1,246,246,246,246
Fresno,72,2023-05-01,189,290,290,0,4092,6351,6350,1,62,0,0,6,3021,3023,3021,3023
Glenn,72,2023-05-01,2,2,2,0,31,39,38,1,1,0,0,0,53,53,53,53
Humboldt,72,2023-05-01,6,11,11,0,159,235,234,1,0,0,0,0,171,171,171,171
Imperial,72,2023-05-01,64,98,98,0,778,1281,1280,1,12,0,0,0,981,981,981,981
Inyo,72,2023-05-01,7,10,10,0,109,173,172,1,1,0,0,0,63,63,63,63
Kern,72,2023-05-01,50,73,73,0,2050,2731,2730,1,10,0,0,3,2496,2496,2496,2496
Kings,72,2023-05-01,19,31,31,0,396,598,597,1,0,0,0,0,486,486,486,486
Lake,72,2023-05-01,7,13,13,0,184,288,287,1,1,0,0,0,162,162,162,162
Lassen,72,2023-05-01,1,4,4,0,44,63,62,1,0,0,0,0,64,64,64,64
Los Angeles,72,2023-05-01,787,1015,1015,0,3509,4911,4910,1,249,6,63,28,35996,36189,35990,36126
Madera,72,2023-05-01,32,51,51,0,554,848,847,1,2,0,0,0,376,376,376,376
Marin,72,2023-05-01,45,80,80,0,622,1059,1058,1,9,0,0,1,317,317,317,317
Mariposa,72,2023-05-01,0,0,0,0,53,85,84,1,0,0,0,0,31,31,31,31
Mendocino,72,2023-05-01,7,9,9,0,162,252,251,1,1,0,0,0,145,145,145,145
Merced,72,2023-05-01,28,37,37,0,489,733,732,1,2,0,0,1,903,903,903,903
Modoc,72,2023-05-01,0,0,0,0,3,4,3,1,0,0,0,0,9,9,9,9
Mono,72,2023-05-01,1,1,1,0,21,31,30,1,0,0,0,0,8,8,8,8
Monterey,72,2023-05-01,34,56,56,0,826,1367,1366,1,18,0,0,1,811,811,811,811
Napa,72,2023-05-01,23,33,33,0,478,772,771,1,1,0,0,0,172,172,172,172
Nevada,72,2023-05-01,12,14,14,0,133,179,178,1,6,0,0,0,138,138,138,138
Orange,72,2023-05-01,296,438,438,0,7972,11887,11886,1,60,0,0,12,8119,8143,8119,8143
Placer,72,2023-05-01,68,109,109,0,993,1584,1583,1,45,0,0,0,682,682,682,682
Plumas,72,2023-05-01,5,9,9,0,37,67,66,1,0,0,0,0,15,15,15,15
Riverside,72,2023-05-01,159,217,217,0,5204,7167,7166,1,47,0,0,8,6850,6851,6850,6851
Sacramento,72,2023-05-01,351,548,548,0,4522,6792,6791,1,73,1,18,5,3589,3614,3588,3596
San Benito,72,2023-05-01,10,17,17,0,256,453,452,1,0,0,0,0,113,113,113,113
San Bernardino,72,2023-05-01,197,279,279,0,5492,7548,7547,1,54,0,0,12,8133,8133,8133,8133
San Diego,72,2023-05-01,369,536,536,0,11207,16075,16074,1,90,0,0,7,5852,5865,5852,5865
San Francisco,72,2023-05-01,151,228,228,0,3591,5560,5559,1,38,0,0,4,1206,1208,1206,1208
San Joaquin,72,2023-05-01,92,145,145,0,2630,3964,3963,1,15,0,0,2,2442,2443,2442,2443
San Luis Obispo,72,2023-05-01,23,37,37,0,468,693,692,1,3,0,0,0,574,574,574,574
San Mateo,72,2023-05-01,130,208,208,0,2473,3676,3675,1,15,0,0,2,742,742,742,742
Santa Barbara,72,2023-05-01,55,77,77,0,1604,2330,2329,1,16,0,0,1,767,773,767,773
Santa Clara,72,2023-05-01,373,582,582,0,7418,10926,10925,1,95,0,0,15,2768,2775,2768,2775
Santa Cruz,72,2023-05-01,23,31,31,0,889,1203,1202,1,14,0,0,1,276,276,276,276
Shasta,72,2023-05-01,4,4,4,0,192,256,255,1,3,0,0,1,606,606,606,606
Siskiyou,72,2023-05-01,6,8,8,0,84,142,141,1,3,0,0,0,95,95,95,95
Solano,72,2023-05-01,60,98,98,0,1185,1916,1915,1,19,0,0,4,475,475,475,475
Sonoma,72,2023-05-01,71,121,121,0,1382,2251,2250,1,12,0,0,1,565,566,565,566
Stanislaus,72,2023-05-01,56,91,91,0,1330,2113,2112,1,24,0,0,4,1842,1842,1842,1842
Sutter,72,2023-05-01,10,16,16,0,148,254,253,1,0,0,0,0,238,238,238,238
Tehama,72,2023-05-01,5,10,10,0,71,104,103,1,0,0,0,0,236,236,236,236
Trinity,72,2023-05-01,2,2,2,0,9,11,10,1,0,0,0,0,23,23,23,23
Tulare,72,2023-05-01,47,74,74,0,1030,1305,1304,1,9,0,0,0,1595,1596,1595,1596
Tuolumne,72,2023-05-01,8,17,17,0,131,223,222,1,1,0,0,0,211,211,211,211
Ventura,72,2023-05-01,74,109,109,0,1905,3018,3017,1,15,0,0,1,1701,1704,1701,1704
Yolo,72,2023-05-01,32,49,49,0,488,729,728,1,3,0,0,1,451,451,451,451
Yuba,72,2023-05-01,10,13,13,0,180,274,273,1,3,0,0,0,122,122,122,122
California,1,2021-12-21,103245,103245,59375,43870,2141756,2141776,1236627,905149,2652,501,501,937,77427,77427,76926,76926
California,2,2021-12-28,304171,304173,194350,109823,2104282,2104302,1308092,796210,3727,487,487,1032,77914,77914,77427,77427
California,3,2022-01-04,617957,617961,420857,197104,3287469,3287511,2227638,1059873,6642,641,641,1390,78555,78555,77914,77914
California,4,2022-01-11,845819,845825,609337,236488,4649895,4649968,3381890,1268078,10414,1014,1014,1903,79569,79569,78555,78555
California,5,2022-01-18,646610,646616,486545,160071,4018156,4018236,3082943,935293,12775,1495,1495,2404,81064,81064,79569,79569
California,6,2022-01-25,467682,467687,368146,99541,3751436,3751534,3027606,723928,12670,1804,1804,2609,82868,82868,81064,81064
California,7,2022-02-01,242836,242837,198749,44088,3048189,3048283,2566506,481777,10560,1933,1933,2435,84801,84801,82868,82868
California,8,2022-02-08,134613,134613,114095,20518,2616009,2616091,2285356,330735,8051,1738,1738,1958,86539,86539,84801,84801
California,9,2022-02-15,78601,78601,68855,9746,2286411,2286486,2057131,229355,6143,1331,1331,1502,87870,87870,86539,86539
California,10,2022-02-22,44473,44473,40011,4462,1899251,1899320,1746042,153278,4433,980,980,1054,88850,88850,87870,87870
California,11,2022-03-01,30244,30244,27843,2401,1982610,1982698,1858839,123859,3249,666,666,740,89516,89516,88850,88850
California,12,2022-03-08,21649,21649,20288,1361,1799582,1799683,1710298,89385,2336,471,471,536,89987,89987,89516,89516
California,13,2022-03-15,16320,16320,15512,808,1714092,1714201,1647541,66660,1827,336,336,400,90323,90323,89987,89987
California,14,2022-03-22,15037,15037,14463,574,1608925,1609038,1559877,49161,1475,243,243,299,90566,90566,90323,90323
California,15,2022-03-29,15168,15168,14722,446,1485840,1485969,1449809,36160,1145,176,176,246,90742,90742,90566,90566
California,16,2022-04-05,18338,18338,17928,410,1472058,1472209,1444888,27321,936,143,143,202,90885,90885,90742,90742
California,17,2022-04-12,22265,22265,21869,396,1286078,1286222,1266648,19574,884,113,113,156,90998,90998,90885,90885
California,18,2022-04-19,28651,28651,28254,397,1226643,1226811,1211969,14842,819,110,110,153,91108,91108,90998,90998
California,19,2022-04-26,38950,38952,38527,425,1650981,1651293,1636923,14370,877,92,92,131,91200,91200,91108,91108
California,20,2022-05-03,51380,51384,50948,436,1708392,1708805,1697053,11752,967,89,89,142,91289,91289,91200,91200
California,21,2022-05-10,65435,65441,64996,445,1779445,1780000,1770346,9654,1098,95,95,148,91384,91384,91289,91289
California,22,2022-05-17,84601,84614,84161,453,1847476,1848242,1840316,7926,1415,113,113,200,91497,91497,91384,91384
California,23,2022-05-24,99873,99901,99491,410,1873739,1874706,1868407,6299,1737,129,129,224,91626,91626,91497,91497
California,24,2022-05-31,96367,96404,96097,307,1599471,1600419,1596194,4225,2039,139,139,242,91765,91765,91626,91626
California,25,2022-06-07,115649,115709,115415,294,1791870,1793095,1789468,3627,2301,144,144,300,91909,91909,91765,91765
California,26,2022-06-14,103399,103460,103256,204,1306613,1307584,1305313,2271,2498,184,184,298,92093,92093,91909,91909
California,27,2022-06-21,103972,104039,103881,158,1031554,1032420,1030897,1523,2600,217,217,305,92310,92310,92093,92093
California,28,2022-06-28,117256,117343,117210,133,1024347,1025323,1024148,1175,3064,221,221,347,92531,92531,92310,92310
California,29,2022-07-05,114588,114688,114586,102,884185,885105,884309,796,3332,274,274,417,92805,92805,92531,92531
California,30,2022-07-12,136715,136842,136751,91,1032535,1033676,1032959,717,3888,313,313,490,93118,93118,92805,92805
California,31,2022-07-19,128602,128730,128662,68,990532,991692,991156,536,4247,302,302,543,93420,93420,93118,93118
California,32,2022-07-26,115172,115286,115242,44,934931,936065,935664,401,4300,364,364,543,93784,93784,93420,93420
California,33,2022-08-02,96263,96359,96328,31,864414,865504,865208,296,4062,347,347,543,94131,94131,93784,93784
California,34,2022-08-09,80566,80650,80633,17,817115,818183,817960,223,3609,340,340,491,94471,94471,94131,94131
California,35,2022-08-16,67808,67877,67866,11,790492,791559,791384,175,3317,298,298,462,94769,94769,94471,94471
California,36,2022-08-23,60091,60152,60147,5,780326,781415,781273,142,3065,272,272,416,95041,95041,94769,94769
California,37,2022-08-30,50078,50126,50124,2,769540,770675,770560,115,2732,232,232,363,95273,95273,95041,95041
California,38,2022-09-06,36949,36981,36981,0,662563,663586,663499,87,2602,241,241,381,95514,95514,95273,95273
California,39,2022-09-13,33632,33657,33657,0,711909,713040,712959,81,2360,215,215,329,95729,95729,95514,95514
California,40,2022-09-20,27151,27169,27169,0,683329,684455,684384,71,1909,177,177,275,95906,95906,95729,95729
California,41,2022-09-27,25287,25305,25305,0,633224,634292,634230,62,1756,171,171,243,96077,96077,95906,95906
California,42,2022-10-04,22923,22939,22939,0,572128,573129,573070,59,1667,148,148,229,96225,96225,96077,96077
California,43,2022-10-11,23186,23199,23199,0,626991,628105,628047,58,1541,149,149,218,96356,96356,96207,96207
California,44,2022-10-18,18766,18777,18777,0,519309,520275,520218,57,1389,121,121,212,96477,96477,96356,96356
California,45,2022-10-25,18752,18765,18765,0,518668,519674,519617,57,1339,125,125,198,96602,96602,96477,96477
California,46,2022-11-01,21906,21926,21926,0,524362,525432,525375,57,1434,106,106,200,96708,96708,96602,96602
California,47,2022-11-08,27309,27341,27341,0,545492,546661,546604,57,1630,132,132,225,96840,96840,96708,96708
California,48,2022-11-15,32531,32581,32581,0,561864,563121,563064,57,1829,128,128,266,96968,96968,96840,96840
California,49,2022-11-22,42062,42139,42139,0,563620,564923,564866,57,2332,153,153,346,97121,97121,96968,96968
California,50,2022-11-29,58989,59105,59105,0,549224,550590,550533,57,3354,215,215,384,97336,97336,97121,97121
California,51,2022-12-06,64434,64573,64573,0,650889,652564,652506,58,3858,263,263,463,97599,97599,97336,97336
California,52,2022-12-13,55771,55899,55899,0,618792,620502,620444,58,4024,346,346,531,97945,97945,97599,97599
California,53,2022-12-20,50850,50976,50976,0,556198,557851,557794,57,4029,345,345,515,98290,98290,97945,97945
California,54,2022-12-27,46918,47043,47043,0,423962,425325,425268,57,3902,410,410,530,98700,98700,98290,98290
California,55,2023-01-03,42989,43118,43118,0,435623,437171,437114,57,4124,349,349,524,99049,99049,98700,98700
California,56,2023-01-10,30263,30356,30356,0,484505,486459,486402,57,3599,347,347,482,99396,99396,99049,99049
California,57,2023-01-17,20116,20179,20179,0,425167,427071,427014,57,3066,313,313,412,99709,99709,99396,99396
California,58,2023-01-24,18195,18267,18267,0,436241,438402,438345,57,2330,248,248,406,99957,99957,99709,99709
California,59,2023-01-31,19681,19763,19763,0,416238,418474,418417,57,2279,210,210,283,100167,100167,99957,99957
California,60,2023-02-07,21547,21651,21651,0,399522,401997,401940,57,2310,164,164,268,100331,100331,100167,100167
California,61,2023-02-14,21210,21339,21339,0,380995,383765,383709,56,2247,153,157,282,100484,100488,100331,100331
California,62,2023-02-21,20416,20562,20562,0,357934,360972,360916,56,2295,167,171,278,100651,100659,100484,100488
California,63,2023-02-28,19131,19297,19297,0,368986,372647,372591,56,2206,169,175,311,100820,100834,100651,100659
California,64,2023-03-07,16797,16959,16959,0,345523,349437,349381,56,2180,143,149,275,100963,100983,100820,100834
California,65,2023-03-14,15094,15258,15258,0,328639,332849,332793,56,1920,161,172,277,101124,101155,100963,100983
California,66,2023-03-21,12089,12242,12242,0,299449,303824,303768,56,1670,122,130,222,101246,101285,101124,101155
California,67,2023-03-28,10076,10224,10224,0,284443,289231,289175,56,1448,88,95,177,101334,101380,101246,101285
California,68,2023-04-04,10025,10201,10201,0,262193,267467,267411,56,1376,85,98,177,101419,101478,101334,101380
California,69,2023-04-11,9669,9889,9889,0,247808,254186,254130,56,1306,66,93,164,101485,101571,101419,101478
California,70,2023-04-18,9027,9332,9332,0,244947,253768,253712,56,1324,46,93,145,101531,101664,101485,101571
California,71,2023-04-25,8047,8577,8577,0,192304,204911,204855,56,1178,25,109,169,101556,101773,101531,101664
California,72,2023-05-01,4573,6818,6818,0,88917,132152,132096,56,1149,7,81,133,101563,101854,101556,101773
