county,time,date,cases,est_cases,est_omicron_cases,est_other_cases,tests,est_tests,est_omicron_tests,est_other_tests,hospitalizations,deaths,est_deaths,icu,cum_deaths,cum_est_deaths,prev_cum_deaths,prev_cum_est_deaths
Alameda,1,2021-12-20,2976,2976,1416,1560,89677,89689,41880,47809,47,9,9,14,1547,1547,1538,1538
Amador,1,2021-12-20,49,49,18,31,1716,1716,602,1114,2,0,0,3,70,70,70,70
Butte,1,2021-12-20,193,193,101,92,4385,4385,2285,2100,24,5,5,1,359,359,354,354
Calaveras,1,2021-12-20,59,59,23,36,1520,1520,582,938,1,2,2,0,92,92,90,90
Colusa,1,2021-12-20,11,11,5,6,397,397,170,227,1,0,0,0,21,21,21,21
Contra Costa,1,2021-12-20,1686,1686,590,1096,43206,43211,14842,28369,27,4,4,7,1080,1080,1076,1076
Del Norte,1,2021-12-20,19,19,8,11,1378,1378,570,808,0,0,0,0,42,42,42,42
El Dorado,1,2021-12-20,237,237,93,144,4466,4466,1729,2737,4,4,4,3,178,178,174,174
Fresno,1,2021-12-20,1054,1054,379,675,25056,25060,8920,16140,131,19,19,45,2420,2420,2401,2401
Glenn,1,2021-12-20,20,20,8,12,462,462,185,277,0,0,0,0,41,41,41,41
Humboldt,1,2021-12-20,164,164,67,97,3772,3772,1529,2243,11,1,1,2,121,121,120,120
Imperial,1,2021-12-20,585,585,225,360,5535,5535,2109,3426,40,9,9,27,817,817,808,808
Inyo,1,2021-12-20,31,31,14,17,358,358,154,204,1,1,1,0,49,49,48,48
Kern,1,2021-12-20,927,927,401,526,26093,26097,11162,14935,84,24,24,27,2023,2023,1999,1999
Kings,1,2021-12-20,244,244,94,150,6912,6912,2638,4274,15,6,6,3,387,387,381,381
Lake,1,2021-12-20,37,37,13,24,1317,1317,464,853,0,0,0,0,116,116,116,116
Lassen,1,2021-12-20,11,11,5,6,2387,2387,1093,1294,0,0,0,0,54,54,54,54
Los Angeles,1,2021-12-20,31621,31626,22007,9619,985580,985707,676317,309390,574,107,107,174,27375,27375,27268,27268
Madera,1,2021-12-20,159,159,56,103,6014,6014,2122,3892,9,3,3,5,334,334,331,331
Marin,1,2021-12-20,566,566,210,356,11810,11810,4294,7516,5,1,1,1,256,256,255,255
Mariposa,1,2021-12-20,21,21,7,14,448,448,154,294,0,0,0,0,21,21,21,21
Mendocino,1,2021-12-20,91,91,27,64,2687,2687,789,1898,3,2,2,4,103,103,101,101
Merced,1,2021-12-20,323,323,138,185,5616,5616,2366,3250,11,6,6,12,693,693,687,687
Modoc,1,2021-12-20,5,5,2,3,67,67,30,37,2,0,0,0,6,6,6,6
Mono,1,2021-12-20,37,37,10,27,310,310,80,230,1,0,0,0,4,4,4,4
Monterey,1,2021-12-20,480,480,125,355,13256,13256,3420,9836,23,3,3,8,642,642,639,639
Napa,1,2021-12-20,229,229,106,123,5390,5390,2432,2958,2,1,1,2,108,108,107,107
Nevada,1,2021-12-20,161,161,58,103,2765,2765,999,1766,4,1,1,2,110,110,109,109
Orange,1,2021-12-20,4862,4862,2403,2459,99353,99366,48399,50967,132,34,34,56,6005,6005,5971,5971
Placer,1,2021-12-20,547,547,187,360,11155,11155,3769,7386,53,6,6,24,501,501,495,495
Plumas,1,2021-12-20,16,16,6,10,513,513,195,318,0,0,0,0,12,12,12,12
Riverside,1,2021-12-20,5594,5594,2346,3248,78330,78341,32452,45889,238,40,40,82,5578,5578,5538,5538
Sacramento,1,2021-12-20,2144,2144,856,1288,53564,53570,21165,32405,101,21,21,41,2496,2496,2475,2475
San Benito,1,2021-12-20,92,92,41,51,1928,1928,860,1068,2,3,3,2,81,81,78,78
San Bernardino,1,2021-12-20,5005,5005,2366,2639,79687,79699,37181,42518,299,65,65,112,6506,6506,6441,6441
San Diego,1,2021-12-20,8678,8678,5931,2747,149614,149634,101540,48094,249,29,29,94,4479,4479,4450,4450
San Francisco,1,2021-12-20,2984,2984,740,2244,56973,56980,13800,43180,28,3,3,10,693,693,690,690
San Joaquin,1,2021-12-20,962,962,362,600,25324,25328,9394,15934,48,13,13,27,1972,1972,1959,1959
San Luis Obispo,1,2021-12-20,425,425,187,238,9993,9993,4349,5644,11,3,3,6,371,371,368,368
San Mateo,1,2021-12-20,1559,1559,770,789,50573,50579,24504,26075,9,0,0,5,601,601,601,601
Santa Barbara,1,2021-12-20,788,788,326,462,15818,15818,6434,9384,18,8,8,12,570,570,562,562
Santa Clara,1,2021-12-20,2952,2952,1984,968,118669,118685,78656,40029,85,8,8,38,1978,1978,1970,1970
Santa Cruz,1,2021-12-20,404,404,182,222,19811,19813,8759,11054,11,2,2,5,230,230,228,228
Shasta,1,2021-12-20,163,163,65,98,6035,6035,2392,3643,28,8,8,8,448,448,440,440
Siskiyou,1,2021-12-20,20,20,9,11,449,449,207,242,2,2,2,2,63,63,61,61
Solano,1,2021-12-20,496,496,207,289,14746,14746,6067,8679,21,4,4,5,389,389,385,385
Sonoma,1,2021-12-20,751,751,319,432,20778,20780,8668,12112,22,1,1,6,420,420,419,419
Stanislaus,1,2021-12-20,669,669,209,460,13019,13019,4035,8984,90,13,13,22,1431,1431,1418,1418
Sutter,1,2021-12-20,123,123,51,72,2314,2314,946,1368,0,2,2,0,193,193,191,191
Tehama,1,2021-12-20,52,52,17,35,1324,1324,425,899,4,0,0,3,165,165,165,165
Trinity,1,2021-12-20,1,1,0,1,98,98,31,67,0,1,1,0,19,19,18,18
Tulare,1,2021-12-20,404,404,125,279,12352,12352,3799,8553,36,19,19,13,1309,1309,1290,1290
Tuolumne,1,2021-12-20,97,97,35,62,1940,1940,693,1247,7,0,0,0,153,153,153,153
Ventura,1,2021-12-20,2046,2046,1052,994,39236,39241,19903,19338,62,9,9,14,1216,1216,1207,1207
Yolo,1,2021-12-20,329,329,146,183,24683,24688,10815,13873,4,0,0,1,296,296,296,296
Yuba,1,2021-12-20,99,99,42,57,1873,1873,799,1074,3,0,0,4,102,102,102,102
Alameda,2,2021-12-27,7505,7505,4022,3483,87297,87310,46149,41161,89,12,12,19,1559,1559,1547,1547
Amador,2,2021-12-27,92,92,38,54,1445,1445,590,855,2,0,0,3,70,70,70,70
Butte,2,2021-12-27,540,540,318,222,4551,4551,2662,1889,37,3,3,3,362,362,359,359
Calaveras,2,2021-12-27,100,100,45,55,989,989,442,547,1,1,1,1,93,93,92,92
Colusa,2,2021-12-27,27,27,14,13,243,243,119,124,4,0,0,0,21,21,21,21
Contra Costa,2,2021-12-27,5131,5131,2102,3029,46320,46327,18592,27735,44,3,3,16,1083,1083,1080,1080
Del Norte,2,2021-12-27,25,25,12,13,1423,1423,679,744,0,0,0,1,42,42,42,42
El Dorado,2,2021-12-27,516,516,233,283,4081,4081,1814,2267,7,0,0,4,178,178,178,178
Fresno,2,2021-12-27,2199,2199,930,1269,23914,23918,9956,13962,122,16,16,41,2436,2436,2420,2420
Glenn,2,2021-12-27,53,53,24,29,451,451,207,244,0,1,1,0,42,42,41,41
Humboldt,2,2021-12-27,501,501,238,263,3456,3456,1617,1839,10,1,1,0,122,122,121,121
Imperial,2,2021-12-27,881,881,396,485,5910,5910,2617,3293,35,10,10,26,827,827,817,817
Inyo,2,2021-12-27,109,109,54,55,447,447,219,228,0,1,1,0,50,50,49,49
Kern,2,2021-12-27,1988,1988,996,992,22591,22594,11166,11428,79,18,18,36,2041,2041,2023,2023
Kings,2,2021-12-27,505,505,229,276,5481,5481,2433,3048,17,1,1,3,388,388,387,387
Lake,2,2021-12-27,67,67,28,39,1203,1203,495,708,0,1,1,0,117,117,116,116
Lassen,2,2021-12-27,21,21,11,10,2242,2242,1160,1082,0,0,0,0,54,54,54,54
Los Angeles,2,2021-12-27,96077,96092,71566,24526,717662,717772,530991,186781,862,115,115,207,27490,27490,27375,27375
Madera,2,2021-12-27,341,341,144,197,4210,4210,1748,2462,9,2,2,4,336,336,334,334
Marin,2,2021-12-27,1607,1607,688,919,16774,16776,7085,9691,3,0,0,1,256,256,256,256
Mariposa,2,2021-12-27,36,36,15,21,493,493,195,298,0,0,0,0,21,21,21,21
Mendocino,2,2021-12-27,152,152,55,97,2496,2496,862,1634,5,0,0,2,103,103,103,103
Merced,2,2021-12-27,652,652,321,331,5100,5100,2471,2629,11,7,7,10,700,700,693,693
Modoc,2,2021-12-27,3,3,1,2,38,38,19,19,1,0,0,0,6,6,6,6
Mono,2,2021-12-27,123,123,38,85,366,366,110,256,1,0,0,0,4,4,4,4
Monterey,2,2021-12-27,1010,1010,319,691,12881,12881,3971,8910,21,3,3,11,645,645,642,642
Napa,2,2021-12-27,809,809,422,387,6660,6660,3443,3217,6,0,0,1,108,108,108,108
Nevada,2,2021-12-27,236,236,100,136,1984,1984,815,1169,6,1,1,1,111,111,110,110
Orange,2,2021-12-27,18032,18033,10059,7974,130271,130291,71851,58440,256,31,31,66,6036,6036,6005,6005
Placer,2,2021-12-27,1231,1231,494,737,10769,10769,4261,6508,63,2,2,27,503,503,501,501
Plumas,2,2021-12-27,18,18,8,10,299,299,129,170,0,0,0,0,12,12,12,12
Riverside,2,2021-12-27,13686,13687,6602,7085,87494,87507,41716,45791,306,53,53,81,5631,5631,5578,5578
Sacramento,2,2021-12-27,5195,5195,2412,2783,52461,52468,23998,28470,135,22,22,44,2518,2518,2496,2496
San Benito,2,2021-12-27,317,317,163,154,2307,2307,1173,1134,1,3,3,3,84,84,81,81
San Bernardino,2,2021-12-27,14358,14359,7715,6644,87888,87900,46459,41441,341,69,69,141,6575,6575,6506,6506
San Diego,2,2021-12-27,27098,27102,19918,7184,177583,177611,129651,47960,315,34,34,96,4513,4513,4479,4479
San Francisco,2,2021-12-27,6855,6855,2009,4846,65894,65904,19035,46869,31,1,1,14,694,694,693,693
San Joaquin,2,2021-12-27,2363,2363,1042,1321,22763,22767,9881,12886,61,15,15,25,1987,1987,1972,1972
San Luis Obispo,2,2021-12-27,1153,1153,583,570,11180,11181,5562,5619,11,1,1,8,372,372,371,371
San Mateo,2,2021-12-27,5280,5280,2931,2349,55505,55514,30380,25134,19,2,2,5,603,603,601,601
Santa Barbara,2,2021-12-27,2142,2142,1022,1120,15278,15279,7173,8106,33,5,5,10,575,575,570,570
Santa Clara,2,2021-12-27,9055,9055,6553,2502,106756,106772,76600,30172,95,10,10,38,1988,1988,1978,1978
Santa Cruz,2,2021-12-27,946,946,489,457,12416,12417,6302,6115,11,0,0,2,230,230,230,230
Shasta,2,2021-12-27,261,261,122,139,4624,4624,2123,2501,32,5,5,12,453,453,448,448
Siskiyou,2,2021-12-27,21,21,11,10,360,360,190,170,0,0,0,0,63,63,63,63
Solano,2,2021-12-27,1298,1298,626,672,17040,17042,8085,8957,25,5,5,5,394,394,389,389
Sonoma,2,2021-12-27,1913,1913,933,980,21661,21665,10425,11240,19,1,1,5,421,421,420,420
Stanislaus,2,2021-12-27,1250,1250,468,782,11150,11150,4114,7036,94,17,17,18,1448,1448,1431,1431
Sutter,2,2021-12-27,225,225,108,117,2131,2131,1006,1125,0,2,2,0,195,195,193,193
Tehama,2,2021-12-27,103,103,40,63,1106,1106,419,687,6,2,2,3,167,167,165,165
Trinity,2,2021-12-27,4,4,2,2,101,101,37,64,0,0,0,0,19,19,19,19
Tulare,2,2021-12-27,814,814,301,513,11115,11116,4057,7059,36,10,10,9,1319,1319,1309,1309
Tuolumne,2,2021-12-27,170,170,72,98,1670,1670,692,978,5,0,0,1,153,153,153,153
Ventura,2,2021-12-27,5720,5720,3307,2413,39327,39333,22503,16830,66,8,8,19,1224,1224,1216,1216
Yolo,2,2021-12-27,819,819,418,401,22112,22116,11080,11036,7,1,1,4,297,297,296,296
Yuba,2,2021-12-27,164,164,81,83,1534,1534,749,785,8,1,1,4,103,103,102,102
Alameda,3,2022-01-03,17649,17652,10477,7175,117225,117249,69448,47801,156,5,5,31,1564,1564,1559,1559
Amador,3,2022-01-03,218,218,104,114,2179,2179,1029,1150,5,1,1,2,71,71,70,70
Butte,3,2022-01-03,1200,1200,777,423,6871,6871,4430,2441,32,0,0,4,362,362,362,362
Calaveras,3,2022-01-03,232,232,120,112,1305,1305,666,639,0,1,1,1,94,94,93,93
Colusa,3,2022-01-03,48,48,26,22,393,393,217,176,5,0,0,0,21,21,21,21
Contra Costa,3,2022-01-03,13498,13499,6279,7220,69094,69106,32061,37045,76,10,10,21,1093,1093,1083,1083
Del Norte,3,2022-01-03,86,86,47,39,2132,2132,1143,989,0,0,0,0,42,42,42,42
El Dorado,3,2022-01-03,1282,1282,656,626,6060,6060,3078,2982,7,4,4,6,182,182,178,178
Fresno,3,2022-01-03,6429,6429,3088,3341,38676,38683,18466,20217,175,14,14,44,2450,2450,2436,2436
Glenn,3,2022-01-03,76,76,39,37,610,610,318,292,0,1,1,0,43,43,42,42
Humboldt,3,2022-01-03,880,880,470,410,5295,5295,2810,2485,9,1,1,3,123,123,122,122
Imperial,3,2022-01-03,1877,1877,955,922,9147,9148,4619,4529,35,14,14,29,841,841,827,827
Inyo,3,2022-01-03,265,265,147,118,713,713,394,319,3,0,0,0,50,50,50,50
Kern,3,2022-01-03,5833,5833,3270,2563,35873,35881,20001,15880,100,16,16,32,2057,2057,2041,2041
Kings,3,2022-01-03,1093,1093,560,533,8511,8512,4310,4202,13,3,3,5,391,391,388,388
Lake,3,2022-01-03,220,220,106,114,1776,1776,846,930,1,0,0,1,117,117,117,117
Lassen,3,2022-01-03,61,61,35,26,3119,3119,1806,1313,2,0,0,0,54,54,54,54
Los Angeles,3,2022-01-03,204013,204055,160481,43574,1087970,1088191,856125,232066,1937,149,149,303,27639,27639,27490,27490
Madera,3,2022-01-03,829,829,397,432,6362,6362,3024,3338,17,3,3,6,339,339,336,336
Marin,3,2022-01-03,2367,2367,1150,1217,17674,17678,8533,9145,15,1,1,3,257,257,256,256
Mariposa,3,2022-01-03,103,103,48,55,657,657,304,353,0,0,0,0,21,21,21,21
Mendocino,3,2022-01-03,452,452,186,266,3572,3572,1454,2118,7,1,1,2,104,104,103,103
Merced,3,2022-01-03,1548,1548,850,698,8548,8549,4667,3882,3,9,9,4,709,709,700,700
Modoc,3,2022-01-03,15,15,8,7,59,59,33,26,0,0,0,0,6,6,6,6
Mono,3,2022-01-03,180,180,65,115,435,435,156,279,2,0,0,0,4,4,4,4
Monterey,3,2022-01-03,2461,2461,906,1555,20637,20641,7548,13093,30,4,4,10,649,649,645,645
Napa,3,2022-01-03,1855,1855,1075,780,11755,11756,6790,4966,9,1,1,3,109,109,108,108
Nevada,3,2022-01-03,646,646,313,333,3070,3070,1485,1585,7,1,1,3,112,112,111,111
Orange,3,2022-01-03,45442,45450,27772,17678,220179,220223,134360,85863,504,33,33,110,6069,6069,6036,6036
Placer,3,2022-01-03,2871,2871,1316,1555,15068,15072,6863,8209,113,15,15,24,518,518,503,503
Plumas,3,2022-01-03,54,54,27,27,496,496,248,248,1,0,0,0,12,12,12,12
Riverside,3,2022-01-03,32031,32038,17304,14734,138442,138470,74458,64012,564,54,54,94,5685,5685,5631,5631
Sacramento,3,2022-01-03,14137,14138,7383,6755,80485,80502,41836,38666,219,25,25,57,2543,2543,2518,2518
San Benito,3,2022-01-03,738,738,421,317,3464,3464,1976,1488,3,1,1,2,85,85,84,84
San Bernardino,3,2022-01-03,33809,33816,20002,13814,135043,135070,79612,55458,571,93,93,136,6668,6668,6575,6575
San Diego,3,2022-01-03,61075,61087,47455,13632,253638,253689,196979,56710,561,33,33,121,4546,4546,4513,4513
San Francisco,3,2022-01-03,11428,11429,3970,7459,85493,85511,29506,56005,78,5,5,22,699,699,694,694
San Joaquin,3,2022-01-03,6977,6977,3479,3498,36111,36118,17894,18224,80,13,13,27,2000,2000,1987,1987
San Luis Obispo,3,2022-01-03,2475,2475,1387,1088,15962,15966,8919,7047,24,5,5,7,377,377,372,372
San Mateo,3,2022-01-03,10630,10631,6508,4123,81912,81928,50064,31864,37,4,4,7,607,607,603,603
Santa Barbara,3,2022-01-03,5322,5322,2849,2473,28185,28192,15052,13140,53,5,5,7,580,580,575,575
Santa Clara,3,2022-01-03,23029,23034,17708,5326,169856,169890,130422,39468,186,10,10,58,1998,1998,1988,1988
Santa Cruz,3,2022-01-03,2405,2405,1385,1020,21654,21658,12483,9175,15,5,5,3,235,235,230,230
Shasta,3,2022-01-03,601,601,318,283,6173,6173,3228,2945,33,2,2,13,455,455,453,453
Siskiyou,3,2022-01-03,74,74,44,30,590,590,348,242,0,0,0,0,63,63,63,63
Solano,3,2022-01-03,4068,4068,2178,1890,26129,26133,13981,12152,54,2,2,9,396,396,394,394
Sonoma,3,2022-01-03,4540,4540,2480,2060,32185,32191,17531,14660,25,7,7,4,428,428,421,421
Stanislaus,3,2022-01-03,3332,3332,1435,1897,17983,17987,7689,10298,129,9,9,20,1457,1457,1448,1448
Sutter,3,2022-01-03,547,547,296,251,2980,2980,1594,1386,0,2,2,0,197,197,195,195
Tehama,3,2022-01-03,215,215,96,119,1465,1465,648,817,4,1,1,2,168,168,167,167
Trinity,3,2022-01-03,13,13,6,7,107,107,46,61,0,0,0,0,19,19,19,19
Tulare,3,2022-01-03,2131,2131,912,1219,16005,16008,6776,9232,57,5,5,7,1324,1324,1319,1319
Tuolumne,3,2022-01-03,383,383,186,197,2544,2544,1227,1317,7,3,3,0,156,156,153,153
Ventura,3,2022-01-03,12666,12667,7984,4683,59668,59679,37565,22114,136,11,11,28,1235,1235,1224,1224
Yolo,3,2022-01-03,2315,2315,1320,995,31686,31692,17927,13765,8,4,4,3,301,301,297,297
Yuba,3,2022-01-03,472,472,262,210,2331,2331,1284,1047,17,1,1,6,104,104,103,103
Alameda,4,2022-01-10,31196,31203,20215,10988,193819,193868,125727,68141,277,14,14,46,1578,1578,1564,1564
Amador,4,2022-01-10,391,391,209,182,2726,2726,1447,1279,4,0,0,4,71,71,71,71
Butte,4,2022-01-10,1999,1999,1395,604,10455,10456,7285,3171,55,2,2,4,364,364,362,362
Calaveras,4,2022-01-10,523,523,299,224,2608,2608,1479,1129,0,1,1,2,95,95,94,94
Colusa,4,2022-01-10,105,105,65,40,756,756,462,294,5,0,0,0,21,21,21,21
Contra Costa,4,2022-01-10,19690,19695,10315,9380,102196,102221,53527,48694,152,12,12,24,1105,1105,1093,1093
Del Norte,4,2022-01-10,178,178,106,72,3958,3958,2363,1595,2,0,0,0,42,42,42,42
El Dorado,4,2022-01-10,2218,2218,1262,956,9360,9361,5324,4037,14,6,6,2,188,188,182,182
Fresno,4,2022-01-10,13234,13237,7154,6083,60051,60064,32388,27676,301,14,14,47,2464,2464,2450,2450
Glenn,4,2022-01-10,219,219,127,92,938,938,544,394,2,0,0,0,43,43,43,43
Humboldt,4,2022-01-10,1400,1400,827,573,8355,8355,4924,3431,18,5,5,2,128,128,123,123
Imperial,4,2022-01-10,3623,3623,2047,1576,13837,13842,7805,6037,58,11,11,25,852,852,841,841
Inyo,4,2022-01-10,408,408,248,160,1356,1356,826,530,4,2,2,0,52,52,50,50
Kern,4,2022-01-10,11937,11938,7341,4597,57114,57128,35090,22038,181,26,26,35,2083,2083,2057,2057
Kings,4,2022-01-10,2415,2415,1382,1033,13013,13015,7403,5612,33,1,1,4,392,392,391,391
Lake,4,2022-01-10,499,499,268,231,2761,2761,1477,1284,0,3,3,1,120,120,117,117
Lassen,4,2022-01-10,194,194,124,70,3438,3438,2185,1253,1,0,0,0,54,54,54,54
Los Angeles,4,2022-01-10,328914,328995,270785,58210,1914800,1915272,1576929,338343,3253,270,270,513,27909,27909,27639,27639
Madera,4,2022-01-10,1909,1909,1027,882,10379,10381,5547,4834,19,1,1,6,340,340,339,339
Marin,4,2022-01-10,2939,2939,1601,1338,21010,21016,11440,9576,18,3,3,5,260,260,257,257
Mariposa,4,2022-01-10,199,199,105,94,1158,1158,607,551,0,1,1,0,22,22,21,21
Mendocino,4,2022-01-10,875,875,411,464,5535,5535,2580,2955,8,2,2,2,106,106,104,104
Merced,4,2022-01-10,3689,3689,2233,1456,14516,14521,8778,5743,33,10,10,11,719,719,709,709
Modoc,4,2022-01-10,13,13,8,5,109,109,67,42,0,0,0,0,6,6,6,6
Mono,4,2022-01-10,253,253,106,147,863,863,360,503,1,1,1,0,5,5,4,4
Monterey,4,2022-01-10,4976,4976,2115,2861,33232,33241,14055,19186,44,5,5,12,654,654,649,649
Napa,4,2022-01-10,2648,2648,1680,968,14353,14358,9106,5252,14,1,1,4,110,110,109,109
Nevada,4,2022-01-10,1185,1185,644,541,5232,5232,2839,2393,10,2,2,3,114,114,112,112
Orange,4,2022-01-10,60036,60051,39970,20081,317569,317647,211494,106153,854,100,100,159,6169,6169,6069,6069
Placer,4,2022-01-10,5233,5233,2711,2522,22554,22559,11668,10891,179,6,6,29,524,524,518,518
Plumas,4,2022-01-10,142,142,79,63,803,803,446,357,5,0,0,0,12,12,12,12
Riverside,4,2022-01-10,48247,48260,28852,19408,187740,187786,112232,75554,762,83,83,139,5768,5768,5685,5685
Sacramento,4,2022-01-10,27511,27517,15923,11594,121778,121810,70494,51316,375,37,37,89,2580,2580,2543,2543
San Benito,4,2022-01-10,1040,1040,655,385,4615,4615,2909,1706,3,1,1,2,86,86,85,85
San Bernardino,4,2022-01-10,50658,50670,32823,17847,192715,192762,124813,67949,784,113,113,187,6781,6781,6668,6668
San Diego,4,2022-01-10,82764,82785,67454,15331,330053,330135,269039,61096,895,65,65,166,4611,4611,4546,4546
San Francisco,4,2022-01-10,15079,15084,6030,9054,117228,117257,46943,70314,158,12,12,35,711,711,699,699
San Joaquin,4,2022-01-10,14507,14512,8086,6426,66807,66823,37173,29650,151,15,15,45,2015,2015,2000,2000
San Luis Obispo,4,2022-01-10,4335,4335,2675,1660,21621,21626,13360,8266,30,2,2,7,379,379,377,377
San Mateo,4,2022-01-10,15006,15011,9998,5013,113009,113037,75283,37754,95,5,5,16,612,612,607,607
Santa Barbara,4,2022-01-10,8536,8536,5053,3483,47380,47393,28058,19335,84,9,9,10,589,589,580,580
Santa Clara,4,2022-01-10,36518,36526,29477,7049,270805,270873,218545,52328,350,26,26,68,2024,2024,1998,1998
Santa Cruz,4,2022-01-10,4541,4541,2860,1681,42805,42817,26981,15836,25,2,2,2,237,237,235,235
Shasta,4,2022-01-10,1055,1055,616,439,8404,8405,4893,3512,37,7,7,12,462,462,455,455
Siskiyou,4,2022-01-10,120,120,77,43,919,919,591,328,3,1,1,1,64,64,63,63
Solano,4,2022-01-10,6916,6916,4121,2795,37113,37122,22130,14992,94,6,6,15,402,402,396,396
Sonoma,4,2022-01-10,8860,8860,5338,3522,47193,47206,28458,18748,72,9,9,8,437,437,428,428
Stanislaus,4,2022-01-10,6738,6738,3301,3437,29310,29317,14323,14994,173,13,13,19,1470,1470,1457,1457
Sutter,4,2022-01-10,1245,1245,743,502,5062,5062,3006,2056,0,2,2,0,199,199,197,197
Tehama,4,2022-01-10,511,511,256,255,2482,2482,1241,1241,13,1,1,1,169,169,168,168
Trinity,4,2022-01-10,38,38,19,19,275,275,135,140,0,0,0,0,19,19,19,19
Tulare,4,2022-01-10,5194,5194,2531,2663,24072,24078,11672,12406,66,9,9,8,1333,1333,1324,1324
Tuolumne,4,2022-01-10,804,804,435,369,4178,4178,2257,1921,13,1,1,1,157,157,156,156
Ventura,4,2022-01-10,17504,17509,11974,5535,88202,88224,60309,27915,227,23,23,34,1258,1258,1235,1235
Yolo,4,2022-01-10,3762,3762,2342,1420,48226,48238,30000,18238,6,4,4,1,305,305,301,301
Yuba,4,2022-01-10,1022,1022,624,398,4107,4107,2504,1603,41,0,0,7,104,104,104,104
Alameda,5,2022-01-17,24849,24856,17436,7420,170522,170574,119587,50987,366,32,32,62,1610,1610,1578,1578
Amador,5,2022-01-17,476,476,282,194,3557,3557,2081,1476,10,2,2,3,73,73,71,71
Butte,5,2022-01-17,2062,2062,1537,525,9327,9330,6951,2379,58,6,6,6,370,370,364,364
Calaveras,5,2022-01-17,564,564,353,211,2473,2473,1543,930,3,2,2,3,97,97,95,95
Colusa,5,2022-01-17,161,161,107,54,719,719,476,243,3,0,0,0,21,21,21,21
Contra Costa,5,2022-01-17,16191,16196,9456,6740,87991,88018,51308,36710,198,22,22,41,1127,1127,1105,1105
Del Norte,5,2022-01-17,200,200,131,69,3758,3758,2429,1329,2,0,0,1,42,42,42,42
El Dorado,5,2022-01-17,1963,1963,1227,736,8063,8064,5042,3022,9,4,4,2,192,192,188,188
Fresno,5,2022-01-17,17050,17056,10218,6838,66164,66185,39604,26581,386,27,27,61,2491,2491,2464,2464
Glenn,5,2022-01-17,307,307,194,113,1076,1076,683,393,3,2,2,0,45,45,43,43
Humboldt,5,2022-01-17,1141,1141,737,404,8322,8324,5366,2958,10,1,1,4,129,129,128,128
Imperial,5,2022-01-17,3408,3408,2119,1289,13240,13245,8233,5012,69,12,12,29,864,864,852,852
Inyo,5,2022-01-17,327,327,216,111,1040,1040,688,352,4,0,0,0,52,52,52,52
Kern,5,2022-01-17,11686,11689,7800,3889,51810,51826,34542,17284,242,29,29,44,2112,2112,2083,2083
Kings,5,2022-01-17,3194,3194,1995,1199,14866,14871,9261,5610,40,4,4,1,396,396,392,392
Lake,5,2022-01-17,583,583,348,235,3246,3246,1936,1310,2,1,1,2,121,121,120,120
Lassen,5,2022-01-17,283,283,195,88,3322,3322,2278,1044,0,0,0,0,54,54,54,54
Los Angeles,5,2022-01-17,218275,218343,186786,31557,1610319,1610817,1377075,233742,4034,504,504,680,28413,28413,27909,27909
Madera,5,2022-01-17,2393,2393,1427,966,10611,10615,6304,4311,32,5,5,10,345,345,340,340
Marin,5,2022-01-17,2420,2420,1461,959,17702,17707,10681,7026,38,4,4,6,264,264,260,260
Mariposa,5,2022-01-17,163,163,95,68,1115,1115,648,467,0,0,0,0,22,22,22,22
Mendocino,5,2022-01-17,921,921,486,435,5015,5015,2630,2385,18,3,3,2,109,109,106,106
Merced,5,2022-01-17,3929,3929,2590,1339,13639,13644,8992,4652,41,18,18,11,737,737,719,719
Modoc,5,2022-01-17,13,13,9,4,102,102,68,34,0,1,1,0,7,7,6,6
Mono,5,2022-01-17,198,198,94,104,809,809,386,423,2,0,0,0,5,5,5,5
Monterey,5,2022-01-17,5896,5896,2857,3039,28326,28336,13714,14622,69,6,6,14,660,660,654,654
Napa,5,2022-01-17,1927,1927,1327,600,11914,11919,8180,3739,21,2,2,5,112,112,110,110
Nevada,5,2022-01-17,1251,1251,751,500,5429,5429,3261,2168,19,1,1,1,115,115,114,114
Orange,5,2022-01-17,41285,41298,29623,11675,251461,251540,180262,71278,998,111,111,199,6280,6280,6169,6169
Placer,5,2022-01-17,4326,4326,2498,1828,19462,19467,11220,8247,178,14,14,36,538,538,524,524
Plumas,5,2022-01-17,194,194,119,75,852,852,524,328,3,0,0,0,12,12,12,12
Riverside,5,2022-01-17,41234,41246,26964,14282,168044,168096,109905,58191,920,97,97,158,5865,5865,5768,5768
Sacramento,5,2022-01-17,21456,21462,13658,7804,101457,101490,64510,36980,473,64,64,97,2644,2644,2580,2580
San Benito,5,2022-01-17,904,904,619,285,4272,4272,2921,1351,4,1,1,4,87,87,86,86
San Bernardino,5,2022-01-17,38532,38545,26963,11582,164346,164396,114996,49400,936,144,144,227,6925,6925,6781,6781
San Diego,5,2022-01-17,60730,60750,51568,9182,265917,266000,225816,40184,1067,101,101,193,4712,4712,4611,4611
San Francisco,5,2022-01-17,11260,11265,5203,6062,93966,93996,43298,50698,212,14,14,44,725,725,711,711
San Joaquin,5,2022-01-17,12719,12724,7806,4918,58089,58107,35656,22451,201,20,20,57,2035,2035,2015,2015
San Luis Obispo,5,2022-01-17,3933,3933,2646,1287,21021,21026,14128,6898,46,12,12,10,391,391,379,379
San Mateo,5,2022-01-17,12472,12477,8941,3536,95898,95928,68655,27273,92,10,10,30,622,622,612,612
Santa Barbara,5,2022-01-17,6849,6849,4443,2406,40484,40496,26237,14259,123,12,12,12,601,601,589,589
Santa Clara,5,2022-01-17,29593,29602,24907,4695,235489,235562,198078,37484,451,24,24,84,2048,2048,2024,2024
Santa Cruz,5,2022-01-17,4181,4181,2866,1315,42199,42212,28868,13344,23,3,3,3,240,240,237,237
Shasta,5,2022-01-17,1345,1345,862,483,9163,9166,5846,3320,55,7,7,14,469,469,462,462
Siskiyou,5,2022-01-17,158,158,110,48,927,927,640,287,3,1,1,2,65,65,64,64
Solano,5,2022-01-17,6431,6431,4197,2234,35192,35203,22973,12230,121,6,6,22,408,408,402,402
Sonoma,5,2022-01-17,7620,7620,5021,2599,42775,42789,28139,14650,73,7,7,15,444,444,437,437
Stanislaus,5,2022-01-17,7322,7322,4016,3306,29051,29062,15918,13144,206,10,10,31,1480,1480,1470,1470
Sutter,5,2022-01-17,1246,1246,810,436,4863,4863,3161,1702,0,4,4,0,203,203,199,199
Tehama,5,2022-01-17,614,614,343,271,2420,2420,1349,1071,15,5,5,2,174,174,169,169
Trinity,5,2022-01-17,41,41,23,18,255,255,140,115,0,1,1,0,20,20,19,19
Tulare,5,2022-01-17,7461,7461,4061,3400,27085,27092,14726,12366,97,16,16,16,1349,1349,1333,1333
Tuolumne,5,2022-01-17,884,884,530,354,3835,3835,2286,1549,10,8,8,1,165,165,157,157
Ventura,5,2022-01-17,11973,11978,8783,3195,66927,66947,49027,17920,300,41,41,56,1299,1299,1258,1258
Yolo,5,2022-01-17,2802,2802,1897,905,39481,39494,26703,12791,15,4,4,4,309,309,305,305
Yuba,5,2022-01-17,1063,1063,706,357,3747,3747,2489,1258,42,2,2,6,106,106,104,104
Alameda,6,2022-01-24,19836,19843,14897,4946,171829,171904,129229,42675,373,41,41,68,1651,1651,1610,1610
Amador,6,2022-01-24,544,544,352,192,4667,4667,3019,1648,8,0,0,5,73,73,73,73
Butte,6,2022-01-24,1903,1903,1500,403,9606,9611,7593,2018,82,10,10,9,380,380,370,370
Calaveras,6,2022-01-24,556,556,378,178,2507,2507,1705,802,6,2,2,2,99,99,97,97
Colusa,6,2022-01-24,177,177,127,50,951,951,680,271,6,0,0,0,21,21,21,21
Contra Costa,6,2022-01-24,13553,13558,8713,4845,85287,85325,54894,30431,217,25,25,64,1152,1152,1127,1127
Del Norte,6,2022-01-24,348,348,246,102,4326,4326,3042,1284,3,0,0,3,42,42,42,42
El Dorado,6,2022-01-24,1403,1403,956,447,7329,7333,5003,2330,17,2,2,6,194,194,192,192
Fresno,6,2022-01-24,17443,17449,11433,6016,68803,68832,45183,23649,491,43,43,83,2534,2534,2491,2491
Glenn,6,2022-01-24,249,249,172,77,971,971,670,301,0,0,0,0,45,45,45,45
Humboldt,6,2022-01-24,915,915,641,274,7713,7717,5411,2306,25,3,3,3,132,132,129,129
Imperial,6,2022-01-24,3613,3613,2452,1161,13187,13192,8972,4220,70,14,14,27,878,878,864,864
Inyo,6,2022-01-24,142,142,102,40,625,625,449,176,1,1,1,0,53,53,52,52
Kern,6,2022-01-24,10554,10559,7602,2957,53944,53967,38904,15063,267,47,47,51,2159,2159,2112,2112
Kings,6,2022-01-24,4298,4298,2920,1378,19064,19071,12981,6090,40,4,4,4,400,400,396,396
Lake,6,2022-01-24,746,746,488,258,3417,3417,2234,1183,6,2,2,3,123,123,121,121
Lassen,6,2022-01-24,418,418,307,111,3982,3982,2932,1050,6,0,0,0,54,54,54,54
Los Angeles,6,2022-01-24,164804,164873,145640,19233,1659105,1659803,1467214,192589,3769,611,611,785,29024,29024,28413,28413
Madera,6,2022-01-24,2708,2708,1766,942,12170,12175,7941,4234,49,7,7,10,352,352,345,345
Marin,6,2022-01-24,1857,1857,1227,630,17547,17553,11611,5942,38,4,4,10,268,268,264,264
Mariposa,6,2022-01-24,134,134,86,48,946,946,606,340,0,0,0,0,22,22,22,22
Mendocino,6,2022-01-24,917,917,538,379,4873,4873,2854,2019,23,2,2,3,111,111,109,109
Merced,6,2022-01-24,3159,3159,2254,905,12907,12912,9217,3695,55,9,9,12,746,746,737,737
Modoc,6,2022-01-24,14,14,10,4,114,114,82,32,2,0,0,0,7,7,7,7
Mono,6,2022-01-24,97,97,52,45,422,422,227,195,1,0,0,0,5,5,5,5
Monterey,6,2022-01-24,5080,5080,2770,2310,31794,31808,17341,14467,80,9,9,17,669,669,660,660
Napa,6,2022-01-24,1672,1672,1236,436,12465,12470,9209,3261,23,5,5,4,117,117,112,112
Nevada,6,2022-01-24,999,999,658,341,4807,4808,3172,1636,29,1,1,6,116,116,115,115
Orange,6,2022-01-24,26655,26666,20378,6288,230894,230991,176770,54221,923,176,176,191,6456,6456,6280,6280
Placer,6,2022-01-24,3658,3658,2328,1330,18642,18650,11871,6779,215,8,8,43,546,546,538,538
Plumas,6,2022-01-24,215,215,144,71,836,836,559,277,5,0,0,0,12,12,12,12
Riverside,6,2022-01-24,31898,31911,22578,9333,158772,158840,112507,46333,901,122,122,168,5987,5987,5865,5865
Sacramento,6,2022-01-24,17499,17506,12113,5393,98831,98873,68450,30423,542,63,63,105,2707,2707,2644,2644
San Benito,6,2022-01-24,776,776,570,206,3928,3928,2888,1040,7,1,1,3,88,88,87,87
San Bernardino,6,2022-01-24,28089,28102,21060,7042,153565,153630,115245,38385,975,170,170,223,7095,7095,6925,6925
San Diego,6,2022-01-24,51531,51553,45247,6306,252111,252217,221614,30603,1056,129,129,232,4841,4841,4712,4712
San Francisco,6,2022-01-24,8096,8100,4234,3866,88908,88945,46553,42392,232,19,19,37,744,744,725,725
San Joaquin,6,2022-01-24,11042,11047,7398,3649,59056,59081,39649,19432,241,34,34,71,2069,2069,2035,2035
San Luis Obispo,6,2022-01-24,3562,3562,2583,979,21516,21525,15609,5916,42,10,10,12,401,401,391,391
San Mateo,6,2022-01-24,8503,8508,6500,2008,95128,95169,72764,22405,139,19,19,28,641,641,622,622
Santa Barbara,6,2022-01-24,6483,6485,4559,1926,43826,43845,30835,13010,127,12,12,19,613,613,601,601
Santa Clara,6,2022-01-24,22810,22821,19903,2918,233005,233104,203281,29823,412,48,48,88,2096,2096,2048,2048
Santa Cruz,6,2022-01-24,5039,5040,3707,1333,45614,45633,33584,12049,31,1,1,2,241,241,240,240
Shasta,6,2022-01-24,1484,1484,1031,453,10135,10140,7036,3104,78,7,7,9,476,476,469,469
Siskiyou,6,2022-01-24,159,159,118,41,857,857,635,222,6,3,3,1,68,68,65,65
Solano,6,2022-01-24,5125,5125,3625,1500,32611,32626,23092,9534,143,14,14,26,422,422,408,408
Sonoma,6,2022-01-24,6916,6918,4925,1993,42473,42491,30258,12233,94,7,7,18,451,451,444,444
Stanislaus,6,2022-01-24,6368,6369,3872,2497,28263,28275,17216,11059,277,27,27,44,1507,1507,1480,1480
Sutter,6,2022-01-24,1046,1046,736,310,5001,5001,3520,1481,0,2,2,0,205,205,203,203
Tehama,6,2022-01-24,576,576,356,220,2702,2702,1674,1028,19,4,4,5,178,178,174,174
Trinity,6,2022-01-24,63,63,38,25,322,322,196,126,0,0,0,0,20,20,20,20
Tulare,6,2022-01-24,7660,7664,4624,3040,29523,29535,17858,11677,138,11,11,14,1360,1360,1349,1349
Tuolumne,6,2022-01-24,950,950,626,324,3823,3823,2508,1315,17,3,3,3,168,168,165,165
Ventura,6,2022-01-24,9408,9413,7332,2081,68515,68545,53447,15098,269,28,28,68,1327,1327,1299,1299
Yolo,6,2022-01-24,2297,2297,1675,622,40461,40478,29513,10965,18,12,12,5,321,321,309,309
Yuba,6,2022-01-24,911,911,653,258,3778,3778,2710,1068,54,3,3,10,109,109,106,106
Alameda,7,2022-01-31,11016,11022,8760,2262,137333,137403,109336,28067,336,50,50,75,1701,1701,1651,1651
Amador,7,2022-01-31,347,347,244,103,3226,3226,2273,953,15,1,1,4,74,74,73,73
Butte,7,2022-01-31,1167,1167,966,201,7608,7612,6308,1304,80,6,6,7,386,386,380,380
Calaveras,7,2022-01-31,263,263,193,70,1940,1940,1424,516,3,5,5,2,104,104,99,99
Colusa,7,2022-01-31,106,106,81,25,704,704,540,164,9,0,0,0,21,21,21,21
Contra Costa,7,2022-01-31,7305,7310,5096,2214,68616,68652,47938,20714,207,39,39,54,1191,1191,1152,1152
Del Norte,7,2022-01-31,315,315,237,78,3957,3958,2978,980,6,2,2,2,44,44,42,42
El Dorado,7,2022-01-31,739,739,542,197,6019,6023,4423,1600,13,4,4,5,198,198,194,194
Fresno,7,2022-01-31,10901,10906,7734,3172,54898,54926,39004,15922,503,39,39,98,2573,2573,2534,2534
Glenn,7,2022-01-31,189,189,140,49,759,759,563,196,2,2,2,0,47,47,45,45
Humboldt,7,2022-01-31,585,585,440,145,5790,5794,4351,1443,18,3,3,3,135,135,132,132
Imperial,7,2022-01-31,2192,2192,1598,594,11300,11305,8265,3040,71,17,17,28,895,895,878,878
Inyo,7,2022-01-31,55,55,42,13,467,467,357,110,5,3,3,0,56,56,53,53
Kern,7,2022-01-31,5646,5648,4339,1309,42262,42285,32520,9765,264,47,47,54,2206,2206,2159,2159
Kings,7,2022-01-31,2386,2386,1746,640,13681,13686,10021,3665,55,5,5,4,405,405,400,400
Lake,7,2022-01-31,478,478,338,140,3193,3193,2258,935,4,4,4,4,127,127,123,123
Lassen,7,2022-01-31,311,311,243,68,3624,3624,2838,786,7,1,1,0,55,55,54,54
Los Angeles,7,2022-01-31,74541,74580,67647,6933,1302823,1303504,1183138,120366,2991,640,640,719,29664,29664,29024,29024
Madera,7,2022-01-31,1739,1739,1230,509,9628,9633,6817,2816,50,6,6,7,358,358,352,352
Marin,7,2022-01-31,1063,1063,759,304,13816,13822,9892,3930,26,5,5,9,273,273,268,268
Mariposa,7,2022-01-31,101,101,70,31,840,840,584,256,0,2,2,0,24,24,22,22
Mendocino,7,2022-01-31,463,463,299,164,3486,3486,2252,1234,12,3,3,4,114,114,111,111
Merced,7,2022-01-31,2115,2115,1610,505,10464,10469,7978,2491,54,12,12,14,758,758,746,746
Modoc,7,2022-01-31,12,12,9,3,89,89,68,21,1,0,0,0,7,7,7,7
Mono,7,2022-01-31,41,41,25,16,339,339,203,136,0,0,0,0,5,5,5,5
Monterey,7,2022-01-31,3557,3557,2153,1404,26742,26756,16237,10519,82,9,9,13,678,678,669,669
Napa,7,2022-01-31,988,988,776,212,9376,9381,7358,2023,17,7,7,10,124,124,117,117
Nevada,7,2022-01-31,565,565,401,164,3912,3913,2789,1124,26,3,3,5,119,119,116,116
Orange,7,2022-01-31,11984,11990,9673,2317,177025,177118,143001,34117,708,169,169,164,6625,6625,6456,6456
Placer,7,2022-01-31,2263,2263,1565,698,15374,15382,10652,4730,152,19,19,42,565,565,546,546
Plumas,7,2022-01-31,137,137,98,39,753,753,542,211,1,0,0,0,12,12,12,12
Riverside,7,2022-01-31,15941,15950,12055,3895,121038,121101,91736,29365,740,111,111,171,6098,6098,5987,5987
Sacramento,7,2022-01-31,10174,10179,7553,2626,77582,77622,57679,19943,501,92,92,106,2799,2799,2707,2707
San Benito,7,2022-01-31,471,471,367,104,3320,3320,2594,726,5,2,2,3,90,90,88,88
San Bernardino,7,2022-01-31,13244,13250,10515,2735,116536,116596,92640,23956,744,185,185,207,7280,7280,7095,7095
San Diego,7,2022-01-31,24897,24911,22475,2436,181378,181472,163873,17599,944,105,105,214,4946,4946,4841,4841
San Francisco,7,2022-01-31,4040,4040,2355,1685,69153,69189,40415,28774,208,24,24,45,768,768,744,744
San Joaquin,7,2022-01-31,5703,5707,4129,1578,43638,43662,31653,12009,210,36,36,75,2105,2105,2069,2069
San Luis Obispo,7,2022-01-31,1979,1979,1528,451,16236,16244,12547,3697,40,12,12,10,413,413,401,401
San Mateo,7,2022-01-31,4317,4317,3480,837,75096,75135,60593,14542,131,10,10,19,651,651,641,641
Santa Barbara,7,2022-01-31,3634,3634,2733,901,35024,35042,26397,8645,103,23,23,13,636,636,613,613
Santa Clara,7,2022-01-31,13852,13859,12436,1423,206806,206914,185719,21195,427,54,54,93,2150,2150,2096,2096
Santa Cruz,7,2022-01-31,3436,3436,2678,758,51416,51443,40168,11275,35,5,5,6,246,246,241,241
Shasta,7,2022-01-31,900,900,670,230,8419,8424,6273,2151,59,14,14,11,490,490,476,476
Siskiyou,7,2022-01-31,119,119,94,25,691,691,545,146,8,2,2,2,70,70,68,68
Solano,7,2022-01-31,3812,3812,2885,927,28697,28713,21728,6985,126,6,6,30,428,428,422,422
Sonoma,7,2022-01-31,3570,3570,2712,858,32146,32164,24465,7699,84,12,12,15,463,463,451,451
Stanislaus,7,2022-01-31,3689,3689,2459,1230,22305,22318,14905,7413,261,33,33,53,1540,1540,1507,1507
Sutter,7,2022-01-31,619,619,466,153,3764,3764,2837,927,0,4,4,0,209,209,205,205
Tehama,7,2022-01-31,378,378,256,122,2022,2022,1368,654,17,2,2,5,180,180,178,178
Trinity,7,2022-01-31,43,43,29,14,227,227,151,76,0,0,0,0,20,20,20,20
Tulare,7,2022-01-31,4681,4682,3095,1587,22903,22915,15183,7732,150,22,22,21,1382,1382,1360,1360
Tuolumne,7,2022-01-31,708,708,501,207,3265,3265,2315,950,12,2,2,4,170,170,168,168
Ventura,7,2022-01-31,4601,4602,3769,833,52324,52351,42923,9428,253,39,39,48,1366,1366,1327,1327
Yolo,7,2022-01-31,1351,1351,1048,303,37499,37517,29112,8405,19,5,5,5,326,326,321,321
Yuba,7,2022-01-31,523,523,400,123,2930,2930,2243,687,78,2,2,11,111,111,109,109
Alameda,8,2022-02-07,5976,5980,4979,1001,115630,115701,96397,19304,254,44,44,62,1745,1745,1701,1701
Amador,8,2022-02-07,206,206,155,51,2908,2908,2186,722,14,4,4,5,78,78,74,74
Butte,8,2022-02-07,782,782,673,109,6392,6396,5508,888,74,8,8,12,394,394,386,386
Calaveras,8,2022-02-07,182,182,142,40,1427,1427,1112,315,2,2,2,1,106,106,104,104
Colusa,8,2022-02-07,71,71,57,14,555,555,449,106,0,0,0,0,21,21,21,21
Contra Costa,8,2022-02-07,4130,4130,3088,1042,54139,54173,40521,13652,149,32,32,52,1223,1223,1191,1191
Del Norte,8,2022-02-07,285,285,228,57,4003,4004,3184,820,5,0,0,0,44,44,44,44
El Dorado,8,2022-02-07,431,431,336,95,5035,5038,3930,1108,20,1,1,5,199,199,198,198
Fresno,8,2022-02-07,6314,6319,4787,1532,42573,42598,32309,10289,450,49,49,87,2622,2622,2573,2573
Glenn,8,2022-02-07,113,113,88,25,620,620,488,132,4,3,3,0,50,50,47,47
Humboldt,8,2022-02-07,468,468,372,96,4875,4878,3876,1002,15,1,1,2,136,136,135,135
Imperial,8,2022-02-07,1094,1094,850,244,7941,7946,6178,1768,46,12,12,26,907,907,895,895
Inyo,8,2022-02-07,38,38,30,8,447,447,361,86,5,0,0,0,56,56,56,56
Kern,8,2022-02-07,3474,3474,2813,661,34658,34680,28107,6573,190,32,32,43,2238,2238,2206,2206
Kings,8,2022-02-07,1350,1350,1050,300,10246,10251,7979,2272,52,14,14,5,419,419,405,405
Lake,8,2022-02-07,351,351,265,86,2625,2625,1985,640,11,1,1,5,128,128,127,127
Lassen,8,2022-02-07,140,140,115,25,3023,3024,2488,536,5,2,2,0,57,57,55,55
Los Angeles,8,2022-02-07,37326,37349,34592,2757,1151433,1152128,1067528,84600,2155,638,638,547,30302,30302,29664,29664
Madera,8,2022-02-07,1057,1057,799,258,8081,8086,6122,1964,38,4,4,9,362,362,358,358
Marin,8,2022-02-07,657,657,501,156,11290,11295,8620,2675,29,8,8,6,281,281,273,273
Mariposa,8,2022-02-07,51,51,38,13,579,579,431,148,0,0,0,0,24,24,24,24
Mendocino,8,2022-02-07,327,327,229,98,2817,2817,1974,843,12,2,2,5,116,116,114,114
Merced,8,2022-02-07,1211,1211,974,237,8063,8068,6496,1572,53,13,13,12,771,771,758,758
Modoc,8,2022-02-07,25,25,20,5,219,219,179,40,3,0,0,0,7,7,7,7
Mono,8,2022-02-07,44,44,29,15,271,271,178,93,0,0,0,0,5,5,5,5
Monterey,8,2022-02-07,2221,2221,1474,747,22460,22474,14947,7527,68,11,11,14,689,689,678,678
Napa,8,2022-02-07,740,740,610,130,7766,7771,6400,1371,16,6,6,2,130,130,124,124
Nevada,8,2022-02-07,357,357,271,86,3187,3188,2430,758,24,3,3,1,122,122,119,119
Orange,8,2022-02-07,6394,6399,5395,1004,152267,152357,128499,23858,494,117,117,125,6742,6742,6625,6625
Placer,8,2022-02-07,1294,1294,960,334,11885,11892,8834,3058,148,22,22,34,587,587,565,565
Plumas,8,2022-02-07,79,79,60,19,521,521,399,122,1,1,1,0,13,13,12,12
Riverside,8,2022-02-07,8140,8145,6513,1632,93424,93480,74815,18665,548,107,107,116,6205,6205,6098,6098
Sacramento,8,2022-02-07,6074,6079,4787,1292,63984,64023,50455,13568,390,71,71,95,2870,2870,2799,2799
San Benito,8,2022-02-07,312,312,256,56,2660,2660,2184,476,3,0,0,4,90,90,90,90
San Bernardino,8,2022-02-07,7044,7049,5863,1186,90076,90130,75025,15105,528,140,140,156,7420,7420,7280,7280
San Diego,8,2022-02-07,13647,13655,12596,1059,151877,151969,140248,11721,773,116,116,169,5062,5062,4946,4946
San Francisco,8,2022-02-07,2410,2410,1553,857,55759,55792,35922,19870,171,25,25,40,793,793,768,768
San Joaquin,8,2022-02-07,3339,3339,2574,765,36514,36536,28214,8322,186,42,42,62,2147,2147,2105,2105
San Luis Obispo,8,2022-02-07,1202,1202,977,225,12341,12347,10047,2300,23,16,16,7,429,429,413,413
San Mateo,8,2022-02-07,2464,2464,2076,388,62105,62143,52362,9781,83,16,16,18,667,667,651,651
Santa Barbara,8,2022-02-07,2282,2282,1814,468,30723,30742,24447,6295,75,15,15,17,651,651,636,636
Santa Clara,8,2022-02-07,8041,8046,7388,658,174965,175071,160776,14295,377,31,31,74,2181,2181,2150,2150
Santa Cruz,8,2022-02-07,1899,1899,1559,340,38675,38698,31778,6920,28,4,4,5,250,250,246,246
Shasta,8,2022-02-07,672,672,530,142,6857,6862,5417,1445,64,15,15,10,505,505,490,490
Siskiyou,8,2022-02-07,91,91,75,16,720,720,595,125,10,2,2,0,72,72,70,70
Solano,8,2022-02-07,2238,2238,1784,454,24196,24210,19347,4863,91,5,5,28,433,433,428,428
Sonoma,8,2022-02-07,2083,2083,1674,409,27050,27067,21746,5321,57,7,7,11,470,470,463,463
Stanislaus,8,2022-02-07,2490,2490,1791,699,18735,18748,13508,5240,243,43,43,43,1583,1583,1540,1540
Sutter,8,2022-02-07,360,360,286,74,3305,3305,2631,674,0,5,5,0,214,214,209,209
Tehama,8,2022-02-07,282,282,205,77,1644,1644,1197,447,17,3,3,6,183,183,180,180
Trinity,8,2022-02-07,18,18,13,5,136,136,98,38,0,0,0,0,20,20,20,20
Tulare,8,2022-02-07,2694,2694,1926,768,17907,17919,12840,5079,130,26,26,21,1408,1408,1382,1382
Tuolumne,8,2022-02-07,348,348,263,85,2576,2576,1953,623,10,2,2,1,172,172,170,170
Ventura,8,2022-02-07,2695,2695,2301,394,42326,42350,36185,6165,207,40,40,45,1406,1406,1366,1366
Yolo,8,2022-02-07,865,865,707,158,30847,30864,25186,5678,12,11,11,6,337,337,326,326
Yuba,8,2022-02-07,333,333,269,64,2405,2405,1942,463,42,4,4,13,115,115,111,111
Alameda,9,2022-02-14,3400,3400,2940,460,98883,98951,85571,13380,190,40,40,48,1785,1785,1745,1745
Amador,9,2022-02-14,109,109,87,22,2345,2345,1866,479,8,3,3,3,81,81,78,78
Butte,9,2022-02-14,463,463,411,52,5317,5321,4724,597,64,10,10,9,404,404,394,394
Calaveras,9,2022-02-14,78,78,64,14,1162,1162,950,212,4,2,2,2,108,108,106,106
Colusa,9,2022-02-14,35,35,29,6,406,406,341,65,5,0,0,0,21,21,21,21
Contra Costa,9,2022-02-14,2402,2402,1902,500,44839,44871,35549,9322,123,23,23,31,1246,1246,1223,1223
Del Norte,9,2022-02-14,209,209,174,35,3337,3338,2775,563,6,0,0,3,44,44,44,44
El Dorado,9,2022-02-14,261,261,214,47,4432,4435,3633,802,21,4,4,3,203,203,199,199
Fresno,9,2022-02-14,3851,3853,3084,769,34923,34946,27986,6960,375,32,32,75,2654,2654,2622,2622
Glenn,9,2022-02-14,58,58,48,10,482,482,398,84,3,1,1,0,51,51,50,50
Humboldt,9,2022-02-14,333,333,277,56,4202,4206,3498,708,23,0,0,2,136,136,136,136
Imperial,9,2022-02-14,587,587,479,108,5962,5967,4875,1092,44,14,14,18,921,921,907,907
Inyo,9,2022-02-14,29,29,24,5,413,413,348,65,3,0,0,0,56,56,56,56
Kern,9,2022-02-14,2014,2014,1701,313,27232,27250,23026,4224,156,28,28,40,2266,2266,2238,2238
Kings,9,2022-02-14,771,771,631,140,8002,8007,6553,1454,43,8,8,5,427,427,419,419
Lake,9,2022-02-14,256,256,205,51,2307,2307,1842,465,6,2,2,5,130,130,128,128
Lassen,9,2022-02-14,154,154,132,22,2789,2789,2383,406,3,2,2,0,59,59,57,57
Los Angeles,9,2022-02-14,21421,21436,20183,1253,1052319,1053049,991668,61381,1572,490,490,423,30792,30792,30302,30302
Madera,9,2022-02-14,619,619,495,124,6463,6468,5169,1299,29,2,2,7,364,364,362,362
Marin,9,2022-02-14,384,384,309,75,10147,10153,8175,1978,23,5,5,4,286,286,281,281
Mariposa,9,2022-02-14,24,24,19,5,434,434,342,92,0,0,0,0,24,24,24,24
Mendocino,9,2022-02-14,207,207,155,52,2445,2445,1834,611,13,1,1,7,117,117,116,116
Merced,9,2022-02-14,746,746,628,118,6834,6839,5750,1089,37,13,13,8,784,784,771,771
Modoc,9,2022-02-14,16,16,13,3,124,124,104,20,0,0,0,0,7,7,7,7
Mono,9,2022-02-14,10,10,7,3,179,179,127,52,0,0,0,0,5,5,5,5
Monterey,9,2022-02-14,1227,1227,880,347,16949,16961,12162,4799,48,12,12,12,701,701,689,689
Napa,9,2022-02-14,399,399,342,57,6577,6582,5639,943,10,1,1,1,131,131,130,130
Nevada,9,2022-02-14,169,169,136,33,2568,2569,2067,502,19,1,1,5,123,123,122,122
Orange,9,2022-02-14,3999,4000,3495,505,132290,132383,115604,16779,354,115,115,77,6857,6857,6742,6742
Placer,9,2022-02-14,593,593,466,127,9962,9967,7844,2123,105,12,12,23,599,599,587,587
Plumas,9,2022-02-14,43,43,35,8,431,431,348,83,1,0,0,0,13,13,13,13
Riverside,9,2022-02-14,4605,4608,3855,753,74739,74790,62597,12193,400,85,85,86,6290,6290,6205,6205
Sacramento,9,2022-02-14,3420,3420,2826,594,53012,53048,43850,9198,349,58,58,66,2928,2928,2870,2870
San Benito,9,2022-02-14,158,158,135,23,2158,2158,1844,314,0,1,1,3,91,91,90,90
San Bernardino,9,2022-02-14,3696,3697,3193,504,72738,72788,62899,9889,338,117,117,128,7537,7537,7420,7420
San Diego,9,2022-02-14,8091,8096,7597,499,126062,126150,118434,7716,589,87,87,135,5149,5149,5062,5062
San Francisco,9,2022-02-14,1612,1612,1125,487,47547,47580,33247,14333,130,25,25,39,818,818,793,793
San Joaquin,9,2022-02-14,1994,1994,1620,374,30635,30657,24911,5746,123,37,37,53,2184,2184,2147,2147
San Luis Obispo,9,2022-02-14,798,798,677,121,10050,10056,8534,1522,24,9,9,7,438,438,429,429
San Mateo,9,2022-02-14,1345,1345,1174,171,54921,54959,47965,6994,63,16,16,11,683,683,667,667
Santa Barbara,9,2022-02-14,1056,1056,880,176,22481,22496,18765,3731,68,8,8,14,659,659,651,651
Santa Clara,9,2022-02-14,4648,4650,4348,302,154713,154819,144768,10051,296,27,27,59,2208,2208,2181,2181
Santa Cruz,9,2022-02-14,980,980,837,143,30363,30384,25933,4451,23,3,3,4,253,253,250,250
Shasta,9,2022-02-14,443,443,366,77,5851,5855,4844,1011,62,13,13,13,518,518,505,505
Siskiyou,9,2022-02-14,66,66,57,9,520,520,447,73,7,1,1,2,73,73,72,72
Solano,9,2022-02-14,1201,1201,1003,198,18976,18988,15875,3113,73,2,2,20,435,435,433,433
Sonoma,9,2022-02-14,1138,1138,955,183,21173,21190,17774,3416,55,8,8,7,478,478,470,470
Stanislaus,9,2022-02-14,1361,1361,1043,318,15076,15087,11577,3510,206,28,28,41,1611,1611,1583,1583
Sutter,9,2022-02-14,229,229,191,38,2862,2862,2386,476,0,3,3,0,217,217,214,214
Tehama,9,2022-02-14,180,180,139,41,1404,1404,1088,316,15,5,5,5,188,188,183,183
Trinity,9,2022-02-14,22,22,17,5,171,171,131,40,0,0,0,0,20,20,20,20
Tulare,9,2022-02-14,1477,1477,1126,351,15047,15058,11505,3553,116,25,25,19,1433,1433,1408,1408
Tuolumne,9,2022-02-14,190,190,152,38,2221,2221,1778,443,12,4,4,1,176,176,172,172
Ventura,9,2022-02-14,1512,1512,1334,178,35522,35547,31364,4183,141,36,36,26,1442,1442,1406,1406
Yolo,9,2022-02-14,478,478,406,72,26802,26820,22788,4032,10,7,7,3,344,344,337,337
Yuba,9,2022-02-14,220,220,185,35,2109,2109,1777,332,19,0,0,11,115,115,115,115
Alameda,10,2022-02-21,1929,1929,1719,210,77492,77549,68984,8565,138,27,27,26,1812,1812,1785,1785
Amador,10,2022-02-21,70,70,58,12,1921,1921,1598,323,7,3,3,3,84,84,81,81
Butte,10,2022-02-21,257,257,234,23,4420,4424,4025,399,63,12,12,4,416,416,404,404
Calaveras,10,2022-02-21,44,44,37,7,839,839,713,126,3,6,6,0,114,114,108,108
Colusa,10,2022-02-21,25,25,22,3,361,361,314,47,4,0,0,0,21,21,21,21
Contra Costa,10,2022-02-21,1304,1304,1081,223,34116,34142,28264,5878,66,17,17,30,1263,1263,1246,1246
Del Norte,10,2022-02-21,128,128,111,17,2702,2703,2328,375,8,0,0,1,44,44,44,44
El Dorado,10,2022-02-21,157,157,134,23,3612,3614,3079,535,8,1,1,5,204,204,203,203
Fresno,10,2022-02-21,2011,2011,1683,328,26906,26927,22526,4401,272,26,26,54,2680,2680,2654,2654
Glenn,10,2022-02-21,28,28,24,4,405,405,348,57,2,1,1,0,52,52,51,51
Humboldt,10,2022-02-21,193,193,166,27,3331,3333,2874,459,22,3,3,1,139,139,136,136
Imperial,10,2022-02-21,392,392,334,58,4756,4761,4051,710,31,6,6,10,927,927,921,921
Inyo,10,2022-02-21,10,10,9,1,326,326,284,42,1,0,0,0,56,56,56,56
Kern,10,2022-02-21,1283,1283,1122,161,24323,24342,21280,3062,95,23,23,25,2289,2289,2266,2266
Kings,10,2022-02-21,454,454,387,67,6543,6548,5581,967,32,4,4,5,431,431,427,427
Lake,10,2022-02-21,184,184,154,30,1935,1935,1614,321,7,2,2,1,132,132,130,130
Lassen,10,2022-02-21,111,111,98,13,2135,2135,1883,252,1,0,0,0,59,59,59,59
Los Angeles,10,2022-02-21,11801,11811,11264,547,832099,832726,793675,39051,997,321,321,279,31113,31113,30792,30792
Madera,10,2022-02-21,316,316,264,52,5176,5179,4318,861,27,2,2,7,366,366,364,364
Marin,10,2022-02-21,198,198,166,32,8843,8850,7429,1421,13,3,3,4,289,289,286,286
Mariposa,10,2022-02-21,23,23,19,4,372,372,307,65,0,1,1,0,25,25,24,24
Mendocino,10,2022-02-21,113,113,90,23,1942,1942,1539,403,9,2,2,3,119,119,117,117
Merced,10,2022-02-21,429,429,373,56,5162,5167,4496,671,26,10,10,7,794,794,784,784
Modoc,10,2022-02-21,9,9,8,1,65,65,57,8,2,0,0,0,7,7,7,7
Mono,10,2022-02-21,7,7,5,2,162,162,123,39,0,1,1,0,6,6,5,5
Monterey,10,2022-02-21,778,778,594,184,12976,12987,9901,3086,47,5,5,7,706,706,701,701
Napa,10,2022-02-21,229,229,202,27,4985,4989,4408,581,6,4,4,3,135,135,131,131
Nevada,10,2022-02-21,102,102,85,17,1985,1985,1665,320,16,2,2,5,125,125,123,123
Orange,10,2022-02-21,2462,2462,2212,250,110369,110451,99054,11397,256,79,79,69,6936,6936,6857,6857
Placer,10,2022-02-21,324,324,267,57,8678,8684,7161,1523,92,9,9,13,608,608,599,599
Plumas,10,2022-02-21,21,21,18,3,328,328,276,52,0,0,0,0,13,13,13,13
Riverside,10,2022-02-21,2433,2433,2110,323,61395,61441,53298,8143,262,53,53,61,6343,6343,6290,6290
Sacramento,10,2022-02-21,1959,1959,1681,278,42777,42809,36716,6093,249,34,34,47,2962,2962,2928,2928
San Benito,10,2022-02-21,105,105,92,13,1696,1696,1494,202,0,0,0,1,91,91,91,91
San Bernardino,10,2022-02-21,1902,1902,1694,208,60235,60281,53656,6625,251,82,82,78,7619,7619,7537,7537
San Diego,10,2022-02-21,4626,4629,4403,226,100563,100639,95736,4903,468,61,61,106,5210,5210,5149,5149
San Francisco,10,2022-02-21,974,974,729,245,40280,40309,30072,10237,98,11,11,24,829,829,818,818
San Joaquin,10,2022-02-21,1051,1051,889,162,23842,23861,20180,3681,91,25,25,31,2209,2209,2184,2184
San Luis Obispo,10,2022-02-21,440,440,385,55,7650,7655,6708,947,16,16,16,3,454,454,438,438
San Mateo,10,2022-02-21,693,693,622,71,42429,42462,38059,4403,47,8,8,8,691,691,683,683
Santa Barbara,10,2022-02-21,609,609,526,83,19192,19207,16588,2619,40,6,6,10,665,665,659,659
Santa Clara,10,2022-02-21,2510,2510,2381,129,119651,119743,113484,6259,224,25,25,53,2233,2233,2208,2208
Santa Cruz,10,2022-02-21,578,578,509,69,25006,25024,22024,3000,21,1,1,4,254,254,253,253
Shasta,10,2022-02-21,259,259,222,37,4976,4980,4279,701,46,9,9,10,527,527,518,518
Siskiyou,10,2022-02-21,47,47,42,5,450,450,398,52,6,4,4,1,77,77,73,73
Solano,10,2022-02-21,697,697,604,93,15106,15117,13099,2018,51,5,5,15,440,440,435,435
Sonoma,10,2022-02-21,629,629,547,82,16814,16827,14606,2221,36,2,2,8,480,480,478,478
Stanislaus,10,2022-02-21,730,730,589,141,11755,11765,9494,2271,168,29,29,30,1640,1640,1611,1611
Sutter,10,2022-02-21,122,122,105,17,2108,2108,1821,287,0,2,2,0,219,219,217,217
Tehama,10,2022-02-21,96,96,78,18,1219,1219,993,226,8,10,10,2,198,198,188,188
Trinity,10,2022-02-21,15,15,12,3,199,199,160,39,0,0,0,0,20,20,20,20
Tulare,10,2022-02-21,780,780,627,153,10925,10933,8790,2143,86,14,14,9,1447,1447,1433,1433
Tuolumne,10,2022-02-21,107,107,90,17,1784,1784,1491,293,2,6,6,2,182,182,176,176
Ventura,10,2022-02-21,886,886,802,84,27533,27553,24935,2618,107,21,21,22,1463,1463,1442,1442
Yolo,10,2022-02-21,283,283,249,34,20964,20979,18400,2579,7,6,6,3,350,350,344,344
Yuba,10,2022-02-21,134,134,117,17,1679,1679,1466,213,22,1,1,8,116,116,115,115
Alameda,11,2022-02-28,1474,1474,1347,127,78643,78709,71887,6822,113,17,17,23,1829,1829,1812,1812
Amador,11,2022-02-28,56,56,48,8,2077,2077,1796,281,7,0,0,2,84,84,84,84
Butte,11,2022-02-28,188,188,175,13,4467,4471,4152,319,45,6,6,4,422,422,416,416
Calaveras,11,2022-02-28,40,40,35,5,1255,1255,1105,150,0,3,3,0,117,117,114,114
Colusa,11,2022-02-28,10,10,9,1,406,406,364,42,5,0,0,0,21,21,21,21
Contra Costa,11,2022-02-28,933,933,804,129,34985,35015,30190,4825,56,15,15,19,1278,1278,1263,1263
Del Norte,11,2022-02-28,84,84,75,9,2874,2875,2556,319,5,3,3,2,47,47,44,44
El Dorado,11,2022-02-28,107,107,94,13,3684,3687,3253,434,5,2,2,3,206,206,204,204
Fresno,11,2022-02-28,1313,1313,1141,172,26338,26359,22900,3459,196,28,28,44,2708,2708,2680,2680
Glenn,11,2022-02-28,18,18,16,2,435,435,386,49,1,0,0,0,52,52,52,52
Humboldt,11,2022-02-28,156,156,139,17,2953,2955,2631,324,6,1,1,1,140,140,139,139
Imperial,11,2022-02-28,264,264,233,31,4782,4787,4214,573,13,6,6,10,933,933,927,927
Inyo,11,2022-02-28,10,10,9,1,379,379,341,38,0,0,0,0,56,56,56,56
Kern,11,2022-02-28,790,790,711,79,24602,24623,22168,2455,77,16,16,16,2305,2305,2289,2289
Kings,11,2022-02-28,246,246,216,30,6079,6084,5360,724,19,7,7,3,438,438,431,431
Lake,11,2022-02-28,110,110,95,15,1956,1956,1695,261,0,4,4,1,136,136,132,132
Lassen,11,2022-02-28,44,44,40,4,2097,2097,1899,198,1,2,2,0,61,61,59,59
Los Angeles,11,2022-02-28,8212,8218,7920,298,1057202,1058090,1019523,38567,753,222,222,174,31335,31335,31113,31113
Madera,11,2022-02-28,189,189,164,25,4623,4627,4016,611,20,2,2,6,368,368,366,366
Marin,11,2022-02-28,160,160,140,20,7659,7664,6681,983,13,3,3,3,292,292,289,289
Mariposa,11,2022-02-28,29,29,25,4,347,347,298,49,0,1,1,0,26,26,25,25
Mendocino,11,2022-02-28,84,84,70,14,1889,1889,1571,318,11,2,2,2,121,121,119,119
Merced,11,2022-02-28,285,285,256,29,5030,5035,4513,522,25,7,7,5,801,801,794,794
Modoc,11,2022-02-28,6,6,5,1,57,57,51,6,1,0,0,0,7,7,7,7
Mono,11,2022-02-28,5,5,4,1,169,169,136,33,0,0,0,0,6,6,6,6
Monterey,11,2022-02-28,355,355,286,69,14334,14347,11569,2778,28,9,9,5,715,715,706,706
Napa,11,2022-02-28,194,194,176,18,5593,5598,5083,515,8,3,3,2,138,138,135,135
Nevada,11,2022-02-28,70,70,61,9,2016,2016,1753,263,9,0,0,1,125,125,125,125
Orange,11,2022-02-28,1684,1684,1548,136,126306,126414,116147,10267,198,41,41,35,6977,6977,6936,6936
Placer,11,2022-02-28,250,250,215,35,8419,8426,7237,1189,65,4,4,13,612,612,608,608
Plumas,11,2022-02-28,23,23,20,3,370,370,323,47,0,0,0,0,13,13,13,13
Riverside,11,2022-02-28,1687,1687,1508,179,63257,63309,56608,6701,185,37,37,35,6380,6380,6343,6343
Sacramento,11,2022-02-28,1162,1162,1031,131,45687,45726,40541,5185,163,24,24,35,2986,2986,2962,2962
San Benito,11,2022-02-28,55,55,50,5,1809,1809,1638,171,0,0,0,1,91,91,91,91
San Bernardino,11,2022-02-28,1174,1174,1072,102,61075,61127,55805,5322,157,60,60,45,7679,7679,7619,7619
San Diego,11,2022-02-28,3035,3035,2919,116,100000,100083,96277,3806,341,37,37,83,5247,5247,5210,5210
San Francisco,11,2022-02-28,835,835,662,173,39995,40029,31713,8316,74,16,16,19,845,845,829,829
San Joaquin,11,2022-02-28,657,657,576,81,26088,26110,22885,3225,58,10,10,24,2219,2219,2209,2209
San Luis Obispo,11,2022-02-28,378,378,341,37,8504,8511,7678,833,9,5,5,2,459,459,454,454
San Mateo,11,2022-02-28,600,600,552,48,41300,41335,37990,3345,33,4,4,7,695,695,691,691
Santa Barbara,11,2022-02-28,369,369,329,40,21380,21399,19075,2324,36,5,5,10,670,670,665,665
Santa Clara,11,2022-02-28,1732,1732,1662,70,102555,102642,98541,4101,191,22,22,46,2255,2255,2233,2233
Santa Cruz,11,2022-02-28,459,459,416,43,27967,27991,25359,2632,20,2,2,4,256,256,254,254
Shasta,11,2022-02-28,167,167,148,19,4925,4929,4376,553,36,11,11,8,538,538,527,527
Siskiyou,11,2022-02-28,25,25,23,2,475,475,432,43,4,2,2,1,79,79,77,77
Solano,11,2022-02-28,476,476,425,51,15304,15318,13690,1628,47,3,3,17,443,443,440,440
Sonoma,11,2022-02-28,455,455,408,47,16941,16956,15191,1765,28,3,3,5,483,483,480,480
Stanislaus,11,2022-02-28,476,476,401,75,13361,13372,11284,2088,124,11,11,21,1651,1651,1640,1640
Sutter,11,2022-02-28,107,107,95,12,2333,2333,2079,254,0,2,2,0,221,221,219,219
Tehama,11,2022-02-28,60,60,51,9,1221,1221,1039,182,7,1,1,2,199,199,198,198
Trinity,11,2022-02-28,5,5,4,1,118,118,99,19,0,0,0,0,20,20,20,20
Tulare,11,2022-02-28,462,462,389,73,11875,11883,9996,1887,67,14,14,9,1461,1461,1447,1447
Tuolumne,11,2022-02-28,67,67,58,9,1486,1486,1291,195,6,3,3,1,185,185,182,182
Ventura,11,2022-02-28,548,548,507,41,29882,29907,27665,2242,75,10,10,11,1473,1473,1463,1463
Yolo,11,2022-02-28,206,206,186,20,26234,26255,23709,2546,4,5,5,6,355,355,350,350
Yuba,11,2022-02-28,75,75,67,8,1711,1711,1537,174,12,1,1,6,117,117,116,116
Alameda,12,2022-03-07,1092,1092,1017,75,72239,72308,67329,4979,77,12,12,16,1841,1841,1829,1829
Amador,12,2022-03-07,75,75,67,8,1428,1428,1274,154,6,2,2,1,86,86,84,84
Butte,12,2022-03-07,99,99,93,6,3638,3642,3438,204,33,4,4,3,426,426,422,422
Calaveras,12,2022-03-07,25,25,23,2,1049,1049,949,100,1,1,1,0,118,118,117,117
Colusa,12,2022-03-07,9,9,8,1,355,355,326,29,6,0,0,0,21,21,21,21
Contra Costa,12,2022-03-07,628,628,559,69,30938,30968,27543,3425,47,8,8,13,1286,1286,1278,1278
Del Norte,12,2022-03-07,50,50,46,4,1779,1779,1624,155,7,0,0,1,47,47,47,47
El Dorado,12,2022-03-07,76,76,69,7,3195,3198,2898,300,5,3,3,2,209,209,206,206
Fresno,12,2022-03-07,859,859,769,90,22259,22280,19947,2333,145,18,18,27,2726,2726,2708,2708
Glenn,12,2022-03-07,19,19,17,2,395,395,359,36,2,1,1,0,53,53,52,52
Humboldt,12,2022-03-07,81,81,74,7,3045,3049,2783,266,10,3,3,4,143,143,140,140
Imperial,12,2022-03-07,122,122,110,12,4480,4485,4057,428,16,5,5,10,938,938,933,933
Inyo,12,2022-03-07,10,10,9,1,269,269,247,22,0,0,0,0,56,56,56,56
Kern,12,2022-03-07,433,433,398,35,20833,20853,19202,1651,67,12,12,16,2317,2317,2305,2305
Kings,12,2022-03-07,201,201,182,19,4986,4991,4518,473,13,4,4,2,442,442,438,438
Lake,12,2022-03-07,63,63,56,7,1760,1760,1572,188,2,2,2,1,138,138,136,136
Lassen,12,2022-03-07,95,95,88,7,1889,1889,1748,141,0,1,1,0,62,62,61,61
Los Angeles,12,2022-03-07,5532,5538,5381,157,875949,876784,851840,24944,573,171,171,133,31506,31506,31335,31335
Madera,12,2022-03-07,133,133,119,14,3916,3920,3506,414,15,1,1,2,369,369,368,368
Marin,12,2022-03-07,154,154,138,16,7557,7563,6782,781,10,1,1,2,293,293,292,292
Mariposa,12,2022-03-07,11,11,10,1,296,296,263,33,0,1,1,0,27,27,26,26
Mendocino,12,2022-03-07,65,65,56,9,1643,1643,1418,225,6,0,0,2,121,121,121,121
Merced,12,2022-03-07,173,173,159,14,4537,4542,4167,375,17,7,7,5,808,808,801,801
Modoc,12,2022-03-07,0,0,0,0,54,54,50,4,0,0,0,0,7,7,7,7
Mono,12,2022-03-07,2,2,2,0,128,128,108,20,0,0,0,1,6,6,6,6
Monterey,12,2022-03-07,245,245,206,39,11053,11065,9334,1731,19,5,5,2,720,720,715,715
Napa,12,2022-03-07,199,199,185,14,4874,4879,4523,356,2,1,1,2,139,139,138,138
Nevada,12,2022-03-07,50,50,45,5,1750,1750,1568,182,0,1,1,0,126,126,125,125
Orange,12,2022-03-07,1251,1251,1171,80,107251,107353,100455,6898,138,29,29,28,7006,7006,6977,6977
Placer,12,2022-03-07,162,162,144,18,7796,7802,6920,882,54,3,3,11,615,615,612,612
Plumas,12,2022-03-07,7,7,6,1,266,266,239,27,0,0,0,0,13,13,13,13
Riverside,12,2022-03-07,982,982,899,83,53617,53667,49150,4517,125,26,26,30,6406,6406,6380,6380
Sacramento,12,2022-03-07,775,775,705,70,40192,40231,36608,3623,124,18,18,28,3004,3004,2986,2986
San Benito,12,2022-03-07,41,41,38,3,1525,1525,1411,114,0,2,2,1,93,93,91,91
San Bernardino,12,2022-03-07,792,792,737,55,53255,53305,49629,3676,95,43,43,38,7722,7722,7679,7679
San Diego,12,2022-03-07,2337,2337,2267,70,96625,96717,93832,2885,237,31,31,57,5278,5278,5247,5247
San Francisco,12,2022-03-07,697,697,579,118,37364,37399,31045,6354,62,5,5,11,850,850,845,845
San Joaquin,12,2022-03-07,441,441,398,43,21191,21210,19130,2080,33,9,9,19,2228,2228,2219,2219
San Luis Obispo,12,2022-03-07,245,245,226,19,7300,7306,6741,565,7,5,5,1,464,464,459,459
San Mateo,12,2022-03-07,535,535,501,34,39934,39971,37389,2582,30,2,2,3,697,697,695,695
Santa Barbara,12,2022-03-07,203,203,186,17,17713,17730,16201,1529,15,4,4,8,674,674,670,670
Santa Clara,12,2022-03-07,1471,1471,1425,46,111505,111611,108058,3553,128,13,13,38,2268,2268,2255,2255
Santa Cruz,12,2022-03-07,334,334,309,25,24967,24991,23131,1860,11,0,0,7,256,256,256,256
Shasta,12,2022-03-07,140,140,127,13,4940,4945,4502,443,24,8,8,3,546,546,538,538
Siskiyou,12,2022-03-07,12,12,11,1,399,399,370,29,2,1,1,0,80,80,79,79
Solano,12,2022-03-07,353,353,323,30,14065,14079,12886,1193,46,2,2,10,445,445,443,443
Sonoma,12,2022-03-07,321,321,294,27,14915,14929,13691,1238,26,3,3,6,486,486,483,483
Stanislaus,12,2022-03-07,276,276,241,35,10854,10865,9506,1359,94,10,10,13,1661,1661,1651,1651
Sutter,12,2022-03-07,79,79,72,7,1908,1908,1742,166,0,1,1,0,222,222,221,221
Tehama,12,2022-03-07,40,40,35,5,1115,1115,980,135,5,2,2,1,201,201,199,199
Trinity,12,2022-03-07,4,4,3,1,114,114,100,14,0,0,0,0,20,20,20,20
Tulare,12,2022-03-07,303,303,264,39,10283,10293,8983,1310,37,13,13,3,1474,1474,1461,1461
Tuolumne,12,2022-03-07,48,48,43,5,1253,1253,1122,131,2,0,0,1,185,185,185,185
Ventura,12,2022-03-07,417,417,392,25,26712,26737,25155,1582,45,4,4,11,1477,1477,1473,1473
Yolo,12,2022-03-07,160,160,148,12,22142,22164,20459,1705,3,2,2,2,357,357,355,355
Yuba,12,2022-03-07,58,58,53,5,1552,1552,1425,127,13,0,0,6,117,117,117,117
Alameda,13,2022-03-14,877,877,829,48,68763,68835,65090,3745,64,9,9,6,1850,1850,1841,1841
Amador,13,2022-03-14,32,32,29,3,1439,1439,1315,124,4,0,0,0,86,86,86,86
Butte,13,2022-03-14,82,82,78,4,3592,3596,3436,160,24,1,1,0,427,427,426,426
Calaveras,13,2022-03-14,17,17,16,1,991,991,915,76,1,1,1,1,119,119,118,118
Colusa,13,2022-03-14,4,4,4,0,257,257,240,17,4,0,0,0,21,21,21,21
Contra Costa,13,2022-03-14,565,565,515,50,29112,29142,26573,2569,19,5,5,9,1291,1291,1286,1286
Del Norte,13,2022-03-14,31,31,29,2,1415,1415,1317,98,1,2,2,1,49,49,47,47
El Dorado,13,2022-03-14,46,46,43,3,2977,2980,2757,223,4,1,1,0,210,210,209,209
Fresno,13,2022-03-14,522,522,478,44,21168,21191,19421,1770,120,10,10,20,2736,2736,2726,2726
Glenn,13,2022-03-14,11,11,10,1,342,342,318,24,1,0,0,0,53,53,53,53
Humboldt,13,2022-03-14,56,56,52,4,2651,2653,2468,185,3,1,1,2,144,144,143,143
Imperial,13,2022-03-14,75,75,69,6,4551,4556,4208,348,5,2,2,7,940,940,938,938
Inyo,13,2022-03-14,6,6,6,0,165,165,154,11,0,0,0,0,56,56,56,56
Kern,13,2022-03-14,301,301,282,19,20272,20294,19022,1272,42,14,14,12,2331,2331,2317,2317
Kings,13,2022-03-14,155,155,143,12,4695,4700,4346,354,17,1,1,2,443,443,442,442
Lake,13,2022-03-14,48,48,44,4,1570,1570,1436,134,1,1,1,0,139,139,138,138
Lassen,13,2022-03-14,5,5,5,0,1515,1515,1426,89,0,0,0,0,62,62,62,62
Los Angeles,13,2022-03-14,4056,4061,3971,90,845503,846386,827515,18871,412,116,116,91,31622,31622,31506,31506
Madera,13,2022-03-14,52,52,48,4,3575,3579,3276,303,12,0,0,2,369,369,369,369
Marin,13,2022-03-14,170,170,156,14,6531,6537,6001,536,7,1,1,0,294,294,293,293
Mariposa,13,2022-03-14,9,9,8,1,222,222,202,20,0,0,0,0,27,27,27,27
Mendocino,13,2022-03-14,34,34,30,4,1433,1433,1275,158,4,2,2,1,123,123,121,121
Merced,13,2022-03-14,134,134,125,9,4167,4172,3899,273,17,2,2,4,810,810,808,808
Modoc,13,2022-03-14,3,3,3,0,52,52,49,3,1,0,0,0,7,7,7,7
Mono,13,2022-03-14,2,2,2,0,118,118,103,15,0,0,0,0,6,6,6,6
Monterey,13,2022-03-14,155,155,135,20,10109,10120,8841,1279,14,4,4,2,724,724,720,720
Napa,13,2022-03-14,120,120,113,7,4103,4108,3870,238,6,1,1,3,140,140,139,139
Nevada,13,2022-03-14,50,50,46,4,1571,1571,1441,130,2,0,0,0,126,126,126,126
Orange,13,2022-03-14,821,821,779,42,101452,101558,96403,5155,109,31,31,31,7037,7037,7006,7006
Placer,13,2022-03-14,150,150,136,14,7318,7326,6664,662,45,3,3,5,618,618,615,615
Plumas,13,2022-03-14,4,4,4,0,317,317,291,26,0,0,0,0,13,13,13,13
Riverside,13,2022-03-14,737,737,688,49,52723,52778,49259,3519,87,15,15,16,6421,6421,6406,6406
Sacramento,13,2022-03-14,588,588,546,42,35118,35153,32629,2524,122,16,16,22,3020,3020,3004,3004
San Benito,13,2022-03-14,36,36,34,2,1461,1461,1374,87,0,0,0,1,93,93,93,93
San Bernardino,13,2022-03-14,566,566,535,31,51660,51715,48893,2822,68,26,26,32,7748,7748,7722,7722
San Diego,13,2022-03-14,1842,1842,1799,43,96017,96120,93864,2256,174,17,17,47,5295,5295,5278,5278
San Francisco,13,2022-03-14,609,609,526,83,34264,34300,29582,4718,28,7,7,7,857,857,850,850
San Joaquin,13,2022-03-14,270,270,249,21,18866,18886,17400,1486,28,7,7,11,2235,2235,2228,2228
San Luis Obispo,13,2022-03-14,162,162,152,10,6664,6670,6260,410,7,7,7,1,471,471,464,464
San Mateo,13,2022-03-14,441,441,419,22,35705,35742,33912,1830,27,0,0,3,697,697,697,697
Santa Barbara,13,2022-03-14,195,195,182,13,16855,16874,15714,1160,16,7,7,2,681,681,674,674
Santa Clara,13,2022-03-14,1180,1180,1151,29,99225,99330,96846,2484,108,12,12,28,2280,2280,2268,2268
Santa Cruz,13,2022-03-14,239,239,225,14,22167,22189,20881,1308,10,3,3,3,259,259,256,256
Shasta,13,2022-03-14,97,97,90,7,4836,4841,4494,347,16,5,5,2,551,551,546,546
Siskiyou,13,2022-03-14,9,9,8,1,370,370,349,21,0,3,3,0,83,83,80,80
Solano,13,2022-03-14,221,221,206,15,12299,12312,11483,829,34,1,1,6,446,446,445,445
Sonoma,13,2022-03-14,229,229,214,15,13389,13403,12517,886,14,1,1,4,487,487,486,486
Stanislaus,13,2022-03-14,215,215,193,22,9401,9410,8462,948,82,11,11,17,1672,1672,1661,1661
Sutter,13,2022-03-14,41,41,38,3,1815,1816,1690,126,0,0,0,0,222,222,222,222
Tehama,13,2022-03-14,17,17,15,2,981,981,886,95,2,3,3,0,204,204,201,201
Trinity,13,2022-03-14,3,3,3,0,96,96,86,10,0,0,0,0,20,20,20,20
Tulare,13,2022-03-14,173,173,155,18,9301,9310,8356,954,33,0,0,6,1474,1474,1474,1474
Tuolumne,13,2022-03-14,22,22,20,2,1246,1246,1142,104,1,0,0,0,185,185,185,185
Ventura,13,2022-03-14,326,326,311,15,24584,24610,23458,1152,37,6,6,7,1483,1483,1477,1477
Yolo,13,2022-03-14,118,118,111,7,21605,21627,20309,1318,1,3,3,2,360,360,357,357
Yuba,13,2022-03-14,35,35,33,2,1417,1417,1325,92,10,0,0,3,117,117,117,117
Alameda,14,2022-03-21,719,719,688,31,65642,65714,62887,2827,58,7,7,3,1857,1857,1850,1850
Amador,14,2022-03-21,29,29,27,2,1356,1356,1263,93,2,0,0,0,86,86,86,86
Butte,14,2022-03-21,81,81,78,3,3158,3162,3052,110,17,0,0,2,427,427,427,427
Calaveras,14,2022-03-21,8,8,8,0,658,658,619,39,0,0,0,0,119,119,119,119
Colusa,14,2022-03-21,3,3,3,0,231,231,219,12,2,0,0,0,21,21,21,21
Contra Costa,14,2022-03-21,466,466,434,32,26897,26928,25036,1892,27,7,7,9,1298,1298,1291,1291
Del Norte,14,2022-03-21,19,19,18,1,1192,1192,1127,65,0,0,0,0,49,49,49,49
El Dorado,14,2022-03-21,44,44,41,3,2810,2813,2647,166,1,2,2,0,212,212,210,210
Fresno,14,2022-03-21,347,347,324,23,19376,19397,18110,1287,97,11,11,12,2747,2747,2736,2736
Glenn,14,2022-03-21,7,7,7,0,366,366,345,21,1,0,0,0,53,53,53,53
Humboldt,14,2022-03-21,31,31,29,2,2456,2459,2325,134,5,1,1,2,145,145,144,144
Imperial,14,2022-03-21,59,59,55,4,3964,3969,3730,239,4,3,3,4,943,943,940,940
Inyo,14,2022-03-21,1,1,1,0,148,148,140,8,0,0,0,0,56,56,56,56
Kern,14,2022-03-21,206,206,196,10,19489,19509,18543,966,34,4,4,9,2335,2335,2331,2331
Kings,14,2022-03-21,79,79,74,5,4411,4416,4152,264,7,1,1,1,444,444,443,443
Lake,14,2022-03-21,18,18,17,1,1365,1365,1272,93,0,0,0,0,139,139,139,139
Lassen,14,2022-03-21,10,10,10,0,1388,1388,1323,65,0,0,0,0,62,62,62,62
Los Angeles,14,2022-03-21,4129,4134,4063,71,822724,823634,809248,14386,338,76,76,66,31698,31698,31622,31622
Madera,14,2022-03-21,40,40,37,3,3392,3396,3168,228,9,1,1,1,370,370,369,369
Marin,14,2022-03-21,133,133,124,9,6225,6230,5824,406,6,1,1,0,295,295,294,294
Mariposa,14,2022-03-21,7,7,6,1,236,236,219,17,0,0,0,0,27,27,27,27
Mendocino,14,2022-03-21,28,28,26,2,1505,1505,1373,132,4,0,0,1,123,123,123,123
Merced,14,2022-03-21,87,87,82,5,3771,3776,3581,195,13,5,5,1,815,815,810,810
Modoc,14,2022-03-21,2,2,2,0,60,60,57,3,0,0,0,0,7,7,7,7
Mono,14,2022-03-21,4,4,4,0,134,134,120,14,1,0,0,0,6,6,6,6
Monterey,14,2022-03-21,152,152,137,15,10083,10096,9071,1025,22,0,0,1,724,724,724,724
Napa,14,2022-03-21,54,54,52,2,3450,3454,3297,157,6,1,1,2,141,141,140,140
Nevada,14,2022-03-21,18,18,17,1,1528,1528,1428,100,2,0,0,0,126,126,126,126
Orange,14,2022-03-21,754,754,724,30,96039,96145,92292,3853,100,12,12,25,7049,7049,7037,7037
Placer,14,2022-03-21,111,111,103,8,6472,6479,6014,465,40,2,2,6,620,620,618,618
Plumas,14,2022-03-21,2,2,2,0,228,228,213,15,0,0,0,0,13,13,13,13
Riverside,14,2022-03-21,617,617,584,33,51884,51941,49182,2759,69,13,13,18,6434,6434,6421,6421
Sacramento,14,2022-03-21,461,461,435,26,32975,33011,31138,1873,89,13,13,13,3033,3033,3020,3020
San Benito,14,2022-03-21,19,19,18,1,1385,1385,1320,65,0,1,1,0,94,94,93,93
San Bernardino,14,2022-03-21,473,473,453,20,49291,49345,47212,2133,49,20,20,31,7768,7768,7748,7748
San Diego,14,2022-03-21,1370,1370,1345,25,84562,84655,83098,1557,146,14,14,39,5309,5309,5295,5295
San Francisco,14,2022-03-21,688,688,613,75,33499,33536,29827,3709,34,3,3,3,860,860,857,857
San Joaquin,14,2022-03-21,222,222,208,14,15666,15683,14711,972,23,6,6,6,2241,2241,2235,2235
San Luis Obispo,14,2022-03-21,107,107,102,5,6416,6423,6110,313,3,5,5,0,476,476,471,471
San Mateo,14,2022-03-21,367,367,352,15,34821,34860,33458,1402,30,1,1,1,698,698,697,697
Santa Barbara,14,2022-03-21,161,161,152,9,14292,14308,13518,790,17,5,5,4,686,686,681,681
Santa Clara,14,2022-03-21,1098,1098,1077,21,94591,94696,92841,1855,101,5,5,20,2285,2285,2280,2280
Santa Cruz,14,2022-03-21,183,183,174,9,20023,20046,19110,936,8,0,0,3,259,259,259,259
Shasta,14,2022-03-21,42,42,40,2,4136,4140,3905,235,10,6,6,2,557,557,551,551
Siskiyou,14,2022-03-21,9,9,9,0,370,370,353,17,1,0,0,0,83,83,83,83
Solano,14,2022-03-21,187,187,177,10,11749,11763,11138,625,17,1,1,5,447,447,446,446
Sonoma,14,2022-03-21,229,229,217,12,12374,12388,11736,652,15,2,2,2,489,489,487,487
Stanislaus,14,2022-03-21,142,142,131,11,8426,8434,7758,676,59,12,12,8,1684,1684,1672,1672
Sutter,14,2022-03-21,35,35,33,2,1479,1479,1399,80,0,1,1,0,223,223,222,222
Tehama,14,2022-03-21,10,10,9,1,926,926,854,72,2,0,0,0,204,204,204,204
Trinity,14,2022-03-21,0,0,0,0,111,111,102,9,0,0,0,0,20,20,20,20
Tulare,14,2022-03-21,112,112,103,9,8167,8175,7508,667,27,5,5,4,1479,1479,1474,1474
Tuolumne,14,2022-03-21,19,19,18,1,1131,1131,1055,76,2,0,0,0,185,185,185,185
Ventura,14,2022-03-21,289,289,278,11,23278,23304,22444,860,30,5,5,6,1488,1488,1483,1483
Yolo,14,2022-03-21,107,107,102,5,21383,21406,20369,1037,1,0,0,1,360,360,360,360
Yuba,14,2022-03-21,42,42,40,2,1318,1318,1251,67,8,0,0,2,117,117,117,117
Alameda,15,2022-03-28,932,932,901,31,59096,59165,57170,1995,35,4,4,5,1861,1861,1857,1857
Amador,15,2022-03-28,8,8,8,0,1374,1374,1300,74,3,0,0,0,86,86,86,86
Butte,15,2022-03-28,64,64,62,2,2853,2856,2778,78,11,0,0,1,427,427,427,427
Calaveras,15,2022-03-28,15,15,14,1,581,581,554,27,0,0,0,0,119,119,119,119
Colusa,15,2022-03-28,4,4,4,0,207,207,199,8,0,0,0,0,21,21,21,21
Contra Costa,15,2022-03-28,532,532,503,29,24836,24866,23487,1379,29,1,1,6,1299,1299,1298,1298
Del Norte,15,2022-03-28,16,16,15,1,1038,1038,993,45,1,0,0,0,49,49,49,49
El Dorado,15,2022-03-28,60,60,57,3,2802,2806,2675,131,0,0,0,0,212,212,212,212
Fresno,15,2022-03-28,274,274,260,14,17934,17955,17013,942,71,5,5,18,2752,2752,2747,2747
Glenn,15,2022-03-28,8,8,8,0,333,333,318,15,0,0,0,0,53,53,53,53
Humboldt,15,2022-03-28,27,27,26,1,2608,2612,2499,113,4,0,0,3,145,145,145,145
Imperial,15,2022-03-28,62,62,59,3,3535,3540,3372,168,4,1,1,3,944,944,943,943
Inyo,15,2022-03-28,4,4,4,0,186,186,178,8,1,0,0,0,56,56,56,56
Kern,15,2022-03-28,144,144,138,6,18179,18199,17488,711,17,4,4,8,2339,2339,2335,2335
Kings,15,2022-03-28,56,56,53,3,4275,4280,4078,202,6,2,2,0,446,446,444,444
Lake,15,2022-03-28,10,10,9,1,1068,1068,1010,58,0,0,0,0,139,139,139,139
Lassen,15,2022-03-28,4,4,4,0,1284,1284,1236,48,0,0,0,0,62,62,62,62
Los Angeles,15,2022-03-28,4473,4480,4419,61,703737,704561,694824,9737,264,52,52,57,31750,31750,31698,31698
Madera,15,2022-03-28,24,24,23,1,3451,3456,3273,183,4,0,0,2,370,370,370,370
Marin,15,2022-03-28,179,179,170,9,6000,6006,5698,308,3,0,0,0,295,295,295,295
Mariposa,15,2022-03-28,5,5,5,0,179,179,169,10,0,1,1,0,28,28,27,27
Mendocino,15,2022-03-28,31,31,29,2,1314,1314,1223,91,0,1,1,0,124,124,123,123
Merced,15,2022-03-28,65,65,62,3,3359,3364,3227,137,5,1,1,3,816,816,815,815
Modoc,15,2022-03-28,3,3,3,0,45,45,43,2,0,0,0,0,7,7,7,7
Mono,15,2022-03-28,1,1,1,0,134,134,123,11,0,0,0,0,6,6,6,6
Monterey,15,2022-03-28,148,148,136,12,8782,8793,8079,714,14,1,1,0,725,725,724,724
Napa,15,2022-03-28,67,67,65,2,3327,3332,3213,119,1,2,2,1,143,143,141,141
Nevada,15,2022-03-28,27,27,26,1,1431,1431,1357,74,1,1,1,0,127,127,126,126
Orange,15,2022-03-28,813,813,788,25,90127,90232,87395,2837,81,12,12,17,7061,7061,7049,7049
Placer,15,2022-03-28,107,107,101,6,6222,6229,5876,353,26,4,4,6,624,624,620,620
Plumas,15,2022-03-28,3,3,3,0,267,267,253,14,0,0,0,0,13,13,13,13
Riverside,15,2022-03-28,521,521,500,21,43921,43973,42140,1833,47,7,7,10,6441,6441,6434,6434
Sacramento,15,2022-03-28,457,457,437,20,32456,32494,31043,1451,68,6,6,19,3039,3039,3033,3033
San Benito,15,2022-03-28,14,14,13,1,1365,1365,1315,50,0,0,0,0,94,94,94,94
San Bernardino,15,2022-03-28,543,543,525,18,41295,41343,39945,1398,40,18,18,24,7786,7786,7768,7768
San Diego,15,2022-03-28,1325,1325,1306,19,72102,72187,71151,1036,114,9,9,26,5318,5318,5309,5309
San Francisco,15,2022-03-28,844,844,771,73,32738,32776,29884,2892,23,5,5,5,865,865,860,860
San Joaquin,15,2022-03-28,190,190,181,9,17484,17503,16648,855,20,4,4,4,2245,2245,2241,2241
San Luis Obispo,15,2022-03-28,96,96,92,4,5701,5707,5489,218,5,1,1,1,477,477,476,476
San Mateo,15,2022-03-28,582,582,564,18,33834,33873,32801,1072,26,3,3,3,701,701,698,698
Santa Barbara,15,2022-03-28,135,135,129,6,10211,10223,9792,431,15,1,1,4,687,687,686,686
Santa Clara,15,2022-03-28,1272,1272,1253,19,94516,94627,93183,1444,88,10,10,18,2295,2295,2285,2285
Santa Cruz,15,2022-03-28,145,145,140,5,19667,19690,18973,717,3,0,0,2,259,259,259,259
Shasta,15,2022-03-28,33,33,32,1,3878,3883,3710,173,7,2,2,3,559,559,557,557
Siskiyou,15,2022-03-28,5,5,5,0,292,292,282,10,0,0,0,0,83,83,83,83
Solano,15,2022-03-28,169,169,162,7,10930,10943,10486,457,18,0,0,6,447,447,447,447
Sonoma,15,2022-03-28,259,259,249,10,8550,8560,8213,347,13,0,0,1,489,489,489,489
Stanislaus,15,2022-03-28,116,116,109,7,8182,8192,7673,519,28,2,2,3,1686,1686,1684,1684
Sutter,15,2022-03-28,25,25,24,1,1490,1490,1426,64,0,1,1,0,224,224,223,223
Tehama,15,2022-03-28,13,13,12,1,798,798,749,49,3,1,1,0,205,205,204,204
Trinity,15,2022-03-28,0,0,0,0,79,79,74,5,0,0,0,0,20,20,20,20
Tulare,15,2022-03-28,79,79,74,5,7838,7846,7338,508,20,6,6,1,1485,1485,1479,1479
Tuolumne,15,2022-03-28,7,7,7,0,1083,1083,1026,57,3,1,1,0,186,186,185,185
Ventura,15,2022-03-28,334,334,324,10,21201,21225,20610,615,23,5,5,3,1493,1493,1488,1488
Yolo,15,2022-03-28,103,103,99,4,20455,20479,19717,762,3,2,2,0,362,362,360,360
Yuba,15,2022-03-28,26,26,25,1,1214,1214,1165,49,2,2,2,1,119,119,117,117
Alameda,16,2022-04-04,1061,1061,1033,28,55975,56044,54554,1490,40,3,3,3,1864,1864,1861,1861
Amador,16,2022-04-04,2,2,2,0,1107,1107,1060,47,1,0,0,0,86,86,86,86
Butte,16,2022-04-04,44,44,43,1,2582,2585,2529,56,8,2,2,1,429,429,427,427
Calaveras,16,2022-04-04,8,8,8,0,589,589,567,22,0,0,0,0,119,119,119,119
Colusa,16,2022-04-04,2,2,2,0,202,202,196,6,0,0,0,0,21,21,21,21
Contra Costa,16,2022-04-04,542,542,519,23,23497,23526,22492,1034,13,1,1,4,1300,1300,1299,1299
Del Norte,16,2022-04-04,8,8,8,0,1118,1118,1080,38,0,0,0,1,49,49,49,49
El Dorado,16,2022-04-04,48,48,46,2,2714,2719,2619,100,0,1,1,1,213,213,212,212
Fresno,16,2022-04-04,188,188,180,8,16792,16813,16119,694,62,4,4,12,2756,2756,2752,2752
Glenn,16,2022-04-04,3,3,3,0,287,287,277,10,0,0,0,0,53,53,53,53
Humboldt,16,2022-04-04,22,22,21,1,2385,2389,2307,82,5,0,0,2,145,145,145,145
Imperial,16,2022-04-04,38,38,37,1,3447,3452,3323,129,3,0,0,2,944,944,944,944
Inyo,16,2022-04-04,9,9,9,0,182,182,176,6,0,0,0,0,56,56,56,56
Kern,16,2022-04-04,152,152,147,5,16749,16770,16254,516,16,2,2,7,2341,2341,2339,2339
Kings,16,2022-04-04,47,47,45,2,4176,4181,4025,156,2,0,0,1,446,446,446,446
Lake,16,2022-04-04,14,14,13,1,973,973,931,42,0,0,0,0,139,139,139,139
Lassen,16,2022-04-04,5,5,5,0,1284,1284,1247,37,0,0,0,0,62,62,62,62
Los Angeles,16,2022-04-04,5458,5465,5408,57,803245,804224,795607,8617,255,47,47,42,31797,31797,31750,31750
Madera,16,2022-04-04,27,27,26,1,3190,3195,3062,133,3,0,0,1,370,370,370,370
Marin,16,2022-04-04,167,167,160,7,6340,6346,6088,258,3,0,0,1,295,295,295,295
Mariposa,16,2022-04-04,7,7,7,0,235,235,225,10,0,0,0,0,28,28,28,28
Mendocino,16,2022-04-04,25,25,24,1,1196,1196,1130,66,2,0,0,0,124,124,124,124
Merced,16,2022-04-04,58,58,56,2,3349,3354,3247,107,2,2,2,0,818,818,816,816
Modoc,16,2022-04-04,4,4,4,0,43,43,42,1,0,0,0,0,7,7,7,7
Mono,16,2022-04-04,1,1,1,0,142,142,133,9,0,0,0,0,6,6,6,6
Monterey,16,2022-04-04,128,128,120,8,7487,7497,7017,480,8,3,3,0,728,728,725,725
Napa,16,2022-04-04,75,75,73,2,3142,3147,3059,88,1,0,0,1,143,143,143,143
Nevada,16,2022-04-04,30,30,29,1,1447,1447,1388,59,1,1,1,0,128,128,127,127
Orange,16,2022-04-04,988,988,964,24,81457,81556,79523,2033,56,17,17,14,7078,7078,7061,7061
Placer,16,2022-04-04,129,129,123,6,6693,6700,6401,299,19,1,1,5,625,625,624,624
Plumas,16,2022-04-04,4,4,4,0,235,235,225,10,0,0,0,0,13,13,13,13
Riverside,16,2022-04-04,693,693,671,22,38899,38946,37672,1274,36,5,5,8,6446,6446,6441,6441
Sacramento,16,2022-04-04,430,430,415,15,32863,32903,31747,1156,50,8,8,11,3047,3047,3039,3039
San Benito,16,2022-04-04,13,13,13,0,1187,1187,1153,34,0,0,0,0,94,94,94,94
San Bernardino,16,2022-04-04,611,611,595,16,42043,42094,40975,1119,32,11,11,13,7797,7797,7786,7786
San Diego,16,2022-04-04,1547,1547,1530,17,66648,66728,65984,744,88,6,6,29,5324,5324,5318,5318
San Francisco,16,2022-04-04,999,999,930,69,28649,28683,26679,2004,20,1,1,3,866,866,865,865
San Joaquin,16,2022-04-04,229,229,220,9,15664,15683,15080,603,9,2,2,8,2247,2247,2245,2245
San Luis Obispo,16,2022-04-04,99,99,96,3,5382,5387,5225,162,2,1,1,1,478,478,477,477
San Mateo,16,2022-04-04,723,723,705,18,29218,29255,28532,723,14,2,2,1,703,703,701,701
Santa Barbara,16,2022-04-04,187,187,181,6,15270,15290,14773,517,7,2,2,1,689,689,687,687
Santa Clara,16,2022-04-04,1492,1492,1474,18,87479,87585,86535,1050,89,2,2,18,2297,2297,2295,2295
Santa Cruz,16,2022-04-04,210,210,204,6,16675,16696,16206,490,4,0,0,2,259,259,259,259
Shasta,16,2022-04-04,29,29,28,1,3319,3323,3206,117,4,1,1,2,560,560,559,559
Siskiyou,16,2022-04-04,2,2,2,0,294,294,286,8,0,0,0,0,83,83,83,83
Solano,16,2022-04-04,172,172,166,6,10218,10232,9895,337,21,1,1,4,448,448,447,447
Sonoma,16,2022-04-04,329,329,319,10,10649,10663,10319,344,9,1,1,1,490,490,489,489
Stanislaus,16,2022-04-04,113,113,107,6,7960,7969,7571,398,21,3,3,5,1689,1689,1686,1686
Sutter,16,2022-04-04,24,24,23,1,1324,1324,1280,44,0,0,0,0,224,224,224,224
Tehama,16,2022-04-04,6,6,6,0,765,765,728,37,0,1,1,0,206,206,205,205
Trinity,16,2022-04-04,1,1,1,0,87,87,83,4,0,0,0,0,20,20,20,20
Tulare,16,2022-04-04,49,49,46,3,7735,7743,7347,396,13,3,3,0,1488,1488,1485,1485
Tuolumne,16,2022-04-04,9,9,9,0,1034,1034,991,43,1,1,1,0,187,187,186,186
Ventura,16,2022-04-04,300,300,293,7,20329,20354,19890,464,19,5,5,5,1498,1498,1493,1493
Yolo,16,2022-04-04,104,104,101,3,26184,26215,25430,785,0,0,0,0,362,362,362,362
Yuba,16,2022-04-04,11,11,11,0,1071,1071,1037,34,4,0,0,1,119,119,119,119
Alameda,17,2022-04-11,1492,1492,1462,30,49597,49659,48634,1025,51,6,6,2,1870,1870,1864,1864
Amador,17,2022-04-11,9,9,9,0,1068,1068,1032,36,1,0,0,0,86,86,86,86
Butte,17,2022-04-11,33,33,32,1,2262,2264,2226,38,3,0,0,1,429,429,429,429
Calaveras,17,2022-04-11,14,14,14,0,649,649,630,19,0,0,0,0,119,119,119,119
Colusa,17,2022-04-11,6,6,6,0,203,203,198,5,0,0,0,0,21,21,21,21
Contra Costa,17,2022-04-11,712,712,688,24,20794,20820,20111,709,15,1,1,5,1301,1301,1300,1300
Del Norte,17,2022-04-11,9,9,9,0,1012,1012,985,27,0,0,0,0,49,49,49,49
El Dorado,17,2022-04-11,48,48,47,1,2508,2512,2439,73,1,0,0,0,213,213,213,213
Fresno,17,2022-04-11,194,194,188,6,15725,15744,15231,513,54,3,3,6,2759,2759,2756,2756
Glenn,17,2022-04-11,2,2,2,0,258,258,251,7,0,0,0,0,53,53,53,53
Humboldt,17,2022-04-11,46,46,45,1,2347,2351,2288,63,5,1,1,2,146,146,145,145
Imperial,17,2022-04-11,28,28,27,1,3448,3453,3351,102,2,1,1,1,945,945,944,944
Inyo,17,2022-04-11,4,4,4,0,188,188,183,5,0,0,0,0,56,56,56,56
Kern,17,2022-04-11,135,135,132,3,16363,16384,15986,398,20,2,2,6,2343,2343,2341,2341
Kings,17,2022-04-11,31,31,30,1,4156,4161,4039,122,3,0,0,0,446,446,446,446
Lake,17,2022-04-11,22,22,21,1,869,869,840,29,0,0,0,0,139,139,139,139
Lassen,17,2022-04-11,1,1,1,0,1291,1291,1262,29,1,0,0,0,62,62,62,62
Los Angeles,17,2022-04-11,6732,6740,6685,55,675550,676396,670684,5712,234,46,46,36,31843,31843,31797,31797
Madera,17,2022-04-11,29,29,28,1,3076,3081,2980,101,4,0,0,2,370,370,370,370
Marin,17,2022-04-11,214,214,207,7,5550,5557,5381,176,6,0,0,1,295,295,295,295
Mariposa,17,2022-04-11,7,7,7,0,246,246,237,9,0,0,0,0,28,28,28,28
Mendocino,17,2022-04-11,32,32,31,1,1158,1158,1108,50,0,0,0,0,124,124,124,124
Merced,17,2022-04-11,69,69,67,2,3221,3226,3145,81,6,2,2,0,820,820,818,818
Modoc,17,2022-04-11,0,0,0,0,40,40,39,1,0,0,0,0,7,7,7,7
Mono,17,2022-04-11,9,9,9,0,170,170,161,9,0,0,0,0,6,6,6,6
Monterey,17,2022-04-11,109,109,103,6,6884,6894,6544,350,9,2,2,0,730,730,728,728
Napa,17,2022-04-11,120,120,117,3,2799,2804,2742,62,1,0,0,0,143,143,143,143
Nevada,17,2022-04-11,45,45,44,1,1431,1431,1385,46,2,0,0,0,128,128,128,128
Orange,17,2022-04-11,1159,1159,1137,22,61960,62037,60858,1179,70,8,8,16,7086,7086,7078,7078
Placer,17,2022-04-11,126,126,122,4,5632,5639,5440,199,18,2,2,2,627,627,625,625
Plumas,17,2022-04-11,6,6,6,0,247,247,239,8,0,0,0,0,13,13,13,13
Riverside,17,2022-04-11,727,727,709,18,37765,37813,36842,971,35,5,5,9,6451,6451,6446,6446
Sacramento,17,2022-04-11,507,507,493,14,30131,30169,29335,834,47,11,11,5,3058,3058,3047,3047
San Benito,17,2022-04-11,17,17,17,0,1182,1182,1155,27,0,0,0,0,94,94,94,94
San Bernardino,17,2022-04-11,910,910,891,19,41998,42052,41176,876,33,5,5,7,7802,7802,7797,7797
San Diego,17,2022-04-11,1833,1833,1817,16,74059,74152,73503,649,91,4,4,22,5328,5328,5324,5324
San Francisco,17,2022-04-11,1179,1179,1114,65,29793,29829,28177,1652,19,6,6,4,872,872,866,866
San Joaquin,17,2022-04-11,223,223,216,7,15218,15237,14775,462,10,0,0,1,2247,2247,2247,2247
San Luis Obispo,17,2022-04-11,119,119,116,3,4906,4911,4795,116,2,1,1,0,479,479,478,478
San Mateo,17,2022-04-11,857,857,841,16,30235,30272,29683,589,8,2,2,1,705,705,703,703
Santa Barbara,17,2022-04-11,303,303,295,8,15107,15126,14724,402,6,2,2,1,691,691,689,689
Santa Clara,17,2022-04-11,1660,1660,1645,15,80647,80748,79996,752,61,4,4,13,2301,2301,2297,2297
Santa Cruz,17,2022-04-11,326,326,319,7,10986,11000,10759,241,7,1,1,0,260,260,259,259
Shasta,17,2022-04-11,18,18,18,0,3123,3128,3041,87,2,1,1,1,561,561,560,560
Siskiyou,17,2022-04-11,1,1,1,0,340,340,332,8,0,0,0,0,83,83,83,83
Solano,17,2022-04-11,249,249,243,6,9408,9420,9177,243,16,0,0,1,448,448,448,448
Sonoma,17,2022-04-11,416,416,406,10,10680,10694,10423,271,8,1,1,0,491,491,490,490
Stanislaus,17,2022-04-11,124,124,119,5,7637,7646,7345,301,22,1,1,1,1690,1690,1689,1689
Sutter,17,2022-04-11,20,20,19,1,1237,1237,1204,33,0,1,1,0,225,225,224,224
Tehama,17,2022-04-11,9,9,9,0,753,753,724,29,1,0,0,0,206,206,206,206
Trinity,17,2022-04-11,0,0,0,0,77,77,74,3,0,0,0,0,20,20,20,20
Tulare,17,2022-04-11,54,54,52,2,7834,7843,7526,317,11,3,3,0,1491,1491,1488,1488
Tuolumne,17,2022-04-11,22,22,21,1,1062,1062,1027,35,1,0,0,0,187,187,187,187
Ventura,17,2022-04-11,323,323,317,6,17583,17604,17291,313,16,2,2,2,1500,1500,1498,1498
Yolo,17,2022-04-11,130,130,127,3,18027,18049,17630,419,1,0,0,0,362,362,362,362
Yuba,17,2022-04-11,15,15,15,0,1019,1019,994,25,2,0,0,0,119,119,119,119
Alameda,18,2022-04-18,1780,1781,1752,29,54064,54134,53253,881,42,4,4,4,1874,1874,1870,1870
Amador,18,2022-04-18,12,12,12,0,1194,1194,1162,32,2,0,0,0,86,86,86,86
Butte,18,2022-04-18,47,47,46,1,2268,2270,2240,30,5,2,2,0,431,431,429,429
Calaveras,18,2022-04-18,16,16,16,0,576,576,563,13,0,1,1,0,120,120,119,119
Colusa,18,2022-04-18,3,3,3,0,157,157,154,3,0,0,0,0,21,21,21,21
Contra Costa,18,2022-04-18,1047,1047,1019,28,24723,24754,24085,669,26,1,1,5,1302,1302,1301,1301
Del Norte,18,2022-04-18,12,12,12,0,1010,1010,989,21,0,0,0,0,49,49,49,49
El Dorado,18,2022-04-18,69,69,67,2,2455,2459,2404,55,0,0,0,0,213,213,213,213
Fresno,18,2022-04-18,246,246,240,6,13938,13957,13604,353,42,4,4,5,2763,2763,2759,2759
Glenn,18,2022-04-18,4,4,4,0,278,278,272,6,0,0,0,0,53,53,53,53
Humboldt,18,2022-04-18,106,106,104,2,2052,2054,2011,43,4,1,1,2,147,147,146,146
Imperial,18,2022-04-18,49,49,48,1,3219,3224,3149,75,2,0,0,1,945,945,945,945
Inyo,18,2022-04-18,2,2,2,0,164,164,161,3,0,0,0,0,56,56,56,56
Kern,18,2022-04-18,151,151,148,3,13634,13651,13393,258,9,1,1,5,2344,2344,2343,2343
Kings,18,2022-04-18,44,44,43,1,3580,3585,3503,82,3,1,1,1,447,447,446,446
Lake,18,2022-04-18,16,16,16,0,782,782,762,20,2,1,1,1,140,140,139,139
Lassen,18,2022-04-18,1,1,1,0,1340,1340,1316,24,0,0,0,0,62,62,62,62
Los Angeles,18,2022-04-18,8310,8322,8269,53,469146,469760,466785,2975,200,35,35,26,31878,31878,31843,31843
Madera,18,2022-04-18,23,23,22,1,2521,2524,2459,65,2,0,0,2,370,370,370,370
Marin,18,2022-04-18,322,322,314,8,5987,5994,5844,150,6,0,0,0,295,295,295,295
Mariposa,18,2022-04-18,18,18,18,0,248,248,241,7,0,0,0,0,28,28,28,28
Mendocino,18,2022-04-18,53,53,51,2,1285,1285,1241,44,0,1,1,0,125,125,124,124
Merced,18,2022-04-18,65,65,64,1,3047,3052,2992,60,3,2,2,0,822,822,820,820
Modoc,18,2022-04-18,1,1,1,0,40,40,39,1,0,0,0,0,7,7,7,7
Mono,18,2022-04-18,9,9,9,0,122,122,117,5,0,0,0,0,6,6,6,6
Monterey,18,2022-04-18,157,157,151,6,6520,6528,6268,260,2,1,1,0,731,731,730,730
Napa,18,2022-04-18,164,164,161,3,2853,2858,2809,49,1,0,0,0,143,143,143,143
Nevada,18,2022-04-18,41,41,40,1,1260,1260,1228,32,1,0,0,0,128,128,128,128
Orange,18,2022-04-18,1442,1442,1421,21,79744,79849,78640,1209,50,5,5,10,7091,7091,7086,7086
Placer,18,2022-04-18,162,162,158,4,4800,4806,4674,132,30,0,0,3,627,627,627,627
Plumas,18,2022-04-18,6,6,6,0,225,225,219,6,0,0,0,0,13,13,13,13
Riverside,18,2022-04-18,933,933,914,19,36714,36763,36022,741,36,7,7,7,6458,6458,6451,6451
Sacramento,18,2022-04-18,714,714,699,15,27848,27885,27284,601,47,9,9,8,3067,3067,3058,3058
San Benito,18,2022-04-18,24,24,24,0,1170,1170,1149,21,0,0,0,0,94,94,94,94
San Bernardino,18,2022-04-18,1059,1059,1042,17,40080,40131,39477,654,35,7,7,8,7809,7809,7802,7802
San Diego,18,2022-04-18,2047,2048,2034,14,67074,67161,66702,459,78,9,9,17,5337,5337,5328,5328
San Francisco,18,2022-04-18,1437,1437,1375,62,30503,30544,29208,1336,27,2,2,2,874,874,872,872
San Joaquin,18,2022-04-18,246,246,240,6,14720,14739,14388,351,8,1,1,4,2248,2248,2247,2247
San Luis Obispo,18,2022-04-18,180,180,177,3,4958,4964,4872,92,2,2,2,0,481,481,479,479
San Mateo,18,2022-04-18,1145,1145,1128,17,30555,30594,30131,463,15,2,2,2,707,707,705,705
Santa Barbara,18,2022-04-18,299,299,293,6,14680,14699,14393,306,8,0,0,0,691,691,691,691
Santa Clara,18,2022-04-18,2234,2235,2219,16,70731,70824,70306,518,67,4,4,16,2305,2305,2301,2301
Santa Cruz,18,2022-04-18,436,436,428,8,12225,12241,12026,215,3,0,0,1,260,260,260,260
Shasta,18,2022-04-18,33,33,32,1,2849,2854,2792,62,2,1,1,2,562,562,561,561
Siskiyou,18,2022-04-18,8,8,8,0,318,318,312,6,0,0,0,0,83,83,83,83
Solano,18,2022-04-18,253,253,248,5,9314,9326,9137,189,6,1,1,1,449,449,448,448
Sonoma,18,2022-04-18,502,502,492,10,11183,11197,10974,223,16,1,1,4,492,492,491,491
Stanislaus,18,2022-04-18,161,161,156,5,7665,7674,7435,239,15,0,0,3,1690,1690,1690,1690
Sutter,18,2022-04-18,24,24,24,0,1173,1173,1149,24,0,0,0,0,225,225,225,225
Tehama,18,2022-04-18,7,7,7,0,685,685,664,21,1,0,0,0,206,206,206,206
Trinity,18,2022-04-18,1,1,1,0,72,72,70,2,0,0,0,0,20,20,20,20
Tulare,18,2022-04-18,77,77,75,2,6658,6665,6454,211,13,0,0,0,1491,1491,1491,1491
Tuolumne,18,2022-04-18,25,25,24,1,1025,1025,999,26,1,0,0,0,187,187,187,187
Ventura,18,2022-04-18,367,367,362,5,16410,16432,16204,228,8,3,3,0,1503,1503,1500,1500
Yolo,18,2022-04-18,217,217,213,4,17889,17912,17583,329,2,1,1,0,363,363,362,362
Yuba,18,2022-04-18,28,28,27,1,996,996,977,19,1,0,0,1,119,119,119,119
Alameda,19,2022-04-25,2535,2537,2505,32,60750,60830,60063,767,44,6,6,4,1880,1880,1874,1874
Amador,19,2022-04-25,26,26,25,1,1316,1316,1289,27,0,0,0,0,86,86,86,86
Butte,19,2022-04-25,66,66,65,1,2596,2600,2573,27,5,1,1,1,432,432,431,431
Calaveras,19,2022-04-25,34,34,33,1,687,687,675,12,0,0,0,0,120,120,120,120
Colusa,19,2022-04-25,3,3,3,0,199,199,196,3,0,0,0,0,21,21,21,21
Contra Costa,19,2022-04-25,1510,1510,1478,32,27232,27267,26693,574,25,3,3,3,1305,1305,1302,1302
Del Norte,19,2022-04-25,25,25,25,0,1104,1104,1086,18,0,0,0,0,49,49,49,49
El Dorado,19,2022-04-25,102,102,100,2,2646,2651,2604,47,1,0,0,0,213,213,213,213
Fresno,19,2022-04-25,333,333,326,7,15887,15909,15592,317,34,3,3,2,2766,2766,2763,2763
Glenn,19,2022-04-25,4,4,4,0,287,287,282,5,0,0,0,0,53,53,53,53
Humboldt,19,2022-04-25,168,168,165,3,2853,2858,2811,47,2,0,0,2,147,147,147,147
Imperial,19,2022-04-25,65,65,64,1,3512,3517,3454,63,4,0,0,1,945,945,945,945
Inyo,19,2022-04-25,7,7,7,0,194,194,191,3,0,0,0,0,56,56,56,56
Kern,19,2022-04-25,250,250,246,4,18299,18322,18051,271,14,2,2,4,2346,2346,2344,2344
Kings,19,2022-04-25,54,54,53,1,4515,4520,4439,81,3,0,0,1,447,447,447,447
Lake,19,2022-04-25,21,21,21,0,887,887,869,18,0,0,0,0,140,140,140,140
Lassen,19,2022-04-25,1,1,1,0,1556,1557,1535,22,0,0,0,0,62,62,62,62
Los Angeles,19,2022-04-25,11348,11361,11304,57,884829,886010,881520,4490,207,29,29,25,31907,31907,31878,31878
Madera,19,2022-04-25,44,44,43,1,2916,2920,2861,59,2,0,0,0,370,370,370,370
Marin,19,2022-04-25,328,328,322,6,6436,6445,6319,126,7,0,0,0,295,295,295,295
Mariposa,19,2022-04-25,9,9,9,0,205,205,201,4,0,0,0,0,28,28,28,28
Mendocino,19,2022-04-25,55,55,54,1,1254,1254,1220,34,0,1,1,0,126,126,125,125
Merced,19,2022-04-25,100,100,98,2,3030,3035,2989,46,5,0,0,0,822,822,822,822
Modoc,19,2022-04-25,1,1,1,0,41,41,40,1,0,0,0,0,7,7,7,7
Mono,19,2022-04-25,4,4,4,0,94,94,91,3,0,0,0,0,6,6,6,6
Monterey,19,2022-04-25,321,321,311,10,8006,8019,7769,250,5,1,1,0,732,732,731,731
Napa,19,2022-04-25,199,199,196,3,3375,3380,3334,46,2,0,0,0,143,143,143,143
Nevada,19,2022-04-25,52,52,51,1,1399,1400,1372,28,1,0,0,1,128,128,128,128
Orange,19,2022-04-25,1971,1972,1949,23,86592,86708,85685,1023,53,7,7,13,7098,7098,7091,7091
Placer,19,2022-04-25,237,237,232,5,6091,6098,5966,132,18,0,0,4,627,627,627,627
Plumas,19,2022-04-25,2,2,2,0,228,228,223,5,0,0,0,0,13,13,13,13
Riverside,19,2022-04-25,1302,1302,1282,20,40524,40579,39939,640,33,4,4,5,6462,6462,6458,6458
Sacramento,19,2022-04-25,1020,1020,1003,17,31858,31901,31361,540,44,4,4,4,3071,3071,3067,3067
San Benito,19,2022-04-25,34,34,34,0,1118,1118,1102,16,0,0,0,0,94,94,94,94
San Bernardino,19,2022-04-25,1292,1292,1276,16,42973,43031,42483,548,21,10,10,7,7819,7819,7809,7809
San Diego,19,2022-04-25,3012,3017,3001,16,74308,74407,74011,396,86,5,5,10,5342,5342,5337,5337
San Francisco,19,2022-04-25,1996,1997,1929,68,32469,32514,31398,1116,23,1,1,3,875,875,874,874
San Joaquin,19,2022-04-25,393,393,386,7,15463,15483,15194,289,12,0,0,1,2248,2248,2248,2248
San Luis Obispo,19,2022-04-25,210,210,207,3,5033,5039,4966,73,6,0,0,0,481,481,481,481
San Mateo,19,2022-04-25,1529,1529,1511,18,32791,32835,32447,388,14,1,1,3,708,708,707,707
Santa Barbara,19,2022-04-25,371,371,365,6,15227,15247,14999,248,7,2,2,1,693,693,691,691
Santa Clara,19,2022-04-25,3144,3150,3132,18,76572,76675,76244,431,73,4,4,9,2309,2309,2305,2305
Santa Cruz,19,2022-04-25,473,473,467,6,20459,20488,20206,282,4,1,1,0,261,261,260,260
Shasta,19,2022-04-25,48,48,47,1,3316,3321,3265,56,3,0,0,1,562,562,562,562
Siskiyou,19,2022-04-25,7,7,7,0,322,322,318,4,0,0,0,0,83,83,83,83
Solano,19,2022-04-25,475,475,468,7,10606,10619,10451,168,11,0,0,2,449,449,449,449
Sonoma,19,2022-04-25,672,672,662,10,12061,12076,11888,188,19,0,0,2,492,492,492,492
Stanislaus,19,2022-04-25,240,240,234,6,7895,7906,7714,192,25,3,3,0,1693,1693,1690,1690
Sutter,19,2022-04-25,39,39,38,1,1399,1399,1376,23,0,1,1,0,226,226,225,225
Tehama,19,2022-04-25,17,17,17,0,711,711,694,17,1,0,0,0,206,206,206,206
Trinity,19,2022-04-25,1,1,1,0,72,72,70,2,0,0,0,0,20,20,20,20
Tulare,19,2022-04-25,90,90,88,2,6912,6920,6748,172,11,1,1,0,1492,1492,1491,1491
Tuolumne,19,2022-04-25,43,43,42,1,1124,1124,1101,23,2,0,0,0,187,187,187,187
Ventura,19,2022-04-25,604,604,597,7,18900,18925,18720,205,10,1,1,3,1504,1504,1503,1503
Yolo,19,2022-04-25,272,272,268,4,19348,19375,19097,278,1,0,0,0,363,363,363,363
Yuba,19,2022-04-25,31,31,31,0,1106,1106,1089,17,0,0,0,0,119,119,119,119
Alameda,20,2022-05-02,3373,3379,3346,33,67877,67971,67295,676,42,2,2,5,1882,1882,1880,1880
Amador,20,2022-05-02,19,19,19,0,1335,1335,1313,22,0,0,0,0,86,86,86,86
Butte,20,2022-05-02,90,90,89,1,2385,2388,2369,19,4,2,2,0,434,434,432,432
Calaveras,20,2022-05-02,23,23,23,0,725,725,715,10,0,0,0,0,120,120,120,120
Colusa,20,2022-05-02,2,2,2,0,203,203,201,2,0,0,0,0,21,21,21,21
Contra Costa,20,2022-05-02,1879,1880,1849,31,29215,29256,28773,483,40,2,2,5,1307,1307,1305,1305
Del Norte,20,2022-05-02,40,40,39,1,1202,1202,1187,15,1,0,0,0,49,49,49,49
El Dorado,20,2022-05-02,138,138,136,2,2753,2758,2720,38,1,1,1,0,214,214,213,213
Fresno,20,2022-05-02,499,499,491,8,16700,16723,16462,261,42,3,3,4,2769,2769,2766,2766
Glenn,20,2022-05-02,4,4,4,0,252,252,249,3,0,0,0,0,53,53,53,53
Humboldt,20,2022-05-02,268,268,265,3,2941,2946,2908,38,6,0,0,2,147,147,147,147
Imperial,20,2022-05-02,122,122,120,2,3644,3649,3597,52,1,0,0,1,945,945,945,945
Inyo,20,2022-05-02,2,2,2,0,179,179,177,2,0,0,0,0,56,56,56,56
Kern,20,2022-05-02,292,292,289,3,17932,17956,17748,208,10,0,0,5,2346,2346,2346,2346
Kings,20,2022-05-02,58,58,57,1,4847,4852,4784,68,3,0,0,1,447,447,447,447
Lake,20,2022-05-02,29,29,29,0,1003,1003,987,16,1,0,0,0,140,140,140,140
Lassen,20,2022-05-02,8,8,8,0,1608,1609,1591,18,0,0,0,0,62,62,62,62
Los Angeles,20,2022-05-02,14791,14811,14753,58,917525,918792,915145,3647,214,23,23,22,31930,31930,31907,31907
Madera,20,2022-05-02,75,75,74,1,3307,3312,3260,52,5,0,0,0,370,370,370,370
Marin,20,2022-05-02,427,427,421,6,6535,6544,6444,100,10,0,0,0,295,295,295,295
Mariposa,20,2022-05-02,7,7,7,0,244,244,240,4,0,0,0,0,28,28,28,28
Mendocino,20,2022-05-02,60,60,59,1,1222,1222,1196,26,0,0,0,0,126,126,126,126
Merced,20,2022-05-02,128,128,126,2,3282,3287,3248,39,8,4,4,0,826,826,822,822
Modoc,20,2022-05-02,0,0,0,0,36,37,36,1,0,0,0,0,7,7,7,7
Mono,20,2022-05-02,6,6,6,0,106,106,103,3,0,0,0,0,6,6,6,6
Monterey,20,2022-05-02,353,353,344,9,8384,8397,8191,206,8,1,1,0,733,733,732,732
Napa,20,2022-05-02,228,228,226,2,3546,3551,3513,38,4,0,0,0,143,143,143,143
Nevada,20,2022-05-02,80,80,79,1,1535,1536,1512,24,2,0,0,0,128,128,128,128
Orange,20,2022-05-02,2635,2639,2615,24,87471,87593,86783,810,61,5,5,13,7103,7103,7098,7098
Placer,20,2022-05-02,301,301,296,5,6372,6379,6271,108,20,0,0,4,627,627,627,627
Plumas,20,2022-05-02,9,9,9,0,256,256,252,4,0,0,0,0,13,13,13,13
Riverside,20,2022-05-02,2045,2046,2021,25,42954,43012,42482,530,37,3,3,5,6465,6465,6462,6462
Sacramento,20,2022-05-02,1393,1393,1375,18,33649,33695,33251,444,43,5,5,9,3076,3076,3071,3071
San Benito,20,2022-05-02,50,50,49,1,1285,1285,1271,14,0,0,0,0,94,94,94,94
San Bernardino,20,2022-05-02,1489,1489,1474,15,43529,43590,43156,434,30,7,7,6,7826,7826,7819,7819
San Diego,20,2022-05-02,4121,4128,4111,17,72911,73011,72708,303,79,3,3,13,5345,5345,5342,5342
San Francisco,20,2022-05-02,2413,2415,2351,64,35430,35479,34522,957,39,3,3,13,878,878,875,875
San Joaquin,20,2022-05-02,547,547,539,8,15173,15194,14973,221,14,1,1,1,2249,2249,2248,2248
San Luis Obispo,20,2022-05-02,249,249,246,3,5109,5115,5057,58,5,2,2,0,483,483,481,481
San Mateo,20,2022-05-02,1815,1816,1799,17,35869,35919,35586,333,22,2,2,5,710,710,708,708
Santa Barbara,20,2022-05-02,439,439,434,5,15309,15330,15135,195,10,0,0,2,693,693,693,693
Santa Clara,20,2022-05-02,4348,4355,4336,19,95841,95973,95547,426,88,5,5,15,2314,2314,2309,2309
Santa Cruz,20,2022-05-02,678,678,671,7,22014,22044,21806,238,2,1,1,0,262,262,261,261
Shasta,20,2022-05-02,67,67,66,1,3449,3453,3407,46,7,0,0,1,562,562,562,562
Siskiyou,20,2022-05-02,9,9,9,0,329,329,326,3,0,0,0,0,83,83,83,83
Solano,20,2022-05-02,622,622,614,8,11759,11776,11630,146,20,0,0,2,449,449,449,449
Sonoma,20,2022-05-02,899,899,888,11,12791,12809,12654,155,16,1,1,4,493,493,492,492
Stanislaus,20,2022-05-02,269,269,264,5,8081,8094,7940,154,22,0,0,3,1693,1693,1693,1693
Sutter,20,2022-05-02,47,47,46,1,1263,1263,1247,16,0,1,1,0,227,227,226,226
Tehama,20,2022-05-02,17,17,17,0,699,699,686,13,0,0,0,0,206,206,206,206
Trinity,20,2022-05-02,1,1,1,0,84,84,82,2,0,0,0,0,20,20,20,20
Tulare,20,2022-05-02,161,161,158,3,7286,7296,7154,142,10,3,3,0,1495,1495,1492,1492
Tuolumne,20,2022-05-02,93,93,92,1,1297,1297,1277,20,5,0,0,0,187,187,187,187
Ventura,20,2022-05-02,743,743,737,6,19918,19946,19777,169,15,4,4,1,1508,1508,1504,1504
Yolo,20,2022-05-02,352,352,348,4,18770,18795,18584,211,1,1,1,0,364,364,363,363
Yuba,20,2022-05-02,47,47,46,1,1053,1053,1041,12,2,0,0,1,119,119,119,119
Alameda,21,2022-05-09,4150,4157,4125,32,71306,71410,70857,553,44,6,6,6,1888,1888,1882,1882
Amador,21,2022-05-09,25,25,25,0,1518,1519,1500,19,0,0,0,0,86,86,86,86
Butte,21,2022-05-09,115,115,114,1,2412,2416,2401,15,5,0,0,0,434,434,434,434
Calaveras,21,2022-05-09,33,33,33,0,689,689,681,8,1,0,0,0,120,120,120,120
Colusa,21,2022-05-09,3,3,3,0,215,215,213,2,0,0,0,0,21,21,21,21
Contra Costa,21,2022-05-09,2516,2521,2489,32,30499,30543,30148,395,48,4,4,12,1311,1311,1307,1307
Del Norte,21,2022-05-09,49,49,49,0,1356,1357,1343,14,0,0,0,0,49,49,49,49
El Dorado,21,2022-05-09,176,176,174,2,2888,2893,2862,31,3,0,0,1,214,214,214,214
Fresno,21,2022-05-09,744,744,735,9,17838,17864,17646,218,29,1,1,1,2770,2770,2769,2769
Glenn,21,2022-05-09,8,8,8,0,228,228,226,2,0,0,0,0,53,53,53,53
Humboldt,21,2022-05-09,273,273,270,3,3149,3154,3122,32,5,0,0,2,147,147,147,147
Imperial,21,2022-05-09,131,131,130,1,3826,3831,3789,42,0,0,0,1,945,945,945,945
Inyo,21,2022-05-09,26,26,26,0,236,236,234,2,0,0,0,0,56,56,56,56
Kern,21,2022-05-09,467,467,463,4,18696,18721,18552,169,18,2,2,2,2348,2348,2346,2346
Kings,21,2022-05-09,91,91,90,1,4936,4941,4887,54,1,0,0,1,447,447,447,447
Lake,21,2022-05-09,30,30,30,0,1029,1029,1016,13,1,0,0,0,140,140,140,140
Lassen,21,2022-05-09,6,6,6,0,1689,1691,1677,14,0,0,0,0,62,62,62,62
Los Angeles,21,2022-05-09,18409,18435,18379,56,926816,928168,925300,2868,225,29,29,27,31959,31959,31930,31930
Madera,21,2022-05-09,132,132,130,2,3725,3730,3684,46,3,0,0,0,370,370,370,370
Marin,21,2022-05-09,708,708,700,8,7775,7787,7694,93,12,0,0,0,295,295,295,295
Mariposa,21,2022-05-09,32,32,32,0,287,287,283,4,0,0,0,0,28,28,28,28
Mendocino,21,2022-05-09,92,92,91,1,1264,1264,1243,21,0,1,1,0,127,127,126,126
Merced,21,2022-05-09,199,199,197,2,3428,3433,3401,32,4,1,1,0,827,827,826,826
Modoc,21,2022-05-09,2,2,2,0,41,42,41,1,0,0,0,0,7,7,7,7
Mono,21,2022-05-09,9,9,9,0,113,113,111,2,0,0,0,0,6,6,6,6
Monterey,21,2022-05-09,439,439,431,8,9377,9392,9211,181,11,0,0,0,733,733,733,733
Napa,21,2022-05-09,232,232,230,2,3119,3124,3098,26,2,0,0,0,143,143,143,143
Nevada,21,2022-05-09,101,101,100,1,1655,1656,1636,20,5,0,0,0,128,128,128,128
Orange,21,2022-05-09,3510,3516,3491,25,91755,91890,91227,663,84,8,8,17,7111,7111,7103,7103
Placer,21,2022-05-09,536,536,529,7,6753,6765,6675,90,25,0,0,2,627,627,627,627
Plumas,21,2022-05-09,13,13,13,0,274,274,271,3,0,0,0,0,13,13,13,13
Riverside,21,2022-05-09,2400,2403,2380,23,45138,45204,44768,436,42,4,4,8,6469,6469,6465,6465
Sacramento,21,2022-05-09,2256,2257,2234,23,36119,36170,35796,374,62,4,4,10,3080,3080,3076,3076
San Benito,21,2022-05-09,73,73,72,1,1433,1433,1421,12,0,0,0,0,94,94,94,94
San Bernardino,21,2022-05-09,1930,1931,1916,15,46589,46658,46295,363,31,5,5,4,7831,7831,7826,7826
San Diego,21,2022-05-09,5217,5225,5208,17,87117,87246,86962,284,98,2,2,11,5347,5347,5345,5345
San Francisco,21,2022-05-09,3038,3043,2979,64,38057,38111,37304,807,52,6,6,9,884,884,878,878
San Joaquin,21,2022-05-09,774,774,765,9,16040,16062,15879,183,11,1,1,3,2250,2250,2249,2249
San Luis Obispo,21,2022-05-09,289,289,286,3,5221,5227,5181,46,0,0,0,0,483,483,483,483
San Mateo,21,2022-05-09,2309,2311,2295,16,37593,37647,37375,272,26,3,3,1,713,713,710,710
Santa Barbara,21,2022-05-09,638,638,632,6,15588,15612,15457,155,10,0,0,3,693,693,693,693
Santa Clara,21,2022-05-09,5621,5629,5610,19,105573,105727,105361,366,87,3,3,23,2317,2317,2314,2314
Santa Cruz,21,2022-05-09,729,729,723,6,23965,24000,23798,202,2,0,0,0,262,262,262,262
Shasta,21,2022-05-09,106,106,105,1,3301,3306,3272,34,7,0,0,0,562,562,562,562
Siskiyou,21,2022-05-09,16,16,16,0,285,285,283,2,0,0,0,0,83,83,83,83
Solano,21,2022-05-09,917,917,908,9,12289,12306,12186,120,20,0,0,1,449,449,449,449
Sonoma,21,2022-05-09,1179,1179,1168,11,13974,13994,13861,133,18,1,1,2,494,494,493,493
Stanislaus,21,2022-05-09,460,460,453,7,8942,8956,8822,134,27,0,0,2,1693,1693,1693,1693
Sutter,21,2022-05-09,61,61,60,1,1565,1566,1550,16,0,0,0,0,227,227,227,227
Tehama,21,2022-05-09,28,28,28,0,691,691,681,10,1,0,0,0,206,206,206,206
Trinity,21,2022-05-09,4,4,4,0,69,69,68,1,0,0,0,0,20,20,20,20
Tulare,21,2022-05-09,183,183,180,3,7633,7645,7528,117,11,1,1,1,1496,1496,1495,1495
Tuolumne,21,2022-05-09,71,71,70,1,1429,1430,1413,17,1,2,2,0,189,189,187,187
Ventura,21,2022-05-09,1151,1151,1143,8,20948,20980,20841,139,15,1,1,2,1509,1509,1508,1508
Yolo,21,2022-05-09,492,492,488,4,19641,19671,19498,173,1,0,0,1,364,364,364,364
Yuba,21,2022-05-09,77,77,76,1,1241,1241,1229,12,2,0,0,0,119,119,119,119
Alameda,22,2022-05-16,4994,5002,4972,30,74814,74928,74474,454,73,8,8,6,1896,1896,1888,1888
Amador,22,2022-05-16,54,54,53,1,1672,1673,1656,17,0,0,0,0,86,86,86,86
Butte,22,2022-05-16,206,206,205,1,2664,2668,2655,13,7,2,2,0,436,436,434,434
Calaveras,22,2022-05-16,43,43,43,0,765,765,758,7,0,1,1,1,121,121,120,120
Colusa,22,2022-05-16,7,7,7,0,217,217,215,2,0,0,0,0,21,21,21,21
Contra Costa,22,2022-05-16,3481,3488,3453,35,33493,33543,33204,339,50,5,5,7,1316,1316,1311,1311
Del Norte,22,2022-05-16,172,172,171,1,1859,1861,1846,15,0,0,0,0,49,49,49,49
El Dorado,22,2022-05-16,267,267,265,2,3039,3044,3018,26,5,0,0,1,214,214,214,214
Fresno,22,2022-05-16,1139,1139,1128,11,19026,19055,18874,181,46,2,2,6,2772,2772,2770,2770
Glenn,22,2022-05-16,15,15,15,0,259,259,257,2,0,0,0,0,53,53,53,53
Humboldt,22,2022-05-16,274,274,272,2,3253,3258,3232,26,9,1,1,2,148,148,147,147
Imperial,22,2022-05-16,207,207,205,2,4276,4282,4245,37,1,0,0,1,945,945,945,945
Inyo,22,2022-05-16,19,19,19,0,228,228,226,2,1,0,0,0,56,56,56,56
Kern,22,2022-05-16,686,686,681,5,19977,20007,19866,141,22,3,3,3,2351,2351,2348,2348
Kings,22,2022-05-16,221,221,219,2,5418,5426,5380,46,0,0,0,0,447,447,447,447
Lake,22,2022-05-16,74,74,73,1,1118,1118,1107,11,2,0,0,0,140,140,140,140
Lassen,22,2022-05-16,20,20,20,0,1704,1706,1695,11,1,0,0,0,62,62,62,62
Los Angeles,22,2022-05-16,21397,21430,21379,51,938034,939458,937194,2264,283,38,38,44,31997,31997,31959,31959
Madera,22,2022-05-16,199,199,197,2,3632,3637,3602,35,2,0,0,0,370,370,370,370
Marin,22,2022-05-16,814,814,806,8,8382,8395,8316,79,12,0,0,0,295,295,295,295
Mariposa,22,2022-05-16,23,23,23,0,340,340,336,4,0,0,0,0,28,28,28,28
Mendocino,22,2022-05-16,99,99,98,1,1326,1326,1309,17,0,1,1,1,128,128,127,127
Merced,22,2022-05-16,316,316,314,2,4013,4018,3989,29,8,1,1,1,828,828,827,827
Modoc,22,2022-05-16,4,4,4,0,43,44,43,1,0,0,0,0,7,7,7,7
Mono,22,2022-05-16,11,11,11,0,112,112,110,2,0,0,0,0,6,6,6,6
Monterey,22,2022-05-16,508,508,500,8,9600,9615,9470,145,6,1,1,0,734,734,733,733
Napa,22,2022-05-16,299,299,297,2,3736,3741,3717,24,3,0,0,0,143,143,143,143
Nevada,22,2022-05-16,146,146,145,1,1833,1835,1818,17,2,0,0,0,128,128,128,128
Orange,22,2022-05-16,4548,4555,4530,25,94612,94756,94223,533,74,7,7,15,7118,7118,7111,7111
Placer,22,2022-05-16,738,738,730,8,7776,7789,7708,81,43,2,2,3,629,629,627,627
Plumas,22,2022-05-16,48,48,48,0,242,242,240,2,1,0,0,0,13,13,13,13
Riverside,22,2022-05-16,3342,3349,3324,25,47979,48053,47692,361,65,1,1,6,6470,6470,6469,6469
Sacramento,22,2022-05-16,3136,3142,3117,25,39839,39900,39578,322,89,8,8,12,3088,3088,3080,3080
San Benito,22,2022-05-16,110,110,109,1,1529,1530,1520,10,1,0,0,0,94,94,94,94
San Bernardino,22,2022-05-16,2465,2470,2455,15,49161,49236,48937,299,44,8,8,5,7839,7839,7831,7831
San Diego,22,2022-05-16,6664,6673,6656,17,94780,94925,94685,240,91,6,6,25,5353,5353,5347,5347
San Francisco,22,2022-05-16,3396,3403,3347,56,39289,39350,38697,653,68,5,5,8,889,889,884,884
San Joaquin,22,2022-05-16,1195,1195,1184,11,18985,19015,18846,169,16,1,1,1,2251,2251,2250,2250
San Luis Obispo,22,2022-05-16,425,425,422,3,6056,6064,6022,42,3,0,0,0,483,483,483,483
San Mateo,22,2022-05-16,2760,2765,2750,15,39871,39932,39707,225,39,1,1,1,714,714,713,713
Santa Barbara,22,2022-05-16,912,912,905,7,17036,17063,16931,132,13,0,0,2,693,693,693,693
Santa Clara,22,2022-05-16,7197,7208,7189,19,112666,112836,112532,304,111,9,9,15,2326,2326,2317,2317
Santa Cruz,22,2022-05-16,808,808,803,5,20738,20770,20630,140,5,0,0,0,262,262,262,262
Shasta,22,2022-05-16,127,127,126,1,3813,3818,3787,31,6,0,0,1,562,562,562,562
Siskiyou,22,2022-05-16,19,19,19,0,372,372,370,2,0,0,0,0,83,83,83,83
Solano,22,2022-05-16,1269,1269,1260,9,14155,14177,14070,107,29,0,0,2,449,449,449,449
Sonoma,22,2022-05-16,1568,1569,1558,11,15543,15568,15453,115,28,0,0,4,494,494,494,494
Stanislaus,22,2022-05-16,742,742,733,9,9945,9959,9843,116,33,2,2,5,1695,1695,1693,1693
Sutter,22,2022-05-16,109,109,108,1,1828,1831,1817,14,0,0,0,0,227,227,227,227
Tehama,22,2022-05-16,37,37,37,0,840,840,831,9,0,1,1,1,207,207,206,206
Trinity,22,2022-05-16,5,5,5,0,69,69,68,1,0,0,0,0,20,20,20,20
Tulare,22,2022-05-16,399,399,394,5,8316,8329,8230,99,14,1,1,0,1497,1497,1496,1496
Tuolumne,22,2022-05-16,139,139,138,1,1448,1449,1435,14,1,1,1,0,190,190,189,189
Ventura,22,2022-05-16,1551,1552,1544,8,23859,23895,23771,124,34,2,2,2,1511,1511,1509,1509
Yolo,22,2022-05-16,688,688,683,5,22144,22178,22026,152,0,0,0,1,364,364,364,364
Yuba,22,2022-05-16,119,119,118,1,1335,1335,1325,10,4,0,0,0,119,119,119,119
Alameda,23,2022-05-23,5602,5611,5585,26,77741,77864,77496,368,76,4,4,4,1900,1900,1896,1896
Amador,23,2022-05-23,80,80,79,1,1440,1440,1429,11,0,0,0,0,86,86,86,86
Butte,23,2022-05-23,284,284,283,1,2767,2771,2760,11,5,1,1,1,437,437,436,436
Calaveras,23,2022-05-23,52,52,52,0,743,743,738,5,0,1,1,0,122,122,121,121
Colusa,23,2022-05-23,7,7,7,0,232,232,231,1,0,0,0,0,21,21,21,21
Contra Costa,23,2022-05-23,3831,3838,3808,30,35347,35404,35124,280,71,10,10,7,1326,1326,1316,1316
Del Norte,23,2022-05-23,64,64,64,0,1346,1346,1338,8,0,1,1,0,50,50,49,49
El Dorado,23,2022-05-23,360,360,358,2,3417,3422,3399,23,6,2,2,0,216,216,214,214
Fresno,23,2022-05-23,1638,1639,1627,12,21297,21331,21172,159,63,2,2,8,2774,2774,2772,2772
Glenn,23,2022-05-23,26,26,26,0,273,273,271,2,0,0,0,0,53,53,53,53
Humboldt,23,2022-05-23,245,245,244,1,2911,2916,2898,18,14,1,1,3,149,149,148,148
Imperial,23,2022-05-23,343,343,341,2,4746,4752,4720,32,2,0,0,1,945,945,945,945
Inyo,23,2022-05-23,27,27,27,0,221,221,220,1,0,0,0,0,56,56,56,56
Kern,23,2022-05-23,1005,1005,1000,5,21275,21310,21193,117,34,0,0,7,2351,2351,2351,2351
Kings,23,2022-05-23,249,249,247,2,5643,5651,5613,38,1,0,0,0,447,447,447,447
Lake,23,2022-05-23,96,96,95,1,1238,1238,1228,10,1,0,0,1,140,140,140,140
Lassen,23,2022-05-23,41,41,41,0,1762,1764,1755,9,0,0,0,0,62,62,62,62
Los Angeles,23,2022-05-23,27651,27695,27644,51,946249,947729,945949,1780,366,31,31,53,32028,32028,31997,31997
Madera,23,2022-05-23,214,214,212,2,3763,3768,3739,29,1,0,0,2,370,370,370,370
Marin,23,2022-05-23,798,798,792,6,8778,8791,8727,64,15,0,0,1,295,295,295,295
Mariposa,23,2022-05-23,32,32,32,0,340,340,337,3,0,0,0,0,28,28,28,28
Mendocino,23,2022-05-23,150,150,149,1,1659,1661,1644,17,3,1,1,1,129,129,128,128
Merced,23,2022-05-23,409,409,407,2,4202,4208,4184,24,4,0,0,0,828,828,828,828
Modoc,23,2022-05-23,2,2,2,0,40,41,40,1,0,0,0,0,7,7,7,7
Mono,23,2022-05-23,14,14,14,0,163,163,161,2,0,0,0,0,6,6,6,6
Monterey,23,2022-05-23,698,698,690,8,9612,9627,9514,113,17,1,1,1,735,735,734,734
Napa,23,2022-05-23,331,331,329,2,3937,3942,3922,20,5,0,0,0,143,143,143,143
Nevada,23,2022-05-23,150,150,149,1,1904,1907,1893,14,2,0,0,0,128,128,128,128
Orange,23,2022-05-23,5574,5582,5558,24,94571,94719,94303,416,111,11,11,20,7129,7129,7118,7118
Placer,23,2022-05-23,878,878,871,7,7834,7847,7783,64,49,2,2,4,631,631,629,629
Plumas,23,2022-05-23,46,46,46,0,279,279,277,2,0,0,0,0,13,13,13,13
Riverside,23,2022-05-23,4448,4455,4429,26,52417,52500,52192,308,73,6,6,10,6476,6476,6470,6470
Sacramento,23,2022-05-23,3888,3895,3871,24,41034,41098,40838,260,122,7,7,10,3095,3095,3088,3088
San Benito,23,2022-05-23,167,167,166,1,1667,1669,1660,9,0,0,0,0,94,94,94,94
San Bernardino,23,2022-05-23,3314,3321,3305,16,50638,50718,50478,240,53,3,3,10,7842,7842,7839,7839
San Diego,23,2022-05-23,8835,8848,8831,17,103266,103427,103222,205,138,4,4,20,5357,5357,5353,5353
San Francisco,23,2022-05-23,3595,3601,3554,47,41600,41664,41124,540,85,6,6,9,895,895,889,889
San Joaquin,23,2022-05-23,1547,1547,1536,11,20952,20985,20839,146,20,3,3,7,2254,2254,2251,2251
San Luis Obispo,23,2022-05-23,668,668,664,4,7270,7283,7244,39,10,3,3,0,486,486,483,483
San Mateo,23,2022-05-23,3131,3136,3122,14,40765,40828,40648,180,35,0,0,0,714,714,714,714
Santa Barbara,23,2022-05-23,1064,1064,1058,6,17776,17804,17696,108,20,0,0,3,693,693,693,693
Santa Clara,23,2022-05-23,7823,7835,7819,16,110949,111122,110888,234,126,7,7,18,2333,2333,2326,2326
Santa Cruz,23,2022-05-23,505,505,502,3,7812,7825,7785,40,16,0,0,0,262,262,262,262
Shasta,23,2022-05-23,196,196,195,1,3608,3614,3591,23,4,1,1,3,563,563,562,562
Siskiyou,23,2022-05-23,29,29,29,0,364,364,362,2,1,0,0,0,83,83,83,83
Solano,23,2022-05-23,1503,1503,1494,9,14886,14909,14821,88,24,1,1,3,450,450,449,449
Sonoma,23,2022-05-23,1486,1486,1477,9,16332,16358,16263,95,34,2,2,3,496,496,494,494
Stanislaus,23,2022-05-23,868,868,860,8,10691,10707,10609,98,37,2,2,3,1697,1697,1695,1695
Sutter,23,2022-05-23,140,140,139,1,1912,1914,1903,11,0,1,1,0,228,228,227,227
Tehama,23,2022-05-23,49,49,49,0,811,811,804,7,1,0,0,1,207,207,207,207
Trinity,23,2022-05-23,3,3,3,0,90,90,89,1,0,0,0,0,20,20,20,20
Tulare,23,2022-05-23,555,555,550,5,9070,9086,9002,84,26,0,0,0,1497,1497,1497,1497
Tuolumne,23,2022-05-23,136,136,135,1,1576,1578,1566,12,0,1,1,0,191,191,190,190
Ventura,23,2022-05-23,1917,1920,1912,8,24017,24055,23958,97,36,1,1,1,1512,1512,1511,1511
Yolo,23,2022-05-23,729,729,725,4,22655,22691,22569,122,1,1,1,1,365,365,364,364
Yuba,23,2022-05-23,151,151,150,1,1453,1454,1446,8,6,0,0,1,119,119,119,119
Alameda,24,2022-05-30,4901,4908,4890,18,60655,60753,60524,229,95,4,4,7,1904,1904,1900,1900
Amador,24,2022-05-30,88,88,87,1,1191,1192,1185,7,0,1,1,0,87,87,86,86
Butte,24,2022-05-30,275,275,274,1,2709,2713,2705,8,20,0,0,1,437,437,437,437
Calaveras,24,2022-05-30,54,54,54,0,617,617,614,3,0,0,0,0,122,122,122,122
Colusa,24,2022-05-30,13,13,13,0,170,170,169,1,0,0,0,0,21,21,21,21
Contra Costa,24,2022-05-30,3314,3319,3298,21,28972,29019,28837,182,65,7,7,9,1333,1333,1326,1326
Del Norte,24,2022-05-30,36,36,36,0,975,975,970,5,2,1,1,0,51,51,50,50
El Dorado,24,2022-05-30,333,333,331,2,2938,2942,2926,16,6,2,2,2,218,218,216,216
Fresno,24,2022-05-30,1670,1672,1662,10,19441,19473,19358,115,71,6,6,7,2780,2780,2774,2774
Glenn,24,2022-05-30,27,27,27,0,290,290,289,1,2,0,0,0,53,53,53,53
Humboldt,24,2022-05-30,181,181,180,1,2296,2300,2289,11,10,0,0,5,149,149,149,149
Imperial,24,2022-05-30,332,332,330,2,4146,4152,4130,22,2,1,1,2,946,946,945,945
Inyo,24,2022-05-30,18,18,18,0,151,151,150,1,0,0,0,0,56,56,56,56
Kern,24,2022-05-30,1078,1078,1073,5,17985,18014,17935,79,36,0,0,6,2351,2351,2351,2351
Kings,24,2022-05-30,291,291,289,2,4664,4672,4647,25,2,0,0,1,447,447,447,447
Lake,24,2022-05-30,89,89,88,1,994,994,988,6,1,0,0,0,140,140,140,140
Lassen,24,2022-05-30,50,50,50,0,1615,1616,1609,7,1,0,0,0,62,62,62,62
Los Angeles,24,2022-05-30,25969,26011,25973,38,746580,747782,746655,1127,425,47,47,54,32075,32075,32028,32028
Madera,24,2022-05-30,235,235,234,1,3310,3315,3295,20,4,0,0,1,370,370,370,370
Marin,24,2022-05-30,649,649,645,4,7145,7157,7115,42,16,3,3,1,298,298,295,295
Mariposa,24,2022-05-30,39,39,39,0,303,303,301,2,0,0,0,0,28,28,28,28
Mendocino,24,2022-05-30,137,137,136,1,1264,1265,1255,10,4,0,0,1,129,129,129,129
Merced,24,2022-05-30,365,365,363,2,3407,3411,3395,16,6,0,0,2,828,828,828,828
Modoc,24,2022-05-30,4,4,4,0,38,39,38,1,0,0,0,0,7,7,7,7
Mono,24,2022-05-30,6,6,6,0,81,81,80,1,0,0,0,0,6,6,6,6
Monterey,24,2022-05-30,527,527,522,5,7139,7151,7084,67,19,1,1,1,736,736,735,735
Napa,24,2022-05-30,312,312,311,1,3179,3183,3170,13,4,0,0,0,143,143,143,143
Nevada,24,2022-05-30,181,181,180,1,1595,1598,1589,9,3,2,2,1,130,130,128,128
Orange,24,2022-05-30,5594,5604,5585,19,81959,82092,81805,287,122,9,9,18,7138,7138,7129,7129
Placer,24,2022-05-30,748,748,743,5,6131,6142,6102,40,52,0,0,8,631,631,631,631
Plumas,24,2022-05-30,35,35,35,0,200,200,199,1,1,0,0,0,13,13,13,13
Riverside,24,2022-05-30,3861,3868,3850,18,43856,43926,43721,205,82,3,3,10,6479,6479,6476,6476
Sacramento,24,2022-05-30,3841,3847,3828,19,33076,33129,32962,167,130,8,8,20,3103,3103,3095,3095
San Benito,24,2022-05-30,153,153,152,1,1273,1274,1269,5,0,0,0,0,94,94,94,94
San Bernardino,24,2022-05-30,3328,3334,3322,12,42865,42935,42773,162,49,5,5,10,7847,7847,7842,7842
San Diego,24,2022-05-30,8408,8421,8408,13,85850,85989,85854,135,153,10,10,26,5367,5367,5357,5357
San Francisco,24,2022-05-30,3116,3122,3090,32,33354,33407,33063,344,88,11,11,14,906,906,895,895
San Joaquin,24,2022-05-30,1399,1399,1391,8,17001,17029,16935,94,25,1,1,9,2255,2255,2254,2254
San Luis Obispo,24,2022-05-30,651,651,648,3,5436,5446,5423,23,12,1,1,0,487,487,486,486
San Mateo,24,2022-05-30,2728,2732,2723,9,31127,31177,31067,110,33,3,3,2,717,717,714,714
Santa Barbara,24,2022-05-30,1029,1029,1024,5,14449,14472,14402,70,23,2,2,5,695,695,693,693
Santa Clara,24,2022-05-30,7012,7023,7011,12,84934,85071,84928,143,154,10,10,22,2343,2343,2333,2333
Santa Cruz,24,2022-05-30,526,526,524,2,6241,6252,6226,26,7,1,1,1,263,263,262,262
Shasta,24,2022-05-30,133,133,132,1,2838,2842,2828,14,4,3,3,4,566,566,563,563
Siskiyou,24,2022-05-30,53,53,53,0,340,340,339,1,3,0,0,0,83,83,83,83
Solano,24,2022-05-30,1170,1170,1164,6,11525,11544,11489,55,28,0,0,7,450,450,450,450
Sonoma,24,2022-05-30,1198,1198,1193,5,13239,13261,13200,61,38,2,2,5,498,498,496,496
Stanislaus,24,2022-05-30,801,801,795,6,8578,8590,8528,62,55,2,2,3,1699,1699,1697,1697
Sutter,24,2022-05-30,158,158,157,1,1701,1702,1694,8,0,0,0,0,228,228,228,228
Tehama,24,2022-05-30,62,62,62,0,757,757,752,5,2,0,0,0,207,207,207,207
Trinity,24,2022-05-30,8,8,8,0,96,96,95,1,0,0,0,0,20,20,20,20
Tulare,24,2022-05-30,594,594,590,4,7483,7496,7440,56,19,0,0,0,1497,1497,1497,1497
Tuolumne,24,2022-05-30,121,121,120,1,1306,1307,1299,8,3,0,0,0,191,191,191,191
Ventura,24,2022-05-30,1681,1682,1677,5,19539,19570,19507,63,30,1,1,4,1513,1513,1512,1512
Yolo,24,2022-05-30,612,612,609,3,17618,17647,17572,75,4,0,0,1,365,365,365,365
Yuba,24,2022-05-30,144,144,143,1,1276,1276,1270,6,7,0,0,2,119,119,119,119
Alameda,25,2022-06-06,6464,6475,6456,19,73052,73172,72960,212,112,5,5,12,1909,1909,1904,1904
Amador,25,2022-06-06,115,115,114,1,1724,1727,1719,8,1,0,0,1,87,87,87,87
Butte,25,2022-06-06,452,452,451,1,3617,3622,3614,8,24,1,1,1,438,438,437,437
Calaveras,25,2022-06-06,73,73,73,0,737,737,734,3,0,2,2,0,124,124,122,122
Colusa,25,2022-06-06,22,22,22,0,276,276,275,1,3,0,0,0,21,21,21,21
Contra Costa,25,2022-06-06,4234,4241,4221,20,35651,35710,35537,173,107,9,9,7,1342,1342,1333,1333
Del Norte,25,2022-06-06,63,63,63,0,1134,1134,1130,4,2,0,0,0,51,51,51,51
El Dorado,25,2022-06-06,412,412,410,2,3635,3640,3625,15,5,0,0,5,218,218,218,218
Fresno,25,2022-06-06,2447,2452,2441,11,22673,22710,22607,103,94,2,2,6,2782,2782,2780,2780
Glenn,25,2022-06-06,41,41,41,0,325,325,324,1,3,0,0,0,53,53,53,53
Humboldt,25,2022-06-06,260,260,259,1,3054,3059,3048,11,14,1,1,3,150,150,149,149
Imperial,25,2022-06-06,465,465,463,2,4873,4881,4861,20,2,0,0,0,946,946,946,946
Inyo,25,2022-06-06,20,20,20,0,213,213,212,1,1,0,0,0,56,56,56,56
Kern,25,2022-06-06,1607,1608,1603,5,22974,23013,22935,78,35,1,1,6,2352,2352,2351,2351
Kings,25,2022-06-06,398,398,396,2,5504,5512,5489,23,10,0,0,1,447,447,447,447
Lake,25,2022-06-06,136,136,135,1,1180,1180,1174,6,5,0,0,2,140,140,140,140
Lassen,25,2022-06-06,69,69,69,0,2398,2403,2395,8,2,0,0,0,62,62,62,62
Los Angeles,25,2022-06-06,35158,35216,35176,40,1041594,1043320,1042116,1204,496,39,39,61,32114,32114,32075,32075
Madera,25,2022-06-06,351,351,349,2,4126,4133,4114,19,7,0,0,1,370,370,370,370
Marin,25,2022-06-06,736,736,733,3,7637,7650,7616,34,10,2,2,5,300,300,298,298
Mariposa,25,2022-06-06,58,58,58,0,404,404,402,2,0,0,0,0,28,28,28,28
Mendocino,25,2022-06-06,209,209,208,1,1711,1713,1702,11,9,1,1,2,130,130,129,129
Merced,25,2022-06-06,531,531,529,2,4529,4536,4520,16,16,0,0,0,828,828,828,828
Modoc,25,2022-06-06,11,11,11,0,37,38,37,1,0,0,0,0,7,7,7,7
Mono,25,2022-06-06,15,15,15,0,120,120,119,1,0,0,0,0,6,6,6,6
Monterey,25,2022-06-06,1001,1001,994,7,10219,10236,10162,74,17,2,2,1,738,738,736,736
Napa,25,2022-06-06,543,543,541,2,4203,4209,4196,13,8,1,1,0,144,144,143,143
Nevada,25,2022-06-06,248,248,247,1,2150,2154,2144,10,5,0,0,0,130,130,130,130
Orange,25,2022-06-06,7561,7573,7553,20,73540,73662,73465,197,140,12,12,18,7150,7150,7138,7138
Placer,25,2022-06-06,869,869,865,4,7604,7617,7579,38,65,0,0,11,631,631,631,631
Plumas,25,2022-06-06,40,40,40,0,321,321,320,1,0,0,0,0,13,13,13,13
Riverside,25,2022-06-06,5350,5360,5341,19,55952,56043,55842,201,88,6,6,10,6485,6485,6479,6479
Sacramento,25,2022-06-06,4943,4952,4933,19,42456,42526,42361,165,149,14,14,20,3117,3117,3103,3103
San Benito,25,2022-06-06,272,272,271,1,2015,2019,2013,6,0,0,0,1,94,94,94,94
San Bernardino,25,2022-06-06,5117,5126,5111,15,55831,55924,55762,162,77,7,7,14,7854,7854,7847,7847
San Diego,25,2022-06-06,10782,10800,10787,13,100441,100608,100486,122,185,8,8,22,5375,5375,5367,5367
San Francisco,25,2022-06-06,3513,3520,3492,28,38208,38271,37966,305,77,0,0,11,906,906,906,906
San Joaquin,25,2022-06-06,2128,2132,2123,9,22143,22180,22086,94,40,4,4,9,2259,2259,2255,2255
San Luis Obispo,25,2022-06-06,900,900,897,3,7531,7544,7519,25,16,1,1,1,488,488,487,487
San Mateo,25,2022-06-06,3199,3205,3196,9,36962,37024,36924,100,36,2,2,4,719,719,717,717
Santa Barbara,25,2022-06-06,1246,1246,1241,5,15068,15092,15036,56,22,1,1,5,696,696,695,695
Santa Clara,25,2022-06-06,8489,8502,8491,11,102037,102205,102073,132,176,6,6,22,2349,2349,2343,2343
Santa Cruz,25,2022-06-06,896,896,893,3,9700,9716,9686,30,24,1,1,3,264,264,263,263
Shasta,25,2022-06-06,209,209,208,1,4425,4432,4415,17,10,2,2,2,568,568,566,566
Siskiyou,25,2022-06-06,39,39,39,0,431,431,430,1,1,0,0,0,83,83,83,83
Solano,25,2022-06-06,1729,1732,1726,6,15139,15165,15110,55,29,2,2,1,452,452,450,450
Sonoma,25,2022-06-06,1633,1633,1627,6,13987,14011,13962,49,38,1,1,1,499,499,498,498
Stanislaus,25,2022-06-06,1188,1188,1181,7,10911,10928,10867,61,60,1,1,2,1700,1700,1699,1699
Sutter,25,2022-06-06,206,206,205,1,1941,1943,1936,7,0,0,0,0,228,228,228,228
Tehama,25,2022-06-06,82,82,82,0,1051,1051,1045,6,2,0,0,0,207,207,207,207
Trinity,25,2022-06-06,7,7,7,0,110,110,109,1,0,0,0,0,20,20,20,20
Tulare,25,2022-06-06,860,860,855,5,10773,10791,10730,61,24,0,0,0,1497,1497,1497,1497
Tuolumne,25,2022-06-06,123,123,122,1,1723,1725,1717,8,4,0,0,1,191,191,191,191
Ventura,25,2022-06-06,1973,1976,1971,5,24758,24798,24737,61,43,3,3,3,1516,1516,1513,1513
Yolo,25,2022-06-06,821,821,818,3,21416,21452,21382,70,2,1,1,0,366,366,365,365
Yuba,25,2022-06-06,186,186,185,1,1556,1558,1553,5,9,0,0,1,119,119,119,119
Alameda,26,2022-06-13,5070,5078,5067,11,55761,55856,55731,125,106,4,4,18,1913,1913,1909,1909
Amador,26,2022-06-13,130,130,130,0,1413,1414,1409,5,1,0,0,0,87,87,87,87
Butte,26,2022-06-13,394,394,393,1,3459,3464,3458,6,31,4,4,0,442,442,438,438
Calaveras,26,2022-06-13,69,69,69,0,658,658,656,2,0,0,0,0,124,124,124,124
Colusa,26,2022-06-13,12,12,12,0,328,328,327,1,17,0,0,0,21,21,21,21
Contra Costa,26,2022-06-13,3408,3414,3401,13,27933,27981,27875,106,89,8,8,12,1350,1350,1342,1342
Del Norte,26,2022-06-13,79,79,79,0,658,658,656,2,4,0,0,0,51,51,51,51
El Dorado,26,2022-06-13,329,329,328,1,3200,3205,3195,10,7,3,3,1,221,221,218,218
Fresno,26,2022-06-13,2396,2401,2393,8,20694,20728,20655,73,103,4,4,13,2786,2786,2782,2782
Glenn,26,2022-06-13,32,32,32,0,329,329,328,1,2,0,0,0,53,53,53,53
Humboldt,26,2022-06-13,262,262,261,1,2325,2330,2323,7,11,0,0,3,150,150,150,150
Imperial,26,2022-06-13,444,444,443,1,4530,4536,4521,15,6,1,1,0,947,947,946,946
Inyo,26,2022-06-13,13,13,13,0,189,189,188,1,0,0,0,0,56,56,56,56
Kern,26,2022-06-13,1558,1558,1554,4,21421,21457,21401,56,38,1,1,5,2353,2353,2352,2352
Kings,26,2022-06-13,358,358,357,1,5158,5166,5150,16,4,1,1,0,448,448,447,447
Lake,26,2022-06-13,138,138,137,1,1227,1227,1223,4,1,0,0,0,140,140,140,140
Lassen,26,2022-06-13,77,77,77,0,1994,1997,1992,5,2,0,0,0,62,62,62,62
Los Angeles,26,2022-06-13,30015,30067,30040,27,660311,661435,660836,599,519,54,54,60,32168,32168,32114,32114
Madera,26,2022-06-13,380,380,379,1,4230,4237,4222,15,7,0,0,2,370,370,370,370
Marin,26,2022-06-13,684,684,682,2,7022,7034,7009,25,16,2,2,2,302,302,300,300
Mariposa,26,2022-06-13,45,45,45,0,372,372,371,1,0,0,0,0,28,28,28,28
Mendocino,26,2022-06-13,161,161,160,1,1567,1569,1561,8,9,0,0,1,130,130,130,130
Merced,26,2022-06-13,562,562,560,2,4169,4175,4164,11,13,0,0,2,828,828,828,828
Modoc,26,2022-06-13,7,7,7,0,34,35,34,1,1,1,1,0,8,8,7,7
Mono,26,2022-06-13,19,19,19,0,92,92,91,1,0,0,0,0,6,6,6,6
Monterey,26,2022-06-13,836,836,831,5,8642,8656,8607,49,25,3,3,1,741,741,738,738
Napa,26,2022-06-13,432,432,431,1,3929,3934,3925,9,2,1,1,1,145,145,144,144
Nevada,26,2022-06-13,186,186,185,1,1874,1877,1870,7,8,0,0,0,130,130,130,130
Orange,26,2022-06-13,6993,7005,6991,14,65077,65188,65052,136,175,14,14,19,7164,7164,7150,7150
Placer,26,2022-06-13,792,792,789,3,6801,6813,6787,26,79,2,2,7,633,633,631,631
Plumas,26,2022-06-13,34,34,34,0,271,271,270,1,0,0,0,0,13,13,13,13
Riverside,26,2022-06-13,5037,5045,5031,14,47824,47906,47772,134,105,3,3,11,6488,6488,6485,6485
Sacramento,26,2022-06-13,4174,4181,4168,13,37528,37592,37479,113,190,12,12,20,3129,3129,3117,3117
San Benito,26,2022-06-13,200,200,200,0,1780,1783,1779,4,1,0,0,1,94,94,94,94
San Bernardino,26,2022-06-13,4657,4665,4655,10,48689,48772,48662,110,96,6,6,15,7860,7860,7854,7854
San Diego,26,2022-06-13,9615,9632,9623,9,84880,85025,84945,80,192,9,9,27,5384,5384,5375,5375
San Francisco,26,2022-06-13,3034,3041,3022,19,31081,31134,30941,193,72,11,11,13,917,917,906,906
San Joaquin,26,2022-06-13,1913,1917,1911,6,18999,19032,18969,63,32,5,5,3,2264,2264,2259,2259
San Luis Obispo,26,2022-06-13,661,661,659,2,6049,6061,6046,15,21,0,0,0,488,488,488,488
San Mateo,26,2022-06-13,2630,2635,2630,5,29044,29093,29032,61,44,3,3,3,722,722,719,719
Santa Barbara,26,2022-06-13,931,931,928,3,9468,9484,9457,27,15,1,1,5,697,697,696,696
Santa Clara,26,2022-06-13,7022,7034,7027,7,76178,76308,76232,76,182,13,13,23,2362,2362,2349,2349
Santa Cruz,26,2022-06-13,843,843,841,2,9940,9957,9933,24,23,0,0,1,264,264,264,264
Shasta,26,2022-06-13,220,220,219,1,3390,3395,3385,10,8,1,1,0,569,569,568,568
Siskiyou,26,2022-06-13,50,50,50,0,372,372,371,1,1,0,0,0,83,83,83,83
Solano,26,2022-06-13,1676,1678,1673,5,12875,12897,12861,36,33,0,0,2,452,452,452,452
Sonoma,26,2022-06-13,1337,1337,1333,4,11646,11667,11635,32,36,3,3,6,502,502,499,499
Stanislaus,26,2022-06-13,1132,1132,1127,5,9449,9464,9423,41,63,1,1,7,1701,1701,1700,1700
Sutter,26,2022-06-13,194,194,193,1,1722,1724,1719,5,0,0,0,0,228,228,228,228
Tehama,26,2022-06-13,87,87,87,0,967,967,963,4,3,0,0,0,207,207,207,207
Trinity,26,2022-06-13,11,11,11,0,84,85,84,1,0,0,0,0,20,20,20,20
Tulare,26,2022-06-13,819,819,815,4,9449,9465,9423,42,26,2,2,1,1499,1499,1497,1497
Tuolumne,26,2022-06-13,147,147,146,1,1444,1445,1440,5,2,0,0,0,191,191,191,191
Ventura,26,2022-06-13,1934,1937,1933,4,20976,21012,20972,40,38,3,3,5,1519,1519,1516,1516
Yolo,26,2022-06-13,766,766,764,2,14234,14258,14221,37,4,1,1,0,367,367,366,366
Yuba,26,2022-06-13,188,188,187,1,1420,1420,1416,4,8,0,0,1,119,119,119,119
Alameda,27,2022-06-20,4943,4951,4942,9,48499,48584,48499,85,105,12,12,14,1925,1925,1913,1913
Amador,27,2022-06-20,104,104,104,0,1247,1247,1243,4,2,0,0,0,87,87,87,87
Butte,27,2022-06-20,413,413,412,1,3558,3563,3558,5,28,4,4,1,446,446,442,442
Calaveras,27,2022-06-20,82,82,82,0,624,624,622,2,0,0,0,0,124,124,124,124
Colusa,27,2022-06-20,17,17,17,0,176,177,176,1,15,1,1,0,22,22,21,21
Contra Costa,27,2022-06-20,3336,3343,3333,10,25978,26023,25946,77,81,7,7,8,1357,1357,1350,1350
Del Norte,27,2022-06-20,82,82,82,0,611,611,610,1,3,1,1,1,52,52,51,51
El Dorado,27,2022-06-20,351,351,350,1,3075,3080,3072,8,5,2,2,1,223,223,221,221
Fresno,27,2022-06-20,2466,2471,2464,7,19492,19526,19472,54,100,3,3,16,2789,2789,2786,2786
Glenn,27,2022-06-20,41,41,41,0,314,314,313,1,3,0,0,0,53,53,53,53
Humboldt,27,2022-06-20,272,272,271,1,2273,2278,2273,5,11,0,0,3,150,150,150,150
Imperial,27,2022-06-20,602,602,601,1,3692,3697,3688,9,5,0,0,0,947,947,947,947
Inyo,27,2022-06-20,18,18,18,0,187,188,187,1,0,0,0,0,56,56,56,56
Kern,27,2022-06-20,1647,1648,1645,3,20129,20164,20123,41,39,5,5,9,2358,2358,2353,2353
Kings,27,2022-06-20,413,413,412,1,4866,4875,4863,12,6,1,1,0,449,449,448,448
Lake,27,2022-06-20,120,120,120,0,1234,1234,1231,3,1,0,0,2,140,140,140,140
Lassen,27,2022-06-20,43,43,43,0,1223,1224,1222,2,1,0,0,0,62,62,62,62
Los Angeles,27,2022-06-20,27500,27548,27529,19,351343,351958,351714,244,596,57,57,68,32225,32225,32168,32168
Madera,27,2022-06-20,335,335,334,1,4163,4171,4159,12,4,0,0,1,370,370,370,370
Marin,27,2022-06-20,692,692,690,2,6317,6329,6312,17,21,0,0,1,302,302,302,302
Mariposa,27,2022-06-20,53,53,53,0,335,335,334,1,0,0,0,0,28,28,28,28
Mendocino,27,2022-06-20,179,179,178,1,1577,1579,1573,6,3,0,0,0,130,130,130,130
Merced,27,2022-06-20,541,541,540,1,3955,3961,3953,8,7,3,3,1,831,831,828,828
Modoc,27,2022-06-20,5,5,5,0,37,38,37,1,0,0,0,0,8,8,8,8
Mono,27,2022-06-20,6,6,6,0,82,83,82,1,1,1,1,0,7,7,6,6
Monterey,27,2022-06-20,894,894,890,4,8900,8916,8877,39,38,1,1,2,742,742,741,741
Napa,27,2022-06-20,364,364,363,1,3127,3132,3126,6,3,1,1,0,146,146,145,145
Nevada,27,2022-06-20,170,170,170,0,1619,1621,1617,4,6,1,1,0,131,131,130,130
Orange,27,2022-06-20,6966,6978,6967,11,60364,60470,60372,98,152,10,10,23,7174,7174,7164,7164
Placer,27,2022-06-20,671,671,669,2,6052,6064,6046,18,69,1,1,7,634,634,633,633
Plumas,27,2022-06-20,38,38,38,0,239,239,238,1,0,0,0,0,13,13,13,13
Riverside,27,2022-06-20,4954,4962,4951,11,43292,43369,43274,95,112,5,5,14,6493,6493,6488,6488
Sacramento,27,2022-06-20,3926,3933,3924,9,34800,34861,34779,82,171,12,12,21,3141,3141,3129,3129
San Benito,27,2022-06-20,172,172,172,0,1597,1599,1596,3,0,1,1,2,95,95,94,94
San Bernardino,27,2022-06-20,4507,4514,4506,8,46247,46327,46246,81,105,12,12,17,7872,7872,7860,7860
San Diego,27,2022-06-20,9688,9706,9699,7,77458,77594,77537,57,203,10,10,17,5394,5394,5384,5384
San Francisco,27,2022-06-20,3048,3055,3040,15,28246,28295,28158,137,72,12,12,14,929,929,917,917
San Joaquin,27,2022-06-20,1667,1668,1664,4,17891,17922,17876,46,38,5,5,6,2269,2269,2264,2264
San Luis Obispo,27,2022-06-20,596,596,595,1,5812,5823,5811,12,27,10,10,0,498,498,488,488
San Mateo,27,2022-06-20,2612,2618,2614,4,25825,25871,25829,42,42,2,2,1,724,724,722,722
Santa Barbara,27,2022-06-20,933,933,931,2,8161,8175,8157,18,33,2,2,6,699,699,697,697
Santa Clara,27,2022-06-20,6793,6805,6800,5,62879,62990,62941,49,170,8,8,21,2370,2370,2362,2362
Santa Cruz,27,2022-06-20,818,818,816,2,9114,9131,9114,17,19,1,1,2,265,265,264,264
Shasta,27,2022-06-20,240,240,239,1,3372,3378,3370,8,9,1,1,1,570,570,569,569
Siskiyou,27,2022-06-20,61,61,61,0,394,394,393,1,5,1,1,0,84,84,83,83
Solano,27,2022-06-20,1409,1409,1406,3,11440,11462,11437,25,41,0,0,5,452,452,452,452
Sonoma,27,2022-06-20,1401,1401,1398,3,10790,10809,10786,23,28,1,1,3,503,503,502,502
Stanislaus,27,2022-06-20,1040,1040,1036,4,8832,8847,8817,30,70,6,6,7,1707,1707,1701,1701
Sutter,27,2022-06-20,196,196,196,0,1858,1860,1856,4,0,0,0,0,228,228,228,228
Tehama,27,2022-06-20,98,98,98,0,889,889,886,3,3,0,0,0,207,207,207,207
Trinity,27,2022-06-20,10,10,10,0,106,107,106,1,0,0,0,0,20,20,20,20
Tulare,27,2022-06-20,883,883,880,3,8725,8740,8710,30,32,8,8,0,1507,1507,1499,1499
Tuolumne,27,2022-06-20,141,141,141,0,1554,1556,1552,4,3,0,0,1,191,191,191,191
Ventura,27,2022-06-20,1835,1838,1835,3,18660,18694,18666,28,50,1,1,7,1520,1520,1519,1519
Yolo,27,2022-06-20,678,678,677,1,10553,10571,10550,21,1,2,2,2,369,369,367,367
Yuba,27,2022-06-20,149,149,149,0,1339,1339,1336,3,13,0,0,5,119,119,119,119
Alameda,28,2022-06-27,5455,5464,5457,7,48137,48223,48157,66,124,8,8,16,1933,1933,1925,1925
Amador,28,2022-06-27,88,88,88,0,1149,1149,1146,3,3,0,0,1,87,87,87,87
Butte,28,2022-06-27,410,410,410,0,3468,3473,3469,4,30,2,2,0,448,448,446,446
Calaveras,28,2022-06-27,68,68,68,0,570,570,569,1,1,2,2,0,126,126,124,124
Colusa,28,2022-06-27,28,28,28,0,282,283,282,1,6,0,0,0,22,22,22,22
Contra Costa,28,2022-06-27,3521,3528,3520,8,25880,25926,25867,59,82,11,11,7,1368,1368,1357,1357
Del Norte,28,2022-06-27,140,140,140,0,669,669,668,1,5,1,1,2,53,53,52,52
El Dorado,28,2022-06-27,432,432,431,1,3362,3367,3361,6,5,0,0,1,223,223,223,223
Fresno,28,2022-06-27,2815,2821,2815,6,19934,19970,19927,43,136,2,2,17,2791,2791,2789,2789
Glenn,28,2022-06-27,28,28,28,0,296,296,295,1,1,0,0,0,53,53,53,53
Humboldt,28,2022-06-27,261,261,261,0,2189,2194,2190,4,10,1,1,2,151,151,150,150
Imperial,28,2022-06-27,702,702,701,1,4017,4023,4015,8,7,0,0,4,947,947,947,947
Inyo,28,2022-06-27,32,32,32,0,311,311,310,1,1,0,0,0,56,56,56,56
Kern,28,2022-06-27,1813,1817,1814,3,17277,17310,17282,28,52,7,7,8,2365,2365,2358,2358
Kings,28,2022-06-27,468,468,467,1,3931,3938,3930,8,9,0,0,0,449,449,449,449
Lake,28,2022-06-27,121,121,121,0,1139,1140,1137,3,2,0,0,0,140,140,140,140
Lassen,28,2022-06-27,51,51,51,0,848,848,847,1,1,0,0,0,62,62,62,62
Los Angeles,28,2022-06-27,32728,32787,32769,18,364230,364886,364689,197,679,73,73,68,32298,32298,32225,32225
Madera,28,2022-06-27,413,413,412,1,4286,4295,4286,9,8,0,0,0,370,370,370,370
Marin,28,2022-06-27,659,659,658,1,6226,6238,6225,13,20,1,1,2,303,303,302,302
Mariposa,28,2022-06-27,55,55,55,0,310,310,309,1,0,0,0,0,28,28,28,28
Mendocino,28,2022-06-27,153,153,153,0,1447,1448,1444,4,5,1,1,1,131,131,130,130
Merced,28,2022-06-27,615,615,614,1,4034,4040,4033,7,14,2,2,0,833,833,831,831
Modoc,28,2022-06-27,7,7,7,0,32,33,32,1,0,0,0,0,8,8,8,8
Mono,28,2022-06-27,24,24,24,0,109,110,109,1,1,0,0,0,7,7,7,7
Monterey,28,2022-06-27,933,933,930,3,8267,8282,8254,28,44,2,2,3,744,744,742,742
Napa,28,2022-06-27,391,391,390,1,3311,3316,3311,5,3,2,2,1,148,148,146,146
Nevada,28,2022-06-27,189,189,189,0,1619,1621,1618,3,4,0,0,3,131,131,131,131
Orange,28,2022-06-27,7530,7543,7534,9,59226,59333,59258,75,183,16,16,26,7190,7190,7174,7174
Placer,28,2022-06-27,806,806,804,2,6181,6193,6178,15,79,6,6,6,640,640,634,634
Plumas,28,2022-06-27,50,50,50,0,257,257,256,1,1,0,0,0,13,13,13,13
Riverside,28,2022-06-27,6181,6193,6183,10,44923,45004,44928,76,141,11,11,17,6504,6504,6493,6493
Sacramento,28,2022-06-27,4159,4167,4159,8,35261,35323,35258,65,173,9,9,25,3150,3150,3141,3141
San Benito,28,2022-06-27,221,221,221,0,1655,1658,1656,2,0,0,0,1,95,95,95,95
San Bernardino,28,2022-06-27,5721,5730,5722,8,48812,48900,48833,67,130,12,12,24,7884,7884,7872,7872
San Diego,28,2022-06-27,10867,10888,10882,6,80581,80728,80682,46,264,8,8,28,5402,5402,5394,5394
San Francisco,28,2022-06-27,3272,3279,3267,12,29201,29254,29144,110,92,5,5,23,934,934,929,929
San Joaquin,28,2022-06-27,1890,1894,1890,4,17960,17991,17955,36,46,2,2,5,2271,2271,2269,2269
San Luis Obispo,28,2022-06-27,645,645,644,1,5644,5655,5646,9,25,3,3,0,501,501,498,498
San Mateo,28,2022-06-27,2875,2882,2878,4,26805,26853,26819,34,36,1,1,2,725,725,724,724
Santa Barbara,28,2022-06-27,1145,1145,1143,2,9771,9788,9771,17,26,2,2,2,701,701,699,699
Santa Clara,28,2022-06-27,7522,7537,7532,5,60812,60920,60883,37,213,11,11,19,2381,2381,2370,2370
Santa Cruz,28,2022-06-27,861,861,860,1,9146,9163,9149,14,26,2,2,1,267,267,265,265
Shasta,28,2022-06-27,338,338,337,1,3309,3315,3309,6,21,0,0,4,570,570,570,570
Siskiyou,28,2022-06-27,63,63,63,0,355,355,354,1,2,1,1,0,85,85,84,84
Solano,28,2022-06-27,1594,1595,1592,3,12985,13008,12986,22,47,0,0,4,452,452,452,452
Sonoma,28,2022-06-27,1367,1367,1365,2,10095,10114,10097,17,33,2,2,3,505,505,503,503
Stanislaus,28,2022-06-27,1211,1211,1208,3,8582,8597,8574,23,96,2,2,6,1709,1709,1707,1707
Sutter,28,2022-06-27,197,197,197,0,1843,1845,1842,3,0,0,0,0,228,228,228,228
Tehama,28,2022-06-27,91,91,91,0,888,888,886,2,3,0,0,0,207,207,207,207
Trinity,28,2022-06-27,24,24,24,0,142,143,142,1,1,0,0,0,20,20,20,20
Tulare,28,2022-06-27,909,909,907,2,7882,7897,7876,21,35,0,0,2,1507,1507,1507,1507
Tuolumne,28,2022-06-27,171,171,171,0,1404,1405,1402,3,1,4,4,1,195,195,191,191
Ventura,28,2022-06-27,2090,2095,2093,2,18527,18560,18538,22,61,3,3,1,1523,1523,1520,1520
Yolo,28,2022-06-27,786,786,785,1,11207,11227,11210,17,8,0,0,1,369,369,369,369
Yuba,28,2022-06-27,171,171,171,0,1434,1435,1433,2,10,2,2,2,121,121,119,119
Alameda,29,2022-07-04,4820,4830,4825,5,38600,38673,38631,42,128,11,11,10,1944,1944,1933,1933
Amador,29,2022-07-04,66,66,66,0,1534,1536,1533,3,3,1,1,1,88,88,87,87
Butte,29,2022-07-04,284,284,284,0,2489,2493,2491,2,28,2,2,1,450,450,448,448
Calaveras,29,2022-07-04,82,82,82,0,487,487,486,1,0,2,2,0,128,128,126,126
Colusa,29,2022-07-04,21,21,21,0,150,151,150,1,4,0,0,0,22,22,22,22
Contra Costa,29,2022-07-04,3319,3326,3320,6,20837,20876,20838,38,76,10,10,12,1378,1378,1368,1368
Del Norte,29,2022-07-04,138,138,138,0,587,587,586,1,3,0,0,0,53,53,53,53
El Dorado,29,2022-07-04,307,307,307,0,2392,2396,2392,4,10,1,1,0,224,224,223,223
Fresno,29,2022-07-04,2461,2466,2462,4,15669,15698,15671,27,158,6,6,17,2797,2797,2791,2791
Glenn,29,2022-07-04,24,24,24,0,157,158,157,1,1,0,0,0,53,53,53,53
Humboldt,29,2022-07-04,188,188,188,0,1584,1588,1586,2,12,2,2,3,153,153,151,151
Imperial,29,2022-07-04,697,697,696,1,3234,3239,3234,5,8,1,1,3,948,948,947,947
Inyo,29,2022-07-04,41,41,41,0,292,293,292,1,1,0,0,0,56,56,56,56
Kern,29,2022-07-04,1757,1761,1759,2,14149,14176,14158,18,63,4,4,9,2369,2369,2365,2365
Kings,29,2022-07-04,437,437,436,1,3446,3451,3446,5,5,0,0,0,449,449,449,449
Lake,29,2022-07-04,107,107,107,0,790,790,789,1,3,2,2,0,142,142,140,140
Lassen,29,2022-07-04,31,31,31,0,640,640,639,1,2,0,0,0,62,62,62,62
Los Angeles,29,2022-07-04,32234,32294,32280,14,285760,286296,286173,123,801,88,88,85,32386,32386,32298,32298
Madera,29,2022-07-04,341,341,340,1,3179,3184,3178,6,9,0,0,1,370,370,370,370
Marin,29,2022-07-04,608,608,607,1,5159,5170,5161,9,25,1,1,2,304,304,303,303
Mariposa,29,2022-07-04,36,36,36,0,222,223,222,1,0,0,0,0,28,28,28,28
Mendocino,29,2022-07-04,164,164,164,0,1119,1120,1117,3,6,2,2,1,133,133,131,131
Merced,29,2022-07-04,595,595,594,1,2918,2922,2918,4,14,2,2,1,835,835,833,833
Modoc,29,2022-07-04,10,10,10,0,31,32,31,1,0,0,0,0,8,8,8,8
Mono,29,2022-07-04,22,22,22,0,81,82,81,1,1,0,0,0,7,7,7,7
Monterey,29,2022-07-04,842,842,840,2,6313,6324,6307,17,39,2,2,4,746,746,744,744
Napa,29,2022-07-04,340,340,340,0,2554,2558,2555,3,13,0,0,1,148,148,148,148
Nevada,29,2022-07-04,177,177,177,0,1268,1269,1267,2,5,0,0,1,131,131,131,131
Orange,29,2022-07-04,6953,6966,6959,7,50651,50746,50695,51,203,25,25,34,7215,7215,7190,7190
Placer,29,2022-07-04,806,806,805,1,5048,5059,5050,9,72,3,3,6,643,643,640,640
Plumas,29,2022-07-04,31,31,31,0,172,173,172,1,0,0,0,0,13,13,13,13
Riverside,29,2022-07-04,6384,6395,6386,9,38507,38579,38527,52,137,5,5,8,6509,6509,6504,6504
Sacramento,29,2022-07-04,3576,3583,3578,5,26523,26572,26533,39,163,19,19,22,3169,3169,3150,3150
San Benito,29,2022-07-04,210,210,210,0,1273,1275,1273,2,3,0,0,0,95,95,95,95
San Bernardino,29,2022-07-04,6058,6069,6062,7,41589,41668,41623,45,147,12,12,26,7896,7896,7884,7884
San Diego,29,2022-07-04,9596,9614,9610,4,65453,65576,65546,30,262,10,10,43,5412,5412,5402,5402
San Francisco,29,2022-07-04,2897,2904,2895,9,24122,24167,24095,72,100,11,11,18,945,945,934,934
San Joaquin,29,2022-07-04,1677,1681,1678,3,14658,14686,14663,23,41,5,5,4,2276,2276,2271,2271
San Luis Obispo,29,2022-07-04,616,616,615,1,4165,4173,4168,5,24,0,0,0,501,501,501,501
San Mateo,29,2022-07-04,2590,2596,2593,3,21461,21501,21479,22,39,1,1,3,726,726,725,725
Santa Barbara,29,2022-07-04,1057,1057,1056,1,7649,7664,7653,11,26,4,4,4,705,705,701,701
Santa Clara,29,2022-07-04,6802,6814,6811,3,49998,50090,50066,24,191,16,16,34,2397,2397,2381,2381
Santa Cruz,29,2022-07-04,732,732,731,1,7123,7138,7130,8,22,0,0,0,267,267,267,267
Shasta,29,2022-07-04,280,280,280,0,2396,2400,2396,4,15,5,5,3,575,575,570,570
Siskiyou,29,2022-07-04,34,34,34,0,326,327,326,1,1,0,0,1,85,85,85,85
Solano,29,2022-07-04,1336,1338,1336,2,9819,9837,9824,13,50,0,0,5,452,452,452,452
Sonoma,29,2022-07-04,1084,1084,1083,1,8088,8103,8092,11,35,2,2,1,507,507,505,505
Stanislaus,29,2022-07-04,1168,1168,1166,2,6989,7001,6986,15,84,7,7,16,1716,1716,1709,1709
Sutter,29,2022-07-04,230,230,230,0,1671,1673,1671,2,0,0,0,0,228,228,228,228
Tehama,29,2022-07-04,132,132,132,0,821,821,819,2,3,1,1,0,208,208,207,207
Trinity,29,2022-07-04,17,17,17,0,143,144,143,1,2,0,0,0,20,20,20,20
Tulare,29,2022-07-04,940,940,938,2,6098,6111,6098,13,40,4,4,1,1511,1511,1507,1507
Tuolumne,29,2022-07-04,164,164,164,0,937,938,936,2,8,0,0,1,195,195,195,195
Ventura,29,2022-07-04,1948,1952,1950,2,15405,15434,15420,14,66,2,2,8,1525,1525,1523,1523
Yolo,29,2022-07-04,533,533,532,1,7182,7194,7185,9,6,3,3,2,372,372,369,369
Yuba,29,2022-07-04,168,168,168,0,1078,1078,1077,1,9,0,0,1,121,121,121,121
Alameda,30,2022-07-11,5787,5799,5794,5,48236,48332,48292,40,119,8,8,16,1952,1952,1944,1944
Amador,30,2022-07-11,91,91,91,0,1504,1507,1505,2,2,0,0,0,88,88,88,88
Butte,30,2022-07-11,498,498,498,0,3298,3303,3301,2,27,1,1,4,451,451,450,450
Calaveras,30,2022-07-11,78,78,78,0,566,566,565,1,0,1,1,1,129,129,128,128
Colusa,30,2022-07-11,26,26,26,0,483,484,483,1,0,0,0,0,22,22,22,22
Contra Costa,30,2022-07-11,3680,3687,3682,5,26527,26581,26544,37,91,11,11,11,1389,1389,1378,1378
Del Norte,30,2022-07-11,174,174,174,0,677,677,676,1,5,0,0,1,53,53,53,53
El Dorado,30,2022-07-11,383,383,383,0,3151,3157,3153,4,12,1,1,3,225,225,224,224
Fresno,30,2022-07-11,3658,3665,3660,5,21578,21620,21592,28,161,7,7,14,2804,2804,2797,2797
Glenn,30,2022-07-11,45,45,45,0,382,383,382,1,0,0,0,0,53,53,53,53
Humboldt,30,2022-07-11,291,291,291,0,2189,2194,2192,2,11,1,1,2,154,154,153,153
Imperial,30,2022-07-11,1114,1114,1113,1,4746,4755,4749,6,14,1,1,1,949,949,948,948
Inyo,30,2022-07-11,38,38,38,0,389,390,389,1,0,1,1,0,57,57,56,56
Kern,30,2022-07-11,2452,2457,2455,2,16952,16986,16970,16,77,2,2,9,2371,2371,2369,2369
Kings,30,2022-07-11,730,730,729,1,4341,4349,4344,5,11,3,3,0,452,452,449,449
Lake,30,2022-07-11,126,126,126,0,1115,1115,1113,2,0,0,0,0,142,142,142,142
Lassen,30,2022-07-11,59,59,59,0,821,821,820,1,2,1,1,0,63,63,62,62
Los Angeles,30,2022-07-11,43287,43374,43360,14,381122,381877,381751,126,1038,88,88,115,32474,32474,32386,32386
Madera,30,2022-07-11,532,532,531,1,4126,4134,4128,6,15,0,0,3,370,370,370,370
Marin,30,2022-07-11,603,603,602,1,5926,5938,5930,8,17,1,1,1,305,305,304,304
Mariposa,30,2022-07-11,52,52,52,0,283,284,283,1,0,0,0,0,28,28,28,28
Mendocino,30,2022-07-11,189,189,189,0,1387,1388,1386,2,4,0,0,0,133,133,133,133
Merced,30,2022-07-11,761,761,760,1,4272,4279,4275,4,16,5,5,1,840,840,835,835
Modoc,30,2022-07-11,28,28,28,0,57,58,57,1,0,0,0,0,8,8,8,8
Mono,30,2022-07-11,11,11,11,0,105,106,105,1,0,0,0,0,7,7,7,7
Monterey,30,2022-07-11,1095,1095,1093,2,7945,7961,7944,17,47,5,5,3,751,751,746,746
Napa,30,2022-07-11,367,367,367,0,3660,3666,3663,3,13,1,1,1,149,149,148,148
Nevada,30,2022-07-11,221,221,221,0,1826,1831,1829,2,7,0,0,1,131,131,131,131
Orange,30,2022-07-11,9721,9740,9733,7,64133,64259,64209,50,257,20,20,30,7235,7235,7215,7215
Placer,30,2022-07-11,785,785,784,1,5963,5975,5966,9,76,2,2,8,645,645,643,643
Plumas,30,2022-07-11,71,71,71,0,282,283,282,1,0,0,0,0,13,13,13,13
Riverside,30,2022-07-11,9198,9217,9208,9,52053,52157,52103,54,225,17,17,12,6526,6526,6509,6509
Sacramento,30,2022-07-11,4198,4206,4201,5,35508,35579,35539,40,184,21,21,24,3190,3190,3169,3169
San Benito,30,2022-07-11,235,235,235,0,1666,1669,1667,2,1,0,0,0,95,95,95,95
San Bernardino,30,2022-07-11,8424,8441,8434,7,57661,57776,57728,48,188,14,14,20,7910,7910,7896,7896
San Diego,30,2022-07-11,13663,13691,13686,5,85543,85711,85681,30,332,10,10,41,5422,5422,5412,5412
San Francisco,30,2022-07-11,2989,2995,2988,7,27802,27857,27793,64,105,11,11,23,956,956,945,945
San Joaquin,30,2022-07-11,2133,2138,2135,3,19349,19386,19362,24,55,7,7,11,2283,2283,2276,2276
San Luis Obispo,30,2022-07-11,753,753,752,1,5271,5283,5278,5,22,3,3,1,504,504,501,501
San Mateo,30,2022-07-11,2769,2775,2773,2,25574,25624,25604,20,42,6,6,4,732,732,726,726
Santa Barbara,30,2022-07-11,1326,1326,1325,1,9700,9719,9709,10,46,5,5,9,710,710,705,705
Santa Clara,30,2022-07-11,7404,7418,7415,3,59696,59814,59792,22,211,12,12,38,2409,2409,2397,2397
Santa Cruz,30,2022-07-11,1027,1027,1026,1,9507,9526,9517,9,16,0,0,0,267,267,267,267
Shasta,30,2022-07-11,327,327,327,0,3565,3572,3568,4,21,2,2,6,577,577,575,575
Siskiyou,30,2022-07-11,29,29,29,0,361,362,361,1,1,1,1,1,86,86,85,85
Solano,30,2022-07-11,1617,1622,1620,2,11632,11655,11643,12,40,1,1,6,453,453,452,452
Sonoma,30,2022-07-11,1296,1297,1296,1,9941,9961,9951,10,50,0,0,7,507,507,507,507
Stanislaus,30,2022-07-11,1495,1496,1494,2,8685,8702,8688,14,103,7,7,11,1723,1723,1716,1716
Sutter,30,2022-07-11,287,287,287,0,1777,1781,1779,2,0,0,0,0,228,228,228,228
Tehama,30,2022-07-11,134,134,134,0,925,925,924,1,5,0,0,1,208,208,208,208
Trinity,30,2022-07-11,35,35,35,0,120,121,120,1,0,0,0,0,20,20,20,20
Tulare,30,2022-07-11,1382,1383,1381,2,9558,9578,9562,16,47,4,4,2,1515,1515,1511,1511
Tuolumne,30,2022-07-11,250,250,250,0,1303,1305,1303,2,6,0,0,0,195,195,195,195
Ventura,30,2022-07-11,2549,2555,2553,2,19713,19752,19738,14,89,9,9,6,1534,1534,1525,1525
Yolo,30,2022-07-11,500,500,500,0,5412,5424,5419,5,4,3,3,4,375,375,372,372
Yuba,30,2022-07-11,218,218,218,0,1404,1405,1404,1,9,0,0,1,121,121,121,121
Alameda,31,2022-07-18,4927,4938,4935,3,42845,42935,42907,28,149,9,9,25,1961,1961,1952,1952
Amador,31,2022-07-18,85,85,85,0,1348,1350,1349,1,6,0,0,1,88,88,88,88
Butte,31,2022-07-18,334,334,334,0,2794,2799,2798,1,25,1,1,3,452,452,451,451
Calaveras,31,2022-07-18,78,78,78,0,545,546,545,1,0,0,0,0,129,129,129,129
Colusa,31,2022-07-18,23,23,23,0,349,350,349,1,2,0,0,0,22,22,22,22
Contra Costa,31,2022-07-18,3052,3059,3056,3,22692,22740,22715,25,88,4,4,16,1393,1393,1389,1389
Del Norte,31,2022-07-18,167,167,167,0,705,705,704,1,7,0,0,0,53,53,53,53
El Dorado,31,2022-07-18,279,279,279,0,2637,2642,2640,2,11,1,1,1,226,226,225,225
Fresno,31,2022-07-18,3690,3697,3693,4,21118,21162,21140,22,199,9,9,15,2813,2813,2804,2804
Glenn,31,2022-07-18,34,34,34,0,263,264,263,1,0,0,0,0,53,53,53,53
Humboldt,31,2022-07-18,293,293,293,0,2024,2029,2027,2,10,0,0,4,154,154,154,154
Imperial,31,2022-07-18,1021,1021,1020,1,4434,4445,4441,4,18,2,2,3,951,951,949,949
Inyo,31,2022-07-18,30,30,30,0,331,332,331,1,0,0,0,0,57,57,57,57
Kern,31,2022-07-18,2290,2295,2293,2,16469,16503,16491,12,72,9,9,14,2380,2380,2371,2371
Kings,31,2022-07-18,705,705,704,1,4156,4165,4161,4,16,1,1,0,453,453,452,452
Lake,31,2022-07-18,132,132,132,0,993,994,993,1,3,0,0,0,142,142,142,142
Lassen,31,2022-07-18,77,77,77,0,1238,1240,1239,1,1,0,0,0,63,63,63,63
Los Angeles,31,2022-07-18,41799,41887,41876,11,352116,352849,352759,90,1162,113,113,137,32587,32587,32474,32474
Madera,31,2022-07-18,528,528,527,1,3632,3639,3635,4,5,0,0,3,370,370,370,370
Marin,31,2022-07-18,516,516,515,1,5500,5512,5506,6,12,1,1,5,306,306,305,305
Mariposa,31,2022-07-18,42,42,42,0,242,243,242,1,0,1,1,0,29,29,28,28
Mendocino,31,2022-07-18,185,185,185,0,1491,1494,1492,2,6,0,0,2,133,133,133,133
Merced,31,2022-07-18,751,751,750,1,3981,3989,3986,3,15,1,1,1,841,841,840,840
Modoc,31,2022-07-18,13,13,13,0,34,35,34,1,1,0,0,0,8,8,8,8
Mono,31,2022-07-18,10,10,10,0,85,86,85,1,1,0,0,0,7,7,7,7
Monterey,31,2022-07-18,983,983,981,2,7188,7202,7190,12,46,6,6,4,757,757,751,751
Napa,31,2022-07-18,318,318,318,0,2953,2958,2956,2,10,2,2,2,151,151,149,149
Nevada,31,2022-07-18,135,135,135,0,1330,1331,1330,1,8,0,0,3,131,131,131,131
Orange,31,2022-07-18,8780,8799,8794,5,59760,59884,59848,36,253,24,24,45,7259,7259,7235,7235
Placer,31,2022-07-18,684,684,683,1,5240,5252,5246,6,89,1,1,5,646,646,645,645
Plumas,31,2022-07-18,60,60,60,0,279,280,279,1,0,0,0,0,13,13,13,13
Riverside,31,2022-07-18,8244,8263,8256,7,48065,48165,48126,39,222,16,16,17,6542,6542,6526,6526
Sacramento,31,2022-07-18,3536,3543,3540,3,30401,30464,30438,26,180,12,12,26,3202,3202,3190,3190
San Benito,31,2022-07-18,198,198,198,0,1586,1590,1589,1,1,1,1,0,96,96,95,95
San Bernardino,31,2022-07-18,7964,7981,7976,5,53729,53839,53804,35,214,13,13,35,7923,7923,7910,7910
San Diego,31,2022-07-18,13071,13099,13095,4,79845,80012,79990,22,402,18,18,52,5440,5440,5422,5422
San Francisco,31,2022-07-18,2483,2489,2485,4,25466,25518,25473,45,111,10,10,24,966,966,956,956
San Joaquin,31,2022-07-18,2044,2049,2047,2,18029,18066,18049,17,66,2,2,11,2285,2285,2283,2283
San Luis Obispo,31,2022-07-18,559,559,559,0,4628,4638,4635,3,17,3,3,1,507,507,504,504
San Mateo,31,2022-07-18,2284,2290,2289,1,23030,23079,23065,14,33,0,0,4,732,732,732,732
Santa Barbara,31,2022-07-18,1296,1297,1296,1,9269,9288,9280,8,47,1,1,6,711,711,710,710
Santa Clara,31,2022-07-18,6208,6220,6218,2,54215,54327,54311,16,199,12,12,30,2421,2421,2409,2409
Santa Cruz,31,2022-07-18,874,874,873,1,7443,7460,7455,5,24,1,1,2,268,268,267,267
Shasta,31,2022-07-18,323,323,323,0,3213,3219,3216,3,40,3,3,3,580,580,577,577
Siskiyou,31,2022-07-18,34,34,34,0,345,346,345,1,3,0,0,0,86,86,86,86
Solano,31,2022-07-18,1236,1236,1235,1,9514,9535,9527,8,49,1,1,6,454,454,453,453
Sonoma,31,2022-07-18,1052,1052,1051,1,8741,8760,8753,7,44,0,0,5,507,507,507,507
Stanislaus,31,2022-07-18,1401,1403,1401,2,8395,8413,8402,11,109,5,5,9,1728,1728,1723,1723
Sutter,31,2022-07-18,251,251,251,0,1673,1676,1675,1,0,0,0,0,228,228,228,228
Tehama,31,2022-07-18,110,110,110,0,896,896,895,1,7,1,1,0,209,209,208,208
Trinity,31,2022-07-18,20,20,20,0,111,112,111,1,1,0,0,0,20,20,20,20
Tulare,31,2022-07-18,1181,1181,1180,1,8086,8102,8092,10,45,0,0,0,1515,1515,1515,1515
Tuolumne,31,2022-07-18,239,239,239,0,1142,1143,1142,1,7,4,4,0,199,199,195,195
Ventura,31,2022-07-18,2325,2330,2329,1,19561,19602,19591,11,92,3,3,7,1537,1537,1534,1534
Yolo,31,2022-07-18,430,430,430,0,4643,4652,4649,3,2,3,3,1,378,378,375,375
Yuba,31,2022-07-18,213,213,213,0,1292,1294,1293,1,18,0,0,0,121,121,121,121
Alameda,32,2022-07-25,4398,4407,4405,2,40374,40463,40443,20,143,12,12,19,1973,1973,1961,1961
Amador,32,2022-07-25,89,89,89,0,1206,1207,1206,1,3,0,0,1,88,88,88,88
Butte,32,2022-07-25,359,359,359,0,2945,2950,2949,1,30,1,1,2,453,453,452,452
Calaveras,32,2022-07-25,82,82,82,0,558,559,558,1,0,2,2,1,131,131,129,129
Colusa,32,2022-07-25,26,26,26,0,373,374,373,1,1,0,0,0,22,22,22,22
Contra Costa,32,2022-07-25,2819,2826,2824,2,21948,21995,21976,19,102,6,6,18,1399,1399,1393,1393
Del Norte,32,2022-07-25,66,66,66,0,534,535,534,1,6,0,0,0,53,53,53,53
El Dorado,32,2022-07-25,273,273,273,0,2487,2492,2490,2,9,1,1,0,227,227,226,226
Fresno,32,2022-07-25,3352,3358,3355,3,20396,20440,20424,16,195,6,6,29,2819,2819,2813,2813
Glenn,32,2022-07-25,31,31,31,0,271,272,271,1,0,0,0,0,53,53,53,53
Humboldt,32,2022-07-25,230,230,230,0,1923,1928,1927,1,13,2,2,4,156,156,154,154
Imperial,32,2022-07-25,873,873,872,1,4341,4351,4348,3,18,1,1,6,952,952,951,951
Inyo,32,2022-07-25,18,18,18,0,284,285,284,1,2,1,1,0,58,58,57,57
Kern,32,2022-07-25,1897,1902,1901,1,14987,15020,15011,9,82,3,3,12,2383,2383,2380,2380
Kings,32,2022-07-25,572,572,572,0,3888,3896,3893,3,15,1,1,0,454,454,453,453
Lake,32,2022-07-25,128,128,128,0,1041,1042,1041,1,5,1,1,2,143,143,142,142
Lassen,32,2022-07-25,52,52,52,0,1070,1071,1070,1,1,0,0,0,63,63,63,63
Los Angeles,32,2022-07-25,37098,37178,37171,7,334145,334871,334804,67,1152,120,120,134,32707,32707,32587,32587
Madera,32,2022-07-25,538,538,538,0,3828,3836,3833,3,11,1,1,5,371,371,370,370
Marin,32,2022-07-25,488,488,488,0,5411,5423,5419,4,26,2,2,2,308,308,306,306
Mariposa,32,2022-07-25,40,40,40,0,232,233,232,1,0,0,0,0,29,29,29,29
Mendocino,32,2022-07-25,196,196,196,0,1426,1428,1426,2,6,0,0,0,133,133,133,133
Merced,32,2022-07-25,730,730,730,0,3904,3912,3910,2,22,2,2,2,843,843,841,841
Modoc,32,2022-07-25,5,5,5,0,28,29,28,1,0,1,1,0,9,9,8,8
Mono,32,2022-07-25,15,15,15,0,84,85,84,1,0,0,0,0,7,7,7,7
Monterey,32,2022-07-25,932,932,931,1,7128,7143,7134,9,39,1,1,3,758,758,757,757
Napa,32,2022-07-25,296,296,296,0,2930,2935,2933,2,6,3,3,0,154,154,151,151
Nevada,32,2022-07-25,116,116,116,0,1316,1318,1317,1,3,1,1,0,132,132,131,131
Orange,32,2022-07-25,7990,8008,8004,4,58125,58252,58225,27,306,37,37,35,7296,7296,7259,7259
Placer,32,2022-07-25,604,604,603,1,5086,5099,5095,4,77,5,5,11,651,651,646,646
Plumas,32,2022-07-25,25,25,25,0,188,189,188,1,0,0,0,0,13,13,13,13
Riverside,32,2022-07-25,7501,7518,7513,5,45924,46025,45996,29,259,16,16,27,6558,6558,6542,6542
Sacramento,32,2022-07-25,3627,3635,3633,2,29830,29894,29874,20,207,18,18,32,3220,3220,3202,3202
San Benito,32,2022-07-25,198,198,198,0,1396,1399,1398,1,0,1,1,0,97,97,96,96
San Bernardino,32,2022-07-25,7079,7093,7089,4,52122,52236,52210,26,214,30,30,23,7953,7953,7923,7923
San Diego,32,2022-07-25,11883,11909,11906,3,76163,76329,76313,16,393,17,17,41,5457,5457,5440,5440
San Francisco,32,2022-07-25,2288,2293,2290,3,24222,24273,24239,34,126,9,9,24,975,975,966,966
San Joaquin,32,2022-07-25,1835,1840,1839,1,16570,16605,16593,12,73,5,5,9,2290,2290,2285,2285
San Luis Obispo,32,2022-07-25,538,538,538,0,4382,4391,4388,3,16,4,4,1,511,511,507,507
San Mateo,32,2022-07-25,2008,2014,2013,1,21584,21631,21621,10,57,1,1,7,733,733,732,732
Santa Barbara,32,2022-07-25,1177,1178,1177,1,8769,8787,8781,6,37,4,4,3,715,715,711,711
Santa Clara,32,2022-07-25,5796,5808,5807,1,50449,50558,50547,11,238,16,16,26,2437,2437,2421,2421
Santa Cruz,32,2022-07-25,832,832,832,0,7653,7670,7666,4,23,0,0,0,268,268,268,268
Shasta,32,2022-07-25,306,306,306,0,3080,3087,3085,2,38,2,2,6,582,582,580,580
Siskiyou,32,2022-07-25,36,36,36,0,333,334,333,1,1,0,0,0,86,86,86,86
Solano,32,2022-07-25,1197,1198,1197,1,9461,9482,9476,6,56,0,0,5,454,454,454,454
Sonoma,32,2022-07-25,1065,1065,1064,1,8648,8668,8663,5,48,2,2,4,509,509,507,507
Stanislaus,32,2022-07-25,1379,1381,1380,1,8156,8174,8166,8,104,8,8,11,1736,1736,1728,1728
Sutter,32,2022-07-25,222,222,222,0,1721,1724,1723,1,0,0,0,0,228,228,228,228
Tehama,32,2022-07-25,103,103,103,0,920,920,919,1,5,2,2,0,211,211,209,209
Trinity,32,2022-07-25,12,12,12,0,102,103,102,1,0,0,0,0,20,20,20,20
Tulare,32,2022-07-25,1140,1140,1139,1,8016,8035,8027,8,42,2,2,2,1517,1517,1515,1515
Tuolumne,32,2022-07-25,200,200,200,0,1150,1152,1151,1,5,1,1,0,200,200,199,199
Ventura,32,2022-07-25,2154,2159,2158,1,18388,18428,18420,8,76,5,5,8,1542,1542,1537,1537
Yolo,32,2022-07-25,411,411,411,0,4383,4393,4391,2,4,3,3,1,381,381,378,378
Yuba,32,2022-07-25,175,175,175,0,1282,1285,1284,1,15,0,0,0,121,121,121,121
Alameda,33,2022-08-01,3812,3821,3820,1,37150,37234,37219,15,176,7,7,21,1980,1980,1973,1973
Amador,33,2022-08-01,53,53,53,0,1132,1133,1132,1,3,1,1,0,89,89,88,88
Butte,33,2022-08-01,368,368,368,0,2841,2846,2845,1,33,2,2,3,455,455,453,453
Calaveras,33,2022-08-01,68,68,68,0,573,574,573,1,2,1,1,2,132,132,131,131
Colusa,33,2022-08-01,26,26,26,0,362,363,362,1,7,0,0,0,22,22,22,22
Contra Costa,33,2022-08-01,2615,2622,2620,2,20990,21036,21022,14,86,13,13,15,1412,1412,1399,1399
Del Norte,33,2022-08-01,52,52,52,0,476,477,476,1,4,0,0,2,53,53,53,53
El Dorado,33,2022-08-01,234,234,234,0,2455,2460,2459,1,4,3,3,2,230,230,227,227
Fresno,33,2022-08-01,2984,2990,2988,2,18318,18359,18348,11,231,9,9,16,2828,2828,2819,2819
Glenn,33,2022-08-01,28,28,28,0,251,252,251,1,0,0,0,0,53,53,53,53
Humboldt,33,2022-08-01,223,223,223,0,1878,1883,1882,1,12,0,0,3,156,156,156,156
Imperial,33,2022-08-01,635,635,635,0,3526,3534,3532,2,22,5,5,3,957,957,952,952
Inyo,33,2022-08-01,20,20,20,0,280,281,280,1,2,0,0,0,58,58,58,58
Kern,33,2022-08-01,1687,1692,1691,1,14820,14854,14847,7,81,6,6,17,2389,2389,2383,2383
Kings,33,2022-08-01,624,624,624,0,4045,4053,4051,2,6,0,0,1,454,454,454,454
Lake,33,2022-08-01,125,125,125,0,994,995,994,1,7,0,0,2,143,143,143,143
Lassen,33,2022-08-01,102,102,102,0,947,949,948,1,0,0,0,0,63,63,63,63
Los Angeles,33,2022-08-01,30570,30640,30635,5,308904,309610,309562,48,1105,130,130,137,32837,32837,32707,32707
Madera,33,2022-08-01,463,463,463,0,3482,3489,3487,2,10,0,0,7,371,371,371,371
Marin,33,2022-08-01,411,411,411,0,5129,5141,5138,3,32,1,1,4,309,309,308,308
Mariposa,33,2022-08-01,22,22,22,0,225,226,225,1,0,0,0,0,29,29,29,29
Mendocino,33,2022-08-01,175,175,175,0,1258,1259,1258,1,6,1,1,1,134,134,133,133
Merced,33,2022-08-01,639,639,639,0,3549,3555,3553,2,22,6,6,2,849,849,843,843
Modoc,33,2022-08-01,16,16,16,0,31,32,31,1,0,0,0,0,9,9,9,9
Mono,33,2022-08-01,9,9,9,0,67,68,67,1,0,0,0,0,7,7,7,7
Monterey,33,2022-08-01,927,927,926,1,6398,6413,6407,6,33,2,2,1,760,760,758,758
Napa,33,2022-08-01,282,282,282,0,2836,2841,2840,1,8,0,0,2,154,154,154,154
Nevada,33,2022-08-01,125,125,125,0,1404,1407,1406,1,12,0,0,0,132,132,132,132
Orange,33,2022-08-01,6466,6479,6477,2,52397,52518,52499,19,246,34,34,49,7330,7330,7296,7296
Placer,33,2022-08-01,588,588,588,0,4744,4756,4753,3,71,1,1,11,652,652,651,651
Plumas,33,2022-08-01,24,24,24,0,162,163,162,1,0,0,0,0,13,13,13,13
Riverside,33,2022-08-01,6115,6128,6125,3,42269,42364,42343,21,200,5,5,23,6563,6563,6558,6558
Sacramento,33,2022-08-01,3089,3096,3094,2,27833,27896,27881,15,179,18,18,26,3238,3238,3220,3220
San Benito,33,2022-08-01,177,177,177,0,839,840,839,1,2,1,1,0,98,98,97,97
San Bernardino,33,2022-08-01,6056,6070,6068,2,48909,49020,49001,19,184,26,26,23,7979,7979,7953,7953
San Diego,33,2022-08-01,9363,9385,9383,2,68637,68794,68783,11,396,15,15,46,5472,5472,5457,5457
San Francisco,33,2022-08-01,1808,1813,1811,2,21970,22021,21997,24,105,13,13,20,988,988,975,975
San Joaquin,33,2022-08-01,1734,1739,1738,1,16110,16147,16138,9,69,7,7,11,2297,2297,2290,2290
San Luis Obispo,33,2022-08-01,576,576,576,0,4141,4149,4147,2,14,3,3,0,514,514,511,511
San Mateo,33,2022-08-01,1767,1772,1771,1,20298,20344,20337,7,67,1,1,3,734,734,733,733
Santa Barbara,33,2022-08-01,1117,1118,1117,1,7778,7796,7792,4,40,1,1,3,716,716,715,715
Santa Clara,33,2022-08-01,4835,4846,4845,1,45102,45206,45198,8,230,19,19,36,2456,2456,2437,2437
Santa Cruz,33,2022-08-01,747,747,747,0,6864,6878,6875,3,20,1,1,3,269,269,268,268
Shasta,33,2022-08-01,243,243,243,0,2967,2974,2972,2,34,1,1,7,583,583,582,582
Siskiyou,33,2022-08-01,29,29,29,0,298,299,298,1,2,0,0,0,86,86,86,86
Solano,33,2022-08-01,1139,1140,1139,1,9123,9144,9140,4,53,0,0,4,454,454,454,454
Sonoma,33,2022-08-01,922,922,922,0,8181,8200,8196,4,46,3,3,3,512,512,509,509
Stanislaus,33,2022-08-01,1234,1235,1234,1,7718,7735,7729,6,115,6,6,8,1742,1742,1736,1736
Sutter,33,2022-08-01,232,232,232,0,1634,1637,1636,1,0,3,3,0,231,231,228,228
Tehama,33,2022-08-01,89,89,89,0,757,757,756,1,4,0,0,0,211,211,211,211
Trinity,33,2022-08-01,11,11,11,0,71,72,71,1,0,1,1,0,21,21,20,20
Tulare,33,2022-08-01,1033,1033,1032,1,7462,7480,7474,6,46,1,1,3,1518,1518,1517,1517
Tuolumne,33,2022-08-01,144,144,144,0,1111,1112,1111,1,4,0,0,1,200,200,200,200
Ventura,33,2022-08-01,1807,1812,1811,1,16967,17006,17000,6,75,10,10,10,1552,1552,1542,1542
Yolo,33,2022-08-01,331,331,331,0,4165,4175,4173,2,3,3,3,1,384,384,381,381
Yuba,33,2022-08-01,160,160,160,0,1216,1218,1217,1,10,0,0,3,121,121,121,121
Alameda,34,2022-08-08,3277,3285,3284,1,35189,35273,35262,11,133,13,13,20,1993,1993,1980,1980
Amador,34,2022-08-08,50,50,50,0,852,853,852,1,3,0,0,1,89,89,89,89
Butte,34,2022-08-08,333,333,333,0,2492,2497,2496,1,33,1,1,1,456,456,455,455
Calaveras,34,2022-08-08,57,57,57,0,559,560,559,1,1,1,1,0,133,133,132,132
Colusa,34,2022-08-08,15,15,15,0,362,363,362,1,0,0,0,0,22,22,22,22
Contra Costa,34,2022-08-08,2178,2184,2183,1,19777,19824,19814,10,102,4,4,14,1416,1416,1412,1412
Del Norte,34,2022-08-08,49,49,49,0,498,499,498,1,4,1,1,1,54,54,53,53
El Dorado,34,2022-08-08,196,196,196,0,2321,2326,2325,1,4,0,0,2,230,230,230,230
Fresno,34,2022-08-08,2413,2418,2417,1,17764,17808,17799,9,207,8,8,25,2836,2836,2828,2828
Glenn,34,2022-08-08,22,22,22,0,249,250,249,1,0,0,0,0,53,53,53,53
Humboldt,34,2022-08-08,208,208,208,0,1919,1924,1923,1,12,1,1,2,157,157,156,156
Imperial,34,2022-08-08,547,547,547,0,3275,3282,3281,1,16,2,2,2,959,959,957,957
Inyo,34,2022-08-08,8,8,8,0,276,277,276,1,1,0,0,1,58,58,58,58
Kern,34,2022-08-08,1313,1316,1316,0,13659,13693,13688,5,61,6,6,16,2395,2395,2389,2389
Kings,34,2022-08-08,467,467,467,0,3323,3330,3329,1,20,0,0,2,454,454,454,454
Lake,34,2022-08-08,106,106,106,0,893,895,894,1,4,0,0,1,143,143,143,143
Lassen,34,2022-08-08,132,132,132,0,1023,1026,1025,1,1,0,0,0,63,63,63,63
Los Angeles,34,2022-08-08,25718,25779,25776,3,290987,291688,291653,35,1030,126,126,121,32963,32963,32837,32837
Madera,34,2022-08-08,379,379,379,0,3175,3183,3181,2,16,0,0,3,371,371,371,371
Marin,34,2022-08-08,359,359,359,0,4482,4494,4492,2,26,2,2,2,311,311,309,309
Mariposa,34,2022-08-08,28,28,28,0,197,198,197,1,0,0,0,0,29,29,29,29
Mendocino,34,2022-08-08,132,132,132,0,1128,1129,1128,1,3,1,1,1,135,135,134,134
Merced,34,2022-08-08,537,537,537,0,3378,3385,3384,1,17,1,1,5,850,850,849,849
Modoc,34,2022-08-08,2,2,2,0,22,23,22,1,0,0,0,0,9,9,9,9
Mono,34,2022-08-08,10,10,10,0,85,86,85,1,0,0,0,0,7,7,7,7
Monterey,34,2022-08-08,739,739,738,1,5749,5763,5759,4,28,1,1,0,761,761,760,760
Napa,34,2022-08-08,252,252,252,0,2609,2614,2613,1,10,2,2,3,156,156,154,154
Nevada,34,2022-08-08,94,94,94,0,1290,1292,1291,1,4,0,0,0,132,132,132,132
Orange,34,2022-08-08,5264,5276,5275,1,48031,48147,48133,14,242,29,29,40,7359,7359,7330,7330
Placer,34,2022-08-08,512,512,512,0,4516,4528,4526,2,65,3,3,9,655,655,652,652
Plumas,34,2022-08-08,23,23,23,0,190,191,190,1,1,0,0,0,13,13,13,13
Riverside,34,2022-08-08,5497,5509,5507,2,40549,40646,40631,15,174,13,13,13,6576,6576,6563,6563
Sacramento,34,2022-08-08,2619,2625,2624,1,26958,27022,27011,11,156,16,16,20,3254,3254,3238,3238
San Benito,34,2022-08-08,184,184,184,0,872,873,872,1,1,0,0,0,98,98,98,98
San Bernardino,34,2022-08-08,5033,5045,5043,2,45829,45940,45926,14,204,20,20,15,7999,7999,7979,7979
San Diego,34,2022-08-08,7270,7287,7286,1,64400,64555,64547,8,337,10,10,30,5482,5482,5472,5472
San Francisco,34,2022-08-08,1489,1494,1493,1,20588,20638,20621,17,94,11,11,21,999,999,988,988
San Joaquin,34,2022-08-08,1517,1521,1520,1,15712,15749,15742,7,55,6,6,12,2303,2303,2297,2297
San Luis Obispo,34,2022-08-08,509,509,509,0,3610,3617,3616,1,14,0,0,2,514,514,514,514
San Mateo,34,2022-08-08,1508,1512,1512,0,18470,18515,18510,5,60,0,0,5,734,734,734,734
Santa Barbara,34,2022-08-08,961,961,961,0,7517,7535,7532,3,46,3,3,4,719,719,716,716
Santa Clara,34,2022-08-08,4154,4163,4162,1,40452,40549,40544,5,203,16,16,40,2472,2472,2456,2456
Santa Cruz,34,2022-08-08,618,618,618,0,6043,6056,6054,2,28,1,1,0,270,270,269,269
Shasta,34,2022-08-08,197,197,197,0,2831,2838,2837,1,33,1,1,3,584,584,583,583
Siskiyou,34,2022-08-08,27,27,27,0,291,292,291,1,0,1,1,0,87,87,86,86
Solano,34,2022-08-08,877,877,877,0,7948,7968,7965,3,54,0,0,9,454,454,454,454
Sonoma,34,2022-08-08,839,839,839,0,7722,7741,7738,3,34,5,5,3,517,517,512,512
Stanislaus,34,2022-08-08,1032,1032,1031,1,7168,7185,7181,4,90,7,7,11,1749,1749,1742,1742
Sutter,34,2022-08-08,224,224,224,0,1552,1555,1554,1,0,0,0,0,231,231,231,231
Tehama,34,2022-08-08,77,77,77,0,681,682,681,1,0,0,0,1,211,211,211,211
Trinity,34,2022-08-08,5,5,5,0,71,72,71,1,0,0,0,0,21,21,21,21
Tulare,34,2022-08-08,883,883,882,1,7320,7338,7334,4,46,4,4,3,1522,1522,1518,1518
Tuolumne,34,2022-08-08,118,118,118,0,1054,1054,1053,1,4,3,3,0,203,203,200,200
Ventura,34,2022-08-08,1503,1508,1508,0,15930,15969,15965,4,67,6,6,7,1558,1558,1552,1552
Yolo,34,2022-08-08,288,288,288,0,3874,3883,3882,1,4,1,1,3,385,385,384,384
Yuba,34,2022-08-08,135,135,135,0,1085,1087,1086,1,6,0,0,0,121,121,121,121
Alameda,35,2022-08-15,2561,2568,2567,1,33648,33734,33726,8,105,9,9,22,2002,2002,1993,1993
Amador,35,2022-08-15,47,47,47,0,848,849,848,1,2,0,0,0,89,89,89,89
Butte,35,2022-08-15,260,260,260,0,2244,2250,2249,1,19,0,0,2,456,456,456,456
Calaveras,35,2022-08-15,46,46,46,0,528,529,528,1,0,0,0,0,133,133,133,133
Colusa,35,2022-08-15,16,16,16,0,359,360,359,1,1,0,0,0,22,22,22,22
Contra Costa,35,2022-08-15,1775,1780,1779,1,18944,18991,18983,8,72,6,6,9,1422,1422,1416,1416
Del Norte,35,2022-08-15,52,52,52,0,499,500,499,1,2,0,0,1,54,54,54,54
El Dorado,35,2022-08-15,179,179,179,0,2306,2311,2310,1,5,0,0,3,230,230,230,230
Fresno,35,2022-08-15,1865,1871,1870,1,16141,16182,16176,6,170,7,7,17,2843,2843,2836,2836
Glenn,35,2022-08-15,15,15,15,0,225,226,225,1,3,0,0,0,53,53,53,53
Humboldt,35,2022-08-15,179,179,179,0,1587,1593,1592,1,16,0,0,2,157,157,157,157
Imperial,35,2022-08-15,366,366,366,0,3097,3102,3101,1,11,0,0,2,959,959,959,959
Inyo,35,2022-08-15,14,14,14,0,236,237,236,1,2,1,1,0,59,59,58,58
Kern,35,2022-08-15,1216,1217,1217,0,13478,13512,13508,4,59,7,7,16,2402,2402,2395,2395
Kings,35,2022-08-15,332,332,332,0,3235,3242,3241,1,9,0,0,1,454,454,454,454
Lake,35,2022-08-15,103,103,103,0,1028,1030,1029,1,3,1,1,2,144,144,143,143
Lassen,35,2022-08-15,59,59,59,0,897,900,899,1,0,0,0,0,63,63,63,63
Los Angeles,35,2022-08-15,20902,20955,20953,2,287433,288163,288136,27,905,110,110,117,33073,33073,32963,32963
Madera,35,2022-08-15,303,303,303,0,2954,2961,2960,1,12,0,0,3,371,371,371,371
Marin,35,2022-08-15,293,293,293,0,4106,4118,4116,2,15,0,0,0,311,311,311,311
Mariposa,35,2022-08-15,15,15,15,0,192,193,192,1,0,0,0,0,29,29,29,29
Mendocino,35,2022-08-15,104,104,104,0,996,996,995,1,7,0,0,3,135,135,135,135
Merced,35,2022-08-15,445,445,445,0,3406,3413,3412,1,12,2,2,1,852,852,850,850
Modoc,35,2022-08-15,4,4,4,0,23,24,23,1,0,0,0,0,9,9,9,9
Mono,35,2022-08-15,4,4,4,0,61,62,61,1,0,0,0,0,7,7,7,7
Monterey,35,2022-08-15,661,661,661,0,5803,5817,5814,3,30,0,0,1,761,761,761,761
Napa,35,2022-08-15,212,212,212,0,2280,2285,2284,1,13,0,0,0,156,156,156,156
Nevada,35,2022-08-15,98,98,98,0,1209,1212,1211,1,7,0,0,0,132,132,132,132
Orange,35,2022-08-15,4563,4575,4574,1,43008,43118,43108,10,270,31,31,44,7390,7390,7359,7359
Placer,35,2022-08-15,411,411,411,0,4469,4482,4480,2,61,1,1,11,656,656,655,655
Plumas,35,2022-08-15,17,17,17,0,184,185,184,1,0,0,0,0,13,13,13,13
Riverside,35,2022-08-15,4558,4570,4569,1,38020,38118,38107,11,143,16,16,22,6592,6592,6576,6576
Sacramento,35,2022-08-15,2348,2354,2353,1,25407,25472,25464,8,149,11,11,22,3265,3265,3254,3254
San Benito,35,2022-08-15,140,140,140,0,781,782,781,1,3,1,1,1,99,99,98,98
San Bernardino,35,2022-08-15,4681,4693,4692,1,44139,44252,44241,11,144,14,14,22,8013,8013,7999,7999
San Diego,35,2022-08-15,5499,5512,5511,1,59489,59641,59635,6,288,13,13,34,5495,5495,5482,5482
San Francisco,35,2022-08-15,1257,1260,1259,1,19530,19580,19567,13,103,15,15,11,1014,1014,999,999
San Joaquin,35,2022-08-15,1445,1449,1448,1,15211,15251,15246,5,64,8,8,8,2311,2311,2303,2303
San Luis Obispo,35,2022-08-15,325,325,325,0,3301,3310,3309,1,15,4,4,3,518,518,514,514
San Mateo,35,2022-08-15,1216,1218,1218,0,17319,17364,17360,4,56,1,1,5,735,735,734,734
Santa Barbara,35,2022-08-15,831,831,831,0,7118,7136,7134,2,44,1,1,4,720,720,719,719
Santa Clara,35,2022-08-15,3336,3345,3345,0,39269,39369,39365,4,200,8,8,24,2480,2480,2472,2472
Santa Cruz,35,2022-08-15,492,492,492,0,7531,7551,7549,2,23,3,3,1,273,273,270,270
Shasta,35,2022-08-15,193,193,193,0,2786,2794,2793,1,19,1,1,1,585,585,584,584
Siskiyou,35,2022-08-15,18,18,18,0,284,285,284,1,3,0,0,1,87,87,87,87
Solano,35,2022-08-15,659,659,659,0,7440,7459,7457,2,45,0,0,10,454,454,454,454
Sonoma,35,2022-08-15,630,630,630,0,7281,7301,7299,2,39,2,2,2,519,519,517,517
Stanislaus,35,2022-08-15,938,938,938,0,7651,7670,7666,4,99,9,9,11,1758,1758,1749,1749
Sutter,35,2022-08-15,197,197,197,0,1587,1591,1590,1,0,1,1,0,232,232,231,231
Tehama,35,2022-08-15,60,60,60,0,645,646,645,1,1,0,0,0,211,211,211,211
Trinity,35,2022-08-15,8,8,8,0,58,59,58,1,0,0,0,0,21,21,21,21
Tulare,35,2022-08-15,733,733,733,0,7326,7346,7343,3,32,3,3,1,1525,1525,1522,1522
Tuolumne,35,2022-08-15,110,110,110,0,991,993,992,1,1,0,0,0,203,203,203,203
Ventura,35,2022-08-15,1494,1499,1499,0,15260,15299,15296,3,70,5,5,7,1563,1563,1558,1558
Yolo,35,2022-08-15,264,264,264,0,3527,3536,3535,1,2,4,4,1,389,389,385,385
Yuba,35,2022-08-15,128,128,128,0,1080,1082,1081,1,9,0,0,0,121,121,121,121
Alameda,36,2022-08-22,2239,2246,2246,0,33062,33153,33147,6,117,8,8,21,2010,2010,2002,2002
Amador,36,2022-08-22,49,49,49,0,815,817,816,1,2,1,1,0,90,90,89,89
Butte,36,2022-08-22,222,222,222,0,2129,2135,2134,1,17,1,1,2,457,457,456,456
Calaveras,36,2022-08-22,43,43,43,0,572,573,572,1,1,0,0,0,133,133,133,133
Colusa,36,2022-08-22,16,16,16,0,394,395,394,1,0,0,0,0,22,22,22,22
Contra Costa,36,2022-08-22,1528,1533,1533,0,18809,18860,18854,6,56,5,5,9,1427,1427,1422,1422
Del Norte,36,2022-08-22,31,31,31,0,461,462,461,1,3,1,1,0,55,55,54,54
El Dorado,36,2022-08-22,151,151,151,0,2221,2226,2225,1,4,1,1,0,231,231,230,230
Fresno,36,2022-08-22,1594,1599,1599,0,15781,15825,15820,5,162,6,6,14,2849,2849,2843,2843
Glenn,36,2022-08-22,23,23,23,0,227,228,227,1,1,0,0,0,53,53,53,53
Humboldt,36,2022-08-22,151,151,151,0,1677,1683,1682,1,6,1,1,3,158,158,157,157
Imperial,36,2022-08-22,290,290,290,0,2844,2851,2850,1,15,0,0,0,959,959,959,959
Inyo,36,2022-08-22,8,8,8,0,213,214,213,1,0,0,0,0,59,59,59,59
Kern,36,2022-08-22,980,981,981,0,13745,13782,13779,3,69,6,6,10,2408,2408,2402,2402
Kings,36,2022-08-22,371,371,371,0,3638,3648,3647,1,10,1,1,0,455,455,454,454
Lake,36,2022-08-22,104,104,104,0,884,886,885,1,5,0,0,0,144,144,144,144
Lassen,36,2022-08-22,36,36,36,0,833,836,835,1,0,0,0,0,63,63,63,63
Los Angeles,36,2022-08-22,18440,18490,18489,1,274591,275335,275315,20,811,116,116,104,33189,33189,33073,33073
Madera,36,2022-08-22,298,298,298,0,2612,2619,2618,1,14,2,2,4,373,373,371,371
Marin,36,2022-08-22,249,249,249,0,3959,3971,3970,1,17,0,0,3,311,311,311,311
Mariposa,36,2022-08-22,14,14,14,0,172,173,172,1,0,0,0,0,29,29,29,29
Mendocino,36,2022-08-22,121,121,121,0,1145,1151,1150,1,3,0,0,2,135,135,135,135
Merced,36,2022-08-22,446,446,446,0,3636,3646,3645,1,12,4,4,1,856,856,852,852
Modoc,36,2022-08-22,6,6,6,0,27,28,27,1,0,0,0,0,9,9,9,9
Mono,36,2022-08-22,4,4,4,0,63,64,63,1,0,0,0,0,7,7,7,7
Monterey,36,2022-08-22,546,546,546,0,5905,5921,5918,3,27,1,1,2,762,762,761,761
Napa,36,2022-08-22,128,128,128,0,1998,2004,2003,1,5,2,2,1,158,158,156,156
Nevada,36,2022-08-22,84,84,84,0,1180,1184,1183,1,6,0,0,0,132,132,132,132
Orange,36,2022-08-22,3784,3795,3794,1,40754,40866,40859,7,224,21,21,35,7411,7411,7390,7390
Placer,36,2022-08-22,381,381,381,0,4302,4315,4314,1,61,1,1,14,657,657,656,656
Plumas,36,2022-08-22,20,20,20,0,175,176,175,1,1,0,0,0,13,13,13,13
Riverside,36,2022-08-22,4376,4388,4387,1,37501,37603,37594,9,142,13,13,19,6605,6605,6592,6592
Sacramento,36,2022-08-22,2072,2078,2077,1,24944,25012,25006,6,144,14,14,25,3279,3279,3265,3265
San Benito,36,2022-08-22,102,102,102,0,698,699,698,1,1,1,1,1,100,100,99,99
San Bernardino,36,2022-08-22,4609,4621,4620,1,44240,44361,44353,8,160,18,18,22,8031,8031,8013,8013
San Diego,36,2022-08-22,4784,4796,4796,0,57534,57690,57686,4,287,6,6,28,5501,5501,5495,5495
San Francisco,36,2022-08-22,1091,1092,1091,1,18811,18862,18852,10,81,16,16,12,1030,1030,1014,1014
San Joaquin,36,2022-08-22,1194,1197,1197,0,15720,15764,15760,4,56,1,1,8,2312,2312,2311,2311
San Luis Obispo,36,2022-08-22,257,257,257,0,3089,3096,3095,1,16,1,1,0,519,519,518,518
San Mateo,36,2022-08-22,1010,1011,1011,0,17140,17187,17184,3,42,0,0,2,735,735,735,735
Santa Barbara,36,2022-08-22,736,736,736,0,7435,7455,7453,2,37,1,1,2,721,721,720,720
Santa Clara,36,2022-08-22,3015,3022,3022,0,39698,39807,39804,3,173,10,10,27,2490,2490,2480,2480
Santa Cruz,36,2022-08-22,502,502,502,0,11954,11987,11985,2,13,0,0,0,273,273,273,273
Shasta,36,2022-08-22,172,172,172,0,2757,2763,2762,1,10,2,2,2,587,587,585,585
Siskiyou,36,2022-08-22,25,25,25,0,249,250,249,1,4,1,1,2,88,88,87,87
Solano,36,2022-08-22,526,526,526,0,7193,7213,7211,2,35,0,0,12,454,454,454,454
Sonoma,36,2022-08-22,604,604,604,0,7369,7389,7387,2,42,2,2,1,521,521,519,519
Stanislaus,36,2022-08-22,892,892,892,0,7646,7666,7663,3,79,7,7,16,1765,1765,1758,1758
Sutter,36,2022-08-22,189,189,189,0,1657,1663,1662,1,0,0,0,0,232,232,232,232
Tehama,36,2022-08-22,53,53,53,0,629,631,630,1,1,0,0,0,211,211,211,211
Trinity,36,2022-08-22,10,10,10,0,63,64,63,1,0,0,0,0,21,21,21,21
Tulare,36,2022-08-22,726,726,726,0,6780,6798,6796,2,33,3,3,1,1528,1528,1525,1525
Tuolumne,36,2022-08-22,105,105,105,0,1018,1021,1020,1,0,1,1,0,204,204,203,203
Ventura,36,2022-08-22,1318,1321,1321,0,14997,15038,15036,2,59,3,3,9,1566,1566,1563,1563
Yolo,36,2022-08-22,200,200,200,0,3472,3482,3481,1,10,1,1,1,390,390,389,389
Yuba,36,2022-08-22,126,126,126,0,1106,1110,1109,1,13,0,0,3,121,121,121,121
Alameda,37,2022-08-29,1964,1971,1971,0,34095,34195,34190,5,99,11,11,20,2021,2021,2010,2010
Amador,37,2022-08-29,46,46,46,0,804,806,805,1,2,1,1,0,91,91,90,90
Butte,37,2022-08-29,237,237,237,0,2170,2176,2175,1,18,0,0,3,457,457,457,457
Calaveras,37,2022-08-29,59,59,59,0,591,592,591,1,1,0,0,0,133,133,133,133
Colusa,37,2022-08-29,10,10,10,0,329,330,329,1,3,0,0,0,22,22,22,22
Contra Costa,37,2022-08-29,1351,1356,1356,0,18762,18818,18813,5,44,5,5,7,1432,1432,1427,1427
Del Norte,37,2022-08-29,28,28,28,0,431,432,431,1,5,0,0,1,55,55,55,55
El Dorado,37,2022-08-29,145,145,145,0,1946,1952,1951,1,1,0,0,1,231,231,231,231
Fresno,37,2022-08-29,1417,1422,1422,0,15740,15787,15783,4,159,3,3,15,2852,2852,2849,2849
Glenn,37,2022-08-29,22,22,22,0,220,221,220,1,1,0,0,0,53,53,53,53
Humboldt,37,2022-08-29,124,124,124,0,1662,1668,1667,1,4,0,0,0,158,158,158,158
Imperial,37,2022-08-29,294,294,294,0,2935,2943,2942,1,14,1,1,2,960,960,959,959
Inyo,37,2022-08-29,8,8,8,0,175,176,175,1,0,0,0,0,59,59,59,59
Kern,37,2022-08-29,883,883,883,0,13226,13264,13262,2,50,0,0,8,2408,2408,2408,2408
Kings,37,2022-08-29,314,314,314,0,3490,3501,3500,1,8,0,0,0,455,455,455,455
Lake,37,2022-08-29,92,92,92,0,870,873,872,1,1,1,1,0,145,145,144,144
Lassen,37,2022-08-29,27,27,27,0,771,774,773,1,0,0,0,0,63,63,63,63
Los Angeles,37,2022-08-29,15512,15557,15556,1,271283,272076,272060,16,753,85,85,83,33274,33274,33189,33189
Madera,37,2022-08-29,298,298,298,0,3019,3028,3027,1,13,0,0,3,373,373,373,373
Marin,37,2022-08-29,216,216,216,0,3840,3852,3851,1,16,2,2,2,313,313,311,311
Mariposa,37,2022-08-29,25,25,25,0,186,187,186,1,0,0,0,0,29,29,29,29
Mendocino,37,2022-08-29,87,87,87,0,968,972,971,1,2,0,0,1,135,135,135,135
Merced,37,2022-08-29,390,390,390,0,3397,3407,3406,1,11,3,3,0,859,859,856,856
Modoc,37,2022-08-29,1,1,1,0,30,31,30,1,0,0,0,0,9,9,9,9
Mono,37,2022-08-29,2,2,2,0,45,46,45,1,0,0,0,0,7,7,7,7
Monterey,37,2022-08-29,396,396,396,0,5353,5369,5367,2,33,2,2,5,764,764,762,762
Napa,37,2022-08-29,128,128,128,0,2157,2164,2163,1,10,0,0,1,158,158,158,158
Nevada,37,2022-08-29,116,116,116,0,1206,1210,1209,1,6,0,0,0,132,132,132,132
Orange,37,2022-08-29,2935,2943,2943,0,39156,39270,39265,5,195,18,18,25,7429,7429,7411,7411
Placer,37,2022-08-29,369,369,369,0,4208,4221,4220,1,55,1,1,12,658,658,657,657
Plumas,37,2022-08-29,18,18,18,0,159,160,159,1,1,0,0,0,13,13,13,13
Riverside,37,2022-08-29,3647,3659,3658,1,36821,36929,36922,7,124,9,9,11,6614,6614,6605,6605
Sacramento,37,2022-08-29,1850,1856,1856,0,24683,24755,24750,5,137,10,10,20,3289,3289,3279,3279
San Benito,37,2022-08-29,120,120,120,0,779,780,779,1,1,0,0,0,100,100,100,100
San Bernardino,37,2022-08-29,3612,3623,3622,1,42068,42192,42186,6,156,14,14,18,8045,8045,8031,8031
San Diego,37,2022-08-29,3928,3940,3940,0,56583,56749,56746,3,222,12,12,25,5513,5513,5501,5501
San Francisco,37,2022-08-29,868,868,868,0,19113,19168,19160,8,57,7,7,12,1037,1037,1030,1030
San Joaquin,37,2022-08-29,1003,1005,1005,0,14292,14334,14331,3,27,5,5,11,2317,2317,2312,2312
San Luis Obispo,37,2022-08-29,326,326,326,0,3216,3225,3224,1,17,3,3,0,522,522,519,519
San Mateo,37,2022-08-29,843,843,843,0,16703,16751,16749,2,26,0,0,5,735,735,735,735
Santa Barbara,37,2022-08-29,638,638,638,0,7623,7646,7645,1,24,1,1,3,722,722,721,721
Santa Clara,37,2022-08-29,2303,2310,2310,0,39036,39150,39147,3,135,5,5,24,2495,2495,2490,2490
Santa Cruz,37,2022-08-29,384,384,384,0,12664,12701,12699,2,16,0,0,1,273,273,273,273
Shasta,37,2022-08-29,129,129,129,0,2576,2584,2583,1,19,1,1,1,588,588,587,587
Siskiyou,37,2022-08-29,24,24,24,0,249,250,249,1,0,1,1,0,89,89,88,88
Solano,37,2022-08-29,544,544,544,0,7264,7285,7284,1,33,1,1,8,455,455,454,454
Sonoma,37,2022-08-29,486,486,486,0,7102,7122,7121,1,37,1,1,4,522,522,521,521
Stanislaus,37,2022-08-29,848,848,848,0,8082,8105,8103,2,79,7,7,6,1772,1772,1765,1765
Sutter,37,2022-08-29,170,170,170,0,1638,1644,1643,1,0,0,0,0,232,232,232,232
Tehama,37,2022-08-29,66,66,66,0,737,739,738,1,4,0,0,1,211,211,211,211
Trinity,37,2022-08-29,6,6,6,0,56,57,56,1,0,0,0,0,21,21,21,21
Tulare,37,2022-08-29,678,678,678,0,7369,7391,7389,2,42,0,0,1,1528,1528,1528,1528
Tuolumne,37,2022-08-29,91,91,91,0,856,858,857,1,1,0,0,0,204,204,204,204
Ventura,37,2022-08-29,1020,1021,1021,0,14598,14641,14639,2,71,5,5,7,1571,1571,1566,1566
Yolo,37,2022-08-29,203,203,203,0,3702,3713,3712,1,5,0,0,3,390,390,390,390
Yuba,37,2022-08-29,135,135,135,0,1176,1181,1180,1,14,0,0,1,121,121,121,121
Alameda,38,2022-09-05,1432,1436,1436,0,28017,28104,28101,3,89,4,4,16,2025,2025,2021,2021
Amador,38,2022-09-05,44,44,44,0,748,750,749,1,3,0,0,2,91,91,91,91
Butte,38,2022-09-05,193,193,193,0,2122,2130,2129,1,14,2,2,2,459,459,457,457
Calaveras,38,2022-09-05,22,22,22,0,451,452,451,1,0,0,0,0,133,133,133,133
Colusa,38,2022-09-05,7,7,7,0,197,198,197,1,2,0,0,0,22,22,22,22
Contra Costa,38,2022-09-05,953,954,954,0,15403,15452,15449,3,62,5,5,9,1437,1437,1432,1432
Del Norte,38,2022-09-05,8,8,8,0,345,346,345,1,1,0,0,1,55,55,55,55
El Dorado,38,2022-09-05,91,91,91,0,1521,1526,1525,1,3,1,1,3,232,232,231,231
Fresno,38,2022-09-05,1084,1088,1088,0,13048,13090,13088,2,162,10,10,16,2862,2862,2852,2852
Glenn,38,2022-09-05,11,11,11,0,188,189,188,1,1,0,0,0,53,53,53,53
Humboldt,38,2022-09-05,110,110,110,0,1294,1299,1298,1,9,1,1,2,159,159,158,158
Imperial,38,2022-09-05,234,234,234,0,2521,2531,2530,1,8,1,1,2,961,961,960,960
Inyo,38,2022-09-05,12,12,12,0,139,140,139,1,0,0,0,1,59,59,59,59
Kern,38,2022-09-05,720,721,721,0,11239,11275,11273,2,50,5,5,8,2413,2413,2408,2408
Kings,38,2022-09-05,229,229,229,0,2869,2879,2878,1,8,0,0,0,455,455,455,455
Lake,38,2022-09-05,63,63,63,0,655,656,655,1,1,2,2,1,147,147,145,145
Lassen,38,2022-09-05,19,19,19,0,633,635,634,1,0,0,0,0,63,63,63,63
Los Angeles,38,2022-09-05,10664,10697,10697,0,221931,222625,222615,10,695,95,95,91,33369,33369,33274,33274
Madera,38,2022-09-05,205,205,205,0,2505,2515,2514,1,12,0,0,4,373,373,373,373
Marin,38,2022-09-05,190,190,190,0,3551,3563,3562,1,12,0,0,1,313,313,313,313
Mariposa,38,2022-09-05,16,16,16,0,166,167,166,1,0,0,0,0,29,29,29,29
Mendocino,38,2022-09-05,57,57,57,0,828,830,829,1,2,1,1,1,136,136,135,135
Merced,38,2022-09-05,250,250,250,0,2621,2631,2630,1,12,2,2,1,861,861,859,859
Modoc,38,2022-09-05,3,3,3,0,17,18,17,1,0,0,0,0,9,9,9,9
Mono,38,2022-09-05,4,4,4,0,52,53,52,1,1,0,0,0,7,7,7,7
Monterey,38,2022-09-05,244,244,244,0,4345,4359,4358,1,24,3,3,0,767,767,764,764
Napa,38,2022-09-05,101,101,101,0,1720,1725,1724,1,6,1,1,2,159,159,158,158
Nevada,38,2022-09-05,81,81,81,0,899,902,901,1,3,0,0,0,132,132,132,132
Orange,38,2022-09-05,2163,2170,2170,0,32112,32212,32209,3,169,13,13,34,7442,7442,7429,7429
Placer,38,2022-09-05,239,239,239,0,3468,3479,3478,1,36,0,0,4,658,658,658,658
Plumas,38,2022-09-05,9,9,9,0,129,130,129,1,0,0,0,0,13,13,13,13
Riverside,38,2022-09-05,2399,2407,2407,0,28556,28646,28642,4,99,7,7,14,6621,6621,6614,6614
Sacramento,38,2022-09-05,1240,1244,1244,0,19652,19713,19710,3,139,12,12,22,3301,3301,3289,3289
San Benito,38,2022-09-05,65,65,65,0,638,639,638,1,0,0,0,2,100,100,100,100
San Bernardino,38,2022-09-05,2327,2334,2334,0,34200,34307,34303,4,122,14,14,19,8059,8059,8045,8045
San Diego,38,2022-09-05,2798,2807,2807,0,48210,48360,48358,2,212,14,14,25,5527,5527,5513,5513
San Francisco,38,2022-09-05,677,677,677,0,15678,15728,15723,5,52,9,9,9,1046,1046,1037,1037
San Joaquin,38,2022-09-05,830,830,830,0,11949,11986,11984,2,43,4,4,10,2321,2321,2317,2317
San Luis Obispo,38,2022-09-05,176,176,176,0,2675,2685,2684,1,7,2,2,1,524,524,522,522
San Mateo,38,2022-09-05,610,610,610,0,13456,13499,13498,1,23,1,1,2,736,736,735,735
Santa Barbara,38,2022-09-05,484,484,484,0,6629,6650,6649,1,39,4,4,3,726,726,722,722
Santa Clara,38,2022-09-05,1890,1897,1897,0,32534,32636,32634,2,127,9,9,20,2504,2504,2495,2495
Santa Cruz,38,2022-09-05,283,283,283,0,10202,10234,10233,1,16,0,0,0,273,273,273,273
Shasta,38,2022-09-05,103,103,103,0,2022,2030,2029,1,15,0,0,0,588,588,588,588
Siskiyou,38,2022-09-05,30,30,30,0,216,217,216,1,0,0,0,0,89,89,89,89
Solano,38,2022-09-05,367,367,367,0,5942,5960,5959,1,34,1,1,11,456,456,455,455
Sonoma,38,2022-09-05,369,369,369,0,5995,6014,6013,1,40,0,0,2,522,522,522,522
Stanislaus,38,2022-09-05,547,547,547,0,6346,6366,6365,1,69,5,5,4,1777,1777,1772,1772
Sutter,38,2022-09-05,116,116,116,0,1482,1487,1486,1,0,0,0,0,232,232,232,232
Tehama,38,2022-09-05,50,50,50,0,581,582,581,1,2,1,1,0,212,212,211,211
Trinity,38,2022-09-05,4,4,4,0,51,52,51,1,0,0,0,0,21,21,21,21
Tulare,38,2022-09-05,428,428,428,0,5163,5180,5179,1,37,2,2,1,1530,1530,1528,1528
Tuolumne,38,2022-09-05,68,68,68,0,737,739,738,1,1,0,0,0,204,204,204,204
Ventura,38,2022-09-05,864,864,864,0,12305,12344,12343,1,48,8,8,1,1579,1579,1571,1571
Yolo,38,2022-09-05,138,138,138,0,2887,2897,2896,1,1,3,3,2,393,393,390,390
Yuba,38,2022-09-05,88,88,88,0,975,979,978,1,14,0,0,1,121,121,121,121
Alameda,39,2022-09-12,1614,1621,1621,0,31914,32026,32023,3,94,5,5,16,2030,2030,2025,2025
Amador,39,2022-09-12,32,32,32,0,873,877,876,1,3,0,0,2,91,91,91,91
Butte,39,2022-09-12,196,196,196,0,2466,2476,2475,1,15,3,3,2,462,462,459,459
Calaveras,39,2022-09-12,14,14,14,0,500,501,500,1,1,0,0,0,133,133,133,133
Colusa,39,2022-09-12,17,17,17,0,414,415,414,1,0,0,0,0,22,22,22,22
Contra Costa,39,2022-09-12,976,979,979,0,17296,17357,17354,3,59,6,6,12,1443,1443,1437,1437
Del Norte,39,2022-09-12,34,34,34,0,594,595,594,1,1,0,0,1,55,55,55,55
El Dorado,39,2022-09-12,105,105,105,0,1899,1906,1905,1,3,0,0,1,232,232,232,232
Fresno,39,2022-09-12,901,903,903,0,14672,14722,14720,2,155,6,6,15,2868,2868,2862,2862
Glenn,39,2022-09-12,15,15,15,0,208,209,208,1,0,0,0,0,53,53,53,53
Humboldt,39,2022-09-12,111,111,111,0,1652,1658,1657,1,6,0,0,5,159,159,159,159
Imperial,39,2022-09-12,257,257,257,0,3287,3300,3299,1,10,0,0,2,961,961,961,961
Inyo,39,2022-09-12,15,15,15,0,194,195,194,1,0,1,1,0,60,60,59,59
Kern,39,2022-09-12,637,637,637,0,12821,12865,12864,1,45,7,7,13,2420,2420,2413,2413
Kings,39,2022-09-12,228,228,228,0,3171,3183,3182,1,6,1,1,0,456,456,455,455
Lake,39,2022-09-12,48,48,48,0,882,885,884,1,3,0,0,1,147,147,147,147
Lassen,39,2022-09-12,19,19,19,0,917,921,920,1,0,0,0,0,63,63,63,63
Los Angeles,39,2022-09-12,10968,11005,11005,0,282361,283340,283330,10,652,85,85,83,33454,33454,33369,33369
Madera,39,2022-09-12,240,240,240,0,2923,2935,2934,1,8,0,0,3,373,373,373,373
Marin,39,2022-09-12,173,173,173,0,3906,3920,3919,1,12,2,2,2,315,315,313,313
Mariposa,39,2022-09-12,16,16,16,0,192,193,192,1,0,0,0,0,29,29,29,29
Mendocino,39,2022-09-12,58,58,58,0,952,957,956,1,2,0,0,1,136,136,136,136
Merced,39,2022-09-12,237,237,237,0,3289,3303,3302,1,6,2,2,1,863,863,861,861
Modoc,39,2022-09-12,2,2,2,0,22,23,22,1,0,0,0,0,9,9,9,9
Mono,39,2022-09-12,7,7,7,0,76,77,76,1,0,0,0,0,7,7,7,7
Monterey,39,2022-09-12,229,229,229,0,5089,5107,5106,1,22,1,1,1,768,768,767,767
Napa,39,2022-09-12,118,118,118,0,2247,2255,2254,1,10,0,0,1,159,159,159,159
Nevada,39,2022-09-12,61,61,61,0,1179,1184,1183,1,2,0,0,0,132,132,132,132
Orange,39,2022-09-12,2078,2086,2086,0,36652,36778,36775,3,159,27,27,22,7469,7469,7442,7442
Placer,39,2022-09-12,237,237,237,0,4071,4085,4084,1,38,0,0,5,658,658,658,658
Plumas,39,2022-09-12,22,22,22,0,194,195,194,1,1,0,0,0,13,13,13,13
Riverside,39,2022-09-12,2238,2247,2247,0,32980,33096,33092,4,124,5,5,12,6626,6626,6621,6621
Sacramento,39,2022-09-12,1273,1278,1278,0,23386,23466,23463,3,119,16,16,15,3317,3317,3301,3301
San Benito,39,2022-09-12,92,92,92,0,715,717,716,1,1,0,0,1,100,100,100,100
San Bernardino,39,2022-09-12,1913,1920,1920,0,38547,38682,38679,3,92,13,13,26,8072,8072,8059,8059
San Diego,39,2022-09-12,3039,3050,3050,0,55684,55878,55876,2,194,7,7,24,5534,5534,5527,5527
San Francisco,39,2022-09-12,807,809,809,0,17370,17431,17427,4,58,8,8,15,1054,1054,1046,1046
San Joaquin,39,2022-09-12,643,643,643,0,14263,14314,14312,2,35,5,5,9,2326,2326,2321,2321
San Luis Obispo,39,2022-09-12,185,185,185,0,3218,3231,3230,1,10,0,0,1,524,524,524,524
San Mateo,39,2022-09-12,654,654,654,0,14069,14118,14117,1,20,1,1,2,737,737,736,736
Santa Barbara,39,2022-09-12,329,329,329,0,7229,7255,7254,1,27,1,1,2,727,727,726,726
Santa Clara,39,2022-09-12,1881,1888,1888,0,37674,37805,37804,1,144,6,6,28,2510,2510,2504,2504
Santa Cruz,39,2022-09-12,273,273,273,0,13326,13372,13371,1,15,0,0,0,273,273,273,273
Shasta,39,2022-09-12,180,180,180,0,2589,2599,2598,1,26,1,1,2,589,589,588,588
Siskiyou,39,2022-09-12,27,27,27,0,289,290,289,1,1,0,0,0,89,89,89,89
Solano,39,2022-09-12,416,416,416,0,6721,6744,6743,1,32,0,0,4,456,456,456,456
Sonoma,39,2022-09-12,395,395,395,0,7016,7041,7040,1,39,3,3,1,525,525,522,522
Stanislaus,39,2022-09-12,449,449,449,0,7740,7767,7766,1,73,1,1,4,1778,1778,1777,1777
Sutter,39,2022-09-12,119,119,119,0,1531,1537,1536,1,0,0,0,0,232,232,232,232
Tehama,39,2022-09-12,48,48,48,0,699,702,701,1,2,0,0,0,212,212,212,212
Trinity,39,2022-09-12,2,2,2,0,74,75,74,1,0,0,0,0,21,21,21,21
Tulare,39,2022-09-12,366,366,366,0,6886,6911,6910,1,39,4,4,0,1534,1534,1530,1530
Tuolumne,39,2022-09-12,60,60,60,0,809,812,811,1,2,0,0,1,204,204,204,204
Ventura,39,2022-09-12,842,844,844,0,14802,14855,14854,1,49,1,1,7,1580,1580,1579,1579
Yolo,39,2022-09-12,143,143,143,0,3442,3454,3453,1,1,2,2,3,395,395,393,393
Yuba,39,2022-09-12,92,92,92,0,1162,1168,1167,1,6,0,0,0,121,121,121,121
Alameda,40,2022-09-19,1228,1234,1234,0,29012,29127,29125,2,80,4,4,7,2034,2034,2030,2030
Amador,40,2022-09-19,33,33,33,0,759,762,761,1,1,3,3,1,94,94,91,91
Butte,40,2022-09-19,120,120,120,0,2118,2127,2126,1,18,0,0,1,462,462,462,462
Calaveras,40,2022-09-19,28,28,28,0,476,477,476,1,0,0,0,0,133,133,133,133
Colusa,40,2022-09-19,12,12,12,0,289,290,289,1,3,0,0,0,22,22,22,22
Contra Costa,40,2022-09-19,828,831,831,0,16746,16812,16810,2,52,8,8,8,1451,1451,1443,1443
Del Norte,40,2022-09-19,21,21,21,0,478,479,478,1,2,0,0,0,55,55,55,55
El Dorado,40,2022-09-19,77,77,77,0,1616,1622,1621,1,3,0,0,0,232,232,232,232
Fresno,40,2022-09-19,599,599,599,0,13298,13351,13350,1,110,7,7,14,2875,2875,2868,2868
Glenn,40,2022-09-19,14,14,14,0,201,202,201,1,2,0,0,0,53,53,53,53
Humboldt,40,2022-09-19,104,104,104,0,1456,1462,1461,1,8,0,0,3,159,159,159,159
Imperial,40,2022-09-19,150,150,150,0,2865,2879,2878,1,11,0,0,2,961,961,961,961
Inyo,40,2022-09-19,8,8,8,0,169,170,169,1,0,0,0,0,60,60,60,60
Kern,40,2022-09-19,439,439,439,0,11537,11582,11581,1,34,2,2,6,2422,2422,2420,2420
Kings,40,2022-09-19,136,136,136,0,2642,2653,2652,1,7,2,2,0,458,458,456,456
Lake,40,2022-09-19,37,37,37,0,903,908,907,1,0,0,0,0,147,147,147,147
Lassen,40,2022-09-19,7,7,7,0,704,707,706,1,0,0,0,0,63,63,63,63
Los Angeles,40,2022-09-19,8518,8552,8552,0,254597,255604,255597,7,564,65,65,69,33519,33519,33454,33454
Madera,40,2022-09-19,109,109,109,0,2691,2702,2701,1,9,1,1,2,374,374,373,373
Marin,40,2022-09-19,137,137,137,0,3697,3712,3711,1,6,0,0,0,315,315,315,315
Mariposa,40,2022-09-19,12,12,12,0,170,171,170,1,0,1,1,0,30,30,29,29
Mendocino,40,2022-09-19,43,43,43,0,928,934,933,1,0,0,0,1,136,136,136,136
Merced,40,2022-09-19,170,170,170,0,2891,2905,2904,1,8,3,3,1,866,866,863,863
Modoc,40,2022-09-19,2,2,2,0,17,18,17,1,0,0,0,0,9,9,9,9
Mono,40,2022-09-19,4,4,4,0,63,64,63,1,0,0,0,0,7,7,7,7
Monterey,40,2022-09-19,162,162,162,0,4248,4263,4262,1,14,1,1,2,769,769,768,768
Napa,40,2022-09-19,99,99,99,0,1771,1779,1778,1,4,0,0,0,159,159,159,159
Nevada,40,2022-09-19,66,66,66,0,1110,1116,1115,1,2,0,0,0,132,132,132,132
Orange,40,2022-09-19,1704,1711,1711,0,33928,34063,34061,2,129,16,16,19,7485,7485,7469,7469
Placer,40,2022-09-19,222,222,222,0,3826,3842,3841,1,51,1,1,4,659,659,658,658
Plumas,40,2022-09-19,22,22,22,0,183,184,183,1,1,0,0,0,13,13,13,13
Riverside,40,2022-09-19,1410,1416,1416,0,29076,29191,29189,2,68,4,4,19,6630,6630,6626,6626
Sacramento,40,2022-09-19,1013,1018,1018,0,21283,21367,21365,2,102,7,7,17,3324,3324,3317,3317
San Benito,40,2022-09-19,54,54,54,0,607,609,608,1,0,0,0,0,100,100,100,100
San Bernardino,40,2022-09-19,1458,1465,1465,0,32523,32652,32650,2,83,7,7,19,8079,8079,8072,8072
San Diego,40,2022-09-19,2564,2575,2575,0,55897,56119,56117,2,175,9,9,19,5543,5543,5534,5534
San Francisco,40,2022-09-19,681,682,682,0,16780,16846,16843,3,43,9,9,11,1063,1063,1054,1054
San Joaquin,40,2022-09-19,453,453,453,0,12852,12903,12902,1,35,5,5,2,2331,2331,2326,2326
San Luis Obispo,40,2022-09-19,154,154,154,0,2763,2776,2775,1,8,0,0,0,524,524,524,524
San Mateo,40,2022-09-19,583,583,583,0,13509,13563,13562,1,20,0,0,2,737,737,737,737
Santa Barbara,40,2022-09-19,268,268,268,0,6788,6814,6813,1,34,2,2,0,729,729,727,727
Santa Clara,40,2022-09-19,1423,1430,1430,0,36492,36637,36636,1,137,7,7,21,2517,2517,2510,2510
Santa Cruz,40,2022-09-19,148,148,148,0,12304,12352,12351,1,5,0,0,1,273,273,273,273
Shasta,40,2022-09-19,100,100,100,0,2112,2121,2120,1,21,0,0,3,589,589,589,589
Siskiyou,40,2022-09-19,21,21,21,0,232,233,232,1,2,1,1,0,90,90,89,89
Solano,40,2022-09-19,272,272,272,0,6109,6132,6131,1,24,1,1,5,457,457,456,456
Sonoma,40,2022-09-19,315,315,315,0,6358,6383,6382,1,27,3,3,1,528,528,525,525
Stanislaus,40,2022-09-19,336,336,336,0,6289,6314,6313,1,57,4,4,4,1782,1782,1778,1778
Sutter,40,2022-09-19,75,75,75,0,1388,1395,1394,1,0,0,0,0,232,232,232,232
Tehama,40,2022-09-19,35,35,35,0,599,601,600,1,2,1,1,0,213,213,212,212
Trinity,40,2022-09-19,3,3,3,0,53,54,53,1,0,0,0,0,21,21,21,21
Tulare,40,2022-09-19,232,232,232,0,5724,5747,5746,1,32,1,1,0,1535,1535,1534,1534
Tuolumne,40,2022-09-19,59,59,59,0,717,721,720,1,0,0,0,0,204,204,204,204
Ventura,40,2022-09-19,615,615,615,0,13372,13425,13424,1,42,2,2,6,1582,1582,1580,1580
Yolo,40,2022-09-19,83,83,83,0,3721,3738,3737,1,2,3,3,2,398,398,395,395
Yuba,40,2022-09-19,60,60,60,0,1029,1035,1034,1,3,0,0,0,121,121,121,121
Alameda,41,2022-09-26,1127,1134,1134,0,27580,27701,27700,1,77,2,2,4,2036,2036,2034,2034
Amador,41,2022-09-26,26,26,26,0,721,724,723,1,1,0,0,1,94,94,94,94
Butte,41,2022-09-26,90,90,90,0,1792,1801,1800,1,23,0,0,1,462,462,462,462
Calaveras,41,2022-09-26,20,20,20,0,388,389,388,1,2,1,1,0,134,134,133,133
Colusa,41,2022-09-26,7,7,7,0,299,301,300,1,1,0,0,0,22,22,22,22
Contra Costa,41,2022-09-26,762,765,765,0,16253,16325,16324,1,48,5,5,7,1456,1456,1451,1451
Del Norte,41,2022-09-26,21,21,21,0,468,470,469,1,2,0,0,0,55,55,55,55
El Dorado,41,2022-09-26,86,86,86,0,1580,1588,1587,1,5,0,0,0,232,232,232,232
Fresno,41,2022-09-26,515,515,515,0,12080,12133,12132,1,84,3,3,13,2878,2878,2875,2875
Glenn,41,2022-09-26,7,7,7,0,176,177,176,1,2,0,0,0,53,53,53,53
Humboldt,41,2022-09-26,98,98,98,0,1311,1317,1316,1,10,2,2,0,161,161,159,159
Imperial,41,2022-09-26,115,115,115,0,2628,2642,2641,1,4,1,1,1,962,962,961,961
Inyo,41,2022-09-26,5,5,5,0,165,166,165,1,0,0,0,0,60,60,60,60
Kern,41,2022-09-26,344,344,344,0,10734,10781,10780,1,32,3,3,7,2425,2425,2422,2422
Kings,41,2022-09-26,107,107,107,0,2619,2632,2631,1,2,1,1,0,459,459,458,458
Lake,41,2022-09-26,26,26,26,0,815,819,818,1,0,0,0,0,147,147,147,147
Lassen,41,2022-09-26,13,13,13,0,533,536,535,1,0,0,0,0,63,63,63,63
Los Angeles,41,2022-09-26,7690,7723,7723,0,239246,240289,240284,5,443,62,62,53,33581,33581,33519,33519
Madera,41,2022-09-26,84,84,84,0,2231,2243,2242,1,8,0,0,2,374,374,374,374
Marin,41,2022-09-26,173,173,173,0,3657,3674,3673,1,10,0,0,0,315,315,315,315
Mariposa,41,2022-09-26,4,4,4,0,155,156,155,1,0,0,0,0,30,30,30,30
Mendocino,41,2022-09-26,41,41,41,0,850,855,854,1,1,0,0,0,136,136,136,136
Merced,41,2022-09-26,127,127,127,0,2838,2852,2851,1,10,1,1,0,867,867,866,866
Modoc,41,2022-09-26,0,0,0,0,13,14,13,1,0,0,0,0,9,9,9,9
Mono,41,2022-09-26,1,1,1,0,60,61,60,1,0,0,0,0,7,7,7,7
Monterey,41,2022-09-26,135,135,135,0,4027,4043,4042,1,14,0,0,2,769,769,769,769
Napa,41,2022-09-26,85,85,85,0,1955,1964,1963,1,5,0,0,1,159,159,159,159
Nevada,41,2022-09-26,49,49,49,0,1074,1080,1079,1,1,0,0,0,132,132,132,132
Orange,41,2022-09-26,1662,1669,1669,0,31052,31187,31185,2,117,19,19,23,7504,7504,7485,7485
Placer,41,2022-09-26,209,209,209,0,3591,3607,3606,1,42,1,1,4,660,660,659,659
Plumas,41,2022-09-26,21,21,21,0,151,152,151,1,1,0,0,0,13,13,13,13
Riverside,41,2022-09-26,1273,1280,1280,0,25765,25878,25876,2,55,8,8,15,6638,6638,6630,6630
Sacramento,41,2022-09-26,915,920,920,0,19146,19230,19229,1,106,11,11,20,3335,3335,3324,3324
San Benito,41,2022-09-26,50,50,50,0,576,578,577,1,0,1,1,2,101,101,100,100
San Bernardino,41,2022-09-26,1204,1211,1211,0,27802,27924,27923,1,75,5,5,12,8084,8084,8079,8079
San Diego,41,2022-09-26,2478,2490,2490,0,50917,51140,51139,1,201,7,7,15,5550,5550,5543,5543
San Francisco,41,2022-09-26,668,669,669,0,16113,16184,16182,2,45,2,2,9,1065,1065,1063,1063
San Joaquin,41,2022-09-26,405,405,405,0,11061,11109,11108,1,35,1,1,3,2332,2332,2331,2331
San Luis Obispo,41,2022-09-26,131,131,131,0,2519,2533,2532,1,7,1,1,0,525,525,524,524
San Mateo,41,2022-09-26,591,592,592,0,12958,13016,13015,1,25,0,0,1,737,737,737,737
Santa Barbara,41,2022-09-26,259,259,259,0,6379,6408,6407,1,22,2,2,0,731,731,729,729
Santa Clara,41,2022-09-26,1366,1373,1373,0,35348,35503,35502,1,113,10,10,17,2527,2527,2517,2517
Santa Cruz,41,2022-09-26,222,222,222,0,12494,12549,12548,1,13,0,0,0,273,273,273,273
Shasta,41,2022-09-26,73,73,73,0,1738,1746,1745,1,14,0,0,3,589,589,589,589
Siskiyou,41,2022-09-26,18,18,18,0,183,184,183,1,1,2,2,0,92,92,90,90
Solano,41,2022-09-26,306,306,306,0,5714,5740,5739,1,23,1,1,2,458,458,457,457
Sonoma,41,2022-09-26,292,292,292,0,6331,6361,6360,1,31,1,1,2,529,529,528,528
Stanislaus,41,2022-09-26,266,266,266,0,5811,5837,5836,1,46,2,2,3,1784,1784,1782,1782
Sutter,41,2022-09-26,69,69,69,0,1146,1152,1151,1,0,0,0,0,232,232,232,232
Tehama,41,2022-09-26,36,36,36,0,550,553,552,1,1,2,2,0,215,215,213,213
Trinity,41,2022-09-26,3,3,3,0,44,45,44,1,0,0,0,0,21,21,21,21
Tulare,41,2022-09-26,169,169,169,0,5089,5111,5110,1,18,3,3,2,1538,1538,1535,1535
Tuolumne,41,2022-09-26,44,44,44,0,689,693,692,1,1,0,0,0,204,204,204,204
Ventura,41,2022-09-26,550,550,550,0,11569,11619,11618,1,33,4,4,1,1586,1586,1582,1582
Yolo,41,2022-09-26,129,129,129,0,3970,3988,3987,1,2,3,3,3,401,401,398,398
Yuba,41,2022-09-26,40,40,40,0,933,938,937,1,6,0,0,1,121,121,121,121
Alameda,42,2022-10-03,1119,1126,1126,0,26068,26194,26193,1,54,3,3,5,2039,2039,2036,2036
Amador,42,2022-10-03,13,13,13,0,690,693,692,1,0,0,0,1,94,94,94,94
Butte,42,2022-10-03,67,67,67,0,1751,1762,1761,1,11,2,2,2,464,464,462,462
Calaveras,42,2022-10-03,19,19,19,0,334,335,334,1,1,0,0,0,134,134,134,134
Colusa,42,2022-10-03,7,7,7,0,188,190,189,1,0,0,0,0,22,22,22,22
Contra Costa,42,2022-10-03,720,724,724,0,15675,15752,15751,1,34,3,3,6,1459,1459,1456,1456
Del Norte,42,2022-10-03,12,12,12,0,382,383,382,1,1,0,0,1,55,55,55,55
El Dorado,42,2022-10-03,81,81,81,0,1450,1457,1456,1,3,0,0,1,232,232,232,232
Fresno,42,2022-10-03,460,460,460,0,11204,11259,11258,1,77,2,2,11,2880,2880,2878,2878
Glenn,42,2022-10-03,7,7,7,0,155,156,155,1,0,0,0,0,53,53,53,53
Humboldt,42,2022-10-03,79,79,79,0,1157,1163,1162,1,6,0,0,1,161,161,161,161
Imperial,42,2022-10-03,140,140,140,0,2563,2577,2576,1,6,0,0,0,962,962,962,962
Inyo,42,2022-10-03,5,5,5,0,159,160,159,1,0,0,0,1,60,60,60,60
Kern,42,2022-10-03,285,285,285,0,9961,10010,10009,1,24,4,4,5,2429,2429,2425,2425
Kings,42,2022-10-03,87,87,87,0,2414,2427,2426,1,2,0,0,0,459,459,459,459
Lake,42,2022-10-03,35,35,35,0,759,765,764,1,3,1,1,0,148,148,147,147
Lassen,42,2022-10-03,7,7,7,0,530,532,531,1,2,0,0,0,63,63,63,63
Los Angeles,42,2022-10-03,6995,7030,7030,0,219956,221026,221022,4,439,50,50,69,33631,33631,33581,33581
Madera,42,2022-10-03,66,66,66,0,1563,1572,1571,1,6,0,0,2,374,374,374,374
Marin,42,2022-10-03,189,189,189,0,3469,3486,3485,1,6,0,0,2,315,315,315,315
Mariposa,42,2022-10-03,5,5,5,0,131,132,131,1,0,0,0,0,30,30,30,30
Mendocino,42,2022-10-03,50,50,50,0,778,783,782,1,4,0,0,0,136,136,136,136
Merced,42,2022-10-03,109,109,109,0,2593,2607,2606,1,5,3,3,1,870,870,867,867
Modoc,42,2022-10-03,2,2,2,0,14,15,14,1,0,0,0,0,9,9,9,9
Mono,42,2022-10-03,4,4,4,0,69,70,69,1,0,0,0,0,7,7,7,7
Monterey,42,2022-10-03,111,111,111,0,3756,3775,3774,1,11,1,1,1,770,770,769,769
Napa,42,2022-10-03,88,88,88,0,1697,1705,1704,1,4,0,0,2,159,159,159,159
Nevada,42,2022-10-03,51,51,51,0,954,960,959,1,1,0,0,4,132,132,132,132
Orange,42,2022-10-03,1520,1527,1527,0,27894,28030,28029,1,131,22,22,16,7526,7526,7504,7504
Placer,42,2022-10-03,207,207,207,0,3335,3352,3351,1,41,2,2,3,662,662,660,660
Plumas,42,2022-10-03,12,12,12,0,107,108,107,1,1,0,0,0,13,13,13,13
Riverside,42,2022-10-03,1135,1142,1142,0,22044,22152,22151,1,59,7,7,12,6645,6645,6638,6638
Sacramento,42,2022-10-03,895,900,900,0,18050,18138,18137,1,88,12,12,19,3347,3347,3335,3335
San Benito,42,2022-10-03,34,34,34,0,516,517,516,1,0,0,0,0,101,101,101,101
San Bernardino,42,2022-10-03,1208,1214,1214,0,24829,24951,24950,1,77,4,4,7,8088,8088,8084,8084
San Diego,42,2022-10-03,2084,2095,2095,0,46597,46823,46822,1,162,9,9,18,5559,5559,5550,5550
San Francisco,42,2022-10-03,637,639,639,0,15298,15373,15371,2,44,3,3,9,1068,1068,1065,1065
San Joaquin,42,2022-10-03,339,339,339,0,9923,9972,9971,1,25,4,4,3,2336,2336,2332,2332
San Luis Obispo,42,2022-10-03,150,150,150,0,2382,2395,2394,1,2,1,1,1,526,526,525,525
San Mateo,42,2022-10-03,545,546,546,0,12233,12293,12292,1,22,0,0,2,737,737,737,737
Santa Barbara,42,2022-10-03,253,253,253,0,6288,6321,6320,1,15,0,0,2,731,731,731,731
Santa Clara,42,2022-10-03,1404,1411,1411,0,31876,32031,32030,1,109,6,6,20,2533,2533,2527,2527
Santa Cruz,42,2022-10-03,227,227,227,0,11218,11274,11273,1,10,0,0,1,273,273,273,273
Shasta,42,2022-10-03,54,54,54,0,1441,1449,1448,1,10,0,0,2,589,589,589,589
Siskiyou,42,2022-10-03,10,10,10,0,204,205,204,1,0,0,0,0,92,92,92,92
Solano,42,2022-10-03,246,246,246,0,5345,5372,5371,1,17,0,0,2,458,458,458,458
Sonoma,42,2022-10-03,324,324,324,0,5928,5959,5958,1,17,0,0,3,529,529,529,529
Stanislaus,42,2022-10-03,202,202,202,0,5352,5378,5377,1,49,1,1,6,1785,1785,1784,1784
Sutter,42,2022-10-03,57,57,57,0,1108,1115,1114,1,0,0,0,0,232,232,232,232
Tehama,42,2022-10-03,20,20,20,0,526,529,528,1,1,0,0,0,215,215,215,215
Trinity,42,2022-10-03,1,1,1,0,43,44,43,1,0,0,0,0,21,21,21,21
Tulare,42,2022-10-03,162,162,162,0,5046,5073,5072,1,19,2,2,1,1540,1540,1538,1538
Tuolumne,42,2022-10-03,26,26,26,0,622,626,625,1,0,0,0,0,204,204,204,204
Ventura,42,2022-10-03,476,476,476,0,10424,10477,10476,1,41,1,1,2,1587,1587,1586,1586
Yolo,42,2022-10-03,122,122,122,0,2981,2998,2997,1,3,2,2,2,403,403,401,401
Yuba,42,2022-10-03,35,35,35,0,801,807,806,1,4,0,0,1,121,121,121,121
Alameda,43,2022-10-10,1131,1138,1138,0,27699,27846,27845,1,45,2,2,7,2041,2041,2039,2039
Amador,43,2022-10-10,15,15,15,0,801,806,805,1,0,0,0,2,94,94,94,94
Butte,43,2022-10-10,65,65,65,0,1750,1761,1760,1,12,3,3,1,466,466,463,463
Calaveras,43,2022-10-10,15,15,15,0,373,374,373,1,0,1,1,0,135,135,134,134
Colusa,43,2022-10-10,1,1,1,0,120,121,120,1,1,0,0,0,22,22,22,22
Contra Costa,43,2022-10-10,752,755,755,0,16750,16838,16837,1,31,7,7,6,1464,1464,1457,1457
Del Norte,43,2022-10-10,10,10,10,0,492,493,492,1,1,0,0,1,55,55,55,55
El Dorado,43,2022-10-10,80,80,80,0,1747,1757,1756,1,7,0,0,4,232,232,232,232
Fresno,43,2022-10-10,481,481,481,0,12466,12531,12530,1,60,3,3,9,2883,2883,2880,2880
Glenn,43,2022-10-10,10,10,10,0,226,227,226,1,1,0,0,0,53,53,53,53
Humboldt,43,2022-10-10,97,97,97,0,1418,1425,1424,1,7,1,1,0,162,162,161,161
Imperial,43,2022-10-10,201,201,201,0,2957,2973,2972,1,7,0,0,0,962,962,962,962
Inyo,43,2022-10-10,4,4,4,0,123,124,123,1,0,0,0,0,60,60,60,60
Kern,43,2022-10-10,325,325,325,0,11654,11716,11715,1,24,2,2,2,2431,2431,2429,2429
Kings,43,2022-10-10,102,102,102,0,2750,2765,2764,1,1,1,1,0,460,460,459,459
Lake,43,2022-10-10,33,33,33,0,920,925,924,1,1,0,0,0,148,148,148,148
Lassen,43,2022-10-10,3,3,3,0,573,575,574,1,0,0,0,0,63,63,63,63
Los Angeles,43,2022-10-10,6706,6740,6740,0,226452,227653,227650,3,436,69,69,51,33692,33692,33623,33623
Madera,43,2022-10-10,68,68,68,0,1717,1726,1725,1,7,1,1,2,375,375,374,374
Marin,43,2022-10-10,207,207,207,0,3771,3792,3791,1,9,0,0,0,315,315,315,315
Mariposa,43,2022-10-10,8,8,8,0,128,129,128,1,0,0,0,0,30,30,30,30
Mendocino,43,2022-10-10,31,31,31,0,973,980,979,1,1,0,0,2,136,136,136,136
Merced,43,2022-10-10,111,111,111,0,2766,2783,2782,1,8,1,1,3,871,871,870,870
Modoc,43,2022-10-10,5,5,5,0,12,13,12,1,0,0,0,0,9,9,9,9
Mono,43,2022-10-10,1,1,1,0,55,56,55,1,0,0,0,0,7,7,7,7
Monterey,43,2022-10-10,106,106,106,0,4343,4368,4367,1,9,0,0,1,770,770,770,770
Napa,43,2022-10-10,78,78,78,0,1765,1775,1774,1,3,0,0,2,159,159,159,159
Nevada,43,2022-10-10,42,42,42,0,979,986,985,1,1,0,0,1,132,132,132,132
Orange,43,2022-10-10,1476,1484,1484,0,29610,29766,29765,1,129,14,14,19,7538,7538,7524,7524
Placer,43,2022-10-10,186,186,186,0,3819,3840,3839,1,24,0,0,7,662,662,662,662
Plumas,43,2022-10-10,20,20,20,0,106,107,106,1,0,0,0,0,13,13,13,13
Riverside,43,2022-10-10,1174,1181,1181,0,23894,24020,24019,1,56,5,5,4,6650,6650,6645,6645
Sacramento,43,2022-10-10,936,942,942,0,20299,20407,20406,1,81,5,5,16,3352,3352,3347,3347
San Benito,43,2022-10-10,34,34,34,0,549,551,550,1,3,0,0,0,101,101,101,101
San Bernardino,43,2022-10-10,1089,1095,1095,0,27119,27264,27263,1,66,0,0,13,8088,8088,8088,8088
San Diego,43,2022-10-10,1991,2003,2003,0,51315,51588,51587,1,130,7,7,21,5564,5564,5557,5557
San Francisco,43,2022-10-10,680,684,684,0,16017,16102,16101,1,37,2,2,9,1070,1070,1068,1068
San Joaquin,43,2022-10-10,428,428,428,0,11565,11628,11627,1,17,2,2,8,2338,2338,2336,2336
San Luis Obispo,43,2022-10-10,88,88,88,0,2565,2579,2578,1,2,2,2,0,528,528,526,526
San Mateo,43,2022-10-10,643,645,645,0,13538,13612,13611,1,19,0,0,0,737,737,737,737
Santa Barbara,43,2022-10-10,242,242,242,0,7840,7883,7882,1,20,1,1,1,732,732,731,731
Santa Clara,43,2022-10-10,1418,1426,1426,0,33691,33870,33869,1,107,2,2,18,2535,2535,2533,2533
Santa Cruz,43,2022-10-10,338,338,338,0,12257,12323,12322,1,9,0,0,1,273,273,273,273
Shasta,43,2022-10-10,99,99,99,0,1292,1299,1298,1,13,3,3,1,592,592,589,589
Siskiyou,43,2022-10-10,9,9,9,0,244,245,244,1,0,1,1,0,93,93,92,92
Solano,43,2022-10-10,327,327,327,0,6250,6284,6283,1,23,0,0,4,458,458,458,458
Sonoma,43,2022-10-10,289,289,289,0,6768,6805,6804,1,15,1,1,3,530,530,529,529
Stanislaus,43,2022-10-10,208,208,208,0,5924,5957,5956,1,51,7,7,7,1790,1790,1783,1783
Sutter,43,2022-10-10,57,57,57,0,1126,1133,1132,1,0,0,0,0,232,232,232,232
Tehama,43,2022-10-10,21,21,21,0,566,569,568,1,1,0,0,0,215,215,215,215
Trinity,43,2022-10-10,1,1,1,0,53,54,53,1,0,0,0,0,21,21,21,21
Tulare,43,2022-10-10,170,170,170,0,4979,5007,5006,1,16,1,1,1,1541,1541,1540,1540
Tuolumne,43,2022-10-10,36,36,36,0,661,666,665,1,1,1,1,0,205,205,204,204
Ventura,43,2022-10-10,430,430,430,0,10969,11028,11027,1,41,4,4,1,1590,1590,1586,1586
Yolo,43,2022-10-10,126,126,126,0,3083,3100,3099,1,4,2,2,0,405,405,403,403
Yuba,43,2022-10-10,24,24,24,0,924,930,929,1,0,0,0,0,121,121,121,121
Alameda,44,2022-10-17,912,918,918,0,24394,24542,24541,1,60,5,5,8,2046,2046,2041,2041
Amador,44,2022-10-17,14,14,14,0,591,594,593,1,1,0,0,0,94,94,94,94
Butte,44,2022-10-17,76,76,76,0,1424,1434,1433,1,13,0,0,0,466,466,466,466
Calaveras,44,2022-10-17,19,19,19,0,305,307,306,1,0,0,0,0,135,135,135,135
Colusa,44,2022-10-17,4,4,4,0,80,81,80,1,0,0,0,0,22,22,22,22
Contra Costa,44,2022-10-17,663,668,668,0,14487,14575,14574,1,30,4,4,6,1468,1468,1464,1464
Del Norte,44,2022-10-17,10,10,10,0,379,381,380,1,1,0,0,0,55,55,55,55
El Dorado,44,2022-10-17,88,88,88,0,1380,1391,1390,1,2,0,0,1,232,232,232,232
Fresno,44,2022-10-17,346,347,347,0,10197,10260,10259,1,62,2,2,11,2885,2885,2883,2883
Glenn,44,2022-10-17,6,6,6,0,141,143,142,1,1,0,0,0,53,53,53,53
Humboldt,44,2022-10-17,70,70,70,0,1146,1153,1152,1,1,0,0,0,162,162,162,162
Imperial,44,2022-10-17,118,118,118,0,2318,2333,2332,1,5,0,0,0,962,962,962,962
Inyo,44,2022-10-17,6,6,6,0,122,123,122,1,1,0,0,0,60,60,60,60
Kern,44,2022-10-17,230,230,230,0,9626,9684,9683,1,32,0,0,1,2431,2431,2431,2431
Kings,44,2022-10-17,70,70,70,0,2320,2335,2334,1,2,0,0,0,460,460,460,460
Lake,44,2022-10-17,25,25,25,0,774,780,779,1,1,0,0,0,148,148,148,148
Lassen,44,2022-10-17,7,7,7,0,513,516,515,1,1,0,0,0,63,63,63,63
Los Angeles,44,2022-10-17,5071,5101,5101,0,188124,189261,189259,2,350,41,41,53,33733,33733,33692,33692
Madera,44,2022-10-17,58,58,58,0,1465,1475,1474,1,3,0,0,2,375,375,375,375
Marin,44,2022-10-17,132,132,132,0,3089,3109,3108,1,8,0,0,1,315,315,315,315
Mariposa,44,2022-10-17,6,6,6,0,119,120,119,1,0,0,0,0,30,30,30,30
Mendocino,44,2022-10-17,47,47,47,0,741,747,746,1,2,0,0,0,136,136,136,136
Merced,44,2022-10-17,128,128,128,0,2332,2347,2346,1,15,0,0,2,871,871,871,871
Modoc,44,2022-10-17,1,1,1,0,7,8,7,1,0,0,0,0,9,9,9,9
Mono,44,2022-10-17,6,6,6,0,41,42,41,1,1,0,0,0,7,7,7,7
Monterey,44,2022-10-17,123,123,123,0,3537,3559,3558,1,12,1,1,1,771,771,770,770
Napa,44,2022-10-17,60,60,60,0,1415,1424,1423,1,2,0,0,1,159,159,159,159
Nevada,44,2022-10-17,49,49,49,0,777,784,783,1,0,0,0,5,132,132,132,132
Orange,44,2022-10-17,1078,1085,1085,0,24705,24854,24853,1,91,21,21,18,7559,7559,7538,7538
Placer,44,2022-10-17,148,148,148,0,2919,2936,2935,1,32,0,0,3,662,662,662,662
Plumas,44,2022-10-17,11,11,11,0,98,99,98,1,0,0,0,0,13,13,13,13
Riverside,44,2022-10-17,884,891,891,0,20668,20794,20793,1,66,2,2,2,6652,6652,6650,6650
Sacramento,44,2022-10-17,852,858,858,0,16063,16160,16159,1,84,9,9,14,3361,3361,3352,3352
San Benito,44,2022-10-17,28,28,28,0,433,435,434,1,0,1,1,0,102,102,101,101
San Bernardino,44,2022-10-17,816,821,821,0,23210,23351,23350,1,63,1,1,9,8089,8089,8088,8088
San Diego,44,2022-10-17,1646,1656,1656,0,43403,43666,43665,1,117,8,8,24,5572,5572,5564,5564
San Francisco,44,2022-10-17,559,562,562,0,14385,14473,14472,1,34,3,3,13,1073,1073,1070,1070
San Joaquin,44,2022-10-17,352,353,353,0,9069,9125,9124,1,8,2,2,8,2340,2340,2338,2338
San Luis Obispo,44,2022-10-17,108,108,108,0,2130,2144,2143,1,4,1,1,0,529,529,528,528
San Mateo,44,2022-10-17,540,542,542,0,11180,11250,11249,1,21,0,0,1,737,737,737,737
Santa Barbara,44,2022-10-17,182,182,182,0,5624,5659,5658,1,18,0,0,2,732,732,732,732
Santa Clara,44,2022-10-17,1145,1152,1152,0,28089,28262,28261,1,93,4,4,16,2539,2539,2535,2535
Santa Cruz,44,2022-10-17,281,282,282,0,10278,10343,10342,1,7,1,1,0,274,274,273,273
Shasta,44,2022-10-17,81,81,81,0,1105,1112,1111,1,12,0,0,2,592,592,592,592
Siskiyou,44,2022-10-17,12,12,12,0,181,182,181,1,2,1,1,0,94,94,93,93
Solano,44,2022-10-17,261,261,261,0,4825,4856,4855,1,25,1,1,3,459,459,458,458
Sonoma,44,2022-10-17,243,243,243,0,5367,5400,5399,1,20,1,1,1,531,531,530,530
Stanislaus,44,2022-10-17,223,223,223,0,5292,5325,5324,1,45,0,0,5,1790,1790,1790,1790
Sutter,44,2022-10-17,39,39,39,0,909,915,914,1,0,0,0,0,232,232,232,232
Tehama,44,2022-10-17,21,21,21,0,396,398,397,1,0,0,0,0,215,215,215,215
Trinity,44,2022-10-17,0,0,0,0,34,35,34,1,0,0,0,0,21,21,21,21
Tulare,44,2022-10-17,136,136,136,0,4268,4296,4295,1,11,1,1,1,1542,1542,1541,1541
Tuolumne,44,2022-10-17,35,35,35,0,620,625,624,1,2,0,0,0,205,205,205,205
Ventura,44,2022-10-17,375,375,375,0,9332,9390,9389,1,32,3,3,1,1593,1593,1590,1590
Yolo,44,2022-10-17,103,103,103,0,2200,2214,2213,1,3,2,2,3,407,407,405,405
Yuba,44,2022-10-17,44,44,44,0,767,773,772,1,1,0,0,0,121,121,121,121
Alameda,45,2022-10-24,921,928,928,0,23118,23284,23283,1,46,5,5,10,2051,2051,2046,2046
Amador,45,2022-10-24,18,18,18,0,635,640,639,1,2,0,0,0,94,94,94,94
Butte,45,2022-10-24,68,68,68,0,1405,1415,1414,1,10,1,1,1,467,467,466,466
Calaveras,45,2022-10-24,20,20,20,0,322,324,323,1,0,0,0,0,135,135,135,135
Colusa,45,2022-10-24,3,3,3,0,95,96,95,1,0,0,0,0,22,22,22,22
Contra Costa,45,2022-10-24,619,624,624,0,13854,13952,13951,1,37,5,5,5,1473,1473,1468,1468
Del Norte,45,2022-10-24,6,6,6,0,361,363,362,1,0,0,0,1,55,55,55,55
El Dorado,45,2022-10-24,92,92,92,0,1519,1532,1531,1,1,0,0,0,232,232,232,232
Fresno,45,2022-10-24,373,373,373,0,9740,9810,9809,1,63,0,0,6,2885,2885,2885,2885
Glenn,45,2022-10-24,9,9,9,0,148,150,149,1,0,0,0,0,53,53,53,53
Humboldt,45,2022-10-24,69,69,69,0,1148,1158,1157,1,7,0,0,2,162,162,162,162
Imperial,45,2022-10-24,94,94,94,0,2344,2362,2361,1,8,0,0,0,962,962,962,962
Inyo,45,2022-10-24,8,8,8,0,272,275,274,1,0,0,0,0,60,60,60,60
Kern,45,2022-10-24,269,269,269,0,9630,9701,9700,1,24,2,2,2,2433,2433,2431,2431
Kings,45,2022-10-24,87,87,87,0,2339,2356,2355,1,8,0,0,0,460,460,460,460
Lake,45,2022-10-24,21,21,21,0,643,649,648,1,1,0,0,1,148,148,148,148
Lassen,45,2022-10-24,16,16,16,0,484,489,488,1,1,0,0,0,63,63,63,63
Los Angeles,45,2022-10-24,5307,5345,5345,0,185569,186893,186891,2,332,53,53,43,33786,33786,33733,33733
Madera,45,2022-10-24,61,61,61,0,1388,1398,1397,1,4,0,0,2,375,375,375,375
Marin,45,2022-10-24,138,138,138,0,3075,3097,3096,1,12,1,1,2,316,316,315,315
Mariposa,45,2022-10-24,12,12,12,0,120,121,120,1,0,0,0,0,30,30,30,30
Mendocino,45,2022-10-24,42,42,42,0,770,776,775,1,2,0,0,0,136,136,136,136
Merced,45,2022-10-24,88,88,88,0,2404,2423,2422,1,7,3,3,3,874,874,871,871
Modoc,45,2022-10-24,1,1,1,0,13,14,13,1,0,0,0,0,9,9,9,9
Mono,45,2022-10-24,3,3,3,0,63,64,63,1,0,1,1,0,8,8,7,7
Monterey,45,2022-10-24,129,129,129,0,3707,3733,3732,1,18,0,0,0,771,771,771,771
Napa,45,2022-10-24,51,51,51,0,1467,1480,1479,1,3,0,0,0,159,159,159,159
Nevada,45,2022-10-24,38,38,38,0,784,791,790,1,6,0,0,0,132,132,132,132
Orange,45,2022-10-24,1122,1130,1130,0,25596,25778,25777,1,84,10,10,14,7569,7569,7559,7559
Placer,45,2022-10-24,191,191,191,0,3026,3050,3049,1,39,0,0,6,662,662,662,662
Plumas,45,2022-10-24,12,12,12,0,91,92,91,1,0,0,0,0,13,13,13,13
Riverside,45,2022-10-24,917,924,924,0,20044,20188,20187,1,53,0,0,6,6652,6652,6652,6652
Sacramento,45,2022-10-24,795,802,802,0,15194,15302,15301,1,84,4,4,19,3365,3365,3361,3361
San Benito,45,2022-10-24,41,41,41,0,549,555,554,1,0,0,0,1,102,102,102,102
San Bernardino,45,2022-10-24,772,779,779,0,21404,21556,21555,1,39,3,3,10,8092,8092,8089,8089
San Diego,45,2022-10-24,1681,1693,1693,0,41850,42147,42146,1,83,5,5,18,5577,5577,5572,5572
San Francisco,45,2022-10-24,500,504,504,0,13833,13933,13932,1,35,1,1,5,1074,1074,1073,1073
San Joaquin,45,2022-10-24,270,270,270,0,8491,8553,8552,1,13,2,2,3,2342,2342,2340,2340
San Luis Obispo,45,2022-10-24,89,89,89,0,2053,2069,2068,1,2,0,0,0,529,529,529,529
San Mateo,45,2022-10-24,462,465,465,0,10993,11072,11071,1,19,0,0,2,737,737,737,737
Santa Barbara,45,2022-10-24,164,164,164,0,5728,5770,5769,1,19,2,2,4,734,734,732,732
Santa Clara,45,2022-10-24,1184,1192,1192,0,28821,29028,29027,1,92,2,2,9,2541,2541,2539,2539
Santa Cruz,45,2022-10-24,238,238,238,0,10198,10272,10271,1,14,1,1,0,275,275,274,274
Shasta,45,2022-10-24,73,73,73,0,983,990,989,1,5,0,0,2,592,592,592,592
Siskiyou,45,2022-10-24,12,12,12,0,171,172,171,1,0,0,0,0,94,94,94,94
Solano,45,2022-10-24,237,237,237,0,5014,5052,5051,1,20,0,0,1,459,459,459,459
Sonoma,45,2022-10-24,246,246,246,0,5434,5474,5473,1,23,0,0,1,531,531,531,531
Stanislaus,45,2022-10-24,199,199,199,0,4851,4887,4886,1,40,3,3,3,1793,1793,1790,1790
Sutter,45,2022-10-24,27,27,27,0,881,887,886,1,0,0,0,0,232,232,232,232
Tehama,45,2022-10-24,36,36,36,0,405,408,407,1,1,0,0,0,215,215,215,215
Trinity,45,2022-10-24,1,1,1,0,34,35,34,1,0,0,0,0,21,21,21,21
Tulare,45,2022-10-24,108,108,108,0,4341,4374,4373,1,16,1,1,1,1543,1543,1542,1542
Tuolumne,45,2022-10-24,33,33,33,0,625,630,629,1,1,1,1,0,206,206,205,205
Ventura,45,2022-10-24,293,293,293,0,9021,9086,9085,1,40,3,3,6,1596,1596,1593,1593
Yolo,45,2022-10-24,90,90,90,0,2031,2047,2046,1,5,1,1,0,408,408,407,407
Yuba,45,2022-10-24,51,51,51,0,799,807,806,1,5,0,0,1,121,121,121,121
Alameda,46,2022-10-31,1023,1031,1031,0,22758,22946,22945,1,57,5,5,4,2056,2056,2051,2051
Amador,46,2022-10-31,18,18,18,0,577,582,581,1,2,1,1,0,95,95,94,94
Butte,46,2022-10-31,82,82,82,0,1457,1471,1470,1,11,0,0,3,467,467,467,467
Calaveras,46,2022-10-31,13,13,13,0,256,258,257,1,0,0,0,0,135,135,135,135
Colusa,46,2022-10-31,11,11,11,0,95,96,95,1,0,0,0,0,22,22,22,22
Contra Costa,46,2022-10-31,744,751,751,0,13827,13942,13941,1,37,6,6,7,1479,1479,1473,1473
Del Norte,46,2022-10-31,16,16,16,0,357,361,360,1,1,0,0,0,55,55,55,55
El Dorado,46,2022-10-31,100,100,100,0,1402,1415,1414,1,2,0,0,0,232,232,232,232
Fresno,46,2022-10-31,420,422,422,0,10493,10581,10580,1,57,4,4,8,2889,2889,2885,2885
Glenn,46,2022-10-31,16,16,16,0,156,158,157,1,1,0,0,0,53,53,53,53
Humboldt,46,2022-10-31,44,44,44,0,1019,1030,1029,1,6,0,0,2,162,162,162,162
Imperial,46,2022-10-31,124,124,124,0,2784,2809,2808,1,7,0,0,0,962,962,962,962
Inyo,46,2022-10-31,7,7,7,0,242,244,243,1,0,0,0,0,60,60,60,60
Kern,46,2022-10-31,331,333,333,0,9782,9863,9862,1,20,2,2,2,2435,2435,2433,2433
Kings,46,2022-10-31,117,117,117,0,2460,2480,2479,1,3,0,0,1,460,460,460,460
Lake,46,2022-10-31,30,30,30,0,752,759,758,1,1,0,0,1,148,148,148,148
Lassen,46,2022-10-31,19,19,19,0,522,527,526,1,1,0,0,0,63,63,63,63
Los Angeles,46,2022-10-31,6191,6242,6242,0,190440,192021,192019,2,344,37,37,44,33823,33823,33786,33786
Madera,46,2022-10-31,54,54,54,0,1433,1445,1444,1,3,0,0,2,375,375,375,375
Marin,46,2022-10-31,135,135,135,0,3468,3499,3498,1,10,1,1,1,317,317,316,316
Mariposa,46,2022-10-31,8,8,8,0,126,127,126,1,0,0,0,0,30,30,30,30
Mendocino,46,2022-10-31,23,23,23,0,709,716,715,1,1,0,0,2,136,136,136,136
Merced,46,2022-10-31,113,113,113,0,2134,2153,2152,1,5,0,0,0,874,874,874,874
Modoc,46,2022-10-31,1,1,1,0,13,14,13,1,0,0,0,0,9,9,9,9
Mono,46,2022-10-31,1,1,1,0,85,86,85,1,1,0,0,0,8,8,8,8
Monterey,46,2022-10-31,149,149,149,0,3683,3715,3714,1,18,2,2,0,773,773,771,771
Napa,46,2022-10-31,53,53,53,0,1501,1515,1514,1,2,0,0,0,159,159,159,159
Nevada,46,2022-10-31,36,36,36,0,773,780,779,1,6,0,0,0,132,132,132,132
Orange,46,2022-10-31,1149,1158,1158,0,26704,26926,26925,1,91,14,14,14,7583,7583,7569,7569
Placer,46,2022-10-31,147,147,147,0,2746,2770,2769,1,40,0,0,5,662,662,662,662
Plumas,46,2022-10-31,5,5,5,0,87,88,87,1,0,0,0,0,13,13,13,13
Riverside,46,2022-10-31,1026,1034,1034,0,19422,19585,19584,1,64,5,5,5,6657,6657,6652,6652
Sacramento,46,2022-10-31,730,737,737,0,14043,14161,14160,1,80,8,8,16,3373,3373,3365,3365
San Benito,46,2022-10-31,33,33,33,0,501,507,506,1,1,0,0,1,102,102,102,102
San Bernardino,46,2022-10-31,1022,1030,1030,0,22269,22454,22453,1,64,2,2,11,8094,8094,8092,8092
San Diego,46,2022-10-31,1770,1784,1784,0,42444,42796,42795,1,109,5,5,13,5582,5582,5577,5577
San Francisco,46,2022-10-31,606,612,612,0,14556,14678,14677,1,45,3,3,3,1077,1077,1074,1074
San Joaquin,46,2022-10-31,330,331,331,0,8589,8661,8660,1,21,6,6,3,2348,2348,2342,2342
San Luis Obispo,46,2022-10-31,81,81,81,0,2009,2027,2026,1,1,1,1,0,530,530,529,529
San Mateo,46,2022-10-31,508,512,512,0,11474,11570,11569,1,30,0,0,2,737,737,737,737
Santa Barbara,46,2022-10-31,181,181,181,0,6031,6083,6082,1,20,1,1,6,735,735,734,734
Santa Clara,46,2022-10-31,1259,1269,1269,0,30458,30713,30712,1,85,2,2,16,2543,2543,2541,2541
Santa Cruz,46,2022-10-31,187,187,187,0,9947,10031,10030,1,7,0,0,0,275,275,275,275
Shasta,46,2022-10-31,64,64,64,0,829,836,835,1,6,2,2,1,594,594,592,592
Siskiyou,46,2022-10-31,17,17,17,0,216,217,216,1,1,1,1,0,95,95,94,94
Solano,46,2022-10-31,310,311,311,0,5235,5280,5279,1,16,0,0,4,459,459,459,459
Sonoma,46,2022-10-31,205,205,205,0,5585,5633,5632,1,24,0,0,3,531,531,531,531
Stanislaus,46,2022-10-31,235,235,235,0,4828,4868,4867,1,49,1,1,8,1794,1794,1793,1793
Sutter,46,2022-10-31,55,55,55,0,901,910,909,1,0,0,0,0,232,232,232,232
Tehama,46,2022-10-31,26,26,26,0,395,400,399,1,1,0,0,0,215,215,215,215
Trinity,46,2022-10-31,17,17,17,0,73,74,73,1,5,0,0,0,21,21,21,21
Tulare,46,2022-10-31,154,154,154,0,3675,3706,3705,1,12,0,0,0,1543,1543,1543,1543
Tuolumne,46,2022-10-31,27,27,27,0,518,524,523,1,3,0,0,0,206,206,206,206
Ventura,46,2022-10-31,374,377,377,0,9511,9592,9591,1,24,2,2,2,1598,1598,1596,1596
Yolo,46,2022-10-31,81,81,81,0,1825,1841,1840,1,3,0,0,1,408,408,408,408
Yuba,46,2022-10-31,45,45,45,0,775,783,782,1,3,0,0,0,121,121,121,121
Alameda,47,2022-11-07,1296,1308,1308,0,23837,24069,24068,1,58,7,7,11,2063,2063,2056,2056
Amador,47,2022-11-07,32,32,32,0,685,694,693,1,3,0,0,0,95,95,95,95
Butte,47,2022-11-07,118,118,118,0,1369,1382,1381,1,11,0,0,2,467,467,467,467
Calaveras,47,2022-11-07,16,16,16,0,333,336,335,1,0,0,0,0,135,135,135,135
Colusa,47,2022-11-07,2,2,2,0,102,103,102,1,0,0,0,0,22,22,22,22
Contra Costa,47,2022-11-07,866,874,874,0,15394,15544,15543,1,43,3,3,4,1482,1482,1479,1479
Del Norte,47,2022-11-07,4,4,4,0,375,379,378,1,0,0,0,0,55,55,55,55
El Dorado,47,2022-11-07,107,107,107,0,1598,1613,1612,1,7,2,2,0,234,234,232,232
Fresno,47,2022-11-07,592,599,599,0,10700,10805,10804,1,61,3,3,9,2892,2892,2889,2889
Glenn,47,2022-11-07,29,29,29,0,131,133,132,1,0,0,0,0,53,53,53,53
Humboldt,47,2022-11-07,79,79,79,0,984,996,995,1,9,0,0,2,162,162,162,162
Imperial,47,2022-11-07,210,211,211,0,3708,3745,3744,1,7,0,0,0,962,962,962,962
Inyo,47,2022-11-07,19,19,19,0,264,266,265,1,0,0,0,0,60,60,60,60
Kern,47,2022-11-07,455,458,458,0,10638,10743,10742,1,29,1,1,5,2436,2436,2435,2435
Kings,47,2022-11-07,149,149,149,0,2457,2481,2480,1,7,1,1,0,461,461,460,460
Lake,47,2022-11-07,50,50,50,0,795,804,803,1,3,0,0,1,148,148,148,148
Lassen,47,2022-11-07,10,10,10,0,451,455,454,1,0,0,0,0,63,63,63,63
Los Angeles,47,2022-11-07,8056,8135,8135,0,190019,191868,191866,2,387,54,58,53,33877,33881,33823,33823
Madera,47,2022-11-07,78,78,78,0,1612,1629,1628,1,3,0,0,4,375,375,375,375
Marin,47,2022-11-07,148,148,148,0,3231,3264,3263,1,9,0,0,0,317,317,317,317
Mariposa,47,2022-11-07,14,14,14,0,121,122,121,1,0,0,0,0,30,30,30,30
Mendocino,47,2022-11-07,36,36,36,0,819,828,827,1,4,0,0,0,136,136,136,136
Merced,47,2022-11-07,143,143,143,0,2581,2607,2606,1,9,3,3,0,877,877,874,874
Modoc,47,2022-11-07,2,2,2,0,6,7,6,1,0,0,0,0,9,9,9,9
Mono,47,2022-11-07,3,3,3,0,96,97,96,1,0,0,0,0,8,8,8,8
Monterey,47,2022-11-07,218,219,219,0,3917,3956,3955,1,18,1,1,0,774,774,773,773
Napa,47,2022-11-07,77,77,77,0,1754,1772,1771,1,6,0,0,0,159,159,159,159
Nevada,47,2022-11-07,58,58,58,0,743,752,751,1,3,0,0,1,132,132,132,132
Orange,47,2022-11-07,1241,1254,1254,0,28481,28757,28756,1,94,9,9,20,7592,7592,7583,7583
Placer,47,2022-11-07,229,230,230,0,3331,3365,3364,1,53,2,2,7,664,664,662,662
Plumas,47,2022-11-07,5,5,5,0,69,70,69,1,0,0,0,0,13,13,13,13
Riverside,47,2022-11-07,1491,1506,1506,0,21536,21745,21744,1,71,2,2,5,6659,6659,6657,6657
Sacramento,47,2022-11-07,1081,1091,1091,0,15895,16050,16049,1,90,7,7,9,3380,3380,3373,3373
San Benito,47,2022-11-07,43,43,43,0,517,524,523,1,1,0,0,0,102,102,102,102
San Bernardino,47,2022-11-07,1417,1431,1431,0,23815,24047,24046,1,76,2,2,17,8096,8096,8094,8094
San Diego,47,2022-11-07,2152,2172,2172,0,45225,45666,45665,1,117,7,7,24,5589,5589,5582,5582
San Francisco,47,2022-11-07,709,716,716,0,14659,14802,14801,1,42,2,2,8,1079,1079,1077,1077
San Joaquin,47,2022-11-07,479,486,486,0,8798,8885,8884,1,24,2,2,3,2350,2350,2348,2348
San Luis Obispo,47,2022-11-07,129,129,129,0,2268,2291,2290,1,4,0,0,2,530,530,530,530
San Mateo,47,2022-11-07,563,570,570,0,12147,12267,12266,1,27,0,0,3,737,737,737,737
Santa Barbara,47,2022-11-07,224,225,225,0,6670,6735,6734,1,18,1,1,2,736,736,735,735
Santa Clara,47,2022-11-07,1634,1649,1649,0,30995,31299,31298,1,76,7,7,19,2550,2550,2543,2543
Santa Cruz,47,2022-11-07,281,282,282,0,11323,11435,11434,1,8,0,0,0,275,275,275,275
Shasta,47,2022-11-07,96,96,96,0,1052,1063,1062,1,11,1,1,3,595,595,594,594
Siskiyou,47,2022-11-07,15,15,15,0,295,297,296,1,1,0,0,0,95,95,95,95
Solano,47,2022-11-07,379,382,382,0,5489,5545,5544,1,22,2,2,3,461,461,459,459
Sonoma,47,2022-11-07,248,249,249,0,5903,5962,5961,1,11,2,2,2,533,533,531,531
Stanislaus,47,2022-11-07,302,303,303,0,4928,4977,4976,1,42,2,2,9,1796,1796,1794,1794
Sutter,47,2022-11-07,87,87,87,0,956,966,965,1,0,0,0,0,232,232,232,232
Tehama,47,2022-11-07,47,47,47,0,471,477,476,1,2,0,0,0,215,215,215,215
Trinity,47,2022-11-07,2,2,2,0,34,35,34,1,0,0,0,0,21,21,21,21
Tulare,47,2022-11-07,160,160,160,0,4365,4409,4408,1,14,0,0,0,1543,1543,1543,1543
Tuolumne,47,2022-11-07,82,82,82,0,681,689,688,1,2,0,0,0,206,206,206,206
Ventura,47,2022-11-07,446,453,453,0,10340,10441,10440,1,36,2,2,1,1600,1600,1598,1598
Yolo,47,2022-11-07,172,173,173,0,2232,2254,2253,1,3,2,2,0,410,410,408,408
Yuba,47,2022-11-07,46,46,46,0,902,912,911,1,3,0,0,2,121,121,121,121
Alameda,48,2022-11-14,1457,1474,1474,0,24000,24267,24266,1,77,3,3,9,2066,2066,2063,2063
Amador,48,2022-11-14,20,20,20,0,656,666,665,1,2,0,0,0,95,95,95,95
Butte,48,2022-11-14,119,119,119,0,1378,1394,1393,1,20,0,0,1,467,467,467,467
Calaveras,48,2022-11-14,30,30,30,0,341,345,344,1,0,0,0,0,135,135,135,135
Colusa,48,2022-11-14,11,11,11,0,100,101,100,1,1,0,0,0,22,22,22,22
Contra Costa,48,2022-11-14,935,944,944,0,15571,15745,15744,1,56,1,1,5,1483,1483,1482,1482
Del Norte,48,2022-11-14,17,17,17,0,395,399,398,1,1,0,0,0,55,55,55,55
El Dorado,48,2022-11-14,142,142,142,0,1589,1608,1607,1,7,0,0,1,234,234,234,234
Fresno,48,2022-11-14,763,771,771,0,11261,11388,11387,1,72,8,8,13,2900,2900,2892,2892
Glenn,48,2022-11-14,20,20,20,0,160,162,161,1,0,0,0,0,53,53,53,53
Humboldt,48,2022-11-14,81,81,81,0,1030,1042,1041,1,6,0,0,0,162,162,162,162
Imperial,48,2022-11-14,248,250,250,0,3219,3256,3255,1,4,0,0,1,962,962,962,962
Inyo,48,2022-11-14,10,10,10,0,542,547,546,1,0,0,0,0,60,60,60,60
Kern,48,2022-11-14,446,451,451,0,10599,10717,10716,1,26,1,1,6,2437,2437,2436,2436
Kings,48,2022-11-14,197,197,197,0,2624,2654,2653,1,6,1,1,0,462,462,461,461
Lake,48,2022-11-14,54,54,54,0,802,811,810,1,2,0,0,1,148,148,148,148
Lassen,48,2022-11-14,35,35,35,0,544,551,550,1,0,1,1,0,64,64,63,63
Los Angeles,48,2022-11-14,9350,9455,9455,0,194772,196949,196947,2,477,45,49,75,33922,33930,33877,33881
Madera,48,2022-11-14,95,95,95,0,1712,1732,1731,1,4,0,0,3,375,375,375,375
Marin,48,2022-11-14,174,174,174,0,3566,3608,3607,1,8,0,0,2,317,317,317,317
Mariposa,48,2022-11-14,18,18,18,0,137,138,137,1,0,0,0,0,30,30,30,30
Mendocino,48,2022-11-14,38,38,38,0,908,919,918,1,3,0,0,1,136,136,136,136
Merced,48,2022-11-14,185,185,185,0,2622,2653,2652,1,6,0,0,0,877,877,877,877
Modoc,48,2022-11-14,3,3,3,0,11,12,11,1,0,0,0,0,9,9,9,9
Mono,48,2022-11-14,10,10,10,0,122,123,122,1,0,0,0,0,8,8,8,8
Monterey,48,2022-11-14,198,199,199,0,4136,4183,4182,1,20,1,1,1,775,775,774,774
Napa,48,2022-11-14,105,105,105,0,1918,1942,1941,1,5,0,0,0,159,159,159,159
Nevada,48,2022-11-14,65,65,65,0,794,804,803,1,3,0,0,2,132,132,132,132
Orange,48,2022-11-14,1549,1567,1567,0,26707,27006,27005,1,118,5,5,21,7597,7597,7592,7592
Placer,48,2022-11-14,308,310,310,0,3834,3878,3877,1,54,1,1,5,665,665,664,664
Plumas,48,2022-11-14,4,4,4,0,79,80,79,1,0,0,0,0,13,13,13,13
Riverside,48,2022-11-14,1638,1658,1658,0,22332,22582,22581,1,95,4,4,10,6663,6663,6659,6659
Sacramento,48,2022-11-14,1171,1184,1184,0,16845,17033,17032,1,82,6,6,18,3386,3386,3380,3380
San Benito,48,2022-11-14,42,42,42,0,521,528,527,1,1,0,0,0,102,102,102,102
San Bernardino,48,2022-11-14,1776,1796,1796,0,23965,24233,24232,1,83,0,0,14,8096,8096,8096,8096
San Diego,48,2022-11-14,2453,2481,2481,0,43353,43837,43836,1,124,5,5,21,5594,5594,5589,5589
San Francisco,48,2022-11-14,704,712,712,0,13671,13825,13824,1,52,6,6,5,1085,1085,1079,1079
San Joaquin,48,2022-11-14,601,609,609,0,9495,9603,9602,1,20,0,0,5,2350,2350,2350,2350
San Luis Obispo,48,2022-11-14,120,120,120,0,2197,2222,2221,1,6,0,0,1,530,530,530,530
San Mateo,48,2022-11-14,636,644,644,0,11290,11417,11416,1,27,0,0,2,737,737,737,737
Santa Barbara,48,2022-11-14,191,192,192,0,5885,5950,5949,1,15,1,1,2,737,737,736,736
Santa Clara,48,2022-11-14,1731,1751,1751,0,30385,30727,30726,1,117,3,3,14,2553,2553,2550,2550
Santa Cruz,48,2022-11-14,250,252,252,0,9595,9704,9703,1,11,1,1,0,276,276,275,275
Shasta,48,2022-11-14,101,101,101,0,1070,1084,1083,1,10,1,1,2,596,596,595,595
Siskiyou,48,2022-11-14,26,26,26,0,396,401,400,1,2,0,0,0,95,95,95,95
Solano,48,2022-11-14,433,438,438,0,5407,5470,5469,1,26,0,0,3,461,461,461,461
Sonoma,48,2022-11-14,264,266,266,0,6033,6102,6101,1,23,1,1,0,534,534,533,533
Stanislaus,48,2022-11-14,329,332,332,0,5220,5280,5279,1,48,0,0,10,1796,1796,1796,1796
Sutter,48,2022-11-14,95,95,95,0,1182,1196,1195,1,0,0,0,0,232,232,232,232
Tehama,48,2022-11-14,49,49,49,0,574,582,581,1,1,0,0,0,215,215,215,215
Trinity,48,2022-11-14,10,10,10,0,52,53,52,1,0,1,1,0,22,22,21,21
Tulare,48,2022-11-14,307,310,310,0,4283,4332,4331,1,16,0,0,1,1543,1543,1543,1543
Tuolumne,48,2022-11-14,76,76,76,0,695,705,704,1,2,0,0,0,206,206,206,206
Ventura,48,2022-11-14,573,580,580,0,10606,10726,10725,1,28,1,1,4,1601,1601,1600,1600
Yolo,48,2022-11-14,153,153,153,0,2157,2183,2182,1,2,6,6,0,416,416,410,410
Yuba,48,2022-11-14,60,60,60,0,987,998,997,1,6,0,0,1,121,121,121,121
Alameda,49,2022-11-21,1704,1725,1725,0,25153,25469,25468,1,82,8,8,16,2074,2074,2066,2066
Amador,49,2022-11-21,28,28,28,0,832,843,842,1,2,0,0,0,95,95,95,95
Butte,49,2022-11-21,142,142,142,0,1327,1346,1345,1,21,0,0,1,467,467,467,467
Calaveras,49,2022-11-21,40,40,40,0,421,428,427,1,2,0,0,0,135,135,135,135
Colusa,49,2022-11-21,9,9,9,0,110,111,110,1,0,0,0,0,22,22,22,22
Contra Costa,49,2022-11-21,989,1003,1003,0,16034,16237,16236,1,52,3,3,8,1486,1486,1483,1483
Del Norte,49,2022-11-21,16,16,16,0,452,459,458,1,4,0,0,0,55,55,55,55
El Dorado,49,2022-11-21,187,188,188,0,1826,1850,1849,1,10,0,0,1,234,234,234,234
Fresno,49,2022-11-21,1065,1078,1078,0,12134,12288,12287,1,114,4,4,9,2904,2904,2900,2900
Glenn,49,2022-11-21,21,21,21,0,214,216,215,1,0,0,0,0,53,53,53,53
Humboldt,49,2022-11-21,104,104,104,0,1078,1093,1092,1,4,1,1,1,163,163,162,162
Imperial,49,2022-11-21,278,281,281,0,3121,3161,3160,1,3,1,1,1,963,963,962,962
Inyo,49,2022-11-21,29,29,29,0,402,407,406,1,0,1,1,0,61,61,60,60
Kern,49,2022-11-21,482,487,487,0,9998,10124,10123,1,54,3,3,10,2440,2440,2437,2437
Kings,49,2022-11-21,292,295,295,0,2777,2812,2811,1,4,2,2,1,464,464,462,462
Lake,49,2022-11-21,55,55,55,0,927,940,939,1,0,0,0,1,148,148,148,148
Lassen,49,2022-11-21,34,34,34,0,539,546,545,1,0,0,0,0,64,64,64,64
Los Angeles,49,2022-11-21,13071,13238,13238,0,195064,197515,197513,2,648,69,76,93,33991,34006,33922,33930
Madera,49,2022-11-21,168,169,169,0,1858,1881,1880,1,11,0,0,1,375,375,375,375
Marin,49,2022-11-21,178,178,178,0,3349,3393,3392,1,8,0,0,0,317,317,317,317
Mariposa,49,2022-11-21,19,19,19,0,170,171,170,1,0,0,0,0,30,30,30,30
Mendocino,49,2022-11-21,38,38,38,0,888,901,900,1,4,0,0,1,136,136,136,136
Merced,49,2022-11-21,269,271,271,0,2917,2955,2954,1,9,1,1,4,878,878,877,877
Modoc,49,2022-11-21,8,8,8,0,13,14,13,1,0,0,0,0,9,9,9,9
Mono,49,2022-11-21,3,3,3,0,107,108,107,1,0,0,0,0,8,8,8,8
Monterey,49,2022-11-21,229,230,230,0,4412,4469,4468,1,17,1,1,0,776,776,775,775
Napa,49,2022-11-21,143,143,143,0,2037,2064,2063,1,4,0,0,1,159,159,159,159
Nevada,49,2022-11-21,93,93,93,0,931,945,944,1,2,0,0,2,132,132,132,132
Orange,49,2022-11-21,2143,2170,2170,0,27979,28333,28332,1,170,13,14,32,7610,7611,7597,7597
Placer,49,2022-11-21,358,364,364,0,4057,4110,4109,1,53,0,0,6,665,665,665,665
Plumas,49,2022-11-21,7,7,7,0,104,105,104,1,1,0,0,0,13,13,13,13
Riverside,49,2022-11-21,2141,2169,2169,0,24312,24618,24617,1,110,6,6,9,6669,6669,6663,6663
Sacramento,49,2022-11-21,1518,1538,1538,0,18910,19148,19147,1,105,3,3,18,3389,3389,3386,3386
San Benito,49,2022-11-21,64,64,64,0,559,567,566,1,2,0,0,0,102,102,102,102
San Bernardino,49,2022-11-21,2323,2353,2353,0,26409,26742,26741,1,89,1,1,19,8097,8097,8096,8096
San Diego,49,2022-11-21,3202,3242,3242,0,43569,44114,44113,1,198,3,3,26,5597,5597,5594,5594
San Francisco,49,2022-11-21,935,948,948,0,15021,15212,15211,1,54,5,5,7,1090,1090,1085,1085
San Joaquin,49,2022-11-21,760,770,770,0,11061,11201,11200,1,36,1,1,5,2351,2351,2350,2350
San Luis Obispo,49,2022-11-21,170,170,170,0,2293,2322,2321,1,4,1,1,0,531,531,530,530
San Mateo,49,2022-11-21,735,744,744,0,12280,12435,12434,1,36,0,0,1,737,737,737,737
Santa Barbara,49,2022-11-21,317,322,322,0,6016,6094,6093,1,15,3,3,3,740,740,737,737
Santa Clara,49,2022-11-21,2160,2187,2187,0,34164,34596,34595,1,119,8,8,23,2561,2561,2553,2553
Santa Cruz,49,2022-11-21,284,287,287,0,9435,9554,9553,1,12,0,0,2,276,276,276,276
Shasta,49,2022-11-21,91,91,91,0,1050,1065,1064,1,14,0,0,1,596,596,596,596
Siskiyou,49,2022-11-21,24,24,24,0,342,349,348,1,1,0,0,0,95,95,95,95
Solano,49,2022-11-21,482,488,488,0,5654,5725,5724,1,32,1,1,5,462,462,461,461
Sonoma,49,2022-11-21,319,324,324,0,5774,5849,5848,1,22,0,0,4,534,534,534,534
Stanislaus,49,2022-11-21,447,454,454,0,5969,6045,6044,1,51,0,0,10,1796,1796,1796,1796
Sutter,49,2022-11-21,92,92,92,0,1138,1153,1152,1,0,0,0,0,232,232,232,232
Tehama,49,2022-11-21,72,72,72,0,673,683,682,1,3,0,0,2,215,215,215,215
Trinity,49,2022-11-21,5,5,5,0,51,52,51,1,0,0,0,0,22,22,22,22
Tulare,49,2022-11-21,434,440,440,0,5498,5567,5566,1,23,0,0,1,1543,1543,1543,1543
Tuolumne,49,2022-11-21,97,97,97,0,763,774,773,1,3,0,0,0,206,206,206,206
Ventura,49,2022-11-21,724,732,732,0,10491,10624,10623,1,43,1,1,2,1602,1602,1601,1601
Yolo,49,2022-11-21,133,133,133,0,2235,2264,2263,1,7,4,4,2,420,420,416,416
Yuba,49,2022-11-21,70,70,70,0,1026,1040,1039,1,10,0,0,1,121,121,121,121
Alameda,50,2022-11-28,2215,2247,2247,0,21926,22242,22241,1,103,5,5,13,2079,2079,2074,2074
Amador,50,2022-11-28,32,32,32,0,756,768,767,1,5,1,1,1,96,96,95,95
Butte,50,2022-11-28,204,206,206,0,1472,1495,1494,1,41,0,0,1,467,467,467,467
Calaveras,50,2022-11-28,31,31,31,0,401,409,408,1,3,0,0,0,135,135,135,135
Colusa,50,2022-11-28,14,14,14,0,184,186,185,1,0,0,0,0,22,22,22,22
Contra Costa,50,2022-11-28,1421,1441,1441,0,14999,15216,15215,1,67,4,4,8,1490,1490,1486,1486
Del Norte,50,2022-11-28,28,28,28,0,426,433,432,1,1,1,1,0,56,56,55,55
El Dorado,50,2022-11-28,185,186,186,0,1548,1571,1570,1,13,0,0,1,234,234,234,234
Fresno,50,2022-11-28,1313,1332,1332,0,11696,11865,11864,1,136,5,5,19,2909,2909,2904,2904
Glenn,50,2022-11-28,17,17,17,0,194,196,195,1,3,0,0,0,53,53,53,53
Humboldt,50,2022-11-28,105,105,105,0,983,999,998,1,10,0,0,0,163,163,163,163
Imperial,50,2022-11-28,377,384,384,0,2787,2828,2827,1,6,0,0,1,963,963,963,963
Inyo,50,2022-11-28,34,34,34,0,376,381,380,1,2,0,0,0,61,61,61,61
Kern,50,2022-11-28,580,588,588,0,9197,9330,9329,1,60,4,4,6,2444,2444,2440,2440
Kings,50,2022-11-28,244,246,246,0,2544,2581,2580,1,10,0,0,0,464,464,464,464
Lake,50,2022-11-28,48,48,48,0,846,858,857,1,1,0,0,0,148,148,148,148
Lassen,50,2022-11-28,27,27,27,0,493,502,501,1,0,0,0,0,64,64,64,64
Los Angeles,50,2022-11-28,18710,18982,18982,0,175943,178499,178497,2,918,83,95,122,34074,34101,33991,34006
Madera,50,2022-11-28,164,165,165,0,1626,1650,1649,1,13,0,0,2,375,375,375,375
Marin,50,2022-11-28,298,304,304,0,3066,3111,3110,1,19,0,0,1,317,317,317,317
Mariposa,50,2022-11-28,23,23,23,0,136,138,137,1,0,0,0,0,30,30,30,30
Mendocino,50,2022-11-28,49,49,49,0,726,737,736,1,5,0,0,2,136,136,136,136
Merced,50,2022-11-28,351,358,358,0,2531,2567,2566,1,18,3,3,2,881,881,878,878
Modoc,50,2022-11-28,5,5,5,0,9,10,9,1,0,0,0,0,9,9,9,9
Mono,50,2022-11-28,4,4,4,0,94,95,94,1,0,0,0,0,8,8,8,8
Monterey,50,2022-11-28,282,287,287,0,3873,3931,3930,1,26,1,1,0,777,777,776,776
Napa,50,2022-11-28,141,142,142,0,1884,1911,1910,1,6,0,0,3,159,159,159,159
Nevada,50,2022-11-28,117,117,117,0,1006,1021,1020,1,9,0,0,0,132,132,132,132
Orange,50,2022-11-28,3065,3110,3110,0,25911,26286,26285,1,221,14,15,34,7624,7626,7610,7611
Placer,50,2022-11-28,388,395,395,0,3775,3831,3830,1,69,1,1,5,666,666,665,665
Plumas,50,2022-11-28,6,6,6,0,143,145,144,1,0,0,0,0,13,13,13,13
Riverside,50,2022-11-28,3187,3235,3235,0,23031,23364,23363,1,188,11,11,22,6680,6680,6669,6669
Sacramento,50,2022-11-28,1788,1814,1814,0,17950,18208,18207,1,126,7,7,14,3396,3396,3389,3389
San Benito,50,2022-11-28,130,131,131,0,562,570,569,1,1,0,0,0,102,102,102,102
San Bernardino,50,2022-11-28,3284,3333,3333,0,25629,25999,25998,1,146,1,1,20,8098,8098,8097,8097
San Diego,50,2022-11-28,4102,4162,4162,0,31468,31926,31925,1,259,7,7,27,5604,5604,5597,5597
San Francisco,50,2022-11-28,1160,1176,1176,0,12707,12890,12889,1,67,6,6,8,1096,1096,1090,1090
San Joaquin,50,2022-11-28,988,1003,1003,0,10920,11079,11078,1,50,3,3,11,2354,2354,2351,2351
San Luis Obispo,50,2022-11-28,177,178,178,0,2240,2273,2272,1,9,3,3,1,534,534,531,531
San Mateo,50,2022-11-28,1081,1098,1098,0,10953,11112,11111,1,42,1,1,3,738,738,737,737
Santa Barbara,50,2022-11-28,466,473,473,0,5199,5275,5274,1,27,2,2,5,742,742,740,740
Santa Clara,50,2022-11-28,2899,2940,2940,0,27903,28307,28306,1,159,5,5,22,2566,2566,2561,2561
Santa Cruz,50,2022-11-28,370,376,376,0,6655,6753,6752,1,20,0,0,2,276,276,276,276
Shasta,50,2022-11-28,93,93,93,0,1006,1021,1020,1,16,1,1,3,597,597,596,596
Siskiyou,50,2022-11-28,27,27,27,0,277,281,280,1,2,0,0,0,95,95,95,95
Solano,50,2022-11-28,582,590,590,0,5172,5247,5246,1,34,2,2,7,464,464,462,462
Sonoma,50,2022-11-28,454,461,461,0,4999,5070,5069,1,48,2,2,3,536,536,534,534
Stanislaus,50,2022-11-28,515,523,523,0,5357,5435,5434,1,77,0,0,4,1796,1796,1796,1796
Sutter,50,2022-11-28,82,82,82,0,1119,1137,1136,1,0,0,0,0,232,232,232,232
Tehama,50,2022-11-28,70,70,70,0,580,590,589,1,6,0,0,3,215,215,215,215
Trinity,50,2022-11-28,3,3,3,0,59,60,59,1,0,0,0,0,22,22,22,22
Tulare,50,2022-11-28,511,519,519,0,4925,4997,4996,1,34,0,0,0,1543,1543,1543,1543
Tuolumne,50,2022-11-28,72,72,72,0,675,687,686,1,4,0,0,0,206,206,206,206
Ventura,50,2022-11-28,959,973,973,0,10304,10453,10452,1,58,2,2,2,1604,1604,1602,1602
Yolo,50,2022-11-28,171,172,172,0,2025,2056,2055,1,3,4,4,1,424,424,420,420
Yuba,50,2022-11-28,92,92,92,0,921,934,933,1,12,0,0,0,121,121,121,121
Alameda,51,2022-12-05,2747,2794,2794,0,28706,29182,29181,1,126,7,8,13,2086,2087,2079,2079
Amador,51,2022-12-05,41,41,41,0,811,823,822,1,3,0,0,2,96,96,96,96
Butte,51,2022-12-05,238,242,242,0,1869,1901,1900,1,38,7,7,5,474,474,467,467
Calaveras,51,2022-12-05,47,47,47,0,483,492,491,1,0,1,1,0,136,136,135,135
Colusa,51,2022-12-05,12,12,12,0,206,209,208,1,4,0,0,0,22,22,22,22
Contra Costa,51,2022-12-05,1719,1748,1748,0,18614,18922,18921,1,78,0,0,11,1490,1490,1490,1490
Del Norte,51,2022-12-05,30,30,30,0,490,499,498,1,2,0,0,0,56,56,56,56
El Dorado,51,2022-12-05,181,182,182,0,1575,1603,1602,1,14,0,0,0,234,234,234,234
Fresno,51,2022-12-05,1522,1547,1547,0,14263,14500,14499,1,177,6,6,17,2915,2915,2909,2909
Glenn,51,2022-12-05,24,24,24,0,232,235,234,1,2,0,0,0,53,53,53,53
Humboldt,51,2022-12-05,120,120,120,0,988,1007,1006,1,17,1,1,2,164,164,163,163
Imperial,51,2022-12-05,585,594,594,0,3394,3450,3449,1,18,1,1,5,964,964,963,963
Inyo,51,2022-12-05,26,26,26,0,332,338,337,1,1,1,1,0,62,62,61,61
Kern,51,2022-12-05,797,810,810,0,10503,10678,10677,1,55,1,1,10,2445,2445,2444,2444
Kings,51,2022-12-05,295,300,300,0,3022,3073,3072,1,8,0,0,0,464,464,464,464
Lake,51,2022-12-05,62,62,62,0,828,842,841,1,2,0,0,0,148,148,148,148
Lassen,51,2022-12-05,14,14,14,0,444,453,452,1,0,0,0,0,64,64,64,64
Los Angeles,51,2022-12-05,22251,22621,22621,0,231258,235086,235083,3,1119,103,121,151,34177,34222,34074,34101
Madera,51,2022-12-05,206,209,209,0,1979,2012,2011,1,12,0,0,3,375,375,375,375
Marin,51,2022-12-05,311,318,318,0,3478,3538,3537,1,14,0,0,2,317,317,317,317
Mariposa,51,2022-12-05,19,19,19,0,172,175,174,1,0,0,0,0,30,30,30,30
Mendocino,51,2022-12-05,47,47,47,0,793,807,806,1,6,1,1,2,137,137,136,136
Merced,51,2022-12-05,341,348,348,0,3131,3184,3183,1,23,1,1,2,882,882,881,881
Modoc,51,2022-12-05,12,12,12,0,12,13,12,1,0,0,0,0,9,9,9,9
Mono,51,2022-12-05,9,9,9,0,91,92,91,1,0,0,0,0,8,8,8,8
Monterey,51,2022-12-05,266,272,272,0,4344,4417,4416,1,34,1,1,0,778,778,777,777
Napa,51,2022-12-05,159,160,160,0,2333,2372,2371,1,7,0,0,0,159,159,159,159
Nevada,51,2022-12-05,114,114,114,0,1090,1109,1108,1,8,0,0,2,132,132,132,132
Orange,51,2022-12-05,4167,4236,4236,0,33263,33812,33811,1,301,19,23,48,7643,7649,7624,7626
Placer,51,2022-12-05,390,396,396,0,4031,4100,4099,1,72,1,1,4,667,667,666,666
Plumas,51,2022-12-05,22,22,22,0,184,187,186,1,1,0,0,0,13,13,13,13
Riverside,51,2022-12-05,3951,4017,4017,0,26850,27293,27292,1,186,10,11,25,6690,6691,6680,6680
Sacramento,51,2022-12-05,2123,2158,2158,0,21056,21405,21404,1,128,7,7,28,3403,3403,3396,3396
San Benito,51,2022-12-05,219,223,223,0,807,821,820,1,6,1,1,3,103,103,102,102
San Bernardino,51,2022-12-05,3988,4054,4054,0,27986,28449,28448,1,167,0,0,34,8098,8098,8098,8098
San Diego,51,2022-12-05,5712,5807,5807,0,43516,44236,44235,1,302,11,13,30,5615,5617,5604,5604
San Francisco,51,2022-12-05,1482,1506,1506,0,15903,16166,16165,1,77,7,7,7,1103,1103,1096,1096
San Joaquin,51,2022-12-05,1111,1130,1130,0,12383,12589,12588,1,70,8,8,16,2362,2362,2354,2354
San Luis Obispo,51,2022-12-05,204,208,208,0,2652,2696,2695,1,15,3,3,1,537,537,534,534
San Mateo,51,2022-12-05,1226,1247,1247,0,13344,13565,13564,1,56,0,0,1,738,738,738,738
Santa Barbara,51,2022-12-05,521,530,530,0,6737,6849,6848,1,38,1,1,9,743,743,742,742
Santa Clara,51,2022-12-05,3457,3513,3513,0,34687,35262,35261,1,207,9,9,26,2575,2575,2566,2566
Santa Cruz,51,2022-12-05,470,477,477,0,11779,11975,11974,1,22,0,0,3,276,276,276,276
Shasta,51,2022-12-05,132,132,132,0,1100,1120,1119,1,23,0,0,5,597,597,597,597
Siskiyou,51,2022-12-05,22,22,22,0,306,314,313,1,2,0,0,0,95,95,95,95
Solano,51,2022-12-05,623,634,634,0,6487,6596,6595,1,33,1,1,7,465,465,464,464
Sonoma,51,2022-12-05,505,513,513,0,5876,5974,5973,1,35,4,4,1,540,540,536,536
Stanislaus,51,2022-12-05,639,649,649,0,6713,6825,6824,1,76,0,0,7,1796,1796,1796,1796
Sutter,51,2022-12-05,96,96,96,0,1169,1190,1189,1,0,1,1,0,233,233,232,232
Tehama,51,2022-12-05,92,92,92,0,706,720,719,1,9,2,2,0,217,217,215,215
Trinity,51,2022-12-05,3,3,3,0,38,39,38,1,0,0,0,0,22,22,22,22
Tulare,51,2022-12-05,526,534,534,0,5939,6039,6038,1,35,0,0,1,1543,1543,1543,1543
Tuolumne,51,2022-12-05,107,107,107,0,850,865,864,1,2,0,0,0,206,206,206,206
Ventura,51,2022-12-05,1094,1112,1112,0,11824,12021,12020,1,71,2,2,6,1606,1606,1604,1604
Yolo,51,2022-12-05,214,218,218,0,2594,2638,2637,1,2,1,1,3,425,425,424,424
Yuba,51,2022-12-05,82,82,82,0,1020,1038,1037,1,11,0,0,1,121,121,121,121
Alameda,52,2022-12-12,2595,2646,2646,0,28650,29216,29215,1,147,10,13,20,2096,2100,2086,2087
Amador,52,2022-12-12,32,32,32,0,785,803,802,1,3,0,0,0,96,96,96,96
Butte,52,2022-12-12,180,185,185,0,1810,1846,1845,1,39,2,2,2,476,476,474,474
Calaveras,52,2022-12-12,40,40,40,0,451,461,460,1,1,0,0,0,136,136,136,136
Colusa,52,2022-12-12,13,13,13,0,272,277,276,1,1,0,0,0,22,22,22,22
Contra Costa,52,2022-12-12,1681,1713,1713,0,17613,17962,17961,1,78,8,10,4,1498,1500,1490,1490
Del Norte,52,2022-12-12,27,27,27,0,469,480,479,1,3,0,0,0,56,56,56,56
El Dorado,52,2022-12-12,144,145,145,0,1404,1433,1432,1,8,0,0,3,234,234,234,234
Fresno,52,2022-12-12,1466,1494,1494,0,13763,14035,14034,1,186,11,15,18,2926,2930,2915,2915
Glenn,52,2022-12-12,17,17,17,0,227,233,232,1,6,0,0,0,53,53,53,53
Humboldt,52,2022-12-12,95,95,95,0,911,929,928,1,13,1,1,2,165,165,164,164
Imperial,52,2022-12-12,448,456,456,0,2933,2992,2991,1,27,0,0,3,964,964,964,964
Inyo,52,2022-12-12,22,22,22,0,303,309,308,1,1,0,0,0,62,62,62,62
Kern,52,2022-12-12,939,958,958,0,10733,10945,10944,1,55,1,1,4,2446,2446,2445,2445
Kings,52,2022-12-12,256,261,261,0,2827,2884,2883,1,8,2,2,0,466,466,464,464
Lake,52,2022-12-12,55,55,55,0,761,777,776,1,3,0,0,1,148,148,148,148
Lassen,52,2022-12-12,15,15,15,0,423,433,432,1,0,0,0,0,64,64,64,64
Los Angeles,52,2022-12-12,17332,17676,17676,0,213256,217478,217476,2,1113,140,176,154,34317,34398,34177,34222
Madera,52,2022-12-12,212,215,215,0,2164,2207,2206,1,15,0,0,2,375,375,375,375
Marin,52,2022-12-12,314,320,320,0,3575,3646,3645,1,24,0,0,2,317,317,317,317
Mariposa,52,2022-12-12,18,18,18,0,121,124,123,1,0,0,0,0,30,30,30,30
Mendocino,52,2022-12-12,54,54,54,0,654,668,667,1,7,0,0,0,137,137,137,137
Merced,52,2022-12-12,280,285,285,0,3160,3224,3223,1,14,0,0,2,882,882,882,882
Modoc,52,2022-12-12,5,5,5,0,10,11,10,1,0,0,0,0,9,9,9,9
Mono,52,2022-12-12,9,9,9,0,121,122,121,1,0,0,0,0,8,8,8,8
Monterey,52,2022-12-12,263,270,270,0,4221,4306,4305,1,25,1,1,2,779,779,778,778
Napa,52,2022-12-12,163,165,165,0,2168,2213,2212,1,9,1,1,0,160,160,159,159
Nevada,52,2022-12-12,90,90,90,0,922,941,940,1,5,0,0,2,132,132,132,132
Orange,52,2022-12-12,3385,3452,3452,0,30160,30757,30756,1,300,30,38,48,7673,7687,7643,7649
Placer,52,2022-12-12,327,334,334,0,3857,3934,3933,1,73,3,3,6,670,670,667,667
Plumas,52,2022-12-12,7,7,7,0,186,190,189,1,2,0,0,0,13,13,13,13
Riverside,52,2022-12-12,3297,3362,3362,0,24168,24647,24646,1,204,13,16,25,6703,6707,6690,6691
Sacramento,52,2022-12-12,1800,1836,1836,0,19872,20264,20263,1,173,7,9,31,3410,3412,3403,3403
San Benito,52,2022-12-12,124,125,125,0,645,658,657,1,2,2,2,2,105,105,103,103
San Bernardino,52,2022-12-12,3508,3578,3578,0,26400,26923,26922,1,226,4,4,36,8102,8102,8098,8098
San Diego,52,2022-12-12,4699,4792,4792,0,39714,40501,40500,1,331,14,17,45,5629,5634,5615,5617
San Francisco,52,2022-12-12,1414,1441,1441,0,16561,16891,16890,1,103,5,6,12,1108,1109,1103,1103
San Joaquin,52,2022-12-12,992,1012,1012,0,12281,12526,12525,1,68,5,6,19,2367,2368,2362,2362
San Luis Obispo,52,2022-12-12,222,227,227,0,2600,2653,2652,1,10,1,1,0,538,538,537,537
San Mateo,52,2022-12-12,1149,1171,1171,0,12207,12450,12449,1,59,0,0,3,738,738,738,738
Santa Barbara,52,2022-12-12,509,519,519,0,5689,5803,5802,1,36,2,2,6,745,745,743,743
Santa Clara,52,2022-12-12,3220,3284,3284,0,33774,34442,34441,1,198,7,9,30,2582,2584,2575,2575
Santa Cruz,52,2022-12-12,574,586,586,0,12392,12641,12640,1,29,0,0,1,276,276,276,276
Shasta,52,2022-12-12,95,95,95,0,1122,1144,1143,1,22,0,0,5,597,597,597,597
Siskiyou,52,2022-12-12,15,15,15,0,237,244,243,1,2,0,0,0,95,95,95,95
Solano,52,2022-12-12,628,641,641,0,6113,6234,6233,1,42,1,1,7,466,466,465,465
Sonoma,52,2022-12-12,564,576,576,0,5562,5674,5673,1,41,1,1,7,541,541,540,540
Stanislaus,52,2022-12-12,581,592,592,0,6287,6413,6412,1,104,0,0,12,1796,1796,1796,1796
Sutter,52,2022-12-12,113,113,113,0,1146,1169,1168,1,0,0,0,0,233,233,233,233
Tehama,52,2022-12-12,79,79,79,0,535,547,546,1,6,1,1,0,218,218,217,217
Trinity,52,2022-12-12,3,3,3,0,45,46,45,1,0,0,0,0,22,22,22,22
Tulare,52,2022-12-12,438,447,447,0,5845,5962,5961,1,27,0,0,2,1543,1543,1543,1543
Tuolumne,52,2022-12-12,128,129,129,0,932,952,951,1,5,0,0,0,206,206,206,206
Ventura,52,2022-12-12,909,927,927,0,10273,10478,10477,1,72,4,4,7,1610,1610,1606,1606
Yolo,52,2022-12-12,210,215,215,0,2290,2337,2336,1,5,2,2,2,427,427,425,425
Yuba,52,2022-12-12,75,75,75,0,930,949,948,1,13,0,0,0,121,121,121,121
Alameda,53,2022-12-19,2244,2301,2301,0,26032,26686,26685,1,144,9,12,19,2105,2112,2096,2100
Amador,53,2022-12-19,40,40,40,0,805,826,825,1,6,0,0,0,96,96,96,96
Butte,53,2022-12-19,127,130,130,0,1499,1538,1537,1,34,2,4,2,478,480,476,476
Calaveras,53,2022-12-19,26,26,26,0,438,450,449,1,1,1,1,0,137,137,136,136
Colusa,53,2022-12-19,12,12,12,0,213,219,218,1,1,0,0,0,22,22,22,22
Contra Costa,53,2022-12-19,1636,1678,1678,0,16469,16884,16883,1,95,4,6,7,1502,1506,1498,1500
Del Norte,53,2022-12-19,29,29,29,0,490,503,502,1,3,0,0,0,56,56,56,56
El Dorado,53,2022-12-19,159,164,164,0,1625,1666,1665,1,9,1,1,2,235,235,234,234
Fresno,53,2022-12-19,1149,1178,1178,0,12736,13058,13057,1,212,5,7,22,2931,2937,2926,2930
Glenn,53,2022-12-19,21,21,21,0,203,209,208,1,6,0,0,0,53,53,53,53
Humboldt,53,2022-12-19,95,96,96,0,876,899,898,1,9,0,0,1,165,165,165,165
Imperial,53,2022-12-19,250,255,255,0,2536,2600,2599,1,16,0,0,0,964,964,964,964
Inyo,53,2022-12-19,12,12,12,0,323,331,330,1,1,0,0,0,62,62,62,62
Kern,53,2022-12-19,878,900,900,0,10544,10811,10810,1,60,2,3,5,2448,2449,2446,2446
Kings,53,2022-12-19,229,235,235,0,2701,2768,2767,1,6,3,5,1,469,471,466,466
Lake,53,2022-12-19,62,62,62,0,791,811,810,1,4,0,0,0,148,148,148,148
Lassen,53,2022-12-19,8,8,8,0,466,478,477,1,0,0,0,0,64,64,64,64
Los Angeles,53,2022-12-19,15017,15396,15396,0,190651,195428,195426,2,1096,107,152,155,34424,34550,34317,34398
Madera,53,2022-12-19,175,182,182,0,1882,1931,1930,1,10,0,0,1,375,375,375,375
Marin,53,2022-12-19,267,273,273,0,3188,3269,3268,1,17,0,0,0,317,317,317,317
Mariposa,53,2022-12-19,10,10,10,0,133,137,136,1,0,0,0,0,30,30,30,30
Mendocino,53,2022-12-19,63,63,63,0,752,772,771,1,4,0,0,0,137,137,137,137
Merced,53,2022-12-19,228,234,234,0,2684,2752,2751,1,15,0,0,2,882,882,882,882
Modoc,53,2022-12-19,8,8,8,0,20,21,20,1,0,0,0,0,9,9,9,9
Mono,53,2022-12-19,11,11,11,0,120,123,122,1,1,0,0,0,8,8,8,8
Monterey,53,2022-12-19,220,227,227,0,3802,3898,3897,1,13,1,2,1,780,781,779,779
Napa,53,2022-12-19,181,185,185,0,2085,2139,2138,1,8,0,0,0,160,160,160,160
Nevada,53,2022-12-19,67,67,67,0,848,870,869,1,5,0,0,2,132,132,132,132
Orange,53,2022-12-19,3199,3281,3281,0,28911,29639,29638,1,296,23,33,51,7696,7720,7673,7687
Placer,53,2022-12-19,356,365,365,0,3807,3905,3904,1,90,1,1,10,671,671,670,670
Plumas,53,2022-12-19,8,8,8,0,187,193,192,1,0,0,0,0,13,13,13,13
Riverside,53,2022-12-19,3084,3163,3163,0,22284,22847,22846,1,177,16,23,22,6719,6730,6703,6707
Sacramento,53,2022-12-19,1718,1760,1760,0,19368,19859,19858,1,210,12,17,22,3422,3429,3410,3412
San Benito,53,2022-12-19,99,100,100,0,499,512,511,1,0,4,6,1,109,111,105,105
San Bernardino,53,2022-12-19,3115,3194,3194,0,24356,24970,24969,1,200,3,4,38,8105,8106,8102,8102
San Diego,53,2022-12-19,4685,4804,4804,0,38292,39253,39252,1,381,16,23,45,5645,5657,5629,5634
San Francisco,53,2022-12-19,1203,1234,1234,0,15466,15854,15853,1,106,8,11,17,1116,1120,1108,1109
San Joaquin,53,2022-12-19,836,858,858,0,12538,12855,12854,1,58,8,12,19,2375,2380,2367,2368
San Luis Obispo,53,2022-12-19,225,230,230,0,2345,2405,2404,1,17,1,1,0,539,539,538,538
San Mateo,53,2022-12-19,901,924,924,0,11593,11885,11884,1,62,0,0,5,738,738,738,738
Santa Barbara,53,2022-12-19,451,462,462,0,5148,5277,5276,1,35,4,6,5,749,751,745,745
Santa Clara,53,2022-12-19,2767,2836,2836,0,31162,31945,31944,1,205,2,2,30,2584,2586,2582,2584
Santa Cruz,53,2022-12-19,250,257,257,0,10341,10602,10601,1,31,0,0,1,276,276,276,276
Shasta,53,2022-12-19,101,102,102,0,1095,1124,1123,1,24,1,1,4,598,598,597,597
Siskiyou,53,2022-12-19,15,15,15,0,258,266,265,1,2,0,0,0,95,95,95,95
Solano,53,2022-12-19,628,644,644,0,6064,6217,6216,1,41,1,1,6,467,467,466,466
Sonoma,53,2022-12-19,457,466,466,0,5390,5526,5525,1,38,1,1,4,542,542,541,541
Stanislaus,53,2022-12-19,463,475,475,0,5914,6064,6063,1,94,0,0,12,1796,1796,1796,1796
Sutter,53,2022-12-19,77,77,77,0,1053,1080,1079,1,0,1,2,0,234,235,233,233
Tehama,53,2022-12-19,67,67,67,0,519,533,532,1,6,0,0,0,218,218,218,218
Trinity,53,2022-12-19,2,2,2,0,31,32,31,1,0,0,0,0,22,22,22,22
Tulare,53,2022-12-19,451,461,461,0,5229,5362,5361,1,53,3,4,1,1546,1547,1543,1543
Tuolumne,53,2022-12-19,81,81,81,0,838,860,859,1,2,1,2,1,207,208,206,206
Ventura,53,2022-12-19,906,930,930,0,9512,9753,9752,1,81,3,4,9,1613,1614,1610,1610
Yolo,53,2022-12-19,162,167,167,0,1905,1955,1954,1,5,3,5,0,430,432,427,427
Yuba,53,2022-12-19,81,82,82,0,851,873,872,1,7,0,0,0,121,121,121,121
Alameda,54,2022-12-26,1903,1969,1969,0,20005,20687,20686,1,150,3,7,17,2108,2119,2105,2112
Amador,54,2022-12-26,41,41,41,0,758,784,783,1,5,0,0,0,96,96,96,96
Butte,54,2022-12-26,90,94,94,0,1293,1338,1337,1,33,0,0,1,478,480,478,480
Calaveras,54,2022-12-26,20,20,20,0,364,378,377,1,0,1,2,0,138,139,137,137
Colusa,54,2022-12-26,14,14,14,0,150,157,156,1,0,0,0,0,22,22,22,22
Contra Costa,54,2022-12-26,1379,1427,1427,0,13239,13692,13691,1,89,0,0,11,1502,1506,1502,1506
Del Norte,54,2022-12-26,28,28,28,0,395,409,408,1,3,0,0,0,56,56,56,56
El Dorado,54,2022-12-26,143,150,150,0,1316,1363,1362,1,7,0,0,0,235,235,235,235
Fresno,54,2022-12-26,1049,1085,1085,0,10609,10975,10974,1,186,6,11,33,2937,2948,2931,2937
Glenn,54,2022-12-26,12,12,12,0,193,201,200,1,0,0,0,0,53,53,53,53
Humboldt,54,2022-12-26,66,66,66,0,599,620,619,1,5,1,2,2,166,167,165,165
Imperial,54,2022-12-26,223,230,230,0,2157,2231,2230,1,67,0,0,0,964,964,964,964
Inyo,54,2022-12-26,13,13,13,0,157,165,164,1,1,0,0,0,62,62,62,62
Kern,54,2022-12-26,631,653,653,0,8648,8946,8945,1,51,3,6,8,2451,2455,2448,2449
Kings,54,2022-12-26,198,204,204,0,2254,2333,2332,1,5,0,0,2,469,471,469,471
Lake,54,2022-12-26,49,49,49,0,600,623,622,1,3,0,0,1,148,148,148,148
Lassen,54,2022-12-26,27,27,27,0,485,503,502,1,0,0,0,0,64,64,64,64
Los Angeles,54,2022-12-26,12973,13425,13425,0,126520,130850,130849,1,1032,106,206,164,34530,34756,34424,34550
Madera,54,2022-12-26,160,166,166,0,1559,1614,1613,1,6,0,0,1,375,375,375,375
Marin,54,2022-12-26,208,215,215,0,2539,2627,2626,1,29,0,0,2,317,317,317,317
Mariposa,54,2022-12-26,9,9,9,0,104,108,107,1,0,0,0,0,30,30,30,30
Mendocino,54,2022-12-26,73,74,74,0,646,669,668,1,10,0,0,0,137,137,137,137
Merced,54,2022-12-26,188,194,194,0,1925,1991,1990,1,17,0,0,3,882,882,882,882
Modoc,54,2022-12-26,4,4,4,0,11,12,11,1,0,0,0,0,9,9,9,9
Mono,54,2022-12-26,9,9,9,0,82,85,84,1,0,0,0,0,8,8,8,8
Monterey,54,2022-12-26,168,175,175,0,2934,3038,3037,1,21,1,2,0,781,783,780,781
Napa,54,2022-12-26,141,148,148,0,1716,1775,1774,1,12,0,0,0,160,160,160,160
Nevada,54,2022-12-26,59,59,59,0,747,775,774,1,9,0,0,1,132,132,132,132
Orange,54,2022-12-26,3114,3222,3222,0,23695,24509,24508,1,274,25,48,31,7721,7768,7696,7720
Placer,54,2022-12-26,284,294,294,0,3033,3138,3137,1,87,0,0,12,671,671,671,671
Plumas,54,2022-12-26,9,9,9,0,123,128,127,1,0,0,0,0,13,13,13,13
Riverside,54,2022-12-26,2823,2920,2920,0,17978,18598,18597,1,194,4,7,18,6723,6737,6719,6730
Sacramento,54,2022-12-26,1365,1413,1413,0,14451,14948,14947,1,179,8,18,25,3430,3447,3422,3429
San Benito,54,2022-12-26,101,105,105,0,400,414,413,1,1,0,0,1,109,111,109,111
San Bernardino,54,2022-12-26,2818,2916,2916,0,19744,20425,20424,1,210,1,3,26,8106,8109,8105,8106
San Diego,54,2022-12-26,4435,4588,4588,0,27725,28672,28671,1,395,23,48,45,5668,5705,5645,5657
San Francisco,54,2022-12-26,1002,1038,1038,0,11717,12118,12117,1,90,4,9,15,1120,1129,1116,1120
San Joaquin,54,2022-12-26,744,771,771,0,10053,10402,10401,1,60,2,4,10,2377,2384,2375,2380
San Luis Obispo,54,2022-12-26,188,194,194,0,1952,2020,2019,1,20,0,0,0,539,539,539,539
San Mateo,54,2022-12-26,806,834,834,0,8766,9066,9065,1,55,0,0,6,738,738,738,738
Santa Barbara,54,2022-12-26,477,495,495,0,4076,4218,4217,1,40,0,0,4,749,751,749,751
Santa Clara,54,2022-12-26,2253,2331,2331,0,23282,24079,24078,1,179,0,0,35,2584,2586,2584,2586
Santa Cruz,54,2022-12-26,210,219,219,0,4547,4699,4698,1,25,0,0,2,276,276,276,276
Shasta,54,2022-12-26,92,94,94,0,910,942,941,1,18,0,0,1,598,598,598,598
Siskiyou,54,2022-12-26,16,16,16,0,264,275,274,1,1,0,0,0,95,95,95,95
Solano,54,2022-12-26,645,667,667,0,5229,5409,5408,1,59,1,3,7,468,470,467,467
Sonoma,54,2022-12-26,438,454,454,0,4237,4384,4383,1,39,0,0,4,542,542,542,542
Stanislaus,54,2022-12-26,441,455,455,0,4879,5048,5047,1,96,0,0,5,1796,1796,1796,1796
Sutter,54,2022-12-26,122,126,126,0,925,958,957,1,0,0,0,0,234,235,234,235
Tehama,54,2022-12-26,45,45,45,0,525,544,543,1,2,1,2,0,219,220,218,218
Trinity,54,2022-12-26,3,3,3,0,39,40,39,1,0,0,0,0,22,22,22,22
Tulare,54,2022-12-26,426,441,441,0,3866,4003,4002,1,41,3,7,3,1549,1554,1546,1547
Tuolumne,54,2022-12-26,87,89,89,0,756,783,782,1,6,0,0,2,207,208,207,208
Ventura,54,2022-12-26,852,882,882,0,7668,7934,7933,1,71,13,26,11,1626,1640,1613,1614
Yolo,54,2022-12-26,134,138,138,0,1600,1656,1655,1,9,2,4,1,432,436,430,432
Yuba,54,2022-12-26,98,101,101,0,752,779,778,1,14,0,0,0,121,121,121,121
Alameda,55,2023-01-02,1735,1841,1841,0,19427,20628,20627,1,175,2,7,19,2110,2126,2108,2119
Amador,55,2023-01-02,31,32,32,0,673,718,717,1,3,0,0,0,96,96,96,96
Butte,55,2023-01-02,87,91,91,0,1325,1409,1408,1,35,0,0,2,478,480,478,480
Calaveras,55,2023-01-02,33,33,33,0,359,381,380,1,0,0,0,0,138,139,138,139
Colusa,55,2023-01-02,4,4,4,0,94,100,99,1,0,0,0,0,22,22,22,22
Contra Costa,55,2023-01-02,1281,1361,1361,0,13514,14346,14345,1,89,0,0,13,1502,1506,1502,1506
Del Norte,55,2023-01-02,33,33,33,0,385,411,410,1,3,0,0,2,56,56,56,56
El Dorado,55,2023-01-02,139,147,147,0,1397,1485,1484,1,7,0,0,2,235,235,235,235
Fresno,55,2023-01-02,1024,1088,1088,0,11121,11815,11814,1,195,0,0,28,2937,2948,2937,2948
Glenn,55,2023-01-02,11,11,11,0,188,202,201,1,0,0,0,0,53,53,53,53
Humboldt,55,2023-01-02,41,43,43,0,590,628,627,1,2,0,0,2,166,167,166,167
Imperial,55,2023-01-02,183,193,193,0,2000,2120,2119,1,11,0,0,1,964,964,964,964
Inyo,55,2023-01-02,16,16,16,0,225,240,239,1,1,0,0,0,62,62,62,62
Kern,55,2023-01-02,759,805,805,0,9428,10004,10003,1,66,1,3,8,2452,2458,2451,2455
Kings,55,2023-01-02,182,194,194,0,2119,2248,2247,1,4,0,0,1,469,471,469,471
Lake,55,2023-01-02,49,51,51,0,602,642,641,1,3,0,0,0,148,148,148,148
Lassen,55,2023-01-02,14,14,14,0,490,520,519,1,0,0,0,0,64,64,64,64
Los Angeles,55,2023-01-02,12449,13227,13227,0,125389,133296,133294,2,1091,80,372,154,34610,35128,34530,34756
Madera,55,2023-01-02,145,154,154,0,1646,1749,1748,1,7,0,0,0,375,375,375,375
Marin,55,2023-01-02,208,221,221,0,2366,2513,2512,1,24,0,0,2,317,317,317,317
Mariposa,55,2023-01-02,9,9,9,0,94,101,100,1,0,0,0,0,30,30,30,30
Mendocino,55,2023-01-02,54,57,57,0,684,727,726,1,6,0,0,3,137,137,137,137
Merced,55,2023-01-02,161,172,172,0,1926,2046,2045,1,8,0,0,4,882,882,882,882
Modoc,55,2023-01-02,9,9,9,0,13,14,13,1,0,0,0,0,9,9,9,9
Mono,55,2023-01-02,10,10,10,0,66,71,70,1,0,0,0,0,8,8,8,8
Monterey,55,2023-01-02,199,212,212,0,3014,3209,3208,1,27,0,0,0,781,783,781,783
Napa,55,2023-01-02,121,128,128,0,1675,1777,1776,1,8,1,3,1,161,163,160,160
Nevada,55,2023-01-02,50,52,52,0,718,766,765,1,8,0,0,2,132,132,132,132
Orange,55,2023-01-02,3111,3305,3305,0,23923,25415,25414,1,312,2,6,28,7723,7774,7721,7768
Placer,55,2023-01-02,297,316,316,0,3223,3428,3427,1,108,0,0,8,671,671,671,671
Plumas,55,2023-01-02,10,10,10,0,143,152,151,1,1,0,0,0,13,13,13,13
Riverside,55,2023-01-02,2849,3027,3027,0,18867,20047,20046,1,223,3,12,31,6726,6749,6723,6737
Sacramento,55,2023-01-02,1483,1573,1573,0,15113,16043,16042,1,201,2,9,26,3432,3456,3430,3447
San Benito,55,2023-01-02,51,53,53,0,411,438,437,1,1,0,0,1,109,111,109,111
San Bernardino,55,2023-01-02,2729,2896,2896,0,20167,21427,21426,1,183,0,0,31,8106,8109,8106,8109
San Diego,55,2023-01-02,4507,4780,4780,0,28127,29884,29883,1,401,13,56,43,5681,5761,5668,5705
San Francisco,55,2023-01-02,860,914,914,0,10000,10631,10630,1,77,1,3,15,1121,1132,1120,1129
San Joaquin,55,2023-01-02,724,768,768,0,10363,11000,10999,1,62,0,0,12,2377,2384,2377,2384
San Luis Obispo,55,2023-01-02,178,190,190,0,1930,2049,2048,1,17,0,0,0,539,539,539,539
San Mateo,55,2023-01-02,692,734,734,0,7810,8293,8292,1,50,0,0,9,738,738,738,738
Santa Barbara,55,2023-01-02,408,435,435,0,3956,4213,4212,1,47,1,4,5,750,755,749,751
Santa Clara,55,2023-01-02,2291,2433,2433,0,21918,23288,23287,1,200,0,0,32,2584,2586,2584,2586
Santa Cruz,55,2023-01-02,153,163,163,0,2728,2894,2893,1,27,0,0,0,276,276,276,276
Shasta,55,2023-01-02,90,95,95,0,913,969,968,1,20,0,0,1,598,598,598,598
Siskiyou,55,2023-01-02,15,15,15,0,268,285,284,1,1,0,0,0,95,95,95,95
Solano,55,2023-01-02,627,665,665,0,5273,5602,5601,1,60,3,10,11,471,480,468,470
Sonoma,55,2023-01-02,408,433,433,0,4247,4518,4517,1,56,0,0,2,542,542,542,542
Stanislaus,55,2023-01-02,454,482,482,0,4991,5299,5298,1,88,0,0,8,1796,1796,1796,1796
Sutter,55,2023-01-02,92,98,98,0,882,937,936,1,0,0,0,0,234,235,234,235
Tehama,55,2023-01-02,48,51,51,0,482,514,513,1,2,1,3,0,220,223,219,220
Trinity,55,2023-01-02,2,2,2,0,38,39,38,1,0,0,0,0,22,22,22,22
Tulare,55,2023-01-02,435,462,462,0,4499,4777,4776,1,52,0,0,6,1549,1554,1549,1554
Tuolumne,55,2023-01-02,56,59,59,0,658,699,698,1,5,0,0,0,207,208,207,208
Ventura,55,2023-01-02,848,900,900,0,7107,7554,7553,1,87,4,13,13,1630,1653,1626,1640
Yolo,55,2023-01-02,124,132,132,0,1490,1585,1584,1,4,0,0,1,432,436,432,436
Yuba,55,2023-01-02,78,84,84,0,730,778,777,1,19,0,0,1,121,121,121,121
Alameda,56,2023-01-09,1239,3555,3555,0,19126,48032,48031,1,149,1,9,11,2111,2135,2110,2126
Amador,56,2023-01-09,23,71,71,0,573,1235,1234,1,2,0,0,0,96,96,96,96
Butte,56,2023-01-09,63,107,107,0,1045,2809,2808,1,39,0,0,3,478,480,478,480
Calaveras,56,2023-01-09,13,42,42,0,281,713,712,1,0,0,0,1,138,139,138,139
Colusa,56,2023-01-09,7,26,26,0,66,123,122,1,0,0,0,0,22,22,22,22
Contra Costa,56,2023-01-09,855,2006,2006,0,13009,31318,31316,2,85,0,0,11,1502,1506,1502,1506
Del Norte,56,2023-01-09,13,34,34,0,277,685,684,1,5,0,0,2,56,56,56,56
El Dorado,56,2023-01-09,61,124,124,0,1140,2955,2954,1,4,0,0,0,235,235,235,235
Fresno,56,2023-01-09,637,1430,1430,0,9311,20073,20072,1,171,0,0,23,2937,2948,2937,2948
Glenn,56,2023-01-09,9,29,29,0,105,316,315,1,0,0,0,0,53,53,53,53
Humboldt,56,2023-01-09,36,108,108,0,592,1572,1571,1,7,0,0,4,166,167,166,167
Imperial,56,2023-01-09,125,374,374,0,2101,5447,5446,1,12,0,0,2,964,964,964,964
Inyo,56,2023-01-09,9,25,25,0,180,511,510,1,0,0,0,0,62,62,62,62
Kern,56,2023-01-09,423,862,862,0,7738,15377,15376,1,73,0,0,8,2452,2458,2452,2458
Kings,56,2023-01-09,149,334,334,0,1844,4104,4103,1,9,0,0,0,469,471,469,471
Lake,56,2023-01-09,33,78,78,0,563,1621,1620,1,3,0,0,0,148,148,148,148
Lassen,56,2023-01-09,17,27,27,0,400,683,682,1,2,0,0,0,64,64,64,64
Los Angeles,56,2023-01-09,7004,10271,10271,0,108192,143770,143768,2,965,37,565,136,34647,35693,34610,35128
Madera,56,2023-01-09,71,153,153,0,1338,2649,2648,1,8,0,0,1,375,375,375,375
Marin,56,2023-01-09,124,362,362,0,2176,4889,4888,1,18,0,0,3,317,317,317,317
Mariposa,56,2023-01-09,7,8,8,0,76,220,219,1,0,0,0,0,30,30,30,30
Mendocino,56,2023-01-09,31,137,137,0,585,1940,1939,1,10,0,0,3,137,137,137,137
Merced,56,2023-01-09,96,263,263,0,1312,3042,3041,1,11,0,0,1,882,882,882,882
Modoc,56,2023-01-09,6,6,6,0,11,29,28,1,0,0,0,0,9,9,9,9
Mono,56,2023-01-09,12,56,56,0,73,183,182,1,0,0,0,0,8,8,8,8
Monterey,56,2023-01-09,127,390,390,0,2577,6261,6260,1,20,0,0,3,781,783,781,783
Napa,56,2023-01-09,105,317,317,0,1520,4216,4215,1,9,0,0,3,161,163,161,163
Nevada,56,2023-01-09,20,53,53,0,426,915,914,1,6,0,0,0,132,132,132,132
Orange,56,2023-01-09,2041,4445,4445,0,22423,54262,54261,1,267,0,0,34,7723,7774,7723,7774
Placer,56,2023-01-09,208,627,627,0,2854,7394,7393,1,89,0,0,6,671,671,671,671
Plumas,56,2023-01-09,5,6,6,0,82,232,231,1,1,0,0,0,13,13,13,13
Riverside,56,2023-01-09,1426,2634,2634,0,15861,33277,33276,1,186,1,9,26,6727,6758,6726,6749
Sacramento,56,2023-01-09,768,1967,1967,0,12207,28714,28713,1,178,0,0,28,3432,3456,3432,3456
San Benito,56,2023-01-09,44,135,135,0,734,2833,2832,1,1,0,0,2,109,111,109,111
San Bernardino,56,2023-01-09,1298,2559,2559,0,15960,31305,31304,1,179,1,9,36,8107,8118,8106,8109
San Diego,56,2023-01-09,3022,6020,6020,0,27042,62837,62836,1,397,0,0,40,5681,5761,5681,5761
San Francisco,56,2023-01-09,637,1602,1602,0,10494,24950,24948,2,75,2,48,17,1123,1180,1121,1132
San Joaquin,56,2023-01-09,481,1329,1329,0,8108,17628,17627,1,51,0,0,12,2377,2384,2377,2384
San Luis Obispo,56,2023-01-09,151,232,232,0,1815,3218,3217,1,12,0,0,0,539,539,539,539
San Mateo,56,2023-01-09,482,1110,1110,0,7864,18555,18554,1,47,0,0,5,738,738,738,738
Santa Barbara,56,2023-01-09,327,634,634,0,3894,7995,7994,1,39,0,0,1,750,755,750,755
Santa Clara,56,2023-01-09,1526,3628,3628,0,21291,47181,47180,1,182,0,0,28,2584,2586,2584,2586
Santa Cruz,56,2023-01-09,113,212,212,0,2714,4656,4655,1,27,0,0,1,276,276,276,276
Shasta,56,2023-01-09,20,28,28,0,486,836,835,1,17,0,0,2,598,598,598,598
Siskiyou,56,2023-01-09,11,58,58,0,176,616,615,1,0,0,0,0,95,95,95,95
Solano,56,2023-01-09,347,1184,1184,0,4449,12906,12905,1,54,0,0,6,471,480,471,480
Sonoma,56,2023-01-09,257,738,738,0,4140,10804,10803,1,31,0,0,4,542,542,542,542
Stanislaus,56,2023-01-09,249,649,649,0,4354,10426,10425,1,87,0,0,8,1796,1796,1796,1796
Sutter,56,2023-01-09,52,189,189,0,812,2039,2038,1,0,0,0,0,234,235,234,235
Tehama,56,2023-01-09,10,13,13,0,193,389,388,1,1,0,0,0,220,223,220,223
Trinity,56,2023-01-09,1,1,1,0,23,62,61,1,0,0,0,0,22,22,22,22
Tulare,56,2023-01-09,291,660,660,0,3836,8478,8477,1,53,0,0,2,1549,1554,1549,1554
Tuolumne,56,2023-01-09,60,144,144,0,569,1373,1372,1,2,0,0,0,207,208,207,208
Ventura,56,2023-01-09,512,1082,1082,0,7461,16034,16033,1,65,0,0,12,1630,1653,1630,1653
Yolo,56,2023-01-09,78,239,239,0,1305,3528,3527,1,2,0,0,1,432,436,432,436
Yuba,56,2023-01-09,44,101,101,0,676,1560,1559,1,21,0,0,1,121,121,121,121
California,1,2021-12-20,84258,84263,47170,37093,2162732,2162993,1234154,928839,2585,502,502,932,77346,77346,76844,76844
California,2,2021-12-27,241797,241819,151848,89971,1953503,1953781,1192278,761503,3348,496,496,1030,77842,77842,77346,77346
California,3,2022-01-03,549196,549285,369118,180167,2955552,2956131,1966277,989854,6125,587,587,1280,78429,78429,77842,77842
California,4,2022-01-10,865751,865943,619122,246821,4664953,4666093,3353521,1312572,10002,945,945,1813,79374,79374,78429,78429
California,5,2022-01-17,660459,660641,492417,168224,3983155,3984376,3022418,961958,12343,1427,1427,2311,80801,80801,79374,79374
California,6,2022-01-24,526958,527156,412436,114720,3988454,3990122,3194217,795905,12648,1775,1775,2600,82576,82576,80801,80801
California,7,2022-01-31,270252,270362,219742,50620,3154459,3156083,2636970,519113,10873,1905,1905,2494,84481,84481,82576,82576
California,8,2022-02-07,149211,149276,125760,23516,2669743,2671334,2319013,352321,8405,1776,1776,2007,86257,86257,84481,84481
California,9,2022-02-14,85787,85816,74806,11010,2321908,2323497,2080232,243265,6407,1426,1426,1564,87683,87683,86257,86257
California,10,2022-02-21,48057,48070,43045,5025,1849493,1850872,1692102,158770,4557,1001,1001,1098,88684,88684,87683,87683
California,11,2022-02-28,32661,32667,29957,2710,2097509,2099254,1962296,136958,3357,692,692,772,89376,89376,88684,88684
California,12,2022-03-07,22985,22991,21483,1508,1817047,1818759,1724233,94526,2435,500,500,581,89876,89876,89376,89376
California,13,2022-03-14,16964,16969,16091,878,1724011,1725797,1655443,70354,1844,358,358,419,90234,90234,89876,89876
California,14,2022-03-21,14637,14642,14059,583,1645007,1646806,1594092,52714,1537,252,252,313,90486,90486,90234,90234
California,15,2022-03-28,15459,15466,14989,477,1461844,1463538,1425934,37604,1150,178,178,264,90664,90664,90486,90486
California,16,2022-04-04,17676,17683,17266,417,1523206,1525049,1495527,29522,943,140,140,211,90804,90804,90664,90664
California,17,2022-04-11,21485,21493,21100,393,1341509,1343175,1322337,20838,905,124,124,148,90928,90928,90804,90804
California,18,2022-04-18,26835,26850,26460,390,1130727,1132184,1117285,14899,823,110,110,141,91038,91038,90928,90928
California,19,2022-04-25,37190,37218,36790,428,1621583,1623735,1608874,14861,838,91,91,112,91129,91129,91038,91038
California,20,2022-05-02,48860,48909,48475,434,1700474,1702804,1690569,12235,950,85,85,143,91214,91214,91129,91129
California,21,2022-05-09,63276,63348,62903,445,1769333,1771899,1761858,10041,1050,85,85,153,91299,91299,91214,91214
California,22,2022-05-16,80211,80318,79867,451,1839059,1841840,1833586,8254,1345,118,118,182,91417,91417,91299,91299
California,23,2022-05-23,97644,97773,97354,419,1869341,1872254,1865655,6599,1714,117,117,217,91534,91534,91417,91417
California,24,2022-05-30,90338,90458,90150,308,1497898,1500297,1496044,4253,1918,147,147,272,91681,91681,91534,91534
California,25,2022-06-06,120500,120676,120358,318,1937780,1940974,1936878,4096,2305,138,138,276,91819,91819,91681,91681
California,26,2022-06-13,105193,105349,105132,217,1405156,1407529,1405047,2482,2471,177,177,291,91996,91996,91819,91819
California,27,2022-06-20,101219,101369,101207,162,1025122,1026908,1025321,1587,2552,211,211,310,92207,92207,91996,91996
California,28,2022-06-27,115357,115544,115406,138,1042218,1044078,1042827,1251,3006,217,217,339,92424,92424,92207,92207
California,29,2022-07-04,108168,108349,108247,102,834986,836540,835735,805,3167,272,272,393,92696,92696,92424,92424
California,30,2022-07-11,141191,141445,141346,99,1081768,1083903,1083111,792,3824,293,293,453,92989,92989,92696,92696
California,31,2022-07-18,129597,129842,129770,72,992090,994151,993587,564,4148,294,294,528,93283,93283,92989,92989
California,32,2022-07-25,117500,117727,117679,48,947161,949216,948792,424,4310,356,356,516,93639,93639,93283,93283
California,33,2022-08-01,99131,99331,99298,33,874044,876025,875713,312,4119,360,360,535,93999,93999,93639,93639
California,34,2022-08-08,82984,83153,83134,19,818797,820760,820530,230,3754,326,326,474,94325,94325,93999,93999
California,35,2022-08-15,68677,68827,68815,12,788455,790464,790282,182,3363,295,295,448,94620,94620,94325,94325
California,36,2022-08-22,61051,61187,61181,6,772524,774638,774492,146,3087,279,279,418,94899,94899,94620,94620
California,37,2022-08-29,51436,51557,51554,3,762210,764451,764330,121,2752,215,215,351,95114,95114,94899,94899
California,38,2022-09-05,36409,36494,36494,0,624815,626791,626703,88,2525,242,242,350,95356,95356,95114,95114
California,39,2022-09-12,36131,36231,36231,0,749134,751763,751679,84,2422,220,220,346,95576,95576,95356,95356
California,40,2022-09-19,27526,27613,27613,0,683966,686695,686624,71,2041,180,180,272,95756,95756,95576,95576
California,41,2022-09-26,25207,25297,25297,0,635887,638698,638635,63,1818,167,167,230,95923,95923,95756,95756
California,42,2022-10-03,23198,23290,23290,0,582831,585708,585648,60,1647,145,145,247,96068,96068,95923,95923
California,43,2022-10-10,23228,23325,23325,0,622803,626135,626077,58,1537,151,151,228,96201,96201,96050,96050
California,44,2022-10-17,18548,18639,18639,0,519394,522580,522523,57,1397,115,115,218,96316,96316,96201,96201
California,45,2022-10-24,18407,18513,18513,0,509878,513560,513503,57,1324,110,110,190,96426,96426,96316,96316
California,46,2022-10-31,20523,20664,20664,0,518950,523307,523250,57,1401,111,111,191,96537,96537,96426,96426
California,47,2022-11-07,26627,26862,26862,0,542097,547415,547358,57,1525,127,131,231,96664,96668,96537,96537
California,48,2022-11-14,30476,30791,30791,0,544325,550453,550396,57,1775,103,107,260,96767,96775,96664,96668
California,49,2022-11-21,39801,40282,40282,0,565924,573087,573030,57,2268,144,152,330,96911,96927,96767,96775
California,50,2022-11-28,53741,54509,54509,0,504187,511516,511459,57,3153,179,192,379,97090,97119,96911,96927
California,51,2022-12-05,65373,66440,66440,0,635241,645796,645738,58,3715,219,245,493,97309,97364,97090,97119
California,52,2022-12-12,55830,56914,56914,0,596530,608384,608327,57,3944,279,344,527,97588,97708,97309,97364
California,53,2022-12-19,49612,50848,50848,0,549868,563723,563666,57,3997,247,352,523,97835,98060,97588,97708
California,54,2022-12-26,43906,45420,45420,0,405197,419138,419082,56,3906,208,415,510,98043,98475,97835,98060
California,55,2023-01-02,42657,45283,45283,0,401785,426924,426867,57,4077,114,501,528,98157,98976,98043,98475
California,56,2023-01-09,25776,53474,53474,0,358460,719776,719717,59,3672,42,640,487,98199,99616,98157,98976
