county,time,date,cases,est_cases,est_omicron_cases,est_other_cases,tests,est_tests,est_omicron_tests,est_other_tests,hospitalizations,deaths,est_deaths,icu,cum_deaths,cum_est_deaths,prev_cum_deaths,prev_cum_est_deaths
Alameda,1,2021-12-19,2370,2370,1097,1273,89505,89505,40795,48710,52,8,8,16,1538,1538,1530,1530
Amador,1,2021-12-19,45,45,16,29,1655,1655,562,1093,2,1,1,2,70,70,69,69
Butte,1,2021-12-19,162,162,83,79,4460,4460,2264,2196,24,5,5,1,358,358,353,353
Calaveras,1,2021-12-19,54,54,20,34,1683,1683,623,1060,1,2,2,0,92,92,90,90
Colusa,1,2021-12-19,16,16,7,9,473,473,197,276,0,0,0,0,21,21,21,21
Contra Costa,1,2021-12-19,1384,1384,468,916,43091,43091,14315,28776,25,4,4,8,1080,1080,1076,1076
Del Norte,1,2021-12-19,18,18,7,11,1389,1389,558,831,0,0,0,0,42,42,42,42
El Dorado,1,2021-12-19,215,215,81,134,4417,4417,1653,2764,7,4,4,2,178,178,174,174
Fresno,1,2021-12-19,978,978,340,638,25382,25382,8761,16621,128,22,22,45,2420,2420,2398,2398
Glenn,1,2021-12-19,19,19,7,12,450,450,171,279,0,0,0,0,41,41,41,41
Humboldt,1,2021-12-19,146,146,58,88,3638,3638,1433,2205,10,0,0,2,120,120,120,120
Imperial,1,2021-12-19,589,589,219,370,5694,5694,2096,3598,37,12,12,27,816,816,804,804
Inyo,1,2021-12-19,27,27,11,16,357,357,148,209,1,0,0,0,48,48,48,48
Kern,1,2021-12-19,894,894,375,519,28629,28629,11894,16735,91,26,26,29,2021,2021,1995,1995
Kings,1,2021-12-19,236,236,88,148,7309,7309,2701,4608,17,6,6,2,389,389,383,383
Lake,1,2021-12-19,36,36,12,24,1435,1435,489,946,0,0,0,0,116,116,116,116
Lassen,1,2021-12-19,8,8,4,4,2481,2481,1099,1382,0,0,0,0,54,54,54,54
Los Angeles,1,2021-12-19,25540,25540,17507,8033,1037087,1037102,703356,333746,569,109,109,172,27359,27359,27250,27250
Madera,1,2021-12-19,164,164,57,107,6023,6023,2056,3967,10,4,4,4,334,334,330,330
Marin,1,2021-12-19,443,443,159,284,11480,11480,4058,7422,3,1,1,1,200,200,199,199
Mariposa,1,2021-12-19,16,16,5,11,450,450,151,299,0,0,0,0,21,21,21,21
Mendocino,1,2021-12-19,87,87,25,62,2629,2629,747,1882,2,2,2,3,102,102,100,100
Merced,1,2021-12-19,262,262,108,154,5608,5608,2277,3331,9,4,4,13,691,691,687,687
Modoc,1,2021-12-19,4,4,2,2,50,50,21,29,2,0,0,0,6,6,6,6
Mono,1,2021-12-19,30,30,7,23,297,297,75,222,1,0,0,0,4,4,4,4
Monterey,1,2021-12-19,432,432,109,323,13070,13070,3264,9806,24,3,3,5,642,642,639,639
Napa,1,2021-12-19,199,199,89,110,5670,5670,2488,3182,2,1,1,1,108,108,107,107
Nevada,1,2021-12-19,151,151,53,98,2656,2656,919,1737,3,2,2,3,110,110,108,108
Orange,1,2021-12-19,3968,3968,1910,2058,96541,96541,45931,50610,139,32,32,56,6018,6018,5986,5986
Placer,1,2021-12-19,495,495,165,330,11088,11088,3612,7476,52,7,7,27,501,501,494,494
Plumas,1,2021-12-19,17,17,6,11,510,510,186,324,0,0,0,0,12,12,12,12
Riverside,1,2021-12-19,4839,4839,1971,2868,78669,78669,31629,47040,235,41,41,82,5575,5575,5534,5534
Sacramento,1,2021-12-19,1920,1920,745,1175,53501,53501,20519,32982,91,21,21,46,2488,2488,2467,2467
San Benito,1,2021-12-19,86,86,37,49,1959,1959,846,1113,3,1,1,2,79,79,78,78
San Bernardino,1,2021-12-19,4326,4326,1989,2337,78343,78343,35591,42752,286,65,65,117,6501,6501,6436,6436
San Diego,1,2021-12-19,7098,7098,4772,2326,146843,146843,98115,48728,258,30,30,93,4476,4476,4446,4446
San Francisco,1,2021-12-19,2364,2364,565,1799,53175,53175,12480,40695,25,3,3,10,692,692,689,689
San Joaquin,1,2021-12-19,833,833,303,530,25838,25838,9274,16564,51,13,13,27,1970,1970,1957,1957
San Luis Obispo,1,2021-12-19,355,355,151,204,9612,9612,4045,5567,12,3,3,4,370,370,367,367
San Mateo,1,2021-12-19,1210,1210,584,626,49929,49929,23679,26250,8,0,0,5,601,601,601,601
Santa Barbara,1,2021-12-19,641,641,257,384,15630,15630,6181,9449,19,7,7,12,569,569,562,562
Santa Clara,1,2021-12-19,2346,2346,1550,796,122528,122528,80057,42471,85,8,8,40,1976,1976,1968,1968
Santa Cruz,1,2021-12-19,354,354,156,198,21105,21105,9125,11980,10,2,2,6,230,230,228,228
Shasta,1,2021-12-19,154,154,60,94,6017,6017,2298,3719,26,6,6,9,446,446,440,440
Siskiyou,1,2021-12-19,17,17,8,9,476,476,213,263,4,1,1,0,62,62,61,61
Solano,1,2021-12-19,440,440,178,262,14681,14681,5864,8817,19,4,4,6,389,389,385,385
Sonoma,1,2021-12-19,662,662,274,388,21227,21227,8615,12612,27,1,1,3,420,420,419,419
Stanislaus,1,2021-12-19,631,631,191,440,13636,13636,4079,9557,91,11,11,22,1429,1429,1418,1418
Sutter,1,2021-12-19,94,94,38,56,2209,2209,878,1331,0,2,2,0,193,193,191,191
Tehama,1,2021-12-19,55,55,17,38,1327,1327,411,916,5,2,2,3,165,165,163,163
Trinity,1,2021-12-19,3,3,1,2,106,106,32,74,0,0,0,0,18,18,18,18
Tulare,1,2021-12-19,387,387,115,272,12501,12501,3681,8820,38,17,17,13,1305,1305,1288,1288
Tuolumne,1,2021-12-19,97,97,34,63,1963,1963,679,1284,6,0,0,1,150,150,150,150
Ventura,1,2021-12-19,1660,1660,833,827,38676,38676,19120,19556,67,9,9,13,1216,1216,1207,1207
Yolo,1,2021-12-19,303,303,131,172,25335,25335,10849,14486,4,0,0,1,294,294,294,294
Yuba,1,2021-12-19,97,97,40,57,1886,1886,781,1105,4,0,0,4,102,102,102,102
Alameda,2,2021-12-26,6283,6283,3284,2999,85036,85036,43866,41170,73,12,12,17,1550,1550,1538,1538
Amador,2,2021-12-26,88,88,36,52,1505,1505,594,911,2,0,0,2,70,70,70,70
Butte,2,2021-12-26,441,441,255,186,4141,4141,2355,1786,35,3,3,3,361,361,358,358
Calaveras,2,2021-12-26,94,94,41,53,999,999,428,571,1,1,1,1,93,93,92,92
Colusa,2,2021-12-26,16,16,8,8,237,237,112,125,2,0,0,0,21,21,21,21
Contra Costa,2,2021-12-26,3876,3876,1533,2343,44504,44504,17287,27217,37,2,2,15,1082,1082,1080,1080
Del Norte,2,2021-12-26,24,24,11,13,1246,1246,574,672,0,0,0,0,42,42,42,42
El Dorado,2,2021-12-26,416,416,183,233,4201,4201,1810,2391,6,1,1,4,179,179,178,178
Fresno,2,2021-12-26,1743,1743,713,1030,22599,22599,9097,13502,121,15,15,40,2435,2435,2420,2420
Glenn,2,2021-12-26,45,45,20,25,444,444,194,250,0,0,0,0,41,41,41,41
Humboldt,2,2021-12-26,401,401,185,216,3248,3248,1467,1781,9,2,2,0,122,122,120,120
Imperial,2,2021-12-26,709,709,307,402,5378,5378,2297,3081,29,11,11,26,827,827,816,816
Inyo,2,2021-12-26,94,94,46,48,411,411,194,217,0,2,2,0,50,50,48,48
Kern,2,2021-12-26,1462,1462,710,752,20574,20574,9838,10736,72,17,17,32,2038,2038,2021,2021
Kings,2,2021-12-26,412,412,181,231,5351,5351,2290,3061,15,1,1,4,390,390,389,389
Lake,2,2021-12-26,54,54,22,32,1154,1154,459,695,0,1,1,0,117,117,116,116
Lassen,2,2021-12-26,19,19,10,9,2326,2326,1172,1154,0,0,0,0,54,54,54,54
Los Angeles,2,2021-12-26,75249,75249,55252,19997,684443,684453,499412,185041,766,104,104,200,27463,27463,27359,27359
Madera,2,2021-12-26,248,248,102,146,4227,4227,1683,2544,6,1,1,5,335,335,334,334
Marin,2,2021-12-26,1403,1403,585,818,15716,15716,6474,9242,3,0,0,1,200,200,200,200
Mariposa,2,2021-12-26,36,36,14,22,505,505,196,309,0,0,0,0,21,21,21,21
Mendocino,2,2021-12-26,118,118,41,77,2488,2488,829,1659,3,1,1,3,103,103,102,102
Merced,2,2021-12-26,496,496,235,261,4943,4943,2302,2641,0,8,8,2,699,699,691,691
Modoc,2,2021-12-26,3,3,1,2,58,58,28,30,3,0,0,0,6,6,6,6
Mono,2,2021-12-26,108,108,33,75,366,366,108,258,1,0,0,0,4,4,4,4
Monterey,2,2021-12-26,830,830,253,577,12616,12616,3757,8859,25,2,2,11,644,644,642,642
Napa,2,2021-12-26,649,649,330,319,5762,5762,2892,2870,5,0,0,1,108,108,108,108
Nevada,2,2021-12-26,212,212,87,125,2537,2537,1014,1523,4,1,1,2,111,111,110,110
Orange,2,2021-12-26,13126,13126,7139,5987,114423,114423,61511,52912,216,33,33,66,6051,6051,6018,6018
Placer,2,2021-12-26,1020,1020,397,623,10368,10368,3946,6422,60,1,1,25,502,502,501,501
Plumas,2,2021-12-26,13,13,6,7,399,399,167,232,0,0,0,0,12,12,12,12
Riverside,2,2021-12-26,10948,10948,5133,5815,80371,80371,37147,43224,283,47,47,88,5622,5622,5575,5575
Sacramento,2,2021-12-26,3963,3963,1784,2179,49051,49051,21695,27356,122,16,16,43,2504,2504,2488,2488
San Benito,2,2021-12-26,253,253,127,126,2209,2209,1093,1116,1,3,3,3,82,82,79,79
San Bernardino,2,2021-12-26,10866,10866,5684,5182,82304,82304,42334,39970,311,72,72,127,6573,6573,6501,6501
San Diego,2,2021-12-26,20597,20597,14905,5692,164545,164548,118367,46181,292,33,33,92,4509,4509,4476,4476
San Francisco,2,2021-12-26,6160,6160,1745,4415,64327,64327,17984,46343,30,1,1,11,693,693,692,692
San Joaquin,2,2021-12-26,1805,1805,770,1035,21532,21532,9002,12530,53,18,18,25,1988,1988,1970,1970
San Luis Obispo,2,2021-12-26,830,830,405,425,10351,10351,4972,5379,14,1,1,8,371,371,370,370
San Mateo,2,2021-12-26,4346,4346,2364,1982,53251,53251,28546,24705,14,2,2,7,603,603,601,601
Santa Barbara,2,2021-12-26,1689,1689,783,906,14426,14426,6560,7866,28,4,4,11,573,573,569,569
Santa Clara,2,2021-12-26,7224,7224,5152,2072,101308,101308,71598,29710,84,10,10,34,1986,1986,1976,1976
Santa Cruz,2,2021-12-26,761,761,384,377,11970,11970,5891,6079,12,0,0,2,230,230,230,230
Shasta,2,2021-12-26,217,217,98,119,4661,4661,2051,2610,28,7,7,12,453,453,446,446
Siskiyou,2,2021-12-26,16,16,8,8,357,357,182,175,0,1,1,0,63,63,62,62
Solano,2,2021-12-26,918,918,427,491,15687,15687,7221,8466,26,3,3,3,392,392,389,389
Sonoma,2,2021-12-26,1601,1601,763,838,20133,20133,9413,10720,15,0,0,5,420,420,420,420
Stanislaus,2,2021-12-26,1013,1013,367,646,10797,10797,3834,6963,88,17,17,16,1446,1446,1429,1429
Sutter,2,2021-12-26,200,200,93,107,2065,2065,943,1122,0,2,2,0,195,195,193,193
Tehama,2,2021-12-26,78,78,29,49,1079,1079,392,687,9,0,0,2,165,165,165,165
Trinity,2,2021-12-26,4,4,2,2,96,96,35,61,0,1,1,0,19,19,18,18
Tulare,2,2021-12-26,658,658,235,423,10626,10626,3693,6933,37,13,13,9,1318,1318,1305,1305
Tuolumne,2,2021-12-26,151,151,62,89,1777,1777,716,1061,5,0,0,1,150,150,150,150
Ventura,2,2021-12-26,4466,4466,2523,1943,36834,36834,20506,16328,61,7,7,17,1223,1223,1216,1216
Yolo,2,2021-12-26,615,615,304,311,18979,18979,9183,9796,5,1,1,2,295,295,294,294
Yuba,2,2021-12-26,130,130,63,67,1523,1523,720,803,8,1,1,3,103,103,102,102
Alameda,3,2022-01-02,15221,15221,8844,6377,105562,105562,61087,44475,144,7,7,29,1557,1557,1550,1550
Amador,3,2022-01-02,166,166,77,89,1893,1893,867,1026,4,1,1,2,71,71,70,70
Butte,3,2022-01-02,1013,1013,644,369,6158,6158,3877,2281,27,1,1,6,362,362,361,361
Calaveras,3,2022-01-02,183,183,92,91,1143,1143,562,581,1,1,1,1,94,94,93,93
Colusa,3,2022-01-02,52,52,28,24,322,322,173,149,5,0,0,0,21,21,21,21
Contra Costa,3,2022-01-02,11695,11695,5284,6411,60998,60998,27424,33574,69,9,9,22,1091,1091,1082,1082
Del Norte,3,2022-01-02,59,59,31,28,2007,2007,1045,962,0,0,0,0,42,42,42,42
El Dorado,3,2022-01-02,1108,1108,553,555,5471,5471,2708,2763,12,4,4,5,183,183,179,179
Fresno,3,2022-01-02,5469,5469,2556,2913,35305,35305,16402,18903,155,12,12,38,2447,2447,2435,2435
Glenn,3,2022-01-02,69,69,35,34,551,551,275,276,0,1,1,0,42,42,41,41
Humboldt,3,2022-01-02,782,782,407,375,4853,4853,2503,2350,8,0,0,3,122,122,122,122
Imperial,3,2022-01-02,1530,1530,752,778,8164,8164,3992,4172,28,12,12,30,839,839,827,827
Inyo,3,2022-01-02,219,219,119,100,612,612,327,285,2,0,0,0,50,50,50,50
Kern,3,2022-01-02,4640,4640,2531,2109,30750,30750,16617,14133,90,15,15,34,2053,2053,2038,2038
Kings,3,2022-01-02,929,929,462,467,7681,7681,3776,3905,12,3,3,2,393,393,390,390
Lake,3,2022-01-02,175,175,82,93,1495,1495,688,807,1,0,0,1,117,117,117,117
Lassen,3,2022-01-02,51,51,29,22,2664,2664,1505,1159,2,0,0,0,54,54,54,54
Los Angeles,3,2022-01-02,182860,182864,142175,40689,949388,949406,737681,211725,1716,137,137,278,27600,27600,27463,27463
Madera,3,2022-01-02,697,697,324,373,5830,5830,2682,3148,14,3,3,4,338,338,335,335
Marin,3,2022-01-02,2179,2179,1030,1149,17069,17069,8019,9050,18,1,1,1,201,201,200,200
Mariposa,3,2022-01-02,78,78,36,42,538,538,242,296,0,0,0,0,21,21,21,21
Mendocino,3,2022-01-02,380,380,152,228,3178,3178,1252,1926,8,0,0,2,103,103,103,103
Merced,3,2022-01-02,1269,1269,675,594,7496,7496,3967,3529,13,8,8,13,707,707,699,699
Modoc,3,2022-01-02,14,14,8,6,52,52,28,24,0,0,0,0,6,6,6,6
Mono,3,2022-01-02,177,177,62,115,395,395,138,257,1,0,0,0,4,4,4,4
Monterey,3,2022-01-02,2121,2121,757,1364,18486,18486,6554,11932,26,5,5,10,649,649,644,644
Napa,3,2022-01-02,1556,1556,880,676,10236,10236,5753,4483,8,1,1,3,109,109,108,108
Nevada,3,2022-01-02,519,519,245,274,2245,2245,1052,1193,4,1,1,4,112,112,111,111
Orange,3,2022-01-02,40902,40902,24496,16406,202581,202585,121047,81538,441,32,32,104,6083,6083,6051,6051
Placer,3,2022-01-02,2542,2542,1134,1408,14262,14262,6295,7967,104,14,14,25,516,516,502,502
Plumas,3,2022-01-02,46,46,23,23,363,363,176,187,1,0,0,0,12,12,12,12
Riverside,3,2022-01-02,27909,27909,14709,13200,128338,128338,67312,61026,494,57,57,101,5679,5679,5622,5622
Sacramento,3,2022-01-02,11790,11790,5990,5800,73064,73064,36903,36161,206,27,27,61,2531,2531,2504,2504
San Benito,3,2022-01-02,647,647,362,285,3157,3157,1760,1397,3,3,3,3,85,85,82,82
San Bernardino,3,2022-01-02,30612,30612,17727,12885,125533,125535,72407,53128,514,88,88,141,6661,6661,6573,6573
San Diego,3,2022-01-02,55056,55056,42267,12789,235709,235713,180823,54890,542,33,33,122,4542,4542,4509,4509
San Francisco,3,2022-01-02,10065,10065,3377,6688,76885,76885,25614,51271,78,5,5,18,698,698,693,693
San Joaquin,3,2022-01-02,5901,5901,2866,3035,33117,33117,15932,17185,66,9,9,26,1997,1997,1988,1988
San Luis Obispo,3,2022-01-02,2184,2184,1189,995,14862,14862,8068,6794,16,6,6,6,377,377,371,371
San Mateo,3,2022-01-02,9458,9458,5680,3778,71372,71372,42707,28665,28,4,4,8,607,607,603,603
Santa Barbara,3,2022-01-02,4566,4566,2384,2182,24557,24557,12778,11779,49,7,7,8,580,580,573,573
Santa Clara,3,2022-01-02,19519,19519,14825,4694,144068,144069,109034,35035,169,8,8,56,1994,1994,1986,1986
Santa Cruz,3,2022-01-02,2026,2026,1141,885,16704,16704,9323,7381,18,4,4,4,234,234,230,230
Shasta,3,2022-01-02,490,490,252,238,5599,5599,2825,2774,30,1,1,13,454,454,453,453
Siskiyou,3,2022-01-02,58,58,33,25,460,460,263,197,0,0,0,0,63,63,63,63
Solano,3,2022-01-02,3631,3631,1900,1731,24271,24271,12663,11608,57,4,4,9,396,396,392,392
Sonoma,3,2022-01-02,3722,3722,1982,1740,28213,28213,14934,13279,26,7,7,3,427,427,420,420
Stanislaus,3,2022-01-02,2849,2849,1193,1656,16397,16397,6796,9601,111,9,9,19,1455,1455,1446,1446
Sutter,3,2022-01-02,440,440,232,208,2723,2723,1417,1306,0,2,2,0,197,197,195,195
Tehama,3,2022-01-02,184,184,80,104,1225,1225,518,707,1,3,3,2,168,168,165,165
Trinity,3,2022-01-02,12,12,5,7,100,100,42,58,0,0,0,0,19,19,19,19
Tulare,3,2022-01-02,1727,1727,715,1012,14923,14923,6074,8849,52,5,5,7,1323,1323,1318,1318
Tuolumne,3,2022-01-02,314,314,148,166,1969,1969,919,1050,6,1,1,0,151,151,150,150
Ventura,3,2022-01-02,11584,11584,7167,4417,55437,55437,34159,21278,120,9,9,33,1232,1232,1223,1223
Yolo,3,2022-01-02,1932,1932,1076,856,30081,30081,16552,13529,5,4,4,3,299,299,295,295
Yuba,3,2022-01-02,402,402,218,184,2112,2112,1134,978,18,1,1,6,104,104,103,103
Alameda,4,2022-01-09,31279,31279,20006,11273,191456,191461,122373,69088,277,13,13,45,1570,1570,1557,1557
Amador,4,2022-01-09,371,371,194,177,2748,2748,1423,1325,4,0,0,4,71,71,71,71
Butte,4,2022-01-09,1951,1951,1342,609,10297,10297,7061,3236,43,2,2,5,364,364,362,362
Calaveras,4,2022-01-09,462,462,259,203,2459,2459,1363,1096,0,1,1,2,95,95,94,94
Colusa,4,2022-01-09,84,84,51,33,680,680,406,274,5,0,0,0,21,21,21,21
Contra Costa,4,2022-01-09,20319,20319,10436,9883,103049,103049,52821,50228,144,12,12,23,1103,1103,1091,1091
Del Norte,4,2022-01-09,171,171,100,71,3831,3831,2249,1582,1,0,0,0,42,42,42,42
El Dorado,4,2022-01-09,2185,2185,1222,963,9006,9006,5022,3984,16,6,6,2,189,189,183,183
Fresno,4,2022-01-09,13436,13436,7119,6317,57468,57468,30362,27106,258,15,15,47,2462,2462,2447,2447
Glenn,4,2022-01-09,183,183,104,79,897,897,505,392,2,1,1,0,43,43,42,42
Humboldt,4,2022-01-09,1399,1399,811,588,8295,8295,4802,3493,14,6,6,2,128,128,122,122
Imperial,4,2022-01-09,3441,3441,1899,1542,13512,13512,7448,6064,49,12,12,24,851,851,839,839
Inyo,4,2022-01-09,375,375,223,152,1238,1238,737,501,3,1,1,0,51,51,50,50
Kern,4,2022-01-09,11413,11413,6891,4522,55746,55746,33517,22229,170,23,23,29,2076,2076,2053,2053
Kings,4,2022-01-09,2057,2057,1149,908,12179,12179,6765,5414,26,1,1,3,394,394,393,393
Lake,4,2022-01-09,455,455,239,216,2699,2699,1407,1292,0,3,3,2,120,120,117,117
Lassen,4,2022-01-09,147,147,92,55,3524,3524,2190,1334,2,0,0,0,54,54,54,54
Los Angeles,4,2022-01-09,332247,332253,271660,60593,1899921,1899957,1553140,346817,2990,267,267,482,27867,27867,27600,27600
Madera,4,2022-01-09,1785,1785,941,844,10203,10203,5340,4863,22,2,2,6,340,340,338,338
Marin,4,2022-01-09,3057,3057,1634,1423,21425,21425,11435,9990,18,2,2,5,203,203,201,201
Mariposa,4,2022-01-09,180,180,92,88,1101,1101,565,536,0,1,1,0,22,22,21,21
Mendocino,4,2022-01-09,790,790,361,429,5304,5304,2408,2896,4,3,3,3,106,106,103,103
Merced,4,2022-01-09,3572,3572,2118,1454,13791,13791,8160,5631,33,11,11,12,718,718,707,707
Modoc,4,2022-01-09,13,13,8,5,98,98,59,39,0,0,0,0,6,6,6,6
Mono,4,2022-01-09,247,247,101,146,824,824,337,487,1,1,1,0,5,5,4,4
Monterey,4,2022-01-09,4544,4544,1882,2662,31883,31883,13152,18731,42,4,4,10,653,653,649,649
Napa,4,2022-01-09,2704,2704,1686,1018,15020,15020,9342,5678,16,1,1,1,110,110,109,109
Nevada,4,2022-01-09,1126,1126,599,527,4917,4917,2595,2322,10,2,2,3,114,114,112,112
Orange,4,2022-01-09,61290,61290,40208,21082,311419,311424,204249,107175,824,88,88,140,6171,6171,6083,6083
Placer,4,2022-01-09,4934,4934,2504,2430,21526,21526,10875,10651,163,8,8,26,524,524,516,516
Plumas,4,2022-01-09,119,119,65,54,785,785,425,360,4,0,0,0,12,12,12,12
Riverside,4,2022-01-09,47603,47603,27940,19663,184716,184721,108337,76384,749,77,77,137,5756,5756,5679,5679
Sacramento,4,2022-01-09,26820,26820,15250,11570,119912,119912,68045,51867,354,35,35,72,2566,2566,2531,2531
San Benito,4,2022-01-09,1034,1034,641,393,4498,4498,2783,1715,4,0,0,2,85,85,85,85
San Bernardino,4,2022-01-09,50265,50265,32089,18176,190094,190099,121233,68866,760,109,109,177,6770,6770,6661,6661
San Diego,4,2022-01-09,84653,84653,68446,16207,338084,338090,273385,64705,820,51,51,168,4593,4593,4542,4542
San Francisco,4,2022-01-09,16177,16177,6323,9854,120783,120783,47194,73589,148,12,12,30,710,710,698,698
San Joaquin,4,2022-01-09,13298,13298,7260,6038,61609,61609,33553,28056,117,18,18,39,2015,2015,1997,1997
San Luis Obispo,4,2022-01-09,4268,4268,2588,1680,21447,21447,12985,8462,29,2,2,8,379,379,377,377
San Mateo,4,2022-01-09,15080,15080,9903,5177,113389,113389,74331,39058,96,4,4,14,611,611,607,607
Santa Barbara,4,2022-01-09,8291,8291,4814,3477,45249,45249,26276,18973,77,7,7,10,587,587,580,580
Santa Clara,4,2022-01-09,36357,36357,29094,7263,270306,270311,216100,54211,339,26,26,66,2020,2020,1994,1994
Santa Cruz,4,2022-01-09,4461,4461,2769,1692,41656,41656,25744,15912,20,3,3,2,237,237,234,234
Shasta,4,2022-01-09,1014,1014,579,435,8280,8280,4696,3584,34,8,8,12,462,462,454,454
Siskiyou,4,2022-01-09,115,115,72,43,888,888,557,331,5,1,1,1,64,64,63,63
Solano,4,2022-01-09,6711,6711,3936,2775,36518,36518,21382,15136,81,5,5,11,401,401,396,396
Sonoma,4,2022-01-09,8511,8511,5039,3472,46460,46460,27436,19024,69,9,9,7,436,436,427,427
Stanislaus,4,2022-01-09,6235,6235,2987,3248,27486,27486,13104,14382,154,13,13,24,1468,1468,1455,1455
Sutter,4,2022-01-09,1131,1131,662,469,4712,4712,2741,1971,0,1,1,0,198,198,197,197
Tehama,4,2022-01-09,460,460,225,235,2431,2431,1180,1251,11,1,1,1,169,169,168,168
Trinity,4,2022-01-09,36,36,18,18,267,267,129,138,0,0,0,0,19,19,19,19
Tulare,4,2022-01-09,4469,4469,2118,2351,22631,22631,10645,11986,56,8,8,10,1331,1331,1323,1323
Tuolumne,4,2022-01-09,754,754,400,354,4115,4115,2168,1947,13,3,3,2,154,154,151,151
Ventura,4,2022-01-09,17380,17380,11725,5655,86522,86522,58292,28230,218,22,22,30,1254,1254,1232,1232
Yolo,4,2022-01-09,3828,3828,2345,1483,49038,49038,30021,19017,6,3,3,2,302,302,299,299
Yuba,4,2022-01-09,947,947,569,378,3883,3883,2325,1558,37,0,0,9,104,104,104,104
Alameda,5,2022-01-16,26166,26166,18159,8007,183980,183985,127640,56345,357,29,29,58,1599,1599,1570,1570
Amador,5,2022-01-16,492,492,286,206,3794,3794,2194,1600,8,2,2,4,73,73,71,71
Butte,5,2022-01-16,2109,2109,1555,554,9801,9801,7207,2594,57,3,3,3,367,367,364,364
Calaveras,5,2022-01-16,594,594,365,229,2707,2707,1662,1045,3,2,2,3,97,97,95,95
Colusa,5,2022-01-16,172,172,113,59,843,843,550,293,3,0,0,0,21,21,21,21
Contra Costa,5,2022-01-16,17213,17213,9898,7315,95308,95308,54696,40612,198,22,22,44,1125,1125,1103,1103
Del Norte,5,2022-01-16,196,196,126,70,3949,3949,2519,1430,3,0,0,0,42,42,42,42
El Dorado,5,2022-01-16,2055,2055,1266,789,8800,8800,5418,3382,12,4,4,2,193,193,189,189
Fresno,5,2022-01-16,18247,18247,10758,7489,67367,67367,39669,27698,354,26,26,68,2488,2488,2462,2462
Glenn,5,2022-01-16,306,306,191,115,1104,1104,686,418,1,1,1,0,44,44,43,43
Humboldt,5,2022-01-16,1239,1239,789,450,8842,8842,5631,3211,9,0,0,6,128,128,128,128
Imperial,5,2022-01-16,3680,3680,2247,1433,13930,13930,8508,5422,64,10,10,28,861,861,851,851
Inyo,5,2022-01-16,393,393,256,137,1233,1233,802,431,2,1,1,0,52,52,51,51
Kern,5,2022-01-16,12870,12870,8487,4383,58694,58694,38606,20088,240,27,27,39,2103,2103,2076,2076
Kings,5,2022-01-16,3499,3499,2155,1344,16619,16619,10223,6396,41,3,3,2,397,397,394,394
Lake,5,2022-01-16,590,590,345,245,3178,3178,1856,1322,1,0,0,2,120,120,120,120
Lassen,5,2022-01-16,304,304,207,97,3789,3789,2566,1223,1,0,0,0,54,54,54,54
Los Angeles,5,2022-01-16,243371,243376,207116,36260,1776186,1776219,1511480,264739,3943,469,469,621,28336,28336,27867,27867
Madera,5,2022-01-16,2413,2413,1417,996,11032,11032,6450,4582,30,5,5,6,345,345,340,340
Marin,5,2022-01-16,2578,2578,1534,1044,18913,18913,11238,7675,38,4,4,4,207,207,203,203
Mariposa,5,2022-01-16,186,186,106,80,1216,1216,697,519,0,0,0,0,22,22,22,22
Mendocino,5,2022-01-16,983,983,508,475,5562,5562,2863,2699,18,3,3,3,109,109,106,106
Merced,5,2022-01-16,4487,4487,2914,1573,14950,14950,9703,5247,38,19,19,12,737,737,718,718
Modoc,5,2022-01-16,12,12,8,4,110,110,73,37,0,1,1,0,7,7,6,6
Mono,5,2022-01-16,229,229,107,122,881,881,415,466,1,0,0,0,5,5,5,5
Monterey,5,2022-01-16,6201,6201,2947,3254,30252,30252,14318,15934,58,7,7,13,660,660,653,653
Napa,5,2022-01-16,2166,2166,1471,695,13308,13308,9020,4288,18,2,2,5,112,112,110,110
Nevada,5,2022-01-16,1290,1290,761,529,5658,5658,3324,2334,21,1,1,1,115,115,114,114
Orange,5,2022-01-16,46059,46059,32648,13411,278582,278587,197350,81237,1012,113,113,188,6284,6284,6171,6171
Placer,5,2022-01-16,4608,4608,2609,1999,20993,20993,11859,9134,180,13,13,35,537,537,524,524
Plumas,5,2022-01-16,198,198,120,78,809,809,485,324,4,0,0,0,12,12,12,12
Riverside,5,2022-01-16,44746,44746,28843,15903,180907,180912,116612,64300,871,90,90,152,5846,5846,5756,5756
Sacramento,5,2022-01-16,23307,23307,14609,8698,110959,110959,69476,41483,451,58,58,96,2624,2624,2566,2566
San Benito,5,2022-01-16,930,930,627,303,4496,4496,3028,1468,5,2,2,3,87,87,85,85
San Bernardino,5,2022-01-16,42862,42862,29662,13200,181084,181089,125355,55734,909,138,138,217,6908,6908,6770,6770
San Diego,5,2022-01-16,66198,66198,55862,10336,284576,284581,240207,44374,1067,111,111,189,4704,4704,4593,4593
San Francisco,5,2022-01-16,11624,11624,5263,6361,99578,99578,44948,54630,204,14,14,45,724,724,710,710
San Joaquin,5,2022-01-16,14019,14019,8457,5562,63993,63993,38590,25403,194,20,20,55,2035,2035,2015,2015
San Luis Obispo,5,2022-01-16,4082,4082,2706,1376,22320,22320,14783,7537,38,11,11,8,390,390,379,379
San Mateo,5,2022-01-16,13472,13472,9551,3921,105824,105824,74923,30901,95,10,10,22,621,621,611,611
Santa Barbara,5,2022-01-16,7509,7509,4794,2715,44215,44215,28202,16013,118,11,11,10,598,598,587,587
Santa Clara,5,2022-01-16,32150,32150,26881,5269,258400,258405,215950,42455,437,25,25,78,2045,2045,2020,2020
Santa Cruz,5,2022-01-16,4304,4304,2913,1391,46079,46079,31113,14966,28,3,3,3,240,240,237,237
Shasta,5,2022-01-16,1331,1331,839,492,9674,9674,6063,3611,63,6,6,13,468,468,462,462
Siskiyou,5,2022-01-16,159,159,109,50,1026,1026,698,328,3,1,1,2,65,65,64,64
Solano,5,2022-01-16,6914,6914,4461,2453,37929,37929,24447,13482,103,8,8,21,409,409,401,401
Sonoma,5,2022-01-16,8222,8222,5340,2882,47047,47047,30506,16541,74,8,8,14,444,444,436,436
Stanislaus,5,2022-01-16,7641,7641,4115,3526,30831,30831,16558,14273,200,9,9,31,1477,1477,1468,1468
Sutter,5,2022-01-16,1336,1336,855,481,5101,5101,3256,1845,0,5,5,0,203,203,198,198
Tehama,5,2022-01-16,648,648,356,292,2652,2652,1449,1203,15,4,4,2,173,173,169,169
Trinity,5,2022-01-16,40,40,22,18,268,268,145,123,0,1,1,0,20,20,19,19
Tulare,5,2022-01-16,7576,7576,4039,3537,28097,28097,14929,13168,88,15,15,15,1346,1346,1331,1331
Tuolumne,5,2022-01-16,940,940,556,384,4357,4357,2559,1798,9,8,8,1,162,162,154,154
Ventura,5,2022-01-16,13456,13456,9754,3702,74986,74986,54305,20681,285,39,39,52,1293,1293,1254,1254
Yolo,5,2022-01-16,3019,3019,2017,1002,42808,42808,28617,14191,13,5,5,4,307,307,302,302
Yuba,5,2022-01-16,1084,1084,710,374,3973,3973,2599,1374,39,2,2,5,106,106,104,104
Alameda,6,2022-01-23,20085,20085,14946,5139,160765,160769,119710,41059,381,37,37,61,1636,1636,1599,1599
Amador,6,2022-01-23,561,561,359,202,4355,4355,2789,1566,7,0,0,5,73,73,73,73
Butte,6,2022-01-23,1955,1955,1528,427,9135,9135,7136,1999,79,12,12,12,379,379,367,367
Calaveras,6,2022-01-23,592,592,398,194,2429,2429,1631,798,5,1,1,2,98,98,97,97
Colusa,6,2022-01-23,169,169,120,49,863,863,611,252,5,0,0,0,21,21,21,21
Contra Costa,6,2022-01-23,13668,13668,8671,4997,81154,81154,51486,29668,227,25,25,65,1150,1150,1125,1125
Del Norte,6,2022-01-23,322,322,225,97,3885,3885,2694,1191,4,0,0,1,42,42,42,42
El Dorado,6,2022-01-23,1490,1490,1003,487,7147,7147,4813,2334,14,1,1,5,194,194,193,193
Fresno,6,2022-01-23,18055,18055,11678,6377,66738,66738,43193,23545,485,37,37,83,2525,2525,2488,2488
Glenn,6,2022-01-23,260,260,176,84,976,976,661,315,0,1,1,0,45,45,44,44
Humboldt,6,2022-01-23,943,943,653,290,7213,7213,4995,2218,23,3,3,4,131,131,128,128
Imperial,6,2022-01-23,3593,3593,2407,1186,12612,12612,8442,4170,60,17,17,32,878,878,861,861
Inyo,6,2022-01-23,152,152,107,45,616,616,434,182,1,1,1,0,53,53,52,52
Kern,6,2022-01-23,10465,10465,7469,2996,50379,50379,35923,14456,256,51,51,53,2154,2154,2103,2103
Kings,6,2022-01-23,4045,4045,2720,1325,16901,16901,11371,5530,38,5,5,5,402,402,397,397
Lake,6,2022-01-23,680,680,437,243,3155,3155,2017,1138,5,2,2,3,122,122,120,120
Lassen,6,2022-01-23,414,414,302,112,3663,3663,2673,990,1,0,0,0,54,54,54,54
Los Angeles,6,2022-01-23,167798,167802,147674,20128,1520730,1520761,1338723,182038,3779,607,607,794,28943,28943,28336,28336
Madera,6,2022-01-23,2726,2726,1757,969,11567,11567,7443,4124,45,8,8,12,353,353,345,345
Marin,6,2022-01-23,1894,1894,1237,657,16847,16847,10999,5848,40,5,5,13,212,212,207,207
Mariposa,6,2022-01-23,145,145,92,53,935,935,591,344,0,0,0,0,22,22,22,22
Mendocino,6,2022-01-23,939,939,542,397,4767,4767,2752,2015,20,1,1,3,110,110,109,109
Merced,6,2022-01-23,3462,3462,2438,1024,12390,12390,8728,3662,53,9,9,10,746,746,737,737
Modoc,6,2022-01-23,15,15,11,4,104,104,74,30,2,0,0,0,7,7,7,7
Mono,6,2022-01-23,93,93,50,43,441,441,235,206,1,0,0,0,5,5,5,5
Monterey,6,2022-01-23,5015,5015,2685,2330,30669,30669,16426,14243,71,8,8,20,668,668,660,660
Napa,6,2022-01-23,1685,1685,1233,452,11861,11861,8672,3189,16,4,4,6,116,116,112,112
Nevada,6,2022-01-23,1053,1053,683,370,4767,4767,3080,1687,23,1,1,7,116,116,115,115
Orange,6,2022-01-23,29061,29061,22019,7042,224145,224150,169938,54212,967,172,172,195,6456,6456,6284,6284
Placer,6,2022-01-23,3799,3799,2381,1418,18237,18237,11414,6823,206,7,7,47,544,544,537,537
Plumas,6,2022-01-23,216,216,142,74,884,884,580,304,6,0,0,0,12,12,12,12
Riverside,6,2022-01-23,32977,32977,23076,9901,155325,155328,108738,46590,891,129,129,174,5975,5975,5846,5846
Sacramento,6,2022-01-23,17796,17796,12165,5631,94792,94792,64792,30000,513,68,68,110,2692,2692,2624,2624
San Benito,6,2022-01-23,813,813,590,223,3934,3934,2857,1077,5,1,1,3,88,88,87,87
San Bernardino,6,2022-01-23,28554,28554,21222,7332,146247,146251,108733,37518,966,169,169,216,7077,7077,6908,6908
San Diego,6,2022-01-23,52431,52431,45829,6602,244021,244026,213409,30617,1070,127,127,227,4831,4831,4704,4704
San Francisco,6,2022-01-23,8547,8547,4388,4159,85880,85880,44105,41775,239,15,15,39,739,739,724,724
San Joaquin,6,2022-01-23,11231,11231,7428,3803,56042,56042,37055,18987,231,33,33,66,2068,2068,2035,2035
San Luis Obispo,6,2022-01-23,3521,3521,2519,1002,20440,20440,14633,5807,42,11,11,10,401,401,390,390
San Mateo,6,2022-01-23,8924,8924,6758,2166,89983,89983,68178,21805,122,17,17,31,638,638,621,621
Santa Barbara,6,2022-01-23,6391,6391,4437,1954,41088,41088,28519,12569,122,15,15,17,613,613,598,598
Santa Clara,6,2022-01-23,23228,23228,20158,3070,222183,222188,192802,29386,458,51,51,94,2096,2096,2045,2045
Santa Cruz,6,2022-01-23,5142,5142,3753,1389,46366,46366,33876,12490,37,1,1,2,241,241,240,240
Shasta,6,2022-01-23,1462,1462,1001,461,9472,9472,6470,3002,65,5,5,10,473,473,468,468
Siskiyou,6,2022-01-23,162,162,119,43,832,832,609,223,5,3,3,1,68,68,65,65
Solano,6,2022-01-23,5004,5004,3502,1502,30819,30819,21560,9259,140,12,12,26,421,421,409,409
Sonoma,6,2022-01-23,7052,7052,4968,2084,40957,40957,28836,12121,91,7,7,15,451,451,444,444
Stanislaus,6,2022-01-23,6580,6580,3944,2636,27670,27670,16566,11104,270,27,27,39,1504,1504,1477,1477
Sutter,6,2022-01-23,1088,1088,756,332,4984,4984,3460,1524,0,2,2,0,205,205,203,203
Tehama,6,2022-01-23,565,565,344,221,2462,2462,1497,965,14,5,5,5,178,178,173,173
Trinity,6,2022-01-23,65,65,39,26,317,317,191,126,0,0,0,0,20,20,20,20
Tulare,6,2022-01-23,7732,7732,4588,3144,28277,28277,16761,11516,119,10,10,14,1356,1356,1346,1346
Tuolumne,6,2022-01-23,867,867,563,304,3504,3504,2267,1237,16,2,2,3,164,164,162,162
Ventura,6,2022-01-23,9808,9808,7581,2227,64840,64840,50111,14729,294,32,32,50,1325,1325,1293,1293
Yolo,6,2022-01-23,2318,2318,1671,647,38555,38555,27848,10707,16,12,12,5,319,319,307,307
Yuba,6,2022-01-23,964,964,684,280,3746,3746,2656,1090,56,2,2,7,108,108,106,106
Alameda,7,2022-01-30,12138,12138,9561,2577,141031,141036,111066,29970,339,53,53,77,1689,1689,1636,1636
Amador,7,2022-01-30,353,353,246,107,3283,3283,2281,1002,12,1,1,4,74,74,73,73
Butte,7,2022-01-30,1256,1256,1031,225,7986,7986,6545,1441,86,7,7,8,386,386,379,379
Calaveras,7,2022-01-30,272,272,197,75,1919,1919,1387,532,1,6,6,2,104,104,98,98
Colusa,7,2022-01-30,111,111,84,27,693,693,524,169,8,0,0,0,21,21,21,21
Contra Costa,7,2022-01-30,8260,8260,5681,2579,71120,71120,48945,22175,217,34,34,57,1184,1184,1150,1150
Del Norte,7,2022-01-30,342,342,254,88,4189,4189,3113,1076,5,2,2,3,44,44,42,42
El Dorado,7,2022-01-30,804,804,583,221,6146,6146,4455,1691,11,5,5,5,199,199,194,194
Fresno,7,2022-01-30,11978,11978,8389,3589,57027,57027,39941,17086,482,45,45,105,2570,2570,2525,2525
Glenn,7,2022-01-30,204,204,149,55,797,797,581,216,2,3,3,0,48,48,45,45
Humboldt,7,2022-01-30,593,593,440,153,6099,6099,4519,1580,23,4,4,2,135,135,131,131
Imperial,7,2022-01-30,2473,2473,1780,693,11836,11836,8530,3306,74,15,15,28,893,893,878,878
Inyo,7,2022-01-30,65,65,49,16,504,504,379,125,4,2,2,0,55,55,53,53
Kern,7,2022-01-30,6148,6148,4673,1475,43370,43370,32949,10421,258,39,39,49,2193,2193,2154,2154
Kings,7,2022-01-30,2672,2672,1931,741,14799,14799,10691,4108,49,4,4,4,406,406,402,402
Lake,7,2022-01-30,559,559,388,171,3381,3381,2346,1035,4,5,5,4,127,127,122,122
Lassen,7,2022-01-30,336,336,261,75,3556,3556,2754,802,6,1,1,0,55,55,54,54
Los Angeles,7,2022-01-30,84826,84826,76623,8203,1327235,1327270,1198911,128359,2971,619,619,749,29562,29562,28943,28943
Madera,7,2022-01-30,1808,1808,1261,547,9666,9666,6734,2932,48,4,4,7,357,357,353,353
Marin,7,2022-01-30,1168,1168,824,344,14164,14164,9995,4169,27,5,5,12,217,217,212,212
Mariposa,7,2022-01-30,104,104,72,32,876,876,603,273,0,1,1,0,23,23,22,22
Mendocino,7,2022-01-30,516,516,327,189,3550,3550,2255,1295,14,4,4,2,114,114,110,110
Merced,7,2022-01-30,2416,2416,1816,600,10867,10867,8175,2692,41,11,11,13,757,757,746,746
Modoc,7,2022-01-30,11,11,8,3,99,99,75,24,2,1,1,0,8,8,7,7
Mono,7,2022-01-30,43,43,25,18,340,340,202,138,0,0,0,0,5,5,5,5
Monterey,7,2022-01-30,3808,3808,2263,1545,26650,26650,15853,10797,79,9,9,16,677,677,668,668
Napa,7,2022-01-30,1090,1090,846,244,9708,9708,7532,2176,17,5,5,5,121,121,116,116
Nevada,7,2022-01-30,641,641,449,192,4118,4118,2880,1238,27,3,3,6,119,119,116,116
Orange,7,2022-01-30,13484,13484,10785,2699,182641,182646,146049,36597,760,172,172,174,6628,6628,6456,6456
Placer,7,2022-01-30,2494,2494,1700,794,15916,15916,10845,5071,163,16,16,40,560,560,544,544
Plumas,7,2022-01-30,144,144,102,42,752,752,532,220,2,0,0,0,12,12,12,12
Riverside,7,2022-01-30,18322,18322,13699,4623,125641,125646,94056,31590,748,111,111,163,6086,6086,5975,5975
Sacramento,7,2022-01-30,11331,11331,8310,3021,80797,80797,59267,21530,494,93,93,101,2785,2785,2692,2692
San Benito,7,2022-01-30,530,530,409,121,3345,3345,2582,763,4,1,1,3,89,89,88,88
San Bernardino,7,2022-01-30,15045,15045,11831,3214,121053,121058,95272,25786,736,183,183,217,7260,7260,7077,7077
San Diego,7,2022-01-30,27900,27900,25061,2839,189544,189549,170328,19221,969,108,108,211,4939,4939,4831,4831
San Francisco,7,2022-01-30,4566,4566,2614,1952,73561,73561,42184,31377,210,24,24,48,763,763,739,739
San Joaquin,7,2022-01-30,6339,6339,4521,1818,45218,45218,32240,12978,218,35,35,72,2103,2103,2068,2068
San Luis Obispo,7,2022-01-30,2280,2280,1737,543,17108,17108,13042,4066,45,11,11,8,412,412,401,401
San Mateo,7,2022-01-30,4873,4873,3895,978,78235,78235,62512,15723,121,14,14,30,652,652,638,638
Santa Barbara,7,2022-01-30,4080,4080,3027,1053,35738,35738,26533,9205,96,20,20,12,633,633,613,613
Santa Clara,7,2022-01-30,15210,15210,13586,1624,209477,209482,187127,22355,429,52,52,94,2148,2148,2096,2096
Santa Cruz,7,2022-01-30,3512,3512,2716,796,46802,46802,36249,10553,38,5,5,5,246,246,241,241
Shasta,7,2022-01-30,1019,1019,748,271,8738,8738,6406,2332,64,14,14,8,487,487,473,473
Siskiyou,7,2022-01-30,114,114,89,25,675,675,524,151,11,1,1,2,69,69,68,68
Solano,7,2022-01-30,4087,4087,3062,1025,29832,29832,22330,7502,126,8,8,31,429,429,421,421
Sonoma,7,2022-01-30,4004,4004,3008,996,33090,33090,24863,8227,82,10,10,12,461,461,451,451
Stanislaus,7,2022-01-30,3897,3897,2556,1341,22547,22547,14784,7763,266,32,32,51,1536,1536,1504,1504
Sutter,7,2022-01-30,686,686,511,175,3889,3889,2890,999,0,2,2,0,207,207,205,205
Tehama,7,2022-01-30,403,403,268,135,2164,2164,1435,729,17,3,3,5,181,181,178,178
Trinity,7,2022-01-30,40,40,27,13,217,217,143,74,0,0,0,0,20,20,20,20
Tulare,7,2022-01-30,5204,5204,3385,1819,24384,24384,15845,8539,141,19,19,17,1375,1375,1356,1356
Tuolumne,7,2022-01-30,792,792,553,239,3405,3405,2380,1025,14,1,1,4,165,165,164,164
Ventura,7,2022-01-30,5204,5204,4229,975,54460,54460,44234,10226,252,33,33,55,1358,1358,1325,1325
Yolo,7,2022-01-30,1511,1511,1159,352,37775,37775,29045,8730,17,3,3,5,322,322,319,319
Yuba,7,2022-01-30,558,558,422,136,3010,3010,2277,733,71,3,3,8,111,111,108,108
Alameda,8,2022-02-06,6611,6611,5462,1149,120098,120103,99213,20890,278,43,43,62,1732,1732,1689,1689
Amador,8,2022-02-06,226,226,168,58,2989,2989,2222,767,12,3,3,4,77,77,74,74
Butte,8,2022-02-06,860,860,735,125,6638,6638,5664,974,73,7,7,10,393,393,386,386
Calaveras,8,2022-02-06,212,212,163,49,1557,1557,1197,360,2,2,2,1,106,106,104,104
Colusa,8,2022-02-06,81,81,65,16,566,566,451,115,3,0,0,0,21,21,21,21
Contra Costa,8,2022-02-06,4466,4466,3301,1165,56424,56424,41675,14749,168,34,34,52,1218,1218,1184,1184
Del Norte,8,2022-02-06,271,271,214,57,4059,4059,3200,859,6,0,0,0,44,44,44,44
El Dorado,8,2022-02-06,488,488,376,112,5148,5148,3969,1179,24,1,1,5,200,200,199,199
Fresno,8,2022-02-06,7111,7111,5331,1780,44960,44960,33712,11248,429,45,45,95,2615,2615,2570,2570
Glenn,8,2022-02-06,132,132,102,30,657,657,509,148,2,2,2,0,50,50,48,48
Humboldt,8,2022-02-06,496,496,390,106,5002,5002,3931,1071,12,1,1,3,136,136,135,135
Imperial,8,2022-02-06,1234,1234,947,287,8571,8571,6581,1990,52,14,14,27,907,907,893,893
Inyo,8,2022-02-06,53,53,42,11,452,452,360,92,5,1,1,1,56,56,55,55
Kern,8,2022-02-06,3786,3786,3038,748,35782,35782,28692,7090,182,42,42,49,2235,2235,2193,2193
Kings,8,2022-02-06,1481,1481,1140,341,10635,10635,8182,2453,47,13,13,6,419,419,406,406
Lake,8,2022-02-06,371,371,277,94,2739,2739,2039,700,7,1,1,5,128,128,127,127
Lassen,8,2022-02-06,144,144,117,27,2967,2967,2413,554,5,2,2,0,57,57,55,55
Los Angeles,8,2022-02-06,41931,41931,38703,3228,1174969,1175008,1084425,90583,2181,651,651,592,30213,30213,29562,29562
Madera,8,2022-02-06,1173,1173,876,297,8436,8436,6301,2135,34,5,5,14,362,362,357,357
Marin,8,2022-02-06,705,705,532,173,11790,11790,8890,2900,28,6,6,6,223,223,217,217
Mariposa,8,2022-02-06,55,55,41,14,621,621,458,163,0,1,1,0,24,24,23,23
Mendocino,8,2022-02-06,357,357,247,110,2936,2936,2027,909,9,1,1,6,115,115,114,114
Merced,8,2022-02-06,1356,1356,1079,277,8375,8375,6663,1712,50,10,10,14,767,767,757,757
Modoc,8,2022-02-06,23,23,18,5,160,160,129,31,3,0,0,0,8,8,8,8
Mono,8,2022-02-06,45,45,29,16,268,268,174,94,0,0,0,0,5,5,5,5
Monterey,8,2022-02-06,2444,2444,1595,849,22898,22898,14939,7959,73,10,10,14,687,687,677,677
Napa,8,2022-02-06,798,798,652,146,8028,8028,6550,1478,12,8,8,1,129,129,121,121
Nevada,8,2022-02-06,381,381,286,95,3263,3263,2445,818,23,3,3,2,122,122,119,119
Orange,8,2022-02-06,7095,7095,5939,1156,154982,154987,129651,25336,497,118,118,123,6746,6746,6628,6628
Placer,8,2022-02-06,1445,1445,1060,385,12547,12547,9190,3357,148,24,24,35,584,584,560,560
Plumas,8,2022-02-06,91,91,69,22,579,579,437,142,1,1,1,0,13,13,12,12
Riverside,8,2022-02-06,9073,9073,7190,1883,98020,98024,77658,20366,564,107,107,122,6193,6193,6086,6086
Sacramento,8,2022-02-06,6671,6671,5204,1467,65688,65688,51194,14494,398,74,74,97,2859,2859,2785,2785
San Benito,8,2022-02-06,322,322,262,60,2775,2775,2254,521,4,1,1,4,90,90,89,89
San Bernardino,8,2022-02-06,7844,7844,6476,1368,93622,93626,77294,16332,527,154,154,170,7414,7414,7260,7260
San Diego,8,2022-02-06,15102,15102,13881,1221,156696,156701,144049,12652,783,115,115,176,5054,5054,4939,4939
San Francisco,8,2022-02-06,2575,2575,1633,942,56717,56717,35928,20789,175,26,26,39,789,789,763,763
San Joaquin,8,2022-02-06,3766,3766,2869,897,38185,38185,29080,9105,193,40,40,59,2143,2143,2103,2103
San Luis Obispo,8,2022-02-06,1377,1377,1108,269,13193,13193,10618,2575,29,15,15,7,427,427,412,412
San Mateo,8,2022-02-06,2700,2700,2259,441,63552,63552,53131,10421,99,16,16,18,668,668,652,652
Santa Barbara,8,2022-02-06,2641,2641,2079,562,33157,33157,26093,7064,79,17,17,19,650,650,633,633
Santa Clara,8,2022-02-06,8886,8886,8129,757,178884,178889,163604,15285,370,31,31,75,2179,2179,2148,2148
Santa Cruz,8,2022-02-06,2046,2046,1665,381,39172,39172,31833,7339,25,3,3,7,249,249,246,246
Shasta,8,2022-02-06,715,715,558,157,7100,7100,5528,1572,62,16,16,13,503,503,487,487
Siskiyou,8,2022-02-06,100,100,82,18,710,710,579,131,8,3,3,0,72,72,69,69
Solano,8,2022-02-06,2467,2467,1950,517,24388,24388,19303,5085,97,5,5,27,434,434,429,429
Sonoma,8,2022-02-06,2271,2271,1808,463,27706,27706,22024,5682,59,8,8,11,469,469,461,461
Stanislaus,8,2022-02-06,2751,2751,1952,799,19557,19557,13868,5689,231,43,43,41,1579,1579,1536,1536
Sutter,8,2022-02-06,410,410,323,87,3462,3462,2726,736,0,7,7,0,214,214,207,207
Tehama,8,2022-02-06,314,314,225,89,1725,1725,1235,490,17,1,1,6,182,182,181,181
Trinity,8,2022-02-06,23,23,16,7,149,149,105,44,0,0,0,0,20,20,20,20
Tulare,8,2022-02-06,3016,3016,2126,890,18531,18531,13049,5482,131,32,32,22,1407,1407,1375,1375
Tuolumne,8,2022-02-06,406,406,304,102,2674,2674,2002,672,11,3,3,1,168,168,165,165
Ventura,8,2022-02-06,2897,2897,2458,439,42921,42921,36363,6558,206,44,44,42,1402,1402,1358,1358
Yolo,8,2022-02-06,942,942,763,179,31958,31958,25872,6086,10,12,12,5,334,334,322,322
Yuba,8,2022-02-06,378,378,302,76,2477,2477,1979,498,50,5,5,13,116,116,111,111
Alameda,9,2022-02-13,3826,3826,3287,539,102457,102462,88009,14453,191,43,43,53,1775,1775,1732,1732
Amador,9,2022-02-13,111,111,87,24,2446,2446,1928,518,7,2,2,4,79,79,77,77
Butte,9,2022-02-13,519,519,458,61,5735,5735,5057,678,66,10,10,8,403,403,393,393
Calaveras,9,2022-02-13,99,99,80,19,1302,1302,1055,247,4,2,2,2,108,108,106,106
Colusa,9,2022-02-13,43,43,36,7,520,520,433,87,4,0,0,0,21,21,21,21
Contra Costa,9,2022-02-13,2703,2703,2119,584,46167,46167,36187,9980,133,25,25,33,1243,1243,1218,1218
Del Norte,9,2022-02-13,234,234,193,41,3537,3537,2921,616,7,0,0,2,44,44,44,44
El Dorado,9,2022-02-13,286,286,232,54,4639,4639,3766,873,22,4,4,3,204,204,200,200
Fresno,9,2022-02-13,4197,4197,3332,865,36151,36151,28690,7461,370,35,35,76,2650,2650,2615,2615
Glenn,9,2022-02-13,65,65,53,12,496,496,404,92,4,3,3,0,53,53,50,50
Humboldt,9,2022-02-13,367,367,303,64,4436,4436,3657,779,17,0,0,2,136,136,136,136
Imperial,9,2022-02-13,678,678,548,130,6454,6454,5223,1231,47,14,14,19,921,921,907,907
Inyo,9,2022-02-13,28,28,23,5,406,406,338,68,3,0,0,0,56,56,56,56
Kern,9,2022-02-13,2314,2314,1941,373,29982,29982,25137,4845,155,30,30,43,2265,2265,2235,2235
Kings,9,2022-02-13,872,872,707,165,8400,8400,6807,1593,44,9,9,5,428,428,419,419
Lake,9,2022-02-13,262,262,207,55,2406,2406,1896,510,6,2,2,5,130,130,128,128
Lassen,9,2022-02-13,149,149,127,22,3133,3133,2657,476,3,2,2,0,59,59,57,57
Los Angeles,9,2022-02-13,23798,23798,22347,1451,1077684,1077725,1011776,65949,1617,518,518,437,30731,30731,30213,30213
Madera,9,2022-02-13,689,689,545,144,6943,6943,5491,1452,35,3,3,9,365,365,362,362
Marin,9,2022-02-13,410,410,327,83,10309,10309,8221,2088,24,7,7,6,230,230,223,223
Mariposa,9,2022-02-13,26,26,20,6,434,434,340,94,0,0,0,0,24,24,24,24
Mendocino,9,2022-02-13,221,221,164,57,2486,2486,1841,645,13,2,2,5,117,117,115,115
Merced,9,2022-02-13,828,828,691,137,7246,7246,6037,1209,40,12,12,7,779,779,767,767
Modoc,9,2022-02-13,20,20,17,3,184,184,154,30,0,0,0,0,8,8,8,8
Mono,9,2022-02-13,14,14,10,4,183,183,129,54,0,0,0,0,5,5,5,5
Monterey,9,2022-02-13,1387,1387,980,407,18558,18558,13095,5463,70,13,13,12,700,700,687,687
Napa,9,2022-02-13,442,442,376,66,6807,6807,5787,1020,15,2,2,2,131,131,129,129
Nevada,9,2022-02-13,200,200,159,41,2707,2707,2145,562,17,1,1,3,123,123,122,122
Orange,9,2022-02-13,4330,4330,3761,569,135794,135799,117780,18019,364,121,121,89,6867,6867,6746,6746
Placer,9,2022-02-13,696,696,542,154,10387,10387,8083,2304,112,14,14,22,598,598,584,584
Plumas,9,2022-02-13,48,48,38,10,442,442,352,90,3,0,0,0,13,13,13,13
Riverside,9,2022-02-13,5155,5155,4283,872,78657,78661,65305,13356,395,91,91,95,6284,6284,6193,6193
Sacramento,9,2022-02-13,3771,3771,3091,680,55612,55612,45554,10058,345,58,58,67,2917,2917,2859,2859
San Benito,9,2022-02-13,180,180,152,28,2284,2284,1935,349,3,2,2,3,92,92,90,90
San Bernardino,9,2022-02-13,4198,4198,3604,594,76612,76615,65776,10839,374,111,111,125,7525,7525,7414,7414
San Diego,9,2022-02-13,8996,8996,8419,577,130919,130924,122529,8395,584,94,94,144,5148,5148,5054,5054
San Francisco,9,2022-02-13,1738,1738,1196,542,48822,48822,33630,15192,128,28,28,39,817,817,789,789
San Joaquin,9,2022-02-13,2256,2256,1815,441,32282,32282,25942,6340,136,38,38,48,2181,2181,2143,2143
San Luis Obispo,9,2022-02-13,878,878,738,140,10462,10462,8800,1662,22,10,10,7,437,437,427,427
San Mateo,9,2022-02-13,1462,1462,1269,193,56656,56656,49138,7518,61,17,17,16,685,685,668,668
Santa Barbara,9,2022-02-13,1210,1210,1000,210,23305,23305,19260,4045,64,8,8,13,658,658,650,650
Santa Clara,9,2022-02-13,5116,5116,4770,346,159771,159776,148916,10860,302,29,29,60,2208,2208,2179,2179
Santa Cruz,9,2022-02-13,1139,1139,965,174,34446,34446,29190,5256,22,4,4,4,253,253,249,249
Shasta,9,2022-02-13,486,486,398,88,6152,6152,5034,1118,60,11,11,13,514,514,503,503
Siskiyou,9,2022-02-13,80,80,68,12,583,583,495,88,3,1,1,2,73,73,72,72
Solano,9,2022-02-13,1339,1339,1111,228,20185,20185,16741,3444,74,1,1,20,435,435,434,434
Sonoma,9,2022-02-13,1306,1306,1088,218,23111,23111,19230,3881,50,9,9,15,478,478,469,469
Stanislaus,9,2022-02-13,1568,1568,1189,379,16044,16044,12153,3891,214,28,28,43,1607,1607,1579,1579
Sutter,9,2022-02-13,233,233,193,40,2954,2954,2441,513,0,3,3,0,217,217,214,214
Tehama,9,2022-02-13,195,195,149,46,1481,1481,1132,349,14,7,7,5,189,189,182,182
Trinity,9,2022-02-13,20,20,15,5,172,172,131,41,0,0,0,0,20,20,20,20
Tulare,9,2022-02-13,1698,1698,1280,418,16175,16175,12193,3982,122,24,24,20,1431,1431,1407,1407
Tuolumne,9,2022-02-13,218,218,173,45,2320,2320,1839,481,11,4,4,1,172,172,168,168
Ventura,9,2022-02-13,1692,1692,1485,207,37979,37979,33290,4689,146,36,36,27,1438,1438,1402,1402
Yolo,9,2022-02-13,551,551,465,86,28595,28595,24168,4427,13,8,8,3,342,342,334,334
Yuba,9,2022-02-13,231,231,193,38,2197,2197,1837,360,24,2,2,12,118,118,116,116
Alameda,10,2022-02-20,2187,2187,1940,247,89855,89860,79647,10213,148,27,27,33,1802,1802,1775,1775
Amador,10,2022-02-20,87,87,72,15,2141,2141,1771,370,6,5,5,3,84,84,79,79
Butte,10,2022-02-20,302,302,274,28,4860,4860,4402,458,64,11,11,5,414,414,403,403
Calaveras,10,2022-02-20,48,48,41,7,936,936,791,145,4,5,5,1,113,113,108,108
Colusa,10,2022-02-20,25,25,22,3,382,382,331,51,4,0,0,0,21,21,21,21
Contra Costa,10,2022-02-20,1535,1535,1263,272,39475,39475,32472,7003,80,19,19,26,1262,1262,1243,1243
Del Norte,10,2022-02-20,146,146,125,21,2969,2969,2548,421,9,0,0,1,44,44,44,44
El Dorado,10,2022-02-20,170,170,144,26,4018,4018,3405,613,5,2,2,4,206,206,204,204
Fresno,10,2022-02-20,2353,2353,1957,396,29609,29609,24619,4990,274,31,31,63,2681,2681,2650,2650
Glenn,10,2022-02-20,32,32,27,5,443,443,376,67,2,0,0,0,53,53,53,53
Humboldt,10,2022-02-20,227,227,195,32,3728,3728,3198,530,17,3,3,2,139,139,136,136
Imperial,10,2022-02-20,426,426,360,66,5183,5183,4383,800,33,6,6,10,927,927,921,921
Inyo,10,2022-02-20,13,13,11,2,372,372,321,51,1,0,0,0,56,56,56,56
Kern,10,2022-02-20,1402,1402,1221,181,25799,25799,22448,3351,94,23,23,26,2288,2288,2265,2265
Kings,10,2022-02-20,553,553,469,84,7335,7335,6213,1122,29,5,5,6,433,433,428,428
Lake,10,2022-02-20,215,215,178,37,2208,2208,1827,381,7,2,2,1,132,132,130,130
Lassen,10,2022-02-20,125,125,110,15,2334,2334,2048,286,4,0,0,0,59,59,59,59
Los Angeles,10,2022-02-20,13639,13639,12983,656,985738,985780,938133,47647,1021,343,343,289,31074,31074,30731,30731
Madera,10,2022-02-20,403,403,334,69,5829,5829,4831,998,30,2,2,6,367,367,365,365
Marin,10,2022-02-20,253,253,211,42,9916,9916,8277,1639,13,3,3,4,233,233,230,230
Mariposa,10,2022-02-20,23,23,19,4,403,403,332,71,0,1,1,0,25,25,24,24
Mendocino,10,2022-02-20,132,132,104,28,2231,2231,1754,477,9,2,2,3,119,119,117,117
Merced,10,2022-02-20,541,541,468,73,5930,5930,5130,800,32,14,14,7,793,793,779,779
Modoc,10,2022-02-20,10,10,9,1,73,73,63,10,1,0,0,0,8,8,8,8
Mono,10,2022-02-20,8,8,6,2,174,174,131,43,0,1,1,0,6,6,5,5
Monterey,10,2022-02-20,927,927,702,225,15174,15174,11470,3704,53,5,5,7,705,705,700,700
Napa,10,2022-02-20,284,284,250,34,5779,5779,5082,697,6,3,3,3,134,134,131,131
Nevada,10,2022-02-20,125,125,104,21,2381,2381,1978,403,17,4,4,3,127,127,123,123
Orange,10,2022-02-20,2781,2781,2487,294,126487,126492,113017,13475,258,79,79,76,6946,6946,6867,6867
Placer,10,2022-02-20,368,368,302,66,9421,9421,7712,1709,100,10,10,12,608,608,598,598
Plumas,10,2022-02-20,25,25,21,4,391,391,326,65,1,0,0,0,13,13,13,13
Riverside,10,2022-02-20,2763,2763,2384,379,66930,66934,57754,9180,259,53,53,62,6337,6337,6284,6284
Sacramento,10,2022-02-20,2297,2297,1961,336,48691,48691,41547,7144,268,38,38,40,2955,2955,2917,2917
San Benito,10,2022-02-20,134,134,118,16,2053,2053,1801,252,0,0,0,1,92,92,92,92
San Bernardino,10,2022-02-20,2181,2181,1934,247,66254,66257,58741,7516,261,96,96,82,7621,7621,7525,7525
San Diego,10,2022-02-20,5187,5187,4924,263,110524,110529,104920,5609,461,67,67,115,5215,5215,5148,5148
San Francisco,10,2022-02-20,1091,1091,807,284,44598,44598,32973,11625,107,11,11,26,828,828,817,817
San Joaquin,10,2022-02-20,1231,1231,1035,196,27384,27384,23003,4381,89,24,24,34,2205,2205,2181,2181
San Luis Obispo,10,2022-02-20,557,557,485,72,8966,8966,7816,1150,21,14,14,2,451,451,437,437
San Mateo,10,2022-02-20,841,841,751,90,49042,49042,43804,5238,47,5,5,10,690,690,685,685
Santa Barbara,10,2022-02-20,731,731,628,103,21503,21503,18468,3035,41,7,7,11,665,665,658,658
Santa Clara,10,2022-02-20,2872,2872,2718,154,140222,140227,132670,7557,230,26,26,55,2234,2234,2208,2208
Santa Cruz,10,2022-02-20,667,667,585,82,28110,28110,24663,3447,19,1,1,4,254,254,253,253
Shasta,10,2022-02-20,312,312,266,46,5368,5368,4576,792,54,11,11,13,525,525,514,514
Siskiyou,10,2022-02-20,49,49,43,6,532,532,468,64,8,2,2,3,75,75,73,73
Solano,10,2022-02-20,780,780,672,108,16657,16657,14361,2296,52,5,5,15,440,440,435,435
Sonoma,10,2022-02-20,718,718,621,97,18879,18879,16317,2562,35,2,2,9,480,480,478,478
Stanislaus,10,2022-02-20,858,858,687,171,13259,13259,10612,2647,157,29,29,30,1636,1636,1607,1607
Sutter,10,2022-02-20,148,148,127,21,2397,2397,2059,338,0,1,1,0,218,218,217,217
Tehama,10,2022-02-20,109,109,88,21,1269,1269,1023,246,6,7,7,5,196,196,189,189
Trinity,10,2022-02-20,17,17,14,3,217,217,174,43,0,0,0,0,20,20,20,20
Tulare,10,2022-02-20,899,899,716,183,12319,12319,9812,2507,94,19,19,8,1450,1450,1431,1431
Tuolumne,10,2022-02-20,112,112,93,19,1940,1940,1611,329,4,5,5,2,177,177,172,172
Ventura,10,2022-02-20,984,984,888,96,30821,30821,27775,3046,107,22,22,20,1460,1460,1438,1438
Yolo,10,2022-02-20,323,323,283,40,23548,23548,20608,2940,7,5,5,3,347,347,342,342
Yuba,10,2022-02-20,153,153,133,20,1771,1771,1536,235,23,2,2,8,120,120,118,118
Alameda,11,2022-02-27,1430,1430,1302,128,69556,69560,63316,6244,115,14,14,24,1816,1816,1802,1802
Amador,11,2022-02-27,64,64,55,9,1973,1973,1699,274,7,0,0,2,84,84,84,84
Butte,11,2022-02-27,180,180,167,13,4189,4189,3876,313,42,7,7,2,421,421,414,414
Calaveras,11,2022-02-27,35,35,31,4,1073,1073,941,132,0,4,4,0,117,117,113,113
Colusa,11,2022-02-27,11,11,10,1,375,375,335,40,4,0,0,0,21,21,21,21
Contra Costa,11,2022-02-27,935,935,802,133,31807,31807,27277,4530,67,15,15,16,1277,1277,1262,1262
Del Norte,11,2022-02-27,82,82,73,9,2643,2643,2342,301,4,2,2,3,46,46,44,44
El Dorado,11,2022-02-27,109,109,96,13,3351,3351,2942,409,4,2,2,3,208,208,206,206
Fresno,11,2022-02-27,1306,1306,1129,177,24708,24708,21355,3353,198,26,26,51,2707,2707,2681,2681
Glenn,11,2022-02-27,19,19,17,2,394,394,346,48,0,1,1,0,54,54,53,53
Humboldt,11,2022-02-27,148,148,131,17,2765,2765,2450,315,6,1,1,2,140,140,139,139
Imperial,11,2022-02-27,282,282,247,35,4456,4456,3902,554,12,6,6,11,933,933,927,927
Inyo,11,2022-02-27,9,9,8,1,331,331,295,36,0,0,0,0,56,56,56,56
Kern,11,2022-02-27,810,810,726,84,22406,22406,20077,2329,78,17,17,21,2305,2305,2288,2288
Kings,11,2022-02-27,246,246,216,30,5774,5774,5061,713,23,6,6,3,439,439,433,433
Lake,11,2022-02-27,124,124,107,17,1816,1816,1563,253,3,3,3,1,135,135,132,132
Lassen,11,2022-02-27,48,48,43,5,1916,1916,1728,188,1,2,2,0,61,61,59,59
Los Angeles,11,2022-02-27,8232,8232,7922,310,926051,926092,891222,34870,734,224,224,182,31298,31298,31074,31074
Madera,11,2022-02-27,194,194,168,26,4216,4216,3638,578,22,2,2,5,369,369,367,367
Marin,11,2022-02-27,139,139,121,18,7126,7126,6180,946,10,3,3,2,236,236,233,233
Mariposa,11,2022-02-27,32,32,27,5,324,324,278,46,0,1,1,0,26,26,25,25
Mendocino,11,2022-02-27,77,77,64,13,1726,1726,1426,300,12,1,1,4,120,120,119,119
Merced,11,2022-02-27,258,258,231,27,4678,4678,4174,504,25,8,8,3,801,801,793,793
Modoc,11,2022-02-27,6,6,5,1,49,49,44,5,1,0,0,0,8,8,8,8
Mono,11,2022-02-27,4,4,3,1,162,162,129,33,0,0,0,0,6,6,6,6
Monterey,11,2022-02-27,358,358,286,72,12488,12488,9989,2499,27,9,9,6,714,714,705,705
Napa,11,2022-02-27,179,179,162,17,5010,5010,4531,479,8,4,4,2,138,138,134,134
Nevada,11,2022-02-27,74,74,64,10,1954,1954,1688,266,9,0,0,3,127,127,127,127
Orange,11,2022-02-27,1765,1765,1617,148,114513,114517,104896,9621,189,50,50,41,6996,6996,6946,6946
Placer,11,2022-02-27,242,242,207,35,7816,7816,6668,1148,71,3,3,14,611,611,608,608
Plumas,11,2022-02-27,24,24,21,3,338,338,293,45,0,0,0,0,13,13,13,13
Riverside,11,2022-02-27,1713,1713,1525,188,59400,59401,52880,6521,200,41,41,43,6378,6378,6337,6337
Sacramento,11,2022-02-27,1155,1155,1020,135,41244,41244,36404,4840,181,28,28,35,2983,2983,2955,2955
San Benito,11,2022-02-27,51,51,46,5,1594,1594,1439,155,0,0,0,1,92,92,92,92
San Bernardino,11,2022-02-27,1198,1198,1090,108,56504,56505,51409,5096,165,68,68,50,7689,7689,7621,7621
San Diego,11,2022-02-27,3132,3132,3008,124,93762,93767,90043,3724,351,36,36,84,5251,5251,5215,5215
San Francisco,11,2022-02-27,849,849,667,182,36923,36923,29012,7911,76,14,14,20,842,842,828,828
San Joaquin,11,2022-02-27,672,672,586,86,23707,23707,20662,3045,62,15,15,21,2220,2220,2205,2205
San Luis Obispo,11,2022-02-27,315,315,283,32,7521,7521,6755,766,12,8,8,3,459,459,451,451
San Mateo,11,2022-02-27,562,562,515,47,35512,35512,32516,2996,38,7,7,8,697,697,690,690
Santa Barbara,11,2022-02-27,374,374,332,42,19536,19536,17335,2201,31,5,5,11,670,670,665,665
Santa Clara,11,2022-02-27,1725,1725,1653,72,86164,86168,82560,3608,203,24,24,43,2258,2258,2234,2234
Santa Cruz,11,2022-02-27,465,465,420,45,23808,23808,21492,2316,15,2,2,4,256,256,254,254
Shasta,11,2022-02-27,164,164,145,19,4639,4639,4090,549,42,11,11,8,536,536,525,525
Siskiyou,11,2022-02-27,25,25,23,2,403,403,364,39,3,4,4,2,79,79,75,75
Solano,11,2022-02-27,476,476,424,52,14233,14233,12666,1567,45,2,2,17,442,442,440,440
Sonoma,11,2022-02-27,446,446,398,48,14987,14987,13366,1621,27,2,2,5,482,482,480,480
Stanislaus,11,2022-02-27,470,470,394,76,12103,12103,10143,1960,119,15,15,22,1651,1651,1636,1636
Sutter,11,2022-02-27,101,101,90,11,2200,2200,1953,247,0,2,2,0,220,220,218,218
Tehama,11,2022-02-27,59,59,50,9,1133,1133,955,178,7,4,4,2,200,200,196,196
Trinity,11,2022-02-27,5,5,4,1,107,107,90,17,0,0,0,0,20,20,20,20
Tulare,11,2022-02-27,481,481,402,79,11040,11040,9218,1822,68,16,16,9,1466,1466,1450,1450
Tuolumne,11,2022-02-27,77,77,66,11,1432,1432,1236,196,7,3,3,1,180,180,177,177
Ventura,11,2022-02-27,569,569,525,44,27251,27251,25120,2131,72,14,14,17,1474,1474,1460,1460
Yolo,11,2022-02-27,206,206,186,20,22967,22967,20692,2275,6,5,5,4,352,352,347,347
Yuba,11,2022-02-27,80,80,72,8,1701,1701,1520,181,14,2,2,6,122,122,120,120
Alameda,12,2022-03-06,1174,1174,1090,84,73611,73616,68304,5312,83,13,13,19,1829,1829,1816,1816
Amador,12,2022-03-06,76,76,67,9,1434,1434,1272,162,5,2,2,1,86,86,84,84
Butte,12,2022-03-06,122,122,115,7,3830,3830,3602,228,33,4,4,3,425,425,421,421
Calaveras,12,2022-03-06,31,31,28,3,1125,1125,1012,113,1,1,1,0,118,118,117,117
Colusa,12,2022-03-06,9,9,8,1,352,352,322,30,6,0,0,0,21,21,21,21
Contra Costa,12,2022-03-06,642,642,569,73,31715,31715,28053,3662,48,10,10,13,1287,1287,1277,1277
Del Norte,12,2022-03-06,52,52,47,5,1877,1877,1706,171,4,1,1,1,47,47,46,46
El Dorado,12,2022-03-06,87,87,79,8,3242,3242,2922,320,6,3,3,2,211,211,208,208
Fresno,12,2022-03-06,917,917,817,100,22454,22454,19995,2459,139,20,20,29,2727,2727,2707,2707
Glenn,12,2022-03-06,17,17,15,2,409,409,369,40,2,1,1,0,55,55,54,54
Humboldt,12,2022-03-06,93,93,85,8,3081,3081,2801,280,6,3,3,4,143,143,140,140
Imperial,12,2022-03-06,152,152,137,15,4461,4461,4015,446,9,5,5,10,938,938,933,933
Inyo,12,2022-03-06,9,9,8,1,364,364,332,32,0,0,0,0,56,56,56,56
Kern,12,2022-03-06,494,494,453,41,21517,21517,19721,1796,64,9,9,15,2314,2314,2305,2305
Kings,12,2022-03-06,159,159,143,16,5033,5033,4532,501,14,4,4,1,443,443,439,439
Lake,12,2022-03-06,69,69,61,8,1792,1792,1590,202,3,3,3,1,138,138,135,135
Lassen,12,2022-03-06,91,91,84,7,1915,1915,1764,151,0,1,1,0,62,62,61,61
Los Angeles,12,2022-03-06,5921,5921,5745,176,887190,887232,860696,26536,601,180,180,130,31478,31478,31298,31298
Madera,12,2022-03-06,129,129,115,14,4036,4036,3588,448,11,1,1,2,370,370,369,369
Marin,12,2022-03-06,166,166,148,18,7593,7593,6776,817,11,0,0,1,236,236,236,236
Mariposa,12,2022-03-06,13,13,11,2,301,301,266,35,0,1,1,0,27,27,26,26
Mendocino,12,2022-03-06,70,70,60,10,1745,1745,1497,248,7,1,1,1,121,121,120,120
Merced,12,2022-03-06,194,194,177,17,4658,4658,4255,403,19,7,7,6,808,808,801,801
Modoc,12,2022-03-06,1,1,1,0,54,54,49,5,0,0,0,0,8,8,8,8
Mono,12,2022-03-06,3,3,2,1,135,135,113,22,0,0,0,1,6,6,6,6
Monterey,12,2022-03-06,255,255,213,42,11400,11400,9522,1878,22,6,6,3,720,720,714,714
Napa,12,2022-03-06,202,202,187,15,4975,4975,4593,382,4,2,2,2,140,140,138,138
Nevada,12,2022-03-06,47,47,42,5,1741,1741,1550,191,4,2,2,0,129,129,127,127
Orange,12,2022-03-06,1347,1347,1257,90,109321,109326,101966,7360,142,29,29,37,7025,7025,6996,6996
Placer,12,2022-03-06,173,173,152,21,7835,7835,6904,931,57,3,3,12,614,614,611,611
Plumas,12,2022-03-06,5,5,4,1,275,275,245,30,0,0,0,0,13,13,13,13
Riverside,12,2022-03-06,1059,1059,966,93,54873,54874,50036,4838,141,30,30,31,6408,6408,6378,6378
Sacramento,12,2022-03-06,826,826,748,78,40154,40154,36357,3797,132,19,19,28,3002,3002,2983,2983
San Benito,12,2022-03-06,37,37,34,3,1542,1542,1421,121,0,2,2,1,94,94,92,92
San Bernardino,12,2022-03-06,853,853,791,62,54916,54917,50954,3963,88,37,37,45,7726,7726,7689,7689
San Diego,12,2022-03-06,2414,2414,2339,75,96458,96463,93434,3029,246,37,37,62,5288,5288,5251,5251
San Francisco,12,2022-03-06,691,691,570,121,38216,38216,31473,6743,56,8,8,11,850,850,842,842
San Joaquin,12,2022-03-06,461,461,414,47,21732,21732,19483,2249,41,9,9,17,2229,2229,2220,2220
San Luis Obispo,12,2022-03-06,299,299,274,25,7332,7332,6731,601,7,5,5,1,464,464,459,459
San Mateo,12,2022-03-06,556,556,519,37,41679,41679,38852,2827,32,1,1,4,698,698,697,697
Santa Barbara,12,2022-03-06,200,200,182,18,18121,18121,16478,1643,18,4,4,9,674,674,670,670
Santa Clara,12,2022-03-06,1488,1488,1439,49,116992,116997,113085,3912,140,13,13,43,2271,2271,2258,2258
Santa Cruz,12,2022-03-06,344,344,317,27,24981,24981,23021,1960,11,0,0,7,256,256,256,256
Shasta,12,2022-03-06,149,149,135,14,4965,4965,4494,471,33,9,9,4,545,545,536,536
Siskiyou,12,2022-03-06,15,15,14,1,414,414,382,32,2,1,1,0,80,80,79,79
Solano,12,2022-03-06,368,368,335,33,14029,14029,12785,1244,44,4,4,11,446,446,442,442
Sonoma,12,2022-03-06,368,368,336,32,15367,15367,14029,1338,26,4,4,7,486,486,482,482
Stanislaus,12,2022-03-06,296,296,257,39,11072,11072,9613,1459,98,11,11,14,1662,1662,1651,1651
Sutter,12,2022-03-06,86,86,78,8,1982,1982,1802,180,0,2,2,0,222,222,220,220
Tehama,12,2022-03-06,45,45,39,6,1202,1202,1049,153,3,2,2,1,202,202,200,200
Trinity,12,2022-03-06,5,5,4,1,114,114,99,15,0,0,0,0,20,20,20,20
Tulare,12,2022-03-06,315,315,273,42,10276,10276,8899,1377,39,9,9,5,1475,1475,1466,1466
Tuolumne,12,2022-03-06,55,55,49,6,1265,1265,1125,140,1,1,1,2,181,181,180,180
Ventura,12,2022-03-06,423,423,397,26,27173,27173,25477,1696,39,4,4,15,1478,1478,1474,1474
Yolo,12,2022-03-06,161,161,148,13,22276,22276,20495,1781,4,1,1,2,353,353,352,352
Yuba,12,2022-03-06,65,65,60,5,1586,1586,1451,135,17,0,0,6,122,122,122,122
Alameda,13,2022-03-13,945,945,891,54,68777,68782,64850,3932,71,9,9,6,1838,1838,1829,1829
Amador,13,2022-03-13,33,33,30,3,1434,1434,1305,129,4,0,0,0,86,86,86,86
Butte,13,2022-03-13,75,75,72,3,3609,3609,3440,169,22,2,2,1,427,427,425,425
Calaveras,13,2022-03-13,14,14,13,1,1034,1034,952,82,2,1,1,0,119,119,118,118
Colusa,13,2022-03-13,6,6,6,0,256,256,238,18,2,0,0,0,21,21,21,21
Contra Costa,13,2022-03-13,582,582,529,53,29124,29124,26438,2686,20,5,5,9,1292,1292,1287,1287
Del Norte,13,2022-03-13,42,42,39,3,1447,1447,1342,105,3,2,2,1,49,49,47,47
El Dorado,13,2022-03-13,46,46,42,4,3048,3048,2808,240,4,0,0,2,211,211,211,211
Fresno,13,2022-03-13,585,585,534,51,21406,21406,19535,1871,119,10,10,20,2737,2737,2727,2727
Glenn,13,2022-03-13,12,12,11,1,342,342,315,27,1,1,1,0,56,56,55,55
Humboldt,13,2022-03-13,58,58,54,4,2747,2747,2547,200,5,1,1,2,144,144,143,143
Imperial,13,2022-03-13,82,82,75,7,4555,4555,4190,365,5,2,2,8,940,940,938,938
Inyo,13,2022-03-13,8,8,7,1,170,170,158,12,0,0,0,0,56,56,56,56
Kern,13,2022-03-13,303,303,283,20,20228,20228,18890,1338,43,17,17,13,2331,2331,2314,2314
Kings,13,2022-03-13,217,217,200,17,4871,4871,4486,385,16,2,2,1,445,445,443,443
Lake,13,2022-03-13,59,59,54,5,1610,1610,1465,145,0,1,1,0,139,139,138,138
Lassen,13,2022-03-13,17,17,16,1,1487,1487,1394,93,0,0,0,0,62,62,62,62
Los Angeles,13,2022-03-13,4260,4260,4161,99,848029,848074,828181,19893,402,135,135,98,31613,31613,31478,31478
Madera,13,2022-03-13,74,74,67,7,3705,3705,3376,329,11,0,0,3,370,370,370,370
Marin,13,2022-03-13,172,172,157,15,6632,6632,6063,569,6,2,2,0,238,238,236,236
Mariposa,13,2022-03-13,8,8,7,1,226,226,205,21,0,0,0,0,27,27,27,27
Mendocino,13,2022-03-13,41,41,36,5,1482,1482,1313,169,4,0,0,1,121,121,121,121
Merced,13,2022-03-13,144,144,134,10,4208,4208,3920,288,19,2,2,5,810,810,808,808
Modoc,13,2022-03-13,3,3,3,0,56,56,52,4,1,0,0,0,8,8,8,8
Mono,13,2022-03-13,2,2,2,0,103,103,89,14,0,0,0,0,6,6,6,6
Monterey,13,2022-03-13,166,166,144,22,10348,10348,8968,1380,15,4,4,2,724,724,720,720
Napa,13,2022-03-13,140,140,131,9,4271,4271,4010,261,3,1,1,3,141,141,140,140
Nevada,13,2022-03-13,54,54,49,5,1609,1609,1468,141,2,0,0,1,129,129,129,129
Orange,13,2022-03-13,864,864,818,46,102982,102987,97511,5476,108,33,33,31,7058,7058,7025,7025
Placer,13,2022-03-13,156,156,141,15,7543,7543,6827,716,58,4,4,4,618,618,614,614
Plumas,13,2022-03-13,9,9,8,1,310,310,283,27,0,0,0,0,13,13,13,13
Riverside,13,2022-03-13,770,770,717,53,53106,53109,49404,3705,96,15,15,19,6423,6423,6408,6408
Sacramento,13,2022-03-13,615,615,569,46,37339,37339,34527,2812,113,15,15,21,3017,3017,3002,3002
San Benito,13,2022-03-13,41,41,38,3,1482,1482,1390,92,0,0,0,1,94,94,94,94
San Bernardino,13,2022-03-13,600,600,566,34,51567,51569,48618,2951,80,27,27,34,7753,7753,7726,7726
San Diego,13,2022-03-13,1897,1897,1850,47,96919,96924,94531,2393,168,18,18,50,5306,5306,5288,5288
San Francisco,13,2022-03-13,620,620,532,88,34993,34993,29991,5002,35,6,6,8,856,856,850,850
San Joaquin,13,2022-03-13,301,301,276,25,20525,20525,18833,1692,26,5,5,17,2234,2234,2229,2229
San Luis Obispo,13,2022-03-13,170,170,159,11,6929,6929,6478,451,6,7,7,1,471,471,464,464
San Mateo,13,2022-03-13,446,446,422,24,37442,37442,35437,2005,26,1,1,3,699,699,698,698
Santa Barbara,13,2022-03-13,196,196,182,14,17402,17402,16148,1254,17,6,6,2,680,680,674,674
Santa Clara,13,2022-03-13,1259,1259,1226,33,102654,102659,99967,2692,102,15,15,28,2286,2286,2271,2271
Santa Cruz,13,2022-03-13,238,238,223,15,22985,22985,21554,1431,8,3,3,4,259,259,256,256
Shasta,13,2022-03-13,103,103,95,8,4999,4999,4621,378,17,6,6,2,551,551,545,545
Siskiyou,13,2022-03-13,11,11,10,1,409,409,384,25,0,3,3,0,83,83,80,80
Solano,13,2022-03-13,242,242,225,17,12825,12825,11920,905,35,1,1,10,447,447,446,446
Sonoma,13,2022-03-13,230,230,214,16,13830,13830,12871,959,12,0,0,3,486,486,486,486
Stanislaus,13,2022-03-13,229,229,205,24,10171,10171,9096,1075,87,10,10,14,1672,1672,1662,1662
Sutter,13,2022-03-13,49,49,45,4,1811,1811,1680,131,0,0,0,0,222,222,222,222
Tehama,13,2022-03-13,24,24,22,2,1016,1016,912,104,1,2,2,0,204,204,202,202
Trinity,13,2022-03-13,3,3,3,0,97,97,87,10,0,0,0,0,20,20,20,20
Tulare,13,2022-03-13,196,196,175,21,9769,9769,8715,1054,34,4,4,3,1479,1479,1475,1475
Tuolumne,13,2022-03-13,25,25,23,2,1252,1252,1142,110,1,0,0,0,181,181,181,181
Ventura,13,2022-03-13,337,337,321,16,25118,25118,23877,1241,36,5,5,8,1483,1483,1478,1478
Yolo,13,2022-03-13,125,125,117,8,21631,21631,20259,1372,1,3,3,1,356,356,353,353
Yuba,13,2022-03-13,34,34,32,2,1453,1453,1355,98,9,2,2,3,124,124,122,122
Alameda,14,2022-03-20,711,711,679,32,67673,67678,64622,3056,57,6,6,2,1844,1844,1838,1838
Amador,14,2022-03-20,28,28,26,2,1376,1376,1277,99,2,0,0,0,86,86,86,86
Butte,14,2022-03-20,86,86,83,3,3216,3216,3097,119,16,0,0,1,427,427,427,427
Calaveras,14,2022-03-20,13,13,12,1,657,657,616,41,0,0,0,0,119,119,119,119
Colusa,14,2022-03-20,3,3,3,0,250,250,236,14,1,0,0,0,21,21,21,21
Contra Costa,14,2022-03-20,462,462,428,34,27863,27863,25816,2047,24,5,5,11,1297,1297,1292,1292
Del Norte,14,2022-03-20,21,21,20,1,1289,1289,1215,74,0,0,0,1,49,49,49,49
El Dorado,14,2022-03-20,42,42,39,3,2815,2815,2639,176,2,2,2,0,213,213,211,211
Fresno,14,2022-03-20,351,351,327,24,19658,19658,18292,1366,88,12,12,13,2749,2749,2737,2737
Glenn,14,2022-03-20,9,9,8,1,376,376,353,23,1,0,0,0,56,56,56,56
Humboldt,14,2022-03-20,37,37,35,2,2372,2372,2236,136,6,0,0,2,144,144,144,144
Imperial,14,2022-03-20,58,58,54,4,3985,3985,3733,252,5,1,1,4,941,941,940,940
Inyo,14,2022-03-20,1,1,1,0,152,152,144,8,0,0,0,0,56,56,56,56
Kern,14,2022-03-20,218,218,207,11,19708,19708,18677,1031,33,4,4,11,2335,2335,2331,2331
Kings,14,2022-03-20,77,77,72,5,4455,4455,4176,279,5,1,1,1,446,446,445,445
Lake,14,2022-03-20,17,17,16,1,1440,1440,1337,103,0,0,0,0,139,139,139,139
Lassen,14,2022-03-20,9,9,9,0,1451,1451,1379,72,0,0,0,0,62,62,62,62
Los Angeles,14,2022-03-20,4064,4064,3991,73,827068,827126,811918,15208,339,73,73,65,31686,31686,31613,31613
Madera,14,2022-03-20,43,43,40,3,3416,3416,3175,241,9,1,1,2,371,371,370,370
Marin,14,2022-03-20,141,141,131,10,6298,6298,5868,430,4,1,1,0,239,239,238,238
Mariposa,14,2022-03-20,9,9,8,1,250,250,231,19,0,0,0,0,27,27,27,27
Mendocino,14,2022-03-20,27,27,25,2,1493,1493,1358,135,4,2,2,1,123,123,121,121
Merced,14,2022-03-20,97,97,92,5,3887,3887,3676,211,13,4,4,2,814,814,810,810
Modoc,14,2022-03-20,2,2,2,0,53,53,50,3,0,0,0,0,8,8,8,8
Mono,14,2022-03-20,2,2,2,0,132,132,118,14,1,0,0,0,6,6,6,6
Monterey,14,2022-03-20,156,156,140,16,10227,10227,9134,1093,19,0,0,1,724,724,724,724
Napa,14,2022-03-20,61,61,58,3,3480,3480,3312,168,6,1,1,0,142,142,141,141
Nevada,14,2022-03-20,21,21,20,1,1518,1518,1412,106,2,0,0,0,129,129,129,129
Orange,14,2022-03-20,759,759,728,31,97912,97917,93810,4107,102,13,13,24,7071,7071,7058,7058
Placer,14,2022-03-20,114,114,105,9,6611,6611,6111,500,36,2,2,5,620,620,618,618
Plumas,14,2022-03-20,2,2,2,0,232,232,216,16,0,0,0,0,13,13,13,13
Riverside,14,2022-03-20,652,652,616,36,53474,53479,50518,2961,74,10,10,18,6433,6433,6423,6423
Sacramento,14,2022-03-20,490,490,461,29,32808,32808,30856,1952,95,14,14,10,3031,3031,3017,3017
San Benito,14,2022-03-20,25,25,24,1,1413,1413,1343,70,0,1,1,2,95,95,94,94
San Bernardino,14,2022-03-20,485,485,463,22,51471,51476,49152,2324,51,21,21,30,7774,7774,7753,7753
San Diego,14,2022-03-20,1476,1476,1447,29,88000,88005,86303,1702,158,13,13,34,5319,5319,5306,5306
San Francisco,14,2022-03-20,659,659,584,75,33636,33636,29769,3867,33,3,3,2,859,859,856,856
San Joaquin,14,2022-03-20,238,238,223,15,15548,15548,14534,1014,25,9,9,5,2243,2243,2234,2234
San Luis Obispo,14,2022-03-20,113,113,107,6,6568,6568,6230,338,2,5,5,1,476,476,471,471
San Mateo,14,2022-03-20,386,386,370,16,34228,34228,32786,1442,26,1,1,2,700,700,699,699
Santa Barbara,14,2022-03-20,175,175,165,10,15798,15798,14894,904,13,5,5,3,685,685,680,680
Santa Clara,14,2022-03-20,1077,1077,1055,22,96251,96256,94281,1975,104,4,4,22,2290,2290,2286,2286
Santa Cruz,14,2022-03-20,209,209,199,10,20514,20514,19503,1011,8,0,0,2,259,259,259,259
Shasta,14,2022-03-20,49,49,46,3,4220,4220,3966,254,8,5,5,2,556,556,551,551
Siskiyou,14,2022-03-20,8,8,8,0,353,353,336,17,1,0,0,0,83,83,83,83
Solano,14,2022-03-20,193,193,182,11,11677,11677,11026,651,20,1,1,4,448,448,447,447
Sonoma,14,2022-03-20,219,219,207,12,13348,13348,12618,730,14,3,3,2,489,489,486,486
Stanislaus,14,2022-03-20,150,150,137,13,8469,8469,7757,712,56,12,12,10,1684,1684,1672,1672
Sutter,14,2022-03-20,31,31,29,2,1516,1516,1430,86,0,1,1,0,223,223,222,222
Tehama,14,2022-03-20,9,9,8,1,947,947,870,77,1,1,1,0,205,205,204,204
Trinity,14,2022-03-20,0,0,0,0,100,100,92,8,0,0,0,0,20,20,20,20
Tulare,14,2022-03-20,122,122,112,10,8487,8487,7758,729,23,5,5,5,1484,1484,1479,1479
Tuolumne,14,2022-03-20,17,17,16,1,1171,1171,1089,82,2,0,0,0,181,181,181,181
Ventura,14,2022-03-20,297,297,286,11,23882,23882,22953,929,27,5,5,4,1488,1488,1483,1483
Yolo,14,2022-03-20,107,107,102,5,22311,22311,21192,1119,4,2,2,1,358,358,356,356
Yuba,14,2022-03-20,38,38,36,2,1313,1313,1243,70,8,0,0,0,124,124,124,124
Alameda,15,2022-03-27,878,878,847,31,59565,59570,57456,2114,39,3,3,4,1847,1847,1844,1844
Amador,15,2022-03-27,8,8,8,0,1366,1366,1288,78,3,0,0,0,86,86,86,86
Butte,15,2022-03-27,65,65,63,2,2900,2900,2816,84,15,0,0,1,427,427,427,427
Calaveras,15,2022-03-27,13,13,12,1,591,591,562,29,0,0,0,0,119,119,119,119
Colusa,15,2022-03-27,4,4,4,0,210,210,201,9,0,0,0,0,21,21,21,21
Contra Costa,15,2022-03-27,522,522,492,30,25111,25111,23654,1457,29,3,3,7,1300,1300,1297,1297
Del Norte,15,2022-03-27,17,17,16,1,1038,1038,991,47,0,0,0,0,49,49,49,49
El Dorado,15,2022-03-27,55,55,52,3,2832,2832,2693,139,1,1,1,0,214,214,213,213
Fresno,15,2022-03-27,306,306,289,17,18367,18367,17359,1008,79,5,5,12,2754,2754,2749,2749
Glenn,15,2022-03-27,7,7,7,0,334,334,317,17,0,0,0,0,56,56,56,56
Humboldt,15,2022-03-27,25,25,24,1,2608,2608,2489,119,5,1,1,2,145,145,144,144
Imperial,15,2022-03-27,61,61,58,3,3652,3652,3469,183,5,3,3,3,944,944,941,941
Inyo,15,2022-03-27,3,3,3,0,179,179,171,8,0,0,0,0,56,56,56,56
Kern,15,2022-03-27,148,148,142,6,18499,18499,17735,764,18,5,5,7,2340,2340,2335,2335
Kings,15,2022-03-27,59,59,56,3,4327,4327,4113,214,6,2,2,0,448,448,446,446
Lake,15,2022-03-27,13,13,12,1,1160,1160,1094,66,0,0,0,0,139,139,139,139
Lassen,15,2022-03-27,6,6,6,0,1351,1351,1298,53,0,0,0,0,62,62,62,62
Los Angeles,15,2022-03-27,4450,4450,4387,63,787823,787884,776553,11331,269,54,54,60,31740,31740,31686,31686
Madera,15,2022-03-27,25,25,24,1,3392,3392,3203,189,4,0,0,1,371,371,371,371
Marin,15,2022-03-27,160,160,151,9,6016,6016,5692,324,3,0,0,0,239,239,239,239
Mariposa,15,2022-03-27,5,5,5,0,169,169,159,10,0,1,1,0,28,28,27,27
Mendocino,15,2022-03-27,34,34,32,2,1312,1312,1217,95,0,1,1,0,124,124,123,123
Merced,15,2022-03-27,66,66,63,3,3354,3354,3211,143,7,2,2,2,816,816,814,814
Modoc,15,2022-03-27,2,2,2,0,50,50,48,2,0,0,0,0,8,8,8,8
Mono,15,2022-03-27,3,3,3,0,135,135,123,12,0,0,0,0,6,6,6,6
Monterey,15,2022-03-27,159,159,145,14,9420,9420,8618,802,17,1,1,0,725,725,724,724
Napa,15,2022-03-27,66,66,64,2,3372,3372,3244,128,1,2,2,0,144,144,142,142
Nevada,15,2022-03-27,27,27,26,1,1490,1490,1408,82,1,1,1,0,130,130,129,129
Orange,15,2022-03-27,803,803,777,26,90630,90635,87648,2987,75,13,13,20,7084,7084,7071,7071
Placer,15,2022-03-27,113,113,106,7,6171,6171,5802,369,25,4,4,8,624,624,620,620
Plumas,15,2022-03-27,2,2,2,0,274,274,259,15,0,0,0,0,13,13,13,13
Riverside,15,2022-03-27,532,532,509,23,44772,44777,42827,1950,52,10,10,12,6443,6443,6433,6433
Sacramento,15,2022-03-27,457,457,436,21,31993,31994,30490,1504,77,7,7,15,3038,3038,3031,3031
San Benito,15,2022-03-27,9,9,9,0,1334,1334,1282,52,0,0,0,0,95,95,95,95
San Bernardino,15,2022-03-27,509,509,491,18,41712,41717,40237,1480,47,22,22,23,7796,7796,7774,7774
San Diego,15,2022-03-27,1307,1307,1287,20,74628,74633,73507,1126,122,11,11,28,5330,5330,5319,5319
San Francisco,15,2022-03-27,807,807,733,74,33043,33044,30010,3034,24,2,2,3,861,861,859,859
San Joaquin,15,2022-03-27,185,185,176,9,16681,16681,15821,860,26,4,4,5,2247,2247,2243,2243
San Luis Obispo,15,2022-03-27,99,99,95,4,5804,5804,5570,234,3,1,1,1,477,477,476,476
San Mateo,15,2022-03-27,537,537,519,18,34717,34720,33568,1152,27,5,5,4,705,705,700,700
Santa Barbara,15,2022-03-27,125,125,119,6,9261,9261,8848,413,18,2,2,3,687,687,685,685
Santa Clara,15,2022-03-27,1273,1273,1253,20,93376,93381,91885,1496,83,9,9,19,2299,2299,2290,2290
Santa Cruz,15,2022-03-27,139,139,134,5,18864,18864,18134,730,3,0,0,2,259,259,259,259
Shasta,15,2022-03-27,38,38,36,2,3867,3867,3684,183,7,3,3,3,559,559,556,556
Siskiyou,15,2022-03-27,6,6,6,0,310,310,298,12,0,0,0,0,83,83,83,83
Solano,15,2022-03-27,157,157,150,7,10952,10952,10470,482,18,0,0,5,448,448,448,448
Sonoma,15,2022-03-27,251,251,240,11,8248,8248,7895,353,20,0,0,1,489,489,489,489
Stanislaus,15,2022-03-27,124,124,116,8,8031,8031,7494,537,30,3,3,5,1687,1687,1684,1684
Sutter,15,2022-03-27,26,26,25,1,1510,1510,1442,68,0,1,1,0,224,224,223,223
Tehama,15,2022-03-27,15,15,14,1,811,811,759,52,3,0,0,0,205,205,205,205
Trinity,15,2022-03-27,0,0,0,0,95,95,89,6,0,0,0,0,20,20,20,20
Tulare,15,2022-03-27,92,92,86,6,7861,7861,7326,535,19,3,3,0,1487,1487,1484,1484
Tuolumne,15,2022-03-27,11,11,10,1,1131,1131,1068,63,2,1,1,1,182,182,181,181
Ventura,15,2022-03-27,340,340,330,10,21823,21823,21158,665,21,7,7,3,1495,1495,1488,1488
Yolo,15,2022-03-27,100,100,96,4,18873,18873,18139,734,3,2,2,0,360,360,358,358
Yuba,15,2022-03-27,32,32,31,1,1261,1261,1208,53,2,2,2,1,126,126,124,124
Alameda,16,2022-04-03,991,991,964,27,58330,58335,56709,1626,35,4,4,3,1851,1851,1847,1847
Amador,16,2022-04-03,4,4,4,0,1152,1152,1100,52,1,0,0,0,86,86,86,86
Butte,16,2022-04-03,50,50,49,1,2737,2737,2675,62,7,2,2,1,429,429,427,427
Calaveras,16,2022-04-03,10,10,10,0,584,584,561,23,0,0,0,0,119,119,119,119
Colusa,16,2022-04-03,2,2,2,0,193,193,186,7,0,0,0,0,21,21,21,21
Contra Costa,16,2022-04-03,553,553,528,25,24450,24450,23330,1120,13,1,1,4,1301,1301,1300,1300
Del Norte,16,2022-04-03,9,9,9,0,1107,1107,1067,40,0,0,0,1,49,49,49,49
El Dorado,16,2022-04-03,49,49,47,2,2727,2727,2621,106,3,1,1,0,215,215,214,214
Fresno,16,2022-04-03,203,203,194,9,16741,16741,16017,724,63,4,4,14,2758,2758,2754,2754
Glenn,16,2022-04-03,5,5,5,0,296,296,284,12,0,0,0,0,56,56,56,56
Humboldt,16,2022-04-03,21,21,20,1,2478,2478,2389,89,2,0,0,3,145,145,145,145
Imperial,16,2022-04-03,50,50,48,2,3442,3442,3306,136,3,0,0,3,944,944,944,944
Inyo,16,2022-04-03,8,8,8,0,171,171,165,6,0,0,0,0,56,56,56,56
Kern,16,2022-04-03,165,165,160,5,17237,17237,16677,560,17,2,2,6,2342,2342,2340,2340
Kings,16,2022-04-03,50,50,48,2,4186,4186,4023,163,2,0,0,1,448,448,448,448
Lake,16,2022-04-03,13,13,12,1,990,990,946,44,0,0,0,0,139,139,139,139
Lassen,16,2022-04-03,4,4,4,0,1225,1225,1187,38,0,0,0,0,62,62,62,62
Los Angeles,16,2022-04-03,5087,5087,5031,56,734021,734083,725887,8196,244,48,48,43,31788,31788,31740,31740
Madera,16,2022-04-03,29,29,28,1,3308,3308,3163,145,3,0,0,1,371,371,371,371
Marin,16,2022-04-03,169,169,162,7,6464,6464,6190,274,2,0,0,0,239,239,239,239
Mariposa,16,2022-04-03,6,6,6,0,222,222,212,10,0,0,0,0,28,28,28,28
Mendocino,16,2022-04-03,23,23,22,1,1235,1235,1164,71,2,0,0,0,124,124,124,124
Merced,16,2022-04-03,53,53,51,2,3301,3301,3190,111,4,2,2,0,818,818,816,816
Modoc,16,2022-04-03,4,4,4,0,47,47,45,2,0,0,0,0,8,8,8,8
Mono,16,2022-04-03,1,1,1,0,151,151,141,10,0,0,0,0,6,6,6,6
Monterey,16,2022-04-03,132,132,123,9,7505,7505,6999,506,8,3,3,0,728,728,725,725
Napa,16,2022-04-03,72,72,70,2,3241,3241,3144,97,2,0,0,1,144,144,144,144
Nevada,16,2022-04-03,28,28,27,1,1408,1408,1347,61,0,1,1,0,131,131,130,130
Orange,16,2022-04-03,926,926,903,23,88525,88530,86238,2292,52,15,15,14,7099,7099,7084,7084
Placer,16,2022-04-03,119,119,113,6,6665,6665,6351,314,16,1,1,5,625,625,624,624
Plumas,16,2022-04-03,4,4,4,0,232,232,222,10,0,0,0,0,13,13,13,13
Riverside,16,2022-04-03,621,621,600,21,38711,38716,37386,1330,37,5,5,10,6448,6448,6443,6443
Sacramento,16,2022-04-03,437,437,421,16,32663,32665,31454,1211,49,7,7,11,3045,3045,3038,3038
San Benito,16,2022-04-03,14,14,14,0,1238,1238,1200,38,0,0,0,0,95,95,95,95
San Bernardino,16,2022-04-03,585,585,569,16,41629,41634,40473,1161,31,8,8,12,7804,7804,7796,7796
San Diego,16,2022-04-03,1471,1471,1454,17,65177,65182,64414,768,89,7,7,30,5337,5337,5330,5330
San Francisco,16,2022-04-03,955,955,886,69,28587,28587,26495,2092,20,5,5,5,866,866,861,861
San Joaquin,16,2022-04-03,207,207,199,8,15993,15993,15339,654,7,3,3,7,2250,2250,2247,2247
San Luis Obispo,16,2022-04-03,101,101,98,3,5550,5550,5373,177,2,0,0,1,477,477,477,477
San Mateo,16,2022-04-03,689,689,671,18,29664,29665,28894,771,13,3,3,1,708,708,705,705
Santa Barbara,16,2022-04-03,178,178,172,6,15014,15014,14482,532,7,2,2,1,689,689,687,687
Santa Clara,16,2022-04-03,1403,1403,1386,17,91849,91856,90701,1155,80,6,6,22,2305,2305,2299,2299
Santa Cruz,16,2022-04-03,188,188,182,6,20158,20158,19542,616,4,0,0,2,259,259,259,259
Shasta,16,2022-04-03,24,24,23,1,3552,3552,3419,133,2,2,2,2,561,561,559,559
Siskiyou,16,2022-04-03,2,2,2,0,301,301,292,9,0,0,0,0,83,83,83,83
Solano,16,2022-04-03,173,173,167,6,10330,10330,9971,359,17,1,1,7,449,449,448,448
Sonoma,16,2022-04-03,304,304,294,10,10637,10637,10278,359,8,1,1,2,490,490,489,489
Stanislaus,16,2022-04-03,102,102,97,5,7778,7778,7365,413,23,2,2,4,1689,1689,1687,1687
Sutter,16,2022-04-03,27,27,26,1,1284,1284,1239,45,0,0,0,0,224,224,224,224
Tehama,16,2022-04-03,4,4,4,0,786,786,746,40,0,2,2,0,207,207,205,205
Trinity,16,2022-04-03,1,1,1,0,78,78,74,4,0,0,0,0,20,20,20,20
Tulare,16,2022-04-03,50,50,47,3,7612,7612,7201,411,15,5,5,1,1492,1492,1487,1487
Tuolumne,16,2022-04-03,10,10,10,0,963,963,921,42,1,1,1,0,183,183,182,182
Ventura,16,2022-04-03,290,290,283,7,20850,20850,20352,498,18,5,5,4,1500,1500,1495,1495
Yolo,16,2022-04-03,104,104,101,3,26896,26896,26060,836,2,0,0,0,360,360,360,360
Yuba,16,2022-04-03,12,12,12,0,1023,1023,989,34,3,0,0,1,126,126,126,126
Alameda,17,2022-04-10,1414,1414,1384,30,49292,49297,48224,1073,51,4,4,1,1855,1855,1851,1851
Amador,17,2022-04-10,8,8,8,0,1064,1064,1026,38,1,0,0,0,86,86,86,86
Butte,17,2022-04-10,36,36,35,1,2299,2299,2258,41,3,0,0,1,429,429,429,429
Calaveras,17,2022-04-10,11,11,11,0,654,654,634,20,0,0,0,0,119,119,119,119
Colusa,17,2022-04-10,5,5,5,0,207,207,201,6,0,0,0,0,21,21,21,21
Contra Costa,17,2022-04-10,659,659,636,23,19843,19843,19131,712,15,1,1,6,1302,1302,1301,1301
Del Norte,17,2022-04-10,6,6,6,0,1017,1017,988,29,0,0,0,0,49,49,49,49
El Dorado,17,2022-04-10,55,55,53,2,2596,2596,2517,79,1,0,0,0,215,215,215,215
Fresno,17,2022-04-10,190,190,184,6,16454,16454,15894,560,53,1,1,5,2759,2759,2758,2758
Glenn,17,2022-04-10,2,2,2,0,258,258,250,8,0,0,0,0,56,56,56,56
Humboldt,17,2022-04-10,42,42,41,1,2343,2343,2277,66,4,1,1,2,146,146,145,145
Imperial,17,2022-04-10,26,26,25,1,3438,3438,3331,107,2,1,1,1,945,945,944,944
Inyo,17,2022-04-10,6,6,6,0,198,198,193,5,1,0,0,0,56,56,56,56
Kern,17,2022-04-10,142,142,138,4,17261,17261,16822,439,20,1,1,4,2343,2343,2342,2342
Kings,17,2022-04-10,35,35,34,1,4226,4226,4097,129,3,0,0,0,448,448,448,448
Lake,17,2022-04-10,20,20,19,1,854,854,824,30,0,0,0,0,139,139,139,139
Lassen,17,2022-04-10,1,1,1,0,1297,1297,1265,32,1,0,0,0,62,62,62,62
Los Angeles,17,2022-04-10,6603,6603,6546,57,754337,754412,747794,6618,227,46,46,38,31834,31834,31788,31788
Madera,17,2022-04-10,26,26,25,1,3108,3108,3001,107,3,0,0,1,371,371,371,371
Marin,17,2022-04-10,209,209,202,7,5524,5524,5340,184,4,0,0,2,239,239,239,239
Mariposa,17,2022-04-10,6,6,6,0,242,242,233,9,0,0,0,0,28,28,28,28
Mendocino,17,2022-04-10,30,30,29,1,1137,1137,1085,52,0,0,0,0,124,124,124,124
Merced,17,2022-04-10,73,73,71,2,3297,3297,3210,87,0,0,0,2,818,818,818,818
Modoc,17,2022-04-10,1,1,1,0,46,46,45,1,0,0,0,0,8,8,8,8
Mono,17,2022-04-10,6,6,6,0,137,137,130,7,0,0,0,0,6,6,6,6
Monterey,17,2022-04-10,109,109,103,6,7173,7173,6791,382,11,2,2,0,730,730,728,728
Napa,17,2022-04-10,117,117,114,3,3114,3114,3041,73,1,0,0,0,144,144,144,144
Nevada,17,2022-04-10,34,34,33,1,1495,1495,1444,51,2,0,0,1,131,131,131,131
Orange,17,2022-04-10,1121,1121,1099,22,54778,54783,53677,1106,64,11,11,13,7110,7110,7099,7099
Placer,17,2022-04-10,119,119,115,4,6058,6058,5832,226,20,2,2,3,627,627,625,625
Plumas,17,2022-04-10,5,5,5,0,260,260,251,9,0,0,0,0,13,13,13,13
Riverside,17,2022-04-10,735,735,715,20,37738,37743,36723,1020,32,4,4,9,6452,6452,6448,6448
Sacramento,17,2022-04-10,485,485,471,14,31357,31360,30446,914,40,10,10,5,3055,3055,3045,3045
San Benito,17,2022-04-10,17,17,17,0,1172,1172,1144,28,0,0,0,0,95,95,95,95
San Bernardino,17,2022-04-10,829,829,811,18,42206,42211,41288,923,30,9,9,4,7813,7813,7804,7804
San Diego,17,2022-04-10,1831,1831,1814,17,74412,74419,73734,685,86,5,5,22,5342,5342,5337,5337
San Francisco,17,2022-04-10,1171,1171,1104,67,30133,30137,28392,1745,20,6,6,4,872,872,866,866
San Joaquin,17,2022-04-10,230,230,223,7,15505,15505,15007,498,10,0,0,6,2250,2250,2250,2250
San Luis Obispo,17,2022-04-10,104,104,101,3,4921,4921,4798,123,2,2,2,0,479,479,477,477
San Mateo,17,2022-04-10,830,830,813,17,30751,30754,30127,627,4,1,1,1,709,709,708,708
Santa Barbara,17,2022-04-10,264,264,257,7,15206,15206,14783,423,8,2,2,0,691,691,689,689
Santa Clara,17,2022-04-10,1632,1632,1616,16,80893,80901,80109,792,69,3,3,12,2308,2308,2305,2305
Santa Cruz,17,2022-04-10,292,292,285,7,8401,8401,8202,199,6,1,1,0,260,260,259,259
Shasta,17,2022-04-10,21,21,20,1,3239,3239,3144,95,2,1,1,1,562,562,561,561
Siskiyou,17,2022-04-10,1,1,1,0,331,331,323,8,0,0,0,0,83,83,83,83
Solano,17,2022-04-10,244,244,237,7,9849,9849,9581,268,14,0,0,3,449,449,449,449
Sonoma,17,2022-04-10,395,395,385,10,10643,10643,10361,282,8,1,1,1,491,491,490,490
Stanislaus,17,2022-04-10,132,132,127,5,7886,7886,7556,330,19,1,1,1,1690,1690,1689,1689
Sutter,17,2022-04-10,19,19,18,1,1306,1306,1270,36,0,1,1,0,225,225,224,224
Tehama,17,2022-04-10,9,9,9,0,771,771,740,31,1,0,0,0,207,207,207,207
Trinity,17,2022-04-10,0,0,0,0,88,88,84,4,0,0,0,0,20,20,20,20
Tulare,17,2022-04-10,48,48,46,2,7849,7849,7514,335,8,4,4,0,1496,1496,1492,1492
Tuolumne,17,2022-04-10,16,16,15,1,1056,1056,1019,37,1,0,0,0,183,183,183,183
Ventura,17,2022-04-10,297,297,292,5,18034,18034,17697,337,15,2,2,2,1502,1502,1500,1500
Yolo,17,2022-04-10,121,121,118,3,18607,18607,18154,453,0,0,0,1,360,360,360,360
Yuba,17,2022-04-10,16,16,16,0,1084,1084,1056,28,1,0,0,0,126,126,126,126
Alameda,18,2022-04-17,1720,1720,1691,29,54176,54181,53254,927,40,3,3,6,1858,1858,1855,1855
Amador,18,2022-04-17,9,9,9,0,1158,1158,1126,32,2,0,0,0,86,86,86,86
Butte,18,2022-04-17,48,48,47,1,2239,2239,2208,31,6,2,2,0,431,431,429,429
Calaveras,18,2022-04-17,16,16,16,0,601,601,586,15,0,1,1,0,120,120,119,119
Colusa,18,2022-04-17,3,3,3,0,170,170,166,4,0,0,0,0,21,21,21,21
Contra Costa,18,2022-04-17,981,981,954,27,24600,24603,23905,698,26,1,1,4,1303,1303,1302,1302
Del Norte,18,2022-04-17,11,11,11,0,998,998,976,22,0,0,0,0,49,49,49,49
El Dorado,18,2022-04-17,64,64,63,1,2329,2329,2273,56,0,0,0,0,215,215,215,215
Fresno,18,2022-04-17,207,207,202,5,13438,13438,13080,358,42,5,5,4,2764,2764,2759,2759
Glenn,18,2022-04-17,4,4,4,0,276,276,269,7,0,0,0,0,56,56,56,56
Humboldt,18,2022-04-17,82,82,80,2,1941,1941,1898,43,4,0,0,2,146,146,146,146
Imperial,18,2022-04-17,44,44,43,1,3280,3280,3200,80,2,0,0,1,945,945,945,945
Inyo,18,2022-04-17,0,0,0,0,165,165,162,3,0,0,0,0,56,56,56,56
Kern,18,2022-04-17,133,133,130,3,13431,13431,13164,267,8,2,2,6,2345,2345,2343,2343
Kings,18,2022-04-17,35,35,34,1,3552,3552,3467,85,2,1,1,0,449,449,448,448
Lake,18,2022-04-17,19,19,18,1,798,798,776,22,2,0,0,1,139,139,139,139
Lassen,18,2022-04-17,2,2,2,0,1340,1340,1314,26,0,0,0,0,62,62,62,62
Los Angeles,18,2022-04-17,7660,7660,7608,52,369541,369585,367054,2531,190,43,43,31,31877,31877,31834,31834
Madera,18,2022-04-17,22,22,21,1,2603,2603,2533,70,2,0,0,2,371,371,371,371
Marin,18,2022-04-17,295,295,287,8,5984,5984,5827,157,5,0,0,0,239,239,239,239
Mariposa,18,2022-04-17,12,12,12,0,257,257,250,7,0,0,0,0,28,28,28,28
Mendocino,18,2022-04-17,46,46,44,2,1293,1293,1247,46,2,1,1,1,125,125,124,124
Merced,18,2022-04-17,55,55,54,1,3125,3125,3060,65,5,3,3,0,821,821,818,818
Modoc,18,2022-04-17,1,1,1,0,33,33,32,1,0,0,0,0,8,8,8,8
Mono,18,2022-04-17,11,11,11,0,163,163,156,7,0,0,0,0,6,6,6,6
Monterey,18,2022-04-17,140,140,134,6,6211,6211,5950,261,5,0,0,0,730,730,730,730
Napa,18,2022-04-17,141,141,138,3,2660,2660,2612,48,1,0,0,0,144,144,144,144
Nevada,18,2022-04-17,42,42,41,1,1225,1225,1192,33,0,0,0,1,131,131,131,131
Orange,18,2022-04-17,1335,1335,1314,21,81394,81404,80107,1297,51,6,6,9,7116,7116,7110,7110
Placer,18,2022-04-17,155,155,151,4,4677,4677,4541,136,24,0,0,4,627,627,627,627
Plumas,18,2022-04-17,9,9,9,0,206,206,200,6,0,0,0,0,13,13,13,13
Riverside,18,2022-04-17,864,864,846,18,36780,36785,36003,782,41,7,7,4,6459,6459,6452,6452
Sacramento,18,2022-04-17,652,652,637,15,27558,27562,26933,629,48,10,10,8,3065,3065,3055,3055
San Benito,18,2022-04-17,24,24,24,0,1178,1178,1156,22,0,0,0,0,95,95,95,95
San Bernardino,18,2022-04-17,1053,1053,1035,18,39404,39409,38731,678,34,7,7,9,7820,7820,7813,7813
San Diego,18,2022-04-17,1891,1891,1878,13,66878,66885,66402,483,88,8,8,19,5350,5350,5342,5342
San Francisco,18,2022-04-17,1362,1362,1300,62,30457,30462,29070,1392,26,2,2,2,874,874,872,872
San Joaquin,18,2022-04-17,245,245,239,6,14783,14783,14410,373,8,1,1,4,2251,2251,2250,2250
San Luis Obispo,18,2022-04-17,146,146,143,3,4859,4859,4764,95,3,2,2,0,481,481,479,479
San Mateo,18,2022-04-17,1083,1083,1066,17,29515,29520,29050,470,14,3,3,1,712,712,709,709
Santa Barbara,18,2022-04-17,324,324,317,7,14749,14749,14427,322,8,0,0,0,691,691,691,691
Santa Clara,18,2022-04-17,2076,2076,2060,16,74610,74618,74045,573,61,5,5,13,2313,2313,2308,2308
Santa Cruz,18,2022-04-17,406,406,398,8,12235,12236,12001,235,2,0,0,2,260,260,260,260
Shasta,18,2022-04-17,29,29,28,1,2820,2820,2755,65,1,1,1,2,563,563,562,562
Siskiyou,18,2022-04-17,3,3,3,0,322,322,316,6,1,0,0,1,83,83,83,83
Solano,18,2022-04-17,234,234,229,5,9098,9098,8904,194,10,1,1,1,450,450,449,449
Sonoma,18,2022-04-17,490,490,480,10,11148,11148,10915,233,15,1,1,3,492,492,491,491
Stanislaus,18,2022-04-17,155,155,150,5,7661,7661,7409,252,15,1,1,4,1691,1691,1690,1690
Sutter,18,2022-04-17,23,23,23,0,1171,1171,1145,26,0,0,0,0,225,225,225,225
Tehama,18,2022-04-17,8,8,8,0,680,680,658,22,1,0,0,0,207,207,207,207
Trinity,18,2022-04-17,0,0,0,0,68,68,66,2,0,0,0,0,20,20,20,20
Tulare,18,2022-04-17,82,82,79,3,6738,6738,6511,227,12,0,0,0,1496,1496,1496,1496
Tuolumne,18,2022-04-17,27,27,26,1,1073,1073,1044,29,0,0,0,0,183,183,183,183
Ventura,18,2022-04-17,349,349,344,5,15600,15600,15371,229,8,1,1,0,1503,1503,1502,1502
Yolo,18,2022-04-17,198,198,194,4,17678,17678,17338,340,2,1,1,0,361,361,360,360
Yuba,18,2022-04-17,22,22,22,0,973,973,953,20,1,0,0,0,126,126,126,126
Alameda,19,2022-04-24,2353,2353,2322,31,56964,56969,56211,758,39,7,7,3,1865,1865,1858,1858
Amador,19,2022-04-24,22,22,22,0,1312,1312,1283,29,0,0,0,0,86,86,86,86
Butte,19,2022-04-24,52,52,51,1,2476,2476,2449,27,7,1,1,1,432,432,431,431
Calaveras,19,2022-04-24,28,28,27,1,637,637,625,12,0,0,0,0,120,120,120,120
Colusa,19,2022-04-24,3,3,3,0,184,184,181,3,0,0,0,0,21,21,21,21
Contra Costa,19,2022-04-24,1435,1435,1404,31,26286,26291,25709,582,31,2,2,2,1305,1305,1303,1303
Del Norte,19,2022-04-24,21,21,21,0,1092,1092,1073,19,0,0,0,0,49,49,49,49
El Dorado,19,2022-04-24,95,95,93,2,2714,2714,2663,51,0,0,0,0,215,215,215,215
Fresno,19,2022-04-24,333,333,326,7,15609,15609,15283,326,35,3,3,2,2767,2767,2764,2764
Glenn,19,2022-04-24,4,4,4,0,284,284,279,5,0,0,0,0,56,56,56,56
Humboldt,19,2022-04-24,178,178,175,3,2772,2772,2724,48,2,1,1,2,147,147,146,146
Imperial,19,2022-04-24,62,62,61,1,3373,3373,3309,64,3,0,0,1,945,945,945,945
Inyo,19,2022-04-24,5,5,5,0,175,175,172,3,0,0,0,0,56,56,56,56
Kern,19,2022-04-24,233,233,229,4,17318,17319,17050,269,15,2,2,5,2347,2347,2345,2345
Kings,19,2022-04-24,56,56,55,1,4481,4481,4397,84,2,0,0,0,449,449,449,449
Lake,19,2022-04-24,14,14,14,0,820,820,802,18,1,1,1,0,140,140,139,139
Lassen,19,2022-04-24,0,0,0,0,1505,1505,1483,22,0,0,0,0,62,62,62,62
Los Angeles,19,2022-04-24,11013,11013,10955,58,863820,863932,859312,4620,204,26,26,27,31903,31903,31877,31877
Madera,19,2022-04-24,35,35,34,1,2832,2832,2772,60,2,0,0,0,371,371,371,371
Marin,19,2022-04-24,342,342,335,7,6223,6223,6095,128,9,0,0,0,239,239,239,239
Mariposa,19,2022-04-24,14,14,14,0,214,214,209,5,0,0,0,0,28,28,28,28
Mendocino,19,2022-04-24,65,65,63,2,1221,1221,1187,34,0,1,1,1,126,126,125,125
Merced,19,2022-04-24,95,95,93,2,2964,2964,2916,48,6,1,1,0,822,822,821,821
Modoc,19,2022-04-24,1,1,1,0,39,39,38,1,0,0,0,0,8,8,8,8
Mono,19,2022-04-24,3,3,3,0,93,93,90,3,0,0,0,0,6,6,6,6
Monterey,19,2022-04-24,303,303,293,10,7584,7584,7333,251,3,2,2,1,732,732,730,730
Napa,19,2022-04-24,214,214,211,3,3377,3377,3329,48,1,0,0,0,144,144,144,144
Nevada,19,2022-04-24,52,52,51,1,1371,1371,1342,29,1,0,0,0,131,131,131,131
Orange,19,2022-04-24,1924,1924,1901,23,85080,85090,84036,1054,55,9,9,14,7125,7125,7116,7116
Placer,19,2022-04-24,226,226,221,5,5852,5852,5718,134,20,0,0,5,627,627,627,627
Plumas,19,2022-04-24,0,0,0,0,239,239,234,5,0,0,0,0,13,13,13,13
Riverside,19,2022-04-24,1248,1248,1228,20,39926,39931,39269,662,36,3,3,6,6462,6462,6459,6459
Sacramento,19,2022-04-24,979,979,962,17,31258,31263,30705,558,40,5,5,7,3070,3070,3065,3065
San Benito,19,2022-04-24,33,33,33,0,1142,1142,1125,17,0,0,0,0,95,95,95,95
San Bernardino,19,2022-04-24,1297,1297,1280,17,42966,42971,42395,576,23,8,8,5,7828,7828,7820,7820
San Diego,19,2022-04-24,2870,2870,2854,16,73877,73888,73473,415,85,5,5,13,5355,5355,5350,5350
San Francisco,19,2022-04-24,1875,1875,1808,67,31628,31633,30496,1137,29,1,1,2,875,875,874,874
San Joaquin,19,2022-04-24,353,353,346,7,15431,15431,15126,305,11,0,0,2,2251,2251,2251,2251
San Luis Obispo,19,2022-04-24,202,202,199,3,5049,5049,4972,77,4,0,0,0,481,481,481,481
San Mateo,19,2022-04-24,1465,1465,1447,18,32300,32305,31902,403,15,1,1,4,713,713,712,712
Santa Barbara,19,2022-04-24,360,360,354,6,14813,14813,14560,253,8,0,0,0,691,691,691,691
Santa Clara,19,2022-04-24,2948,2948,2931,17,71077,71088,70665,423,79,3,3,10,2316,2316,2313,2313
Santa Cruz,19,2022-04-24,482,482,475,7,19692,19695,19407,288,2,1,1,0,261,261,260,260
Shasta,19,2022-04-24,48,48,47,1,3106,3106,3050,56,0,0,0,0,563,563,563,563
Siskiyou,19,2022-04-24,10,10,10,0,324,324,319,5,0,0,0,0,83,83,83,83
Solano,19,2022-04-24,436,436,429,7,10360,10360,10187,173,9,0,0,2,450,450,450,450
Sonoma,19,2022-04-24,649,649,639,10,11862,11862,11669,193,18,0,0,2,492,492,492,492
Stanislaus,19,2022-04-24,219,219,214,5,7714,7714,7515,199,23,4,4,0,1695,1695,1691,1691
Sutter,19,2022-04-24,35,35,34,1,1350,1350,1327,23,0,1,1,0,226,226,225,225
Tehama,19,2022-04-24,14,14,14,0,697,697,680,17,1,0,0,0,207,207,207,207
Trinity,19,2022-04-24,2,2,2,0,73,73,71,2,0,0,0,0,20,20,20,20
Tulare,19,2022-04-24,84,84,82,2,7037,7037,6852,185,12,0,0,0,1496,1496,1496,1496
Tuolumne,19,2022-04-24,36,36,35,1,1127,1127,1103,24,1,0,0,0,183,183,183,183
Ventura,19,2022-04-24,589,589,582,7,18905,18906,18690,216,15,3,3,2,1506,1506,1503,1503
Yolo,19,2022-04-24,281,281,277,4,19588,19588,19295,293,1,0,0,0,361,361,361,361
Yuba,19,2022-04-24,33,33,32,1,1116,1116,1098,18,0,0,0,0,126,126,126,126
Alameda,20,2022-05-01,3260,3260,3227,33,69455,69466,68740,726,45,2,2,4,1867,1867,1865,1865
Amador,20,2022-05-01,28,28,28,0,1335,1335,1312,23,0,0,0,0,86,86,86,86
Butte,20,2022-05-01,81,81,80,1,2456,2456,2435,21,4,2,2,0,434,434,432,432
Calaveras,20,2022-05-01,28,28,28,0,730,730,719,11,0,0,0,0,120,120,120,120
Colusa,20,2022-05-01,3,3,3,0,211,211,208,3,0,0,0,0,21,21,21,21
Contra Costa,20,2022-05-01,1795,1795,1764,31,28970,28975,28471,504,39,3,3,5,1308,1308,1305,1305
Del Norte,20,2022-05-01,43,43,42,1,1200,1200,1184,16,0,0,0,0,49,49,49,49
El Dorado,20,2022-05-01,127,127,125,2,2730,2730,2690,40,1,1,1,0,216,216,215,215
Fresno,20,2022-05-01,478,478,470,8,16434,16434,16165,269,35,3,3,4,2770,2770,2767,2767
Glenn,20,2022-05-01,4,4,4,0,261,261,257,4,0,0,0,0,56,56,56,56
Humboldt,20,2022-05-01,230,230,227,3,2944,2944,2904,40,6,0,0,2,147,147,147,147
Imperial,20,2022-05-01,111,111,109,2,3607,3607,3553,54,1,0,0,1,945,945,945,945
Inyo,20,2022-05-01,5,5,5,0,207,207,204,3,0,0,0,0,56,56,56,56
Kern,20,2022-05-01,283,283,280,3,17971,17973,17754,219,12,0,0,5,2347,2347,2347,2347
Kings,20,2022-05-01,47,47,46,1,4714,4714,4645,69,4,0,0,1,449,449,449,449
Lake,20,2022-05-01,30,30,29,1,1014,1014,997,17,1,0,0,0,140,140,140,140
Lassen,20,2022-05-01,9,9,9,0,1614,1614,1595,19,0,0,0,0,62,62,62,62
Los Angeles,20,2022-05-01,14146,14146,14088,58,926441,926578,922704,3874,201,26,26,24,31929,31929,31903,31903
Madera,20,2022-05-01,74,74,73,1,3285,3285,3231,54,4,0,0,1,371,371,371,371
Marin,20,2022-05-01,394,394,388,6,6453,6453,6349,104,10,0,0,0,239,239,239,239
Mariposa,20,2022-05-01,9,9,9,0,240,240,236,4,0,0,0,0,28,28,28,28
Mendocino,20,2022-05-01,46,46,45,1,1268,1268,1240,28,0,0,0,0,126,126,126,126
Merced,20,2022-05-01,123,123,121,2,3251,3251,3210,41,7,3,3,0,825,825,822,822
Modoc,20,2022-05-01,0,0,0,0,41,41,40,1,0,0,0,0,8,8,8,8
Mono,20,2022-05-01,5,5,5,0,86,86,84,2,0,0,0,0,6,6,6,6
Monterey,20,2022-05-01,329,329,321,8,8315,8315,8098,217,8,1,1,0,733,733,732,732
Napa,20,2022-05-01,223,223,221,2,3533,3533,3494,39,5,0,0,0,144,144,144,144
Nevada,20,2022-05-01,77,77,76,1,1506,1506,1481,25,2,0,0,0,131,131,131,131
Orange,20,2022-05-01,2519,2519,2495,24,88153,88166,87311,855,67,5,5,14,7130,7130,7125,7125
Placer,20,2022-05-01,285,285,280,5,6236,6236,6124,112,24,0,0,5,627,627,627,627
Plumas,20,2022-05-01,10,10,10,0,252,252,248,4,0,0,0,0,13,13,13,13
Riverside,20,2022-05-01,1867,1867,1843,24,42451,42456,41906,550,31,5,5,6,6467,6467,6462,6462
Sacramento,20,2022-05-01,1271,1271,1254,17,32709,32714,32257,457,43,5,5,10,3075,3075,3070,3070
San Benito,20,2022-05-01,46,46,45,1,1233,1233,1219,14,0,0,0,0,95,95,95,95
San Bernardino,20,2022-05-01,1405,1405,1391,14,43379,43384,42930,454,26,8,8,10,7836,7836,7828,7828
San Diego,20,2022-05-01,3869,3869,3852,17,71374,71386,71073,313,71,3,3,13,5358,5358,5355,5355
San Francisco,20,2022-05-01,2377,2377,2310,67,35393,35398,34398,1000,38,1,1,6,876,876,875,875
San Joaquin,20,2022-05-01,488,488,481,7,15360,15361,15124,237,12,1,1,3,2252,2252,2251,2251
San Luis Obispo,20,2022-05-01,253,253,250,3,5135,5135,5074,61,8,2,2,0,483,483,481,481
San Mateo,20,2022-05-01,1772,1772,1755,17,36239,36244,35890,354,22,2,2,2,715,715,713,713
Santa Barbara,20,2022-05-01,404,404,399,5,15562,15562,15354,208,8,2,2,2,693,693,691,691
Santa Clara,20,2022-05-01,4095,4095,4076,19,96957,96972,96520,452,85,5,5,18,2321,2321,2316,2316
Santa Cruz,20,2022-05-01,640,640,633,7,22141,22145,21892,253,2,0,0,0,261,261,261,261
Shasta,20,2022-05-01,63,63,62,1,3397,3397,3349,48,8,0,0,1,563,563,563,563
Siskiyou,20,2022-05-01,10,10,10,0,324,324,320,4,0,0,0,0,83,83,83,83
Solano,20,2022-05-01,602,602,594,8,11575,11575,11424,151,9,0,0,2,450,450,450,450
Sonoma,20,2022-05-01,815,815,805,10,12444,12444,12286,158,14,1,1,3,493,493,492,492
Stanislaus,20,2022-05-01,267,267,262,5,8208,8208,8042,166,18,0,0,3,1695,1695,1695,1695
Sutter,20,2022-05-01,48,48,47,1,1258,1258,1241,17,0,1,1,0,227,227,226,226
Tehama,20,2022-05-01,20,20,20,0,698,698,684,14,0,0,0,0,207,207,207,207
Trinity,20,2022-05-01,1,1,1,0,88,88,86,2,0,0,0,0,20,20,20,20
Tulare,20,2022-05-01,160,160,157,3,7172,7172,7024,148,11,3,3,0,1499,1499,1496,1496
Tuolumne,20,2022-05-01,87,87,86,1,1234,1234,1214,20,5,0,0,0,183,183,183,183
Ventura,20,2022-05-01,684,684,678,6,19439,19443,19269,174,15,4,4,2,1510,1510,1506,1506
Yolo,20,2022-05-01,327,327,323,4,18995,18998,18776,222,1,1,1,0,362,362,361,361
Yuba,20,2022-05-01,40,40,40,0,1060,1060,1047,13,1,0,0,1,126,126,126,126
Alameda,21,2022-05-08,3961,3961,3929,32,70566,70579,70005,574,61,4,4,6,1871,1871,1867,1867
Amador,21,2022-05-08,14,14,14,0,1428,1428,1409,19,0,0,0,0,86,86,86,86
Butte,21,2022-05-08,119,119,118,1,2403,2403,2387,16,4,0,0,0,434,434,434,434
Calaveras,21,2022-05-08,30,30,30,0,692,692,684,8,1,0,0,0,120,120,120,120
Colusa,21,2022-05-08,2,2,2,0,216,216,214,2,0,0,0,0,21,21,21,21
Contra Costa,21,2022-05-08,2387,2387,2355,32,30562,30567,30152,415,34,4,4,12,1312,1312,1308,1308
Del Norte,21,2022-05-08,41,41,41,0,1233,1233,1220,13,0,0,0,0,49,49,49,49
El Dorado,21,2022-05-08,172,172,170,2,2820,2820,2788,32,4,0,0,0,216,216,216,216
Fresno,21,2022-05-08,683,683,674,9,17490,17495,17271,224,33,2,2,2,2772,2772,2770,2770
Glenn,21,2022-05-08,6,6,6,0,231,231,228,3,0,0,0,0,56,56,56,56
Humboldt,21,2022-05-08,284,284,281,3,3257,3257,3223,34,2,0,0,2,147,147,147,147
Imperial,21,2022-05-08,121,121,120,1,3743,3743,3699,44,0,0,0,1,945,945,945,945
Inyo,21,2022-05-08,20,20,20,0,199,199,197,2,1,0,0,0,56,56,56,56
Kern,21,2022-05-08,437,437,433,4,18471,18476,18300,176,19,1,1,2,2348,2348,2347,2347
Kings,21,2022-05-08,95,95,94,1,4920,4920,4863,57,2,0,0,0,449,449,449,449
Lake,21,2022-05-08,30,30,30,0,1011,1011,998,13,1,0,0,0,140,140,140,140
Lassen,21,2022-05-08,3,3,3,0,1699,1699,1684,15,0,0,0,0,62,62,62,62
Los Angeles,21,2022-05-08,17847,17852,17795,57,918031,918209,915219,2990,215,29,29,27,31958,31958,31929,31929
Madera,21,2022-05-08,127,127,125,2,3692,3692,3644,48,3,0,0,0,371,371,371,371
Marin,21,2022-05-08,672,672,664,8,7670,7670,7574,96,10,0,0,1,239,239,239,239
Mariposa,21,2022-05-08,26,26,26,0,268,268,264,4,0,0,0,0,28,28,28,28
Mendocino,21,2022-05-08,92,92,90,2,1220,1220,1199,21,0,1,1,0,127,127,126,126
Merced,21,2022-05-08,181,181,179,2,3427,3427,3393,34,5,1,1,0,826,826,825,825
Modoc,21,2022-05-08,2,2,2,0,41,42,41,1,0,0,0,0,8,8,8,8
Mono,21,2022-05-08,11,11,11,0,127,127,124,3,0,0,0,0,6,6,6,6
Monterey,21,2022-05-08,426,426,417,9,9157,9157,8970,187,9,0,0,0,733,733,733,733
Napa,21,2022-05-08,238,238,236,2,3239,3239,3211,28,3,0,0,0,144,144,144,144
Nevada,21,2022-05-08,97,97,96,1,1625,1625,1604,21,4,0,0,0,131,131,131,131
Orange,21,2022-05-08,3409,3409,3384,25,91170,91188,90498,690,100,7,7,17,7137,7137,7130,7130
Placer,21,2022-05-08,499,499,492,7,6726,6726,6632,94,27,0,0,3,627,627,627,627
Plumas,21,2022-05-08,10,10,10,0,275,275,271,4,0,0,0,0,13,13,13,13
Riverside,21,2022-05-08,2378,2378,2354,24,45075,45085,44628,457,35,4,4,8,6471,6471,6467,6467
Sacramento,21,2022-05-08,2082,2082,2060,22,36457,36463,36065,398,63,3,3,10,3078,3078,3075,3075
San Benito,21,2022-05-08,67,67,66,1,1437,1437,1424,13,0,0,0,0,95,95,95,95
San Bernardino,21,2022-05-08,1821,1821,1806,15,45950,45961,45585,376,35,6,6,4,7842,7842,7836,7836
San Diego,21,2022-05-08,5075,5075,5058,17,86600,86617,86321,296,85,3,3,12,5361,5361,5358,5358
San Francisco,21,2022-05-08,2887,2887,2824,63,37740,37747,36911,836,51,8,8,7,884,884,876,876
San Joaquin,21,2022-05-08,730,730,721,9,15963,15966,15774,192,13,1,1,2,2253,2253,2252,2252
San Luis Obispo,21,2022-05-08,290,290,287,3,5205,5205,5156,49,0,0,0,0,483,483,483,483
San Mateo,21,2022-05-08,2217,2217,2200,17,36991,36996,36715,281,25,1,1,1,716,716,715,715
Santa Barbara,21,2022-05-08,609,609,603,6,15354,15358,15198,160,9,0,0,2,693,693,693,693
Santa Clara,21,2022-05-08,5499,5499,5479,20,103993,104013,103635,378,82,2,2,25,2323,2323,2321,2321
Santa Cruz,21,2022-05-08,701,701,695,6,22981,22986,22781,205,4,1,1,0,262,262,261,261
Shasta,21,2022-05-08,94,94,93,1,3453,3453,3415,38,3,0,0,2,563,563,563,563
Siskiyou,21,2022-05-08,14,14,14,0,285,285,282,3,0,0,0,0,83,83,83,83
Solano,21,2022-05-08,877,877,868,9,12395,12395,12268,127,18,0,0,0,450,450,450,450
Sonoma,21,2022-05-08,1179,1179,1167,12,13985,13986,13847,139,0,1,1,23,494,494,493,493
Stanislaus,21,2022-05-08,407,407,401,6,8752,8752,8614,138,25,0,0,1,1695,1695,1695,1695
Sutter,21,2022-05-08,48,48,48,0,1543,1543,1527,16,0,0,0,0,227,227,227,227
Tehama,21,2022-05-08,23,23,23,0,686,686,676,10,1,0,0,0,207,207,207,207
Trinity,21,2022-05-08,3,3,3,0,68,68,67,1,0,0,0,0,20,20,20,20
Tulare,21,2022-05-08,178,178,175,3,7583,7583,7461,122,13,2,2,0,1501,1501,1499,1499
Tuolumne,21,2022-05-08,78,78,77,1,1323,1323,1306,17,2,2,2,0,185,185,183,183
Ventura,21,2022-05-08,1087,1087,1080,7,21163,21168,21020,148,12,1,1,2,1511,1511,1510,1510
Yolo,21,2022-05-08,451,451,447,4,19686,19691,19512,179,1,0,0,1,362,362,362,362
Yuba,21,2022-05-08,65,65,64,1,1196,1196,1184,12,2,0,0,0,126,126,126,126
Alameda,22,2022-05-15,4818,4818,4788,30,74680,74697,74222,475,65,7,7,4,1878,1878,1871,1871
Amador,22,2022-05-15,49,49,48,1,1685,1685,1667,18,1,0,0,0,86,86,86,86
Butte,22,2022-05-15,173,173,172,1,2632,2632,2618,14,5,2,2,1,436,436,434,434
Calaveras,22,2022-05-15,31,31,31,0,763,763,756,7,1,1,1,1,121,121,120,120
Colusa,22,2022-05-15,5,5,5,0,213,213,211,2,0,0,0,0,21,21,21,21
Contra Costa,22,2022-05-15,3237,3237,3203,34,32724,32732,32384,348,48,4,4,8,1316,1316,1312,1312
Del Norte,22,2022-05-15,117,117,116,1,1749,1749,1735,14,0,0,0,0,49,49,49,49
El Dorado,22,2022-05-15,242,242,240,2,3058,3058,3031,27,6,0,0,1,216,216,216,216
Fresno,22,2022-05-15,1040,1040,1030,10,18705,18710,18523,187,45,2,2,4,2774,2774,2772,2772
Glenn,22,2022-05-15,14,14,14,0,258,258,256,2,0,0,0,0,56,56,56,56
Humboldt,22,2022-05-15,278,278,276,2,3238,3238,3211,27,9,1,1,2,148,148,147,147
Imperial,22,2022-05-15,205,205,203,2,4173,4173,4135,38,3,0,0,1,945,945,945,945
Inyo,22,2022-05-15,22,22,22,0,225,225,223,2,1,0,0,0,56,56,56,56
Kern,22,2022-05-15,603,603,599,4,19844,19849,19701,148,18,4,4,3,2352,2352,2348,2348
Kings,22,2022-05-15,177,177,175,2,5332,5332,5284,48,0,1,1,0,450,450,449,449
Lake,22,2022-05-15,64,64,63,1,1127,1127,1115,12,0,0,0,0,140,140,140,140
Lassen,22,2022-05-15,16,16,16,0,1683,1683,1671,12,0,0,0,0,62,62,62,62
Los Angeles,22,2022-05-15,20423,20430,20379,51,938344,938570,936186,2384,268,38,38,44,31996,31996,31958,31958
Madera,22,2022-05-15,179,179,177,2,3632,3632,3595,37,2,0,0,0,371,371,371,371
Marin,22,2022-05-15,771,771,764,7,8210,8210,8129,81,12,0,0,0,239,239,239,239
Mariposa,22,2022-05-15,25,25,25,0,351,351,347,4,0,0,0,0,28,28,28,28
Mendocino,22,2022-05-15,98,98,97,1,1347,1347,1329,18,0,1,1,3,128,128,127,127
Merced,22,2022-05-15,279,279,277,2,3869,3869,3839,30,9,2,2,1,828,828,826,826
Modoc,22,2022-05-15,3,3,3,0,43,44,43,1,0,0,0,0,8,8,8,8
Mono,22,2022-05-15,9,9,9,0,109,109,107,2,0,0,0,0,6,6,6,6
Monterey,22,2022-05-15,492,492,484,8,9572,9573,9420,153,7,1,1,0,734,734,733,733
Napa,22,2022-05-15,285,285,283,2,3507,3507,3483,24,2,0,0,0,144,144,144,144
Nevada,22,2022-05-15,140,140,139,1,1850,1850,1831,19,1,0,0,0,131,131,131,131
Orange,22,2022-05-15,4307,4307,4282,25,94060,94082,93527,555,74,8,8,13,7145,7145,7137,7137
Placer,22,2022-05-15,676,676,669,7,7473,7473,7391,82,40,1,1,3,628,628,627,627
Plumas,22,2022-05-15,46,46,46,0,257,257,254,3,1,0,0,0,13,13,13,13
Riverside,22,2022-05-15,3115,3115,3091,24,47070,47082,46710,372,49,1,1,8,6472,6472,6471,6471
Sacramento,22,2022-05-15,2934,2934,2909,25,38962,38973,38641,332,86,8,8,15,3086,3086,3078,3078
San Benito,22,2022-05-15,100,100,99,1,1549,1549,1538,11,0,0,0,1,95,95,95,95
San Bernardino,22,2022-05-15,2359,2359,2344,15,48819,48831,48520,311,40,7,7,4,7849,7849,7842,7842
San Diego,22,2022-05-15,6190,6190,6174,16,92853,92876,92629,247,87,6,6,23,5367,5367,5361,5361
San Francisco,22,2022-05-15,3354,3354,3296,58,38843,38854,38179,675,51,5,5,6,889,889,884,884
San Joaquin,22,2022-05-15,1142,1142,1131,11,18252,18257,18086,171,12,1,1,1,2254,2254,2253,2253
San Luis Obispo,22,2022-05-15,370,370,367,3,5772,5772,5730,42,4,0,0,0,483,483,483,483
San Mateo,22,2022-05-15,2705,2705,2689,16,39774,39786,39550,236,37,3,3,1,719,719,716,716
Santa Barbara,22,2022-05-15,817,817,810,7,16595,16600,16465,135,10,0,0,2,693,693,693,693
Santa Clara,22,2022-05-15,6860,6860,6841,19,111711,111738,111422,316,95,11,11,20,2334,2334,2323,2323
Santa Cruz,22,2022-05-15,883,883,877,6,24940,24945,24771,174,4,0,0,1,262,262,262,262
Shasta,22,2022-05-15,115,115,114,1,3766,3766,3734,32,5,0,0,1,563,563,563,563
Siskiyou,22,2022-05-15,20,20,20,0,392,392,389,3,0,0,0,0,83,83,83,83
Solano,22,2022-05-15,1133,1133,1124,9,13661,13665,13556,109,24,0,0,2,450,450,450,450
Sonoma,22,2022-05-15,1467,1467,1456,11,15253,15258,15140,118,24,0,0,5,494,494,494,494
Stanislaus,22,2022-05-15,685,685,677,8,9818,9818,9697,121,31,1,1,6,1696,1696,1695,1695
Sutter,22,2022-05-15,103,103,102,1,1756,1756,1742,14,0,0,0,0,227,227,227,227
Tehama,22,2022-05-15,26,26,26,0,810,810,800,10,1,1,1,2,208,208,207,207
Trinity,22,2022-05-15,5,5,5,0,66,66,65,1,0,0,0,0,20,20,20,20
Tulare,22,2022-05-15,338,338,334,4,7850,7850,7751,99,11,1,1,1,1502,1502,1501,1501
Tuolumne,22,2022-05-15,97,97,96,1,1465,1465,1450,15,2,1,1,0,186,186,185,185
Ventura,22,2022-05-15,1442,1442,1434,8,23195,23200,23074,126,22,1,1,3,1512,1512,1511,1511
Yolo,22,2022-05-15,680,680,675,5,21616,21621,21467,154,1,0,0,0,362,362,362,362
Yuba,22,2022-05-15,107,107,106,1,1270,1270,1260,10,4,0,0,0,126,126,126,126
Alameda,23,2022-05-22,5583,5583,5556,27,76602,76624,76244,380,78,5,5,5,1883,1883,1878,1878
Amador,23,2022-05-22,79,79,78,1,1558,1558,1545,13,0,0,0,0,86,86,86,86
Butte,23,2022-05-22,290,290,289,1,2731,2731,2720,11,8,1,1,0,437,437,436,436
Calaveras,23,2022-05-22,60,60,60,0,757,757,752,5,0,1,1,0,122,122,121,121
Colusa,23,2022-05-22,6,6,6,0,224,224,223,1,0,0,0,0,21,21,21,21
Contra Costa,23,2022-05-22,3871,3871,3839,32,35120,35132,34840,292,64,11,11,8,1327,1327,1316,1316
Del Norte,23,2022-05-22,125,125,124,1,1578,1578,1568,10,1,1,1,0,50,50,49,49
El Dorado,23,2022-05-22,345,345,343,2,3358,3358,3335,23,6,2,2,0,218,218,216,216
Fresno,23,2022-05-22,1571,1571,1559,12,20835,20841,20678,163,52,1,1,8,2775,2775,2774,2774
Glenn,23,2022-05-22,19,19,19,0,269,269,267,2,0,0,0,0,56,56,56,56
Humboldt,23,2022-05-22,241,241,239,2,2871,2871,2853,18,10,1,1,5,149,149,148,148
Imperial,23,2022-05-22,311,311,309,2,4692,4692,4659,33,2,0,0,2,945,945,945,945
Inyo,23,2022-05-22,23,23,23,0,239,239,238,1,0,0,0,0,56,56,56,56
Kern,23,2022-05-22,947,947,942,5,20660,20665,20545,120,32,0,0,6,2352,2352,2352,2352
Kings,23,2022-05-22,247,247,245,2,5599,5599,5560,39,0,0,0,0,450,450,450,450
Lake,23,2022-05-22,82,82,81,1,1251,1251,1241,10,0,0,0,2,140,140,140,140
Lassen,23,2022-05-22,34,34,34,0,1733,1733,1723,10,0,0,0,0,62,62,62,62
Los Angeles,23,2022-05-22,26494,26501,26449,52,942978,943267,941400,1867,338,29,29,53,32025,32025,31996,31996
Madera,23,2022-05-22,211,211,209,2,3717,3717,3688,29,0,0,0,1,371,371,371,371
Marin,23,2022-05-22,823,823,817,6,8904,8905,8837,68,13,0,0,1,239,239,239,239
Mariposa,23,2022-05-22,33,33,33,0,338,338,335,3,0,0,0,0,28,28,28,28
Mendocino,23,2022-05-22,142,142,141,1,1614,1614,1597,17,3,1,1,1,129,129,128,128
Merced,23,2022-05-22,417,417,415,2,4132,4132,4107,25,4,0,0,0,828,828,828,828
Modoc,23,2022-05-22,2,2,2,0,39,40,39,1,0,0,0,0,8,8,8,8
Mono,23,2022-05-22,16,16,16,0,163,163,161,2,0,0,0,0,6,6,6,6
Monterey,23,2022-05-22,653,653,645,8,9671,9673,9552,121,14,1,1,1,735,735,734,734
Napa,23,2022-05-22,320,320,318,2,4050,4050,4029,21,5,0,0,0,144,144,144,144
Nevada,23,2022-05-22,146,146,145,1,1830,1830,1816,14,1,0,0,0,131,131,131,131
Orange,23,2022-05-22,5487,5487,5462,25,95946,95975,95533,442,104,9,9,22,7154,7154,7145,7145
Placer,23,2022-05-22,902,902,894,8,7965,7966,7898,68,36,3,3,5,631,631,628,628
Plumas,23,2022-05-22,45,45,45,0,259,259,257,2,0,0,0,0,13,13,13,13
Riverside,23,2022-05-22,4332,4332,4306,26,51492,51508,51191,317,69,5,5,11,6477,6477,6472,6472
Sacramento,23,2022-05-22,3814,3814,3789,25,40985,40998,40725,273,104,7,7,12,3093,3093,3086,3086
San Benito,23,2022-05-22,161,161,160,1,1565,1565,1557,8,0,0,0,0,95,95,95,95
San Bernardino,23,2022-05-22,3160,3160,3144,16,50163,50180,49930,250,48,4,4,8,7853,7853,7849,7849
San Diego,23,2022-05-22,8725,8725,8707,18,102283,102315,102102,213,121,2,2,21,5369,5369,5367,5367
San Francisco,23,2022-05-22,3634,3634,3585,49,41660,41672,41106,566,81,6,6,11,895,895,889,889
San Joaquin,23,2022-05-22,1481,1481,1470,11,20636,20641,20490,151,19,3,3,9,2257,2257,2254,2254
San Luis Obispo,23,2022-05-22,642,642,638,4,7082,7082,7042,40,11,3,3,0,486,486,483,483
San Mateo,23,2022-05-22,3119,3119,3105,14,40594,40607,40419,188,35,0,0,2,719,719,719,719
Santa Barbara,23,2022-05-22,1062,1062,1055,7,17948,17953,17839,114,17,0,0,3,693,693,693,693
Santa Clara,23,2022-05-22,7802,7802,7785,17,112711,112746,112497,249,109,7,7,22,2341,2341,2334,2334
Santa Cruz,23,2022-05-22,517,517,514,3,7966,7967,7924,43,13,0,0,2,262,262,262,262
Shasta,23,2022-05-22,186,186,185,1,3546,3546,3522,24,4,1,1,3,564,564,563,563
Siskiyou,23,2022-05-22,22,22,22,0,346,346,344,2,1,0,0,0,83,83,83,83
Solano,23,2022-05-22,1548,1548,1538,10,14803,14808,14716,92,24,1,1,3,451,451,450,450
Sonoma,23,2022-05-22,1525,1525,1516,9,16393,16398,16299,99,34,2,2,3,496,496,494,494
Stanislaus,23,2022-05-22,871,871,863,8,10418,10420,10320,100,36,3,3,5,1699,1699,1696,1696
Sutter,23,2022-05-22,138,138,137,1,1806,1806,1795,11,0,1,1,0,228,228,227,227
Tehama,23,2022-05-22,60,60,59,1,816,816,808,8,0,0,0,1,208,208,208,208
Trinity,23,2022-05-22,4,4,4,0,89,89,88,1,0,0,0,0,20,20,20,20
Tulare,23,2022-05-22,559,559,554,5,9071,9074,8984,90,24,0,0,0,1502,1502,1502,1502
Tuolumne,23,2022-05-22,171,171,170,1,1609,1609,1596,13,0,1,1,0,187,187,186,186
Ventura,23,2022-05-22,1917,1917,1909,8,24194,24201,24098,103,36,2,2,2,1514,1514,1512,1512
Yolo,23,2022-05-22,721,721,717,4,22714,22719,22592,127,0,1,1,0,363,363,362,362
Yuba,23,2022-05-22,158,158,157,1,1442,1442,1433,9,5,0,0,1,126,126,126,126
Alameda,24,2022-05-29,5511,5511,5490,21,73333,73364,73079,285,91,4,4,11,1887,1887,1883,1883
Amador,24,2022-05-29,101,101,100,1,1281,1281,1273,8,0,1,1,0,87,87,86,86
Butte,24,2022-05-29,312,312,311,1,3135,3135,3125,10,13,0,0,1,437,437,437,437
Calaveras,24,2022-05-29,54,54,54,0,721,721,717,4,0,0,0,0,122,122,122,122
Colusa,24,2022-05-29,16,16,16,0,208,208,207,1,0,0,0,0,21,21,21,21
Contra Costa,24,2022-05-29,3706,3706,3682,24,34251,34266,34043,223,70,7,7,8,1334,1334,1327,1327
Del Norte,24,2022-05-29,50,50,50,0,1132,1132,1126,6,1,1,1,1,51,51,50,50
El Dorado,24,2022-05-29,382,382,380,2,3433,3433,3414,19,4,2,2,1,220,220,218,218
Fresno,24,2022-05-29,1887,1887,1876,11,22124,22135,22000,135,57,6,6,9,2781,2781,2775,2775
Glenn,24,2022-05-29,32,32,32,0,323,323,321,2,2,0,0,0,56,56,56,56
Humboldt,24,2022-05-29,213,213,212,1,2798,2798,2784,14,10,0,0,5,149,149,149,149
Imperial,24,2022-05-29,362,362,360,2,4876,4876,4849,27,2,0,0,2,945,945,945,945
Inyo,24,2022-05-29,25,25,25,0,191,191,190,1,0,0,0,0,56,56,56,56
Kern,24,2022-05-29,1217,1217,1212,5,21122,21131,21035,96,32,0,0,4,2352,2352,2352,2352
Kings,24,2022-05-29,329,329,327,2,5334,5334,5305,29,2,0,0,1,450,450,450,450
Lake,24,2022-05-29,112,112,111,1,1154,1154,1147,7,1,0,0,0,140,140,140,140
Lassen,24,2022-05-29,62,62,62,0,1927,1927,1919,8,1,0,0,0,62,62,62,62
Los Angeles,24,2022-05-29,29645,29657,29612,45,926617,927001,925567,1434,434,43,43,52,32068,32068,32025,32025
Madera,24,2022-05-29,259,259,257,2,3757,3757,3734,23,5,0,0,1,371,371,371,371
Marin,24,2022-05-29,728,728,724,4,8224,8229,8180,49,17,3,3,1,242,242,239,239
Mariposa,24,2022-05-29,38,38,38,0,344,344,342,2,0,0,0,0,28,28,28,28
Mendocino,24,2022-05-29,144,144,143,1,1444,1444,1432,12,4,0,0,1,129,129,129,129
Merced,24,2022-05-29,420,420,418,2,4113,4113,4094,19,7,0,0,2,828,828,828,828
Modoc,24,2022-05-29,5,5,5,0,44,45,44,1,0,0,0,0,8,8,8,8
Mono,24,2022-05-29,6,6,6,0,107,107,106,1,0,0,0,0,6,6,6,6
Monterey,24,2022-05-29,619,619,613,6,8840,8844,8757,87,14,1,1,1,736,736,735,735
Napa,24,2022-05-29,366,366,365,1,3789,3789,3773,16,4,0,0,0,144,144,144,144
Nevada,24,2022-05-29,200,200,199,1,1967,1967,1955,12,2,2,2,0,133,133,131,131
Orange,24,2022-05-29,6201,6201,6179,22,95506,95547,95204,343,118,13,13,19,7167,7167,7154,7154
Placer,24,2022-05-29,832,832,826,6,7325,7328,7279,49,51,0,0,7,631,631,631,631
Plumas,24,2022-05-29,35,35,35,0,262,262,260,2,1,0,0,0,13,13,13,13
Riverside,24,2022-05-29,4359,4359,4338,21,51988,52009,51758,251,86,4,4,10,6481,6481,6477,6477
Sacramento,24,2022-05-29,4189,4189,4167,22,39014,39030,38827,203,123,8,8,16,3101,3101,3093,3093
San Benito,24,2022-05-29,180,180,179,1,1563,1563,1556,7,0,0,0,0,95,95,95,95
San Bernardino,24,2022-05-29,3756,3756,3742,14,50112,50133,49938,195,50,5,5,10,7858,7858,7853,7853
San Diego,24,2022-05-29,9292,9297,9282,15,99301,99343,99181,162,150,11,11,24,5380,5380,5369,5369
San Francisco,24,2022-05-29,3393,3393,3357,36,38174,38190,37784,406,85,8,8,9,903,903,895,895
San Joaquin,24,2022-05-29,1547,1547,1538,9,19863,19870,19756,114,28,1,1,5,2258,2258,2257,2257
San Luis Obispo,24,2022-05-29,756,756,753,3,6735,6737,6707,30,13,1,1,0,487,487,486,486
San Mateo,24,2022-05-29,3074,3074,3063,11,37660,37675,37538,137,39,2,2,1,721,721,719,719
Santa Barbara,24,2022-05-29,1134,1134,1128,6,17151,17156,17071,85,28,1,1,6,694,694,693,693
Santa Clara,24,2022-05-29,7680,7683,7670,13,100717,100758,100584,174,150,11,11,20,2352,2352,2341,2341
Santa Cruz,24,2022-05-29,543,543,541,2,7453,7457,7425,32,8,1,1,0,263,263,262,262
Shasta,24,2022-05-29,170,170,169,1,3567,3567,3548,19,5,3,3,4,567,567,564,564
Siskiyou,24,2022-05-29,57,57,57,0,386,386,384,2,3,0,0,0,83,83,83,83
Solano,24,2022-05-29,1416,1416,1409,7,14080,14085,14016,69,33,0,0,5,451,451,451,451
Sonoma,24,2022-05-29,1394,1394,1387,7,15614,15620,15546,74,37,2,2,5,498,498,496,496
Stanislaus,24,2022-05-29,876,876,869,7,10365,10370,10292,78,59,2,2,4,1701,1701,1699,1699
Sutter,24,2022-05-29,168,168,167,1,1969,1969,1959,10,0,0,0,0,228,228,228,228
Tehama,24,2022-05-29,60,60,60,0,879,879,873,6,2,0,0,0,208,208,208,208
Trinity,24,2022-05-29,7,7,7,0,100,100,99,1,0,0,0,0,20,20,20,20
Tulare,24,2022-05-29,620,620,615,5,9078,9082,9012,70,22,0,0,0,1502,1502,1502,1502
Tuolumne,24,2022-05-29,127,127,126,1,1535,1535,1526,9,3,0,0,0,187,187,187,187
Ventura,24,2022-05-29,1883,1883,1877,6,22927,22938,22862,76,33,1,1,3,1515,1515,1514,1514
Yolo,24,2022-05-29,684,684,681,3,20828,20838,20747,91,2,0,0,2,363,363,363,363
Yuba,24,2022-05-29,155,155,154,1,1443,1443,1436,7,11,0,0,0,126,126,126,126
Alameda,25,2022-06-05,5923,5926,5908,18,64786,64819,64626,193,103,5,5,14,1892,1892,1887,1887
Amador,25,2022-06-05,82,82,82,0,1597,1597,1589,8,1,0,0,1,87,87,87,87
Butte,25,2022-06-05,390,390,389,1,3197,3197,3189,8,22,1,1,1,438,438,437,437
Calaveras,25,2022-06-05,68,68,68,0,619,619,616,3,0,2,2,0,124,124,122,122
Colusa,25,2022-06-05,17,17,17,0,235,235,234,1,3,0,0,0,21,21,21,21
Contra Costa,25,2022-06-05,3870,3870,3851,19,31461,31477,31319,158,102,8,8,12,1342,1342,1334,1334
Del Norte,25,2022-06-05,55,55,55,0,1108,1108,1104,4,2,0,0,0,51,51,51,51
El Dorado,25,2022-06-05,362,362,360,2,3154,3154,3141,13,7,0,0,3,220,220,220,220
Fresno,25,2022-06-05,2112,2112,2102,10,20025,20037,19942,95,95,2,2,6,2783,2783,2781,2781
Glenn,25,2022-06-05,39,39,39,0,292,292,291,1,3,0,0,0,56,56,56,56
Humboldt,25,2022-06-05,232,232,231,1,2590,2590,2580,10,11,1,1,2,150,150,149,149
Imperial,25,2022-06-05,409,409,407,2,4204,4205,4187,18,5,1,1,0,946,946,945,945
Inyo,25,2022-06-05,17,17,17,0,166,166,165,1,0,0,0,0,56,56,56,56
Kern,25,2022-06-05,1398,1398,1393,5,20267,20279,20208,71,34,0,0,7,2352,2352,2352,2352
Kings,25,2022-06-05,346,346,345,1,4897,4899,4878,21,7,0,0,1,450,450,450,450
Lake,25,2022-06-05,126,126,125,1,1023,1023,1018,5,3,0,0,2,140,140,140,140
Lassen,25,2022-06-05,67,67,67,0,2012,2012,2005,7,1,0,0,0,62,62,62,62
Los Angeles,25,2022-06-05,31280,31297,31260,37,886989,887452,886398,1054,467,44,44,63,32112,32112,32068,32068
Madera,25,2022-06-05,314,314,313,1,3579,3579,3562,17,6,0,0,0,371,371,371,371
Marin,25,2022-06-05,694,694,691,3,7106,7110,7077,33,10,1,1,3,243,243,242,242
Mariposa,25,2022-06-05,60,60,60,0,365,365,363,2,0,0,0,0,28,28,28,28
Mendocino,25,2022-06-05,194,194,193,1,1515,1515,1505,10,8,0,0,2,129,129,129,129
Merced,25,2022-06-05,462,462,460,2,3763,3764,3750,14,12,0,0,0,828,828,828,828
Modoc,25,2022-06-05,10,10,10,0,35,36,35,1,0,0,0,0,8,8,8,8
Mono,25,2022-06-05,13,13,13,0,111,111,110,1,0,0,0,0,6,6,6,6
Monterey,25,2022-06-05,904,904,897,7,9055,9059,8991,68,18,1,1,1,737,737,736,736
Napa,25,2022-06-05,461,461,460,1,3495,3495,3484,11,7,1,1,0,145,145,144,144
Nevada,25,2022-06-05,218,218,217,1,1820,1820,1811,9,4,0,0,1,133,133,133,133
Orange,25,2022-06-05,6928,6932,6913,19,65884,65919,65737,182,130,12,12,21,7179,7179,7167,7167
Placer,25,2022-06-05,795,795,791,4,6688,6692,6657,35,67,0,0,11,631,631,631,631
Plumas,25,2022-06-05,39,39,39,0,261,261,260,1,0,0,0,0,13,13,13,13
Riverside,25,2022-06-05,4763,4764,4746,18,48576,48600,48420,180,93,5,5,9,6486,6486,6481,6481
Sacramento,25,2022-06-05,4496,4496,4478,18,37420,37439,37289,150,131,14,14,19,3115,3115,3101,3101
San Benito,25,2022-06-05,234,234,233,1,1752,1752,1746,6,0,0,0,0,95,95,95,95
San Bernardino,25,2022-06-05,4438,4438,4425,13,48694,48720,48574,146,78,6,6,11,7864,7864,7858,7858
San Diego,25,2022-06-05,9623,9628,9616,12,91368,91415,91301,114,187,6,6,26,5386,5386,5380,5380
San Francisco,25,2022-06-05,3365,3365,3337,28,35064,35082,34794,288,73,3,3,8,906,906,903,903
San Joaquin,25,2022-06-05,1856,1856,1848,8,19530,19541,19455,86,35,4,4,9,2262,2262,2258,2258
San Luis Obispo,25,2022-06-05,791,791,788,3,6516,6520,6498,22,11,1,1,1,488,488,487,487
San Mateo,25,2022-06-05,2953,2953,2945,8,32951,32969,32877,92,29,3,3,4,724,724,721,721
Santa Barbara,25,2022-06-05,1184,1184,1179,5,13682,13687,13635,52,16,2,2,6,696,696,694,694
Santa Clara,25,2022-06-05,7876,7880,7870,10,92088,92136,92014,122,163,7,7,19,2359,2359,2352,2352
Santa Cruz,25,2022-06-05,780,780,777,3,7497,7501,7477,24,19,0,0,2,263,263,263,263
Shasta,25,2022-06-05,181,181,180,1,3723,3724,3709,15,9,1,1,1,568,568,567,567
Siskiyou,25,2022-06-05,41,41,41,0,391,391,390,1,2,0,0,0,83,83,83,83
Solano,25,2022-06-05,1458,1458,1453,5,13034,13040,12991,49,38,2,2,1,453,453,451,451
Sonoma,25,2022-06-05,1449,1449,1444,5,12099,12105,12061,44,31,1,1,2,499,499,498,498
Stanislaus,25,2022-06-05,1088,1088,1082,6,9630,9634,9578,56,56,1,1,2,1702,1702,1701,1701
Sutter,25,2022-06-05,194,194,193,1,1821,1821,1814,7,0,0,0,0,228,228,228,228
Tehama,25,2022-06-05,74,74,74,0,914,914,909,5,1,0,0,0,208,208,208,208
Trinity,25,2022-06-05,8,8,8,0,111,111,110,1,0,0,0,0,20,20,20,20
Tulare,25,2022-06-05,761,761,757,4,8955,8959,8906,53,27,0,0,1,1502,1502,1502,1502
Tuolumne,25,2022-06-05,110,110,109,1,1458,1458,1451,7,2,0,0,1,187,187,187,187
Ventura,25,2022-06-05,1765,1765,1761,4,21973,21985,21929,56,45,1,1,2,1516,1516,1515,1515
Yolo,25,2022-06-05,749,749,746,3,18929,18940,18877,63,3,1,1,0,364,364,363,363
Yuba,25,2022-06-05,162,162,161,1,1407,1407,1402,5,9,0,0,0,126,126,126,126
Alameda,26,2022-06-12,5309,5312,5300,12,57546,57580,57444,136,116,6,6,17,1898,1898,1892,1892
Amador,26,2022-06-12,143,143,142,1,1432,1432,1426,6,2,0,0,0,87,87,87,87
Butte,26,2022-06-12,416,416,415,1,3425,3425,3418,7,30,3,3,0,441,441,438,438
Calaveras,26,2022-06-12,71,71,71,0,699,699,697,2,0,0,0,0,124,124,124,124
Colusa,26,2022-06-12,17,17,17,0,277,277,276,1,17,0,0,0,21,21,21,21
Contra Costa,26,2022-06-12,3530,3530,3516,14,29321,29339,29223,116,89,8,8,11,1350,1350,1342,1342
Del Norte,26,2022-06-12,76,76,76,0,652,652,650,2,3,0,0,0,51,51,51,51
El Dorado,26,2022-06-12,340,340,339,1,3385,3385,3374,11,6,3,3,3,223,223,220,220
Fresno,26,2022-06-12,2400,2400,2391,9,20593,20605,20528,77,119,5,5,9,2788,2788,2783,2783
Glenn,26,2022-06-12,36,36,36,0,327,327,326,1,5,0,0,0,56,56,56,56
Humboldt,26,2022-06-12,247,247,246,1,2433,2433,2426,7,16,0,0,2,150,150,150,150
Imperial,26,2022-06-12,463,463,461,2,4499,4500,4485,15,5,1,1,1,947,947,946,946
Inyo,26,2022-06-12,15,15,15,0,207,207,206,1,0,0,0,0,56,56,56,56
Kern,26,2022-06-12,1595,1595,1591,4,21312,21325,21266,59,28,2,2,7,2354,2354,2352,2352
Kings,26,2022-06-12,356,356,355,1,5130,5134,5117,17,6,1,1,0,451,451,450,450
Lake,26,2022-06-12,133,133,132,1,1215,1215,1210,5,1,0,0,0,140,140,140,140
Lassen,26,2022-06-12,67,67,67,0,1993,1993,1988,5,3,0,0,0,62,62,62,62
Los Angeles,26,2022-06-12,31106,31125,31096,29,761648,762098,761380,718,531,51,51,62,32163,32163,32112,32112
Madera,26,2022-06-12,351,351,350,1,4001,4002,3987,15,8,0,0,1,371,371,371,371
Marin,26,2022-06-12,690,690,688,2,6993,6998,6973,25,16,3,3,2,246,246,243,243
Mariposa,26,2022-06-12,41,41,41,0,378,378,376,2,0,0,0,0,28,28,28,28
Mendocino,26,2022-06-12,175,175,174,1,1614,1614,1606,8,7,1,1,1,130,130,129,129
Merced,26,2022-06-12,537,537,535,2,4083,4084,4072,12,16,0,0,2,828,828,828,828
Modoc,26,2022-06-12,8,8,8,0,35,36,35,1,1,1,1,0,9,9,8,8
Mono,26,2022-06-12,18,18,18,0,83,83,82,1,0,0,0,0,6,6,6,6
Monterey,26,2022-06-12,847,847,842,5,8747,8752,8700,52,26,4,4,1,741,741,737,737
Napa,26,2022-06-12,514,514,513,1,4161,4162,4152,10,3,1,1,1,146,146,145,145
Nevada,26,2022-06-12,185,185,184,1,1894,1894,1887,7,6,0,0,0,133,133,133,133
Orange,26,2022-06-12,7044,7049,7034,15,66344,66385,66241,144,186,15,15,20,7194,7194,7179,7179
Placer,26,2022-06-12,818,818,815,3,7004,7009,6980,29,75,2,2,7,633,633,631,631
Plumas,26,2022-06-12,36,36,36,0,286,286,285,1,0,0,0,0,13,13,13,13
Riverside,26,2022-06-12,5040,5042,5027,15,49281,49311,49167,144,95,3,3,10,6489,6489,6486,6486
Sacramento,26,2022-06-12,4346,4347,4333,14,37900,37923,37803,120,151,14,14,25,3129,3129,3115,3115
San Benito,26,2022-06-12,211,211,210,1,1779,1779,1774,5,0,0,0,2,95,95,95,95
San Bernardino,26,2022-06-12,4735,4736,4725,11,50007,50037,49919,118,83,7,7,15,7871,7871,7864,7864
San Diego,26,2022-06-12,9775,9781,9771,10,85703,85753,85669,84,178,12,12,30,5398,5398,5386,5386
San Francisco,26,2022-06-12,3066,3066,3046,20,31778,31796,31590,206,68,9,9,12,915,915,906,906
San Joaquin,26,2022-06-12,2001,2001,1994,7,19458,19471,19403,68,34,6,6,3,2268,2268,2262,2262
San Luis Obispo,26,2022-06-12,686,686,684,2,6188,6193,6176,17,18,0,0,0,488,488,488,488
San Mateo,26,2022-06-12,2684,2684,2678,6,29874,29892,29826,66,44,3,3,2,727,727,724,724
Santa Barbara,26,2022-06-12,950,950,947,3,9894,9899,9869,30,22,1,1,5,697,697,696,696
Santa Clara,26,2022-06-12,7282,7288,7280,8,81096,81144,81059,85,171,11,11,24,2370,2370,2359,2359
Santa Cruz,26,2022-06-12,874,874,872,2,10569,10575,10548,27,23,1,1,1,264,264,263,263
Shasta,26,2022-06-12,214,214,213,1,3531,3533,3522,11,0,2,2,0,570,570,568,568
Siskiyou,26,2022-06-12,47,47,47,0,374,374,373,1,1,0,0,0,83,83,83,83
Solano,26,2022-06-12,1740,1740,1735,5,13313,13320,13281,39,38,0,0,3,453,453,453,453
Sonoma,26,2022-06-12,1359,1359,1355,4,11983,11989,11955,34,35,2,2,5,501,501,499,499
Stanislaus,26,2022-06-12,1127,1127,1122,5,9568,9574,9530,44,59,1,1,6,1703,1703,1702,1702
Sutter,26,2022-06-12,185,185,184,1,1800,1800,1795,5,0,0,0,0,228,228,228,228
Tehama,26,2022-06-12,88,88,88,0,1002,1002,998,4,3,0,0,0,208,208,208,208
Trinity,26,2022-06-12,8,8,8,0,79,80,79,1,0,0,0,0,20,20,20,20
Tulare,26,2022-06-12,825,825,821,4,9610,9615,9570,45,23,2,2,1,1504,1504,1502,1502
Tuolumne,26,2022-06-12,150,150,149,1,1516,1516,1510,6,2,0,0,0,187,187,187,187
Ventura,26,2022-06-12,1933,1933,1929,4,21114,21126,21083,43,39,6,6,5,1522,1522,1516,1516
Yolo,26,2022-06-12,777,777,775,2,15426,15436,15395,41,2,0,0,0,364,364,364,364
Yuba,26,2022-06-12,201,201,200,1,1465,1465,1461,4,9,0,0,1,126,126,126,126
Alameda,27,2022-06-19,4852,4856,4847,9,51244,51280,51186,94,93,10,10,13,1908,1908,1898,1898
Amador,27,2022-06-19,77,77,77,0,1235,1235,1231,4,1,0,0,0,87,87,87,87
Butte,27,2022-06-19,409,409,408,1,3610,3610,3605,5,25,5,5,0,446,446,441,441
Calaveras,27,2022-06-19,78,78,78,0,618,618,616,2,0,0,0,0,124,124,124,124
Colusa,27,2022-06-19,13,13,13,0,258,258,257,1,18,0,0,0,21,21,21,21
Contra Costa,27,2022-06-19,3249,3249,3239,10,26430,26447,26366,81,68,7,7,7,1357,1357,1350,1350
Del Norte,27,2022-06-19,79,79,79,0,616,616,615,1,2,1,1,1,52,52,51,51
El Dorado,27,2022-06-19,331,331,330,1,3046,3046,3038,8,7,2,2,1,225,225,223,223
Fresno,27,2022-06-19,2488,2488,2481,7,20045,20059,20001,58,85,1,1,15,2789,2789,2788,2788
Glenn,27,2022-06-19,35,35,35,0,317,317,316,1,3,0,0,0,56,56,56,56
Humboldt,27,2022-06-19,293,293,292,1,2279,2279,2274,5,14,0,0,3,150,150,150,150
Imperial,27,2022-06-19,557,557,556,1,4069,4071,4060,11,7,0,0,0,947,947,947,947
Inyo,27,2022-06-19,20,20,20,0,185,186,185,1,0,0,0,0,56,56,56,56
Kern,27,2022-06-19,1567,1567,1564,3,20663,20678,20634,44,35,5,5,10,2359,2359,2354,2354
Kings,27,2022-06-19,397,397,396,1,5017,5021,5008,13,4,1,1,0,452,452,451,451
Lake,27,2022-06-19,130,130,130,0,1190,1190,1186,4,2,0,0,1,140,140,140,140
Lassen,27,2022-06-19,48,48,48,0,1282,1282,1279,3,1,0,0,0,62,62,62,62
Los Angeles,27,2022-06-19,27611,27630,27610,20,368396,368651,368382,269,610,56,56,61,32219,32219,32163,32163
Madera,27,2022-06-19,341,341,340,1,4126,4129,4117,12,6,0,0,0,371,371,371,371
Marin,27,2022-06-19,675,675,673,2,6507,6512,6494,18,19,0,0,2,246,246,246,246
Mariposa,27,2022-06-19,52,52,52,0,343,343,342,1,0,0,0,0,28,28,28,28
Mendocino,27,2022-06-19,176,176,175,1,1572,1572,1566,6,5,0,0,1,130,130,130,130
Merced,27,2022-06-19,555,555,554,1,4132,4133,4124,9,11,3,3,1,831,831,828,828
Modoc,27,2022-06-19,2,2,2,0,34,35,34,1,1,0,0,0,9,9,9,9
Mono,27,2022-06-19,8,8,8,0,91,92,91,1,0,1,1,0,7,7,6,6
Monterey,27,2022-06-19,903,903,899,4,8971,8977,8936,41,35,1,1,2,742,742,741,741
Napa,27,2022-06-19,372,372,371,1,3305,3306,3299,7,0,1,1,3,147,147,146,146
Nevada,27,2022-06-19,184,184,183,1,1727,1727,1722,5,7,1,1,0,134,134,133,133
Orange,27,2022-06-19,7040,7045,7033,12,61822,61865,61760,105,158,9,9,21,7203,7203,7194,7194
Placer,27,2022-06-19,669,669,667,2,6134,6139,6120,19,65,1,1,6,634,634,633,633
Plumas,27,2022-06-19,36,36,36,0,231,231,230,1,0,0,0,0,13,13,13,13
Riverside,27,2022-06-19,5033,5038,5027,11,44722,44753,44651,102,103,6,6,8,6495,6495,6489,6489
Sacramento,27,2022-06-19,3946,3947,3937,10,35792,35817,35729,88,156,10,10,25,3139,3139,3129,3129
San Benito,27,2022-06-19,188,188,188,0,1677,1677,1674,3,0,1,1,1,96,96,95,95
San Bernardino,27,2022-06-19,4637,4639,4631,8,46964,46996,46910,86,102,11,11,14,7882,7882,7871,7871
San Diego,27,2022-06-19,9899,9906,9898,8,80394,80450,80388,62,203,8,8,17,5406,5406,5398,5398
San Francisco,27,2022-06-19,3087,3087,3072,15,29891,29912,29761,151,70,13,13,15,928,928,915,915
San Joaquin,27,2022-06-19,1706,1706,1701,5,18227,18240,18190,50,37,5,5,7,2273,2273,2268,2268
San Luis Obispo,27,2022-06-19,597,597,596,1,5832,5837,5825,12,30,9,9,0,497,497,488,488
San Mateo,27,2022-06-19,2635,2635,2631,4,27395,27414,27367,47,47,2,2,4,729,729,727,727
Santa Barbara,27,2022-06-19,937,937,935,2,8694,8699,8679,20,31,2,2,6,699,699,697,697
Santa Clara,27,2022-06-19,6815,6822,6817,5,65981,66026,65972,54,156,10,10,20,2380,2380,2370,2370
Santa Cruz,27,2022-06-19,815,815,813,2,9307,9313,9294,19,18,1,1,2,265,265,264,264
Shasta,27,2022-06-19,229,229,228,1,3291,3293,3285,8,8,1,1,1,571,571,570,570
Siskiyou,27,2022-06-19,57,57,57,0,399,399,398,1,2,1,1,0,84,84,83,83
Solano,27,2022-06-19,1455,1455,1452,3,11788,11795,11768,27,38,0,0,6,453,453,453,453
Sonoma,27,2022-06-19,1414,1414,1411,3,10984,10991,10966,25,34,2,2,2,503,503,501,501
Stanislaus,27,2022-06-19,1051,1051,1047,4,8897,8903,8871,32,72,5,5,6,1708,1708,1703,1703
Sutter,27,2022-06-19,202,202,202,0,1870,1870,1866,4,0,0,0,0,228,228,228,228
Tehama,27,2022-06-19,107,107,107,0,924,924,921,3,2,0,0,0,208,208,208,208
Trinity,27,2022-06-19,10,10,10,0,108,109,108,1,0,0,0,0,20,20,20,20
Tulare,27,2022-06-19,910,910,907,3,9367,9373,9339,34,31,6,6,0,1510,1510,1504,1504
Tuolumne,27,2022-06-19,142,142,142,0,1559,1559,1554,5,2,0,0,1,187,187,187,187
Ventura,27,2022-06-19,1839,1839,1836,3,19153,19166,19136,30,52,1,1,4,1523,1523,1522,1522
Yolo,27,2022-06-19,713,713,712,1,12069,12077,12052,25,1,2,2,2,366,366,364,364
Yuba,27,2022-06-19,145,145,145,0,1376,1376,1373,3,9,0,0,6,126,126,126,126
Alameda,28,2022-06-26,5311,5316,5308,8,46869,46904,46837,67,134,6,6,14,1914,1914,1908,1908
Amador,28,2022-06-26,99,99,99,0,1163,1163,1160,3,1,0,0,2,87,87,87,87
Butte,28,2022-06-26,399,399,399,0,3377,3379,3375,4,27,2,2,0,448,448,446,446
Calaveras,28,2022-06-26,72,72,72,0,578,578,577,1,1,2,2,0,126,126,124,124
Colusa,28,2022-06-26,23,23,23,0,188,189,188,1,8,1,1,0,22,22,21,21
Contra Costa,28,2022-06-26,3592,3593,3584,9,25367,25385,25324,61,93,11,11,5,1368,1368,1357,1357
Del Norte,28,2022-06-26,135,135,135,0,664,664,663,1,5,1,1,0,53,53,52,52
El Dorado,28,2022-06-26,425,425,424,1,3144,3145,3139,6,7,0,0,1,225,225,225,225
Fresno,28,2022-06-26,2739,2739,2733,6,19770,19785,19740,45,129,3,3,14,2792,2792,2789,2789
Glenn,28,2022-06-26,32,32,32,0,296,296,295,1,2,0,0,0,56,56,56,56
Humboldt,28,2022-06-26,272,272,272,0,2213,2213,2209,4,4,1,1,2,151,151,150,150
Imperial,28,2022-06-26,680,680,679,1,3843,3844,3836,8,7,0,0,2,947,947,947,947
Inyo,28,2022-06-26,22,22,22,0,233,234,233,1,0,0,0,0,56,56,56,56
Kern,28,2022-06-26,1877,1877,1874,3,18352,18366,18335,31,43,6,6,10,2365,2365,2359,2359
Kings,28,2022-06-26,456,456,455,1,4139,4142,4134,8,8,0,0,0,452,452,452,452
Lake,28,2022-06-26,117,117,117,0,1130,1130,1127,3,1,0,0,0,140,140,140,140
Lassen,28,2022-06-26,55,55,55,0,1096,1096,1094,2,1,0,0,0,62,62,62,62
Los Angeles,28,2022-06-26,31039,31064,31047,17,353940,354209,354009,200,690,72,72,69,32291,32291,32219,32219
Madera,28,2022-06-26,437,437,436,1,4308,4311,4301,10,7,0,0,0,371,371,371,371
Marin,28,2022-06-26,667,667,666,1,6229,6234,6220,14,23,0,0,3,246,246,246,246
Mariposa,28,2022-06-26,54,54,54,0,303,303,302,1,0,0,0,0,28,28,28,28
Mendocino,28,2022-06-26,151,151,151,0,1422,1422,1418,4,4,0,0,0,130,130,130,130
Merced,28,2022-06-26,584,584,583,1,4022,4025,4018,7,5,2,2,3,833,833,831,831
Modoc,28,2022-06-26,9,9,9,0,33,34,33,1,0,0,0,0,9,9,9,9
Mono,28,2022-06-26,17,17,17,0,81,82,81,1,0,0,0,0,7,7,7,7
Monterey,28,2022-06-26,908,908,905,3,8462,8467,8437,30,36,2,2,5,744,744,742,742
Napa,28,2022-06-26,374,374,373,1,3207,3207,3202,5,2,2,2,1,149,149,147,147
Nevada,28,2022-06-26,175,175,175,0,1585,1585,1581,4,3,0,0,1,134,134,134,134
Orange,28,2022-06-26,7400,7407,7397,10,58526,58571,58494,77,172,13,13,25,7216,7216,7203,7203
Placer,28,2022-06-26,798,798,796,2,6153,6158,6143,15,87,6,6,7,640,640,634,634
Plumas,28,2022-06-26,46,46,46,0,263,263,262,1,0,0,0,0,13,13,13,13
Riverside,28,2022-06-26,5841,5848,5838,10,44014,44048,43970,78,125,10,10,21,6505,6505,6495,6495
Sacramento,28,2022-06-26,4072,4075,4067,8,34547,34572,34506,66,181,13,13,23,3152,3152,3139,3139
San Benito,28,2022-06-26,195,195,195,0,1546,1546,1544,2,0,0,0,2,96,96,96,96
San Bernardino,28,2022-06-26,5337,5342,5334,8,47598,47634,47566,68,120,12,12,21,7894,7894,7882,7882
San Diego,28,2022-06-26,10218,10225,10219,6,77838,77897,77851,46,249,10,10,22,5416,5416,5406,5406
San Francisco,28,2022-06-26,3157,3157,3145,12,27791,27812,27703,109,95,4,4,18,932,932,928,928
San Joaquin,28,2022-06-26,1838,1838,1834,4,18210,18224,18185,39,39,3,3,9,2276,2276,2273,2273
San Luis Obispo,28,2022-06-26,651,651,650,1,5812,5817,5807,10,26,4,4,0,501,501,497,497
San Mateo,28,2022-06-26,2827,2827,2823,4,25718,25738,25704,34,37,1,1,1,730,730,729,729
Santa Barbara,28,2022-06-26,1110,1110,1108,2,9319,9326,9309,17,26,2,2,2,701,701,699,699
Santa Clara,28,2022-06-26,7336,7343,7338,5,59871,59917,59879,38,185,12,12,13,2392,2392,2380,2380
Santa Cruz,28,2022-06-26,867,867,866,1,9126,9131,9117,14,21,2,2,1,267,267,265,265
Shasta,28,2022-06-26,315,315,314,1,3304,3306,3300,6,21,0,0,3,571,571,571,571
Siskiyou,28,2022-06-26,57,57,57,0,344,344,343,1,1,1,1,0,85,85,84,84
Solano,28,2022-06-26,1600,1600,1597,3,12735,12746,12723,23,39,0,0,4,453,453,453,453
Sonoma,28,2022-06-26,1375,1375,1373,2,10012,10018,10001,17,36,2,2,3,505,505,503,503
Stanislaus,28,2022-06-26,1196,1196,1193,3,8797,8803,8779,24,95,2,2,6,1710,1710,1708,1708
Sutter,28,2022-06-26,192,192,192,0,1840,1840,1837,3,0,0,0,0,228,228,228,228
Tehama,28,2022-06-26,85,85,85,0,829,829,827,2,3,0,0,0,208,208,208,208
Trinity,28,2022-06-26,22,22,22,0,139,140,139,1,1,0,0,0,20,20,20,20
Tulare,28,2022-06-26,913,913,910,3,7817,7822,7800,22,38,2,2,1,1512,1512,1510,1510
Tuolumne,28,2022-06-26,171,171,171,0,1415,1415,1412,3,1,4,4,0,191,191,187,187
Ventura,28,2022-06-26,2047,2047,2045,2,18776,18790,18767,23,58,2,2,1,1525,1525,1523,1523
Yolo,28,2022-06-26,767,767,766,1,10590,10597,10580,17,8,1,1,1,367,367,366,366
Yuba,28,2022-06-26,168,168,168,0,1401,1401,1399,2,8,2,2,2,128,128,126,126
Alameda,29,2022-07-03,5354,5359,5353,6,45360,45398,45347,51,126,11,11,11,1925,1925,1914,1914
Amador,29,2022-07-03,97,97,97,0,1661,1661,1658,3,3,0,0,2,87,87,87,87
Butte,29,2022-07-03,343,343,343,0,3089,3090,3087,3,24,2,2,1,450,450,448,448
Calaveras,29,2022-07-03,80,80,80,0,562,562,561,1,0,2,2,0,128,128,126,126
Colusa,29,2022-07-03,28,28,28,0,263,264,263,1,3,0,0,0,22,22,22,22
Contra Costa,29,2022-07-03,3595,3598,3591,7,24604,24625,24579,46,78,10,10,18,1378,1378,1368,1368
Del Norte,29,2022-07-03,153,153,153,0,667,667,666,1,4,0,0,0,53,53,53,53
El Dorado,29,2022-07-03,358,358,357,1,3023,3024,3019,5,11,1,1,0,226,226,225,225
Fresno,29,2022-07-03,2757,2757,2752,5,18216,18231,18199,32,146,4,4,18,2796,2796,2792,2792
Glenn,29,2022-07-03,28,28,28,0,267,268,267,1,1,0,0,0,56,56,56,56
Humboldt,29,2022-07-03,201,201,201,0,1911,1911,1908,3,8,2,2,4,153,153,151,151
Imperial,29,2022-07-03,770,770,769,1,3795,3798,3792,6,8,1,1,3,948,948,947,947
Inyo,29,2022-07-03,49,49,49,0,366,366,365,1,2,0,0,0,56,56,56,56
Kern,29,2022-07-03,1959,1959,1956,3,16431,16445,16424,21,53,5,5,6,2370,2370,2365,2365
Kings,29,2022-07-03,520,520,519,1,3915,3919,3913,6,5,0,0,0,452,452,452,452
Lake,29,2022-07-03,115,115,115,0,1021,1021,1019,2,2,2,2,1,142,142,140,140
Lassen,29,2022-07-03,37,37,37,0,820,820,819,1,2,0,0,0,62,62,62,62
Los Angeles,29,2022-07-03,36034,36064,36048,16,340970,341256,341105,151,759,82,82,87,32373,32373,32291,32291
Madera,29,2022-07-03,383,383,382,1,4047,4051,4044,7,10,0,0,1,371,371,371,371
Marin,29,2022-07-03,658,658,657,1,5704,5709,5699,10,24,1,1,2,247,247,246,246
Mariposa,29,2022-07-03,40,40,40,0,251,252,251,1,0,0,0,0,28,28,28,28
Mendocino,29,2022-07-03,181,181,181,0,1311,1311,1308,3,5,3,3,0,133,133,130,130
Merced,29,2022-07-03,679,679,678,1,3683,3685,3680,5,12,1,1,1,834,834,833,833
Modoc,29,2022-07-03,11,11,11,0,34,35,34,1,1,0,0,0,9,9,9,9
Mono,29,2022-07-03,31,31,31,0,119,120,119,1,1,0,0,0,7,7,7,7
Monterey,29,2022-07-03,906,906,903,3,7288,7293,7272,21,47,2,2,3,746,746,744,744
Napa,29,2022-07-03,406,406,406,0,3154,3155,3151,4,12,0,0,0,149,149,149,149
Nevada,29,2022-07-03,202,202,202,0,1527,1527,1524,3,6,0,0,1,134,134,134,134
Orange,29,2022-07-03,7971,7978,7970,8,58259,58307,58247,60,195,26,26,35,7242,7242,7216,7216
Placer,29,2022-07-03,850,850,848,2,5843,5848,5837,11,78,2,2,5,642,642,640,640
Plumas,29,2022-07-03,37,37,37,0,222,223,222,1,5,0,0,0,13,13,13,13
Riverside,29,2022-07-03,7052,7059,7049,10,44717,44754,44692,62,128,7,7,8,6512,6512,6505,6505
Sacramento,29,2022-07-03,4134,4139,4133,6,31978,32004,31956,48,165,12,12,24,3164,3164,3152,3152
San Benito,29,2022-07-03,249,249,249,0,1584,1584,1582,2,2,0,0,1,96,96,96,96
San Bernardino,29,2022-07-03,6670,6676,6669,7,48525,48565,48511,54,138,12,12,24,7906,7906,7894,7894
San Diego,29,2022-07-03,11051,11061,11056,5,76381,76445,76409,36,262,10,10,41,5426,5426,5416,5416
San Francisco,29,2022-07-03,3187,3188,3178,10,27640,27662,27577,85,104,9,9,16,941,941,932,932
San Joaquin,29,2022-07-03,1887,1887,1884,3,16661,16675,16647,28,43,4,4,6,2280,2280,2276,2276
San Luis Obispo,29,2022-07-03,682,682,681,1,4976,4981,4975,6,23,0,0,0,501,501,501,501
San Mateo,29,2022-07-03,2812,2812,2809,3,25310,25331,25305,26,34,2,2,3,732,732,730,730
Santa Barbara,29,2022-07-03,1157,1157,1155,2,9125,9133,9120,13,25,4,4,5,705,705,701,701
Santa Clara,29,2022-07-03,7460,7467,7463,4,58033,58081,58052,29,195,16,16,32,2408,2408,2392,2392
Santa Cruz,29,2022-07-03,829,829,828,1,8884,8890,8879,11,21,0,0,1,267,267,267,267
Shasta,29,2022-07-03,328,328,328,0,3092,3094,3089,5,14,4,4,2,575,575,571,571
Siskiyou,29,2022-07-03,49,49,49,0,387,388,387,1,1,0,0,1,85,85,85,85
Solano,29,2022-07-03,1540,1540,1538,2,11728,11738,11722,16,49,0,0,6,453,453,453,453
Sonoma,29,2022-07-03,1214,1214,1212,2,9602,9610,9597,13,38,1,1,0,506,506,505,505
Stanislaus,29,2022-07-03,1246,1246,1243,3,7952,7957,7940,17,88,7,7,14,1717,1717,1710,1710
Sutter,29,2022-07-03,249,249,249,0,1845,1846,1843,3,0,0,0,0,228,228,228,228
Tehama,29,2022-07-03,131,131,131,0,984,984,982,2,4,2,2,0,210,210,208,208
Trinity,29,2022-07-03,21,21,21,0,150,151,150,1,2,0,0,0,20,20,20,20
Tulare,29,2022-07-03,1030,1030,1028,2,7609,7615,7598,17,30,2,2,3,1514,1514,1512,1512
Tuolumne,29,2022-07-03,170,170,170,0,1171,1171,1169,2,8,0,0,1,191,191,191,191
Ventura,29,2022-07-03,2132,2132,2130,2,17759,17774,17757,17,86,3,3,3,1528,1528,1525,1525
Yolo,29,2022-07-03,607,607,606,1,8440,8446,8435,11,5,3,3,2,370,370,367,367
Yuba,29,2022-07-03,191,191,191,0,1239,1239,1237,2,6,1,1,2,129,129,128,128
Alameda,30,2022-07-10,5353,5359,5354,5,42095,42135,42099,36,120,4,4,19,1929,1929,1925,1925
Amador,30,2022-07-10,90,90,90,0,1442,1442,1440,2,0,0,0,2,87,87,87,87
Butte,30,2022-07-10,411,411,411,0,2717,2719,2717,2,26,1,1,3,451,451,450,450
Calaveras,30,2022-07-10,85,85,85,0,493,493,492,1,0,1,1,0,129,129,128,128
Colusa,30,2022-07-10,24,24,24,0,360,361,360,1,0,0,0,0,22,22,22,22
Contra Costa,30,2022-07-10,3425,3428,3423,5,23035,23058,23025,33,98,13,13,13,1391,1391,1378,1378
Del Norte,30,2022-07-10,143,143,143,0,590,590,589,1,6,0,0,2,53,53,53,53
El Dorado,30,2022-07-10,331,331,331,0,2687,2688,2685,3,14,0,0,2,226,226,226,226
Fresno,30,2022-07-10,3240,3244,3240,4,18553,18571,18546,25,156,8,8,13,2804,2804,2796,2796
Glenn,30,2022-07-10,41,41,41,0,283,284,283,1,0,0,0,0,56,56,56,56
Humboldt,30,2022-07-10,254,254,254,0,1829,1829,1827,2,8,1,1,2,154,154,153,153
Imperial,30,2022-07-10,968,968,967,1,3910,3914,3909,5,9,0,0,1,948,948,948,948
Inyo,30,2022-07-10,39,39,39,0,330,331,330,1,0,1,1,0,57,57,56,56
Kern,30,2022-07-10,2107,2107,2105,2,14698,14712,14697,15,70,2,2,11,2372,2372,2370,2370
Kings,30,2022-07-10,582,582,581,1,3794,3798,3793,5,11,4,4,1,456,456,452,452
Lake,30,2022-07-10,112,112,112,0,974,974,973,1,1,0,0,0,142,142,142,142
Lassen,30,2022-07-10,47,47,47,0,701,701,700,1,5,1,1,0,63,63,62,62
Los Angeles,30,2022-07-10,38837,38875,38862,13,327034,327345,327234,111,982,91,91,97,32464,32464,32373,32373
Madera,30,2022-07-10,451,451,450,1,3428,3431,3426,5,12,0,0,4,371,371,371,371
Marin,30,2022-07-10,576,576,575,1,5371,5375,5368,7,17,1,1,2,248,248,247,247
Mariposa,30,2022-07-10,49,49,49,0,267,268,267,1,0,0,0,0,28,28,28,28
Mendocino,30,2022-07-10,172,172,172,0,1247,1247,1245,2,6,0,0,0,133,133,133,133
Merced,30,2022-07-10,654,654,653,1,3592,3596,3592,4,16,5,5,1,839,839,834,834
Modoc,30,2022-07-10,27,27,27,0,53,54,53,1,0,1,1,0,10,10,9,9
Mono,30,2022-07-10,11,11,11,0,85,86,85,1,0,0,0,0,7,7,7,7
Monterey,30,2022-07-10,1016,1016,1014,2,7052,7058,7043,15,46,4,4,1,750,750,746,746
Napa,30,2022-07-10,329,329,329,0,3103,3107,3104,3,11,1,1,2,150,150,149,149
Nevada,30,2022-07-10,179,179,179,0,1530,1530,1528,2,5,0,0,1,134,134,134,134
Orange,30,2022-07-10,8650,8657,8650,7,56770,56824,56779,45,245,23,23,31,7265,7265,7242,7242
Placer,30,2022-07-10,754,754,753,1,5244,5249,5241,8,87,3,3,8,645,645,642,642
Plumas,30,2022-07-10,65,65,65,0,245,246,245,1,0,0,0,0,13,13,13,13
Riverside,30,2022-07-10,8188,8196,8187,9,45012,45055,45007,48,200,16,16,13,6528,6528,6512,6512
Sacramento,30,2022-07-10,3774,3778,3774,4,30702,30732,30696,36,191,26,26,23,3190,3190,3164,3164
San Benito,30,2022-07-10,206,206,206,0,1453,1453,1452,1,1,0,0,0,96,96,96,96
San Bernardino,30,2022-07-10,7583,7590,7583,7,49352,49400,49357,43,174,12,12,24,7918,7918,7906,7906
San Diego,30,2022-07-10,11906,11917,11913,4,74678,74749,74722,27,316,9,9,50,5435,5435,5426,5426
San Francisco,30,2022-07-10,2783,2784,2777,7,24831,24855,24796,59,107,14,14,19,955,955,941,941
San Joaquin,30,2022-07-10,1937,1937,1935,2,17158,17174,17152,22,58,7,7,7,2287,2287,2280,2280
San Luis Obispo,30,2022-07-10,702,702,701,1,4714,4718,4713,5,25,3,3,0,504,504,501,501
San Mateo,30,2022-07-10,2614,2614,2612,2,22348,22370,22352,18,36,5,5,12,737,737,732,732
Santa Barbara,30,2022-07-10,1201,1201,1200,1,8350,8357,8348,9,37,4,4,11,709,709,705,705
Santa Clara,30,2022-07-10,6995,7002,6999,3,53779,53830,53810,20,203,12,12,42,2420,2420,2408,2408
Santa Cruz,30,2022-07-10,901,901,900,1,7921,7928,7921,7,16,0,0,0,267,267,267,267
Shasta,30,2022-07-10,296,296,296,0,2923,2925,2922,3,18,3,3,5,578,578,575,575
Siskiyou,30,2022-07-10,29,29,29,0,317,318,317,1,1,1,1,1,86,86,85,85
Solano,30,2022-07-10,1457,1457,1455,2,10060,10069,10058,11,48,1,1,6,454,454,453,453
Sonoma,30,2022-07-10,1206,1206,1205,1,8744,8751,8742,9,39,1,1,6,507,507,506,506
Stanislaus,30,2022-07-10,1373,1373,1371,2,7973,7981,7968,13,101,7,7,10,1724,1724,1717,1717
Sutter,30,2022-07-10,259,259,259,0,1611,1611,1609,2,0,0,0,0,228,228,228,228
Tehama,30,2022-07-10,125,125,125,0,782,782,781,1,6,0,0,1,210,210,210,210
Trinity,30,2022-07-10,30,30,30,0,113,114,113,1,0,0,0,0,20,20,20,20
Tulare,30,2022-07-10,1231,1231,1229,2,7636,7642,7629,13,46,5,5,1,1519,1519,1514,1514
Tuolumne,30,2022-07-10,240,240,240,0,1127,1127,1125,2,5,0,0,0,191,191,191,191
Ventura,30,2022-07-10,2286,2286,2284,2,17314,17331,17318,13,78,8,8,4,1536,1536,1528,1528
Yolo,30,2022-07-10,467,467,467,0,4766,4770,4765,5,7,3,3,3,373,373,370,370
Yuba,30,2022-07-10,193,193,193,0,1254,1254,1253,1,6,0,0,2,129,129,129,129
Alameda,31,2022-07-17,5046,5051,5048,3,43707,43752,43722,30,141,6,6,29,1935,1935,1929,1929
Amador,31,2022-07-17,86,86,86,0,1264,1264,1263,1,3,0,0,2,87,87,87,87
Butte,31,2022-07-17,373,373,373,0,2916,2919,2917,2,28,1,1,3,452,452,451,451
Calaveras,31,2022-07-17,71,71,71,0,548,548,547,1,0,0,0,0,129,129,129,129
Colusa,31,2022-07-17,21,21,21,0,347,348,347,1,0,0,0,0,22,22,22,22
Contra Costa,31,2022-07-17,3106,3109,3105,4,23037,23062,23036,26,92,3,3,15,1394,1394,1391,1391
Del Norte,31,2022-07-17,181,181,181,0,689,689,688,1,7,0,0,0,53,53,53,53
El Dorado,31,2022-07-17,316,316,316,0,2688,2690,2687,3,8,2,2,0,228,228,226,226
Fresno,31,2022-07-17,3679,3684,3680,4,21093,21114,21091,23,180,9,9,15,2813,2813,2804,2804
Glenn,31,2022-07-17,33,33,33,0,264,265,264,1,0,0,0,0,56,56,56,56
Humboldt,31,2022-07-17,298,298,298,0,2019,2019,2017,2,8,0,0,4,154,154,154,154
Imperial,31,2022-07-17,1054,1054,1053,1,4635,4640,4635,5,17,3,3,0,951,951,948,948
Inyo,31,2022-07-17,25,25,25,0,331,332,331,1,1,0,0,0,57,57,57,57
Kern,31,2022-07-17,2334,2335,2333,2,16144,16161,16148,13,71,9,9,17,2381,2381,2372,2372
Kings,31,2022-07-17,744,744,743,1,4160,4165,4161,4,12,0,0,0,456,456,456,456
Lake,31,2022-07-17,125,125,125,0,939,939,938,1,0,0,0,0,142,142,142,142
Lassen,31,2022-07-17,67,67,67,0,994,994,993,1,1,0,0,0,63,63,63,63
Los Angeles,31,2022-07-17,41846,41890,41879,11,351793,352160,352066,94,1142,111,111,131,32575,32575,32464,32464
Madera,31,2022-07-17,527,527,526,1,3862,3867,3863,4,9,0,0,5,371,371,371,371
Marin,31,2022-07-17,515,515,514,1,5463,5469,5463,6,12,1,1,6,249,249,248,248
Mariposa,31,2022-07-17,42,42,42,0,247,248,247,1,0,1,1,0,29,29,28,28
Mendocino,31,2022-07-17,175,175,175,0,1453,1453,1451,2,7,0,0,2,133,133,133,133
Merced,31,2022-07-17,774,774,773,1,3921,3926,3923,3,16,2,2,1,841,841,839,839
Modoc,31,2022-07-17,11,11,11,0,31,32,31,1,1,0,0,0,10,10,10,10
Mono,31,2022-07-17,9,9,9,0,81,82,81,1,0,0,0,1,7,7,7,7
Monterey,31,2022-07-17,985,985,983,2,7149,7156,7144,12,49,7,7,7,757,757,750,750
Napa,31,2022-07-17,331,331,331,0,3118,3122,3120,2,9,0,0,0,150,150,150,150
Nevada,31,2022-07-17,169,169,169,0,1347,1347,1346,1,10,0,0,2,134,134,134,134
Orange,31,2022-07-17,8972,8981,8975,6,59709,59771,59734,37,255,22,22,40,7287,7287,7265,7265
Placer,31,2022-07-17,712,712,711,1,5357,5362,5356,6,86,1,1,4,646,646,645,645
Plumas,31,2022-07-17,58,58,58,0,256,257,256,1,1,0,0,0,13,13,13,13
Riverside,31,2022-07-17,8372,8380,8373,7,48223,48275,48234,41,214,16,16,15,6544,6544,6528,6528
Sacramento,31,2022-07-17,3581,3586,3583,3,30473,30505,30477,28,172,13,13,25,3203,3203,3190,3190
San Benito,31,2022-07-17,209,209,209,0,1616,1616,1615,1,0,1,1,0,97,97,96,96
San Bernardino,31,2022-07-17,8033,8041,8036,5,54599,54656,54619,37,190,15,15,26,7933,7933,7918,7918
San Diego,31,2022-07-17,13194,13207,13203,4,80484,80567,80544,23,388,14,14,46,5449,5449,5435,5435
San Francisco,31,2022-07-17,2576,2577,2572,5,25657,25684,25636,48,111,10,10,25,965,965,955,955
San Joaquin,31,2022-07-17,2053,2053,2051,2,17943,17961,17943,18,66,3,3,14,2290,2290,2287,2287
San Luis Obispo,31,2022-07-17,562,562,562,0,4617,4622,4618,4,16,3,3,1,507,507,504,504
San Mateo,31,2022-07-17,2388,2388,2387,1,23617,23642,23627,15,45,1,1,2,738,738,737,737
Santa Barbara,31,2022-07-17,1262,1262,1261,1,9257,9268,9260,8,43,2,2,6,711,711,709,709
Santa Clara,31,2022-07-17,6268,6275,6273,2,54734,54791,54775,16,195,10,10,34,2430,2430,2420,2420
Santa Cruz,31,2022-07-17,868,868,867,1,7676,7683,7677,6,22,1,1,3,268,268,267,267
Shasta,31,2022-07-17,334,334,334,0,3199,3202,3199,3,37,3,3,4,581,581,578,578
Siskiyou,31,2022-07-17,31,31,31,0,324,325,324,1,1,0,0,0,86,86,86,86
Solano,31,2022-07-17,1297,1297,1296,1,9673,9683,9675,8,47,1,1,6,455,455,454,454
Sonoma,31,2022-07-17,1064,1064,1063,1,8864,8873,8866,7,40,0,0,5,507,507,507,507
Stanislaus,31,2022-07-17,1369,1369,1367,2,8108,8116,8105,11,111,4,4,8,1728,1728,1724,1724
Sutter,31,2022-07-17,249,249,249,0,1665,1666,1665,1,0,0,0,0,228,228,228,228
Tehama,31,2022-07-17,113,113,113,0,903,903,902,1,5,1,1,1,211,211,210,210
Trinity,31,2022-07-17,23,23,23,0,108,109,108,1,1,0,0,0,20,20,20,20
Tulare,31,2022-07-17,1222,1222,1220,2,8446,8454,8442,12,40,1,1,1,1520,1520,1519,1519
Tuolumne,31,2022-07-17,243,243,243,0,1155,1155,1154,1,5,4,4,0,195,195,191,191
Ventura,31,2022-07-17,2343,2343,2342,1,19088,19109,19098,11,81,5,5,6,1541,1541,1536,1536
Yolo,31,2022-07-17,432,432,432,0,4639,4644,4640,4,4,3,3,1,376,376,373,373
Yuba,31,2022-07-17,212,212,212,0,1260,1260,1259,1,15,0,0,0,129,129,129,129
Alameda,32,2022-07-24,4512,4517,4515,2,41360,41406,41384,22,138,9,9,20,1944,1944,1935,1935
Amador,32,2022-07-24,77,77,77,0,1300,1300,1299,1,3,0,0,1,87,87,87,87
Butte,32,2022-07-24,355,355,355,0,2983,2986,2985,1,28,1,1,2,453,453,452,452
Calaveras,32,2022-07-24,81,81,81,0,553,554,553,1,1,2,2,0,131,131,129,129
Colusa,32,2022-07-24,26,26,26,0,374,375,374,1,1,0,0,0,22,22,22,22
Contra Costa,32,2022-07-24,2857,2859,2856,3,22439,22465,22445,20,91,7,7,17,1401,1401,1394,1394
Del Norte,32,2022-07-24,75,75,75,0,578,579,578,1,7,0,0,0,53,53,53,53
El Dorado,32,2022-07-24,272,272,272,0,2490,2492,2490,2,9,1,1,0,229,229,228,228
Fresno,32,2022-07-24,3405,3410,3407,3,20401,20424,20407,17,203,7,7,28,2820,2820,2813,2813
Glenn,32,2022-07-24,31,31,31,0,269,270,269,1,1,0,0,0,56,56,56,56
Humboldt,32,2022-07-24,253,253,253,0,2007,2007,2006,1,14,2,2,4,156,156,154,154
Imperial,32,2022-07-24,906,906,905,1,4355,4360,4357,3,20,1,1,1,952,952,951,951
Inyo,32,2022-07-24,24,24,24,0,309,310,309,1,1,0,0,0,57,57,57,57
Kern,32,2022-07-24,2057,2058,2057,1,16012,16030,16020,10,77,3,3,13,2384,2384,2381,2381
Kings,32,2022-07-24,585,585,585,0,3953,3958,3955,3,14,2,2,0,458,458,456,456
Lake,32,2022-07-24,134,134,134,0,995,995,994,1,4,0,0,2,142,142,142,142
Lassen,32,2022-07-24,52,52,52,0,1097,1097,1096,1,0,0,0,0,63,63,63,63
Los Angeles,32,2022-07-24,37958,37999,37991,8,340325,340700,340629,71,1111,114,114,124,32689,32689,32575,32575
Madera,32,2022-07-24,550,550,550,0,3780,3785,3782,3,11,1,1,4,372,372,371,371
Marin,32,2022-07-24,517,517,517,0,5572,5578,5573,5,18,2,2,3,251,251,249,249
Mariposa,32,2022-07-24,44,44,44,0,231,232,231,1,0,0,0,0,29,29,29,29
Mendocino,32,2022-07-24,186,186,186,0,1378,1378,1376,2,7,0,0,1,133,133,133,133
Merced,32,2022-07-24,708,708,708,0,3855,3860,3858,2,18,2,2,2,843,843,841,841
Modoc,32,2022-07-24,8,8,8,0,29,30,29,1,0,1,1,0,11,11,10,10
Mono,32,2022-07-24,16,16,16,0,92,93,92,1,0,0,0,0,7,7,7,7
Monterey,32,2022-07-24,948,948,947,1,7144,7152,7142,10,38,1,1,4,758,758,757,757
Napa,32,2022-07-24,303,303,303,0,2901,2905,2903,2,5,5,5,0,155,155,150,150
Nevada,32,2022-07-24,124,124,124,0,1360,1360,1359,1,8,1,1,0,135,135,134,134
Orange,32,2022-07-24,8294,8303,8299,4,58761,58826,58797,29,271,33,33,37,7320,7320,7287,7287
Placer,32,2022-07-24,570,570,569,1,4994,4999,4994,5,78,3,3,10,649,649,646,646
Plumas,32,2022-07-24,39,39,39,0,212,213,212,1,0,0,0,0,13,13,13,13
Riverside,32,2022-07-24,7680,7688,7683,5,46774,46825,46794,31,242,16,16,19,6560,6560,6544,6544
Sacramento,32,2022-07-24,3616,3621,3618,3,29863,29896,29875,21,194,17,17,27,3220,3220,3203,3203
San Benito,32,2022-07-24,203,203,203,0,1841,1842,1841,1,1,1,1,1,98,98,97,97
San Bernardino,32,2022-07-24,7148,7156,7152,4,52109,52166,52138,28,196,25,25,23,7958,7958,7933,7933
San Diego,32,2022-07-24,12195,12209,12206,3,76688,76772,76755,17,397,19,19,43,5468,5468,5449,5449
San Francisco,32,2022-07-24,2306,2307,2304,3,24593,24620,24584,36,120,8,8,26,973,973,965,965
San Joaquin,32,2022-07-24,1854,1854,1853,1,17050,17069,17056,13,74,4,4,9,2294,2294,2290,2290
San Luis Obispo,32,2022-07-24,510,510,510,0,4419,4424,4421,3,15,4,4,1,511,511,507,507
San Mateo,32,2022-07-24,2059,2059,2058,1,21811,21834,21823,11,51,1,1,9,739,739,738,738
Santa Barbara,32,2022-07-24,1220,1220,1219,1,9028,9039,9033,6,39,3,3,3,714,714,711,711
Santa Clara,32,2022-07-24,5870,5877,5876,1,51918,51974,51962,12,234,18,18,25,2448,2448,2430,2430
Santa Cruz,32,2022-07-24,857,857,857,0,7774,7782,7778,4,26,0,0,0,268,268,268,268
Shasta,32,2022-07-24,294,294,294,0,3135,3138,3136,2,38,1,1,6,582,582,581,581
Siskiyou,32,2022-07-24,38,38,38,0,367,368,367,1,2,0,0,0,86,86,86,86
Solano,32,2022-07-24,1188,1188,1187,1,9627,9638,9632,6,56,0,0,6,455,455,455,455
Sonoma,32,2022-07-24,1057,1057,1056,1,8623,8633,8627,6,45,0,0,4,507,507,507,507
Stanislaus,32,2022-07-24,1351,1351,1350,1,8078,8087,8079,8,102,8,8,11,1736,1736,1728,1728
Sutter,32,2022-07-24,224,224,224,0,1709,1710,1709,1,0,0,0,0,228,228,228,228
Tehama,32,2022-07-24,115,115,115,0,898,898,897,1,6,1,1,0,212,212,211,211
Trinity,32,2022-07-24,14,14,14,0,98,99,98,1,0,0,0,0,20,20,20,20
Tulare,32,2022-07-24,1182,1182,1181,1,8052,8060,8051,9,37,1,1,1,1521,1521,1520,1520
Tuolumne,32,2022-07-24,199,199,199,0,1160,1160,1159,1,5,1,1,0,196,196,195,195
Ventura,32,2022-07-24,2203,2203,2202,1,18817,18836,18827,9,70,5,5,7,1546,1546,1541,1541
Yolo,32,2022-07-24,414,414,414,0,4546,4551,4548,3,5,3,3,2,379,379,376,376
Yuba,32,2022-07-24,188,188,188,0,1328,1328,1327,1,13,0,0,1,129,129,129,129
Alameda,33,2022-07-31,3890,3895,3893,2,37672,37716,37700,16,174,9,9,20,1953,1953,1944,1944
Amador,33,2022-07-31,62,62,62,0,1146,1146,1145,1,4,1,1,0,88,88,87,87
Butte,33,2022-07-31,357,357,357,0,2775,2778,2777,1,34,1,1,1,454,454,453,453
Calaveras,33,2022-07-31,73,73,73,0,562,563,562,1,1,1,1,2,132,132,131,131
Colusa,33,2022-07-31,28,28,28,0,375,376,375,1,5,0,0,0,22,22,22,22
Contra Costa,33,2022-07-31,2683,2686,2684,2,21320,21346,21331,15,92,12,12,19,1413,1413,1401,1401
Del Norte,33,2022-07-31,60,60,60,0,478,479,478,1,4,0,0,2,53,53,53,53
El Dorado,33,2022-07-31,251,251,251,0,2486,2488,2487,1,3,3,3,2,232,232,229,229
Fresno,33,2022-07-31,3096,3100,3098,2,18969,18991,18979,12,217,9,9,18,2829,2829,2820,2820
Glenn,33,2022-07-31,31,31,31,0,249,250,249,1,0,0,0,0,56,56,56,56
Humboldt,33,2022-07-31,217,217,217,0,1873,1873,1872,1,9,0,0,4,156,156,156,156
Imperial,33,2022-07-31,692,692,692,0,3697,3702,3700,2,23,3,3,4,955,955,952,952
Inyo,33,2022-07-31,19,19,19,0,287,288,287,1,2,1,1,0,58,58,57,57
Kern,33,2022-07-31,1789,1789,1788,1,14925,14943,14936,7,78,6,6,12,2390,2390,2384,2384
Kings,33,2022-07-31,622,622,622,0,4005,4010,4008,2,7,0,0,1,458,458,458,458
Lake,33,2022-07-31,135,135,135,0,1039,1039,1038,1,5,1,1,1,143,143,142,142
Lassen,33,2022-07-31,50,50,50,0,913,914,913,1,1,0,0,0,63,63,63,63
Los Angeles,33,2022-07-31,31843,31880,31875,5,312698,313065,313014,51,1071,132,132,129,32821,32821,32689,32689
Madera,33,2022-07-31,474,474,474,0,3552,3556,3554,2,9,0,0,5,372,372,372,372
Marin,33,2022-07-31,409,409,409,0,5203,5209,5206,3,32,0,0,3,251,251,251,251
Mariposa,33,2022-07-31,19,19,19,0,208,209,208,1,0,0,0,0,29,29,29,29
Mendocino,33,2022-07-31,205,205,205,0,1367,1367,1366,1,4,1,1,0,134,134,133,133
Merced,33,2022-07-31,673,673,673,0,3698,3703,3701,2,23,6,6,3,849,849,843,843
Modoc,33,2022-07-31,12,12,12,0,31,32,31,1,0,0,0,0,11,11,11,11
Mono,33,2022-07-31,9,9,9,0,78,79,78,1,0,0,0,0,7,7,7,7
Monterey,33,2022-07-31,948,948,947,1,6723,6731,6724,7,39,1,1,2,759,759,758,758
Napa,33,2022-07-31,274,274,274,0,2871,2875,2874,1,14,0,0,0,155,155,155,155
Nevada,33,2022-07-31,106,106,106,0,1370,1370,1369,1,10,0,0,0,135,135,135,135
Orange,33,2022-07-31,6867,6875,6872,3,53590,53654,53634,20,253,38,38,43,7358,7358,7320,7320
Placer,33,2022-07-31,610,610,610,0,4919,4924,4920,4,75,3,3,9,652,652,649,649
Plumas,33,2022-07-31,18,18,18,0,178,179,178,1,0,0,0,0,13,13,13,13
Riverside,33,2022-07-31,6341,6348,6345,3,42846,42895,42873,22,204,5,5,20,6565,6565,6560,6560
Sacramento,33,2022-07-31,3183,3187,3185,2,28683,28717,28701,16,161,18,18,26,3238,3238,3220,3220
San Benito,33,2022-07-31,168,168,168,0,1462,1462,1461,1,2,2,2,0,100,100,98,98
San Bernardino,33,2022-07-31,6306,6314,6311,3,49939,49997,49976,21,183,29,29,24,7987,7987,7958,7958
San Diego,33,2022-07-31,9828,9840,9838,2,70087,70169,70157,12,377,22,22,48,5490,5490,5468,5468
San Francisco,33,2022-07-31,1873,1874,1872,2,22319,22346,22321,25,100,13,13,21,986,986,973,973
San Joaquin,33,2022-07-31,1735,1735,1734,1,15860,15879,15869,10,74,6,6,15,2300,2300,2294,2294
San Luis Obispo,33,2022-07-31,577,577,577,0,4118,4123,4121,2,14,3,3,0,514,514,511,511
San Mateo,33,2022-07-31,1868,1868,1867,1,20733,20758,20750,8,66,1,1,4,740,740,739,739
Santa Barbara,33,2022-07-31,1114,1114,1113,1,7829,7839,7835,4,30,2,2,3,716,716,714,714
Santa Clara,33,2022-07-31,5012,5019,5018,1,46768,46822,46813,9,219,16,16,42,2464,2464,2448,2448
Santa Cruz,33,2022-07-31,752,752,752,0,7121,7129,7126,3,17,1,1,0,269,269,268,268
Shasta,33,2022-07-31,261,261,261,0,2981,2984,2982,2,41,2,2,8,584,584,582,582
Siskiyou,33,2022-07-31,23,23,23,0,286,287,286,1,1,0,0,0,86,86,86,86
Solano,33,2022-07-31,1163,1163,1162,1,9211,9222,9217,5,45,0,0,5,455,455,455,455
Sonoma,33,2022-07-31,970,970,970,0,8351,8361,8357,4,47,5,5,3,512,512,507,507
Stanislaus,33,2022-07-31,1288,1288,1287,1,7785,7795,7789,6,116,7,7,10,1743,1743,1736,1736
Sutter,33,2022-07-31,239,239,239,0,1657,1658,1657,1,0,3,3,0,231,231,228,228
Tehama,33,2022-07-31,94,94,94,0,795,795,794,1,2,2,2,0,214,214,212,212
Trinity,33,2022-07-31,10,10,10,0,80,81,80,1,0,1,1,0,21,21,20,20
Tulare,33,2022-07-31,1030,1030,1029,1,7559,7567,7561,6,39,1,1,2,1522,1522,1521,1521
Tuolumne,33,2022-07-31,154,154,154,0,1091,1091,1090,1,5,0,0,0,196,196,196,196
Ventura,33,2022-07-31,1897,1897,1896,1,17193,17212,17206,6,76,9,9,6,1555,1555,1546,1546
Yolo,33,2022-07-31,348,348,348,0,4150,4155,4153,2,4,3,3,1,382,382,379,379
Yuba,33,2022-07-31,155,155,155,0,1203,1203,1202,1,9,0,0,0,129,129,129,129
Alameda,34,2022-08-07,3494,3499,3498,1,35836,35880,35869,11,128,9,9,21,1962,1962,1953,1953
Amador,34,2022-08-07,56,56,56,0,877,878,877,1,3,0,0,0,88,88,88,88
Butte,34,2022-08-07,338,338,338,0,2599,2602,2601,1,28,2,2,1,456,456,454,454
Calaveras,34,2022-08-07,56,56,56,0,565,566,565,1,1,1,1,0,133,133,132,132
Colusa,34,2022-08-07,15,15,15,0,350,351,350,1,2,0,0,0,22,22,22,22
Contra Costa,34,2022-08-07,2262,2263,2262,1,20077,20102,20091,11,96,5,5,16,1418,1418,1413,1413
Del Norte,34,2022-08-07,49,49,49,0,501,502,501,1,5,0,0,0,53,53,53,53
El Dorado,34,2022-08-07,178,178,178,0,2286,2288,2287,1,7,0,0,0,232,232,232,232
Fresno,34,2022-08-07,2551,2555,2554,1,17296,17317,17308,9,207,7,7,25,2836,2836,2829,2829
Glenn,34,2022-08-07,23,23,23,0,252,253,252,1,2,0,0,0,56,56,56,56
Humboldt,34,2022-08-07,209,209,209,0,1965,1965,1964,1,9,1,1,3,157,157,156,156
Imperial,34,2022-08-07,569,569,569,0,3342,3347,3345,2,19,3,3,3,958,958,955,955
Inyo,34,2022-08-07,13,13,13,0,257,258,257,1,0,0,0,1,58,58,58,58
Kern,34,2022-08-07,1422,1422,1421,1,14480,14499,14494,5,63,6,6,15,2396,2396,2390,2390
Kings,34,2022-08-07,496,496,496,0,3477,3482,3480,2,9,0,0,3,458,458,458,458
Lake,34,2022-08-07,108,108,108,0,925,926,925,1,2,0,0,1,143,143,143,143
Lassen,34,2022-08-07,156,156,156,0,1096,1098,1097,1,0,1,1,0,64,64,63,63
Los Angeles,34,2022-08-07,26579,26612,26609,3,293591,293949,293912,37,975,132,132,122,32953,32953,32821,32821
Madera,34,2022-08-07,411,411,411,0,3131,3135,3133,2,18,0,0,5,372,372,372,372
Marin,34,2022-08-07,376,376,376,0,4593,4598,4596,2,25,3,3,3,254,254,251,251
Mariposa,34,2022-08-07,31,31,31,0,211,212,211,1,0,0,0,0,29,29,29,29
Mendocino,34,2022-08-07,131,131,131,0,1130,1130,1129,1,1,1,1,1,135,135,134,134
Merced,34,2022-08-07,540,540,540,0,3453,3458,3457,1,16,0,0,6,849,849,849,849
Modoc,34,2022-08-07,5,5,5,0,28,29,28,1,0,0,0,0,11,11,11,11
Mono,34,2022-08-07,8,8,8,0,67,68,67,1,1,0,0,0,7,7,7,7
Monterey,34,2022-08-07,764,764,763,1,5856,5862,5857,5,34,2,2,0,761,761,759,759
Napa,34,2022-08-07,285,285,285,0,2683,2687,2686,1,6,2,2,1,157,157,155,155
Nevada,34,2022-08-07,108,108,108,0,1330,1330,1329,1,6,0,0,0,135,135,135,135
Orange,34,2022-08-07,5578,5585,5583,2,49568,49628,49613,15,231,28,28,43,7386,7386,7358,7358
Placer,34,2022-08-07,526,526,526,0,4533,4539,4536,3,66,2,2,8,654,654,652,652
Plumas,34,2022-08-07,28,28,28,0,183,184,183,1,1,0,0,0,13,13,13,13
Riverside,34,2022-08-07,5717,5724,5722,2,40932,40982,40966,16,188,11,11,16,6576,6576,6565,6565
Sacramento,34,2022-08-07,2739,2744,2743,1,26910,26942,26930,12,179,20,20,24,3258,3258,3238,3238
San Benito,34,2022-08-07,192,192,192,0,1432,1432,1431,1,1,0,0,0,100,100,100,100
San Bernardino,34,2022-08-07,5363,5370,5368,2,46270,46326,46311,15,204,17,17,15,8004,8004,7987,7987
San Diego,34,2022-08-07,7611,7620,7619,1,65870,65950,65941,9,329,10,10,33,5500,5500,5490,5490
San Francisco,34,2022-08-07,1611,1611,1610,1,20646,20670,20652,18,89,13,13,22,999,999,986,986
San Joaquin,34,2022-08-07,1577,1577,1576,1,15921,15940,15932,8,61,8,8,7,2308,2308,2300,2300
San Luis Obispo,34,2022-08-07,559,559,559,0,3704,3709,3708,1,15,0,0,0,514,514,514,514
San Mateo,34,2022-08-07,1525,1525,1525,0,18654,18676,18670,6,56,0,0,3,740,740,740,740
Santa Barbara,34,2022-08-07,1007,1007,1007,0,7564,7574,7571,3,36,2,2,1,718,718,716,716
Santa Clara,34,2022-08-07,4244,4251,4250,1,41590,41641,41635,6,206,23,23,37,2487,2487,2464,2464
Santa Cruz,34,2022-08-07,665,665,665,0,6052,6059,6057,2,24,1,1,0,270,270,269,269
Shasta,34,2022-08-07,200,200,200,0,2899,2902,2901,1,32,3,3,3,587,587,584,584
Siskiyou,34,2022-08-07,35,35,35,0,283,284,283,1,0,1,1,0,87,87,86,86
Solano,34,2022-08-07,924,924,924,0,8041,8051,8048,3,52,0,0,10,455,455,455,455
Sonoma,34,2022-08-07,875,875,875,0,7788,7798,7795,3,40,4,4,2,516,516,512,512
Stanislaus,34,2022-08-07,1078,1078,1077,1,7268,7277,7272,5,92,7,7,11,1750,1750,1743,1743
Sutter,34,2022-08-07,231,231,231,0,1572,1573,1572,1,0,0,0,0,231,231,231,231
Tehama,34,2022-08-07,75,75,75,0,679,680,679,1,4,0,0,0,214,214,214,214
Trinity,34,2022-08-07,5,5,5,0,72,73,72,1,0,0,0,0,21,21,21,21
Tulare,34,2022-08-07,923,923,922,1,7425,7433,7428,5,41,5,5,3,1527,1527,1522,1522
Tuolumne,34,2022-08-07,125,125,125,0,1124,1124,1123,1,5,2,2,0,198,198,196,196
Ventura,34,2022-08-07,1563,1563,1563,0,16054,16072,16068,4,67,6,6,7,1561,1561,1555,1555
Yolo,34,2022-08-07,298,298,298,0,3836,3841,3840,1,6,1,1,1,383,383,382,382
Yuba,34,2022-08-07,148,148,148,0,1127,1128,1127,1,5,1,1,0,130,130,129,129
Alameda,35,2022-08-14,2691,2695,2694,1,34417,34460,34451,9,118,8,8,21,1970,1970,1962,1962
Amador,35,2022-08-14,45,45,45,0,812,813,812,1,3,0,0,0,88,88,88,88
Butte,35,2022-08-14,283,283,283,0,2347,2351,2350,1,18,0,0,2,456,456,456,456
Calaveras,35,2022-08-14,50,50,50,0,548,549,548,1,0,0,0,1,133,133,133,133
Colusa,35,2022-08-14,20,20,20,0,378,379,378,1,1,0,0,0,22,22,22,22
Contra Costa,35,2022-08-14,1896,1896,1895,1,19167,19191,19183,8,69,7,7,11,1425,1425,1418,1418
Del Norte,35,2022-08-14,55,55,55,0,494,495,494,1,3,1,1,1,54,54,53,53
El Dorado,35,2022-08-14,187,187,187,0,2297,2299,2298,1,6,0,0,3,232,232,232,232
Fresno,35,2022-08-14,1996,1997,1996,1,16740,16761,16754,7,165,10,10,17,2846,2846,2836,2836
Glenn,35,2022-08-14,14,14,14,0,238,239,238,1,2,0,0,0,56,56,56,56
Humboldt,35,2022-08-14,189,189,189,0,1609,1609,1608,1,12,0,0,2,157,157,157,157
Imperial,35,2022-08-14,382,382,382,0,3132,3137,3136,1,15,1,1,2,959,959,958,958
Inyo,35,2022-08-14,7,7,7,0,246,247,246,1,0,1,1,0,59,59,58,58
Kern,35,2022-08-14,1281,1281,1281,0,13760,13777,13773,4,69,8,8,11,2404,2404,2396,2396
Kings,35,2022-08-14,373,373,373,0,3237,3242,3241,1,8,1,1,1,459,459,458,458
Lake,35,2022-08-14,99,99,99,0,950,951,950,1,3,0,0,2,143,143,143,143
Lassen,35,2022-08-14,95,95,95,0,980,981,980,1,1,0,0,0,64,64,64,64
Los Angeles,35,2022-08-14,21844,21871,21869,2,292012,292379,292350,29,888,113,113,123,33066,33066,32953,32953
Madera,35,2022-08-14,300,300,300,0,2958,2962,2961,1,12,0,0,4,372,372,372,372
Marin,35,2022-08-14,305,305,305,0,4026,4031,4029,2,16,0,0,0,254,254,254,254
Mariposa,35,2022-08-14,16,16,16,0,194,195,194,1,0,0,0,0,29,29,29,29
Mendocino,35,2022-08-14,104,104,104,0,1012,1012,1011,1,6,0,0,2,135,135,135,135
Merced,35,2022-08-14,467,467,467,0,3369,3374,3373,1,11,3,3,3,852,852,849,849
Modoc,35,2022-08-14,4,4,4,0,19,20,19,1,0,0,0,0,11,11,11,11
Mono,35,2022-08-14,5,5,5,0,74,75,74,1,0,0,0,0,7,7,7,7
Monterey,35,2022-08-14,671,671,671,0,5788,5794,5790,4,36,0,0,0,761,761,761,761
Napa,35,2022-08-14,220,220,220,0,2378,2382,2381,1,12,0,0,0,157,157,157,157
Nevada,35,2022-08-14,102,102,102,0,1210,1211,1210,1,6,0,0,0,135,135,135,135
Orange,35,2022-08-14,4877,4884,4883,1,44864,44921,44911,10,261,34,34,38,7420,7420,7386,7386
Placer,35,2022-08-14,437,437,437,0,4474,4480,4478,2,62,2,2,11,656,656,654,654
Plumas,35,2022-08-14,16,16,16,0,176,177,176,1,0,0,0,0,13,13,13,13
Riverside,35,2022-08-14,4721,4728,4727,1,38137,38185,38173,12,141,17,17,18,6593,6593,6576,6576
Sacramento,35,2022-08-14,2364,2367,2366,1,25809,25841,25832,9,159,9,9,16,3267,3267,3258,3258
San Benito,35,2022-08-14,145,145,145,0,1346,1347,1346,1,2,1,1,1,101,101,100,100
San Bernardino,35,2022-08-14,4765,4772,4771,1,45063,45121,45110,11,147,18,18,24,8022,8022,8004,8004
San Diego,35,2022-08-14,5877,5885,5884,1,60468,60544,60538,6,281,14,14,34,5514,5514,5500,5500
San Francisco,35,2022-08-14,1334,1334,1333,1,19896,19920,19906,14,100,15,15,13,1014,1014,999,999
San Joaquin,35,2022-08-14,1451,1451,1450,1,15213,15231,15225,6,60,9,9,8,2317,2317,2308,2308
San Luis Obispo,35,2022-08-14,361,361,361,0,3344,3349,3348,1,15,4,4,2,518,518,514,514
San Mateo,35,2022-08-14,1278,1278,1278,0,17492,17513,17509,4,50,1,1,5,741,741,740,740
Santa Barbara,35,2022-08-14,881,881,881,0,7181,7190,7188,2,47,2,2,3,720,720,718,718
Santa Clara,35,2022-08-14,3535,3540,3540,0,39851,39902,39898,4,203,8,8,24,2495,2495,2487,2487
Santa Cruz,35,2022-08-14,509,509,509,0,6000,6007,6005,2,24,2,2,1,272,272,270,270
Shasta,35,2022-08-14,198,198,198,0,2750,2753,2752,1,17,1,1,0,588,588,587,587
Siskiyou,35,2022-08-14,15,15,15,0,289,290,289,1,0,0,0,3,87,87,87,87
Solano,35,2022-08-14,681,681,681,0,7481,7491,7489,2,46,0,0,7,455,455,455,455
Sonoma,35,2022-08-14,643,643,643,0,7297,7307,7305,2,37,2,2,2,518,518,516,516
Stanislaus,35,2022-08-14,951,951,951,0,7436,7447,7443,4,93,7,7,12,1757,1757,1750,1750
Sutter,35,2022-08-14,191,191,191,0,1561,1562,1561,1,0,1,1,0,232,232,231,231
Tehama,35,2022-08-14,64,64,64,0,615,616,615,1,2,0,0,0,214,214,214,214
Trinity,35,2022-08-14,9,9,9,0,58,59,58,1,0,0,0,0,21,21,21,21
Tulare,35,2022-08-14,736,736,736,0,6974,6982,6978,4,26,2,2,3,1529,1529,1527,1527
Tuolumne,35,2022-08-14,107,107,107,0,986,987,986,1,1,0,0,0,198,198,198,198
Ventura,35,2022-08-14,1486,1486,1486,0,15414,15432,15429,3,72,7,7,8,1568,1568,1561,1561
Yolo,35,2022-08-14,267,267,267,0,3723,3728,3727,1,3,4,4,0,387,387,383,383
Yuba,35,2022-08-14,125,125,125,0,1088,1089,1088,1,6,0,0,0,130,130,130,130
Alameda,36,2022-08-21,2300,2301,2301,0,32642,32684,32678,6,111,8,8,21,1978,1978,1970,1970
Amador,36,2022-08-21,51,51,51,0,852,853,852,1,1,1,1,0,89,89,88,88
Butte,36,2022-08-21,227,227,227,0,2094,2098,2097,1,16,1,1,2,457,457,456,456
Calaveras,36,2022-08-21,39,39,39,0,540,541,540,1,2,0,0,0,133,133,133,133
Colusa,36,2022-08-21,10,10,10,0,380,381,380,1,0,0,0,0,22,22,22,22
Contra Costa,36,2022-08-21,1515,1515,1515,0,18623,18647,18641,6,48,6,6,13,1431,1431,1425,1425
Del Norte,36,2022-08-21,35,35,35,0,480,481,480,1,2,1,1,1,55,55,54,54
El Dorado,36,2022-08-21,150,150,150,0,2269,2271,2270,1,7,0,0,0,232,232,232,232
Fresno,36,2022-08-21,1622,1622,1622,0,15821,15841,15836,5,151,4,4,16,2850,2850,2846,2846
Glenn,36,2022-08-21,22,22,22,0,223,224,223,1,1,0,0,0,56,56,56,56
Humboldt,36,2022-08-21,156,156,156,0,1678,1679,1678,1,4,1,1,4,158,158,157,157
Imperial,36,2022-08-21,297,297,297,0,2864,2869,2868,1,10,0,0,0,959,959,959,959
Inyo,36,2022-08-21,15,15,15,0,251,252,251,1,0,0,0,0,59,59,59,59
Kern,36,2022-08-21,994,994,994,0,13688,13706,13703,3,63,4,4,13,2408,2408,2404,2404
Kings,36,2022-08-21,354,354,354,0,3497,3502,3501,1,5,2,2,1,461,461,459,459
Lake,36,2022-08-21,99,99,99,0,958,959,958,1,2,1,1,1,144,144,143,143
Lassen,36,2022-08-21,50,50,50,0,877,878,877,1,0,0,0,0,64,64,64,64
Los Angeles,36,2022-08-21,18810,18834,18833,1,276658,277019,276998,21,801,120,120,108,33186,33186,33066,33066
Madera,36,2022-08-21,312,312,312,0,2726,2730,2729,1,16,2,2,4,374,374,372,372
Marin,36,2022-08-21,248,248,248,0,3979,3984,3983,1,16,0,0,3,254,254,254,254
Mariposa,36,2022-08-21,14,14,14,0,169,170,169,1,0,0,0,0,29,29,29,29
Mendocino,36,2022-08-21,111,111,111,0,1090,1091,1090,1,3,0,0,3,135,135,135,135
Merced,36,2022-08-21,468,468,468,0,3646,3651,3650,1,11,4,4,1,856,856,852,852
Modoc,36,2022-08-21,6,6,6,0,28,29,28,1,0,0,0,0,11,11,11,11
Mono,36,2022-08-21,6,6,6,0,61,62,61,1,0,0,0,0,7,7,7,7
Monterey,36,2022-08-21,569,569,569,0,5657,5663,5660,3,25,0,0,3,761,761,761,761
Napa,36,2022-08-21,142,142,142,0,2025,2027,2026,1,3,2,2,1,159,159,157,157
Nevada,36,2022-08-21,92,92,92,0,1204,1205,1204,1,4,0,0,1,135,135,135,135
Orange,36,2022-08-21,3995,4000,3999,1,41265,41320,41313,7,220,20,20,33,7440,7440,7420,7420
Placer,36,2022-08-21,386,386,386,0,4358,4364,4363,1,55,1,1,14,657,657,656,656
Plumas,36,2022-08-21,15,15,15,0,174,175,174,1,0,0,0,0,13,13,13,13
Riverside,36,2022-08-21,4399,4406,4405,1,37580,37630,37621,9,150,14,14,16,6607,6607,6593,6593
Sacramento,36,2022-08-21,2200,2202,2201,1,25144,25176,25169,7,137,17,17,24,3284,3284,3267,3267
San Benito,36,2022-08-21,101,101,101,0,1247,1248,1247,1,2,1,1,0,102,102,101,101
San Bernardino,36,2022-08-21,4707,4714,4713,1,44342,44399,44390,9,139,17,17,19,8039,8039,8022,8022
San Diego,36,2022-08-21,4823,4830,4830,0,57541,57615,57610,5,276,5,5,28,5519,5519,5514,5514
San Francisco,36,2022-08-21,1108,1108,1107,1,19143,19167,19157,10,86,14,14,12,1028,1028,1014,1014
San Joaquin,36,2022-08-21,1245,1245,1245,0,15664,15683,15678,5,54,0,0,8,2317,2317,2317,2317
San Luis Obispo,36,2022-08-21,269,269,269,0,3153,3158,3157,1,21,1,1,0,519,519,518,518
San Mateo,36,2022-08-21,1077,1077,1077,0,17313,17336,17333,3,39,0,0,2,741,741,741,741
Santa Barbara,36,2022-08-21,745,745,745,0,7322,7333,7331,2,42,1,1,4,721,721,720,720
Santa Clara,36,2022-08-21,3120,3125,3125,0,40338,40391,40388,3,178,11,11,23,2506,2506,2495,2495
Santa Cruz,36,2022-08-21,493,493,493,0,11464,11479,11477,2,15,1,1,2,273,273,272,272
Shasta,36,2022-08-21,179,179,179,0,2757,2760,2759,1,3,2,2,0,590,590,588,588
Siskiyou,36,2022-08-21,30,30,30,0,262,263,262,1,1,0,0,0,87,87,87,87
Solano,36,2022-08-21,589,589,589,0,7226,7236,7234,2,32,0,0,9,455,455,455,455
Sonoma,36,2022-08-21,606,606,606,0,7274,7285,7283,2,36,2,2,4,520,520,518,518
Stanislaus,36,2022-08-21,911,911,911,0,7628,7639,7636,3,83,7,7,14,1764,1764,1757,1757
Sutter,36,2022-08-21,198,198,198,0,1657,1659,1658,1,0,0,0,0,232,232,232,232
Tehama,36,2022-08-21,49,49,49,0,636,637,636,1,1,0,0,0,214,214,214,214
Trinity,36,2022-08-21,9,9,9,0,63,64,63,1,0,0,0,0,21,21,21,21
Tulare,36,2022-08-21,758,758,758,0,7233,7242,7239,3,31,4,4,1,1533,1533,1529,1529
Tuolumne,36,2022-08-21,109,109,109,0,1023,1024,1023,1,1,0,0,0,198,198,198,198
Ventura,36,2022-08-21,1352,1352,1352,0,14915,14933,14931,2,64,5,5,6,1573,1573,1568,1568
Yolo,36,2022-08-21,207,207,207,0,3441,3446,3445,1,7,1,1,0,388,388,387,387
Yuba,36,2022-08-21,126,126,126,0,1089,1090,1089,1,12,0,0,3,130,130,130,130
Alameda,37,2022-08-28,2103,2104,2104,0,34203,34249,34244,5,101,12,12,22,1990,1990,1978,1978
Amador,37,2022-08-28,46,46,46,0,792,793,792,1,4,1,1,0,90,90,89,89
Butte,37,2022-08-28,231,231,231,0,2145,2149,2148,1,22,0,0,2,457,457,457,457
Calaveras,37,2022-08-28,64,64,64,0,606,607,606,1,1,0,0,0,133,133,133,133
Colusa,37,2022-08-28,14,14,14,0,376,377,376,1,0,0,0,0,22,22,22,22
Contra Costa,37,2022-08-28,1426,1426,1426,0,18824,18849,18844,5,48,5,5,7,1436,1436,1431,1431
Del Norte,37,2022-08-28,29,29,29,0,450,451,450,1,3,0,0,2,55,55,55,55
El Dorado,37,2022-08-28,145,145,145,0,2003,2005,2004,1,6,1,1,1,233,233,232,232
Fresno,37,2022-08-28,1447,1447,1447,0,15784,15805,15801,4,162,4,4,15,2854,2854,2850,2850
Glenn,37,2022-08-28,23,23,23,0,227,228,227,1,0,0,0,0,56,56,56,56
Humboldt,37,2022-08-28,123,123,123,0,1689,1690,1689,1,6,0,0,0,158,158,158,158
Imperial,37,2022-08-28,302,302,302,0,2899,2904,2903,1,0,1,1,0,960,960,959,959
Inyo,37,2022-08-28,7,7,7,0,187,188,187,1,0,0,0,0,59,59,59,59
Kern,37,2022-08-28,960,960,960,0,13701,13719,13717,2,57,2,2,9,2410,2410,2408,2408
Kings,37,2022-08-28,328,328,328,0,3645,3650,3649,1,5,0,0,0,461,461,461,461
Lake,37,2022-08-28,105,105,105,0,898,899,898,1,0,1,1,0,145,145,144,144
Lassen,37,2022-08-28,23,23,23,0,784,785,784,1,0,0,0,0,64,64,64,64
Los Angeles,37,2022-08-28,16133,16155,16154,1,277169,277539,277522,17,703,95,95,77,33281,33281,33186,33186
Madera,37,2022-08-28,302,302,302,0,2905,2909,2908,1,15,0,0,4,374,374,374,374
Marin,37,2022-08-28,232,232,232,0,3931,3936,3935,1,15,2,2,1,256,256,254,254
Mariposa,37,2022-08-28,21,21,21,0,183,184,183,1,0,0,0,0,29,29,29,29
Mendocino,37,2022-08-28,103,103,103,0,994,995,994,1,2,0,0,2,135,135,135,135
Merced,37,2022-08-28,410,410,410,0,3562,3567,3566,1,9,3,3,1,859,859,856,856
Modoc,37,2022-08-28,2,2,2,0,28,29,28,1,0,0,0,0,11,11,11,11
Mono,37,2022-08-28,1,1,1,0,52,53,52,1,0,0,0,0,7,7,7,7
Monterey,37,2022-08-28,433,433,433,0,5612,5618,5616,2,30,3,3,3,764,764,761,761
Napa,37,2022-08-28,123,123,123,0,2098,2102,2101,1,7,0,0,2,159,159,159,159
Nevada,37,2022-08-28,105,105,105,0,1140,1141,1140,1,7,0,0,1,135,135,135,135
Orange,37,2022-08-28,3251,3256,3256,0,40547,40601,40595,6,199,19,19,26,7459,7459,7440,7440
Placer,37,2022-08-28,386,386,386,0,4213,4219,4218,1,60,1,1,10,658,658,657,657
Plumas,37,2022-08-28,22,22,22,0,175,176,175,1,0,0,0,0,13,13,13,13
Riverside,37,2022-08-28,3880,3885,3884,1,37428,37478,37471,7,105,8,8,13,6615,6615,6607,6607
Sacramento,37,2022-08-28,1923,1923,1923,0,24822,24855,24850,5,138,11,11,19,3295,3295,3284,3284
San Benito,37,2022-08-28,130,130,130,0,1431,1432,1431,1,2,0,0,0,102,102,102,102
San Bernardino,37,2022-08-28,3938,3943,3942,1,43170,43229,43222,7,146,16,16,15,8055,8055,8039,8039
San Diego,37,2022-08-28,4028,4034,4034,0,57252,57328,57324,4,220,11,11,27,5530,5530,5519,5519
San Francisco,37,2022-08-28,923,923,923,0,19060,19085,19077,8,40,8,8,8,1036,1036,1028,1028
San Joaquin,37,2022-08-28,1017,1017,1017,0,14551,14568,14565,3,26,5,5,11,2322,2322,2317,2317
San Luis Obispo,37,2022-08-28,329,329,329,0,3229,3234,3233,1,16,1,1,0,520,520,519,519
San Mateo,37,2022-08-28,877,877,877,0,16988,17011,17009,2,27,0,0,3,741,741,741,741
Santa Barbara,37,2022-08-28,634,634,634,0,7577,7588,7587,1,21,1,1,4,722,722,721,721
Santa Clara,37,2022-08-28,2485,2488,2488,0,39931,39986,39983,3,123,5,5,21,2511,2511,2506,2506
Santa Cruz,37,2022-08-28,398,398,398,0,12021,12038,12036,2,16,0,0,0,273,273,273,273
Shasta,37,2022-08-28,136,136,136,0,2682,2685,2684,1,15,1,1,1,591,591,590,590
Siskiyou,37,2022-08-28,19,19,19,0,251,252,251,1,0,2,2,0,89,89,87,87
Solano,37,2022-08-28,538,538,538,0,7296,7306,7305,1,38,1,1,9,456,456,455,455
Sonoma,37,2022-08-28,511,511,511,0,7131,7140,7139,1,33,1,1,3,521,521,520,520
Stanislaus,37,2022-08-28,864,864,864,0,8117,8128,8126,2,75,5,5,3,1769,1769,1764,1764
Sutter,37,2022-08-28,176,176,176,0,1635,1637,1636,1,0,0,0,0,232,232,232,232
Tehama,37,2022-08-28,59,59,59,0,733,734,733,1,5,0,0,0,214,214,214,214
Trinity,37,2022-08-28,11,11,11,0,58,59,58,1,0,0,0,0,21,21,21,21
Tulare,37,2022-08-28,697,697,697,0,7342,7350,7348,2,36,1,1,1,1534,1534,1533,1533
Tuolumne,37,2022-08-28,102,102,102,0,864,865,864,1,2,1,1,0,199,199,198,198
Ventura,37,2022-08-28,1056,1056,1056,0,14814,14832,14830,2,48,5,5,3,1578,1578,1573,1573
Yolo,37,2022-08-28,193,193,193,0,3762,3767,3766,1,3,0,0,3,388,388,388,388
Yuba,37,2022-08-28,139,139,139,0,1144,1145,1144,1,17,0,0,1,130,130,130,130
Alameda,38,2022-09-04,1654,1654,1654,0,33079,33125,33121,4,92,3,3,17,1993,1993,1990,1990
Amador,38,2022-09-04,47,47,47,0,825,826,825,1,3,0,0,2,90,90,90,90
Butte,38,2022-09-04,222,222,222,0,2411,2416,2415,1,17,2,2,1,459,459,457,457
Calaveras,38,2022-09-04,28,28,28,0,524,525,524,1,0,0,0,0,133,133,133,133
Colusa,38,2022-09-04,10,10,10,0,268,269,268,1,2,0,0,0,22,22,22,22
Contra Costa,38,2022-09-04,1071,1071,1071,0,17857,17882,17878,4,56,5,5,11,1441,1441,1436,1436
Del Norte,38,2022-09-04,13,13,13,0,377,378,377,1,2,0,0,1,55,55,55,55
El Dorado,38,2022-09-04,105,105,105,0,1844,1847,1846,1,2,0,0,1,233,233,233,233
Fresno,38,2022-09-04,1230,1230,1230,0,15017,15038,15035,3,167,10,10,12,2864,2864,2854,2854
Glenn,38,2022-09-04,13,13,13,0,203,204,203,1,1,0,0,0,56,56,56,56
Humboldt,38,2022-09-04,125,125,125,0,1497,1498,1497,1,12,0,0,2,158,158,158,158
Imperial,38,2022-09-04,261,261,261,0,2915,2921,2920,1,9,1,1,0,961,961,960,960
Inyo,38,2022-09-04,11,11,11,0,164,165,164,1,0,0,0,0,59,59,59,59
Kern,38,2022-09-04,794,794,794,0,13029,13047,13045,2,52,4,4,9,2414,2414,2410,2410
Kings,38,2022-09-04,272,272,272,0,3236,3241,3240,1,5,0,0,0,461,461,461,461
Lake,38,2022-09-04,67,67,67,0,792,793,792,1,3,3,3,0,148,148,145,145
Lassen,38,2022-09-04,28,28,28,0,754,755,754,1,0,0,0,0,64,64,64,64
Los Angeles,38,2022-09-04,12458,12475,12474,1,262868,263229,263217,12,668,89,89,95,33370,33370,33281,33281
Madera,38,2022-09-04,242,242,242,0,3023,3028,3027,1,11,0,0,5,374,374,374,374
Marin,38,2022-09-04,196,196,196,0,3785,3791,3790,1,11,0,0,1,256,256,256,256
Mariposa,38,2022-09-04,21,21,21,0,183,184,183,1,0,0,0,0,29,29,29,29
Mendocino,38,2022-09-04,67,67,67,0,977,978,977,1,2,1,1,2,136,136,135,135
Merced,38,2022-09-04,302,302,302,0,3158,3164,3163,1,11,1,1,1,860,860,859,859
Modoc,38,2022-09-04,3,3,3,0,23,24,23,1,0,0,0,0,11,11,11,11
Mono,38,2022-09-04,5,5,5,0,53,54,53,1,0,0,0,0,7,7,7,7
Monterey,38,2022-09-04,277,277,277,0,5130,5136,5134,2,18,3,3,1,767,767,764,764
Napa,38,2022-09-04,123,123,123,0,2136,2140,2139,1,3,1,1,2,160,160,159,159
Nevada,38,2022-09-04,94,94,94,0,1170,1172,1171,1,3,0,0,0,135,135,135,135
Orange,38,2022-09-04,2561,2565,2565,0,37727,37779,37775,4,172,13,13,37,7472,7472,7459,7459
Placer,38,2022-09-04,249,249,249,0,3938,3944,3943,1,42,0,0,7,658,658,658,658
Plumas,38,2022-09-04,9,9,9,0,157,158,157,1,0,0,0,0,13,13,13,13
Riverside,38,2022-09-04,2875,2879,2879,0,34295,34341,34336,5,81,8,8,8,6623,6623,6615,6615
Sacramento,38,2022-09-04,1496,1496,1496,0,22998,23030,23026,4,133,13,13,22,3308,3308,3295,3295
San Benito,38,2022-09-04,73,73,73,0,1337,1338,1337,1,0,0,0,2,102,102,102,102
San Bernardino,38,2022-09-04,2824,2828,2828,0,40147,40203,40198,5,121,15,15,18,8070,8070,8055,8055
San Diego,38,2022-09-04,3322,3327,3327,0,55626,55701,55698,3,211,16,16,27,5546,5546,5530,5530
San Francisco,38,2022-09-04,754,754,754,0,18100,18124,18118,6,50,9,9,11,1045,1045,1036,1036
San Joaquin,38,2022-09-04,942,942,942,0,13706,13724,13722,2,43,5,5,10,2327,2327,2322,2322
San Luis Obispo,38,2022-09-04,215,215,215,0,3132,3138,3137,1,8,4,4,0,524,524,520,520
San Mateo,38,2022-09-04,724,724,724,0,16101,16123,16121,2,21,1,1,3,742,742,741,741
Santa Barbara,38,2022-09-04,568,568,568,0,7579,7590,7589,1,37,2,2,3,724,724,722,722
Santa Clara,38,2022-09-04,2139,2141,2141,0,38671,38725,38723,2,117,11,11,20,2522,2522,2511,2511
Santa Cruz,38,2022-09-04,364,364,364,0,14036,14056,14054,2,14,0,0,1,273,273,273,273
Shasta,38,2022-09-04,135,135,135,0,2463,2468,2467,1,16,0,0,0,591,591,591,591
Siskiyou,38,2022-09-04,33,33,33,0,242,243,242,1,0,0,0,0,89,89,89,89
Solano,38,2022-09-04,446,446,446,0,7222,7232,7231,1,34,2,2,9,458,458,456,456
Sonoma,38,2022-09-04,425,425,425,0,7086,7096,7095,1,34,0,0,2,521,521,521,521
Stanislaus,38,2022-09-04,641,641,641,0,7460,7471,7469,2,66,8,8,5,1777,1777,1769,1769
Sutter,38,2022-09-04,132,132,132,0,1626,1628,1627,1,0,0,0,0,232,232,232,232
Tehama,38,2022-09-04,62,62,62,0,725,726,725,1,3,1,1,0,215,215,214,214
Trinity,38,2022-09-04,4,4,4,0,56,57,56,1,0,0,0,0,21,21,21,21
Tulare,38,2022-09-04,499,499,499,0,6524,6533,6531,2,33,2,2,1,1536,1536,1534,1534
Tuolumne,38,2022-09-04,60,60,60,0,819,820,819,1,2,0,0,0,199,199,199,199
Ventura,38,2022-09-04,972,972,972,0,14130,14148,14147,1,42,8,8,2,1586,1586,1578,1578
Yolo,38,2022-09-04,182,182,182,0,3360,3366,3365,1,4,3,3,0,391,391,388,388
Yuba,38,2022-09-04,103,103,103,0,1134,1135,1134,1,17,1,1,1,131,131,130,130
Alameda,39,2022-09-11,1518,1518,1518,0,28720,28762,28759,3,85,1,1,18,1994,1994,1993,1993
Amador,39,2022-09-11,29,29,29,0,785,786,785,1,3,0,0,2,90,90,90,90
Butte,39,2022-09-11,183,183,183,0,2250,2254,2253,1,15,3,3,1,462,462,459,459
Calaveras,39,2022-09-11,13,13,13,0,456,457,456,1,0,0,0,0,133,133,133,133
Colusa,39,2022-09-11,16,16,16,0,300,301,300,1,2,0,0,0,22,22,22,22
Contra Costa,39,2022-09-11,918,918,918,0,15655,15679,15677,2,45,6,6,12,1447,1447,1441,1441
Del Norte,39,2022-09-11,31,31,31,0,523,524,523,1,2,0,0,1,55,55,55,55
El Dorado,39,2022-09-11,105,105,105,0,1730,1732,1731,1,2,1,1,1,234,234,233,233
Fresno,39,2022-09-11,901,901,901,0,13341,13361,13359,2,143,4,4,13,2868,2868,2864,2864
Glenn,39,2022-09-11,13,13,13,0,196,197,196,1,1,0,0,0,56,56,56,56
Humboldt,39,2022-09-11,104,104,104,0,1406,1408,1407,1,7,1,1,5,159,159,158,158
Imperial,39,2022-09-11,243,243,243,0,2914,2919,2918,1,17,0,0,0,961,961,961,961
Inyo,39,2022-09-11,16,16,16,0,186,187,186,1,1,0,0,0,59,59,59,59
Kern,39,2022-09-11,625,625,625,0,11443,11460,11459,1,44,5,5,10,2419,2419,2414,2414
Kings,39,2022-09-11,206,206,206,0,2829,2834,2833,1,5,1,1,0,462,462,461,461
Lake,39,2022-09-11,41,41,41,0,749,750,749,1,5,0,0,0,148,148,148,148
Lassen,39,2022-09-11,17,17,17,0,776,777,776,1,0,0,0,0,64,64,64,64
Los Angeles,39,2022-09-11,10228,10242,10242,0,247955,248317,248308,9,626,91,91,87,33461,33461,33370,33370
Madera,39,2022-09-11,224,224,224,0,2677,2682,2681,1,8,0,0,3,374,374,374,374
Marin,39,2022-09-11,174,174,174,0,3627,3632,3631,1,12,2,2,0,258,258,256,256
Mariposa,39,2022-09-11,14,14,14,0,179,180,179,1,0,0,0,0,29,29,29,29
Mendocino,39,2022-09-11,52,52,52,0,838,839,838,1,3,0,0,1,136,136,136,136
Merced,39,2022-09-11,224,224,224,0,2850,2855,2854,1,9,3,3,1,863,863,860,860
Modoc,39,2022-09-11,2,2,2,0,19,20,19,1,0,0,0,0,11,11,11,11
Mono,39,2022-09-11,4,4,4,0,65,66,65,1,0,0,0,0,7,7,7,7
Monterey,39,2022-09-11,233,233,233,0,4569,4575,4574,1,23,2,2,1,769,769,767,767
Napa,39,2022-09-11,108,108,108,0,1862,1866,1865,1,9,0,0,0,160,160,160,160
Nevada,39,2022-09-11,61,61,61,0,991,992,991,1,3,1,1,0,136,136,135,135
Orange,39,2022-09-11,2051,2053,2053,0,33539,33589,33586,3,155,25,25,24,7497,7497,7472,7472
Placer,39,2022-09-11,241,241,241,0,3731,3737,3736,1,40,0,0,7,658,658,658,658
Plumas,39,2022-09-11,18,18,18,0,153,154,153,1,0,0,0,0,13,13,13,13
Riverside,39,2022-09-11,2175,2177,2177,0,29089,29132,29129,3,117,5,5,10,6628,6628,6623,6623
Sacramento,39,2022-09-11,1200,1200,1200,0,20925,20955,20952,3,125,13,13,15,3321,3321,3308,3308
San Benito,39,2022-09-11,92,92,92,0,1249,1251,1250,1,2,0,0,1,102,102,102,102
San Bernardino,39,2022-09-11,1779,1780,1780,0,34704,34754,34751,3,98,15,15,21,8085,8085,8070,8070
San Diego,39,2022-09-11,2731,2735,2735,0,49822,49895,49893,2,174,8,8,26,5554,5554,5546,5546
San Francisco,39,2022-09-11,740,740,740,0,15641,15665,15661,4,59,7,7,13,1052,1052,1045,1045
San Joaquin,39,2022-09-11,664,664,664,0,12716,12735,12733,2,31,6,6,11,2333,2333,2327,2327
San Luis Obispo,39,2022-09-11,165,165,165,0,2821,2826,2825,1,9,0,0,1,524,524,524,524
San Mateo,39,2022-09-11,620,620,620,0,12805,12823,12822,1,19,1,1,1,743,743,742,742
Santa Barbara,39,2022-09-11,339,339,339,0,6660,6670,6669,1,27,3,3,2,727,727,724,724
Santa Clara,39,2022-09-11,1832,1833,1833,0,34721,34772,34771,1,144,8,8,27,2530,2530,2522,2522
Santa Cruz,39,2022-09-11,255,255,255,0,10388,10402,10401,1,11,0,0,1,273,273,273,273
Shasta,39,2022-09-11,158,158,158,0,2272,2275,2274,1,21,0,0,1,591,591,591,591
Siskiyou,39,2022-09-11,28,28,28,0,263,264,263,1,2,0,0,1,89,89,89,89
Solano,39,2022-09-11,352,352,352,0,5733,5742,5741,1,26,0,0,6,458,458,458,458
Sonoma,39,2022-09-11,359,359,359,0,6059,6070,6069,1,41,3,3,1,524,524,521,521
Stanislaus,39,2022-09-11,440,440,440,0,6887,6899,6898,1,69,1,1,5,1778,1778,1777,1777
Sutter,39,2022-09-11,112,112,112,0,1428,1430,1429,1,0,0,0,0,232,232,232,232
Tehama,39,2022-09-11,42,42,42,0,590,591,590,1,2,0,0,0,215,215,215,215
Trinity,39,2022-09-11,2,2,2,0,60,61,60,1,0,0,0,0,21,21,21,21
Tulare,39,2022-09-11,363,363,363,0,5921,5931,5930,1,40,3,3,0,1539,1539,1536,1536
Tuolumne,39,2022-09-11,66,66,66,0,764,765,764,1,2,0,0,1,199,199,199,199
Ventura,39,2022-09-11,792,792,792,0,13068,13087,13086,1,48,1,1,5,1587,1587,1586,1586
Yolo,39,2022-09-11,125,125,125,0,2878,2884,2883,1,3,2,2,2,393,393,391,391
Yuba,39,2022-09-11,88,88,88,0,1032,1033,1032,1,6,0,0,0,131,131,131,131
Alameda,40,2022-09-18,1313,1313,1313,0,29388,29433,29431,2,78,4,4,7,1998,1998,1994,1994
Amador,40,2022-09-18,34,34,34,0,789,790,789,1,1,3,3,1,93,93,90,90
Butte,40,2022-09-18,138,138,138,0,2153,2157,2156,1,14,0,0,1,462,462,462,462
Calaveras,40,2022-09-18,25,25,25,0,489,490,489,1,0,0,0,0,133,133,133,133
Colusa,40,2022-09-18,14,14,14,0,313,314,313,1,2,0,0,0,22,22,22,22
Contra Costa,40,2022-09-18,842,842,842,0,16704,16729,16727,2,56,7,7,6,1454,1454,1447,1447
Del Norte,40,2022-09-18,21,21,21,0,506,507,506,1,1,0,0,0,55,55,55,55
El Dorado,40,2022-09-18,81,81,81,0,1656,1658,1657,1,3,0,0,0,234,234,234,234
Fresno,40,2022-09-18,617,617,617,0,13620,13641,13639,2,111,10,10,13,2878,2878,2868,2868
Glenn,40,2022-09-18,12,12,12,0,207,208,207,1,1,0,0,0,56,56,56,56
Humboldt,40,2022-09-18,110,110,110,0,1532,1533,1532,1,7,0,0,2,159,159,159,159
Imperial,40,2022-09-18,174,174,174,0,2963,2969,2968,1,12,0,0,0,961,961,961,961
Inyo,40,2022-09-18,7,7,7,0,172,173,172,1,0,1,1,0,60,60,59,59
Kern,40,2022-09-18,476,476,476,0,11993,12011,12010,1,33,5,5,8,2424,2424,2419,2419
Kings,40,2022-09-18,156,156,156,0,2778,2784,2783,1,5,2,2,0,464,464,462,462
Lake,40,2022-09-18,45,45,45,0,889,890,889,1,0,1,1,0,149,149,148,148
Lassen,40,2022-09-18,9,9,9,0,743,744,743,1,0,0,0,0,64,64,64,64
Los Angeles,40,2022-09-18,8750,8763,8763,0,257942,258333,258326,7,529,64,64,78,33525,33525,33461,33461
Madera,40,2022-09-18,117,117,117,0,2740,2746,2745,1,10,1,1,2,375,375,374,374
Marin,40,2022-09-18,141,141,141,0,3704,3711,3710,1,8,0,0,0,258,258,258,258
Mariposa,40,2022-09-18,14,14,14,0,163,164,163,1,0,0,0,0,29,29,29,29
Mendocino,40,2022-09-18,49,49,49,0,939,940,939,1,2,0,0,2,136,136,136,136
Merced,40,2022-09-18,179,179,179,0,2908,2914,2913,1,5,2,2,1,865,865,863,863
Modoc,40,2022-09-18,1,1,1,0,17,18,17,1,0,0,0,0,11,11,11,11
Mono,40,2022-09-18,7,7,7,0,72,73,72,1,0,0,0,0,7,7,7,7
Monterey,40,2022-09-18,163,163,163,0,4439,4445,4444,1,16,0,0,2,769,769,769,769
Napa,40,2022-09-18,107,107,107,0,1868,1870,1869,1,6,0,0,1,160,160,160,160
Nevada,40,2022-09-18,63,63,63,0,1092,1093,1092,1,1,1,1,0,137,137,136,136
Orange,40,2022-09-18,1816,1816,1816,0,34733,34785,34783,2,137,20,20,20,7517,7517,7497,7497
Placer,40,2022-09-18,220,220,220,0,3962,3969,3968,1,56,1,1,4,659,659,658,658
Plumas,40,2022-09-18,22,22,22,0,188,189,188,1,1,0,0,0,13,13,13,13
Riverside,40,2022-09-18,1475,1475,1475,0,29933,29978,29975,3,84,5,5,13,6633,6633,6628,6628
Sacramento,40,2022-09-18,1060,1060,1060,0,22101,22134,22132,2,113,9,9,16,3330,3330,3321,3321
San Benito,40,2022-09-18,57,57,57,0,1219,1221,1220,1,0,0,0,0,102,102,102,102
San Bernardino,40,2022-09-18,1567,1567,1567,0,33965,34016,34014,2,80,7,7,25,8092,8092,8085,8085
San Diego,40,2022-09-18,2626,2631,2631,0,56098,56183,56181,2,179,9,9,21,5563,5563,5554,5554
San Francisco,40,2022-09-18,707,707,707,0,16774,16799,16796,3,45,9,9,8,1061,1061,1052,1052
San Joaquin,40,2022-09-18,484,484,484,0,13329,13349,13348,1,32,4,4,4,2337,2337,2333,2333
San Luis Obispo,40,2022-09-18,167,167,167,0,2858,2864,2863,1,7,0,0,1,524,524,524,524
San Mateo,40,2022-09-18,612,612,612,0,13605,13626,13625,1,14,0,0,0,743,743,743,743
Santa Barbara,40,2022-09-18,264,264,264,0,6869,6880,6879,1,29,2,2,0,729,729,727,727
Santa Clara,40,2022-09-18,1496,1496,1496,0,36868,36925,36924,1,139,6,6,20,2536,2536,2530,2530
Santa Cruz,40,2022-09-18,154,154,154,0,12136,12155,12154,1,7,0,0,0,273,273,273,273
Shasta,40,2022-09-18,114,114,114,0,2120,2124,2123,1,20,1,1,3,592,592,591,591
Siskiyou,40,2022-09-18,20,20,20,0,240,241,240,1,1,1,1,1,90,90,89,89
Solano,40,2022-09-18,300,300,300,0,6243,6254,6253,1,24,1,1,4,459,459,458,458
Sonoma,40,2022-09-18,328,328,328,0,6457,6468,6467,1,27,2,2,3,526,526,524,524
Stanislaus,40,2022-09-18,347,347,347,0,6553,6564,6563,1,59,5,5,7,1783,1783,1778,1778
Sutter,40,2022-09-18,84,84,84,0,1404,1406,1405,1,0,0,0,0,232,232,232,232
Tehama,40,2022-09-18,39,39,39,0,594,595,594,1,2,1,1,0,216,216,215,215
Trinity,40,2022-09-18,3,3,3,0,63,64,63,1,0,0,0,0,21,21,21,21
Tulare,40,2022-09-18,237,237,237,0,5911,5919,5918,1,30,2,2,1,1541,1541,1539,1539
Tuolumne,40,2022-09-18,58,58,58,0,721,722,721,1,0,0,0,0,199,199,199,199
Ventura,40,2022-09-18,646,646,646,0,13672,13692,13691,1,41,2,2,7,1589,1589,1587,1587
Yolo,40,2022-09-18,98,98,98,0,3767,3774,3773,1,3,1,1,1,394,394,393,393
Yuba,40,2022-09-18,59,59,59,0,1057,1058,1057,1,4,1,1,1,132,132,131,131
Alameda,41,2022-09-25,1139,1139,1139,0,28072,28117,28115,2,76,2,2,5,2000,2000,1998,1998
Amador,41,2022-09-25,29,29,29,0,730,731,730,1,1,0,0,1,93,93,93,93
Butte,41,2022-09-25,86,86,86,0,1810,1813,1812,1,28,0,0,1,462,462,462,462
Calaveras,41,2022-09-25,22,22,22,0,387,388,387,1,2,1,1,1,134,134,133,133
Colusa,41,2022-09-25,6,6,6,0,286,287,286,1,1,0,0,0,22,22,22,22
Contra Costa,41,2022-09-25,776,776,776,0,16430,16456,16454,2,45,5,5,9,1459,1459,1454,1454
Del Norte,41,2022-09-25,23,23,23,0,467,468,467,1,1,0,0,0,55,55,55,55
El Dorado,41,2022-09-25,86,86,86,0,1525,1527,1526,1,6,0,0,0,234,234,234,234
Fresno,41,2022-09-25,508,508,508,0,11866,11886,11885,1,90,3,3,11,2881,2881,2878,2878
Glenn,41,2022-09-25,12,12,12,0,176,177,176,1,1,0,0,0,56,56,56,56
Humboldt,41,2022-09-25,101,101,101,0,1317,1318,1317,1,8,1,1,0,160,160,159,159
Imperial,41,2022-09-25,114,114,114,0,2669,2675,2674,1,6,1,1,0,962,962,961,961
Inyo,41,2022-09-25,4,4,4,0,168,169,168,1,0,0,0,0,60,60,60,60
Kern,41,2022-09-25,368,368,368,0,11055,11073,11072,1,33,3,3,8,2427,2427,2424,2424
Kings,41,2022-09-25,106,106,106,0,2591,2596,2595,1,2,0,0,0,464,464,464,464
Lake,41,2022-09-25,27,27,27,0,809,810,809,1,0,0,0,0,149,149,149,149
Lassen,41,2022-09-25,16,16,16,0,573,574,573,1,0,0,0,0,64,64,64,64
Los Angeles,41,2022-09-25,7803,7815,7815,0,246851,247237,247231,6,439,61,61,60,33586,33586,33525,33525
Madera,41,2022-09-25,94,94,94,0,2272,2277,2276,1,9,0,0,2,375,375,375,375
Marin,41,2022-09-25,155,155,155,0,3611,3617,3616,1,7,0,0,0,258,258,258,258
Mariposa,41,2022-09-25,5,5,5,0,158,159,158,1,0,1,1,0,30,30,29,29
Mendocino,41,2022-09-25,35,35,35,0,835,836,835,1,2,0,0,0,136,136,136,136
Merced,41,2022-09-25,131,131,131,0,2821,2827,2826,1,8,2,2,0,867,867,865,865
Modoc,41,2022-09-25,1,1,1,0,15,16,15,1,0,0,0,0,11,11,11,11
Mono,41,2022-09-25,1,1,1,0,64,65,64,1,0,0,0,0,7,7,7,7
Monterey,41,2022-09-25,140,140,140,0,4022,4027,4026,1,16,1,1,2,770,770,769,769
Napa,41,2022-09-25,86,86,86,0,1930,1934,1933,1,3,1,1,1,161,161,160,160
Nevada,41,2022-09-25,49,49,49,0,1107,1108,1107,1,3,0,0,0,137,137,137,137
Orange,41,2022-09-25,1725,1725,1725,0,31915,31966,31964,2,116,16,16,21,7533,7533,7517,7517
Placer,41,2022-09-25,200,200,200,0,3599,3606,3605,1,46,0,0,4,659,659,659,659
Plumas,41,2022-09-25,21,21,21,0,154,155,154,1,1,0,0,0,13,13,13,13
Riverside,41,2022-09-25,1305,1305,1305,0,26295,26337,26335,2,58,9,9,15,6642,6642,6633,6633
Sacramento,41,2022-09-25,960,960,960,0,19527,19558,19557,1,108,11,11,20,3341,3341,3330,3330
San Benito,41,2022-09-25,44,44,44,0,1174,1176,1175,1,0,1,1,2,103,103,102,102
San Bernardino,41,2022-09-25,1244,1244,1244,0,28754,28799,28797,2,71,6,6,15,8098,8098,8092,8092
San Diego,41,2022-09-25,2512,2517,2517,0,51961,52042,52041,1,192,7,7,22,5570,5570,5563,5563
San Francisco,41,2022-09-25,692,692,692,0,16370,16395,16392,3,42,4,4,7,1065,1065,1061,1061
San Joaquin,41,2022-09-25,402,402,402,0,11214,11231,11230,1,38,2,2,2,2339,2339,2337,2337
San Luis Obispo,41,2022-09-25,117,117,117,0,2479,2485,2484,1,6,1,1,1,525,525,524,524
San Mateo,41,2022-09-25,594,594,594,0,13304,13323,13322,1,29,0,0,0,743,743,743,743
Santa Barbara,41,2022-09-25,251,251,251,0,6391,6403,6402,1,23,2,2,0,731,731,729,729
Santa Clara,41,2022-09-25,1402,1402,1402,0,36557,36614,36613,1,115,9,9,17,2545,2545,2536,2536
Santa Cruz,41,2022-09-25,206,206,206,0,12843,12863,12862,1,11,0,0,1,273,273,273,273
Shasta,41,2022-09-25,83,83,83,0,1818,1821,1820,1,15,1,1,5,593,593,592,592
Siskiyou,41,2022-09-25,19,19,19,0,195,196,195,1,1,2,2,2,92,92,90,90
Solano,41,2022-09-25,298,298,298,0,5699,5710,5709,1,25,1,1,2,460,460,459,459
Sonoma,41,2022-09-25,291,291,291,0,6317,6329,6328,1,25,2,2,3,528,528,526,526
Stanislaus,41,2022-09-25,262,262,262,0,5793,5802,5801,1,42,2,2,6,1785,1785,1783,1783
Sutter,41,2022-09-25,66,66,66,0,1159,1160,1159,1,0,0,0,0,232,232,232,232
Tehama,41,2022-09-25,38,38,38,0,588,589,588,1,1,2,2,0,218,218,216,216
Trinity,41,2022-09-25,3,3,3,0,41,42,41,1,0,0,0,0,21,21,21,21
Tulare,41,2022-09-25,187,187,187,0,5174,5182,5181,1,17,2,2,2,1543,1543,1541,1541
Tuolumne,41,2022-09-25,48,48,48,0,674,675,674,1,1,0,0,0,199,199,199,199
Ventura,41,2022-09-25,564,564,564,0,12043,12061,12060,1,33,5,5,3,1594,1594,1589,1589
Yolo,41,2022-09-25,116,116,116,0,3915,3922,3921,1,2,5,5,2,399,399,394,394
Yuba,41,2022-09-25,47,47,47,0,931,932,931,1,6,0,0,0,132,132,132,132
Alameda,42,2022-10-02,1159,1159,1159,0,26831,26875,26874,1,49,2,2,4,2002,2002,2000,2000
Amador,42,2022-10-02,18,18,18,0,695,696,695,1,0,0,0,0,93,93,93,93
Butte,42,2022-10-02,77,77,77,0,1832,1836,1835,1,11,2,2,3,464,464,462,462
Calaveras,42,2022-10-02,19,19,19,0,361,362,361,1,1,0,0,0,134,134,134,134
Colusa,42,2022-10-02,7,7,7,0,277,278,277,1,0,0,0,0,22,22,22,22
Contra Costa,42,2022-10-02,778,778,778,0,15804,15829,15828,1,32,4,4,9,1463,1463,1459,1459
Del Norte,42,2022-10-02,14,14,14,0,404,405,404,1,1,0,0,1,55,55,55,55
El Dorado,42,2022-10-02,83,83,83,0,1511,1514,1513,1,5,0,0,1,234,234,234,234
Fresno,42,2022-10-02,493,493,493,0,11827,11846,11845,1,79,2,2,10,2883,2883,2881,2881
Glenn,42,2022-10-02,4,4,4,0,166,167,166,1,0,0,0,0,56,56,56,56
Humboldt,42,2022-10-02,71,71,71,0,1193,1194,1193,1,6,1,1,0,161,161,160,160
Imperial,42,2022-10-02,127,127,127,0,2522,2528,2527,1,7,0,0,0,962,962,962,962
Inyo,42,2022-10-02,8,8,8,0,150,151,150,1,0,0,0,1,60,60,60,60
Kern,42,2022-10-02,308,308,308,0,10348,10364,10363,1,27,3,3,7,2430,2430,2427,2427
Kings,42,2022-10-02,91,91,91,0,2501,2506,2505,1,2,0,0,0,464,464,464,464
Lake,42,2022-10-02,34,34,34,0,793,794,793,1,2,1,1,0,150,150,149,149
Lassen,42,2022-10-02,7,7,7,0,620,621,620,1,0,0,0,0,64,64,64,64
Los Angeles,42,2022-10-02,7342,7354,7354,0,228362,228730,228726,4,436,57,57,68,33643,33643,33586,33586
Madera,42,2022-10-02,71,71,71,0,1635,1637,1636,1,7,0,0,2,375,375,375,375
Marin,42,2022-10-02,199,199,199,0,3608,3614,3613,1,5,0,0,2,258,258,258,258
Mariposa,42,2022-10-02,5,5,5,0,139,140,139,1,0,0,0,0,30,30,30,30
Mendocino,42,2022-10-02,51,51,51,0,806,807,806,1,2,0,0,0,136,136,136,136
Merced,42,2022-10-02,105,105,105,0,2856,2862,2861,1,5,3,3,0,870,870,867,867
Modoc,42,2022-10-02,2,2,2,0,10,11,10,1,0,0,0,0,11,11,11,11
Mono,42,2022-10-02,4,4,4,0,61,62,61,1,0,0,0,0,7,7,7,7
Monterey,42,2022-10-02,119,119,119,0,3915,3921,3920,1,9,0,0,1,770,770,770,770
Napa,42,2022-10-02,96,96,96,0,1758,1761,1760,1,6,0,0,2,161,161,161,161
Nevada,42,2022-10-02,58,58,58,0,991,992,991,1,1,0,0,4,137,137,137,137
Orange,42,2022-10-02,1620,1620,1620,0,28775,28820,28819,1,132,22,22,19,7555,7555,7533,7533
Placer,42,2022-10-02,226,226,226,0,3415,3422,3421,1,43,3,3,3,662,662,659,659
Plumas,42,2022-10-02,14,14,14,0,122,123,122,1,2,0,0,0,13,13,13,13
Riverside,42,2022-10-02,1176,1176,1176,0,22900,22938,22937,1,56,6,6,10,6648,6648,6642,6642
Sacramento,42,2022-10-02,903,903,903,0,18630,18660,18659,1,87,12,12,19,3353,3353,3341,3341
San Benito,42,2022-10-02,41,41,41,0,1126,1128,1127,1,0,0,0,0,103,103,103,103
San Bernardino,42,2022-10-02,1247,1247,1247,0,25667,25709,25708,1,70,3,3,11,8101,8101,8098,8098
San Diego,42,2022-10-02,2166,2170,2170,0,46647,46721,46720,1,151,10,10,19,5580,5580,5570,5570
San Francisco,42,2022-10-02,655,655,655,0,15612,15637,15635,2,43,3,3,10,1068,1068,1065,1065
San Joaquin,42,2022-10-02,357,357,357,0,10051,10067,10066,1,30,4,4,3,2343,2343,2339,2339
San Luis Obispo,42,2022-10-02,147,147,147,0,2425,2431,2430,1,2,1,1,2,526,526,525,525
San Mateo,42,2022-10-02,570,570,570,0,12560,12579,12578,1,26,0,0,2,743,743,743,743
Santa Barbara,42,2022-10-02,260,260,260,0,6245,6258,6257,1,12,0,0,3,731,731,731,731
Santa Clara,42,2022-10-02,1460,1460,1460,0,33222,33276,33275,1,105,8,8,18,2553,2553,2545,2545
Santa Cruz,42,2022-10-02,236,236,236,0,11310,11329,11328,1,12,0,0,2,273,273,273,273
Shasta,42,2022-10-02,55,55,55,0,1523,1526,1525,1,12,0,0,2,593,593,593,593
Siskiyou,42,2022-10-02,12,12,12,0,198,199,198,1,1,0,0,1,92,92,92,92
Solano,42,2022-10-02,254,254,254,0,5392,5401,5400,1,19,0,0,2,460,460,460,460
Sonoma,42,2022-10-02,329,329,329,0,6106,6118,6117,1,21,0,0,2,528,528,528,528
Stanislaus,42,2022-10-02,218,218,218,0,5543,5553,5552,1,54,1,1,3,1786,1786,1785,1785
Sutter,42,2022-10-02,63,63,63,0,1144,1146,1145,1,0,2,2,0,234,234,232,232
Tehama,42,2022-10-02,23,23,23,0,541,542,541,1,0,0,0,1,218,218,218,218
Trinity,42,2022-10-02,1,1,1,0,46,47,46,1,0,0,0,0,21,21,21,21
Tulare,42,2022-10-02,169,169,169,0,4964,4972,4971,1,20,5,5,2,1548,1548,1543,1543
Tuolumne,42,2022-10-02,27,27,27,0,674,675,674,1,1,1,1,0,200,200,199,199
Ventura,42,2022-10-02,501,501,501,0,10371,10388,10387,1,33,1,1,4,1595,1595,1594,1594
Yolo,42,2022-10-02,138,138,138,0,3264,3271,3270,1,4,2,2,1,401,401,399,399
Yuba,42,2022-10-02,33,33,33,0,846,847,846,1,6,0,0,0,132,132,132,132
Alameda,43,2022-10-09,1052,1052,1052,0,24526,24566,24565,1,42,3,3,13,2005,2005,2002,2002
Amador,43,2022-10-09,11,11,11,0,673,674,673,1,0,0,0,2,93,93,93,93
Butte,43,2022-10-09,61,61,61,0,1683,1685,1684,1,11,1,1,1,465,465,464,464
Calaveras,43,2022-10-09,13,13,13,0,313,314,313,1,0,1,1,0,135,135,134,134
Colusa,43,2022-10-09,3,3,3,0,104,105,104,1,0,0,0,0,22,22,22,22
Contra Costa,43,2022-10-09,664,664,664,0,14922,14947,14946,1,31,5,5,6,1468,1468,1463,1463
Del Norte,43,2022-10-09,11,11,11,0,386,387,386,1,0,0,0,1,55,55,55,55
El Dorado,43,2022-10-09,68,68,68,0,1401,1402,1401,1,5,0,0,1,234,234,234,234
Fresno,43,2022-10-09,378,378,378,0,10859,10877,10876,1,57,3,3,7,2886,2886,2883,2883
Glenn,43,2022-10-09,7,7,7,0,139,140,139,1,0,0,0,0,56,56,56,56
Humboldt,43,2022-10-09,89,89,89,0,1223,1224,1223,1,8,1,1,0,162,162,161,161
Imperial,43,2022-10-09,173,173,173,0,2591,2597,2596,1,7,0,0,0,962,962,962,962
Inyo,43,2022-10-09,4,4,4,0,115,116,115,1,0,0,0,0,60,60,60,60
Kern,43,2022-10-09,315,315,315,0,10305,10323,10322,1,24,3,3,2,2433,2433,2430,2430
Kings,43,2022-10-09,83,83,83,0,2383,2388,2387,1,0,1,1,1,465,465,464,464
Lake,43,2022-10-09,25,25,25,0,726,727,726,1,1,0,0,0,150,150,150,150
Lassen,43,2022-10-09,4,4,4,0,461,462,461,1,1,0,0,0,64,64,64,64
Los Angeles,43,2022-10-09,5925,5934,5934,0,194207,194528,194525,3,433,60,60,48,33703,33703,33643,33643
Madera,43,2022-10-09,56,56,56,0,1512,1513,1512,1,6,1,1,2,376,376,375,375
Marin,43,2022-10-09,174,174,174,0,3211,3217,3216,1,5,0,0,0,258,258,258,258
Mariposa,43,2022-10-09,5,5,5,0,118,119,118,1,0,0,0,0,30,30,30,30
Mendocino,43,2022-10-09,29,29,29,0,819,820,819,1,2,0,0,2,136,136,136,136
Merced,43,2022-10-09,103,103,103,0,2320,2325,2324,1,8,1,1,1,871,871,870,870
Modoc,43,2022-10-09,5,5,5,0,17,18,17,1,0,0,0,0,11,11,11,11
Mono,43,2022-10-09,1,1,1,0,58,59,58,1,0,0,0,0,7,7,7,7
Monterey,43,2022-10-09,92,92,92,0,3716,3722,3721,1,9,1,1,1,771,771,770,770
Napa,43,2022-10-09,61,61,61,0,1585,1587,1586,1,2,0,0,1,161,161,161,161
Nevada,43,2022-10-09,34,34,34,0,898,899,898,1,1,0,0,1,137,137,137,137
Orange,43,2022-10-09,1338,1338,1338,0,26422,26466,26465,1,125,13,13,17,7568,7568,7555,7555
Placer,43,2022-10-09,179,179,179,0,3263,3270,3269,1,25,0,0,6,662,662,662,662
Plumas,43,2022-10-09,20,20,20,0,96,97,96,1,0,0,0,0,13,13,13,13
Riverside,43,2022-10-09,991,991,991,0,21034,21070,21069,1,58,6,6,7,6654,6654,6648,6648
Sacramento,43,2022-10-09,816,816,816,0,17367,17395,17394,1,73,6,6,16,3359,3359,3353,3353
San Benito,43,2022-10-09,36,36,36,0,1047,1049,1048,1,3,0,0,0,103,103,103,103
San Bernardino,43,2022-10-09,1038,1038,1038,0,23907,23947,23946,1,63,1,1,11,8102,8102,8101,8101
San Diego,43,2022-10-09,1799,1802,1802,0,45334,45409,45408,1,122,3,3,20,5583,5583,5580,5580
San Francisco,43,2022-10-09,625,625,625,0,14593,14618,14617,1,47,2,2,7,1070,1070,1068,1068
San Joaquin,43,2022-10-09,352,352,352,0,9956,9974,9973,1,19,2,2,6,2345,2345,2343,2343
San Luis Obispo,43,2022-10-09,111,111,111,0,2256,2260,2259,1,4,2,2,0,528,528,526,526
San Mateo,43,2022-10-09,566,566,566,0,11780,11801,11800,1,22,0,0,0,743,743,743,743
Santa Barbara,43,2022-10-09,222,222,222,0,6628,6641,6640,1,19,1,1,2,732,732,731,731
Santa Clara,43,2022-10-09,1248,1248,1248,0,28808,28857,28856,1,110,5,5,17,2558,2558,2553,2553
Santa Cruz,43,2022-10-09,248,248,248,0,10792,10810,10809,1,9,0,0,1,273,273,273,273
Shasta,43,2022-10-09,66,66,66,0,1175,1177,1176,1,18,3,3,1,596,596,593,593
Siskiyou,43,2022-10-09,9,9,9,0,180,181,180,1,1,1,1,1,93,93,92,92
Solano,43,2022-10-09,286,286,286,0,5276,5286,5285,1,23,0,0,4,460,460,460,460
Sonoma,43,2022-10-09,245,245,245,0,5619,5631,5630,1,18,1,1,1,529,529,528,528
Stanislaus,43,2022-10-09,190,190,190,0,5179,5189,5188,1,54,3,3,7,1789,1789,1786,1786
Sutter,43,2022-10-09,46,46,46,0,977,978,977,1,0,1,1,0,235,235,234,234
Tehama,43,2022-10-09,22,22,22,0,471,472,471,1,0,0,0,0,218,218,218,218
Trinity,43,2022-10-09,1,1,1,0,48,49,48,1,0,0,0,0,21,21,21,21
Tulare,43,2022-10-09,147,147,147,0,4517,4524,4523,1,10,1,1,2,1549,1549,1548,1548
Tuolumne,43,2022-10-09,27,27,27,0,566,567,566,1,1,1,1,0,201,201,200,200
Ventura,43,2022-10-09,422,422,422,0,9941,9959,9958,1,36,3,3,3,1598,1598,1595,1595
Yolo,43,2022-10-09,92,92,92,0,2813,2818,2817,1,2,2,2,0,403,403,401,401
Yuba,43,2022-10-09,23,23,23,0,786,787,786,1,0,0,0,1,132,132,132,132
Alameda,44,2022-10-16,1095,1095,1095,0,28302,28352,28351,1,57,3,3,12,2008,2008,2005,2005
Amador,44,2022-10-16,17,17,17,0,734,735,734,1,1,0,0,0,93,93,93,93
Butte,44,2022-10-16,72,72,72,0,1559,1561,1560,1,13,2,2,0,466,466,464,464
Calaveras,44,2022-10-16,24,24,24,0,350,351,350,1,0,0,0,0,135,135,135,135
Colusa,44,2022-10-16,3,3,3,0,92,93,92,1,1,0,0,0,22,22,22,22
Contra Costa,44,2022-10-16,773,773,773,0,16629,16657,16656,1,25,7,7,5,1473,1473,1466,1466
Del Norte,44,2022-10-16,12,12,12,0,483,484,483,1,1,0,0,0,55,55,55,55
El Dorado,44,2022-10-16,98,98,98,0,1743,1747,1746,1,1,0,0,1,234,234,234,234
Fresno,44,2022-10-16,442,442,442,0,11824,11845,11844,1,58,2,2,13,2888,2888,2886,2886
Glenn,44,2022-10-16,11,11,11,0,225,226,225,1,1,0,0,0,56,56,56,56
Humboldt,44,2022-10-16,77,77,77,0,1296,1297,1296,1,1,0,0,0,162,162,162,162
Imperial,44,2022-10-16,148,148,148,0,2734,2741,2740,1,5,0,0,0,962,962,962,962
Inyo,44,2022-10-16,5,5,5,0,137,138,137,1,1,0,0,0,60,60,60,60
Kern,44,2022-10-16,263,263,263,0,11294,11314,11313,1,27,0,0,3,2433,2433,2433,2433
Kings,44,2022-10-16,93,93,93,0,2707,2713,2712,1,1,1,1,1,466,466,465,465
Lake,44,2022-10-16,35,35,35,0,936,937,936,1,1,0,0,0,150,150,150,150
Lassen,44,2022-10-16,6,6,6,0,582,583,582,1,1,0,0,0,64,64,64,64
Los Angeles,44,2022-10-16,6143,6153,6153,0,226934,227320,227317,3,355,54,54,55,33749,33749,33695,33695
Madera,44,2022-10-16,65,65,65,0,1659,1661,1660,1,3,0,0,2,376,376,376,376
Marin,44,2022-10-16,176,176,176,0,3615,3622,3621,1,6,0,0,1,258,258,258,258
Mariposa,44,2022-10-16,9,9,9,0,133,134,133,1,0,0,0,0,30,30,30,30
Mendocino,44,2022-10-16,51,51,51,0,879,880,879,1,2,0,0,1,136,136,136,136
Merced,44,2022-10-16,145,145,145,0,2831,2838,2837,1,11,0,0,3,871,871,871,871
Modoc,44,2022-10-16,1,1,1,0,7,8,7,1,0,0,0,0,11,11,11,11
Mono,44,2022-10-16,5,5,5,0,48,49,48,1,0,0,0,0,7,7,7,7
Monterey,44,2022-10-16,129,129,129,0,4210,4218,4217,1,18,1,1,1,772,772,771,771
Napa,44,2022-10-16,79,79,79,0,1642,1643,1642,1,2,0,0,1,161,161,161,161
Nevada,44,2022-10-16,59,59,59,0,936,937,936,1,4,0,0,0,137,137,137,137
Orange,44,2022-10-16,1387,1387,1387,0,29508,29559,29558,1,101,21,21,20,7587,7587,7566,7566
Placer,44,2022-10-16,160,160,160,0,3522,3530,3529,1,39,0,0,3,662,662,662,662
Plumas,44,2022-10-16,11,11,11,0,112,113,112,1,0,0,0,0,13,13,13,13
Riverside,44,2022-10-16,1121,1121,1121,0,23822,23861,23860,1,57,2,2,6,6656,6656,6654,6654
Sacramento,44,2022-10-16,1012,1012,1012,0,19746,19780,19779,1,72,10,10,16,3369,3369,3359,3359
San Benito,44,2022-10-16,28,28,28,0,1175,1176,1175,1,0,1,1,0,104,104,103,103
San Bernardino,44,2022-10-16,982,982,982,0,27456,27502,27501,1,70,0,0,8,8102,8102,8102,8102
San Diego,44,2022-10-16,1891,1891,1891,0,51884,51974,51973,1,129,12,12,20,5593,5593,5581,5581
San Francisco,44,2022-10-16,651,651,651,0,16086,16115,16114,1,39,2,2,10,1072,1072,1070,1070
San Joaquin,44,2022-10-16,434,434,434,0,11139,11157,11156,1,13,2,2,5,2347,2347,2345,2345
San Luis Obispo,44,2022-10-16,98,98,98,0,2487,2493,2492,1,6,1,1,0,529,529,528,528
San Mateo,44,2022-10-16,672,672,672,0,13599,13623,13622,1,21,0,0,1,743,743,743,743
Santa Barbara,44,2022-10-16,221,221,221,0,6895,6908,6907,1,16,0,0,3,732,732,732,732
Santa Clara,44,2022-10-16,1402,1402,1402,0,34902,34964,34963,1,100,5,5,14,2563,2563,2558,2558
Santa Cruz,44,2022-10-16,328,328,328,0,11523,11545,11544,1,7,1,1,1,274,274,273,273
Shasta,44,2022-10-16,114,114,114,0,1368,1369,1368,1,9,0,0,3,596,596,596,596
Siskiyou,44,2022-10-16,9,9,9,0,254,255,254,1,3,1,1,1,94,94,93,93
Solano,44,2022-10-16,329,329,329,0,5909,5920,5919,1,24,1,1,3,461,461,460,460
Sonoma,44,2022-10-16,286,286,286,0,6583,6596,6595,1,21,1,1,1,530,530,529,529
Stanislaus,44,2022-10-16,244,244,244,0,6107,6119,6118,1,47,5,5,6,1792,1792,1787,1787
Sutter,44,2022-10-16,56,56,56,0,1026,1027,1026,1,0,0,0,0,235,235,235,235
Tehama,44,2022-10-16,20,20,20,0,522,523,522,1,0,0,0,0,218,218,218,218
Trinity,44,2022-10-16,0,0,0,0,39,40,39,1,0,0,0,0,21,21,21,21
Tulare,44,2022-10-16,157,157,157,0,4935,4944,4943,1,11,1,1,1,1550,1550,1549,1549
Tuolumne,44,2022-10-16,47,47,47,0,713,714,713,1,1,0,0,0,201,201,201,201
Ventura,44,2022-10-16,404,404,404,0,10813,10833,10832,1,37,4,4,2,1601,1601,1597,1597
Yolo,44,2022-10-16,132,132,132,0,2599,2605,2604,1,3,2,2,3,405,405,403,403
Yuba,44,2022-10-16,45,45,45,0,892,893,892,1,1,0,0,0,132,132,132,132
Alameda,45,2022-10-23,926,926,926,0,23194,23235,23234,1,47,4,4,10,2012,2012,2008,2008
Amador,45,2022-10-23,19,19,19,0,626,627,626,1,1,0,0,0,93,93,93,93
Butte,45,2022-10-23,76,76,76,0,1391,1393,1392,1,7,1,1,1,467,467,466,466
Calaveras,45,2022-10-23,16,16,16,0,338,339,338,1,0,0,0,0,135,135,135,135
Colusa,45,2022-10-23,4,4,4,0,98,99,98,1,0,0,0,0,22,22,22,22
Contra Costa,45,2022-10-23,643,643,643,0,14003,14028,14027,1,25,6,6,7,1479,1479,1473,1473
Del Norte,45,2022-10-23,6,6,6,0,362,363,362,1,0,0,0,0,55,55,55,55
El Dorado,45,2022-10-23,93,93,93,0,1508,1511,1510,1,1,0,0,1,234,234,234,234
Fresno,45,2022-10-23,404,404,404,0,9918,9935,9934,1,62,0,0,3,2888,2888,2888,2888
Glenn,45,2022-10-23,8,8,8,0,145,146,145,1,0,0,0,0,56,56,56,56
Humboldt,45,2022-10-23,80,80,80,0,1190,1191,1190,1,8,0,0,2,162,162,162,162
Imperial,45,2022-10-23,116,116,116,0,2310,2316,2315,1,4,1,1,0,963,963,962,962
Inyo,45,2022-10-23,7,7,7,0,186,187,186,1,0,0,0,0,60,60,60,60
Kern,45,2022-10-23,275,275,275,0,9579,9596,9595,1,23,1,1,4,2434,2434,2433,2433
Kings,45,2022-10-23,80,80,80,0,2263,2269,2268,1,6,0,0,0,466,466,466,466
Lake,45,2022-10-23,25,25,25,0,708,709,708,1,1,1,1,1,151,151,150,150
Lassen,45,2022-10-23,14,14,14,0,510,511,510,1,0,0,0,0,64,64,64,64
Los Angeles,45,2022-10-23,5294,5303,5303,0,185928,186254,186252,2,354,51,51,49,33800,33800,33749,33749
Madera,45,2022-10-23,63,63,63,0,1387,1388,1387,1,1,0,0,2,376,376,376,376
Marin,45,2022-10-23,145,145,145,0,3227,3233,3232,1,8,1,1,3,259,259,258,258
Mariposa,45,2022-10-23,10,10,10,0,123,124,123,1,0,0,0,0,30,30,30,30
Mendocino,45,2022-10-23,44,44,44,0,775,776,775,1,2,0,0,0,136,136,136,136
Merced,45,2022-10-23,100,100,100,0,2369,2375,2374,1,8,3,3,2,874,874,871,871
Modoc,45,2022-10-23,1,1,1,0,14,15,14,1,0,0,0,0,11,11,11,11
Mono,45,2022-10-23,4,4,4,0,49,50,49,1,0,1,1,0,8,8,7,7
Monterey,45,2022-10-23,139,139,139,0,3782,3790,3789,1,14,0,0,0,772,772,772,772
Napa,45,2022-10-23,42,42,42,0,1461,1463,1462,1,0,0,0,0,161,161,161,161
Nevada,45,2022-10-23,30,30,30,0,725,726,725,1,3,0,0,0,137,137,137,137
Orange,45,2022-10-23,1136,1136,1136,0,25718,25762,25761,1,88,14,14,12,7601,7601,7587,7587
Placer,45,2022-10-23,187,187,187,0,3032,3039,3038,1,47,0,0,4,662,662,662,662
Plumas,45,2022-10-23,15,15,15,0,91,92,91,1,1,0,0,0,13,13,13,13
Riverside,45,2022-10-23,924,924,924,0,20166,20201,20200,1,49,0,0,7,6656,6656,6656,6656
Sacramento,45,2022-10-23,849,849,849,0,15504,15531,15530,1,74,5,5,19,3374,3374,3369,3369
San Benito,45,2022-10-23,38,38,38,0,903,904,903,1,0,0,0,0,104,104,104,104
San Bernardino,45,2022-10-23,831,831,831,0,21729,21767,21766,1,49,4,4,14,8106,8106,8102,8102
San Diego,45,2022-10-23,1653,1656,1656,0,42611,42686,42685,1,97,5,5,24,5598,5598,5593,5593
San Francisco,45,2022-10-23,514,514,514,0,14067,14093,14092,1,40,2,2,6,1074,1074,1072,1072
San Joaquin,45,2022-10-23,288,288,288,0,8598,8613,8612,1,21,2,2,4,2349,2349,2347,2347
San Luis Obispo,45,2022-10-23,100,100,100,0,2077,2083,2082,1,4,0,0,1,529,529,529,529
San Mateo,45,2022-10-23,487,487,487,0,10999,11020,11019,1,22,0,0,2,743,743,743,743
Santa Barbara,45,2022-10-23,153,153,153,0,5719,5731,5730,1,21,1,1,4,733,733,732,732
Santa Clara,45,2022-10-23,1187,1187,1187,0,28824,28875,28874,1,91,2,2,16,2565,2565,2563,2563
Santa Cruz,45,2022-10-23,272,272,272,0,11274,11295,11294,1,12,1,1,0,275,275,274,274
Shasta,45,2022-10-23,79,79,79,0,954,955,954,1,7,0,0,2,596,596,596,596
Siskiyou,45,2022-10-23,13,13,13,0,162,163,162,1,1,0,0,1,94,94,94,94
Solano,45,2022-10-23,235,235,235,0,5029,5038,5037,1,19,0,0,1,461,461,461,461
Sonoma,45,2022-10-23,236,236,236,0,5334,5345,5344,1,23,0,0,1,530,530,530,530
Stanislaus,45,2022-10-23,187,187,187,0,4900,4910,4909,1,43,3,3,3,1795,1795,1792,1792
Sutter,45,2022-10-23,28,28,28,0,881,882,881,1,0,0,0,0,235,235,235,235
Tehama,45,2022-10-23,35,35,35,0,399,400,399,1,1,0,0,0,218,218,218,218
Trinity,45,2022-10-23,1,1,1,0,36,37,36,1,0,0,0,0,21,21,21,21
Tulare,45,2022-10-23,106,106,106,0,4304,4311,4310,1,16,0,0,1,1550,1550,1550,1550
Tuolumne,45,2022-10-23,32,32,32,0,607,608,607,1,0,1,1,0,202,202,201,201
Ventura,45,2022-10-23,313,313,313,0,9037,9053,9052,1,34,4,4,3,1605,1605,1601,1601
Yolo,45,2022-10-23,88,88,88,0,2067,2072,2071,1,6,1,1,0,406,406,405,405
Yuba,45,2022-10-23,50,50,50,0,793,794,793,1,6,0,0,1,132,132,132,132
Alameda,46,2022-10-30,1038,1038,1038,0,23838,23881,23880,1,50,4,4,5,2016,2016,2012,2012
Amador,46,2022-10-30,15,15,15,0,597,598,597,1,1,1,1,0,94,94,93,93
Butte,46,2022-10-30,73,73,73,0,1468,1470,1469,1,12,0,0,0,467,467,467,467
Calaveras,46,2022-10-30,16,16,16,0,257,258,257,1,0,0,0,0,135,135,135,135
Colusa,46,2022-10-30,10,10,10,0,105,106,105,1,0,0,0,0,22,22,22,22
Contra Costa,46,2022-10-30,697,697,697,0,13944,13969,13968,1,33,6,6,8,1485,1485,1479,1479
Del Norte,46,2022-10-30,14,14,14,0,365,366,365,1,1,0,0,0,55,55,55,55
El Dorado,46,2022-10-30,104,104,104,0,1426,1428,1427,1,2,0,0,0,234,234,234,234
Fresno,46,2022-10-30,403,403,403,0,10586,10606,10605,1,62,4,4,8,2892,2892,2888,2888
Glenn,46,2022-10-30,10,10,10,0,154,155,154,1,1,0,0,0,56,56,56,56
Humboldt,46,2022-10-30,46,46,46,0,1066,1067,1066,1,5,0,0,2,162,162,162,162
Imperial,46,2022-10-30,115,115,115,0,2631,2637,2636,1,11,0,0,0,963,963,963,963
Inyo,46,2022-10-30,9,9,9,0,323,324,323,1,0,0,0,0,60,60,60,60
Kern,46,2022-10-30,321,321,321,0,10031,10051,10050,1,18,3,3,3,2437,2437,2434,2434
Kings,46,2022-10-30,127,127,127,0,2533,2539,2538,1,3,0,0,1,466,466,466,466
Lake,46,2022-10-30,23,23,23,0,731,732,731,1,1,0,0,1,151,151,151,151
Lassen,46,2022-10-30,17,17,17,0,522,523,522,1,1,0,0,0,64,64,64,64
Los Angeles,46,2022-10-30,5925,5937,5937,0,192652,192998,192996,2,350,38,38,42,33838,33838,33800,33800
Madera,46,2022-10-30,57,57,57,0,1474,1476,1475,1,3,0,0,2,376,376,376,376
Marin,46,2022-10-30,133,133,133,0,3380,3387,3386,1,11,1,1,0,260,260,259,259
Mariposa,46,2022-10-30,11,11,11,0,129,130,129,1,0,0,0,0,30,30,30,30
Mendocino,46,2022-10-30,27,27,27,0,723,724,723,1,3,0,0,1,136,136,136,136
Merced,46,2022-10-30,89,89,89,0,2189,2195,2194,1,5,1,1,0,875,875,874,874
Modoc,46,2022-10-30,1,1,1,0,13,14,13,1,0,0,0,0,11,11,11,11
Mono,46,2022-10-30,0,0,0,0,91,92,91,1,0,0,0,1,8,8,8,8
Monterey,46,2022-10-30,140,140,140,0,3635,3643,3642,1,20,2,2,0,774,774,772,772
Napa,46,2022-10-30,57,57,57,0,1507,1509,1508,1,2,0,0,0,161,161,161,161
Nevada,46,2022-10-30,43,43,43,0,818,819,818,1,8,0,0,0,137,137,137,137
Orange,46,2022-10-30,1185,1185,1185,0,27217,27267,27266,1,97,16,16,16,7617,7617,7601,7601
Placer,46,2022-10-30,161,161,161,0,2904,2911,2910,1,38,0,0,7,662,662,662,662
Plumas,46,2022-10-30,5,5,5,0,91,92,91,1,0,0,0,0,13,13,13,13
Riverside,46,2022-10-30,1007,1007,1007,0,20119,20156,20155,1,57,4,4,9,6660,6660,6656,6656
Sacramento,46,2022-10-30,769,769,769,0,14539,14565,14564,1,72,9,9,13,3383,3383,3374,3374
San Benito,46,2022-10-30,34,34,34,0,805,806,805,1,1,0,0,1,104,104,104,104
San Bernardino,46,2022-10-30,986,986,986,0,22476,22516,22515,1,56,2,2,16,8108,8108,8106,8106
San Diego,46,2022-10-30,1766,1768,1768,0,42492,42567,42566,1,115,5,5,19,5603,5603,5598,5598
San Francisco,46,2022-10-30,601,601,601,0,14706,14732,14731,1,42,2,2,4,1076,1076,1074,1074
San Joaquin,46,2022-10-30,324,324,324,0,8631,8648,8647,1,17,2,2,4,2351,2351,2349,2349
San Luis Obispo,46,2022-10-30,82,82,82,0,2022,2027,2026,1,4,1,1,0,530,530,529,529
San Mateo,46,2022-10-30,516,516,516,0,11530,11552,11551,1,31,0,0,0,743,743,743,743
Santa Barbara,46,2022-10-30,195,195,195,0,6021,6033,6032,1,25,1,1,7,734,734,733,733
Santa Clara,46,2022-10-30,1277,1277,1277,0,31308,31365,31364,1,95,4,4,16,2569,2569,2565,2565
Santa Cruz,46,2022-10-30,188,188,188,0,9787,9806,9805,1,10,0,0,0,275,275,275,275
Shasta,46,2022-10-30,65,65,65,0,900,901,900,1,5,2,2,0,598,598,596,596
Siskiyou,46,2022-10-30,17,17,17,0,215,216,215,1,1,1,1,1,95,95,94,94
Solano,46,2022-10-30,301,301,301,0,5284,5295,5294,1,21,0,0,3,461,461,461,461
Sonoma,46,2022-10-30,227,227,227,0,5746,5759,5758,1,25,0,0,3,530,530,530,530
Stanislaus,46,2022-10-30,235,235,235,0,5025,5035,5034,1,50,0,0,6,1795,1795,1795,1795
Sutter,46,2022-10-30,51,51,51,0,970,971,970,1,0,0,0,0,235,235,235,235
Tehama,46,2022-10-30,23,23,23,0,399,400,399,1,1,0,0,0,218,218,218,218
Trinity,46,2022-10-30,18,18,18,0,73,74,73,1,4,0,0,0,21,21,21,21
Tulare,46,2022-10-30,151,151,151,0,3904,3911,3910,1,11,1,1,1,1551,1551,1550,1550
Tuolumne,46,2022-10-30,24,24,24,0,561,562,561,1,3,0,0,0,202,202,202,202
Ventura,46,2022-10-30,358,358,358,0,9526,9543,9542,1,34,1,1,2,1606,1606,1605,1605
Yolo,46,2022-10-30,77,77,77,0,1915,1920,1919,1,3,0,0,1,406,406,406,406
Yuba,46,2022-10-30,44,44,44,0,809,810,809,1,2,1,1,0,133,133,132,132
Alameda,47,2022-11-06,1324,1324,1324,0,24047,24093,24092,1,55,5,5,9,2021,2021,2016,2016
Amador,47,2022-11-06,31,31,31,0,678,679,678,1,3,0,0,0,94,94,94,94
Butte,47,2022-11-06,107,107,107,0,1377,1378,1377,1,10,0,0,0,467,467,467,467
Calaveras,47,2022-11-06,14,14,14,0,321,322,321,1,0,0,0,0,135,135,135,135
Colusa,47,2022-11-06,3,3,3,0,102,103,102,1,0,0,0,0,22,22,22,22
Contra Costa,47,2022-11-06,881,881,881,0,15418,15447,15446,1,39,2,2,6,1487,1487,1485,1485
Del Norte,47,2022-11-06,6,6,6,0,365,366,365,1,0,0,0,0,55,55,55,55
El Dorado,47,2022-11-06,103,103,103,0,1530,1532,1531,1,3,2,2,0,236,236,234,234
Fresno,47,2022-11-06,554,554,554,0,10403,10424,10423,1,58,3,3,6,2895,2895,2892,2892
Glenn,47,2022-11-06,20,20,20,0,145,146,145,1,0,0,0,0,56,56,56,56
Humboldt,47,2022-11-06,78,78,78,0,1018,1019,1018,1,7,0,0,3,162,162,162,162
Imperial,47,2022-11-06,184,184,184,0,3598,3604,3603,1,11,0,0,0,963,963,963,963
Inyo,47,2022-11-06,17,17,17,0,245,246,245,1,0,0,0,0,60,60,60,60
Kern,47,2022-11-06,445,445,445,0,10337,10357,10356,1,30,1,1,4,2438,2438,2437,2437
Kings,47,2022-11-06,114,114,114,0,2350,2356,2355,1,8,1,1,2,467,467,466,466
Lake,47,2022-11-06,46,46,46,0,760,761,760,1,2,0,0,2,151,151,151,151
Lassen,47,2022-11-06,14,14,14,0,418,419,418,1,0,0,0,0,64,64,64,64
Los Angeles,47,2022-11-06,7738,7752,7752,0,192112,192473,192471,2,397,54,54,51,33892,33892,33838,33838
Madera,47,2022-11-06,76,76,76,0,1555,1557,1556,1,3,0,0,5,376,376,376,376
Marin,47,2022-11-06,140,140,140,0,3484,3491,3490,1,7,0,0,0,260,260,260,260
Mariposa,47,2022-11-06,13,13,13,0,122,123,122,1,0,0,0,0,30,30,30,30
Mendocino,47,2022-11-06,33,33,33,0,809,810,809,1,4,0,0,0,136,136,136,136
Merced,47,2022-11-06,147,147,147,0,2467,2473,2472,1,6,4,4,0,879,879,875,875
Modoc,47,2022-11-06,2,2,2,0,5,6,5,1,0,0,0,0,11,11,11,11
Mono,47,2022-11-06,4,4,4,0,89,90,89,1,0,0,0,0,8,8,8,8
Monterey,47,2022-11-06,199,199,199,0,3783,3791,3790,1,16,1,1,0,775,775,774,774
Napa,47,2022-11-06,70,70,70,0,1727,1732,1731,1,3,0,0,0,161,161,161,161
Nevada,47,2022-11-06,52,52,52,0,724,725,724,1,2,0,0,1,137,137,137,137
Orange,47,2022-11-06,1247,1247,1247,0,28599,28652,28651,1,86,8,8,17,7625,7625,7617,7617
Placer,47,2022-11-06,199,199,199,0,3082,3090,3089,1,50,2,2,6,664,664,662,662
Plumas,47,2022-11-06,6,6,6,0,70,71,70,1,1,0,0,0,13,13,13,13
Riverside,47,2022-11-06,1421,1421,1421,0,20935,20974,20973,1,65,3,3,7,6663,6663,6660,6660
Sacramento,47,2022-11-06,1031,1031,1031,0,15488,15519,15518,1,88,7,7,10,3390,3390,3383,3383
San Benito,47,2022-11-06,41,41,41,0,867,868,867,1,1,0,0,0,104,104,104,104
San Bernardino,47,2022-11-06,1363,1363,1363,0,23548,23591,23590,1,67,2,2,17,8110,8110,8108,8108
San Diego,47,2022-11-06,2006,2010,2010,0,44478,44562,44561,1,123,7,7,23,5610,5610,5603,5603
San Francisco,47,2022-11-06,707,707,707,0,14702,14729,14728,1,45,2,2,7,1078,1078,1076,1076
San Joaquin,47,2022-11-06,464,464,464,0,8737,8754,8753,1,19,5,5,3,2356,2356,2351,2351
San Luis Obispo,47,2022-11-06,125,125,125,0,2197,2203,2202,1,5,0,0,2,530,530,530,530
San Mateo,47,2022-11-06,572,572,572,0,12186,12209,12208,1,25,0,0,3,743,743,743,743
Santa Barbara,47,2022-11-06,195,195,195,0,6685,6699,6698,1,17,2,2,2,736,736,734,734
Santa Clara,47,2022-11-06,1618,1619,1619,0,31145,31205,31204,1,79,7,7,15,2576,2576,2569,2569
Santa Cruz,47,2022-11-06,265,265,265,0,10549,10569,10568,1,7,0,0,1,275,275,275,275
Shasta,47,2022-11-06,89,89,89,0,936,937,936,1,11,1,1,3,599,599,598,598
Siskiyou,47,2022-11-06,17,17,17,0,282,283,282,1,2,0,0,1,95,95,95,95
Solano,47,2022-11-06,346,346,346,0,5542,5553,5552,1,26,2,2,3,463,463,461,461
Sonoma,47,2022-11-06,223,223,223,0,5778,5791,5790,1,13,2,2,2,532,532,530,530
Stanislaus,47,2022-11-06,288,288,288,0,4831,4841,4840,1,41,3,3,6,1798,1798,1795,1795
Sutter,47,2022-11-06,76,76,76,0,935,936,935,1,0,0,0,0,235,235,235,235
Tehama,47,2022-11-06,50,50,50,0,460,461,460,1,2,0,0,0,218,218,218,218
Trinity,47,2022-11-06,2,2,2,0,34,35,34,1,0,0,0,0,21,21,21,21
Tulare,47,2022-11-06,156,156,156,0,4158,4166,4165,1,12,0,0,0,1551,1551,1551,1551
Tuolumne,47,2022-11-06,78,78,78,0,628,629,628,1,2,0,0,0,202,202,202,202
Ventura,47,2022-11-06,432,432,432,0,9926,9946,9945,1,43,3,3,1,1609,1609,1606,1606
Yolo,47,2022-11-06,182,182,182,0,2216,2221,2220,1,3,3,3,0,409,409,406,406
Yuba,47,2022-11-06,47,47,47,0,859,860,859,1,4,0,0,0,133,133,133,133
Alameda,48,2022-11-13,1422,1422,1422,0,23813,23861,23860,1,76,2,2,8,2023,2023,2021,2021
Amador,48,2022-11-13,22,22,22,0,636,637,636,1,2,0,0,0,94,94,94,94
Butte,48,2022-11-13,123,123,123,0,1328,1330,1329,1,15,0,0,0,467,467,467,467
Calaveras,48,2022-11-13,31,31,31,0,335,336,335,1,0,0,0,0,135,135,135,135
Colusa,48,2022-11-13,9,9,9,0,99,100,99,1,1,0,0,0,22,22,22,22
Contra Costa,48,2022-11-13,929,929,929,0,15756,15788,15787,1,51,2,2,6,1489,1489,1487,1487
Del Norte,48,2022-11-13,23,23,23,0,422,423,422,1,1,0,0,0,55,55,55,55
El Dorado,48,2022-11-13,133,133,133,0,1593,1596,1595,1,8,0,0,1,236,236,236,236
Fresno,48,2022-11-13,722,722,722,0,10994,11015,11014,1,73,7,7,12,2902,2902,2895,2895
Glenn,48,2022-11-13,29,29,29,0,142,143,142,1,0,0,0,0,56,56,56,56
Humboldt,48,2022-11-13,79,79,79,0,1080,1081,1080,1,5,0,0,1,162,162,162,162
Imperial,48,2022-11-13,238,238,238,0,3282,3288,3287,1,4,0,0,1,963,963,963,963
Inyo,48,2022-11-13,8,8,8,0,451,452,451,1,0,0,0,0,60,60,60,60
Kern,48,2022-11-13,460,460,460,0,10963,10986,10985,1,29,1,1,5,2439,2439,2438,2438
Kings,48,2022-11-13,204,204,204,0,2584,2589,2588,1,7,2,2,0,469,469,467,467
Lake,48,2022-11-13,46,46,46,0,794,795,794,1,0,0,0,0,151,151,151,151
Lassen,48,2022-11-13,20,20,20,0,524,525,524,1,0,1,1,0,65,65,64,64
Los Angeles,48,2022-11-13,9120,9139,9139,0,193882,194267,194265,2,508,45,45,72,33937,33937,33892,33892
Madera,48,2022-11-13,89,89,89,0,1662,1667,1666,1,5,0,0,2,376,376,376,376
Marin,48,2022-11-13,173,173,173,0,3426,3433,3432,1,11,0,0,0,260,260,260,260
Mariposa,48,2022-11-13,16,16,16,0,123,124,123,1,0,0,0,0,30,30,30,30
Mendocino,48,2022-11-13,36,36,36,0,852,853,852,1,2,1,1,1,137,137,136,136
Merced,48,2022-11-13,174,174,174,0,2561,2567,2566,1,7,0,0,1,879,879,879,879
Modoc,48,2022-11-13,3,3,3,0,12,13,12,1,1,0,0,0,11,11,11,11
Mono,48,2022-11-13,10,10,10,0,112,113,112,1,0,0,0,0,8,8,8,8
Monterey,48,2022-11-13,205,205,205,0,4071,4080,4079,1,23,0,0,1,775,775,775,775
Napa,48,2022-11-13,109,109,109,0,1858,1863,1862,1,5,0,0,0,161,161,161,161
Nevada,48,2022-11-13,58,58,58,0,761,762,761,1,2,0,0,2,137,137,137,137
Orange,48,2022-11-13,1537,1538,1538,0,26910,26963,26962,1,106,10,10,21,7635,7635,7625,7625
Placer,48,2022-11-13,304,304,304,0,3731,3739,3738,1,59,1,1,6,665,665,664,664
Plumas,48,2022-11-13,3,3,3,0,83,84,83,1,1,0,0,0,13,13,13,13
Riverside,48,2022-11-13,1582,1584,1584,0,22163,22208,22207,1,85,4,4,11,6667,6667,6663,6663
Sacramento,48,2022-11-13,1185,1185,1185,0,16545,16577,16576,1,86,7,7,13,3397,3397,3390,3390
San Benito,48,2022-11-13,41,41,41,0,924,925,924,1,1,0,0,0,104,104,104,104
San Bernardino,48,2022-11-13,1717,1720,1720,0,23879,23925,23924,1,80,0,0,16,8110,8110,8110,8110
San Diego,48,2022-11-13,2387,2393,2393,0,43879,43966,43965,1,132,6,6,26,5616,5616,5610,5610
San Francisco,48,2022-11-13,711,711,711,0,13676,13703,13702,1,46,7,7,8,1085,1085,1078,1078
San Joaquin,48,2022-11-13,550,550,550,0,9010,9029,9028,1,13,1,1,5,2357,2357,2356,2356
San Luis Obispo,48,2022-11-13,118,118,118,0,2201,2206,2205,1,3,0,0,1,530,530,530,530
San Mateo,48,2022-11-13,635,635,635,0,11436,11462,11461,1,23,0,0,1,743,743,743,743
Santa Barbara,48,2022-11-13,186,186,186,0,5813,5825,5824,1,16,1,1,1,737,737,736,736
Santa Clara,48,2022-11-13,1690,1693,1693,0,30757,30819,30818,1,118,3,3,17,2579,2579,2576,2576
Santa Cruz,48,2022-11-13,256,256,256,0,9802,9822,9821,1,12,1,1,0,276,276,275,275
Shasta,48,2022-11-13,105,105,105,0,1080,1082,1081,1,9,1,1,2,600,600,599,599
Siskiyou,48,2022-11-13,20,20,20,0,350,351,350,1,2,0,0,1,95,95,95,95
Solano,48,2022-11-13,439,439,439,0,5430,5442,5441,1,30,0,0,1,463,463,463,463
Sonoma,48,2022-11-13,279,279,279,0,6022,6035,6034,1,14,1,1,1,533,533,532,532
Stanislaus,48,2022-11-13,320,320,320,0,5145,5157,5156,1,44,0,0,8,1798,1798,1798,1798
Sutter,48,2022-11-13,102,102,102,0,1130,1132,1131,1,0,0,0,0,235,235,235,235
Tehama,48,2022-11-13,38,38,38,0,518,519,518,1,2,0,0,0,218,218,218,218
Trinity,48,2022-11-13,10,10,10,0,52,53,52,1,0,2,2,0,23,23,21,21
Tulare,48,2022-11-13,279,279,279,0,4383,4391,4390,1,14,0,0,1,1551,1551,1551,1551
Tuolumne,48,2022-11-13,76,76,76,0,688,689,688,1,4,0,0,0,202,202,202,202
Ventura,48,2022-11-13,544,544,544,0,10566,10587,10586,1,35,1,1,2,1610,1610,1609,1609
Yolo,48,2022-11-13,141,141,141,0,2136,2141,2140,1,0,5,5,0,414,414,409,409
Yuba,48,2022-11-13,54,54,54,0,981,982,981,1,5,0,0,1,133,133,133,133
Alameda,49,2022-11-20,1717,1720,1720,0,25999,26052,26051,1,81,9,9,16,2032,2032,2023,2023
Amador,49,2022-11-20,28,28,28,0,809,810,809,1,2,0,0,0,94,94,94,94
Butte,49,2022-11-20,141,141,141,0,1349,1351,1350,1,23,0,0,1,467,467,467,467
Calaveras,49,2022-11-20,35,35,35,0,420,421,420,1,1,0,0,0,135,135,135,135
Colusa,49,2022-11-20,9,9,9,0,105,106,105,1,0,0,0,0,22,22,22,22
Contra Costa,49,2022-11-20,1012,1012,1012,0,16741,16775,16774,1,43,3,3,8,1492,1492,1489,1489
Del Norte,49,2022-11-20,15,15,15,0,503,504,503,1,4,0,0,0,55,55,55,55
El Dorado,49,2022-11-20,158,158,158,0,1790,1796,1795,1,11,0,0,1,236,236,236,236
Fresno,49,2022-11-20,1041,1041,1041,0,12324,12349,12348,1,105,6,6,11,2908,2908,2902,2902
Glenn,49,2022-11-20,24,24,24,0,193,194,193,1,0,0,0,0,56,56,56,56
Humboldt,49,2022-11-20,120,120,120,0,1128,1129,1128,1,3,1,1,1,163,163,162,162
Imperial,49,2022-11-20,277,277,277,0,3304,3311,3310,1,5,1,1,1,964,964,963,963
Inyo,49,2022-11-20,27,27,27,0,461,462,461,1,0,1,1,0,61,61,60,60
Kern,49,2022-11-20,513,513,513,0,10712,10736,10735,1,55,3,3,9,2442,2442,2439,2439
Kings,49,2022-11-20,287,287,287,0,2872,2879,2878,1,4,2,2,0,471,471,469,469
Lake,49,2022-11-20,65,65,65,0,977,978,977,1,0,1,1,1,152,152,151,151
Lassen,49,2022-11-20,49,49,49,0,594,595,594,1,0,0,0,0,65,65,65,65
Los Angeles,49,2022-11-20,12301,12327,12327,0,205695,206123,206121,2,673,71,71,87,34008,34008,33937,33937
Madera,49,2022-11-20,167,167,167,0,1914,1920,1919,1,14,0,0,0,376,376,376,376
Marin,49,2022-11-20,183,183,183,0,3573,3580,3579,1,8,0,0,0,260,260,260,260
Mariposa,49,2022-11-20,18,18,18,0,173,174,173,1,0,0,0,0,30,30,30,30
Mendocino,49,2022-11-20,44,44,44,0,981,982,981,1,4,0,0,0,137,137,137,137
Merced,49,2022-11-20,231,231,231,0,3009,3015,3014,1,6,1,1,3,880,880,879,879
Modoc,49,2022-11-20,4,4,4,0,8,9,8,1,1,0,0,0,11,11,11,11
Mono,49,2022-11-20,1,1,1,0,115,116,115,1,0,0,0,0,8,8,8,8
Monterey,49,2022-11-20,232,232,232,0,4504,4515,4514,1,12,2,2,1,777,777,775,775
Napa,49,2022-11-20,141,141,141,0,2118,2124,2123,1,4,0,0,0,161,161,161,161
Nevada,49,2022-11-20,84,84,84,0,973,974,973,1,2,0,0,2,137,137,137,137
Orange,49,2022-11-20,2121,2126,2126,0,28943,29003,29002,1,156,13,13,29,7648,7648,7635,7635
Placer,49,2022-11-20,369,369,369,0,4271,4280,4279,1,50,0,0,7,665,665,665,665
Plumas,49,2022-11-20,7,7,7,0,99,100,99,1,1,0,0,0,13,13,13,13
Riverside,49,2022-11-20,2150,2156,2156,0,24639,24691,24690,1,97,5,5,12,6672,6672,6667,6667
Sacramento,49,2022-11-20,1514,1518,1518,0,19377,19418,19417,1,95,4,4,17,3401,3401,3397,3397
San Benito,49,2022-11-20,54,54,54,0,1077,1078,1077,1,0,0,0,0,104,104,104,104
San Bernardino,49,2022-11-20,2256,2262,2262,0,26790,26846,26845,1,81,1,1,22,8111,8111,8110,8110
San Diego,49,2022-11-20,3072,3079,3079,0,46408,46503,46502,1,176,5,5,24,5621,5621,5616,5616
San Francisco,49,2022-11-20,890,890,890,0,15396,15428,15427,1,53,6,6,8,1091,1091,1085,1085
San Joaquin,49,2022-11-20,788,788,788,0,11074,11099,11098,1,34,1,1,5,2358,2358,2357,2357
San Luis Obispo,49,2022-11-20,158,158,158,0,2317,2323,2322,1,9,0,0,1,530,530,530,530
San Mateo,49,2022-11-20,738,738,738,0,12370,12397,12396,1,27,0,0,1,743,743,743,743
Santa Barbara,49,2022-11-20,319,319,319,0,6224,6237,6236,1,18,3,3,6,740,740,737,737
Santa Clara,49,2022-11-20,2183,2188,2188,0,35107,35182,35181,1,111,9,9,23,2588,2588,2579,2579
Santa Cruz,49,2022-11-20,280,280,280,0,10615,10636,10635,1,13,0,0,3,276,276,276,276
Shasta,49,2022-11-20,103,103,103,0,1077,1079,1078,1,11,2,2,2,602,602,600,600
Siskiyou,49,2022-11-20,29,29,29,0,397,398,397,1,1,0,0,1,95,95,95,95
Solano,49,2022-11-20,476,476,476,0,5781,5794,5793,1,30,1,1,5,464,464,463,463
Sonoma,49,2022-11-20,321,321,321,0,6082,6095,6094,1,18,0,0,4,533,533,533,533
Stanislaus,49,2022-11-20,416,416,416,0,5941,5954,5953,1,53,0,0,9,1798,1798,1798,1798
Sutter,49,2022-11-20,87,87,87,0,1157,1159,1158,1,0,0,0,0,235,235,235,235
Tehama,49,2022-11-20,80,80,80,0,694,695,694,1,1,0,0,2,218,218,218,218
Trinity,49,2022-11-20,6,6,6,0,49,50,49,1,0,0,0,0,23,23,23,23
Tulare,49,2022-11-20,429,429,429,0,5377,5390,5389,1,22,0,0,0,1551,1551,1551,1551
Tuolumne,49,2022-11-20,97,97,97,0,789,790,789,1,1,1,1,0,203,203,202,202
Ventura,49,2022-11-20,712,712,712,0,11106,11130,11129,1,34,1,1,1,1611,1611,1610,1610
Yolo,49,2022-11-20,132,132,132,0,2278,2284,2283,1,7,4,4,2,418,418,414,414
Yuba,49,2022-11-20,79,79,79,0,1059,1060,1059,1,7,0,0,1,133,133,133,133
Alameda,50,2022-11-27,2027,2033,2033,0,20798,20843,20842,1,93,4,4,15,2036,2036,2032,2032
Amador,50,2022-11-27,30,30,30,0,760,761,760,1,5,1,1,1,95,95,94,94
Butte,50,2022-11-27,190,190,190,0,1364,1368,1367,1,40,0,0,1,467,467,467,467
Calaveras,50,2022-11-27,34,34,34,0,385,386,385,1,3,0,0,0,135,135,135,135
Colusa,50,2022-11-27,13,13,13,0,119,120,119,1,0,0,0,0,22,22,22,22
Contra Costa,50,2022-11-27,1323,1325,1325,0,14735,14766,14765,1,62,3,3,7,1495,1495,1492,1492
Del Norte,50,2022-11-27,27,27,27,0,434,435,434,1,1,1,1,0,56,56,55,55
El Dorado,50,2022-11-27,195,195,195,0,1426,1430,1429,1,9,1,1,1,237,237,236,236
Fresno,50,2022-11-27,1192,1192,1192,0,10970,10994,10993,1,124,5,5,21,2913,2913,2908,2908
Glenn,50,2022-11-27,21,21,21,0,207,208,207,1,2,0,0,0,56,56,56,56
Humboldt,50,2022-11-27,118,118,118,0,1037,1039,1038,1,8,0,0,0,163,163,163,163
Imperial,50,2022-11-27,354,354,354,0,2457,2462,2461,1,6,1,1,3,965,965,964,964
Inyo,50,2022-11-27,33,33,33,0,366,367,366,1,1,0,0,0,61,61,61,61
Kern,50,2022-11-27,548,548,548,0,8804,8825,8824,1,56,4,4,7,2446,2446,2442,2442
Kings,50,2022-11-27,221,221,221,0,2419,2425,2424,1,10,0,0,0,471,471,471,471
Lake,50,2022-11-27,46,46,46,0,815,816,815,1,1,0,0,0,152,152,152,152
Lassen,50,2022-11-27,21,21,21,0,484,485,484,1,0,0,0,0,65,65,65,65
Los Angeles,50,2022-11-27,16719,16756,16756,0,163566,163921,163919,2,897,82,82,110,34090,34090,34008,34008
Madera,50,2022-11-27,131,131,131,0,1488,1492,1491,1,11,0,0,2,376,376,376,376
Marin,50,2022-11-27,268,268,268,0,2797,2804,2803,1,14,0,0,1,260,260,260,260
Mariposa,50,2022-11-27,23,23,23,0,132,133,132,1,0,0,0,0,30,30,30,30
Mendocino,50,2022-11-27,40,40,40,0,691,692,691,1,4,0,0,2,137,137,137,137
Merced,50,2022-11-27,314,314,314,0,2357,2364,2363,1,11,5,5,1,885,885,880,880
Modoc,50,2022-11-27,7,7,7,0,14,15,14,1,1,0,0,0,11,11,11,11
Mono,50,2022-11-27,6,6,6,0,99,100,99,1,0,0,0,0,8,8,8,8
Monterey,50,2022-11-27,261,261,261,0,3772,3781,3780,1,26,0,0,0,777,777,777,777
Napa,50,2022-11-27,127,127,127,0,1773,1777,1776,1,3,0,0,2,161,161,161,161
Nevada,50,2022-11-27,117,117,117,0,927,928,927,1,8,0,0,0,137,137,137,137
Orange,50,2022-11-27,2804,2810,2810,0,24917,24972,24971,1,214,15,15,34,7663,7663,7648,7648
Placer,50,2022-11-27,356,356,356,0,3498,3505,3504,1,65,3,3,5,668,668,665,665
Plumas,50,2022-11-27,5,5,5,0,127,128,127,1,0,0,0,0,13,13,13,13
Riverside,50,2022-11-27,2800,2806,2806,0,22000,22048,22047,1,151,12,12,21,6684,6684,6672,6672
Sacramento,50,2022-11-27,1649,1653,1653,0,17103,17140,17139,1,126,8,8,10,3409,3409,3401,3401
San Benito,50,2022-11-27,108,108,108,0,1175,1178,1177,1,1,0,0,0,104,104,104,104
San Bernardino,50,2022-11-27,2975,2981,2981,0,24800,24854,24853,1,129,1,1,26,8112,8112,8111,8111
San Diego,50,2022-11-27,3530,3536,3536,0,29470,29535,29534,1,219,7,7,25,5628,5628,5621,5621
San Francisco,50,2022-11-27,1071,1071,1071,0,12076,12102,12101,1,64,6,6,9,1097,1097,1091,1091
San Joaquin,50,2022-11-27,852,852,852,0,10366,10389,10388,1,49,3,3,11,2361,2361,2358,2358
San Luis Obispo,50,2022-11-27,139,139,139,0,2147,2151,2150,1,7,4,4,0,534,534,530,530
San Mateo,50,2022-11-27,949,949,949,0,10398,10422,10421,1,46,1,1,2,744,744,743,743
Santa Barbara,50,2022-11-27,422,422,422,0,4967,4978,4977,1,23,2,2,6,742,742,740,740
Santa Clara,50,2022-11-27,2655,2661,2661,0,26564,26623,26622,1,141,9,9,23,2597,2597,2588,2588
Santa Cruz,50,2022-11-27,293,293,293,0,5032,5044,5043,1,19,0,0,2,276,276,276,276
Shasta,50,2022-11-27,97,97,97,0,972,974,973,1,14,2,2,3,604,604,602,602
Siskiyou,50,2022-11-27,24,24,24,0,249,250,249,1,1,0,0,1,95,95,95,95
Solano,50,2022-11-27,561,561,561,0,4993,5005,5004,1,31,2,2,6,466,466,464,464
Sonoma,50,2022-11-27,407,407,407,0,4754,4766,4765,1,48,1,1,3,534,534,533,533
Stanislaus,50,2022-11-27,502,502,502,0,5323,5335,5334,1,73,3,3,8,1801,1801,1798,1798
Sutter,50,2022-11-27,80,80,80,0,1068,1070,1069,1,0,0,0,0,235,235,235,235
Tehama,50,2022-11-27,60,60,60,0,550,551,550,1,5,0,0,3,218,218,218,218
Trinity,50,2022-11-27,2,2,2,0,47,48,47,1,0,0,0,0,23,23,23,23
Tulare,50,2022-11-27,430,430,430,0,4640,4652,4651,1,34,0,0,0,1551,1551,1551,1551
Tuolumne,50,2022-11-27,77,77,77,0,621,622,621,1,3,0,0,0,203,203,203,203
Ventura,50,2022-11-27,858,858,858,0,9937,9959,9958,1,43,2,2,2,1613,1613,1611,1611
Yolo,50,2022-11-27,157,157,157,0,1941,1946,1945,1,3,4,4,2,422,422,418,418
Yuba,50,2022-11-27,77,77,77,0,869,870,869,1,9,0,0,0,133,133,133,133
Alameda,51,2022-12-04,2874,2881,2881,0,29503,29571,29570,1,111,7,7,18,2043,2043,2036,2036
Amador,51,2022-12-04,42,42,42,0,825,827,826,1,3,0,0,1,95,95,95,95
Butte,51,2022-12-04,222,222,222,0,1822,1827,1826,1,36,6,6,2,473,473,467,467
Calaveras,51,2022-12-04,40,40,40,0,483,484,483,1,0,0,0,1,135,135,135,135
Colusa,51,2022-12-04,14,14,14,0,261,262,261,1,4,0,0,0,22,22,22,22
Contra Costa,51,2022-12-04,1778,1783,1783,0,19119,19163,19162,1,87,1,1,11,1496,1496,1495,1495
Del Norte,51,2022-12-04,46,46,46,0,571,572,571,1,2,0,0,1,56,56,56,56
El Dorado,51,2022-12-04,202,202,202,0,1791,1797,1796,1,10,1,1,0,238,238,237,237
Fresno,51,2022-12-04,1587,1591,1591,0,14542,14575,14574,1,175,7,7,17,2920,2920,2913,2913
Glenn,51,2022-12-04,20,20,20,0,219,220,219,1,2,0,0,0,56,56,56,56
Humboldt,51,2022-12-04,135,135,135,0,1119,1121,1120,1,13,0,0,2,163,163,163,163
Imperial,51,2022-12-04,595,595,595,0,3675,3684,3683,1,23,1,1,2,966,966,965,965
Inyo,51,2022-12-04,32,32,32,0,347,348,347,1,0,1,1,0,62,62,61,61
Kern,51,2022-12-04,836,836,836,0,11359,11385,11384,1,53,2,2,8,2448,2448,2446,2446
Kings,51,2022-12-04,311,311,311,0,3069,3077,3076,1,8,0,0,0,471,471,471,471
Lake,51,2022-12-04,64,64,64,0,854,855,854,1,2,0,0,0,152,152,152,152
Lassen,51,2022-12-04,18,18,18,0,485,486,485,1,0,0,0,0,65,65,65,65
Los Angeles,51,2022-12-04,23776,23831,23831,0,253059,253635,253632,3,1104,103,103,135,34193,34193,34090,34090
Madera,51,2022-12-04,226,226,226,0,2097,2103,2102,1,11,0,0,3,376,376,376,376
Marin,51,2022-12-04,305,305,305,0,3555,3564,3563,1,13,0,0,1,260,260,260,260
Mariposa,51,2022-12-04,20,20,20,0,170,171,170,1,0,0,0,0,30,30,30,30
Mendocino,51,2022-12-04,53,53,53,0,812,813,812,1,6,1,1,4,138,138,137,137
Merced,51,2022-12-04,411,411,411,0,3276,3285,3284,1,22,3,3,3,888,888,885,885
Modoc,51,2022-12-04,12,12,12,0,11,12,11,1,1,0,0,0,11,11,11,11
Mono,51,2022-12-04,8,8,8,0,98,99,98,1,0,0,0,0,8,8,8,8
Monterey,51,2022-12-04,292,292,292,0,4521,4532,4531,1,26,2,2,1,779,779,777,777
Napa,51,2022-12-04,173,173,173,0,2279,2285,2284,1,4,0,0,0,161,161,161,161
Nevada,51,2022-12-04,121,121,121,0,1171,1174,1173,1,0,0,0,2,137,137,137,137
Orange,51,2022-12-04,4519,4529,4529,0,35228,35308,35307,1,295,22,22,48,7685,7685,7663,7663
Placer,51,2022-12-04,419,419,419,0,4182,4192,4191,1,70,1,1,4,669,669,668,668
Plumas,51,2022-12-04,21,21,21,0,158,159,158,1,0,0,0,0,13,13,13,13
Riverside,51,2022-12-04,4207,4217,4217,0,28768,28833,28832,1,174,13,13,22,6697,6697,6684,6684
Sacramento,51,2022-12-04,2261,2267,2267,0,21508,21557,21556,1,123,9,9,26,3418,3418,3409,3409
San Benito,51,2022-12-04,244,244,244,0,1542,1546,1545,1,6,1,1,2,105,105,104,104
San Bernardino,51,2022-12-04,4249,4258,4258,0,29357,29424,29423,1,145,0,0,33,8112,8112,8112,8112
San Diego,51,2022-12-04,5871,5884,5884,0,45381,45484,45483,1,279,12,12,28,5640,5640,5628,5628
San Francisco,51,2022-12-04,1504,1508,1508,0,16185,16222,16221,1,73,6,6,9,1103,1103,1097,1097
San Joaquin,51,2022-12-04,1203,1204,1204,0,12610,12638,12637,1,68,9,9,12,2370,2370,2361,2361
San Luis Obispo,51,2022-12-04,237,237,237,0,2724,2730,2729,1,16,3,3,1,537,537,534,534
San Mateo,51,2022-12-04,1371,1373,1373,0,13835,13867,13866,1,54,1,1,2,745,745,744,744
Santa Barbara,51,2022-12-04,530,530,530,0,6890,6906,6905,1,29,1,1,11,743,743,742,742
Santa Clara,51,2022-12-04,3572,3580,3580,0,36124,36207,36206,1,189,10,10,25,2607,2607,2597,2597
Santa Cruz,51,2022-12-04,555,555,555,0,12131,12161,12160,1,24,0,0,2,276,276,276,276
Shasta,51,2022-12-04,133,133,133,0,1121,1123,1122,1,27,0,0,5,604,604,604,604
Siskiyou,51,2022-12-04,22,22,22,0,341,342,341,1,2,0,0,1,95,95,95,95
Solano,51,2022-12-04,640,640,640,0,6474,6490,6489,1,30,1,1,5,467,467,466,466
Sonoma,51,2022-12-04,516,516,516,0,5934,5949,5948,1,36,6,6,1,540,540,534,534
Stanislaus,51,2022-12-04,633,633,633,0,6568,6582,6581,1,77,0,0,11,1801,1801,1801,1801
Sutter,51,2022-12-04,96,96,96,0,1228,1231,1230,1,0,1,1,0,236,236,235,235
Tehama,51,2022-12-04,99,99,99,0,838,839,838,1,7,2,2,0,220,220,218,218
Trinity,51,2022-12-04,4,4,4,0,56,57,56,1,0,0,0,0,23,23,23,23
Tulare,51,2022-12-04,566,566,566,0,5956,5971,5970,1,38,0,0,1,1551,1551,1551,1551
Tuolumne,51,2022-12-04,91,91,91,0,862,863,862,1,4,0,0,0,203,203,203,203
Ventura,51,2022-12-04,1171,1172,1172,0,12411,12439,12438,1,69,2,2,4,1615,1615,1613,1613
Yolo,51,2022-12-04,206,206,206,0,2613,2619,2618,1,3,2,2,3,424,424,422,422
Yuba,51,2022-12-04,92,92,92,0,1057,1058,1057,1,13,0,0,0,133,133,133,133
Alameda,52,2022-12-11,2814,2821,2821,0,29617,29688,29687,1,138,7,7,17,2050,2050,2043,2043
Amador,52,2022-12-11,34,34,34,0,793,794,793,1,1,0,0,0,95,95,95,95
Butte,52,2022-12-11,217,217,217,0,1954,1960,1959,1,43,3,3,3,476,476,473,473
Calaveras,52,2022-12-11,42,42,42,0,463,464,463,1,1,0,0,1,135,135,135,135
Colusa,52,2022-12-11,13,13,13,0,231,232,231,1,0,0,0,0,22,22,22,22
Contra Costa,52,2022-12-11,1747,1752,1752,0,18554,18598,18597,1,83,9,9,5,1505,1505,1496,1496
Del Norte,52,2022-12-11,32,32,32,0,538,539,538,1,2,0,0,0,56,56,56,56
El Dorado,52,2022-12-11,145,145,145,0,1351,1354,1353,1,9,0,0,3,238,238,238,238
Fresno,52,2022-12-11,1540,1545,1545,0,14134,14169,14168,1,178,10,10,15,2930,2930,2920,2920
Glenn,52,2022-12-11,20,20,20,0,251,252,251,1,6,0,0,0,56,56,56,56
Humboldt,52,2022-12-11,127,127,127,0,1061,1063,1062,1,12,2,2,2,165,165,163,163
Imperial,52,2022-12-11,463,463,463,0,2993,3001,3000,1,24,4,4,4,970,970,966,966
Inyo,52,2022-12-11,23,23,23,0,296,297,296,1,1,0,0,0,62,62,62,62
Kern,52,2022-12-11,883,883,883,0,10954,10981,10980,1,57,2,2,5,2450,2450,2448,2448
Kings,52,2022-12-11,280,280,280,0,2904,2912,2911,1,7,2,2,1,473,473,471,471
Lake,52,2022-12-11,63,63,63,0,802,803,802,1,2,0,0,1,152,152,152,152
Lassen,52,2022-12-11,15,15,15,0,401,402,401,1,0,0,0,0,65,65,65,65
Los Angeles,52,2022-12-11,18225,18268,18268,0,230444,230998,230995,3,1087,157,157,139,34350,34350,34193,34193
Madera,52,2022-12-11,198,198,198,0,2034,2040,2039,1,15,0,0,2,376,376,376,376
Marin,52,2022-12-11,320,320,320,0,3650,3660,3659,1,18,0,0,1,260,260,260,260
Mariposa,52,2022-12-11,20,20,20,0,120,121,120,1,0,0,0,0,30,30,30,30
Mendocino,52,2022-12-11,50,50,50,0,690,691,690,1,6,1,1,1,139,139,138,138
Merced,52,2022-12-11,307,307,307,0,3341,3350,3349,1,13,0,0,1,888,888,888,888
Modoc,52,2022-12-11,7,7,7,0,9,10,9,1,0,0,0,0,11,11,11,11
Mono,52,2022-12-11,9,9,9,0,112,113,112,1,0,0,0,0,8,8,8,8
Monterey,52,2022-12-11,245,245,245,0,4260,4271,4270,1,22,3,3,2,782,782,779,779
Napa,52,2022-12-11,147,147,147,0,2335,2341,2340,1,8,0,0,0,161,161,161,161
Nevada,52,2022-12-11,99,99,99,0,984,987,986,1,5,0,0,2,137,137,137,137
Orange,52,2022-12-11,3534,3543,3543,0,31505,31581,31580,1,278,32,32,46,7717,7717,7685,7685
Placer,52,2022-12-11,349,349,349,0,3892,3903,3902,1,65,4,4,9,673,673,669,669
Plumas,52,2022-12-11,8,8,8,0,210,211,210,1,1,0,0,0,13,13,13,13
Riverside,52,2022-12-11,3476,3484,3484,0,24967,25027,25026,1,196,19,19,22,6716,6716,6697,6697
Sacramento,52,2022-12-11,1841,1847,1847,0,20306,20355,20354,1,163,6,6,28,3424,3424,3418,3418
San Benito,52,2022-12-11,131,131,131,0,1340,1344,1343,1,3,2,2,1,107,107,105,105
San Bernardino,52,2022-12-11,3756,3765,3765,0,27466,27533,27532,1,218,4,4,35,8116,8116,8112,8112
San Diego,52,2022-12-11,5030,5043,5043,0,41636,41736,41735,1,300,14,14,43,5654,5654,5640,5640
San Francisco,52,2022-12-11,1453,1457,1457,0,16483,16522,16521,1,105,8,8,11,1111,1111,1103,1103
San Joaquin,52,2022-12-11,997,997,997,0,12550,12580,12579,1,68,6,6,16,2376,2376,2370,2370
San Luis Obispo,52,2022-12-11,215,215,215,0,2668,2674,2673,1,9,1,1,0,538,538,537,537
San Mateo,52,2022-12-11,1176,1177,1177,0,13197,13230,13229,1,61,1,1,4,746,746,745,745
Santa Barbara,52,2022-12-11,500,500,500,0,5973,5988,5987,1,32,2,2,7,745,745,743,743
Santa Clara,52,2022-12-11,3284,3292,3292,0,35387,35474,35473,1,177,19,19,34,2626,2626,2607,2607
Santa Cruz,52,2022-12-11,524,524,524,0,13594,13628,13627,1,27,0,0,1,276,276,276,276
Shasta,52,2022-12-11,110,110,110,0,1180,1182,1181,1,24,0,0,5,604,604,604,604
Siskiyou,52,2022-12-11,16,16,16,0,228,229,228,1,2,0,0,1,95,95,95,95
Solano,52,2022-12-11,651,651,651,0,6427,6443,6442,1,41,2,2,8,469,469,467,467
Sonoma,52,2022-12-11,529,529,529,0,5630,5645,5644,1,34,2,2,5,542,542,540,540
Stanislaus,52,2022-12-11,603,603,603,0,6382,6397,6396,1,104,7,7,11,1808,1808,1801,1801
Sutter,52,2022-12-11,117,117,117,0,1191,1193,1192,1,0,0,0,0,236,236,236,236
Tehama,52,2022-12-11,81,81,81,0,815,816,815,1,6,1,1,0,221,221,220,220
Trinity,52,2022-12-11,2,2,2,0,40,41,40,1,0,0,0,0,23,23,23,23
Tulare,52,2022-12-11,454,454,454,0,5932,5948,5947,1,20,2,2,2,1553,1553,1551,1551
Tuolumne,52,2022-12-11,140,140,140,0,941,942,941,1,5,0,0,1,203,203,203,203
Ventura,52,2022-12-11,921,921,921,0,10868,10894,10893,1,66,4,4,8,1619,1619,1615,1615
Yolo,52,2022-12-11,233,233,233,0,2444,2451,2450,1,8,2,2,1,426,426,424,424
Yuba,52,2022-12-11,67,67,67,0,981,982,981,1,12,0,0,0,133,133,133,133
Alameda,53,2022-12-18,2369,2376,2376,0,27886,27957,27956,1,152,10,10,18,2060,2060,2050,2050
Amador,53,2022-12-18,38,38,38,0,811,812,811,1,5,0,0,0,95,95,95,95
Butte,53,2022-12-18,137,137,137,0,1706,1711,1710,1,35,2,2,3,478,478,476,476
Calaveras,53,2022-12-18,34,34,34,0,458,459,458,1,1,1,1,1,136,136,135,135
Colusa,53,2022-12-18,12,12,12,0,213,214,213,1,1,0,0,0,22,22,22,22
Contra Costa,53,2022-12-18,1747,1752,1752,0,18034,18080,18079,1,83,8,8,9,1513,1513,1505,1505
Del Norte,53,2022-12-18,38,38,38,0,560,561,560,1,4,0,0,0,56,56,56,56
El Dorado,53,2022-12-18,157,157,157,0,1651,1657,1656,1,7,2,2,3,240,240,238,238
Fresno,53,2022-12-18,1218,1220,1220,0,12821,12853,12852,1,192,7,7,17,2937,2937,2930,2930
Glenn,53,2022-12-18,21,21,21,0,205,206,205,1,2,0,0,0,56,56,56,56
Humboldt,53,2022-12-18,116,116,116,0,947,948,947,1,10,0,0,1,165,165,165,165
Imperial,53,2022-12-18,285,285,285,0,2554,2560,2559,1,14,1,1,2,971,971,970,970
Inyo,53,2022-12-18,10,10,10,0,338,339,338,1,1,0,0,0,62,62,62,62
Kern,53,2022-12-18,986,987,987,0,10468,10497,10496,1,56,3,3,6,2453,2453,2450,2450
Kings,53,2022-12-18,213,213,213,0,2768,2776,2775,1,8,3,3,1,476,476,473,473
Lake,53,2022-12-18,61,61,61,0,774,775,774,1,5,0,0,0,152,152,152,152
Lassen,53,2022-12-18,9,9,9,0,451,452,451,1,0,0,0,0,65,65,65,65
Los Angeles,53,2022-12-18,15726,15765,15765,0,216386,216932,216930,2,1098,140,140,132,34490,34490,34350,34350
Madera,53,2022-12-18,196,196,196,0,1978,1984,1983,1,10,0,0,1,376,376,376,376
Marin,53,2022-12-18,286,286,286,0,3392,3401,3400,1,16,0,0,1,260,260,260,260
Mariposa,53,2022-12-18,24,24,24,0,142,143,142,1,0,0,0,0,30,30,30,30
Mendocino,53,2022-12-18,61,61,61,0,701,702,701,1,5,0,0,0,139,139,139,139
Merced,53,2022-12-18,283,283,283,0,2935,2944,2943,1,14,2,2,1,890,890,888,888
Modoc,53,2022-12-18,8,8,8,0,21,22,21,1,0,0,0,0,11,11,11,11
Mono,53,2022-12-18,7,7,7,0,118,119,118,1,1,0,0,0,8,8,8,8
Monterey,53,2022-12-18,248,248,248,0,4069,4081,4080,1,18,0,0,1,782,782,782,782
Napa,53,2022-12-18,168,168,168,0,2005,2012,2011,1,6,1,1,0,162,162,161,161
Nevada,53,2022-12-18,70,70,70,0,933,936,935,1,5,0,0,2,137,137,137,137
Orange,53,2022-12-18,3364,3372,3372,0,31071,31151,31150,1,314,32,32,44,7749,7749,7717,7717
Placer,53,2022-12-18,354,354,354,0,3914,3925,3924,1,80,3,3,11,676,676,673,673
Plumas,53,2022-12-18,7,7,7,0,199,200,199,1,0,0,0,0,13,13,13,13
Riverside,53,2022-12-18,3150,3157,3157,0,23206,23264,23263,1,156,20,20,22,6736,6736,6716,6716
Sacramento,53,2022-12-18,1759,1764,1764,0,19289,19336,19335,1,179,13,13,26,3437,3437,3424,3424
San Benito,53,2022-12-18,101,101,101,0,1164,1168,1167,1,2,3,3,1,110,110,107,107
San Bernardino,53,2022-12-18,3263,3271,3271,0,25532,25597,25596,1,212,4,4,34,8120,8120,8116,8116
San Diego,53,2022-12-18,4841,4853,4853,0,40253,40355,40354,1,342,16,16,40,5670,5670,5654,5654
San Francisco,53,2022-12-18,1239,1240,1240,0,16440,16483,16482,1,110,9,9,13,1120,1120,1111,1111
San Joaquin,53,2022-12-18,879,879,879,0,13298,13330,13329,1,62,9,9,15,2385,2385,2376,2376
San Luis Obispo,53,2022-12-18,252,252,252,0,2461,2467,2466,1,15,1,1,0,539,539,538,538
San Mateo,53,2022-12-18,973,974,974,0,11888,11919,11918,1,64,1,1,9,747,747,746,746
Santa Barbara,53,2022-12-18,481,481,481,0,5389,5403,5402,1,32,3,3,5,748,748,745,745
Santa Clara,53,2022-12-18,2936,2944,2944,0,33619,33704,33703,1,186,16,16,36,2642,2642,2626,2626
Santa Cruz,53,2022-12-18,343,343,343,0,12356,12388,12387,1,30,0,0,1,276,276,276,276
Shasta,53,2022-12-18,115,115,115,0,1124,1127,1126,1,26,2,2,4,606,606,604,604
Siskiyou,53,2022-12-18,14,14,14,0,270,271,270,1,2,0,0,0,95,95,95,95
Solano,53,2022-12-18,626,626,626,0,6155,6172,6171,1,40,0,0,8,469,469,469,469
Sonoma,53,2022-12-18,527,527,527,0,5486,5501,5500,1,46,1,1,1,543,543,542,542
Stanislaus,53,2022-12-18,492,492,492,0,6207,6223,6222,1,99,2,2,13,1810,1810,1808,1808
Sutter,53,2022-12-18,86,86,86,0,1085,1087,1086,1,0,0,0,0,236,236,236,236
Tehama,53,2022-12-18,71,71,71,0,677,678,677,1,6,0,0,0,221,221,221,221
Trinity,53,2022-12-18,3,3,3,0,35,36,35,1,0,0,0,0,23,23,23,23
Tulare,53,2022-12-18,456,456,456,0,5284,5300,5299,1,53,5,5,1,1558,1558,1553,1553
Tuolumne,53,2022-12-18,91,91,91,0,860,861,860,1,3,1,1,0,204,204,203,203
Ventura,53,2022-12-18,919,919,919,0,10461,10489,10488,1,76,4,4,6,1623,1623,1619,1619
Yolo,53,2022-12-18,170,170,170,0,1941,1947,1946,1,7,3,3,0,429,429,426,426
Yuba,53,2022-12-18,76,76,76,0,915,916,915,1,8,1,1,0,134,134,133,133
Alameda,54,2022-12-25,2093,2098,2098,0,23134,23195,23194,1,133,11,11,23,2071,2071,2060,2060
Amador,54,2022-12-25,43,43,43,0,793,795,794,1,5,1,1,0,96,96,95,95
Butte,54,2022-12-25,99,99,99,0,1399,1404,1403,1,37,1,1,1,479,479,478,478
Calaveras,54,2022-12-25,25,25,25,0,382,383,382,1,1,1,1,0,137,137,136,136
Colusa,54,2022-12-25,14,14,14,0,204,205,204,1,0,0,0,0,22,22,22,22
Contra Costa,54,2022-12-25,1523,1528,1528,0,15150,15191,15190,1,74,9,9,11,1522,1522,1513,1513
Del Norte,54,2022-12-25,37,37,37,0,453,454,453,1,3,0,0,0,56,56,56,56
El Dorado,54,2022-12-25,162,162,162,0,1381,1387,1386,1,6,1,1,0,241,241,240,240
Fresno,54,2022-12-25,1158,1161,1161,0,11658,11689,11688,1,186,11,11,33,2948,2948,2937,2937
Glenn,54,2022-12-25,14,14,14,0,197,198,197,1,0,0,0,0,56,56,56,56
Humboldt,54,2022-12-25,88,88,88,0,729,730,729,1,5,2,2,2,167,167,165,165
Imperial,54,2022-12-25,251,251,251,0,2454,2462,2461,1,5,2,2,0,973,973,971,971
Inyo,54,2022-12-25,14,14,14,0,204,205,204,1,0,0,0,0,62,62,62,62
Kern,54,2022-12-25,776,776,776,0,9871,9899,9898,1,55,9,9,11,2462,2462,2453,2453
Kings,54,2022-12-25,208,208,208,0,2524,2531,2530,1,5,1,1,0,477,477,476,476
Lake,54,2022-12-25,71,71,71,0,692,693,692,1,3,1,1,1,153,153,152,152
Lassen,54,2022-12-25,27,27,27,0,520,521,520,1,0,0,0,0,65,65,65,65
Los Angeles,54,2022-12-25,13978,14015,14015,0,153009,153421,153419,2,1016,159,159,142,34649,34649,34490,34490
Madera,54,2022-12-25,181,181,181,0,1710,1716,1715,1,7,0,0,1,376,376,376,376
Marin,54,2022-12-25,226,226,226,0,2766,2774,2773,1,33,0,0,3,260,260,260,260
Mariposa,54,2022-12-25,24,24,24,0,117,118,117,1,0,0,0,0,30,30,30,30
Mendocino,54,2022-12-25,77,77,77,0,717,718,717,1,8,0,0,1,139,139,139,139
Merced,54,2022-12-25,215,215,215,0,2191,2197,2196,1,17,4,4,2,894,894,890,890
Modoc,54,2022-12-25,3,3,3,0,13,14,13,1,0,0,0,0,11,11,11,11
Mono,54,2022-12-25,10,10,10,0,94,95,94,1,0,0,0,0,8,8,8,8
Monterey,54,2022-12-25,205,205,205,0,3251,3261,3260,1,18,5,5,1,787,787,782,782
Napa,54,2022-12-25,176,176,176,0,1988,1994,1993,1,9,0,0,0,162,162,162,162
Nevada,54,2022-12-25,75,75,75,0,785,786,785,1,7,0,0,0,137,137,137,137
Orange,54,2022-12-25,3315,3324,3324,0,26954,27027,27026,1,276,40,40,34,7789,7789,7749,7749
Placer,54,2022-12-25,322,322,322,0,3364,3375,3374,1,87,2,2,10,678,678,676,676
Plumas,54,2022-12-25,12,12,12,0,135,136,135,1,0,0,0,0,13,13,13,13
Riverside,54,2022-12-25,2994,3002,3002,0,20130,20185,20184,1,179,15,15,17,6751,6751,6736,6736
Sacramento,54,2022-12-25,1524,1529,1529,0,16814,16859,16858,1,168,16,16,28,3453,3453,3437,3437
San Benito,54,2022-12-25,110,110,110,0,1002,1005,1004,1,1,1,1,1,111,111,110,110
San Bernardino,54,2022-12-25,3066,3075,3075,0,21942,22000,21999,1,201,6,6,32,8126,8126,8120,8120
San Diego,54,2022-12-25,4852,4865,4865,0,31809,31894,31893,1,350,24,24,48,5694,5694,5670,5670
San Francisco,54,2022-12-25,1124,1126,1126,0,13171,13207,13206,1,84,20,20,18,1140,1140,1120,1120
San Joaquin,54,2022-12-25,803,803,803,0,11422,11454,11453,1,63,8,8,11,2393,2393,2385,2385
San Luis Obispo,54,2022-12-25,234,234,234,0,2263,2269,2268,1,17,3,3,0,542,542,539,539
San Mateo,54,2022-12-25,910,910,910,0,10185,10213,10212,1,51,0,0,7,747,747,747,747
Santa Barbara,54,2022-12-25,524,524,524,0,4397,4410,4409,1,39,1,1,8,749,749,748,748
Santa Clara,54,2022-12-25,2493,2499,2499,0,26862,26935,26934,1,149,11,11,28,2653,2653,2642,2642
Santa Cruz,54,2022-12-25,195,195,195,0,6684,6702,6701,1,26,0,0,1,276,276,276,276
Shasta,54,2022-12-25,98,98,98,0,1061,1063,1062,1,22,1,1,1,607,607,606,606
Siskiyou,54,2022-12-25,21,21,21,0,271,272,271,1,1,0,0,0,95,95,95,95
Solano,54,2022-12-25,698,698,698,0,5726,5743,5742,1,59,1,1,6,470,470,469,469
Sonoma,54,2022-12-25,473,473,473,0,4574,4589,4588,1,33,1,1,4,544,544,543,543
Stanislaus,54,2022-12-25,474,474,474,0,5331,5346,5345,1,96,10,10,5,1820,1820,1810,1810
Sutter,54,2022-12-25,125,125,125,0,952,954,953,1,0,1,1,0,237,237,236,236
Tehama,54,2022-12-25,51,51,51,0,688,689,688,1,2,4,4,1,225,225,221,221
Trinity,54,2022-12-25,3,3,3,0,39,40,39,1,0,0,0,0,23,23,23,23
Tulare,54,2022-12-25,469,469,469,0,4707,4722,4721,1,40,6,6,1,1564,1564,1558,1558
Tuolumne,54,2022-12-25,84,84,84,0,795,796,795,1,5,1,1,2,205,205,204,204
Ventura,54,2022-12-25,929,929,929,0,8505,8529,8528,1,67,13,13,9,1636,1636,1623,1623
Yolo,54,2022-12-25,148,148,148,0,1790,1796,1795,1,6,3,3,1,432,432,429,429
Yuba,54,2022-12-25,105,105,105,0,788,789,788,1,15,0,0,0,134,134,134,134
Alameda,55,2023-01-01,1938,1944,1944,0,20117,20175,20174,1,158,13,13,21,2084,2084,2071,2071
Amador,55,2023-01-01,38,38,38,0,690,691,690,1,3,1,1,0,97,97,96,96
Butte,55,2023-01-01,101,101,101,0,1310,1314,1313,1,31,3,3,2,482,482,479,479
Calaveras,55,2023-01-01,35,35,35,0,387,388,387,1,0,2,2,0,139,139,137,137
Colusa,55,2023-01-01,5,5,5,0,98,99,98,1,0,0,0,0,22,22,22,22
Contra Costa,55,2023-01-01,1451,1456,1456,0,14187,14230,14229,1,89,6,6,12,1528,1528,1522,1522
Del Norte,55,2023-01-01,35,35,35,0,430,431,430,1,4,0,0,1,56,56,56,56
El Dorado,55,2023-01-01,138,138,138,0,1439,1445,1444,1,5,1,1,2,242,242,241,241
Fresno,55,2023-01-01,1073,1075,1075,0,11370,11402,11401,1,195,14,14,30,2962,2962,2948,2948
Glenn,55,2023-01-01,9,9,9,0,191,192,191,1,0,0,0,0,56,56,56,56
Humboldt,55,2023-01-01,48,48,48,0,628,629,628,1,7,0,0,2,167,167,167,167
Imperial,55,2023-01-01,222,222,222,0,2042,2049,2048,1,11,0,0,1,973,973,973,973
Inyo,55,2023-01-01,16,16,16,0,222,223,222,1,1,0,0,1,62,62,62,62
Kern,55,2023-01-01,917,920,920,0,9860,9890,9889,1,62,3,3,9,2465,2465,2462,2462
Kings,55,2023-01-01,202,202,202,0,2160,2167,2166,1,4,1,1,1,478,478,477,477
Lake,55,2023-01-01,41,41,41,0,578,579,578,1,4,1,1,0,154,154,153,153
Lassen,55,2023-01-01,14,14,14,0,496,497,496,1,0,0,0,0,65,65,65,65
Los Angeles,55,2023-01-01,13866,13906,13906,0,133252,133641,133639,2,1061,151,151,146,34800,34800,34649,34649
Madera,55,2023-01-01,158,158,158,0,1676,1682,1681,1,4,0,0,0,376,376,376,376
Marin,55,2023-01-01,229,229,229,0,2400,2409,2408,1,22,0,0,3,260,260,260,260
Mariposa,55,2023-01-01,13,13,13,0,96,97,96,1,0,0,0,0,30,30,30,30
Mendocino,55,2023-01-01,65,65,65,0,703,704,703,1,6,1,1,3,140,140,139,139
Merced,55,2023-01-01,202,202,202,0,2063,2069,2068,1,9,3,3,5,897,897,894,894
Modoc,55,2023-01-01,10,10,10,0,16,17,16,1,0,0,0,0,11,11,11,11
Mono,55,2023-01-01,14,14,14,0,65,66,65,1,0,0,0,0,8,8,8,8
Monterey,55,2023-01-01,220,220,220,0,3032,3043,3042,1,26,1,1,1,788,788,787,787
Napa,55,2023-01-01,131,131,131,0,1684,1690,1689,1,6,1,1,1,163,163,162,162
Nevada,55,2023-01-01,58,58,58,0,740,741,740,1,9,0,0,2,137,137,137,137
Orange,55,2023-01-01,3441,3452,3452,0,25374,25448,25447,1,318,43,43,24,7832,7832,7789,7789
Placer,55,2023-01-01,309,309,309,0,3241,3253,3252,1,105,1,1,9,679,679,678,678
Plumas,55,2023-01-01,10,10,10,0,147,148,147,1,0,0,0,0,13,13,13,13
Riverside,55,2023-01-01,3227,3237,3237,0,20046,20105,20104,1,226,7,7,25,6758,6758,6751,6751
Sacramento,55,2023-01-01,1539,1544,1544,0,15476,15522,15521,1,187,17,17,21,3470,3470,3453,3453
San Benito,55,2023-01-01,64,64,64,0,805,808,807,1,1,0,0,1,111,111,111,111
San Bernardino,55,2023-01-01,3041,3050,3050,0,21049,21111,21110,1,192,2,2,30,8128,8128,8126,8126
San Diego,55,2023-01-01,4774,4788,4788,0,29293,29379,29378,1,382,26,26,40,5720,5720,5694,5694
San Francisco,55,2023-01-01,938,939,939,0,10133,10161,10160,1,87,13,13,8,1153,1153,1140,1140
San Joaquin,55,2023-01-01,789,789,789,0,10665,10698,10697,1,64,8,8,11,2401,2401,2393,2393
San Luis Obispo,55,2023-01-01,215,215,215,0,2017,2023,2022,1,15,5,5,0,547,547,542,542
San Mateo,55,2023-01-01,773,774,774,0,8057,8081,8080,1,53,0,0,5,747,747,747,747
Santa Barbara,55,2023-01-01,422,422,422,0,3985,3998,3997,1,41,1,1,6,750,750,749,749
Santa Clara,55,2023-01-01,2510,2517,2517,0,23273,23344,23343,1,197,14,14,30,2667,2667,2653,2653
Santa Cruz,55,2023-01-01,218,218,218,0,2974,2983,2982,1,27,0,0,0,276,276,276,276
Shasta,55,2023-01-01,104,104,104,0,966,968,967,1,22,1,1,2,608,608,607,607
Siskiyou,55,2023-01-01,14,14,14,0,271,272,271,1,1,0,0,0,95,95,95,95
Solano,55,2023-01-01,662,662,662,0,5348,5366,5365,1,63,4,4,11,474,474,470,470
Sonoma,55,2023-01-01,443,443,443,0,4301,4314,4313,1,56,0,0,2,544,544,544,544
Stanislaus,55,2023-01-01,487,487,487,0,5137,5152,5151,1,93,7,7,9,1827,1827,1820,1820
Sutter,55,2023-01-01,103,103,103,0,902,904,903,1,0,0,0,0,237,237,237,237
Tehama,55,2023-01-01,55,55,55,0,604,605,604,1,2,4,4,0,229,229,225,225
Trinity,55,2023-01-01,4,4,4,0,44,45,44,1,0,0,0,0,23,23,23,23
Tulare,55,2023-01-01,505,505,505,0,4799,4815,4814,1,57,4,4,3,1568,1568,1564,1564
Tuolumne,55,2023-01-01,85,85,85,0,700,701,700,1,5,2,2,0,207,207,205,205
Ventura,55,2023-01-01,940,941,941,0,7460,7483,7482,1,88,13,13,11,1649,1649,1636,1636
Yolo,55,2023-01-01,141,141,141,0,1554,1560,1559,1,3,3,3,1,435,435,432,432
Yuba,55,2023-01-01,88,88,88,0,742,743,742,1,17,0,0,1,134,134,134,134
Alameda,56,2023-01-08,1489,1494,1494,0,21290,21357,21356,1,155,11,11,10,2095,2095,2084,2084
Amador,56,2023-01-08,24,24,24,0,694,696,695,1,3,0,0,0,97,97,97,97
Butte,56,2023-01-08,86,86,86,0,1167,1172,1171,1,33,2,2,5,484,484,482,482
Calaveras,56,2023-01-08,16,16,16,0,314,315,314,1,0,0,0,1,139,139,139,139
Colusa,56,2023-01-08,9,9,9,0,96,97,96,1,0,0,0,0,22,22,22,22
Contra Costa,56,2023-01-08,1106,1111,1111,0,14423,14468,14467,1,88,7,7,14,1535,1535,1528,1528
Del Norte,56,2023-01-08,16,16,16,0,342,343,342,1,4,0,0,1,56,56,56,56
El Dorado,56,2023-01-08,104,104,104,0,1376,1381,1380,1,2,0,0,1,242,242,242,242
Fresno,56,2023-01-08,830,831,831,0,11007,11042,11041,1,171,8,8,21,2970,2970,2962,2962
Glenn,56,2023-01-08,10,10,10,0,186,187,186,1,0,0,0,0,56,56,56,56
Humboldt,56,2023-01-08,59,59,59,0,683,684,683,1,5,0,0,4,167,167,167,167
Imperial,56,2023-01-08,155,155,155,0,2252,2260,2259,1,12,2,2,1,975,975,973,973
Inyo,56,2023-01-08,10,10,10,0,213,214,213,1,0,0,0,0,62,62,62,62
Kern,56,2023-01-08,606,606,606,0,9836,9868,9867,1,72,4,4,8,2469,2469,2465,2465
Kings,56,2023-01-08,185,185,185,0,2187,2194,2193,1,8,1,1,0,479,479,478,478
Lake,56,2023-01-08,47,47,47,0,608,609,608,1,2,1,1,1,155,155,154,154
Lassen,56,2023-01-08,18,18,18,0,487,488,487,1,3,0,0,0,65,65,65,65
Los Angeles,56,2023-01-08,10630,10664,10664,0,176218,176771,176769,2,973,143,143,142,34943,34943,34800,34800
Madera,56,2023-01-08,92,92,92,0,1547,1553,1552,1,2,0,0,1,376,376,376,376
Marin,56,2023-01-08,151,151,151,0,2472,2481,2480,1,17,0,0,4,260,260,260,260
Mariposa,56,2023-01-08,11,11,11,0,89,90,89,1,0,1,1,0,31,31,30,30
Mendocino,56,2023-01-08,37,37,37,0,594,595,594,1,11,2,2,3,142,142,140,140
Merced,56,2023-01-08,186,186,186,0,1965,1973,1972,1,12,0,0,3,897,897,897,897
Modoc,56,2023-01-08,8,8,8,0,12,13,12,1,0,0,0,0,11,11,11,11
Mono,56,2023-01-08,10,10,10,0,85,86,85,1,0,0,0,0,8,8,8,8
Monterey,56,2023-01-08,174,174,174,0,3059,3070,3069,1,19,3,3,4,791,791,788,788
Napa,56,2023-01-08,119,119,119,0,1700,1706,1705,1,7,0,0,3,163,163,163,163
Nevada,56,2023-01-08,38,38,38,0,711,712,711,1,7,0,0,0,137,137,137,137
Orange,56,2023-01-08,2570,2578,2578,0,26739,26823,26822,1,264,31,31,26,7863,7863,7832,7832
Placer,56,2023-01-08,249,249,249,0,3285,3297,3296,1,91,0,0,5,679,679,679,679
Plumas,56,2023-01-08,7,7,7,0,90,91,90,1,1,1,1,0,14,14,13,13
Riverside,56,2023-01-08,2140,2146,2146,0,20454,20519,20518,1,172,14,14,26,6772,6772,6758,6758
Sacramento,56,2023-01-08,1048,1052,1052,0,14805,14851,14850,1,177,14,14,25,3484,3484,3470,3470
San Benito,56,2023-01-08,50,50,50,0,672,674,673,1,3,0,0,2,111,111,111,111
San Bernardino,56,2023-01-08,1834,1841,1841,0,20107,20170,20169,1,186,7,7,35,8135,8135,8128,8128
San Diego,56,2023-01-08,3555,3566,3566,0,32728,32833,32832,1,384,25,25,34,5745,5745,5720,5720
San Francisco,56,2023-01-08,782,783,783,0,11825,11863,11862,1,79,7,7,14,1160,1160,1153,1153
San Joaquin,56,2023-01-08,584,584,584,0,9847,9879,9878,1,55,9,9,12,2410,2410,2401,2401
San Luis Obispo,56,2023-01-08,190,190,190,0,2067,2074,2073,1,11,4,4,0,551,551,547,547
San Mateo,56,2023-01-08,609,609,609,0,8741,8769,8768,1,54,0,0,4,747,747,747,747
Santa Barbara,56,2023-01-08,408,408,408,0,4552,4568,4567,1,37,3,3,1,753,753,750,750
Santa Clara,56,2023-01-08,1990,1996,1996,0,25754,25836,25835,1,188,16,16,34,2683,2683,2667,2667
Santa Cruz,56,2023-01-08,147,147,147,0,3327,3338,3337,1,27,0,0,1,276,276,276,276
Shasta,56,2023-01-08,62,62,62,0,820,822,821,1,17,0,0,2,608,608,608,608
Siskiyou,56,2023-01-08,18,18,18,0,233,234,233,1,1,0,0,0,95,95,95,95
Solano,56,2023-01-08,391,391,391,0,4886,4904,4903,1,48,1,1,6,475,475,474,474
Sonoma,56,2023-01-08,275,275,275,0,4491,4506,4505,1,39,3,3,4,547,547,544,544
Stanislaus,56,2023-01-08,319,319,319,0,4810,4826,4825,1,80,6,6,9,1833,1833,1827,1827
Sutter,56,2023-01-08,61,61,61,0,878,880,879,1,0,0,0,0,237,237,237,237
Tehama,56,2023-01-08,31,31,31,0,502,503,502,1,1,2,2,0,231,231,229,229
Trinity,56,2023-01-08,3,3,3,0,26,27,26,1,0,0,0,0,23,23,23,23
Tulare,56,2023-01-08,339,339,339,0,4520,4535,4534,1,54,4,4,2,1572,1572,1568,1568
Tuolumne,56,2023-01-08,70,70,70,0,633,634,633,1,1,0,0,0,207,207,207,207
Ventura,56,2023-01-08,674,674,674,0,8914,8943,8942,1,72,5,5,15,1654,1654,1649,1649
Yolo,56,2023-01-08,101,101,101,0,1605,1612,1611,1,3,1,1,0,436,436,435,435
Yuba,56,2023-01-08,54,54,54,0,742,743,742,1,19,0,0,1,134,134,134,134
Alameda,57,2023-01-15,967,970,970,0,21894,21971,21970,1,105,5,5,10,2100,2100,2095,2095
Amador,57,2023-01-15,24,24,24,0,613,615,614,1,2,0,0,0,97,97,97,97
Butte,57,2023-01-15,67,67,67,0,1193,1198,1197,1,25,2,2,0,486,486,484,484
Calaveras,57,2023-01-15,15,15,15,0,317,318,317,1,1,0,0,0,139,139,139,139
Colusa,57,2023-01-15,6,6,6,0,83,84,83,1,1,0,0,0,22,22,22,22
Contra Costa,57,2023-01-15,678,678,678,0,13410,13456,13455,1,54,3,3,18,1538,1538,1535,1535
Del Norte,57,2023-01-15,11,11,11,0,332,333,332,1,3,1,1,0,57,57,56,56
El Dorado,57,2023-01-15,59,59,59,0,1136,1141,1140,1,3,1,1,0,243,243,242,242
Fresno,57,2023-01-15,517,517,517,0,10073,10109,10108,1,163,6,6,12,2976,2976,2970,2970
Glenn,57,2023-01-15,3,3,3,0,167,168,167,1,0,0,0,0,56,56,56,56
Humboldt,57,2023-01-15,40,40,40,0,533,534,533,1,8,0,0,3,167,167,167,167
Imperial,57,2023-01-15,137,137,137,0,2177,2184,2183,1,12,2,2,3,977,977,975,975
Inyo,57,2023-01-15,12,12,12,0,202,203,202,1,1,0,0,0,62,62,62,62
Kern,57,2023-01-15,404,404,404,0,8979,9011,9010,1,60,5,5,11,2474,2474,2469,2469
Kings,57,2023-01-15,135,135,135,0,2100,2108,2107,1,5,2,2,0,481,481,479,479
Lake,57,2023-01-15,27,27,27,0,566,567,566,1,3,1,1,0,156,156,155,155
Lassen,57,2023-01-15,7,7,7,0,444,445,444,1,0,0,0,0,65,65,65,65
Los Angeles,57,2023-01-15,6726,6750,6750,0,165566,166137,166135,2,853,143,143,122,35086,35086,34943,34943
Madera,57,2023-01-15,79,79,79,0,1406,1414,1413,1,4,0,0,2,376,376,376,376
Marin,57,2023-01-15,120,120,120,0,2271,2278,2277,1,19,0,0,2,260,260,260,260
Mariposa,57,2023-01-15,10,10,10,0,106,107,106,1,0,0,0,0,31,31,31,31
Mendocino,57,2023-01-15,33,33,33,0,548,549,548,1,6,0,0,0,142,142,142,142
Merced,57,2023-01-15,134,134,134,0,1842,1850,1849,1,11,3,3,4,900,900,897,897
Modoc,57,2023-01-15,1,1,1,0,11,12,11,1,0,0,0,0,11,11,11,11
Mono,57,2023-01-15,8,8,8,0,68,69,68,1,1,0,0,0,8,8,8,8
Monterey,57,2023-01-15,120,120,120,0,2699,2709,2708,1,20,4,4,2,795,795,791,791
Napa,57,2023-01-15,79,79,79,0,1683,1689,1688,1,6,0,0,0,163,163,163,163
Nevada,57,2023-01-15,28,28,28,0,621,623,622,1,5,0,0,0,137,137,137,137
Orange,57,2023-01-15,1578,1583,1583,0,25501,25590,25589,1,232,47,47,30,7910,7910,7863,7863
Placer,57,2023-01-15,182,182,182,0,2854,2864,2863,1,74,0,0,7,679,679,679,679
Plumas,57,2023-01-15,1,1,1,0,71,72,71,1,0,0,0,0,14,14,14,14
Riverside,57,2023-01-15,1320,1325,1325,0,18317,18380,18379,1,149,17,17,30,6789,6789,6772,6772
Sacramento,57,2023-01-15,641,641,641,0,13435,13483,13482,1,140,25,25,24,3509,3509,3484,3484
San Benito,57,2023-01-15,30,30,30,0,610,612,611,1,0,1,1,0,112,112,111,111
San Bernardino,57,2023-01-15,1101,1105,1105,0,17725,17784,17783,1,144,3,3,36,8138,8138,8135,8135
San Diego,57,2023-01-15,2364,2372,2372,0,31801,31912,31911,1,312,14,14,35,5759,5759,5745,5745
San Francisco,57,2023-01-15,497,497,497,0,11423,11463,11462,1,81,1,1,11,1161,1161,1160,1160
San Joaquin,57,2023-01-15,392,392,392,0,9439,9473,9472,1,45,9,9,12,2419,2419,2410,2410
San Luis Obispo,57,2023-01-15,109,109,109,0,1789,1796,1795,1,15,1,1,2,552,552,551,551
San Mateo,57,2023-01-15,451,451,451,0,8732,8763,8762,1,37,0,0,2,747,747,747,747
Santa Barbara,57,2023-01-15,236,236,236,0,3956,3970,3969,1,31,2,2,2,755,755,753,753
Santa Clara,57,2023-01-15,1285,1290,1290,0,27820,27916,27915,1,126,14,14,21,2697,2697,2683,2683
Santa Cruz,57,2023-01-15,160,160,160,0,7065,7090,7089,1,24,0,0,1,276,276,276,276
Shasta,57,2023-01-15,44,44,44,0,736,739,738,1,15,2,2,2,610,610,608,608
Siskiyou,57,2023-01-15,9,9,9,0,210,211,210,1,1,0,0,0,95,95,95,95
Solano,57,2023-01-15,275,275,275,0,4216,4232,4231,1,49,0,0,7,475,475,475,475
Sonoma,57,2023-01-15,208,208,208,0,4123,4138,4137,1,32,4,4,2,551,551,547,547
Stanislaus,57,2023-01-15,215,215,215,0,4556,4572,4571,1,72,1,1,5,1834,1834,1833,1833
Sutter,57,2023-01-15,50,50,50,0,721,723,722,1,0,0,0,0,237,237,237,237
Tehama,57,2023-01-15,19,19,19,0,385,386,385,1,3,1,1,0,232,232,231,231
Trinity,57,2023-01-15,3,3,3,0,25,26,25,1,0,0,0,0,23,23,23,23
Tulare,57,2023-01-15,254,254,254,0,4382,4398,4397,1,39,5,5,4,1577,1577,1572,1572
Tuolumne,57,2023-01-15,46,46,46,0,557,558,557,1,1,3,3,0,210,210,207,207
Ventura,57,2023-01-15,456,456,456,0,8336,8366,8365,1,50,3,3,21,1657,1657,1654,1654
Yolo,57,2023-01-15,85,85,85,0,1365,1371,1370,1,3,3,3,0,439,439,436,436
Yuba,57,2023-01-15,38,38,38,0,616,617,616,1,9,0,0,2,134,134,134,134
Alameda,58,2023-01-22,733,734,734,0,19766,19843,19842,1,89,8,8,10,2108,2108,2100,2100
Amador,58,2023-01-22,35,35,35,0,566,568,567,1,1,0,0,0,97,97,97,97
Butte,58,2023-01-22,41,41,41,0,1079,1085,1084,1,12,1,1,0,487,487,486,486
Calaveras,58,2023-01-22,12,12,12,0,275,276,275,1,0,0,0,0,139,139,139,139
Colusa,58,2023-01-22,10,10,10,0,74,75,74,1,0,0,0,0,22,22,22,22
Contra Costa,58,2023-01-22,505,505,505,0,12277,12325,12324,1,53,6,6,10,1544,1544,1538,1538
Del Norte,58,2023-01-22,20,20,20,0,334,335,334,1,1,1,1,0,58,58,57,57
El Dorado,58,2023-01-22,46,46,46,0,972,977,976,1,2,0,0,0,243,243,243,243
Fresno,58,2023-01-22,415,415,415,0,9891,9931,9930,1,114,8,8,22,2984,2984,2976,2976
Glenn,58,2023-01-22,3,3,3,0,149,150,149,1,0,0,0,0,56,56,56,56
Humboldt,58,2023-01-22,33,33,33,0,522,523,522,1,8,2,2,4,169,169,167,167
Imperial,58,2023-01-22,81,81,81,0,2101,2110,2109,1,11,0,0,1,977,977,977,977
Inyo,58,2023-01-22,6,6,6,0,166,167,166,1,0,1,1,0,63,63,62,62
Kern,58,2023-01-22,330,330,330,0,8869,8906,8905,1,36,5,5,9,2479,2479,2474,2474
Kings,58,2023-01-22,94,94,94,0,1864,1873,1872,1,4,0,0,0,481,481,481,481
Lake,58,2023-01-22,24,24,24,0,569,570,569,1,2,2,2,2,158,158,156,156
Lassen,58,2023-01-22,5,5,5,0,446,447,446,1,0,0,0,0,65,65,65,65
Los Angeles,58,2023-01-22,5411,5431,5431,0,158822,159449,159447,2,700,120,120,93,35206,35206,35086,35086
Madera,58,2023-01-22,48,48,48,0,1434,1441,1440,1,6,0,0,2,376,376,376,376
Marin,58,2023-01-22,122,122,122,0,2263,2275,2274,1,18,0,0,3,260,260,260,260
Mariposa,58,2023-01-22,8,8,8,0,98,99,98,1,0,0,0,0,31,31,31,31
Mendocino,58,2023-01-22,17,17,17,0,510,511,510,1,2,0,0,2,142,142,142,142
Merced,58,2023-01-22,111,111,111,0,1757,1765,1764,1,12,3,3,4,903,903,900,900
Modoc,58,2023-01-22,2,2,2,0,10,11,10,1,1,0,0,0,11,11,11,11
Mono,58,2023-01-22,5,5,5,0,72,73,72,1,0,0,0,0,8,8,8,8
Monterey,58,2023-01-22,100,100,100,0,2591,2602,2601,1,16,1,1,1,796,796,795,795
Napa,58,2023-01-22,74,74,74,0,1387,1393,1392,1,2,0,0,1,163,163,163,163
Nevada,58,2023-01-22,23,23,23,0,591,593,592,1,4,0,0,0,137,137,137,137
Orange,58,2023-01-22,1207,1213,1213,0,23373,23466,23465,1,188,23,23,26,7933,7933,7910,7910
Placer,58,2023-01-22,140,140,140,0,2618,2630,2629,1,48,1,1,5,680,680,679,679
Plumas,58,2023-01-22,6,6,6,0,91,92,91,1,0,0,0,0,14,14,14,14
Riverside,58,2023-01-22,1008,1013,1013,0,15952,16016,16015,1,123,10,10,19,6799,6799,6789,6789
Sacramento,58,2023-01-22,552,552,552,0,12573,12624,12623,1,119,8,8,21,3517,3517,3509,3509
San Benito,58,2023-01-22,24,24,24,0,517,518,517,1,0,0,0,0,112,112,112,112
San Bernardino,58,2023-01-22,989,993,993,0,18417,18490,18489,1,135,1,1,26,8139,8139,8138,8138
San Diego,58,2023-01-22,1924,1932,1932,0,30065,30184,30183,1,247,13,13,40,5772,5772,5759,5759
San Francisco,58,2023-01-22,447,447,447,0,10530,10572,10571,1,59,6,6,7,1167,1167,1161,1161
San Joaquin,58,2023-01-22,249,249,249,0,8287,8320,8319,1,35,3,3,8,2422,2422,2419,2419
San Luis Obispo,58,2023-01-22,105,105,105,0,1853,1861,1860,1,8,2,2,1,554,554,552,552
San Mateo,58,2023-01-22,323,323,323,0,7960,7992,7991,1,23,0,0,0,747,747,747,747
Santa Barbara,58,2023-01-22,203,203,203,0,4069,4086,4085,1,30,1,1,3,756,756,755,755
Santa Clara,58,2023-01-22,979,982,982,0,22881,22974,22973,1,145,7,7,16,2704,2704,2697,2697
Santa Cruz,58,2023-01-22,125,125,125,0,7449,7479,7478,1,18,0,0,0,276,276,276,276
Shasta,58,2023-01-22,23,23,23,0,727,730,729,1,6,2,2,1,612,612,610,610
Siskiyou,58,2023-01-22,6,6,6,0,181,182,181,1,1,0,0,0,95,95,95,95
Solano,58,2023-01-22,212,212,212,0,3904,3921,3920,1,29,0,0,3,475,475,475,475
Sonoma,58,2023-01-22,199,199,199,0,4071,4088,4087,1,24,2,2,3,553,553,551,551
Stanislaus,58,2023-01-22,184,184,184,0,4337,4355,4354,1,51,4,4,6,1838,1838,1834,1834
Sutter,58,2023-01-22,44,44,44,0,749,752,751,1,0,1,1,0,238,238,237,237
Tehama,58,2023-01-22,11,11,11,0,310,311,310,1,1,0,0,0,232,232,232,232
Trinity,58,2023-01-22,2,2,2,0,28,29,28,1,0,0,0,0,23,23,23,23
Tulare,58,2023-01-22,242,242,242,0,4042,4060,4059,1,29,2,2,6,1579,1579,1577,1577
Tuolumne,58,2023-01-22,36,36,36,0,500,501,500,1,1,1,1,0,211,211,210,210
Ventura,58,2023-01-22,358,358,358,0,8186,8219,8218,1,56,6,6,8,1663,1663,1657,1657
Yolo,58,2023-01-22,81,81,81,0,1292,1298,1297,1,2,3,3,0,442,442,439,439
Yuba,58,2023-01-22,28,28,28,0,665,667,666,1,5,0,0,0,134,134,134,134
Alameda,59,2023-01-29,823,827,827,0,18339,18418,18417,1,78,5,5,8,2113,2113,2108,2108
Amador,59,2023-01-29,21,21,21,0,609,611,610,1,2,1,1,0,98,98,97,97
Butte,59,2023-01-29,56,56,56,0,1121,1127,1126,1,11,2,2,2,489,489,487,487
Calaveras,59,2023-01-29,16,16,16,0,315,316,315,1,0,1,1,0,140,140,139,139
Colusa,59,2023-01-29,5,5,5,0,188,189,188,1,0,0,0,0,22,22,22,22
Contra Costa,59,2023-01-29,621,621,621,0,12501,12555,12554,1,38,10,10,6,1554,1554,1544,1544
Del Norte,59,2023-01-29,25,25,25,0,382,383,382,1,0,1,1,0,59,59,58,58
El Dorado,59,2023-01-29,55,55,55,0,1222,1230,1229,1,4,2,2,0,245,245,243,243
Fresno,59,2023-01-29,464,464,464,0,9914,9959,9958,1,117,8,8,12,2992,2992,2984,2984
Glenn,59,2023-01-29,4,4,4,0,161,162,161,1,0,0,0,0,56,56,56,56
Humboldt,59,2023-01-29,28,28,28,0,553,554,553,1,6,0,0,1,169,169,169,169
Imperial,59,2023-01-29,100,100,100,0,2065,2076,2075,1,5,0,0,1,977,977,977,977
Inyo,59,2023-01-29,8,8,8,0,188,189,188,1,1,0,0,0,63,63,63,63
Kern,59,2023-01-29,287,287,287,0,8975,9015,9014,1,36,1,1,8,2480,2480,2479,2479
Kings,59,2023-01-29,137,137,137,0,2210,2221,2220,1,3,1,1,0,482,482,481,481
Lake,59,2023-01-29,27,27,27,0,581,584,583,1,4,1,1,0,159,159,158,158
Lassen,59,2023-01-29,5,5,5,0,466,468,467,1,0,0,0,0,65,65,65,65
Los Angeles,59,2023-01-29,5640,5665,5665,0,152974,153635,153633,2,599,108,108,75,35314,35314,35206,35206
Madera,59,2023-01-29,52,52,52,0,1475,1483,1482,1,6,0,0,0,376,376,376,376
Marin,59,2023-01-29,96,96,96,0,2176,2188,2187,1,17,0,0,2,260,260,260,260
Mariposa,59,2023-01-29,4,4,4,0,109,110,109,1,0,0,0,0,31,31,31,31
Mendocino,59,2023-01-29,25,25,25,0,524,525,524,1,2,0,0,2,142,142,142,142
Merced,59,2023-01-29,142,142,142,0,1863,1873,1872,1,9,0,0,2,903,903,903,903
Modoc,59,2023-01-29,0,0,0,0,10,11,10,1,1,0,0,0,11,11,11,11
Mono,59,2023-01-29,2,2,2,0,65,66,65,1,0,0,0,0,8,8,8,8
Monterey,59,2023-01-29,153,153,153,0,2802,2815,2814,1,7,0,0,0,796,796,796,796
Napa,59,2023-01-29,65,65,65,0,1365,1372,1371,1,4,0,0,1,163,163,163,163
Nevada,59,2023-01-29,28,28,28,0,580,582,581,1,1,0,0,2,137,137,137,137
Orange,59,2023-01-29,1161,1167,1167,0,22782,22882,22881,1,139,18,18,25,7951,7951,7933,7933
Placer,59,2023-01-29,162,162,162,0,2697,2710,2709,1,55,2,2,7,682,682,680,680
Plumas,59,2023-01-29,3,3,3,0,73,74,73,1,0,0,0,0,14,14,14,14
Riverside,59,2023-01-29,1038,1044,1044,0,15803,15872,15871,1,100,9,9,15,6808,6808,6799,6799
Sacramento,59,2023-01-29,673,675,675,0,13605,13664,13663,1,121,9,9,14,3526,3526,3517,3517
San Benito,59,2023-01-29,29,29,29,0,561,562,561,1,0,0,0,0,112,112,112,112
San Bernardino,59,2023-01-29,939,943,943,0,17045,17120,17119,1,145,0,0,19,8139,8139,8139,8139
San Diego,59,2023-01-29,1866,1873,1873,0,31502,31637,31636,1,234,12,12,36,5784,5784,5772,5772
San Francisco,59,2023-01-29,452,452,452,0,10722,10769,10768,1,55,3,3,4,1170,1170,1167,1167
San Joaquin,59,2023-01-29,283,283,283,0,7781,7816,7815,1,25,4,4,4,2426,2426,2422,2422
San Luis Obispo,59,2023-01-29,130,130,130,0,1864,1874,1873,1,12,7,7,1,561,561,554,554
San Mateo,59,2023-01-29,431,431,431,0,8685,8723,8722,1,24,0,0,6,747,747,747,747
Santa Barbara,59,2023-01-29,232,232,232,0,4260,4279,4278,1,25,2,2,2,758,758,756,756
Santa Clara,59,2023-01-29,1124,1131,1131,0,23212,23312,23311,1,147,7,7,19,2711,2711,2704,2704
Santa Cruz,59,2023-01-29,130,130,130,0,9148,9188,9187,1,12,0,0,0,276,276,276,276
Shasta,59,2023-01-29,19,19,19,0,681,684,683,1,8,0,0,0,612,612,612,612
Siskiyou,59,2023-01-29,4,4,4,0,192,193,192,1,1,0,0,0,95,95,95,95
Solano,59,2023-01-29,231,231,231,0,4090,4108,4107,1,44,0,0,3,475,475,475,475
Sonoma,59,2023-01-29,170,170,170,0,3744,3761,3760,1,25,1,1,0,554,554,553,553
Stanislaus,59,2023-01-29,218,218,218,0,4135,4155,4154,1,49,2,2,5,1840,1840,1838,1838
Sutter,59,2023-01-29,30,30,30,0,630,633,632,1,0,1,1,0,239,239,238,238
Tehama,59,2023-01-29,11,11,11,0,334,335,334,1,0,1,1,1,233,233,232,232
Trinity,59,2023-01-29,2,2,2,0,28,29,28,1,0,1,1,0,24,24,23,23
Tulare,59,2023-01-29,247,247,247,0,4007,4026,4025,1,26,3,3,5,1582,1582,1579,1579
Tuolumne,59,2023-01-29,47,47,47,0,551,553,552,1,3,0,0,0,211,211,211,211
Ventura,59,2023-01-29,358,358,358,0,8268,8305,8304,1,50,6,6,10,1669,1669,1663,1663
Yolo,59,2023-01-29,83,83,83,0,1285,1292,1291,1,2,1,1,1,443,443,442,442
Yuba,59,2023-01-29,33,33,33,0,676,679,678,1,6,0,0,1,134,134,134,134
Alameda,60,2023-02-05,1031,1038,1038,0,18391,18480,18479,1,83,4,4,7,2117,2117,2113,2113
Amador,60,2023-02-05,32,32,32,0,655,657,656,1,0,0,0,0,98,98,98,98
Butte,60,2023-02-05,72,72,72,0,1175,1182,1181,1,16,0,0,2,489,489,489,489
Calaveras,60,2023-02-05,15,15,15,0,316,317,316,1,0,0,0,0,140,140,140,140
Colusa,60,2023-02-05,6,6,6,0,173,174,173,1,0,0,0,0,22,22,22,22
Contra Costa,60,2023-02-05,697,701,701,0,11861,11918,11917,1,52,3,3,8,1557,1557,1554,1554
Del Norte,60,2023-02-05,47,47,47,0,384,385,384,1,0,0,0,0,59,59,59,59
El Dorado,60,2023-02-05,58,58,58,0,1079,1085,1084,1,3,0,0,0,245,245,245,245
Fresno,60,2023-02-05,479,479,479,0,9178,9224,9223,1,95,4,4,6,2996,2996,2992,2992
Glenn,60,2023-02-05,9,9,9,0,158,159,158,1,0,0,0,0,56,56,56,56
Humboldt,60,2023-02-05,53,53,53,0,558,560,559,1,6,0,0,0,169,169,169,169
Imperial,60,2023-02-05,123,123,123,0,2161,2173,2172,1,7,2,2,0,979,979,977,977
Inyo,60,2023-02-05,10,10,10,0,202,203,202,1,0,0,0,0,63,63,63,63
Kern,60,2023-02-05,325,325,325,0,8628,8671,8670,1,35,2,2,5,2482,2482,2480,2480
Kings,60,2023-02-05,129,129,129,0,2075,2087,2086,1,4,0,0,1,482,482,482,482
Lake,60,2023-02-05,21,21,21,0,544,545,544,1,5,2,2,0,161,161,159,159
Lassen,60,2023-02-05,4,4,4,0,470,472,471,1,0,0,0,0,65,65,65,65
Los Angeles,60,2023-02-05,5909,5937,5937,0,145568,146274,146272,2,606,88,88,78,35402,35402,35314,35314
Madera,60,2023-02-05,53,53,53,0,1307,1315,1314,1,5,1,1,0,377,377,376,376
Marin,60,2023-02-05,136,136,136,0,2149,2161,2160,1,15,0,0,3,260,260,260,260
Mariposa,60,2023-02-05,4,4,4,0,110,111,110,1,0,0,0,0,31,31,31,31
Mendocino,60,2023-02-05,32,32,32,0,489,492,491,1,1,0,0,1,142,142,142,142
Merced,60,2023-02-05,164,164,164,0,1862,1873,1872,1,12,0,0,1,903,903,903,903
Modoc,60,2023-02-05,1,1,1,0,5,6,5,1,0,0,0,0,11,11,11,11
Mono,60,2023-02-05,5,5,5,0,90,91,90,1,0,0,0,0,8,8,8,8
Monterey,60,2023-02-05,217,217,217,0,2929,2944,2943,1,18,3,3,0,799,799,796,796
Napa,60,2023-02-05,100,100,100,0,1329,1335,1334,1,6,0,0,2,163,163,163,163
Nevada,60,2023-02-05,29,29,29,0,578,580,579,1,5,0,0,0,137,137,137,137
Orange,60,2023-02-05,1306,1313,1313,0,22447,22557,22556,1,161,20,20,17,7971,7971,7951,7951
Placer,60,2023-02-05,165,165,165,0,2651,2665,2664,1,45,0,0,4,682,682,682,682
Plumas,60,2023-02-05,2,2,2,0,74,75,74,1,0,1,1,0,15,15,14,14
Riverside,60,2023-02-05,1129,1136,1136,0,15539,15614,15613,1,84,4,4,16,6812,6812,6808,6808
Sacramento,60,2023-02-05,684,688,688,0,12960,13023,13022,1,107,5,5,19,3531,3531,3526,3526
San Benito,60,2023-02-05,48,48,48,0,543,545,544,1,0,0,0,0,112,112,112,112
San Bernardino,60,2023-02-05,1048,1055,1055,0,17718,17804,17803,1,137,0,0,20,8139,8139,8139,8139
San Diego,60,2023-02-05,1834,1843,1843,0,29301,29443,29442,1,251,9,9,26,5793,5793,5784,5784
San Francisco,60,2023-02-05,557,557,557,0,10694,10746,10745,1,57,2,2,2,1172,1172,1170,1170
San Joaquin,60,2023-02-05,396,396,396,0,7289,7325,7324,1,31,1,1,3,2427,2427,2426,2426
San Luis Obispo,60,2023-02-05,148,148,148,0,1885,1896,1895,1,8,1,1,0,562,562,561,561
San Mateo,60,2023-02-05,509,509,509,0,8279,8321,8320,1,36,0,0,2,747,747,747,747
Santa Barbara,60,2023-02-05,236,236,236,0,4334,4356,4355,1,20,1,1,0,759,759,758,758
Santa Clara,60,2023-02-05,1254,1261,1261,0,23629,23745,23744,1,134,8,8,24,2719,2719,2711,2711
Santa Cruz,60,2023-02-05,218,218,218,0,10294,10346,10345,1,9,0,0,0,276,276,276,276
Shasta,60,2023-02-05,25,25,25,0,662,667,666,1,8,0,0,0,612,612,612,612
Siskiyou,60,2023-02-05,13,13,13,0,211,212,211,1,1,0,0,0,95,95,95,95
Solano,60,2023-02-05,260,260,260,0,3836,3855,3854,1,36,0,0,5,475,475,475,475
Sonoma,60,2023-02-05,245,245,245,0,3538,3557,3556,1,20,3,3,1,557,557,554,554
Stanislaus,60,2023-02-05,266,266,266,0,3965,3985,3984,1,54,1,1,6,1841,1841,1840,1840
Sutter,60,2023-02-05,46,46,46,0,697,700,699,1,0,0,0,0,239,239,239,239
Tehama,60,2023-02-05,14,14,14,0,344,345,344,1,2,0,0,0,233,233,233,233
Trinity,60,2023-02-05,8,8,8,0,22,23,22,1,0,0,0,0,24,24,24,24
Tulare,60,2023-02-05,265,265,265,0,4258,4280,4279,1,23,3,3,1,1585,1585,1582,1582
Tuolumne,60,2023-02-05,46,46,46,0,585,588,587,1,1,0,0,1,211,211,211,211
Ventura,60,2023-02-05,326,326,326,0,7064,7099,7098,1,41,2,2,8,1671,1671,1669,1669
Yolo,60,2023-02-05,77,77,77,0,1255,1263,1262,1,3,0,0,2,443,443,443,443
Yuba,60,2023-02-05,18,18,18,0,598,600,599,1,1,0,0,1,134,134,134,134
Alameda,61,2023-02-12,1159,1165,1165,0,17947,18040,18039,1,78,2,2,7,2119,2119,2117,2117
Amador,61,2023-02-12,18,18,18,0,490,491,490,1,0,0,0,0,98,98,98,98
Butte,61,2023-02-12,98,98,98,0,1282,1290,1289,1,27,1,1,1,490,490,489,489
Calaveras,61,2023-02-12,15,15,15,0,306,307,306,1,0,0,0,0,140,140,140,140
Colusa,61,2023-02-12,11,11,11,0,188,189,188,1,0,0,0,0,22,22,22,22
Contra Costa,61,2023-02-12,729,734,734,0,11538,11599,11598,1,43,3,3,7,1560,1560,1557,1557
Del Norte,61,2023-02-12,37,37,37,0,315,316,315,1,2,0,0,0,59,59,59,59
El Dorado,61,2023-02-12,62,62,62,0,1097,1103,1102,1,2,0,0,0,245,245,245,245
Fresno,61,2023-02-12,493,494,494,0,8773,8820,8819,1,107,4,4,6,3000,3000,2996,2996
Glenn,61,2023-02-12,11,11,11,0,173,174,173,1,5,0,0,0,56,56,56,56
Humboldt,61,2023-02-12,38,38,38,0,576,580,579,1,7,1,1,1,170,170,169,169
Imperial,61,2023-02-12,138,138,138,0,1868,1879,1878,1,3,0,0,5,979,979,979,979
Inyo,61,2023-02-12,7,7,7,0,207,208,207,1,0,0,0,0,63,63,63,63
Kern,61,2023-02-12,319,319,319,0,8277,8321,8320,1,37,2,2,7,2484,2484,2482,2482
Kings,61,2023-02-12,101,101,101,0,1921,1933,1932,1,5,0,0,1,482,482,482,482
Lake,61,2023-02-12,24,24,24,0,585,589,588,1,2,0,0,0,161,161,161,161
Lassen,61,2023-02-12,7,7,7,0,370,371,370,1,0,0,0,0,65,65,65,65
Los Angeles,61,2023-02-12,6006,6037,6037,0,132432,133125,133123,2,622,79,79,63,35481,35481,35402,35402
Madera,61,2023-02-12,63,63,63,0,1258,1266,1265,1,9,0,0,1,377,377,377,377
Marin,61,2023-02-12,150,150,150,0,1905,1917,1916,1,18,0,0,3,260,260,260,260
Mariposa,61,2023-02-12,3,3,3,0,99,100,99,1,0,0,0,0,31,31,31,31
Mendocino,61,2023-02-12,28,28,28,0,549,552,551,1,3,2,2,1,144,144,142,142
Merced,61,2023-02-12,162,162,162,0,1894,1905,1904,1,8,0,0,0,903,903,903,903
Modoc,61,2023-02-12,1,1,1,0,3,4,3,1,0,0,0,0,11,11,11,11
Mono,61,2023-02-12,1,1,1,0,70,71,70,1,0,0,0,0,8,8,8,8
Monterey,61,2023-02-12,217,217,217,0,2673,2688,2687,1,18,4,4,0,803,803,799,799
Napa,61,2023-02-12,106,106,106,0,1501,1509,1508,1,5,0,0,0,163,163,163,163
Nevada,61,2023-02-12,41,41,41,0,606,610,609,1,5,0,0,0,137,137,137,137
Orange,61,2023-02-12,1405,1412,1412,0,21155,21266,21265,1,141,17,17,21,7988,7988,7971,7971
Placer,61,2023-02-12,166,166,166,0,2631,2646,2645,1,37,0,0,6,682,682,682,682
Plumas,61,2023-02-12,2,2,2,0,81,82,81,1,1,0,0,0,15,15,15,15
Riverside,61,2023-02-12,1092,1099,1099,0,15951,16035,16034,1,84,6,6,13,6818,6818,6812,6812
Sacramento,61,2023-02-12,840,845,845,0,13224,13294,13293,1,103,5,5,17,3536,3536,3531,3531
San Benito,61,2023-02-12,49,49,49,0,569,572,571,1,2,0,0,0,112,112,112,112
San Bernardino,61,2023-02-12,1024,1031,1031,0,16988,17078,17077,1,130,0,0,18,8139,8139,8139,8139
San Diego,61,2023-02-12,2012,2023,2023,0,30463,30625,30624,1,243,6,6,25,5799,5799,5793,5793
San Francisco,61,2023-02-12,586,588,588,0,10691,10747,10746,1,61,4,4,3,1176,1176,1172,1172
San Joaquin,61,2023-02-12,471,472,472,0,6863,6900,6899,1,30,1,1,4,2428,2428,2427,2427
San Luis Obispo,61,2023-02-12,137,137,137,0,1774,1784,1783,1,5,1,1,0,563,563,562,562
San Mateo,61,2023-02-12,511,511,511,0,8130,8175,8174,1,32,0,0,4,747,747,747,747
Santa Barbara,61,2023-02-12,200,200,200,0,4025,4047,4046,1,15,1,1,3,760,760,759,759
Santa Clara,61,2023-02-12,1381,1388,1388,0,22968,23089,23088,1,116,11,11,21,2730,2730,2719,2719
Santa Cruz,61,2023-02-12,227,227,227,0,10297,10352,10351,1,16,0,0,0,276,276,276,276
Shasta,61,2023-02-12,29,29,29,0,664,669,668,1,7,0,0,0,612,612,612,612
Siskiyou,61,2023-02-12,12,12,12,0,214,215,214,1,1,0,0,0,95,95,95,95
Solano,61,2023-02-12,294,294,294,0,3865,3886,3885,1,32,0,0,3,475,475,475,475
Sonoma,61,2023-02-12,218,218,218,0,3446,3466,3465,1,21,1,1,2,558,558,557,557
Stanislaus,61,2023-02-12,278,278,278,0,3876,3898,3897,1,52,1,1,7,1842,1842,1841,1841
Sutter,61,2023-02-12,51,51,51,0,682,687,686,1,0,1,1,0,240,240,239,239
Tehama,61,2023-02-12,18,18,18,0,368,369,368,1,1,1,1,0,234,234,233,233
Trinity,61,2023-02-12,1,1,1,0,24,25,24,1,0,0,0,0,24,24,24,24
Tulare,61,2023-02-12,267,267,267,0,4238,4262,4261,1,29,3,3,1,1588,1588,1585,1585
Tuolumne,61,2023-02-12,38,38,38,0,475,476,475,1,2,0,0,0,211,211,211,211
Ventura,61,2023-02-12,337,337,337,0,6714,6751,6750,1,28,5,5,6,1676,1676,1671,1671
Yolo,61,2023-02-12,86,86,86,0,1250,1257,1256,1,2,1,1,1,444,444,443,443
Yuba,61,2023-02-12,32,32,32,0,660,666,665,1,7,0,0,0,134,134,134,134
Alameda,62,2023-02-19,1056,1063,1063,0,16992,17094,17093,1,83,3,3,6,2122,2122,2119,2119
Amador,62,2023-02-19,25,25,25,0,524,527,526,1,1,0,0,1,98,98,98,98
Butte,62,2023-02-19,53,53,53,0,1109,1116,1115,1,22,2,2,1,492,492,490,490
Calaveras,62,2023-02-19,17,17,17,0,304,305,304,1,1,0,0,0,140,140,140,140
Colusa,62,2023-02-19,7,7,7,0,95,96,95,1,0,0,0,0,22,22,22,22
Contra Costa,62,2023-02-19,695,701,701,0,11104,11170,11169,1,51,3,3,5,1563,1563,1560,1560
Del Norte,62,2023-02-19,14,14,14,0,285,286,285,1,3,0,0,0,59,59,59,59
El Dorado,62,2023-02-19,61,61,61,0,1052,1060,1059,1,3,0,0,1,245,245,245,245
Fresno,62,2023-02-19,478,478,478,0,8588,8641,8640,1,83,5,5,11,3005,3005,3000,3000
Glenn,62,2023-02-19,6,6,6,0,163,165,164,1,4,0,0,0,56,56,56,56
Humboldt,62,2023-02-19,36,36,36,0,619,625,624,1,9,0,0,1,170,170,170,170
Imperial,62,2023-02-19,128,128,128,0,1804,1816,1815,1,0,1,1,8,980,980,979,979
Inyo,62,2023-02-19,6,6,6,0,173,174,173,1,0,0,0,0,63,63,63,63
Kern,62,2023-02-19,416,417,417,0,7915,7964,7963,1,28,3,3,5,2487,2487,2484,2484
Kings,62,2023-02-19,74,74,74,0,1732,1743,1742,1,4,2,2,0,484,484,482,482
Lake,62,2023-02-19,21,21,21,0,522,527,526,1,2,1,1,1,162,162,161,161
Lassen,62,2023-02-19,1,1,1,0,350,351,350,1,0,0,0,0,65,65,65,65
Los Angeles,62,2023-02-19,5748,5783,5783,0,126025,126779,126778,1,578,83,84,72,35564,35565,35481,35481
Madera,62,2023-02-19,57,57,57,0,1142,1150,1149,1,4,0,0,2,377,377,377,377
Marin,62,2023-02-19,158,158,158,0,1990,2003,2002,1,10,0,0,2,260,260,260,260
Mariposa,62,2023-02-19,6,6,6,0,127,128,127,1,0,0,0,0,31,31,31,31
Mendocino,62,2023-02-19,20,20,20,0,523,527,526,1,4,0,0,0,144,144,144,144
Merced,62,2023-02-19,138,138,138,0,1822,1834,1833,1,16,0,0,1,903,903,903,903
Modoc,62,2023-02-19,1,1,1,0,14,15,14,1,0,0,0,0,11,11,11,11
Mono,62,2023-02-19,2,2,2,0,73,74,73,1,0,0,0,0,8,8,8,8
Monterey,62,2023-02-19,167,167,167,0,2432,2447,2446,1,21,0,0,1,803,803,803,803
Napa,62,2023-02-19,77,77,77,0,1183,1190,1189,1,3,2,2,0,165,165,163,163
Nevada,62,2023-02-19,28,28,28,0,614,619,618,1,4,1,1,2,138,138,137,137
Orange,62,2023-02-19,1335,1342,1342,0,20211,20334,20333,1,145,18,18,17,8006,8006,7988,7988
Placer,62,2023-02-19,167,167,167,0,2584,2600,2599,1,41,1,1,4,683,683,682,682
Plumas,62,2023-02-19,8,8,8,0,76,77,76,1,0,0,0,0,15,15,15,15
Riverside,62,2023-02-19,1047,1054,1054,0,15919,16016,16015,1,91,7,7,10,6825,6825,6818,6818
Sacramento,62,2023-02-19,756,762,762,0,12380,12455,12454,1,109,11,11,15,3547,3547,3536,3536
San Benito,62,2023-02-19,31,31,31,0,515,519,518,1,1,1,1,0,113,113,112,112
San Bernardino,62,2023-02-19,963,970,970,0,15956,16051,16050,1,120,0,0,27,8139,8139,8139,8139
San Diego,62,2023-02-19,1891,1903,1903,0,26887,27049,27048,1,224,7,7,28,5806,5806,5799,5799
San Francisco,62,2023-02-19,623,627,627,0,10534,10598,10597,1,77,0,0,7,1176,1176,1176,1176
San Joaquin,62,2023-02-19,457,457,457,0,7598,7645,7644,1,32,1,1,5,2429,2429,2428,2428
San Luis Obispo,62,2023-02-19,115,115,115,0,1604,1615,1614,1,10,0,0,0,563,563,563,563
San Mateo,62,2023-02-19,518,519,519,0,8193,8243,8242,1,40,0,0,4,747,747,747,747
Santa Barbara,62,2023-02-19,203,203,203,0,3764,3788,3787,1,15,0,0,5,760,760,760,760
Santa Clara,62,2023-02-19,1333,1340,1340,0,22032,22166,22165,1,102,11,11,22,2741,2741,2730,2730
Santa Cruz,62,2023-02-19,135,135,135,0,8060,8108,8107,1,15,0,0,0,276,276,276,276
Shasta,62,2023-02-19,21,21,21,0,719,724,723,1,2,0,0,0,612,612,612,612
Siskiyou,62,2023-02-19,12,12,12,0,200,201,200,1,1,0,0,0,95,95,95,95
Solano,62,2023-02-19,252,252,252,0,3674,3697,3696,1,30,0,0,3,475,475,475,475
Sonoma,62,2023-02-19,267,267,267,0,3369,3390,3389,1,23,1,1,3,559,559,558,558
Stanislaus,62,2023-02-19,255,255,255,0,3717,3740,3739,1,51,0,0,7,1842,1842,1842,1842
Sutter,62,2023-02-19,41,41,41,0,543,548,547,1,0,1,1,0,241,241,240,240
Tehama,62,2023-02-19,13,13,13,0,275,276,275,1,1,1,1,0,235,235,234,234
Trinity,62,2023-02-19,0,0,0,0,27,28,27,1,0,0,0,0,24,24,24,24
Tulare,62,2023-02-19,204,204,204,0,4214,4241,4240,1,19,0,0,1,1588,1588,1588,1588
Tuolumne,62,2023-02-19,29,29,29,0,492,494,493,1,0,0,0,0,211,211,211,211
Ventura,62,2023-02-19,284,284,284,0,5955,5992,5991,1,36,4,4,4,1680,1680,1676,1676
Yolo,62,2023-02-19,78,78,78,0,1245,1253,1252,1,1,1,1,1,445,445,444,444
Yuba,62,2023-02-19,29,29,29,0,535,539,538,1,5,0,0,0,134,134,134,134
Alameda,63,2023-02-26,1095,1103,1103,0,16928,17050,17049,1,106,3,3,9,2125,2125,2122,2122
Amador,63,2023-02-26,17,17,17,0,493,496,495,1,1,0,0,0,98,98,98,98
Butte,63,2023-02-26,51,51,51,0,962,970,969,1,8,1,1,1,493,493,492,492
Calaveras,63,2023-02-26,14,14,14,0,300,301,300,1,1,0,0,0,140,140,140,140
Colusa,63,2023-02-26,16,16,16,0,85,86,85,1,0,0,0,0,22,22,22,22
Contra Costa,63,2023-02-26,703,710,710,0,10556,10631,10630,1,67,5,5,7,1568,1568,1563,1563
Del Norte,63,2023-02-26,6,6,6,0,262,263,262,1,0,0,0,0,59,59,59,59
El Dorado,63,2023-02-26,53,53,53,0,1004,1013,1012,1,3,2,2,0,247,247,245,245
Fresno,63,2023-02-26,466,469,469,0,8553,8615,8614,1,83,2,2,12,3007,3007,3005,3005
Glenn,63,2023-02-26,3,3,3,0,141,143,142,1,1,0,0,0,56,56,56,56
Humboldt,63,2023-02-26,29,29,29,0,479,485,484,1,4,0,0,1,170,170,170,170
Imperial,63,2023-02-26,164,164,164,0,1853,1867,1866,1,11,0,0,0,980,980,980,980
Inyo,63,2023-02-26,4,4,4,0,161,162,161,1,0,0,0,0,63,63,63,63
Kern,63,2023-02-26,381,382,382,0,7740,7795,7794,1,45,2,2,8,2489,2489,2487,2487
Kings,63,2023-02-26,64,64,64,0,1650,1664,1663,1,4,1,1,0,485,485,484,484
Lake,63,2023-02-26,21,21,21,0,441,445,444,1,3,1,1,0,163,163,162,162
Lassen,63,2023-02-26,2,2,2,0,326,328,327,1,0,0,0,0,65,65,65,65
Los Angeles,63,2023-02-26,5399,5436,5436,0,128541,129450,129449,1,563,70,72,70,35634,35637,35564,35565
Madera,63,2023-02-26,61,61,61,0,1155,1164,1163,1,6,0,0,1,377,377,377,377
Marin,63,2023-02-26,146,146,146,0,1842,1856,1855,1,22,0,0,1,260,260,260,260
Mariposa,63,2023-02-26,7,7,7,0,93,94,93,1,0,0,0,0,31,31,31,31
Mendocino,63,2023-02-26,30,30,30,0,511,516,515,1,5,0,0,1,144,144,144,144
Merced,63,2023-02-26,120,120,120,0,1769,1783,1782,1,20,0,0,2,903,903,903,903
Modoc,63,2023-02-26,1,1,1,0,9,10,9,1,0,0,0,0,11,11,11,11
Mono,63,2023-02-26,5,5,5,0,51,52,51,1,0,0,0,0,8,8,8,8
Monterey,63,2023-02-26,195,195,195,0,2436,2452,2451,1,26,2,2,1,805,805,803,803
Napa,63,2023-02-26,81,81,81,0,1220,1230,1229,1,4,2,2,3,167,167,165,165
Nevada,63,2023-02-26,26,26,26,0,590,595,594,1,3,0,0,0,138,138,138,138
Orange,63,2023-02-26,1276,1286,1286,0,19141,19277,19276,1,153,17,17,21,8023,8023,8006,8006
Placer,63,2023-02-26,175,175,175,0,2437,2456,2455,1,40,0,0,7,683,683,683,683
Plumas,63,2023-02-26,4,4,4,0,88,89,88,1,0,0,0,0,15,15,15,15
Riverside,63,2023-02-26,911,918,918,0,15001,15108,15107,1,73,9,9,14,6834,6834,6825,6825
Sacramento,63,2023-02-26,869,876,876,0,12153,12240,12239,1,112,7,7,22,3554,3554,3547,3547
San Benito,63,2023-02-26,26,26,26,0,438,440,439,1,1,1,1,0,114,114,113,113
San Bernardino,63,2023-02-26,856,863,863,0,15469,15581,15580,1,150,0,0,19,8139,8139,8139,8139
San Diego,63,2023-02-26,1777,1790,1790,0,26658,26847,26846,1,233,6,6,24,5812,5812,5806,5806
San Francisco,63,2023-02-26,639,645,645,0,10980,11059,11058,1,78,5,5,7,1181,1181,1176,1176
San Joaquin,63,2023-02-26,367,368,368,0,7141,7194,7193,1,41,2,2,3,2431,2431,2429,2429
San Luis Obispo,63,2023-02-26,71,71,71,0,1502,1514,1513,1,13,1,1,0,564,564,563,563
San Mateo,63,2023-02-26,454,456,456,0,6909,6959,6958,1,36,0,0,5,747,747,747,747
Santa Barbara,63,2023-02-26,183,183,183,0,3418,3445,3444,1,17,1,1,7,761,761,760,760
Santa Clara,63,2023-02-26,1238,1246,1246,0,19728,19870,19869,1,120,9,9,25,2750,2750,2741,2741
Santa Cruz,63,2023-02-26,163,163,163,0,6908,6958,6957,1,11,0,0,1,276,276,276,276
Shasta,63,2023-02-26,33,33,33,0,630,636,635,1,8,0,0,1,612,612,612,612
Siskiyou,63,2023-02-26,13,13,13,0,233,234,233,1,0,0,0,0,95,95,95,95
Solano,63,2023-02-26,260,261,261,0,3290,3316,3315,1,30,0,0,7,475,475,475,475
Sonoma,63,2023-02-26,236,236,236,0,3284,3308,3307,1,28,1,1,3,560,560,559,559
Stanislaus,63,2023-02-26,251,251,251,0,3679,3707,3706,1,62,0,0,5,1842,1842,1842,1842
Sutter,63,2023-02-26,43,43,43,0,498,504,503,1,0,0,0,0,241,241,241,241
Tehama,63,2023-02-26,14,14,14,0,258,259,258,1,2,0,0,1,235,235,235,235
Trinity,63,2023-02-26,0,0,0,0,22,23,22,1,0,0,0,0,24,24,24,24
Tulare,63,2023-02-26,228,228,228,0,3702,3728,3727,1,18,3,3,1,1591,1591,1588,1588
Tuolumne,63,2023-02-26,46,46,46,0,481,484,483,1,1,0,0,1,211,211,211,211
Ventura,63,2023-02-26,279,279,279,0,5780,5822,5821,1,36,2,2,4,1682,1682,1680,1680
Yolo,63,2023-02-26,88,88,88,0,1317,1327,1326,1,3,2,2,0,447,447,445,445
Yuba,63,2023-02-26,31,31,31,0,494,500,499,1,1,0,0,0,134,134,134,134
Alameda,64,2023-03-05,960,967,967,0,17133,17275,17274,1,102,5,5,11,2130,2130,2125,2125
Amador,64,2023-03-05,11,11,11,0,457,462,461,1,0,0,0,0,98,98,98,98
Butte,64,2023-03-05,39,39,39,0,578,584,583,1,11,1,1,0,494,494,493,493
Calaveras,64,2023-03-05,17,17,17,0,279,280,279,1,0,1,1,0,141,141,140,140
Colusa,64,2023-03-05,10,10,10,0,120,121,120,1,0,0,0,0,22,22,22,22
Contra Costa,64,2023-03-05,681,688,688,0,10295,10380,10379,1,64,4,4,10,1572,1572,1568,1568
Del Norte,64,2023-03-05,7,7,7,0,263,264,263,1,1,0,0,1,59,59,59,59
El Dorado,64,2023-03-05,51,51,51,0,962,972,971,1,2,0,0,1,247,247,247,247
Fresno,64,2023-03-05,382,385,385,0,8219,8289,8288,1,73,4,4,12,3011,3011,3007,3007
Glenn,64,2023-03-05,3,3,3,0,158,160,159,1,0,0,0,0,56,56,56,56
Humboldt,64,2023-03-05,21,21,21,0,480,486,485,1,4,0,0,1,170,170,170,170
Imperial,64,2023-03-05,158,158,158,0,1565,1578,1577,1,10,0,0,1,980,980,980,980
Inyo,64,2023-03-05,3,3,3,0,133,134,133,1,2,0,0,0,63,63,63,63
Kern,64,2023-03-05,348,350,350,0,8044,8112,8111,1,33,3,3,5,2492,2492,2489,2489
Kings,64,2023-03-05,60,60,60,0,1528,1541,1540,1,1,0,0,0,485,485,485,485
Lake,64,2023-03-05,20,20,20,0,498,503,502,1,1,0,0,0,163,163,163,163
Lassen,64,2023-03-05,4,4,4,0,318,320,319,1,0,0,0,0,65,65,65,65
Los Angeles,64,2023-03-05,4749,4789,4789,0,124738,125763,125762,1,562,75,79,67,35709,35716,35634,35637
Madera,64,2023-03-05,84,84,84,0,1147,1157,1156,1,5,0,0,0,377,377,377,377
Marin,64,2023-03-05,128,128,128,0,1790,1805,1804,1,18,0,0,3,260,260,260,260
Mariposa,64,2023-03-05,0,0,0,0,72,73,72,1,0,0,0,0,31,31,31,31
Mendocino,64,2023-03-05,25,25,25,0,433,437,436,1,7,1,1,0,145,145,144,144
Merced,64,2023-03-05,145,145,145,0,1823,1838,1837,1,17,0,0,2,903,903,903,903
Modoc,64,2023-03-05,1,1,1,0,9,10,9,1,0,0,0,0,11,11,11,11
Mono,64,2023-03-05,4,4,4,0,56,57,56,1,0,0,0,0,8,8,8,8
Monterey,64,2023-03-05,137,137,137,0,2217,2236,2235,1,25,3,3,5,808,808,805,805
Napa,64,2023-03-05,54,54,54,0,1095,1104,1103,1,9,1,1,2,168,168,167,167
Nevada,64,2023-03-05,16,16,16,0,462,467,466,1,1,0,0,0,138,138,138,138
Orange,64,2023-03-05,998,1006,1006,0,18603,18758,18757,1,123,24,24,26,8047,8047,8023,8023
Placer,64,2023-03-05,162,162,162,0,2446,2466,2465,1,63,0,0,6,683,683,683,683
Plumas,64,2023-03-05,1,1,1,0,70,71,70,1,0,0,0,0,15,15,15,15
Riverside,64,2023-03-05,889,896,896,0,14486,14606,14605,1,81,3,3,11,6837,6837,6834,6834
Sacramento,64,2023-03-05,868,875,875,0,11789,11886,11885,1,104,7,7,8,3561,3561,3554,3554
San Benito,64,2023-03-05,18,18,18,0,480,485,484,1,1,0,0,0,114,114,114,114
San Bernardino,64,2023-03-05,783,790,790,0,15478,15608,15607,1,126,0,0,20,8139,8139,8139,8139
San Diego,64,2023-03-05,1454,1466,1466,0,25351,25561,25560,1,205,10,10,16,5822,5822,5812,5812
San Francisco,64,2023-03-05,597,603,603,0,10893,10983,10982,1,76,6,6,11,1187,1187,1181,1181
San Joaquin,64,2023-03-05,394,396,396,0,7029,7089,7088,1,37,1,1,9,2432,2432,2431,2431
San Luis Obispo,64,2023-03-05,90,90,90,0,1377,1391,1390,1,10,5,5,0,569,569,564,564
San Mateo,64,2023-03-05,433,438,438,0,7464,7527,7526,1,27,0,0,3,747,747,747,747
Santa Barbara,64,2023-03-05,143,143,143,0,3738,3770,3769,1,16,3,3,1,764,764,761,761
Santa Clara,64,2023-03-05,1109,1119,1119,0,21563,21743,21742,1,135,9,9,30,2759,2759,2750,2750
Santa Cruz,64,2023-03-05,118,118,118,0,6420,6474,6473,1,19,0,0,1,276,276,276,276
Shasta,64,2023-03-05,24,24,24,0,659,665,664,1,2,0,0,2,612,612,612,612
Siskiyou,64,2023-03-05,5,5,5,0,217,218,217,1,1,0,0,0,95,95,95,95
Solano,64,2023-03-05,257,257,257,0,3403,3432,3431,1,37,0,0,4,475,475,475,475
Sonoma,64,2023-03-05,210,210,210,0,3252,3278,3277,1,34,0,0,2,560,560,560,560
Stanislaus,64,2023-03-05,261,261,261,0,3538,3568,3567,1,67,0,0,8,1842,1842,1842,1842
Sutter,64,2023-03-05,42,42,42,0,606,612,611,1,0,0,0,0,241,241,241,241
Tehama,64,2023-03-05,14,14,14,0,270,271,270,1,4,0,0,1,235,235,235,235
Trinity,64,2023-03-05,2,2,2,0,21,22,21,1,0,0,0,0,24,24,24,24
Tulare,64,2023-03-05,209,209,209,0,3573,3602,3601,1,31,0,0,1,1591,1591,1591,1591
Tuolumne,64,2023-03-05,38,38,38,0,401,405,404,1,1,0,0,0,211,211,211,211
Ventura,64,2023-03-05,248,248,248,0,5084,5128,5127,1,41,2,2,4,1684,1684,1682,1682
Yolo,64,2023-03-05,77,77,77,0,1318,1330,1329,1,4,1,1,0,448,448,447,447
Yuba,64,2023-03-05,42,42,42,0,511,517,516,1,7,0,0,0,134,134,134,134
Alameda,65,2023-03-12,858,865,865,0,15466,15616,15615,1,71,3,3,12,2133,2133,2130,2130
Amador,65,2023-03-12,19,19,19,0,414,419,418,1,4,0,0,0,98,98,98,98
Butte,65,2023-03-12,41,41,41,0,613,620,619,1,8,1,1,1,495,495,494,494
Calaveras,65,2023-03-12,17,17,17,0,236,237,236,1,0,1,1,0,142,142,141,141
Colusa,65,2023-03-12,8,8,8,0,149,152,151,1,0,1,1,0,23,23,22,22
Contra Costa,65,2023-03-12,618,625,625,0,9863,9960,9959,1,54,1,1,9,1573,1573,1572,1572
Del Norte,65,2023-03-12,7,7,7,0,252,253,252,1,0,1,1,0,60,60,59,59
El Dorado,65,2023-03-12,56,56,56,0,882,892,891,1,1,0,0,0,247,247,247,247
Fresno,65,2023-03-12,391,396,396,0,7971,8049,8048,1,83,1,1,8,3012,3012,3011,3011
Glenn,65,2023-03-12,12,12,12,0,146,148,147,1,0,0,0,0,56,56,56,56
Humboldt,65,2023-03-12,27,27,27,0,491,498,497,1,4,0,0,2,170,170,170,170
Imperial,65,2023-03-12,231,231,231,0,2036,2057,2056,1,10,1,1,0,981,981,980,980
Inyo,65,2023-03-12,1,1,1,0,262,266,265,1,0,0,0,0,63,63,63,63
Kern,65,2023-03-12,323,324,324,0,7360,7431,7430,1,43,1,1,9,2493,2493,2492,2492
Kings,65,2023-03-12,69,69,69,0,1500,1515,1514,1,1,0,0,1,485,485,485,485
Lake,65,2023-03-12,12,12,12,0,392,398,397,1,1,0,0,0,163,163,163,163
Lassen,65,2023-03-12,5,5,5,0,323,327,326,1,0,0,0,0,65,65,65,65
Los Angeles,65,2023-03-12,3904,3942,3942,0,120513,121676,121675,1,438,58,62,53,35767,35778,35709,35716
Madera,65,2023-03-12,47,47,47,0,1163,1175,1174,1,6,0,0,0,377,377,377,377
Marin,65,2023-03-12,108,108,108,0,1681,1698,1697,1,24,0,0,1,260,260,260,260
Mariposa,65,2023-03-12,4,4,4,0,82,83,82,1,0,0,0,0,31,31,31,31
Mendocino,65,2023-03-12,17,17,17,0,469,475,474,1,4,0,0,1,145,145,145,145
Merced,65,2023-03-12,109,109,109,0,1500,1515,1514,1,10,0,0,2,903,903,903,903
Modoc,65,2023-03-12,1,1,1,0,12,13,12,1,0,0,0,0,11,11,11,11
Mono,65,2023-03-12,2,2,2,0,51,52,51,1,0,0,0,0,8,8,8,8
Monterey,65,2023-03-12,87,87,87,0,1906,1926,1925,1,25,1,1,1,809,809,808,808
Napa,65,2023-03-12,58,58,58,0,958,969,968,1,3,1,1,2,169,169,168,168
Nevada,65,2023-03-12,18,18,18,0,465,471,470,1,4,0,0,0,138,138,138,138
Orange,65,2023-03-12,917,926,926,0,18617,18798,18797,1,129,22,22,22,8069,8069,8047,8047
Placer,65,2023-03-12,170,170,170,0,2182,2204,2203,1,65,0,0,6,683,683,683,683
Plumas,65,2023-03-12,5,5,5,0,62,63,62,1,0,0,0,0,15,15,15,15
Riverside,65,2023-03-12,874,882,882,0,14489,14629,14628,1,75,6,6,15,6843,6843,6837,6837
Sacramento,65,2023-03-12,724,731,731,0,10738,10842,10841,1,108,7,7,12,3568,3568,3561,3561
San Benito,65,2023-03-12,11,11,11,0,402,408,407,1,0,0,0,0,114,114,114,114
San Bernardino,65,2023-03-12,665,672,672,0,14503,14643,14642,1,129,0,0,17,8139,8139,8139,8139
San Diego,65,2023-03-12,1358,1370,1370,0,24299,24533,24532,1,183,10,10,15,5832,5832,5822,5822
San Francisco,65,2023-03-12,543,548,548,0,9496,9588,9587,1,77,3,3,11,1190,1190,1187,1187
San Joaquin,65,2023-03-12,379,383,383,0,6637,6702,6701,1,38,3,3,4,2435,2435,2432,2432
San Luis Obispo,65,2023-03-12,91,91,91,0,1320,1334,1333,1,8,0,0,0,569,569,569,569
San Mateo,65,2023-03-12,383,388,388,0,6761,6828,6827,1,27,0,0,3,747,747,747,747
Santa Barbara,65,2023-03-12,159,159,159,0,3447,3482,3481,1,11,0,0,2,764,764,764,764
Santa Clara,65,2023-03-12,1049,1060,1060,0,20415,20614,20613,1,126,9,9,16,2768,2768,2759,2759
Santa Cruz,65,2023-03-12,116,116,116,0,3373,3405,3404,1,19,0,0,0,276,276,276,276
Shasta,65,2023-03-12,32,32,32,0,592,599,598,1,2,0,0,3,612,612,612,612
Siskiyou,65,2023-03-12,7,7,7,0,156,157,156,1,0,0,0,0,95,95,95,95
Solano,65,2023-03-12,224,224,224,0,3097,3127,3126,1,24,0,0,4,475,475,475,475
Sonoma,65,2023-03-12,192,192,192,0,2868,2897,2896,1,33,3,3,5,563,563,560,560
Stanislaus,65,2023-03-12,218,218,218,0,3450,3484,3483,1,52,0,0,6,1842,1842,1842,1842
Sutter,65,2023-03-12,24,24,24,0,526,533,532,1,0,0,0,0,241,241,241,241
Tehama,65,2023-03-12,14,14,14,0,229,230,229,1,3,0,0,0,235,235,235,235
Trinity,65,2023-03-12,0,0,0,0,21,22,21,1,0,0,0,0,24,24,24,24
Tulare,65,2023-03-12,170,170,170,0,3146,3177,3176,1,28,3,3,3,1594,1594,1591,1591
Tuolumne,65,2023-03-12,16,16,16,0,344,349,348,1,2,0,0,0,211,211,211,211
Ventura,65,2023-03-12,245,245,245,0,4414,4457,4456,1,30,4,4,2,1688,1688,1684,1684
Yolo,65,2023-03-12,69,69,69,0,1063,1074,1073,1,3,2,2,0,450,450,448,448
Yuba,65,2023-03-12,30,30,30,0,467,473,472,1,5,0,0,0,134,134,134,134
Alameda,66,2023-03-19,797,805,805,0,14996,15164,15163,1,66,4,4,10,2137,2137,2133,2133
Amador,66,2023-03-19,10,10,10,0,377,384,383,1,2,0,0,0,98,98,98,98
Butte,66,2023-03-19,39,39,39,0,514,520,519,1,4,1,1,3,496,496,495,495
Calaveras,66,2023-03-19,7,7,7,0,250,252,251,1,0,0,0,0,142,142,142,142
Colusa,66,2023-03-19,3,3,3,0,160,163,162,1,1,0,0,0,23,23,23,23
Contra Costa,66,2023-03-19,446,452,452,0,9604,9713,9712,1,32,7,7,2,1580,1580,1573,1573
Del Norte,66,2023-03-19,3,3,3,0,221,222,221,1,0,0,0,1,60,60,60,60
El Dorado,66,2023-03-19,38,38,38,0,876,887,886,1,0,0,0,0,247,247,247,247
Fresno,66,2023-03-19,386,393,393,0,7700,7787,7786,1,69,2,2,13,3014,3014,3012,3012
Glenn,66,2023-03-19,4,4,4,0,131,133,132,1,0,0,0,0,56,56,56,56
Humboldt,66,2023-03-19,28,28,28,0,490,497,496,1,4,0,0,2,170,170,170,170
Imperial,66,2023-03-19,151,151,151,0,1633,1653,1652,1,7,0,0,1,981,981,981,981
Inyo,66,2023-03-19,5,5,5,0,209,212,211,1,0,0,0,0,63,63,63,63
Kern,66,2023-03-19,233,234,234,0,7765,7852,7851,1,33,2,2,6,2495,2495,2493,2493
Kings,66,2023-03-19,48,48,48,0,1443,1459,1458,1,1,1,1,0,486,486,485,485
Lake,66,2023-03-19,12,12,12,0,415,421,420,1,1,0,0,1,163,163,163,163
Lassen,66,2023-03-19,6,6,6,0,309,313,312,1,0,0,0,0,65,65,65,65
Los Angeles,66,2023-03-19,3422,3460,3460,0,112913,114165,114164,1,399,70,77,48,35837,35855,35767,35778
Madera,66,2023-03-19,57,57,57,0,1089,1102,1101,1,5,0,0,0,377,377,377,377
Marin,66,2023-03-19,96,96,96,0,1613,1632,1631,1,22,0,0,2,260,260,260,260
Mariposa,66,2023-03-19,2,2,2,0,93,94,93,1,0,0,0,0,31,31,31,31
Mendocino,66,2023-03-19,9,9,9,0,413,419,418,1,3,0,0,0,145,145,145,145
Merced,66,2023-03-19,94,94,94,0,1504,1521,1520,1,4,0,0,1,903,903,903,903
Modoc,66,2023-03-19,0,0,0,0,8,9,8,1,0,0,0,0,11,11,11,11
Mono,66,2023-03-19,4,4,4,0,49,50,49,1,0,0,0,0,8,8,8,8
Monterey,66,2023-03-19,66,66,66,0,1457,1474,1473,1,18,0,0,1,809,809,809,809
Napa,66,2023-03-19,33,33,33,0,923,935,934,1,4,3,3,1,172,172,169,169
Nevada,66,2023-03-19,18,18,18,0,460,466,465,1,4,0,0,0,138,138,138,138
Orange,66,2023-03-19,789,797,797,0,16715,16900,16899,1,115,16,16,22,8085,8085,8069,8069
Placer,66,2023-03-19,131,131,131,0,2162,2186,2185,1,51,0,0,8,683,683,683,683
Plumas,66,2023-03-19,2,2,2,0,49,50,49,1,0,0,0,0,15,15,15,15
Riverside,66,2023-03-19,668,676,676,0,12904,13048,13047,1,63,1,1,9,6844,6844,6843,6843
Sacramento,66,2023-03-19,557,565,565,0,10008,10120,10119,1,90,3,3,16,3571,3571,3568,3568
San Benito,66,2023-03-19,23,23,23,0,473,480,479,1,0,1,1,0,115,115,114,114
San Bernardino,66,2023-03-19,590,598,598,0,14241,14399,14398,1,80,0,0,10,8139,8139,8139,8139
San Diego,66,2023-03-19,1155,1167,1167,0,23476,23738,23737,1,155,9,9,11,5841,5841,5832,5832
San Francisco,66,2023-03-19,441,445,445,0,8636,8732,8731,1,61,2,2,11,1192,1192,1190,1190
San Joaquin,66,2023-03-19,294,296,296,0,6054,6122,6121,1,29,7,7,3,2442,2442,2435,2435
San Luis Obispo,66,2023-03-19,48,48,48,0,1181,1195,1194,1,9,1,1,0,570,570,569,569
San Mateo,66,2023-03-19,318,321,321,0,6478,6550,6549,1,26,0,0,0,747,747,747,747
Santa Barbara,66,2023-03-19,116,116,116,0,3127,3162,3161,1,15,1,1,3,765,765,764,764
Santa Clara,66,2023-03-19,865,874,874,0,17324,17516,17515,1,136,8,8,25,2776,2776,2768,2768
Santa Cruz,66,2023-03-19,119,119,119,0,3061,3096,3095,1,9,0,0,1,276,276,276,276
Shasta,66,2023-03-19,18,18,18,0,612,620,619,1,3,0,0,2,612,612,612,612
Siskiyou,66,2023-03-19,7,7,7,0,167,168,167,1,0,0,0,0,95,95,95,95
Solano,66,2023-03-19,203,204,204,0,2933,2966,2965,1,30,0,0,5,475,475,475,475
Sonoma,66,2023-03-19,187,187,187,0,2790,2822,2821,1,34,0,0,3,563,563,563,563
Stanislaus,66,2023-03-19,189,189,189,0,3277,3315,3314,1,46,0,0,6,1842,1842,1842,1842
Sutter,66,2023-03-19,36,36,36,0,488,495,494,1,0,0,0,0,241,241,241,241
Tehama,66,2023-03-19,16,16,16,0,208,209,208,1,2,1,1,0,236,236,235,235
Trinity,66,2023-03-19,0,0,0,0,18,19,18,1,0,0,0,0,24,24,24,24
Tulare,66,2023-03-19,130,130,130,0,2756,2786,2785,1,22,1,1,1,1595,1595,1594,1594
Tuolumne,66,2023-03-19,16,16,16,0,388,395,394,1,0,0,0,0,211,211,211,211
Ventura,66,2023-03-19,179,179,179,0,4230,4278,4277,1,33,4,4,5,1692,1692,1688,1688
Yolo,66,2023-03-19,59,59,59,0,1084,1097,1096,1,4,0,0,0,450,450,450,450
Yuba,66,2023-03-19,23,23,23,0,467,475,474,1,6,0,0,0,134,134,134,134
Alameda,67,2023-03-26,615,623,623,0,13667,13839,13838,1,79,6,6,10,2143,2143,2137,2137
Amador,67,2023-03-26,13,13,13,0,375,382,381,1,1,0,0,0,98,98,98,98
Butte,67,2023-03-26,35,35,35,0,511,519,518,1,5,1,1,0,497,497,496,496
Calaveras,67,2023-03-26,10,10,10,0,239,243,242,1,0,1,1,0,143,143,142,142
Colusa,67,2023-03-26,5,5,5,0,162,165,164,1,0,0,0,0,23,23,23,23
Contra Costa,67,2023-03-26,407,412,412,0,9067,9181,9180,1,39,1,1,7,1581,1581,1580,1580
Del Norte,67,2023-03-26,5,5,5,0,216,218,217,1,0,0,0,0,60,60,60,60
El Dorado,67,2023-03-26,34,34,34,0,781,791,790,1,2,0,0,0,247,247,247,247
Fresno,67,2023-03-26,271,274,274,0,7392,7487,7486,1,60,1,1,6,3015,3015,3014,3014
Glenn,67,2023-03-26,5,5,5,0,135,137,136,1,0,0,0,0,56,56,56,56
Humboldt,67,2023-03-26,11,11,11,0,479,486,485,1,4,1,1,2,171,171,170,170
Imperial,67,2023-03-26,154,154,154,0,1727,1750,1749,1,13,0,0,2,981,981,981,981
Inyo,67,2023-03-26,15,15,15,0,301,305,304,1,0,0,0,0,63,63,63,63
Kern,67,2023-03-26,188,188,188,0,7079,7168,7167,1,30,1,1,3,2496,2496,2495,2495
Kings,67,2023-03-26,31,31,31,0,1354,1372,1371,1,1,0,0,0,486,486,486,486
Lake,67,2023-03-26,12,12,12,0,353,359,358,1,0,1,1,0,164,164,163,163
Lassen,67,2023-03-26,6,6,6,0,330,336,335,1,0,0,0,0,65,65,65,65
Los Angeles,67,2023-03-26,2561,2594,2594,0,105551,106870,106869,1,350,33,35,42,35870,35890,35837,35855
Madera,67,2023-03-26,39,39,39,0,1004,1018,1017,1,4,0,0,0,377,377,377,377
Marin,67,2023-03-26,81,81,81,0,1371,1391,1390,1,15,0,0,1,260,260,260,260
Mariposa,67,2023-03-26,1,1,1,0,79,80,79,1,0,0,0,0,31,31,31,31
Mendocino,67,2023-03-26,15,15,15,0,420,428,427,1,1,0,0,1,145,145,145,145
Merced,67,2023-03-26,108,108,108,0,1338,1355,1354,1,4,0,0,1,903,903,903,903
Modoc,67,2023-03-26,1,1,1,0,7,8,7,1,0,0,0,0,11,11,11,11
Mono,67,2023-03-26,1,1,1,0,51,52,51,1,0,0,0,0,8,8,8,8
Monterey,67,2023-03-26,45,45,45,0,1682,1704,1703,1,18,0,0,1,809,809,809,809
Napa,67,2023-03-26,38,38,38,0,871,884,883,1,3,0,0,1,172,172,172,172
Nevada,67,2023-03-26,22,22,22,0,474,481,480,1,3,0,0,0,138,138,138,138
Orange,67,2023-03-26,646,653,653,0,15656,15854,15853,1,104,12,12,17,8097,8097,8085,8085
Placer,67,2023-03-26,111,111,111,0,1961,1988,1987,1,35,0,0,6,683,683,683,683
Plumas,67,2023-03-26,1,1,1,0,59,60,59,1,0,0,0,0,15,15,15,15
Riverside,67,2023-03-26,566,573,573,0,11467,11612,11611,1,45,3,3,7,6847,6847,6844,6844
Sacramento,67,2023-03-26,440,447,447,0,9571,9691,9690,1,91,10,10,11,3581,3581,3571,3571
San Benito,67,2023-03-26,39,39,39,0,714,723,722,1,1,0,0,0,115,115,115,115
San Bernardino,67,2023-03-26,426,433,433,0,12618,12777,12776,1,81,0,0,10,8139,8139,8139,8139
San Diego,67,2023-03-26,914,926,926,0,21048,21311,21310,1,144,7,7,12,5848,5848,5841,5841
San Francisco,67,2023-03-26,392,399,399,0,8098,8199,8198,1,51,5,5,5,1197,1197,1192,1192
San Joaquin,67,2023-03-26,250,251,251,0,5666,5738,5737,1,22,4,4,9,2446,2446,2442,2442
San Luis Obispo,67,2023-03-26,45,45,45,0,1166,1181,1180,1,3,0,0,0,570,570,570,570
San Mateo,67,2023-03-26,268,271,271,0,5796,5869,5868,1,30,0,0,2,747,747,747,747
Santa Barbara,67,2023-03-26,84,84,84,0,3290,3332,3331,1,12,0,0,2,765,765,765,765
Santa Clara,67,2023-03-26,684,693,693,0,16276,16481,16480,1,109,9,9,17,2785,2785,2776,2776
Santa Cruz,67,2023-03-26,133,133,133,0,3099,3139,3138,1,8,0,0,1,276,276,276,276
Shasta,67,2023-03-26,16,16,16,0,511,517,516,1,3,0,0,2,612,612,612,612
Siskiyou,67,2023-03-26,2,2,2,0,153,154,153,1,0,0,0,0,95,95,95,95
Solano,67,2023-03-26,172,172,172,0,2711,2746,2745,1,20,1,1,3,476,476,475,475
Sonoma,67,2023-03-26,160,160,160,0,2371,2401,2400,1,34,2,2,1,565,565,563,563
Stanislaus,67,2023-03-26,148,148,148,0,2722,2758,2757,1,35,0,0,4,1842,1842,1842,1842
Sutter,67,2023-03-26,33,33,33,0,417,425,424,1,0,0,0,0,241,241,241,241
Tehama,67,2023-03-26,5,5,5,0,210,212,211,1,2,1,1,0,237,237,236,236
Trinity,67,2023-03-26,0,0,0,0,21,22,21,1,0,0,0,0,24,24,24,24
Tulare,67,2023-03-26,103,103,103,0,2753,2787,2786,1,24,0,0,1,1595,1595,1595,1595
Tuolumne,67,2023-03-26,8,8,8,0,329,334,333,1,0,0,0,0,211,211,211,211
Ventura,67,2023-03-26,142,142,142,0,4054,4105,4104,1,27,2,2,4,1694,1694,1692,1692
Yolo,67,2023-03-26,66,66,66,0,1112,1127,1126,1,4,1,1,0,451,451,450,450
Yuba,67,2023-03-26,15,15,15,0,433,441,440,1,0,0,0,0,134,134,134,134
Alameda,68,2023-04-02,567,574,574,0,12662,12843,12842,1,56,2,2,8,2145,2145,2143,2143
Amador,68,2023-04-02,16,16,16,0,301,307,306,1,1,0,0,0,98,98,98,98
Butte,68,2023-04-02,20,20,20,0,404,410,409,1,3,0,0,0,497,497,497,497
Calaveras,68,2023-04-02,9,9,9,0,219,222,221,1,0,0,0,0,143,143,143,143
Colusa,68,2023-04-02,8,8,8,0,171,174,173,1,2,0,0,0,23,23,23,23
Contra Costa,68,2023-04-02,384,391,391,0,8628,8752,8751,1,36,3,3,7,1584,1584,1581,1581
Del Norte,68,2023-04-02,5,5,5,0,208,211,210,1,0,0,0,0,60,60,60,60
El Dorado,68,2023-04-02,63,63,63,0,783,795,794,1,3,0,0,0,247,247,247,247
Fresno,68,2023-04-02,264,268,268,0,7120,7222,7221,1,53,4,4,12,3019,3019,3015,3015
Glenn,68,2023-04-02,4,4,4,0,125,127,126,1,0,0,0,0,56,56,56,56
Humboldt,68,2023-04-02,19,19,19,0,437,444,443,1,5,0,0,0,171,171,171,171
Imperial,68,2023-04-02,187,188,188,0,1555,1578,1577,1,15,0,0,2,981,981,981,981
Inyo,68,2023-04-02,1,1,1,0,145,148,147,1,0,0,0,0,63,63,63,63
Kern,68,2023-04-02,152,152,152,0,5834,5918,5917,1,26,2,2,2,2498,2498,2496,2496
Kings,68,2023-04-02,34,34,34,0,1106,1123,1122,1,5,0,0,0,486,486,486,486
Lake,68,2023-04-02,15,15,15,0,362,368,367,1,0,0,0,0,164,164,164,164
Lassen,68,2023-04-02,4,4,4,0,195,198,197,1,0,0,0,0,65,65,65,65
Los Angeles,68,2023-04-02,2390,2423,2423,0,99910,101329,101328,1,339,37,42,39,35907,35932,35870,35890
Madera,68,2023-04-02,36,36,36,0,867,881,880,1,1,0,0,0,377,377,377,377
Marin,68,2023-04-02,90,90,90,0,1288,1307,1306,1,16,0,0,0,260,260,260,260
Mariposa,68,2023-04-02,6,6,6,0,76,77,76,1,0,0,0,0,31,31,31,31
Mendocino,68,2023-04-02,17,17,17,0,369,375,374,1,0,0,0,1,145,145,145,145
Merced,68,2023-04-02,74,74,74,0,1054,1070,1069,1,4,0,0,0,903,903,903,903
Modoc,68,2023-04-02,4,4,4,0,9,10,9,1,0,0,0,0,11,11,11,11
Mono,68,2023-04-02,2,2,2,0,40,41,40,1,0,0,0,0,8,8,8,8
Monterey,68,2023-04-02,65,65,65,0,1465,1486,1485,1,15,1,1,1,810,810,809,809
Napa,68,2023-04-02,45,45,45,0,852,865,864,1,6,2,2,2,174,174,172,172
Nevada,68,2023-04-02,48,48,48,0,458,467,466,1,6,1,1,0,139,139,138,138
Orange,68,2023-04-02,642,651,651,0,15314,15533,15532,1,94,16,18,13,8113,8115,8097,8097
Placer,68,2023-04-02,105,105,105,0,1877,1904,1903,1,38,0,0,4,683,683,683,683
Plumas,68,2023-04-02,2,2,2,0,62,63,62,1,0,0,0,0,15,15,15,15
Riverside,68,2023-04-02,449,456,456,0,10812,10967,10966,1,57,4,4,7,6851,6851,6847,6847
Sacramento,68,2023-04-02,504,511,511,0,9127,9258,9257,1,66,2,2,17,3583,3583,3581,3581
San Benito,68,2023-04-02,28,28,28,0,654,666,665,1,0,0,0,0,115,115,115,115
San Bernardino,68,2023-04-02,451,458,458,0,11987,12158,12157,1,62,0,0,11,8139,8139,8139,8139
San Diego,68,2023-04-02,778,789,789,0,19721,20003,20002,1,137,6,6,13,5854,5854,5848,5848
San Francisco,68,2023-04-02,344,349,349,0,6842,6939,6938,1,35,4,4,10,1201,1201,1197,1197
San Joaquin,68,2023-04-02,228,229,229,0,5165,5239,5238,1,30,3,3,9,2449,2449,2446,2446
San Luis Obispo,68,2023-04-02,41,41,41,0,1024,1039,1038,1,3,4,4,0,574,574,570,570
San Mateo,68,2023-04-02,272,276,276,0,5627,5707,5706,1,26,0,0,0,747,747,747,747
Santa Barbara,68,2023-04-02,99,99,99,0,2708,2747,2746,1,14,0,0,1,765,765,765,765
Santa Clara,68,2023-04-02,646,654,654,0,15056,15272,15271,1,76,2,2,12,2787,2787,2785,2785
Santa Cruz,68,2023-04-02,130,130,130,0,2633,2672,2671,1,15,0,0,0,276,276,276,276
Shasta,68,2023-04-02,16,16,16,0,506,515,514,1,2,0,0,1,612,612,612,612
Siskiyou,68,2023-04-02,0,0,0,0,92,93,92,1,0,0,0,0,95,95,95,95
Solano,68,2023-04-02,147,148,148,0,2513,2550,2549,1,21,0,0,2,476,476,476,476
Sonoma,68,2023-04-02,137,137,137,0,2180,2211,2210,1,25,2,2,2,567,567,565,565
Stanislaus,68,2023-04-02,126,126,126,0,2529,2567,2566,1,35,0,0,3,1842,1842,1842,1842
Sutter,68,2023-04-02,35,35,35,0,388,396,395,1,0,0,0,0,241,241,241,241
Tehama,68,2023-04-02,11,11,11,0,190,193,192,1,0,0,0,0,237,237,237,237
Trinity,68,2023-04-02,0,0,0,0,14,15,14,1,0,0,0,0,24,24,24,24
Tulare,68,2023-04-02,103,103,103,0,2689,2727,2726,1,21,0,0,0,1595,1595,1595,1595
Tuolumne,68,2023-04-02,7,7,7,0,261,265,264,1,1,0,0,0,211,211,211,211
Ventura,68,2023-04-02,144,144,144,0,3673,3727,3726,1,26,6,6,1,1700,1700,1694,1694
Yolo,68,2023-04-02,40,40,40,0,969,983,982,1,4,1,1,1,452,452,451,451
Yuba,68,2023-04-02,19,19,19,0,400,408,407,1,1,0,0,0,134,134,134,134
Alameda,69,2023-04-09,545,554,554,0,10968,11149,11148,1,56,2,2,10,2147,2147,2145,2145
Amador,69,2023-04-09,8,8,8,0,212,217,216,1,1,0,0,0,98,98,98,98
Butte,69,2023-04-09,18,18,18,0,453,462,461,1,5,1,1,0,498,498,497,497
Calaveras,69,2023-04-09,10,10,10,0,199,203,202,1,0,0,0,0,143,143,143,143
Colusa,69,2023-04-09,2,2,2,0,152,155,154,1,1,0,0,0,23,23,23,23
Contra Costa,69,2023-04-09,402,409,409,0,8234,8370,8369,1,34,0,0,6,1584,1584,1584,1584
Del Norte,69,2023-04-09,3,3,3,0,130,131,130,1,0,1,1,0,61,61,60,60
El Dorado,69,2023-04-09,43,43,43,0,652,663,662,1,3,0,0,0,247,247,247,247
Fresno,69,2023-04-09,266,272,272,0,6293,6398,6397,1,59,1,1,3,3020,3020,3019,3019
Glenn,69,2023-04-09,5,5,5,0,133,135,134,1,1,0,0,0,56,56,56,56
Humboldt,69,2023-04-09,18,18,18,0,422,428,427,1,4,0,0,0,171,171,171,171
Imperial,69,2023-04-09,147,148,148,0,1308,1330,1329,1,6,1,1,0,982,982,981,981
Inyo,69,2023-04-09,6,6,6,0,173,176,175,1,0,0,0,0,63,63,63,63
Kern,69,2023-04-09,148,149,149,0,5120,5204,5203,1,23,0,0,3,2498,2498,2498,2498
Kings,69,2023-04-09,37,37,37,0,865,880,879,1,3,0,0,1,486,486,486,486
Lake,69,2023-04-09,13,13,13,0,296,302,301,1,0,0,0,0,164,164,164,164
Lassen,69,2023-04-09,0,0,0,0,115,116,115,1,0,0,0,0,65,65,65,65
Los Angeles,69,2023-04-09,2287,2326,2326,0,86220,87633,87632,1,318,42,49,39,35949,35981,35907,35932
Madera,69,2023-04-09,70,70,70,0,847,862,861,1,0,0,0,0,377,377,377,377
Marin,69,2023-04-09,103,103,103,0,1150,1170,1169,1,14,0,0,2,260,260,260,260
Mariposa,69,2023-04-09,3,3,3,0,57,58,57,1,0,0,0,0,31,31,31,31
Mendocino,69,2023-04-09,12,12,12,0,353,361,360,1,2,0,0,1,145,145,145,145
Merced,69,2023-04-09,53,53,53,0,758,770,769,1,4,0,0,1,903,903,903,903
Modoc,69,2023-04-09,1,1,1,0,9,10,9,1,0,0,0,0,11,11,11,11
Mono,69,2023-04-09,1,1,1,0,41,42,41,1,0,0,0,0,8,8,8,8
Monterey,69,2023-04-09,50,50,50,0,1487,1513,1512,1,11,1,1,1,811,811,810,810
Napa,69,2023-04-09,27,27,27,0,654,666,665,1,3,1,1,0,175,175,174,174
Nevada,69,2023-04-09,49,49,49,0,352,361,360,1,2,0,0,0,139,139,139,139
Orange,69,2023-04-09,556,565,565,0,15293,15546,15545,1,74,13,15,14,8126,8130,8113,8115
Placer,69,2023-04-09,96,96,96,0,1569,1597,1596,1,34,0,0,5,683,683,683,683
Plumas,69,2023-04-09,3,3,3,0,37,38,37,1,0,0,0,0,15,15,15,15
Riverside,69,2023-04-09,417,424,424,0,11074,11257,11256,1,56,1,1,5,6852,6852,6851,6851
Sacramento,69,2023-04-09,459,466,466,0,7962,8094,8093,1,84,5,6,13,3588,3589,3583,3583
San Benito,69,2023-04-09,24,24,24,0,438,448,447,1,2,1,1,0,116,116,115,115
San Bernardino,69,2023-04-09,483,491,491,0,11865,12060,12059,1,72,0,0,11,8139,8139,8139,8139
San Diego,69,2023-04-09,819,832,832,0,20637,20975,20974,1,127,3,3,21,5857,5857,5854,5854
San Francisco,69,2023-04-09,282,288,288,0,6027,6128,6127,1,38,6,6,6,1207,1207,1201,1201
San Joaquin,69,2023-04-09,202,206,206,0,4591,4668,4667,1,20,3,3,7,2452,2452,2449,2449
San Luis Obispo,69,2023-04-09,58,58,58,0,877,893,892,1,3,1,1,1,575,575,574,574
San Mateo,69,2023-04-09,227,232,232,0,5196,5281,5280,1,13,0,0,2,747,747,747,747
Santa Barbara,69,2023-04-09,94,94,94,0,2777,2824,2823,1,17,0,0,3,765,765,765,765
Santa Clara,69,2023-04-09,633,644,644,0,14784,15026,15025,1,85,3,3,14,2790,2790,2787,2787
Santa Cruz,69,2023-04-09,104,104,104,0,1593,1620,1619,1,17,0,0,1,276,276,276,276
Shasta,69,2023-04-09,23,23,23,0,492,501,500,1,5,0,0,1,612,612,612,612
Siskiyou,69,2023-04-09,9,9,9,0,113,114,113,1,0,0,0,0,95,95,95,95
Solano,69,2023-04-09,119,120,120,0,2016,2050,2049,1,17,0,0,3,476,476,476,476
Sonoma,69,2023-04-09,125,125,125,0,2018,2052,2051,1,17,2,2,1,569,569,567,567
Stanislaus,69,2023-04-09,128,128,128,0,2327,2367,2366,1,25,0,0,2,1842,1842,1842,1842
Sutter,69,2023-04-09,34,34,34,0,421,429,428,1,0,0,0,0,241,241,241,241
Tehama,69,2023-04-09,5,5,5,0,167,170,169,1,1,0,0,0,237,237,237,237
Trinity,69,2023-04-09,2,2,2,0,12,13,12,1,0,0,0,0,24,24,24,24
Tulare,69,2023-04-09,77,77,77,0,2386,2427,2426,1,12,0,0,1,1595,1595,1595,1595
Tuolumne,69,2023-04-09,4,4,4,0,205,209,208,1,0,0,0,0,211,211,211,211
Ventura,69,2023-04-09,148,148,148,0,3255,3309,3308,1,29,0,0,1,1700,1700,1700,1700
Yolo,69,2023-04-09,58,58,58,0,919,936,935,1,3,0,0,0,452,452,452,452
Yuba,69,2023-04-09,24,24,24,0,390,398,397,1,4,0,0,0,134,134,134,134
Alameda,70,2023-04-16,575,588,588,0,10732,10943,10942,1,62,4,4,8,2151,2151,2147,2147
Amador,70,2023-04-16,17,17,17,0,198,204,203,1,0,0,0,0,98,98,98,98
Butte,70,2023-04-16,33,33,33,0,456,466,465,1,7,0,0,0,498,498,498,498
Calaveras,70,2023-04-16,8,8,8,0,164,167,166,1,0,0,0,0,143,143,143,143
Colusa,70,2023-04-16,1,1,1,0,47,48,47,1,0,1,1,0,24,24,23,23
Contra Costa,70,2023-04-16,396,404,404,0,7685,7836,7835,1,34,1,1,3,1585,1585,1584,1584
Del Norte,70,2023-04-16,1,1,1,0,106,107,106,1,0,0,0,0,61,61,61,61
El Dorado,70,2023-04-16,44,44,44,0,632,645,644,1,1,0,0,0,247,247,247,247
Fresno,70,2023-04-16,253,259,259,0,6298,6422,6421,1,55,2,2,5,3022,3022,3020,3020
Glenn,70,2023-04-16,7,7,7,0,123,125,124,1,0,0,0,0,56,56,56,56
Humboldt,70,2023-04-16,9,9,9,0,372,381,380,1,3,0,0,0,171,171,171,171
Imperial,70,2023-04-16,169,172,172,0,1170,1194,1193,1,9,0,0,0,982,982,982,982
Inyo,70,2023-04-16,4,4,4,0,155,158,157,1,0,0,0,0,63,63,63,63
Kern,70,2023-04-16,149,151,151,0,4244,4328,4327,1,18,0,0,6,2498,2498,2498,2498
Kings,70,2023-04-16,56,56,56,0,833,850,849,1,1,0,0,0,486,486,486,486
Lake,70,2023-04-16,17,17,17,0,274,280,279,1,1,0,0,0,164,164,164,164
Lassen,70,2023-04-16,2,2,2,0,71,72,71,1,0,0,0,0,65,65,65,65
Los Angeles,70,2023-04-16,2403,2448,2448,0,96747,98632,98631,1,280,41,51,28,35990,36032,35949,35981
Madera,70,2023-04-16,70,70,70,0,885,903,902,1,0,0,0,0,377,377,377,377
Marin,70,2023-04-16,71,71,71,0,985,1007,1006,1,15,0,0,3,260,260,260,260
Mariposa,70,2023-04-16,2,2,2,0,58,59,58,1,0,0,0,0,31,31,31,31
Mendocino,70,2023-04-16,23,23,23,0,322,329,328,1,1,0,0,1,145,145,145,145
Merced,70,2023-04-16,52,52,52,0,724,739,738,1,8,0,0,0,903,903,903,903
Modoc,70,2023-04-16,1,1,1,0,4,5,4,1,0,0,0,0,11,11,11,11
Mono,70,2023-04-16,1,1,1,0,43,44,43,1,0,0,0,0,8,8,8,8
Monterey,70,2023-04-16,43,43,43,0,1333,1358,1357,1,15,0,0,0,811,811,811,811
Napa,70,2023-04-16,37,37,37,0,740,756,755,1,4,0,0,1,175,175,175,175
Nevada,70,2023-04-16,29,29,29,0,328,336,335,1,5,0,0,0,139,139,139,139
Orange,70,2023-04-16,526,536,536,0,15352,15654,15653,1,81,10,11,11,8136,8141,8126,8130
Placer,70,2023-04-16,93,93,93,0,1550,1580,1579,1,40,0,0,4,683,683,683,683
Plumas,70,2023-04-16,4,4,4,0,48,49,48,1,0,0,0,0,15,15,15,15
Riverside,70,2023-04-16,400,407,407,0,11162,11382,11381,1,56,1,1,4,6853,6853,6852,6852
Sacramento,70,2023-04-16,495,506,506,0,7493,7641,7640,1,74,1,1,10,3589,3590,3588,3589
San Benito,70,2023-04-16,13,13,13,0,450,460,459,1,0,0,0,0,116,116,116,116
San Bernardino,70,2023-04-16,461,470,470,0,11102,11318,11317,1,58,0,0,10,8139,8139,8139,8139
San Diego,70,2023-04-16,845,861,861,0,19961,20351,20350,1,131,1,1,18,5858,5858,5857,5857
San Francisco,70,2023-04-16,323,330,330,0,6244,6367,6366,1,43,2,2,7,1209,1209,1207,1207
San Joaquin,70,2023-04-16,158,160,160,0,4265,4350,4349,1,18,1,1,5,2453,2453,2452,2452
San Luis Obispo,70,2023-04-16,63,63,63,0,893,912,911,1,9,0,0,0,575,575,575,575
San Mateo,70,2023-04-16,199,204,204,0,5189,5292,5291,1,20,0,0,4,747,747,747,747
Santa Barbara,70,2023-04-16,117,117,117,0,2729,2782,2781,1,16,0,0,3,765,765,765,765
Santa Clara,70,2023-04-16,586,598,598,0,12485,12730,12729,1,85,6,7,15,2796,2797,2790,2790
Santa Cruz,70,2023-04-16,99,99,99,0,2281,2325,2324,1,20,0,0,0,276,276,276,276
Shasta,70,2023-04-16,30,30,30,0,522,532,531,1,5,0,0,1,612,612,612,612
Siskiyou,70,2023-04-16,6,6,6,0,81,82,81,1,0,0,0,1,95,95,95,95
Solano,70,2023-04-16,165,169,169,0,1922,1959,1958,1,33,0,0,2,476,476,476,476
Sonoma,70,2023-04-16,147,149,149,0,2087,2129,2128,1,31,1,1,5,570,570,569,569
Stanislaus,70,2023-04-16,117,117,117,0,2037,2078,2077,1,25,0,0,3,1842,1842,1842,1842
Sutter,70,2023-04-16,18,18,18,0,313,321,320,1,0,0,0,0,241,241,241,241
Tehama,70,2023-04-16,11,11,11,0,172,175,174,1,2,0,0,0,237,237,237,237
Trinity,70,2023-04-16,0,0,0,0,14,15,14,1,0,0,0,0,24,24,24,24
Tulare,70,2023-04-16,107,107,107,0,2328,2374,2373,1,13,1,1,1,1596,1596,1595,1595
Tuolumne,70,2023-04-16,6,6,6,0,206,213,212,1,0,0,0,0,211,211,211,211
Ventura,70,2023-04-16,115,115,115,0,3368,3436,3435,1,26,2,2,2,1702,1702,1700,1700
Yolo,70,2023-04-16,60,60,60,0,760,776,775,1,2,1,1,0,453,453,452,452
Yuba,70,2023-04-16,15,15,15,0,293,301,300,1,5,0,0,1,134,134,134,134
Alameda,71,2023-04-23,551,565,565,0,9992,10240,10239,1,68,2,3,5,2153,2154,2151,2151
Amador,71,2023-04-23,15,15,15,0,191,198,197,1,1,0,0,0,98,98,98,98
Butte,71,2023-04-23,34,34,34,0,458,470,469,1,11,1,1,1,499,499,498,498
Calaveras,71,2023-04-23,6,6,6,0,182,189,188,1,0,0,0,0,143,143,143,143
Colusa,71,2023-04-23,1,1,1,0,38,39,38,1,0,0,0,0,24,24,24,24
Contra Costa,71,2023-04-23,372,380,380,0,7307,7488,7487,1,42,6,9,6,1591,1594,1585,1585
Del Norte,71,2023-04-23,3,3,3,0,93,95,94,1,0,0,0,0,61,61,61,61
El Dorado,71,2023-04-23,44,44,44,0,628,643,642,1,3,0,0,0,247,247,247,247
Fresno,71,2023-04-23,225,232,232,0,5986,6135,6134,1,58,4,5,7,3026,3027,3022,3022
Glenn,71,2023-04-23,3,3,3,0,108,111,110,1,0,0,0,0,56,56,56,56
Humboldt,71,2023-04-23,7,7,7,0,255,263,262,1,0,0,0,0,171,171,171,171
Imperial,71,2023-04-23,138,141,141,0,1156,1186,1185,1,4,1,2,0,983,984,982,982
Inyo,71,2023-04-23,4,4,4,0,152,155,154,1,0,0,0,0,63,63,63,63
Kern,71,2023-04-23,91,91,91,0,3634,3725,3724,1,15,1,1,4,2499,2499,2498,2498
Kings,71,2023-04-23,24,24,24,0,742,760,759,1,1,0,0,0,486,486,486,486
Lake,71,2023-04-23,12,12,12,0,303,311,310,1,0,0,0,2,164,164,164,164
Lassen,71,2023-04-23,1,1,1,0,74,75,74,1,0,0,0,0,65,65,65,65
Los Angeles,71,2023-04-23,1914,1962,1962,0,92974,95269,95268,1,241,29,41,26,36019,36073,35990,36032
Madera,71,2023-04-23,28,28,28,0,734,752,751,1,2,0,0,0,377,377,377,377
Marin,71,2023-04-23,65,65,65,0,937,962,961,1,15,0,0,1,260,260,260,260
Mariposa,71,2023-04-23,4,4,4,0,52,53,52,1,0,0,0,0,31,31,31,31
Mendocino,71,2023-04-23,10,10,10,0,268,275,274,1,2,1,1,0,146,146,145,145
Merced,71,2023-04-23,58,58,58,0,744,763,762,1,7,0,0,0,903,903,903,903
Modoc,71,2023-04-23,2,2,2,0,8,9,8,1,0,0,0,0,11,11,11,11
Mono,71,2023-04-23,1,1,1,0,42,43,42,1,0,0,0,0,8,8,8,8
Monterey,71,2023-04-23,58,58,58,0,1419,1455,1454,1,16,0,0,2,811,811,811,811
Napa,71,2023-04-23,27,27,27,0,699,718,717,1,2,0,0,1,175,175,175,175
Nevada,71,2023-04-23,28,28,28,0,325,334,333,1,2,0,0,0,139,139,139,139
Orange,71,2023-04-23,510,522,522,0,14111,14463,14462,1,81,11,15,12,8147,8156,8136,8141
Placer,71,2023-04-23,109,110,110,0,1397,1433,1432,1,35,2,2,3,685,685,683,683
Plumas,71,2023-04-23,2,2,2,0,72,74,73,1,1,0,0,0,15,15,15,15
Riverside,71,2023-04-23,314,323,323,0,11248,11526,11525,1,54,1,1,6,6854,6854,6853,6853
Sacramento,71,2023-04-23,471,482,482,0,7340,7523,7522,1,64,3,4,7,3592,3594,3589,3590
San Benito,71,2023-04-23,9,9,9,0,408,419,418,1,1,0,0,0,116,116,116,116
San Bernardino,71,2023-04-23,407,417,417,0,10719,10985,10984,1,130,0,0,14,8139,8139,8139,8139
San Diego,71,2023-04-23,723,742,742,0,18830,19297,19296,1,114,5,7,16,5863,5865,5858,5858
San Francisco,71,2023-04-23,305,313,313,0,5625,5766,5765,1,52,4,5,7,1213,1214,1209,1209
San Joaquin,71,2023-04-23,157,161,161,0,4394,4505,4504,1,23,0,0,1,2453,2453,2453,2453
San Luis Obispo,71,2023-04-23,38,38,38,0,778,797,796,1,8,1,1,0,576,576,575,575
San Mateo,71,2023-04-23,190,197,197,0,4708,4826,4825,1,18,0,0,4,747,747,747,747
Santa Barbara,71,2023-04-23,108,109,109,0,2811,2881,2880,1,13,1,1,3,766,766,765,765
Santa Clara,71,2023-04-23,518,532,532,0,12203,12506,12505,1,86,3,4,17,2799,2801,2796,2797
Santa Cruz,71,2023-04-23,65,65,65,0,1571,1610,1609,1,23,0,0,2,276,276,276,276
Shasta,71,2023-04-23,19,19,19,0,409,421,420,1,3,0,0,0,612,612,612,612
Siskiyou,71,2023-04-23,6,6,6,0,93,95,94,1,2,0,0,0,95,95,95,95
Solano,71,2023-04-23,143,146,146,0,1989,2039,2038,1,18,0,0,4,476,476,476,476
Sonoma,71,2023-04-23,178,184,184,0,2105,2158,2157,1,28,0,0,1,570,570,570,570
Stanislaus,71,2023-04-23,104,104,104,0,2082,2133,2132,1,19,0,0,3,1842,1842,1842,1842
Sutter,71,2023-04-23,27,27,27,0,265,272,271,1,0,0,0,0,241,241,241,241
Tehama,71,2023-04-23,7,7,7,0,153,157,156,1,0,0,0,0,237,237,237,237
Trinity,71,2023-04-23,2,2,2,0,15,16,15,1,0,0,0,0,24,24,24,24
Tulare,71,2023-04-23,73,73,73,0,2093,2145,2144,1,15,1,1,0,1597,1597,1596,1596
Tuolumne,71,2023-04-23,4,4,4,0,160,166,165,1,0,0,0,0,211,211,211,211
Ventura,71,2023-04-23,129,131,131,0,3095,3174,3173,1,25,0,0,1,1702,1702,1702,1702
Yolo,71,2023-04-23,39,39,39,0,839,860,859,1,2,1,2,0,454,455,453,453
Yuba,71,2023-04-23,17,17,17,0,260,268,267,1,5,0,0,0,134,134,134,134
Alameda,72,2023-04-30,472,489,489,0,9237,9552,9551,1,69,2,4,5,2155,2158,2153,2154
Amador,72,2023-04-30,7,7,7,0,137,143,142,1,1,0,0,0,98,98,98,98
Butte,72,2023-04-30,25,25,25,0,403,416,415,1,20,0,0,0,499,499,499,499
Calaveras,72,2023-04-30,3,3,3,0,151,158,157,1,1,0,0,0,143,143,143,143
Colusa,72,2023-04-30,4,4,4,0,49,50,49,1,0,0,0,0,24,24,24,24
Contra Costa,72,2023-04-30,362,375,375,0,7013,7253,7252,1,40,2,4,4,1593,1598,1591,1594
Del Norte,72,2023-04-30,3,3,3,0,100,104,103,1,0,0,0,0,61,61,61,61
El Dorado,72,2023-04-30,41,41,41,0,605,627,626,1,2,0,0,1,247,247,247,247
Fresno,72,2023-04-30,272,280,280,0,5828,6031,6030,1,59,3,7,9,3029,3034,3026,3027
Glenn,72,2023-04-30,4,4,4,0,114,117,116,1,0,0,0,0,56,56,56,56
Humboldt,72,2023-04-30,11,11,11,0,247,257,256,1,0,0,0,0,171,171,171,171
Imperial,72,2023-04-30,103,106,106,0,1126,1166,1165,1,11,0,0,0,983,984,983,984
Inyo,72,2023-04-30,8,8,8,0,163,168,167,1,0,0,0,0,63,63,63,63
Kern,72,2023-04-30,81,83,83,0,3639,3762,3761,1,13,0,0,2,2499,2499,2499,2499
Kings,72,2023-04-30,36,36,36,0,694,719,718,1,0,0,0,0,486,486,486,486
Lake,72,2023-04-30,11,11,11,0,285,296,295,1,1,0,0,0,164,164,164,164
Lassen,72,2023-04-30,2,2,2,0,76,78,77,1,0,0,0,0,65,65,65,65
Los Angeles,72,2023-04-30,1913,1978,1978,0,90803,93899,93898,1,239,24,45,30,36043,36118,36019,36073
Madera,72,2023-04-30,53,53,53,0,803,832,831,1,1,0,0,0,377,377,377,377
Marin,72,2023-04-30,65,65,65,0,854,884,883,1,9,0,0,1,260,260,260,260
Mariposa,72,2023-04-30,2,2,2,0,64,65,64,1,0,0,0,0,31,31,31,31
Mendocino,72,2023-04-30,11,11,11,0,228,237,236,1,0,0,0,0,146,146,146,146
Merced,72,2023-04-30,45,45,45,0,687,710,709,1,1,0,0,1,903,903,903,903
Modoc,72,2023-04-30,5,5,5,0,9,10,9,1,0,0,0,0,11,11,11,11
Mono,72,2023-04-30,2,2,2,0,35,36,35,1,0,0,0,0,8,8,8,8
Monterey,72,2023-04-30,64,64,64,0,1467,1519,1518,1,16,0,0,1,811,811,811,811
Napa,72,2023-04-30,33,33,33,0,640,663,662,1,2,1,2,0,176,177,175,175
Nevada,72,2023-04-30,30,30,30,0,234,243,242,1,5,0,0,0,139,139,139,139
Orange,72,2023-04-30,428,442,442,0,14092,14580,14579,1,63,5,9,13,8152,8165,8147,8156
Placer,72,2023-04-30,98,101,101,0,1442,1492,1491,1,39,0,0,1,685,685,685,685
Plumas,72,2023-04-30,8,8,8,0,49,50,49,1,0,0,0,0,15,15,15,15
Riverside,72,2023-04-30,283,292,292,0,10516,10877,10876,1,48,0,0,8,6854,6854,6854,6854
Sacramento,72,2023-04-30,529,547,547,0,7037,7278,7277,1,63,5,11,7,3597,3605,3592,3594
San Benito,72,2023-04-30,15,15,15,0,318,329,328,1,0,0,0,0,116,116,116,116
San Bernardino,72,2023-04-30,357,369,369,0,10476,10838,10837,1,53,0,0,10,8139,8139,8139,8139
San Diego,72,2023-04-30,629,649,649,0,18050,18667,18666,1,112,1,2,9,5864,5867,5863,5865
San Francisco,72,2023-04-30,265,273,273,0,5536,5727,5726,1,42,1,2,4,1214,1216,1213,1214
San Joaquin,72,2023-04-30,154,160,160,0,3892,4028,4027,1,22,0,0,2,2453,2453,2453,2453
San Luis Obispo,72,2023-04-30,40,40,40,0,724,751,750,1,4,1,2,0,577,578,576,576
San Mateo,72,2023-04-30,197,204,204,0,4547,4702,4701,1,19,0,0,1,747,747,747,747
Santa Barbara,72,2023-04-30,76,78,78,0,2431,2515,2514,1,14,1,2,2,767,768,766,766
Santa Clara,72,2023-04-30,565,585,585,0,11813,12216,12215,1,92,1,2,18,2800,2803,2799,2801
Santa Cruz,72,2023-04-30,46,46,46,0,1449,1499,1498,1,13,0,0,1,276,276,276,276
Shasta,72,2023-04-30,10,10,10,0,374,388,387,1,3,0,0,1,612,612,612,612
Siskiyou,72,2023-04-30,10,10,10,0,101,106,105,1,2,0,0,0,95,95,95,95
Solano,72,2023-04-30,100,102,102,0,1786,1848,1847,1,18,0,0,4,476,476,476,476
Sonoma,72,2023-04-30,108,113,113,0,1910,1976,1975,1,13,2,4,1,572,574,570,570
Stanislaus,72,2023-04-30,95,97,97,0,1898,1964,1963,1,23,0,0,4,1842,1842,1842,1842
Sutter,72,2023-04-30,12,12,12,0,234,244,243,1,0,0,0,0,241,241,241,241
Tehama,72,2023-04-30,9,9,9,0,139,144,143,1,0,0,0,0,237,237,237,237
Trinity,72,2023-04-30,2,2,2,0,10,11,10,1,0,0,0,0,24,24,24,24
Tulare,72,2023-04-30,76,78,78,0,1991,2057,2056,1,10,0,0,0,1597,1597,1597,1597
Tuolumne,72,2023-04-30,10,10,10,0,164,172,171,1,0,0,0,0,211,211,211,211
Ventura,72,2023-04-30,126,132,132,0,2705,2800,2799,1,23,0,0,1,1702,1702,1702,1702
Yolo,72,2023-04-30,47,47,47,0,872,902,901,1,4,0,0,1,454,455,454,455
Yuba,72,2023-04-30,21,21,21,0,264,275,274,1,3,0,0,0,134,134,134,134
Alameda,73,2023-05-07,431,458,458,0,8326,8843,8842,1,55,0,0,7,2155,2158,2155,2158
Amador,73,2023-05-07,6,6,6,0,135,144,143,1,1,0,0,0,98,98,98,98
Butte,73,2023-05-07,22,22,22,0,465,494,493,1,8,0,0,0,499,499,499,499
Calaveras,73,2023-05-07,5,5,5,0,163,175,174,1,1,0,0,0,143,143,143,143
Colusa,73,2023-05-07,2,2,2,0,30,32,31,1,1,0,0,0,24,24,24,24
Contra Costa,73,2023-05-07,234,248,248,0,5960,6326,6325,1,34,1,3,7,1594,1601,1593,1598
Del Norte,73,2023-05-07,6,6,6,0,86,94,93,1,0,0,0,0,61,61,61,61
El Dorado,73,2023-05-07,28,28,28,0,509,541,540,1,0,0,0,0,247,247,247,247
Fresno,73,2023-05-07,192,205,205,0,5232,5556,5555,1,54,0,0,6,3029,3034,3029,3034
Glenn,73,2023-05-07,7,7,7,0,115,120,119,1,1,0,0,0,56,56,56,56
Humboldt,73,2023-05-07,13,13,13,0,207,222,221,1,0,0,0,0,171,171,171,171
Imperial,73,2023-05-07,80,84,84,0,998,1058,1057,1,2,0,0,1,983,984,983,984
Inyo,73,2023-05-07,2,2,2,0,155,166,165,1,0,0,0,0,63,63,63,63
Kern,73,2023-05-07,92,99,99,0,3455,3660,3659,1,10,0,0,4,2499,2499,2499,2499
Kings,73,2023-05-07,30,30,30,0,633,672,671,1,1,0,0,0,486,486,486,486
Lake,73,2023-05-07,7,7,7,0,264,282,281,1,1,0,0,0,164,164,164,164
Lassen,73,2023-05-07,8,8,8,0,68,73,72,1,0,0,0,0,65,65,65,65
Los Angeles,73,2023-05-07,1779,1892,1892,0,66536,70378,70377,1,220,11,56,21,36054,36174,36043,36118
Madera,73,2023-05-07,34,34,34,0,654,697,696,1,0,0,0,0,377,377,377,377
Marin,73,2023-05-07,57,60,60,0,784,836,835,1,9,0,0,2,260,260,260,260
Mariposa,73,2023-05-07,0,0,0,0,53,58,57,1,0,0,0,0,31,31,31,31
Mendocino,73,2023-05-07,7,7,7,0,243,258,257,1,0,0,0,0,146,146,146,146
Merced,73,2023-05-07,36,37,37,0,594,631,630,1,4,0,0,0,903,903,903,903
Modoc,73,2023-05-07,10,10,10,0,11,12,11,1,0,0,0,0,11,11,11,11
Mono,73,2023-05-07,0,0,0,0,39,43,42,1,0,0,0,0,8,8,8,8
Monterey,73,2023-05-07,41,42,42,0,1313,1397,1396,1,13,1,4,0,812,815,811,811
Napa,73,2023-05-07,44,46,46,0,692,734,733,1,1,0,0,0,176,177,176,177
Nevada,73,2023-05-07,23,24,24,0,229,245,244,1,5,0,0,1,139,139,139,139
Orange,73,2023-05-07,423,452,452,0,13661,14505,14504,1,67,1,3,7,8153,8168,8152,8165
Placer,73,2023-05-07,110,119,119,0,1311,1393,1392,1,33,0,0,1,685,685,685,685
Plumas,73,2023-05-07,6,6,6,0,45,47,46,1,1,0,0,0,15,15,15,15
Riverside,73,2023-05-07,253,269,269,0,9764,10369,10368,1,44,0,0,3,6854,6854,6854,6854
Sacramento,73,2023-05-07,351,372,372,0,6081,6454,6453,1,60,0,0,8,3597,3605,3597,3605
San Benito,73,2023-05-07,8,8,8,0,288,307,306,1,1,0,0,0,116,116,116,116
San Bernardino,73,2023-05-07,284,302,302,0,9886,10490,10489,1,60,0,0,10,8139,8139,8139,8139
San Diego,73,2023-05-07,544,578,578,0,16889,17923,17922,1,101,2,10,14,5866,5877,5864,5867
San Francisco,73,2023-05-07,202,215,215,0,4726,5015,5014,1,37,0,0,6,1214,1216,1214,1216
San Joaquin,73,2023-05-07,172,184,184,0,3609,3831,3830,1,17,0,0,2,2453,2453,2453,2453
San Luis Obispo,73,2023-05-07,37,38,38,0,721,769,768,1,6,0,0,0,577,578,577,578
San Mateo,73,2023-05-07,214,227,227,0,3835,4066,4065,1,24,0,0,1,747,747,747,747
Santa Barbara,73,2023-05-07,74,80,80,0,1646,1749,1748,1,9,2,10,2,769,778,767,768
Santa Clara,73,2023-05-07,465,495,495,0,9766,10367,10366,1,95,0,0,19,2800,2803,2800,2803
Santa Cruz,73,2023-05-07,63,67,67,0,1366,1451,1450,1,11,0,0,0,276,276,276,276
Shasta,73,2023-05-07,11,11,11,0,387,410,409,1,2,0,0,1,612,612,612,612
Siskiyou,73,2023-05-07,8,8,8,0,102,110,109,1,1,1,3,0,96,98,95,95
Solano,73,2023-05-07,76,82,82,0,1492,1585,1584,1,12,0,0,2,476,476,476,476
Sonoma,73,2023-05-07,89,95,95,0,1669,1773,1772,1,17,0,0,2,572,574,572,574
Stanislaus,73,2023-05-07,74,77,77,0,1880,2000,1999,1,32,0,0,1,1842,1842,1842,1842
Sutter,73,2023-05-07,12,12,12,0,281,299,298,1,0,0,0,0,241,241,241,241
Tehama,73,2023-05-07,12,12,12,0,148,157,156,1,2,0,0,0,237,237,237,237
Trinity,73,2023-05-07,0,0,0,0,6,7,6,1,0,0,0,0,24,24,24,24
Tulare,73,2023-05-07,54,59,59,0,1776,1878,1877,1,8,0,0,0,1597,1597,1597,1597
Tuolumne,73,2023-05-07,14,14,14,0,198,211,210,1,0,0,0,0,211,211,211,211
Ventura,73,2023-05-07,87,93,93,0,2649,2815,2814,1,21,1,4,1,1703,1706,1702,1702
Yolo,73,2023-05-07,34,35,35,0,633,671,670,1,3,0,0,0,454,455,454,455
Yuba,73,2023-05-07,12,12,12,0,244,260,259,1,1,0,0,2,134,134,134,134
Alameda,74,2023-05-12,334,451,451,0,6105,8022,8021,1,44,1,18,7,2156,2176,2155,2158
Amador,74,2023-05-12,2,2,2,0,102,134,133,1,0,0,0,0,98,98,98,98
Butte,74,2023-05-12,50,65,65,0,508,640,639,1,14,0,0,0,499,499,499,499
Calaveras,74,2023-05-12,6,9,9,0,98,135,134,1,1,0,0,0,143,143,143,143
Colusa,74,2023-05-12,3,3,3,0,38,50,49,1,1,0,0,0,24,24,24,24
Contra Costa,74,2023-05-12,207,283,283,0,4645,6113,6112,1,34,0,0,4,1594,1601,1594,1601
Del Norte,74,2023-05-12,2,2,2,0,69,90,89,1,0,0,0,0,61,61,61,61
El Dorado,74,2023-05-12,24,32,32,0,470,616,615,1,0,0,0,1,247,247,247,247
Fresno,74,2023-05-12,138,182,182,0,3965,5182,5181,1,49,0,0,6,3029,3034,3029,3034
Glenn,74,2023-05-12,2,2,2,0,109,131,130,1,1,0,0,0,56,56,56,56
Humboldt,74,2023-05-12,9,12,12,0,223,292,291,1,1,0,0,0,171,171,171,171
Imperial,74,2023-05-12,66,83,83,0,895,1188,1187,1,10,0,0,1,983,984,983,984
Inyo,74,2023-05-12,7,9,9,0,112,152,151,1,0,0,0,0,63,63,63,63
Kern,74,2023-05-12,54,72,72,0,2860,3739,3738,1,7,0,0,5,2499,2499,2499,2499
Kings,74,2023-05-12,25,32,32,0,453,592,591,1,2,0,0,0,486,486,486,486
Lake,74,2023-05-12,14,18,18,0,225,289,288,1,1,0,0,0,164,164,164,164
Lassen,74,2023-05-12,4,6,6,0,52,74,73,1,0,0,0,0,65,65,65,65
Los Angeles,74,2023-05-12,1134,1484,1484,0,4491,5876,5875,1,222,4,57,31,36058,36231,36054,36174
Madera,74,2023-05-12,20,29,29,0,526,700,699,1,2,0,0,0,377,377,377,377
Marin,74,2023-05-12,48,65,65,0,618,826,825,1,7,0,0,0,260,260,260,260
Mariposa,74,2023-05-12,0,0,0,0,33,44,43,1,0,0,0,0,31,31,31,31
Mendocino,74,2023-05-12,0,0,0,0,179,236,235,1,2,0,0,1,146,146,146,146
Merced,74,2023-05-12,27,38,38,0,438,595,594,1,3,0,0,0,903,903,903,903
Modoc,74,2023-05-12,3,3,3,0,4,5,4,1,0,0,0,0,11,11,11,11
Mono,74,2023-05-12,0,0,0,0,26,34,33,1,0,0,0,0,8,8,8,8
Monterey,74,2023-05-12,28,38,38,0,1056,1421,1420,1,12,0,0,1,812,815,812,815
Napa,74,2023-05-12,25,33,33,0,520,691,690,1,3,0,0,0,176,177,176,177
Nevada,74,2023-05-12,11,16,16,0,157,212,211,1,5,0,0,1,139,139,139,139
Orange,74,2023-05-12,351,458,458,0,9033,11932,11931,1,56,0,0,11,8153,8168,8153,8168
Placer,74,2023-05-12,57,78,78,0,975,1294,1293,1,35,0,0,3,685,685,685,685
Plumas,74,2023-05-12,2,3,3,0,25,35,34,1,0,0,0,0,15,15,15,15
Riverside,74,2023-05-12,226,303,303,0,5131,6813,6812,1,33,0,0,9,6854,6854,6854,6854
Sacramento,74,2023-05-12,311,427,427,0,4528,5970,5969,1,65,0,0,5,3597,3605,3597,3605
San Benito,74,2023-05-12,11,14,14,0,251,331,330,1,1,0,0,0,116,116,116,116
San Bernardino,74,2023-05-12,227,300,300,0,6747,8953,8952,1,49,0,0,13,8139,8139,8139,8139
San Diego,74,2023-05-12,403,543,543,0,13816,18274,18273,1,79,0,0,16,5866,5877,5866,5877
San Francisco,74,2023-05-12,141,189,189,0,3621,4753,4752,1,30,0,0,6,1214,1216,1214,1216
San Joaquin,74,2023-05-12,121,164,164,0,2499,3291,3290,1,12,0,0,1,2453,2453,2453,2453
San Luis Obispo,74,2023-05-12,32,42,42,0,608,811,810,1,5,0,0,0,577,578,577,578
San Mateo,74,2023-05-12,116,153,153,0,2949,3783,3782,1,20,0,0,0,747,747,747,747
Santa Barbara,74,2023-05-12,53,73,73,0,1001,1336,1335,1,8,0,0,1,769,778,769,778
Santa Clara,74,2023-05-12,334,447,447,0,7068,9233,9232,1,87,0,0,16,2800,2803,2800,2803
Santa Cruz,74,2023-05-12,34,48,48,0,1021,1368,1367,1,14,0,0,0,276,276,276,276
Shasta,74,2023-05-12,13,18,18,0,344,470,469,1,2,0,0,1,612,612,612,612
Siskiyou,74,2023-05-12,6,9,9,0,53,73,72,1,1,0,0,0,96,98,96,98
Solano,74,2023-05-12,66,87,87,0,1124,1500,1499,1,16,0,0,3,476,476,476,476
Sonoma,74,2023-05-12,78,106,106,0,1333,1760,1759,1,17,0,0,2,572,574,572,574
Stanislaus,74,2023-05-12,81,108,108,0,1515,1996,1995,1,24,0,0,2,1842,1842,1842,1842
Sutter,74,2023-05-12,16,22,22,0,221,287,286,1,0,0,0,0,241,241,241,241
Tehama,74,2023-05-12,12,15,15,0,106,140,139,1,1,0,0,0,237,237,237,237
Trinity,74,2023-05-12,1,2,2,0,5,8,7,1,0,0,0,0,24,24,24,24
Tulare,74,2023-05-12,31,40,40,0,1323,1643,1642,1,7,0,0,0,1597,1597,1597,1597
Tuolumne,74,2023-05-12,5,6,6,0,134,179,178,1,3,0,0,0,211,211,211,211
Ventura,74,2023-05-12,88,119,119,0,2032,2720,2719,1,9,0,0,1,1703,1706,1703,1706
Yolo,74,2023-05-12,23,30,30,0,398,539,538,1,3,0,0,0,454,455,454,455
Yuba,74,2023-05-12,12,17,17,0,166,222,221,1,1,0,0,2,134,134,134,134
California,1,2021-12-19,69977,69977,38095,31882,2212379,2212394,1247941,964453,2585,502,502,938,77228,77228,76726,76726
California,2,2021-12-26,189197,189197,116230,72967,1842464,1842477,1102431,740046,3020,479,479,981,77707,77707,77228,77228
California,3,2022-01-02,485779,485783,322041,163742,2638624,2638653,1719671,918982,5523,565,565,1266,78272,78272,77707,77707
California,4,2022-01-09,866234,866240,613788,252452,4622275,4622342,3287175,1335167,9338,904,904,1710,79176,79176,78272,78272
California,5,2022-01-16,722475,722480,534810,187670,4353570,4353633,3279026,1074607,12024,1371,1371,2185,80547,80547,79176,79176
California,6,2022-01-23,538572,538576,418226,120350,3753066,3753123,2976763,776360,12602,1771,1771,2602,82318,82318,80547,80547
California,7,2022-01-30,302624,302624,244221,58403,3235023,3235088,2680195,554893,10901,1862,1862,2534,84180,84180,82318,82318
California,8,2022-02-06,165615,165615,138616,26999,2742115,2742182,2363658,378524,8494,1827,1827,2101,86007,86007,84180,84180
California,9,2022-02-13,95578,95578,82819,12759,2406607,2406675,2142055,264620,6560,1498,1498,1629,87505,87505,86007,86007
California,10,2022-02-20,55379,55379,49370,6009,2134828,2134897,1948128,186769,4672,1058,1058,1149,88563,88563,87505,87505
California,11,2022-02-27,32792,32792,29982,2810,1865855,1865915,1738581,127334,3416,739,739,817,89302,89302,88563,88563
California,12,2022-03-06,24299,24299,22638,1661,1848188,1848252,1747357,100895,2519,525,525,620,89827,89827,89302,89302
California,13,2022-03-13,17938,17938,16961,977,1745373,1745443,1670416,75027,1856,388,388,443,90215,90215,89827,89827
California,14,2022-03-20,14866,14866,14246,620,1668816,1668904,1612733,56171,1528,249,249,305,90464,90464,90215,90215
California,15,2022-03-27,15276,15276,14779,497,1548656,1548752,1508100,40652,1209,197,197,261,90661,90661,90464,90464
California,16,2022-04-03,16792,16792,16376,416,1472694,1472791,1442196,30595,907,149,149,223,90810,90810,90661,90661
California,17,2022-04-10,20856,20856,20454,402,1417445,1417565,1395058,22507,863,123,123,152,90933,90933,90810,90810
California,18,2022-04-17,25048,25048,24661,387,1031900,1032002,1016962,15040,818,119,119,145,91052,91052,90933,90933
California,19,2022-04-24,35729,35729,35301,428,1581329,1581513,1566255,15258,848,91,91,119,91143,91143,91052,91052
California,20,2022-05-01,46413,46413,45982,431,1708738,1708970,1696082,12888,904,90,90,148,91233,91233,91143,91143
California,21,2022-05-08,60902,60907,60460,447,1753473,1753797,1743338,10459,1017,84,84,173,91317,91317,91233,91233
California,22,2022-05-15,75871,75878,75432,446,1830771,1831198,1822590,8608,1218,120,120,191,91437,91437,91317,91317
California,23,2022-05-22,95854,95861,95426,435,1864015,1864559,1857657,6902,1562,115,115,239,91552,91552,91437,91437
California,24,2022-05-29,101389,101409,101056,353,1812184,1812919,1807686,5233,1913,144,144,251,91696,91696,91552,91552
California,25,2022-06-05,108284,108318,108024,294,1681882,1682738,1679039,3699,2186,137,137,275,91833,91833,91696,91696
California,26,2022-06-12,107888,107931,107697,234,1526025,1526912,1524171,2741,2419,187,187,297,92020,92020,91833,91833
California,27,2022-06-19,101816,101866,101698,168,1066156,1066874,1065151,1723,2486,201,201,295,92221,92221,92020,92020
California,28,2022-06-26,111322,111389,111248,141,1020345,1021097,1019815,1282,2913,219,219,318,92440,92440,92221,92221
California,29,2022-07-03,120911,120992,120872,120,984155,984960,983990,970,3102,256,256,394,92696,92696,92440,92440
California,30,2022-07-10,127004,127100,127006,94,938430,939312,938601,711,3670,302,302,456,92998,92998,92696,92696
California,31,2022-07-17,130983,131092,131016,76,995890,996922,996328,594,4015,289,289,513,93287,93287,92998,92998
California,32,2022-07-24,119952,120058,120007,51,962415,963468,963015,453,4145,334,334,497,93621,93621,93287,93287
California,33,2022-07-31,102911,103007,102971,36,889364,890402,890071,331,4021,379,379,518,94000,94000,93621,93621
California,34,2022-08-07,86655,86740,86719,21,830251,831260,831012,248,3693,340,340,473,94340,94340,94000,94000
California,35,2022-08-14,71725,71794,71782,12,799378,800387,800195,192,3335,313,313,439,94653,94653,94340,94340
California,36,2022-08-21,62520,62578,62572,6,776232,777249,777097,152,2987,281,281,418,94934,94934,94653,94653
California,37,2022-08-28,53963,54010,54007,3,775111,776149,776024,125,2614,233,233,330,95167,95167,94934,94934
California,38,2022-09-04,42548,42584,42583,1,737695,738727,738623,104,2451,245,245,352,95412,95412,95167,95167
California,39,2022-09-11,34132,34156,34156,0,665810,666804,666723,81,2341,222,222,338,95634,95634,95412,95412
California,40,2022-09-18,28725,28743,28743,0,696219,697292,697219,73,2035,190,190,284,95824,95824,95634,95634
California,41,2022-09-25,25620,25637,25637,0,651501,652542,652474,68,1811,172,172,253,95996,95996,95824,95824
California,42,2022-10-02,24251,24267,24267,0,601295,602286,602226,60,1635,159,159,254,96155,96155,95996,95996
California,43,2022-10-09,20611,20623,20623,0,542102,543023,542965,58,1515,138,138,220,96293,96293,96155,96155
California,44,2022-10-16,22277,22287,22287,0,620137,621222,621164,58,1423,142,142,226,96417,96417,96275,96275
California,45,2022-10-23,18701,18713,18713,0,513984,514909,514852,57,1347,115,115,211,96532,96532,96417,96417
California,46,2022-10-30,20208,20222,20222,0,527163,528137,528080,57,1423,112,112,203,96644,96644,96532,96532
California,47,2022-11-06,25661,25680,25680,0,539842,540877,540820,57,1501,132,132,218,96776,96776,96644,96644
California,48,2022-11-13,29800,29834,29834,0,543406,544501,544444,57,1776,112,112,256,96888,96888,96776,96776
California,49,2022-11-20,38790,38852,38852,0,589838,591079,591022,57,2167,157,157,327,97045,97045,96888,96888
California,50,2022-11-27,48346,48425,48425,0,475800,476854,476797,57,2914,192,192,376,97237,97237,97045,97045
California,51,2022-12-04,69245,69380,69380,0,673175,674724,674666,58,3567,237,237,468,97474,97474,97237,97237
California,52,2022-12-11,58283,58401,58401,0,629509,631040,630982,58,3763,338,338,504,97812,97812,97474,97474
California,53,2022-12-18,52116,52220,52220,0,595904,597431,597374,57,3899,329,329,489,98141,98141,97812,97812
California,54,2022-12-25,47929,48031,48031,0,470747,472035,471978,57,3670,406,406,505,98547,98547,98141,98141
California,55,2023-01-01,47150,47265,47265,0,421295,422550,422493,57,4019,377,377,493,98924,98924,98547,98547
California,56,2023-01-08,34787,34875,34875,0,473666,475179,475122,57,3670,338,338,485,99262,99262,98924,98924
California,57,2023-01-15,22496,22550,22550,0,451806,453387,453330,57,3055,334,334,445,99596,99596,99262,99262
California,58,2023-01-22,18021,18068,18068,0,425082,426790,426733,57,2477,254,254,363,99850,99850,99596,99596
California,59,2023-01-29,18995,19056,19056,0,422094,423952,423895,57,2259,230,230,300,100080,100080,99850,99850
California,60,2023-02-05,20904,20984,20984,0,409096,411109,411052,57,2244,170,170,272,100250,100250,100080,100080
California,61,2023-02-12,21809,21899,21899,0,391189,393276,393219,57,2204,163,163,258,100413,100413,100250,100250
California,62,2023-02-19,20563,20663,20663,0,370554,372813,372757,56,2125,171,172,283,100584,100585,100413,100413
California,63,2023-02-26,19691,19809,19809,0,361790,364401,364345,56,2253,157,159,295,100741,100744,100584,100585
California,64,2023-03-05,17604,17727,17727,0,354912,357874,357818,56,2200,169,173,285,100910,100917,100741,100744
California,65,2023-03-12,15735,15861,15861,0,334270,337543,337487,56,1971,143,147,248,101053,101064,100910,100917
California,66,2023-03-19,13196,13319,13319,0,312922,316438,316382,56,1698,145,152,233,101198,101216,101053,101064
California,67,2023-03-26,10598,10707,10707,0,291298,294993,294937,56,1517,103,105,191,101301,101321,101198,101216
California,68,2023-04-02,10033,10145,10145,0,271656,275565,275509,56,1381,102,109,181,101403,101430,101301,101321
California,69,2023-04-09,9540,9674,9674,0,247094,251195,251139,56,1305,88,98,179,101491,101528,101403,101430
California,70,2023-04-16,9652,9814,9814,0,251036,255978,255922,56,1312,76,88,162,101567,101616,101491,101528
California,71,2023-04-23,8400,8587,8587,0,239274,245231,245175,56,1310,78,106,156,101645,101722,101567,101616
California,72,2023-04-30,7984,8228,8228,0,230511,238431,238375,56,1173,49,96,142,101694,101818,101645,101722
California,73,2023-05-07,6885,7304,7304,0,193008,204659,204603,56,1086,20,93,131,101714,101911,101694,101818
California,74,2023-05-12,5094,6790,6790,0,97004,127793,127737,56,999,5,75,150,101719,101986,101714,101911
