county,time,date,cases,est_cases,est_omicron_cases,est_other_cases,tests,est_tests,est_omicron_tests,est_other_tests,hospitalizations,deaths,est_deaths,icu,cum_deaths,cum_est_deaths,prev_cum_deaths,prev_cum_est_deaths
Alameda,1,2021-12-20,2983,2983,1419,1564,89769,89774,41920,47854,47,9,9,14,1549,1549,1540,1540
Amador,1,2021-12-20,49,49,18,31,1716,1716,602,1114,2,0,0,3,70,70,70,70
Butte,1,2021-12-20,193,193,101,92,4386,4386,2286,2100,24,5,5,1,359,359,354,354
Calaveras,1,2021-12-20,59,59,23,36,1520,1520,582,938,1,2,2,0,92,92,90,90
Colusa,1,2021-12-20,11,11,5,6,397,397,170,227,1,0,0,0,21,21,21,21
Contra Costa,1,2021-12-20,1684,1684,590,1094,43228,43228,14848,28380,27,4,4,7,1080,1080,1076,1076
Del Norte,1,2021-12-20,19,19,8,11,1378,1378,570,808,0,0,0,0,42,42,42,42
El Dorado,1,2021-12-20,238,238,93,145,4466,4466,1729,2737,4,4,4,3,179,179,175,175
Fresno,1,2021-12-20,1058,1058,380,678,25057,25057,8919,16138,131,19,19,45,2419,2419,2400,2400
Glenn,1,2021-12-20,20,20,8,12,462,462,185,277,0,0,0,0,41,41,41,41
Humboldt,1,2021-12-20,164,164,67,97,3772,3772,1529,2243,11,1,1,2,121,121,120,120
Imperial,1,2021-12-20,585,585,225,360,5535,5535,2109,3426,40,9,9,27,817,817,808,808
Inyo,1,2021-12-20,31,31,14,17,358,358,154,204,1,1,1,0,49,49,48,48
Kern,1,2021-12-20,927,927,401,526,26093,26093,11160,14933,84,24,24,27,2023,2023,1999,1999
Kings,1,2021-12-20,244,244,94,150,6912,6912,2638,4274,15,6,6,3,389,389,383,383
Lake,1,2021-12-20,37,37,13,24,1317,1317,464,853,0,0,0,0,116,116,116,116
Lassen,1,2021-12-20,11,11,5,6,2387,2387,1093,1294,0,0,0,0,54,54,54,54
Los Angeles,1,2021-12-20,31635,31635,22013,9622,985756,985794,676378,309416,574,107,107,174,27374,27374,27267,27267
Madera,1,2021-12-20,159,159,56,103,6014,6014,2122,3892,9,3,3,5,334,334,331,331
Marin,1,2021-12-20,567,567,211,356,11810,11810,4294,7516,5,1,1,1,256,256,255,255
Mariposa,1,2021-12-20,21,21,7,14,448,448,154,294,0,0,0,0,21,21,21,21
Mendocino,1,2021-12-20,91,91,27,64,2687,2687,789,1898,3,2,2,4,103,103,101,101
Merced,1,2021-12-20,323,323,138,185,5616,5616,2366,3250,11,6,6,12,693,693,687,687
Modoc,1,2021-12-20,5,5,2,3,67,67,30,37,2,0,0,0,6,6,6,6
Mono,1,2021-12-20,37,37,10,27,313,313,81,232,1,0,0,0,4,4,4,4
Monterey,1,2021-12-20,481,481,126,355,13259,13259,3421,9838,23,3,3,8,642,642,639,639
Napa,1,2021-12-20,229,229,106,123,5390,5390,2432,2958,2,1,1,2,108,108,107,107
Nevada,1,2021-12-20,161,161,58,103,2764,2764,999,1765,4,1,1,2,110,110,109,109
Orange,1,2021-12-20,4864,4864,2404,2460,99380,99385,48408,50977,132,34,34,56,6021,6021,5987,5987
Placer,1,2021-12-20,555,555,190,365,11155,11155,3769,7386,53,6,6,24,501,501,495,495
Plumas,1,2021-12-20,16,16,6,10,513,513,195,318,0,0,0,0,12,12,12,12
Riverside,1,2021-12-20,5610,5610,2352,3258,78334,78336,32450,45886,238,40,40,82,5579,5579,5539,5539
Sacramento,1,2021-12-20,2148,2148,857,1291,53573,53573,21167,32406,101,21,21,41,2490,2490,2469,2469
San Benito,1,2021-12-20,91,91,41,50,1928,1928,860,1068,2,3,3,2,81,81,78,78
San Bernardino,1,2021-12-20,5011,5011,2369,2642,79698,79701,37182,42519,299,66,66,112,6511,6511,6445,6445
San Diego,1,2021-12-20,8681,8681,5933,2748,149629,149635,101540,48095,249,29,29,94,4479,4479,4450,4450
San Francisco,1,2021-12-20,2988,2988,741,2247,57003,57003,13806,43197,28,3,3,10,693,693,690,690
San Joaquin,1,2021-12-20,952,952,359,593,25345,25345,9400,15945,48,13,13,27,1972,1972,1959,1959
San Luis Obispo,1,2021-12-20,426,426,187,239,9993,9993,4349,5644,11,3,3,6,371,371,368,368
San Mateo,1,2021-12-20,1560,1560,771,789,50631,50631,24529,26102,9,0,0,5,601,601,601,601
Santa Barbara,1,2021-12-20,789,789,326,463,15818,15818,6434,9384,18,8,8,12,570,570,562,562
Santa Clara,1,2021-12-20,2948,2948,1981,967,118952,118957,78837,40120,85,8,8,38,1978,1978,1970,1970
Santa Cruz,1,2021-12-20,404,404,182,222,19816,19816,8760,11056,11,2,2,5,230,230,228,228
Shasta,1,2021-12-20,163,163,65,98,6035,6035,2392,3643,28,8,8,8,448,448,440,440
Siskiyou,1,2021-12-20,20,20,9,11,449,449,207,242,2,2,2,2,63,63,61,61
Solano,1,2021-12-20,497,497,207,290,14795,14795,6087,8708,21,4,4,5,389,389,385,385
Sonoma,1,2021-12-20,754,754,320,434,20780,20780,8668,12112,22,1,1,6,420,420,419,419
Stanislaus,1,2021-12-20,670,670,210,460,13020,13020,4035,8985,90,13,13,22,1432,1432,1419,1419
Sutter,1,2021-12-20,123,123,51,72,2315,2315,947,1368,0,2,2,0,193,193,191,191
Tehama,1,2021-12-20,52,52,17,35,1324,1324,425,899,4,0,0,3,165,165,165,165
Trinity,1,2021-12-20,1,1,0,1,98,98,31,67,0,1,1,0,19,19,18,18
Tulare,1,2021-12-20,404,404,125,279,12352,12352,3799,8553,36,19,19,13,1307,1307,1288,1288
Tuolumne,1,2021-12-20,97,97,35,62,1940,1940,693,1247,7,0,0,0,150,150,150,150
Ventura,1,2021-12-20,2046,2046,1052,994,39239,39239,19902,19337,62,9,9,14,1216,1216,1207,1207
Yolo,1,2021-12-20,329,329,146,183,24709,24709,10825,13884,4,0,0,1,295,295,295,295
Yuba,1,2021-12-20,100,100,43,57,1874,1874,799,1075,3,0,0,4,102,102,102,102
Alameda,2,2021-12-27,7511,7511,4025,3486,87416,87420,46208,41212,89,12,12,19,1561,1561,1549,1549
Amador,2,2021-12-27,92,92,38,54,1445,1445,590,855,2,0,0,3,70,70,70,70
Butte,2,2021-12-27,540,540,318,222,4551,4551,2662,1889,37,3,3,3,362,362,359,359
Calaveras,2,2021-12-27,100,100,45,55,989,989,442,547,1,1,1,1,93,93,92,92
Colusa,2,2021-12-27,27,27,14,13,243,243,119,124,4,0,0,0,21,21,21,21
Contra Costa,2,2021-12-27,5141,5141,2106,3035,46336,46336,18596,27740,44,3,3,16,1083,1083,1080,1080
Del Norte,2,2021-12-27,25,25,12,13,1423,1423,679,744,0,0,0,1,42,42,42,42
El Dorado,2,2021-12-27,511,511,231,280,4086,4086,1816,2270,7,0,0,4,179,179,179,179
Fresno,2,2021-12-27,2209,2209,935,1274,23916,23916,9955,13961,122,16,16,41,2435,2435,2419,2419
Glenn,2,2021-12-27,53,53,24,29,451,451,207,244,0,1,1,0,42,42,41,41
Humboldt,2,2021-12-27,501,501,238,263,3456,3456,1617,1839,10,1,1,0,122,122,121,121
Imperial,2,2021-12-27,881,881,396,485,5910,5910,2617,3293,35,10,10,26,827,827,817,817
Inyo,2,2021-12-27,109,109,54,55,447,447,219,228,0,1,1,0,50,50,49,49
Kern,2,2021-12-27,1988,1988,996,992,22592,22592,11165,11427,79,18,18,36,2041,2041,2023,2023
Kings,2,2021-12-27,506,506,229,277,5481,5481,2433,3048,17,1,1,3,390,390,389,389
Lake,2,2021-12-27,67,67,28,39,1203,1203,495,708,0,1,1,0,117,117,116,116
Lassen,2,2021-12-27,21,21,11,10,2242,2242,1160,1082,0,0,0,0,54,54,54,54
Los Angeles,2,2021-12-27,96136,96140,71602,24538,717903,717934,531110,186824,862,115,115,207,27489,27489,27374,27374
Madera,2,2021-12-27,341,341,144,197,4209,4209,1747,2462,9,2,2,4,336,336,334,334
Marin,2,2021-12-27,1607,1607,688,919,16774,16774,7084,9690,3,0,0,1,256,256,256,256
Mariposa,2,2021-12-27,36,36,15,21,493,493,195,298,0,0,0,0,21,21,21,21
Mendocino,2,2021-12-27,152,152,55,97,2496,2496,862,1634,5,0,0,2,103,103,103,103
Merced,2,2021-12-27,653,653,322,331,5100,5100,2471,2629,11,7,7,10,700,700,693,693
Modoc,2,2021-12-27,3,3,1,2,38,38,19,19,1,0,0,0,6,6,6,6
Mono,2,2021-12-27,123,123,38,85,366,366,110,256,1,0,0,0,4,4,4,4
Monterey,2,2021-12-27,1009,1009,318,691,12882,12882,3971,8911,21,3,3,11,645,645,642,642
Napa,2,2021-12-27,809,809,422,387,6660,6660,3443,3217,6,0,0,1,108,108,108,108
Nevada,2,2021-12-27,236,236,100,136,1984,1984,815,1169,6,1,1,1,111,111,110,110
Orange,2,2021-12-27,18032,18032,10058,7974,130305,130311,71862,58449,256,31,31,66,6052,6052,6021,6021
Placer,2,2021-12-27,1251,1251,502,749,10769,10769,4261,6508,63,2,2,27,503,503,501,501
Plumas,2,2021-12-27,18,18,8,10,299,299,129,170,0,0,0,0,12,12,12,12
Riverside,2,2021-12-27,13683,13683,6600,7083,87498,87502,41714,45788,306,53,53,81,5632,5632,5579,5579
Sacramento,2,2021-12-27,5200,5200,2414,2786,52471,52472,24000,28472,135,22,22,44,2512,2512,2490,2490
San Benito,2,2021-12-27,318,318,163,155,2307,2307,1173,1134,1,3,3,3,84,84,81,81
San Bernardino,2,2021-12-27,14391,14391,7732,6659,87891,87895,46456,41439,341,69,69,141,6580,6580,6511,6511
San Diego,2,2021-12-27,27101,27101,19918,7183,177595,177602,129644,47958,315,34,34,96,4513,4513,4479,4479
San Francisco,2,2021-12-27,6858,6858,2010,4848,65930,65934,19044,46890,31,1,1,14,694,694,693,693
San Joaquin,2,2021-12-27,2353,2353,1038,1315,22786,22786,9889,12897,61,15,15,25,1987,1987,1972,1972
San Luis Obispo,2,2021-12-27,1153,1153,583,570,11182,11182,5563,5619,11,1,1,8,372,372,371,371
San Mateo,2,2021-12-27,5283,5283,2933,2350,55543,55543,30396,25147,19,2,2,5,603,603,601,601
Santa Barbara,2,2021-12-27,2142,2142,1022,1120,15278,15278,7172,8106,33,5,5,10,575,575,570,570
Santa Clara,2,2021-12-27,9051,9051,6550,2501,107055,107059,76807,30252,95,10,10,38,1988,1988,1978,1978
Santa Cruz,2,2021-12-27,946,946,489,457,12423,12423,6305,6118,11,0,0,2,230,230,230,230
Shasta,2,2021-12-27,263,263,123,140,4624,4624,2123,2501,32,5,5,12,453,453,448,448
Siskiyou,2,2021-12-27,21,21,11,10,360,360,190,170,0,0,0,0,63,63,63,63
Solano,2,2021-12-27,1299,1299,626,673,17100,17100,8112,8988,25,5,5,5,394,394,389,389
Sonoma,2,2021-12-27,1912,1912,933,979,21664,21664,10424,11240,19,1,1,5,421,421,420,420
Stanislaus,2,2021-12-27,1249,1249,468,781,11151,11151,4114,7037,94,17,17,18,1449,1449,1432,1432
Sutter,2,2021-12-27,226,226,108,118,2131,2131,1006,1125,0,2,2,0,195,195,193,193
Tehama,2,2021-12-27,103,103,40,63,1106,1106,419,687,6,2,2,3,167,167,165,165
Trinity,2,2021-12-27,4,4,2,2,101,101,37,64,0,0,0,0,19,19,19,19
Tulare,2,2021-12-27,816,816,302,514,11116,11116,4057,7059,36,10,10,9,1317,1317,1307,1307
Tuolumne,2,2021-12-27,171,171,72,99,1672,1672,692,980,5,0,0,1,150,150,150,150
Ventura,2,2021-12-27,5720,5720,3307,2413,39329,39329,22501,16828,66,8,8,19,1224,1224,1216,1216
Yolo,2,2021-12-27,818,818,417,401,22132,22132,11088,11044,7,1,1,4,296,296,295,295
Yuba,2,2021-12-27,164,164,81,83,1534,1534,749,785,8,1,1,4,103,103,102,102
Alameda,3,2022-01-03,17654,17654,10478,7176,117283,117287,69469,47818,156,5,5,31,1566,1566,1561,1561
Amador,3,2022-01-03,218,218,104,114,2179,2179,1029,1150,5,1,1,2,71,71,70,70
Butte,3,2022-01-03,1202,1202,778,424,6876,6876,4433,2443,32,0,0,4,362,362,362,362
Calaveras,3,2022-01-03,232,232,120,112,1305,1305,666,639,0,1,1,1,94,94,93,93
Colusa,3,2022-01-03,48,48,26,22,393,393,217,176,5,0,0,0,21,21,21,21
Contra Costa,3,2022-01-03,13520,13520,6289,7231,69132,69136,32075,37061,76,10,10,21,1093,1093,1083,1083
Del Norte,3,2022-01-03,86,86,47,39,2132,2132,1143,989,0,0,0,0,42,42,42,42
El Dorado,3,2022-01-03,1290,1290,660,630,6062,6062,3079,2983,7,4,4,6,183,183,179,179
Fresno,3,2022-01-03,6603,6603,3174,3429,38678,38678,18464,20214,175,14,14,44,2449,2449,2435,2435
Glenn,3,2022-01-03,79,79,41,38,610,610,318,292,0,1,1,0,43,43,42,42
Humboldt,3,2022-01-03,881,881,471,410,5295,5295,2810,2485,9,1,1,3,123,123,122,122
Imperial,3,2022-01-03,1878,1878,956,922,9148,9148,4619,4529,35,14,14,29,841,841,827,827
Inyo,3,2022-01-03,265,265,147,118,713,713,394,319,3,0,0,0,50,50,50,50
Kern,3,2022-01-03,5835,5835,3271,2564,35876,35877,19999,15878,100,16,16,32,2057,2057,2041,2041
Kings,3,2022-01-03,1096,1096,561,535,8511,8511,4310,4201,13,3,3,5,393,393,390,390
Lake,3,2022-01-03,220,220,106,114,1777,1777,847,930,1,0,0,1,117,117,117,117
Lassen,3,2022-01-03,61,61,35,26,3119,3119,1806,1313,2,0,0,0,54,54,54,54
Los Angeles,3,2022-01-03,204144,204152,160558,43594,1088506,1088555,856415,232140,1937,149,149,303,27638,27638,27489,27489
Madera,3,2022-01-03,830,830,398,432,6362,6362,3024,3338,17,3,3,6,339,339,336,336
Marin,3,2022-01-03,2363,2363,1148,1215,17674,17674,8532,9142,15,1,1,3,257,257,256,256
Mariposa,3,2022-01-03,103,103,48,55,657,657,304,353,0,0,0,0,21,21,21,21
Mendocino,3,2022-01-03,453,453,187,266,3572,3572,1454,2118,7,1,1,2,104,104,103,103
Merced,3,2022-01-03,1558,1558,856,702,8548,8548,4667,3881,3,9,9,4,709,709,700,700
Modoc,3,2022-01-03,15,15,8,7,59,59,33,26,0,0,0,0,6,6,6,6
Mono,3,2022-01-03,180,180,65,115,435,435,156,279,2,0,0,0,4,4,4,4
Monterey,3,2022-01-03,2465,2465,908,1557,20639,20639,7547,13092,30,4,4,10,649,649,645,645
Napa,3,2022-01-03,1856,1856,1076,780,11756,11756,6790,4966,9,1,1,3,109,109,108,108
Nevada,3,2022-01-03,647,647,314,333,3071,3071,1485,1586,7,1,1,3,112,112,111,111
Orange,3,2022-01-03,45471,45472,27785,17687,220202,220212,134353,85859,504,34,34,110,6086,6086,6052,6052
Placer,3,2022-01-03,2916,2916,1337,1579,15071,15071,6863,8208,113,15,15,24,518,518,503,503
Plumas,3,2022-01-03,55,55,28,27,496,496,248,248,1,0,0,0,12,12,12,12
Riverside,3,2022-01-03,32052,32052,17312,14740,138453,138460,74452,64008,564,54,54,94,5686,5686,5632,5632
Sacramento,3,2022-01-03,14150,14150,7389,6761,80499,80503,41837,38666,219,25,25,57,2537,2537,2512,2512
San Benito,3,2022-01-03,739,739,422,317,3464,3464,1976,1488,3,1,1,2,85,85,84,84
San Bernardino,3,2022-01-03,33833,33833,20011,13822,135045,135049,79600,55449,571,94,94,136,6674,6674,6580,6580
San Diego,3,2022-01-03,61071,61072,47443,13629,253655,253667,196962,56705,561,35,35,121,4548,4548,4513,4513
San Francisco,3,2022-01-03,11439,11439,3973,7466,85528,85532,29513,56019,78,5,5,22,699,699,694,694
San Joaquin,3,2022-01-03,6977,6977,3479,3498,36142,36142,17906,18236,80,13,13,27,2000,2000,1987,1987
San Luis Obispo,3,2022-01-03,2473,2473,1386,1087,15963,15963,8917,7046,24,5,5,7,377,377,372,372
San Mateo,3,2022-01-03,10628,10628,6507,4121,81980,81984,50098,31886,37,4,4,7,607,607,603,603
Santa Barbara,3,2022-01-03,5326,5326,2851,2475,28193,28193,15053,13140,53,5,5,7,580,580,575,575
Santa Clara,3,2022-01-03,23030,23030,17705,5325,170172,170179,130643,39536,186,10,10,58,1998,1998,1988,1988
Santa Cruz,3,2022-01-03,2410,2410,1388,1022,21662,21662,12485,9177,15,5,5,3,235,235,230,230
Shasta,3,2022-01-03,602,602,318,284,6173,6173,3228,2945,33,2,2,13,455,455,453,453
Siskiyou,3,2022-01-03,74,74,44,30,590,590,348,242,0,0,0,0,63,63,63,63
Solano,3,2022-01-03,4071,4071,2180,1891,26219,26219,14027,12192,54,3,3,9,397,397,394,394
Sonoma,3,2022-01-03,4541,4541,2480,2061,32189,32189,17530,14659,25,7,7,4,428,428,421,421
Stanislaus,3,2022-01-03,3333,3333,1436,1897,17985,17985,7689,10296,129,9,9,20,1458,1458,1449,1449
Sutter,3,2022-01-03,547,547,296,251,2980,2980,1594,1386,0,2,2,0,197,197,195,195
Tehama,3,2022-01-03,216,216,97,119,1474,1474,652,822,4,1,1,2,168,168,167,167
Trinity,3,2022-01-03,14,14,6,8,107,107,46,61,0,0,0,0,19,19,19,19
Tulare,3,2022-01-03,2144,2144,918,1226,16001,16001,6773,9228,57,5,5,7,1322,1322,1317,1317
Tuolumne,3,2022-01-03,383,383,186,197,2544,2544,1227,1317,7,3,3,0,153,153,150,150
Ventura,3,2022-01-03,12671,12671,7986,4685,59673,59674,37562,22112,136,11,11,28,1235,1235,1224,1224
Yolo,3,2022-01-03,2321,2321,1323,998,31717,31717,17941,13776,8,4,4,3,300,300,296,296
Yuba,3,2022-01-03,473,473,262,211,2331,2331,1284,1047,17,1,1,6,104,104,103,103
Alameda,4,2022-01-10,31207,31207,20218,10989,193864,193876,125733,68143,277,14,14,46,1580,1580,1566,1566
Amador,4,2022-01-10,391,391,209,182,2726,2726,1447,1279,4,0,0,4,71,71,71,71
Butte,4,2022-01-10,1999,1999,1395,604,10460,10460,7287,3173,55,2,2,4,364,364,362,362
Calaveras,4,2022-01-10,523,523,299,224,2607,2607,1479,1128,0,1,1,2,95,95,94,94
Colusa,4,2022-01-10,105,105,65,40,756,756,462,294,5,0,0,0,21,21,21,21
Contra Costa,4,2022-01-10,19744,19744,10341,9403,102259,102264,53549,48715,152,12,12,24,1105,1105,1093,1093
Del Norte,4,2022-01-10,177,177,106,71,3958,3958,2363,1595,2,0,0,0,42,42,42,42
El Dorado,4,2022-01-10,2214,2214,1260,954,9363,9363,5325,4038,14,6,6,2,189,189,183,183
Fresno,4,2022-01-10,14407,14407,7785,6622,60057,60058,32385,27673,301,14,14,47,2463,2463,2449,2449
Glenn,4,2022-01-10,219,219,127,92,938,938,544,394,2,0,0,0,43,43,43,43
Humboldt,4,2022-01-10,1401,1401,827,574,8356,8356,4925,3431,18,5,5,2,128,128,123,123
Imperial,4,2022-01-10,3623,3623,2047,1576,13842,13842,7805,6037,58,11,11,25,852,852,841,841
Inyo,4,2022-01-10,408,408,248,160,1356,1356,826,530,4,2,2,0,52,52,50,50
Kern,4,2022-01-10,11945,11945,7345,4600,57114,57115,35082,22033,181,26,26,35,2083,2083,2057,2057
Kings,4,2022-01-10,2412,2412,1380,1032,13012,13012,7401,5611,33,1,1,4,394,394,393,393
Lake,4,2022-01-10,499,499,268,231,2761,2761,1477,1284,0,3,3,1,120,120,117,117
Lassen,4,2022-01-10,196,196,126,70,3438,3438,2185,1253,1,0,0,0,54,54,54,54
Los Angeles,4,2022-01-10,329089,329106,270877,58229,1916082,1916175,1577678,338497,3253,270,270,513,27908,27908,27638,27638
Madera,4,2022-01-10,1914,1914,1029,885,10379,10379,5546,4833,19,1,1,6,340,340,339,339
Marin,4,2022-01-10,2940,2940,1602,1338,21011,21011,11437,9574,18,3,3,5,260,260,257,257
Mariposa,4,2022-01-10,199,199,105,94,1158,1158,607,551,0,1,1,0,22,22,21,21
Mendocino,4,2022-01-10,874,874,410,464,5538,5538,2581,2957,8,2,2,2,106,106,104,104
Merced,4,2022-01-10,3697,3697,2238,1459,14514,14514,8774,5740,33,10,10,11,719,719,709,709
Modoc,4,2022-01-10,13,13,8,5,109,109,67,42,0,0,0,0,6,6,6,6
Mono,4,2022-01-10,253,253,106,147,863,863,360,503,1,1,1,0,5,5,4,4
Monterey,4,2022-01-10,4982,4982,2118,2864,33232,33232,14051,19181,44,5,5,12,654,654,649,649
Napa,4,2022-01-10,2646,2646,1679,967,14353,14353,9103,5250,14,1,1,4,110,110,109,109
Nevada,4,2022-01-10,1189,1189,646,543,5233,5233,2839,2394,10,2,2,3,114,114,112,112
Orange,4,2022-01-10,60078,60080,39989,20091,317667,317684,211520,106164,854,100,100,159,6186,6186,6086,6086
Placer,4,2022-01-10,5195,5195,2692,2503,22555,22555,11665,10890,179,6,6,29,524,524,518,518
Plumas,4,2022-01-10,141,141,79,62,803,803,446,357,5,0,0,0,12,12,12,12
Riverside,4,2022-01-10,48260,48260,28852,19408,187754,187763,112219,75544,762,83,83,139,5769,5769,5686,5686
Sacramento,4,2022-01-10,27538,27538,15935,11603,121789,121794,70484,51310,375,37,37,89,2574,2574,2537,2537
San Benito,4,2022-01-10,1038,1038,654,384,4616,4616,2910,1706,3,1,1,2,86,86,85,85
San Bernardino,4,2022-01-10,50661,50661,32819,17842,192767,192778,124825,67953,784,113,113,187,6787,6787,6674,6674
San Diego,4,2022-01-10,82743,82748,67424,15324,330085,330102,269013,61089,895,66,66,166,4614,4614,4548,4548
San Francisco,4,2022-01-10,15093,15093,6033,9060,117285,117290,46957,70333,158,12,12,35,711,711,699,699
San Joaquin,4,2022-01-10,14516,14516,8088,6428,66860,66863,37195,29668,151,15,15,45,2015,2015,2000,2000
San Luis Obispo,4,2022-01-10,4336,4336,2675,1661,21621,21621,13356,8265,30,2,2,7,379,379,377,377
San Mateo,4,2022-01-10,15023,15023,10006,5017,113103,113108,75331,37777,95,5,5,16,612,612,607,607
Santa Barbara,4,2022-01-10,8537,8537,5053,3484,47382,47382,28051,19331,84,9,9,10,589,589,580,580
Santa Clara,4,2022-01-10,36502,36502,29457,7045,271164,271177,218791,52386,350,26,26,68,2024,2024,1998,1998
Santa Cruz,4,2022-01-10,4543,4543,2861,1682,42815,42815,26980,15835,25,2,2,2,237,237,235,235
Shasta,4,2022-01-10,1060,1060,619,441,8406,8406,4894,3512,37,7,7,12,462,462,455,455
Siskiyou,4,2022-01-10,120,120,77,43,919,919,591,328,3,1,1,1,64,64,63,63
Solano,4,2022-01-10,6923,6923,4125,2798,37199,37199,22176,15023,94,6,6,15,403,403,397,397
Sonoma,4,2022-01-10,8869,8869,5343,3526,47198,47199,28453,18746,72,9,9,8,437,437,428,428
Stanislaus,4,2022-01-10,6740,6740,3302,3438,29317,29317,14323,14994,173,13,13,19,1471,1471,1458,1458
Sutter,4,2022-01-10,1245,1245,743,502,5062,5062,3006,2056,0,2,2,0,199,199,197,197
Tehama,4,2022-01-10,513,513,257,256,2482,2482,1241,1241,13,1,1,1,169,169,168,168
Trinity,4,2022-01-10,38,38,19,19,275,275,135,140,0,0,0,0,19,19,19,19
Tulare,4,2022-01-10,5208,5208,2538,2670,24078,24078,11672,12406,66,9,9,8,1331,1331,1322,1322
Tuolumne,4,2022-01-10,806,806,436,370,4178,4178,2257,1921,13,1,1,1,154,154,153,153
Ventura,4,2022-01-10,17512,17512,11976,5536,88215,88220,60306,27914,227,23,23,34,1258,1258,1235,1235
Yolo,4,2022-01-10,3760,3760,2341,1419,48259,48259,30013,18246,6,4,4,1,304,304,300,300
Yuba,4,2022-01-10,1022,1022,624,398,4108,4108,2504,1604,41,0,0,7,104,104,104,104
Alameda,5,2022-01-17,24707,24707,17331,7376,170503,170514,119545,50969,366,33,33,62,1613,1613,1580,1580
Amador,5,2022-01-17,476,476,282,194,3557,3557,2081,1476,10,2,2,3,73,73,71,71
Butte,5,2022-01-17,2061,2061,1537,524,9328,9328,6950,2378,58,6,6,6,370,370,364,364
Calaveras,5,2022-01-17,564,564,353,211,2472,2472,1542,930,3,2,2,3,97,97,95,95
Colusa,5,2022-01-17,161,161,107,54,719,719,476,243,3,0,0,0,21,21,21,21
Contra Costa,5,2022-01-17,16224,16224,9473,6751,88051,88056,51330,36726,198,22,22,41,1127,1127,1105,1105
Del Norte,5,2022-01-17,200,200,131,69,3758,3758,2429,1329,2,0,0,1,42,42,42,42
El Dorado,5,2022-01-17,1967,1967,1229,738,8062,8062,5041,3021,9,4,4,2,193,193,189,189
Fresno,5,2022-01-17,18260,18260,10936,7324,66176,66181,39601,26580,386,27,27,61,2490,2490,2463,2463
Glenn,5,2022-01-17,306,306,194,112,1076,1076,683,393,3,2,2,0,45,45,43,43
Humboldt,5,2022-01-17,1144,1144,739,405,8322,8322,5364,2958,10,1,1,4,129,129,128,128
Imperial,5,2022-01-17,3414,3414,2123,1291,13242,13242,8232,5010,69,12,12,29,864,864,852,852
Inyo,5,2022-01-17,327,327,216,111,1040,1040,688,352,4,0,0,0,52,52,52,52
Kern,5,2022-01-17,11693,11693,7803,3890,51810,51813,34534,17279,242,29,29,44,2112,2112,2083,2083
Kings,5,2022-01-17,3200,3200,1999,1201,14866,14866,9258,5608,40,4,4,1,398,398,394,394
Lake,5,2022-01-17,583,583,348,235,3245,3245,1935,1310,2,1,1,2,121,121,120,120
Lassen,5,2022-01-17,284,284,196,88,3322,3322,2278,1044,0,0,0,0,54,54,54,54
Los Angeles,5,2022-01-17,218478,218489,186911,31578,1610674,1610763,1377028,233735,4034,504,504,680,28412,28412,27908,27908
Madera,5,2022-01-17,2400,2400,1431,969,10611,10611,6301,4310,32,5,5,10,345,345,340,340
Marin,5,2022-01-17,2420,2420,1461,959,17702,17702,10678,7024,38,4,4,6,264,264,260,260
Mariposa,5,2022-01-17,163,163,95,68,1115,1115,648,467,0,0,0,0,22,22,22,22
Mendocino,5,2022-01-17,922,922,487,435,5015,5015,2630,2385,18,3,3,2,109,109,106,106
Merced,5,2022-01-17,3970,3970,2618,1352,13639,13639,8989,4650,41,18,18,11,737,737,719,719
Modoc,5,2022-01-17,13,13,9,4,102,102,68,34,0,1,1,0,7,7,6,6
Mono,5,2022-01-17,198,198,94,104,809,809,386,423,2,0,0,0,5,5,5,5
Monterey,5,2022-01-17,5902,5902,2860,3042,28328,28328,13710,14618,69,6,6,14,660,660,654,654
Napa,5,2022-01-17,1930,1930,1329,601,11914,11914,8177,3737,21,2,2,5,112,112,110,110
Nevada,5,2022-01-17,1253,1253,753,500,5431,5431,3262,2169,19,1,1,1,115,115,114,114
Orange,5,2022-01-17,41324,41324,29642,11682,251495,251510,180241,71269,998,111,111,199,6297,6297,6186,6186
Placer,5,2022-01-17,4320,4320,2495,1825,19460,19460,11216,8244,178,14,14,36,538,538,524,524
Plumas,5,2022-01-17,194,194,119,75,852,852,524,328,3,0,0,0,12,12,12,12
Riverside,5,2022-01-17,41254,41254,26969,14285,168056,168066,109885,58181,920,97,97,158,5866,5866,5769,5769
Sacramento,5,2022-01-17,21457,21457,13655,7802,101465,101470,64497,36973,473,64,64,97,2638,2638,2574,2574
San Benito,5,2022-01-17,903,903,618,285,4273,4273,2922,1351,4,1,1,4,87,87,86,86
San Bernardino,5,2022-01-17,38500,38500,26931,11569,164350,164360,114971,49389,936,146,146,227,6933,6933,6787,6787
San Diego,5,2022-01-17,60699,60702,51527,9175,265928,265943,225768,40175,1067,103,103,193,4717,4717,4614,4614
San Francisco,5,2022-01-17,11266,11266,5203,6063,94012,94017,43307,50710,212,14,14,44,725,725,711,711
San Joaquin,5,2022-01-17,12720,12720,7804,4916,58135,58140,35676,22464,201,20,20,57,2035,2035,2015,2015
San Luis Obispo,5,2022-01-17,3935,3935,2647,1288,21023,21023,14126,6897,46,12,12,10,391,391,379,379
San Mateo,5,2022-01-17,12487,12487,8948,3539,95951,95956,68675,27281,92,10,10,30,622,622,612,612
Santa Barbara,5,2022-01-17,6852,6852,4445,2407,40485,40485,26230,14255,123,12,12,12,601,601,589,589
Santa Clara,5,2022-01-17,29559,29559,24870,4689,235959,235973,198422,37551,451,24,24,84,2048,2048,2024,2024
Santa Cruz,5,2022-01-17,4185,4185,2868,1317,42205,42206,28863,13343,23,3,3,3,240,240,237,237
Shasta,5,2022-01-17,1347,1347,863,484,9163,9163,5844,3319,55,7,7,14,469,469,462,462
Siskiyou,5,2022-01-17,158,158,110,48,927,927,640,287,3,1,1,2,65,65,64,64
Solano,5,2022-01-17,6434,6434,4199,2235,35261,35261,23011,12250,121,6,6,22,409,409,403,403
Sonoma,5,2022-01-17,7628,7628,5026,2602,42780,42780,28133,14647,73,7,7,15,444,444,437,437
Stanislaus,5,2022-01-17,7327,7327,4018,3309,29058,29058,15916,13142,206,10,10,31,1481,1481,1471,1471
Sutter,5,2022-01-17,1248,1248,812,436,4863,4863,3161,1702,0,4,4,0,203,203,199,199
Tehama,5,2022-01-17,615,615,344,271,2420,2420,1349,1071,15,5,5,2,174,174,169,169
Trinity,5,2022-01-17,41,41,23,18,255,255,140,115,0,1,1,0,20,20,19,19
Tulare,5,2022-01-17,7476,7476,4069,3407,27093,27093,14727,12366,97,16,16,16,1347,1347,1331,1331
Tuolumne,5,2022-01-17,886,886,532,354,3836,3836,2287,1549,10,8,8,1,162,162,154,154
Ventura,5,2022-01-17,11975,11975,8781,3194,66930,66935,49018,17917,300,41,41,56,1299,1299,1258,1258
Yolo,5,2022-01-17,2805,2805,1899,906,39517,39517,26719,12798,15,4,4,4,308,308,304,304
Yuba,5,2022-01-17,1064,1064,707,357,3747,3747,2489,1258,42,2,2,6,106,106,104,104
Alameda,6,2022-01-24,19744,19744,14823,4921,171782,171795,129147,42648,373,41,41,68,1654,1654,1613,1613
Amador,6,2022-01-24,544,544,352,192,4667,4667,3019,1648,8,0,0,5,73,73,73,73
Butte,6,2022-01-24,1904,1904,1501,403,9612,9612,7594,2018,82,10,10,9,380,380,370,370
Calaveras,6,2022-01-24,556,556,378,178,2506,2506,1705,801,6,2,2,2,99,99,97,97
Colusa,6,2022-01-24,177,177,127,50,951,951,680,271,6,0,0,0,21,21,21,21
Contra Costa,6,2022-01-24,13595,13595,8737,4858,85321,85326,54894,30432,217,25,25,64,1152,1152,1127,1127
Del Norte,6,2022-01-24,348,348,246,102,4326,4326,3042,1284,3,0,0,3,42,42,42,42
El Dorado,6,2022-01-24,1400,1400,954,446,7329,7329,5001,2328,17,2,2,6,195,195,193,193
Fresno,6,2022-01-24,17719,17719,11610,6109,68853,68858,45200,23658,491,43,43,83,2533,2533,2490,2490
Glenn,6,2022-01-24,250,250,172,78,971,971,670,301,0,0,0,0,45,45,45,45
Humboldt,6,2022-01-24,915,915,641,274,7714,7714,5409,2305,25,3,3,3,132,132,129,129
Imperial,6,2022-01-24,3618,3618,2456,1162,13189,13189,8970,4219,70,14,14,27,878,878,864,864
Inyo,6,2022-01-24,142,142,102,40,625,625,449,176,1,1,1,0,53,53,52,52
Kern,6,2022-01-24,10554,10554,7599,2955,53946,53951,38893,15058,267,47,47,51,2159,2159,2112,2112
Kings,6,2022-01-24,4306,4306,2925,1381,19064,19064,12977,6087,40,4,4,4,402,402,398,398
Lake,6,2022-01-24,746,746,488,258,3417,3417,2234,1183,6,2,2,3,123,123,121,121
Lassen,6,2022-01-24,418,418,307,111,3982,3982,2932,1050,6,0,0,0,54,54,54,54
Los Angeles,6,2022-01-24,164900,164912,145674,19238,1659631,1659747,1467164,192583,3769,611,611,785,29023,29023,28412,28412
Madera,6,2022-01-24,2715,2715,1771,944,12170,12170,7938,4232,49,7,7,10,352,352,345,345
Marin,6,2022-01-24,1857,1857,1227,630,17548,17548,11608,5940,38,4,4,10,268,268,264,264
Mariposa,6,2022-01-24,133,133,85,48,945,945,605,340,0,0,0,0,22,22,22,22
Mendocino,6,2022-01-24,917,917,538,379,4873,4873,2854,2019,23,2,2,3,111,111,109,109
Merced,6,2022-01-24,3235,3235,2308,927,12907,12907,9214,3693,55,9,9,12,746,746,737,737
Modoc,6,2022-01-24,14,14,10,4,114,114,82,32,2,0,0,0,7,7,7,7
Mono,6,2022-01-24,97,97,52,45,422,422,227,195,1,0,0,0,5,5,5,5
Monterey,6,2022-01-24,5088,5088,2775,2313,31797,31797,17335,14462,80,9,9,17,669,669,660,660
Napa,6,2022-01-24,1672,1672,1236,436,12465,12465,9206,3259,23,5,5,4,117,117,112,112
Nevada,6,2022-01-24,1001,1001,659,342,4806,4806,3170,1636,29,1,1,6,116,116,115,115
Orange,6,2022-01-24,26680,26680,20389,6291,230900,230917,176713,54204,923,177,177,191,6474,6474,6297,6297
Placer,6,2022-01-24,3660,3660,2330,1330,18644,18644,11867,6777,215,8,8,43,546,546,538,538
Plumas,6,2022-01-24,215,215,144,71,836,836,559,277,5,0,0,0,12,12,12,12
Riverside,6,2022-01-24,31910,31910,22577,9333,158777,158789,112471,46318,901,122,122,168,5988,5988,5866,5866
Sacramento,6,2022-01-24,17472,17472,12089,5383,98840,98846,68432,30414,542,64,64,105,2702,2702,2638,2638
San Benito,6,2022-01-24,776,776,570,206,3929,3929,2889,1040,7,1,1,3,88,88,87,87
San Bernardino,6,2022-01-24,28080,28080,21043,7037,153566,153577,115205,38372,975,170,170,223,7103,7103,6933,6933
San Diego,6,2022-01-24,51481,51485,45187,6298,252113,252131,221538,30593,1056,131,131,232,4848,4848,4717,4717
San Francisco,6,2022-01-24,8097,8097,4233,3864,88916,88921,46541,42380,232,19,19,37,744,744,725,725
San Joaquin,6,2022-01-24,11055,11055,7404,3651,59113,59118,39674,19444,241,34,34,71,2069,2069,2035,2035
San Luis Obispo,6,2022-01-24,3561,3561,2582,979,21516,21516,15603,5913,42,10,10,12,401,401,391,391
San Mateo,6,2022-01-24,8510,8510,6501,2009,95138,95143,72744,22399,139,19,19,28,641,641,622,622
Santa Barbara,6,2022-01-24,6484,6484,4559,1925,43826,43829,30824,13005,127,12,12,19,613,613,601,601
Santa Clara,6,2022-01-24,22785,22785,19871,2914,233307,233323,203470,29853,412,48,48,88,2096,2096,2048,2048
Santa Cruz,6,2022-01-24,5045,5045,3710,1335,45621,45624,33577,12047,31,1,1,2,241,241,240,240
Shasta,6,2022-01-24,1486,1486,1032,454,10135,10135,7033,3102,78,7,7,9,476,476,469,469
Siskiyou,6,2022-01-24,159,159,118,41,857,857,635,222,6,3,3,1,68,68,65,65
Solano,6,2022-01-24,5127,5127,3627,1500,32696,32696,23142,9554,143,14,14,26,423,423,409,409
Sonoma,6,2022-01-24,6926,6926,4931,1995,42475,42478,30249,12229,94,7,7,18,451,451,444,444
Stanislaus,6,2022-01-24,6376,6376,3877,2499,28268,28268,17211,11057,277,27,27,44,1508,1508,1481,1481
Sutter,6,2022-01-24,1047,1047,737,310,5002,5002,3521,1481,0,2,2,0,205,205,203,203
Tehama,6,2022-01-24,578,578,358,220,2702,2702,1674,1028,19,4,4,5,178,178,174,174
Trinity,6,2022-01-24,63,63,38,25,322,322,196,126,0,0,0,0,20,20,20,20
Tulare,6,2022-01-24,7673,7673,4629,3044,29527,29527,17853,11674,138,11,11,14,1358,1358,1347,1347
Tuolumne,6,2022-01-24,953,953,627,326,3827,3827,2510,1317,17,2,2,3,164,164,162,162
Ventura,6,2022-01-24,9412,9412,7331,2081,68520,68525,53431,15094,269,28,28,68,1327,1327,1299,1299
Yolo,6,2022-01-24,2300,2300,1677,623,40478,40480,29514,10966,18,12,12,5,320,320,308,308
Yuba,6,2022-01-24,911,911,653,258,3779,3779,2711,1068,54,3,3,10,109,109,106,106
Alameda,7,2022-01-31,11000,11000,8743,2257,137321,137333,109280,28053,336,50,50,75,1704,1704,1654,1654
Amador,7,2022-01-31,350,350,246,104,3226,3226,2273,953,15,1,1,4,74,74,73,73
Butte,7,2022-01-31,1168,1168,967,201,7609,7609,6306,1303,80,6,6,7,386,386,380,380
Calaveras,7,2022-01-31,263,263,193,70,1940,1940,1424,516,3,5,5,2,104,104,99,99
Colusa,7,2022-01-31,106,106,81,25,704,704,540,164,9,0,0,0,21,21,21,21
Contra Costa,7,2022-01-31,7315,7315,5100,2215,68627,68632,47924,20708,207,39,39,54,1191,1191,1152,1152
Del Norte,7,2022-01-31,315,315,237,78,3957,3957,2977,980,6,2,2,2,44,44,42,42
El Dorado,7,2022-01-31,741,741,544,197,6021,6021,4421,1600,13,4,4,5,199,199,195,195
Fresno,7,2022-01-31,10968,10968,7778,3190,54946,54951,39023,15928,503,39,39,98,2572,2572,2533,2533
Glenn,7,2022-01-31,190,190,140,50,759,759,563,196,2,2,2,0,47,47,45,45
Humboldt,7,2022-01-31,583,583,438,145,5790,5790,4348,1442,18,3,3,3,135,135,132,132
Imperial,7,2022-01-31,2195,2195,1600,595,11303,11303,8264,3039,71,17,17,28,895,895,878,878
Inyo,7,2022-01-31,55,55,42,13,467,467,357,110,5,3,3,0,56,56,53,53
Kern,7,2022-01-31,5650,5650,4340,1310,42263,42267,32506,9761,264,47,47,54,2206,2206,2159,2159
Kings,7,2022-01-31,2391,2391,1749,642,13681,13681,10017,3664,55,5,5,4,407,407,402,402
Lake,7,2022-01-31,478,478,338,140,3193,3193,2258,935,4,4,4,4,127,127,123,123
Lassen,7,2022-01-31,311,311,243,68,3624,3624,2838,786,7,1,1,0,55,55,54,54
Los Angeles,7,2022-01-31,74572,74577,67644,6933,1303397,1303500,1183134,120366,2991,640,640,719,29663,29663,29023,29023
Madera,7,2022-01-31,1744,1744,1233,511,9631,9631,6816,2815,50,6,6,7,358,358,352,352
Marin,7,2022-01-31,1064,1064,760,304,13816,13816,9888,3928,26,5,5,9,273,273,268,268
Mariposa,7,2022-01-31,101,101,70,31,840,840,584,256,0,2,2,0,24,24,22,22
Mendocino,7,2022-01-31,464,464,299,165,3486,3486,2252,1234,12,3,3,4,114,114,111,111
Merced,7,2022-01-31,2125,2125,1618,507,10465,10465,7975,2490,54,12,12,14,758,758,746,746
Modoc,7,2022-01-31,12,12,9,3,89,89,68,21,1,0,0,0,7,7,7,7
Mono,7,2022-01-31,41,41,25,16,339,339,203,136,0,0,0,0,5,5,5,5
Monterey,7,2022-01-31,3558,3558,2154,1404,26742,26742,16229,10513,82,9,9,13,678,678,669,669
Napa,7,2022-01-31,989,989,776,213,9376,9376,7355,2021,17,7,7,10,124,124,117,117
Nevada,7,2022-01-31,568,568,404,164,3912,3912,2788,1124,26,3,3,5,119,119,116,116
Orange,7,2022-01-31,12000,12000,9681,2319,177031,177046,142943,34103,708,170,170,164,6644,6644,6474,6474
Placer,7,2022-01-31,2256,2256,1560,696,15375,15375,10647,4728,152,19,19,42,565,565,546,546
Plumas,7,2022-01-31,137,137,98,39,753,753,542,211,1,0,0,0,12,12,12,12
Riverside,7,2022-01-31,15945,15945,12051,3894,121042,121053,91700,29353,740,111,111,171,6099,6099,5988,5988
Sacramento,7,2022-01-31,10138,10138,7522,2616,77585,77590,57655,19935,501,93,93,106,2795,2795,2702,2702
San Benito,7,2022-01-31,474,474,370,104,3323,3323,2596,727,5,2,2,3,90,90,88,88
San Bernardino,7,2022-01-31,13252,13252,10516,2736,116537,116548,92602,23946,744,185,185,207,7288,7288,7103,7103
San Diego,7,2022-01-31,24866,24866,22435,2431,181384,181399,163807,17592,944,105,105,214,4953,4953,4848,4848
San Francisco,7,2022-01-31,4047,4047,2360,1687,69165,69170,40404,28766,208,24,24,45,768,768,744,744
San Joaquin,7,2022-01-31,5702,5702,4125,1577,43686,43690,31673,12017,210,36,36,75,2105,2105,2069,2069
San Luis Obispo,7,2022-01-31,1981,1981,1530,451,16234,16234,12540,3694,40,12,12,10,413,413,401,401
San Mateo,7,2022-01-31,4328,4328,3489,839,75105,75110,60573,14537,131,10,10,19,651,651,641,641
Santa Barbara,7,2022-01-31,3634,3634,2733,901,35026,35028,26387,8641,103,23,23,13,636,636,613,613
Santa Clara,7,2022-01-31,13837,13837,12416,1421,207114,207130,185912,21218,427,54,54,93,2150,2150,2096,2096
Santa Cruz,7,2022-01-31,3441,3441,2682,759,51420,51425,40154,11271,35,5,5,6,246,246,241,241
Shasta,7,2022-01-31,900,900,670,230,8419,8419,6269,2150,59,13,13,11,489,489,476,476
Siskiyou,7,2022-01-31,119,119,94,25,691,691,545,146,8,2,2,2,70,70,68,68
Solano,7,2022-01-31,3813,3813,2885,928,28763,28763,21766,6997,126,6,6,30,429,429,423,423
Sonoma,7,2022-01-31,3569,3569,2711,858,32148,32150,24455,7695,84,12,12,15,463,463,451,451
Stanislaus,7,2022-01-31,3687,3687,2458,1229,22306,22306,14897,7409,261,33,33,53,1541,1541,1508,1508
Sutter,7,2022-01-31,619,619,466,153,3764,3764,2837,927,0,4,4,0,209,209,205,205
Tehama,7,2022-01-31,377,377,256,121,2022,2022,1368,654,17,3,3,5,181,181,178,178
Trinity,7,2022-01-31,43,43,29,14,227,227,151,76,0,0,0,0,20,20,20,20
Tulare,7,2022-01-31,4684,4684,3097,1587,22907,22907,15177,7730,150,22,22,21,1380,1380,1358,1358
Tuolumne,7,2022-01-31,710,710,502,208,3265,3265,2315,950,12,2,2,4,166,166,164,164
Ventura,7,2022-01-31,4599,4599,3766,833,52327,52332,42907,9425,253,39,39,48,1366,1366,1327,1327
Yolo,7,2022-01-31,1353,1353,1049,304,37523,37525,29119,8406,19,5,5,5,325,325,320,320
Yuba,7,2022-01-31,523,523,400,123,2930,2930,2243,687,78,2,2,11,111,111,109,109
Alameda,8,2022-02-07,5966,5966,4967,999,115667,115677,96377,19300,254,44,44,62,1748,1748,1704,1704
Amador,8,2022-02-07,204,204,153,51,2909,2909,2187,722,14,4,4,5,78,78,74,74
Butte,8,2022-02-07,782,782,673,109,6394,6394,5506,888,74,8,8,12,394,394,386,386
Calaveras,8,2022-02-07,183,183,142,41,1427,1427,1112,315,2,2,2,1,106,106,104,104
Colusa,8,2022-02-07,71,71,57,14,555,555,449,106,0,0,0,0,21,21,21,21
Contra Costa,8,2022-02-07,4137,4137,3094,1043,54157,54162,40512,13650,149,32,32,52,1223,1223,1191,1191
Del Norte,8,2022-02-07,286,286,228,58,4003,4003,3184,819,5,0,0,0,44,44,44,44
El Dorado,8,2022-02-07,427,427,333,94,5036,5036,3928,1108,20,1,1,5,200,200,199,199
Fresno,8,2022-02-07,6384,6384,4836,1548,42579,42584,32298,10286,450,49,49,87,2621,2621,2572,2572
Glenn,8,2022-02-07,113,113,88,25,620,620,488,132,4,3,3,0,50,50,47,47
Humboldt,8,2022-02-07,467,467,371,96,4875,4875,3874,1001,15,1,1,2,136,136,135,135
Imperial,8,2022-02-07,1095,1095,851,244,7941,7941,6174,1767,46,12,12,26,907,907,895,895
Inyo,8,2022-02-07,38,38,30,8,447,447,361,86,5,0,0,0,56,56,56,56
Kern,8,2022-02-07,3472,3472,2811,661,34656,34660,28091,6569,190,32,32,43,2238,2238,2206,2206
Kings,8,2022-02-07,1352,1352,1052,300,10247,10247,7976,2271,52,14,14,5,421,421,407,407
Lake,8,2022-02-07,351,351,265,86,2625,2625,1985,640,11,1,1,5,128,128,127,127
Lassen,8,2022-02-07,140,140,115,25,3023,3023,2487,536,5,2,2,0,57,57,55,55
Los Angeles,8,2022-02-07,37351,37355,34597,2758,1151737,1151835,1067257,84578,2155,638,638,547,30301,30301,29663,29663
Madera,8,2022-02-07,1060,1060,802,258,8081,8081,6118,1963,38,4,4,9,362,362,358,358
Marin,8,2022-02-07,655,655,500,155,11291,11291,8617,2674,29,8,8,6,281,281,273,273
Mariposa,8,2022-02-07,51,51,38,13,579,579,431,148,0,0,0,0,24,24,24,24
Mendocino,8,2022-02-07,327,327,229,98,2817,2817,1974,843,12,2,2,5,116,116,114,114
Merced,8,2022-02-07,1209,1209,973,236,8063,8063,6492,1571,53,13,13,12,771,771,758,758
Modoc,8,2022-02-07,25,25,20,5,219,219,179,40,3,0,0,0,7,7,7,7
Mono,8,2022-02-07,44,44,29,15,271,271,178,93,0,0,0,0,5,5,5,5
Monterey,8,2022-02-07,2221,2221,1474,747,22461,22461,14939,7522,68,11,11,14,689,689,678,678
Napa,8,2022-02-07,742,742,611,131,7766,7766,6396,1370,16,6,6,2,130,130,124,124
Nevada,8,2022-02-07,357,357,271,86,3187,3187,2429,758,24,3,3,1,122,122,119,119
Orange,8,2022-02-07,6394,6394,5391,1003,152286,152299,128450,23849,494,118,118,125,6762,6762,6644,6644
Placer,8,2022-02-07,1294,1294,960,334,11887,11887,8831,3056,148,22,22,34,587,587,565,565
Plumas,8,2022-02-07,79,79,60,19,521,521,399,122,1,1,1,0,13,13,12,12
Riverside,8,2022-02-07,8144,8144,6512,1632,93427,93434,74778,18656,548,107,107,116,6206,6206,6099,6099
Sacramento,8,2022-02-07,6076,6076,4784,1292,63991,63996,50434,13562,390,72,72,95,2867,2867,2795,2795
San Benito,8,2022-02-07,312,312,256,56,2660,2660,2184,476,3,0,0,4,90,90,90,90
San Bernardino,8,2022-02-07,7050,7050,5864,1186,90089,90096,74997,15099,528,140,140,156,7428,7428,7288,7288
San Diego,8,2022-02-07,13636,13636,12579,1057,151885,151898,140182,11716,773,116,116,169,5069,5069,4953,4953
San Francisco,8,2022-02-07,2409,2409,1553,856,55777,55782,35915,19867,171,25,25,40,793,793,768,768
San Joaquin,8,2022-02-07,3348,3348,2581,767,36552,36555,28229,8326,186,42,42,62,2147,2147,2105,2105
San Luis Obispo,8,2022-02-07,1204,1204,979,225,12341,12341,10042,2299,23,16,16,7,429,429,413,413
San Mateo,8,2022-02-07,2463,2463,2075,388,62131,62136,52356,9780,83,16,16,18,667,667,651,651
Santa Barbara,8,2022-02-07,2282,2282,1814,468,30723,30725,24434,6291,75,15,15,17,651,651,636,636
Santa Clara,8,2022-02-07,8033,8033,7376,657,175343,175359,161039,14320,377,31,31,74,2181,2181,2150,2150
Santa Cruz,8,2022-02-07,1900,1900,1560,340,38681,38685,31767,6918,28,4,4,5,250,250,246,246
Shasta,8,2022-02-07,677,677,534,143,6857,6857,5413,1444,64,15,15,10,504,504,489,489
Siskiyou,8,2022-02-07,91,91,75,16,720,720,595,125,10,2,2,0,72,72,70,70
Solano,8,2022-02-07,2238,2238,1784,454,24263,24263,19389,4874,91,5,5,28,434,434,429,429
Sonoma,8,2022-02-07,2086,2086,1676,410,27054,27055,21736,5319,57,7,7,11,470,470,463,463
Stanislaus,8,2022-02-07,2491,2491,1792,699,18738,18738,13501,5237,243,43,43,43,1584,1584,1541,1541
Sutter,8,2022-02-07,360,360,286,74,3305,3305,2631,674,0,5,5,0,214,214,209,209
Tehama,8,2022-02-07,282,282,205,77,1644,1644,1197,447,17,3,3,6,184,184,181,181
Trinity,8,2022-02-07,18,18,13,5,136,136,98,38,0,0,0,0,20,20,20,20
Tulare,8,2022-02-07,2705,2705,1934,771,17913,17913,12835,5078,130,26,26,21,1406,1406,1380,1380
Tuolumne,8,2022-02-07,348,348,263,85,2576,2576,1953,623,10,2,2,1,168,168,166,166
Ventura,8,2022-02-07,2696,2696,2301,395,42327,42332,36170,6162,207,40,40,45,1406,1406,1366,1366
Yolo,8,2022-02-07,864,864,706,158,30867,30867,25188,5679,12,11,11,6,336,336,325,325
Yuba,8,2022-02-07,333,333,269,64,2405,2405,1942,463,42,4,4,13,115,115,111,111
Alameda,9,2022-02-14,3405,3405,2944,461,98990,98999,85613,13386,190,40,40,48,1788,1788,1748,1748
Amador,9,2022-02-14,109,109,87,22,2345,2345,1866,479,8,3,3,3,81,81,78,78
Butte,9,2022-02-14,464,464,412,52,5317,5317,4721,596,64,10,10,9,404,404,394,394
Calaveras,9,2022-02-14,79,79,64,15,1161,1161,949,212,4,2,2,2,108,108,106,106
Colusa,9,2022-02-14,35,35,29,6,406,406,341,65,5,0,0,0,21,21,21,21
Contra Costa,9,2022-02-14,2405,2405,1905,500,44864,44869,35547,9322,123,23,23,31,1246,1246,1223,1223
Del Norte,9,2022-02-14,210,210,175,35,3338,3338,2775,563,6,0,0,3,44,44,44,44
El Dorado,9,2022-02-14,260,260,213,47,4433,4433,3631,802,21,4,4,3,204,204,200,200
Fresno,9,2022-02-14,3866,3866,3095,771,34937,34941,27982,6959,375,33,33,75,2654,2654,2621,2621
Glenn,9,2022-02-14,58,58,48,10,482,482,398,84,3,1,1,0,51,51,50,50
Humboldt,9,2022-02-14,331,331,275,56,4202,4202,3495,707,23,0,0,2,136,136,136,136
Imperial,9,2022-02-14,588,588,480,108,5962,5962,4871,1091,44,14,14,18,921,921,907,907
Inyo,9,2022-02-14,29,29,24,5,413,413,348,65,3,0,0,0,56,56,56,56
Kern,9,2022-02-14,2014,2014,1701,313,27232,27235,23014,4221,156,28,28,40,2266,2266,2238,2238
Kings,9,2022-02-14,774,774,633,141,8001,8001,6548,1453,43,8,8,5,429,429,421,421
Lake,9,2022-02-14,256,256,205,51,2307,2307,1842,465,6,2,2,5,130,130,128,128
Lassen,9,2022-02-14,155,155,133,22,2789,2789,2383,406,3,2,2,0,59,59,57,57
Los Angeles,9,2022-02-14,21438,21438,20185,1253,1052567,1052673,991314,61359,1572,490,490,423,30791,30791,30301,30301
Madera,9,2022-02-14,620,620,496,124,6462,6462,5165,1297,29,2,2,7,364,364,362,362
Marin,9,2022-02-14,383,383,309,74,10150,10150,8173,1977,23,5,5,4,286,286,281,281
Mariposa,9,2022-02-14,24,24,19,5,433,433,342,91,0,0,0,0,24,24,24,24
Mendocino,9,2022-02-14,207,207,155,52,2445,2445,1834,611,13,1,1,7,117,117,116,116
Merced,9,2022-02-14,745,745,627,118,6832,6832,5744,1088,37,13,13,8,784,784,771,771
Modoc,9,2022-02-14,17,17,14,3,124,124,104,20,0,0,0,0,7,7,7,7
Mono,9,2022-02-14,10,10,7,3,179,179,127,52,0,0,0,0,5,5,5,5
Monterey,9,2022-02-14,1229,1229,881,348,16949,16949,12154,4795,48,12,12,12,701,701,689,689
Napa,9,2022-02-14,400,400,343,57,6577,6577,5635,942,10,1,1,1,131,131,130,130
Nevada,9,2022-02-14,169,169,136,33,2568,2568,2066,502,19,3,3,5,125,125,122,122
Orange,9,2022-02-14,3997,3997,3492,505,132322,132337,115564,16773,354,115,115,77,6877,6877,6762,6762
Placer,9,2022-02-14,595,595,468,127,9967,9967,7844,2123,105,12,12,23,599,599,587,587
Plumas,9,2022-02-14,43,43,35,8,431,431,348,83,1,0,0,0,13,13,13,13
Riverside,9,2022-02-14,4612,4612,3859,753,74753,74760,62572,12188,400,85,85,86,6291,6291,6206,6206
Sacramento,9,2022-02-14,3415,3415,2822,593,53018,53023,43830,9193,349,59,59,66,2926,2926,2867,2867
San Benito,9,2022-02-14,158,158,135,23,2159,2159,1845,314,0,1,1,3,91,91,90,90
San Bernardino,9,2022-02-14,3704,3704,3199,505,72754,72759,62874,9885,338,117,117,128,7545,7545,7428,7428
San Diego,9,2022-02-14,8080,8080,7582,498,126079,126092,118380,7712,589,89,89,135,5158,5158,5069,5069
San Francisco,9,2022-02-14,1610,1610,1124,486,47602,47607,33266,14341,130,25,25,39,818,818,793,793
San Joaquin,9,2022-02-14,1986,1986,1613,373,30667,30671,24922,5749,123,37,37,53,2184,2184,2147,2147
San Luis Obispo,9,2022-02-14,798,798,677,121,10051,10051,8530,1521,24,9,9,7,438,438,429,429
San Mateo,9,2022-02-14,1345,1345,1174,171,55007,55012,48011,7001,63,16,16,11,683,683,667,667
Santa Barbara,9,2022-02-14,1056,1056,880,176,22481,22482,18753,3729,68,8,8,14,659,659,651,651
Santa Clara,9,2022-02-14,4636,4636,4335,301,155253,155269,145188,10081,296,27,27,59,2208,2208,2181,2181
Santa Cruz,9,2022-02-14,981,981,838,143,30369,30373,25923,4450,23,3,3,4,253,253,250,250
Shasta,9,2022-02-14,443,443,366,77,5851,5851,4841,1010,62,13,13,13,517,517,504,504
Siskiyou,9,2022-02-14,66,66,57,9,520,520,447,73,7,1,1,2,73,73,72,72
Solano,9,2022-02-14,1201,1201,1003,198,19021,19021,15903,3118,73,2,2,20,436,436,434,434
Sonoma,9,2022-02-14,1135,1135,953,182,21178,21178,17764,3414,55,8,8,7,478,478,470,470
Stanislaus,9,2022-02-14,1364,1364,1046,318,15080,15080,11571,3509,206,28,28,41,1612,1612,1584,1584
Sutter,9,2022-02-14,230,230,192,38,2862,2862,2386,476,0,3,3,0,217,217,214,214
Tehama,9,2022-02-14,180,180,139,41,1404,1404,1088,316,15,5,5,5,189,189,184,184
Trinity,9,2022-02-14,22,22,17,5,171,171,131,40,0,0,0,0,20,20,20,20
Tulare,9,2022-02-14,1480,1480,1128,352,15051,15051,11500,3551,116,27,27,19,1433,1433,1406,1406
Tuolumne,9,2022-02-14,192,192,154,38,2222,2222,1778,444,12,4,4,1,172,172,168,168
Ventura,9,2022-02-14,1511,1511,1333,178,35526,35531,31350,4181,141,36,36,26,1442,1442,1406,1406
Yolo,9,2022-02-14,479,479,407,72,26828,26829,22796,4033,10,7,7,3,343,343,336,336
Yuba,9,2022-02-14,220,220,185,35,2109,2109,1777,332,19,0,0,11,115,115,115,115
Alameda,10,2022-02-21,1928,1928,1718,210,77633,77642,69067,8575,138,28,28,26,1816,1816,1788,1788
Amador,10,2022-02-21,70,70,58,12,1921,1921,1598,323,7,3,3,3,84,84,81,81
Butte,10,2022-02-21,255,255,232,23,4426,4426,4027,399,63,12,12,4,416,416,404,404
Calaveras,10,2022-02-21,44,44,37,7,838,838,712,126,3,6,6,0,114,114,108,108
Colusa,10,2022-02-21,26,26,23,3,362,362,315,47,4,0,0,0,21,21,21,21
Contra Costa,10,2022-02-21,1305,1305,1081,224,34149,34153,28274,5879,66,17,17,30,1263,1263,1246,1246
Del Norte,10,2022-02-21,129,129,111,18,2704,2704,2329,375,8,0,0,1,44,44,44,44
El Dorado,10,2022-02-21,155,155,132,23,3612,3612,3078,534,8,1,1,5,205,205,204,204
Fresno,10,2022-02-21,2011,2011,1683,328,26915,26918,22518,4400,272,26,26,54,2680,2680,2654,2654
Glenn,10,2022-02-21,28,28,24,4,405,405,348,57,2,1,1,0,52,52,51,51
Humboldt,10,2022-02-21,193,193,166,27,3331,3331,2873,458,22,3,3,1,139,139,136,136
Imperial,10,2022-02-21,394,394,335,59,4756,4756,4047,709,31,6,6,10,927,927,921,921
Inyo,10,2022-02-21,10,10,9,1,326,326,284,42,1,0,0,0,56,56,56,56
Kern,10,2022-02-21,1285,1285,1123,162,24322,24325,21266,3059,95,23,23,25,2289,2289,2266,2266
Kings,10,2022-02-21,454,454,387,67,6543,6543,5576,967,32,4,4,5,433,433,429,429
Lake,10,2022-02-21,185,185,155,30,1935,1935,1614,321,7,2,2,1,132,132,130,130
Lassen,10,2022-02-21,111,111,98,13,2135,2135,1883,252,1,0,0,0,59,59,59,59
Los Angeles,10,2022-02-21,11809,11809,11262,547,832365,832462,793424,39038,997,322,322,279,31113,31113,30791,30791
Madera,10,2022-02-21,317,317,265,52,5176,5176,4315,861,27,2,2,7,366,366,364,364
Marin,10,2022-02-21,199,199,167,32,8845,8845,7425,1420,13,3,3,4,289,289,286,286
Mariposa,10,2022-02-21,23,23,19,4,372,372,307,65,0,1,1,0,25,25,24,24
Mendocino,10,2022-02-21,113,113,90,23,1942,1942,1539,403,9,2,2,3,119,119,117,117
Merced,10,2022-02-21,427,427,372,55,5160,5160,4489,671,26,10,10,7,794,794,784,784
Modoc,10,2022-02-21,9,9,8,1,65,65,57,8,2,0,0,0,7,7,7,7
Mono,10,2022-02-21,7,7,5,2,162,162,123,39,0,1,1,0,6,6,5,5
Monterey,10,2022-02-21,780,780,596,184,12977,12977,9894,3083,47,5,5,7,706,706,701,701
Napa,10,2022-02-21,229,229,202,27,4985,4985,4405,580,6,4,4,3,135,135,131,131
Nevada,10,2022-02-21,102,102,85,17,1985,1985,1665,320,16,2,2,5,127,127,125,125
Orange,10,2022-02-21,2463,2463,2213,250,110415,110429,99035,11394,256,79,79,69,6956,6956,6877,6877
Placer,10,2022-02-21,328,328,271,57,8679,8679,7157,1522,92,9,9,13,608,608,599,599
Plumas,10,2022-02-21,21,21,18,3,328,328,276,52,0,0,0,0,13,13,13,13
Riverside,10,2022-02-21,2439,2439,2115,324,61414,61420,53280,8140,262,53,53,61,6344,6344,6291,6291
Sacramento,10,2022-02-21,1961,1961,1683,278,42786,42791,36701,6090,249,33,33,47,2959,2959,2926,2926
San Benito,10,2022-02-21,104,104,92,12,1696,1696,1494,202,0,0,0,1,91,91,91,91
San Bernardino,10,2022-02-21,1901,1901,1693,208,60249,60255,53633,6622,251,82,82,78,7627,7627,7545,7545
San Diego,10,2022-02-21,4625,4625,4400,225,100589,100601,95700,4901,468,61,61,106,5219,5219,5158,5158
San Francisco,10,2022-02-21,975,975,730,245,40355,40360,30111,10249,98,11,11,24,829,829,818,818
San Joaquin,10,2022-02-21,1049,1049,888,161,23868,23871,20189,3682,91,25,25,31,2209,2209,2184,2184
San Luis Obispo,10,2022-02-21,441,441,386,55,7650,7650,6704,946,16,16,16,3,454,454,438,438
San Mateo,10,2022-02-21,695,695,624,71,42575,42579,38164,4415,47,8,8,8,691,691,683,683
Santa Barbara,10,2022-02-21,611,611,528,83,19195,19195,16577,2618,40,6,6,10,665,665,659,659
Santa Clara,10,2022-02-21,2515,2515,2385,130,120311,120325,114036,6289,224,25,25,53,2233,2233,2208,2208
Santa Cruz,10,2022-02-21,578,578,509,69,25013,25016,22017,2999,21,1,1,4,254,254,253,253
Shasta,10,2022-02-21,263,263,225,38,4976,4976,4276,700,46,9,9,10,526,526,517,517
Siskiyou,10,2022-02-21,47,47,42,5,450,450,398,52,6,4,4,1,77,77,73,73
Solano,10,2022-02-21,697,697,604,93,15143,15143,13122,2021,51,5,5,15,441,441,436,436
Sonoma,10,2022-02-21,629,629,547,82,16824,16825,14605,2220,36,2,2,8,480,480,478,478
Stanislaus,10,2022-02-21,732,732,590,142,11759,11759,9489,2270,168,29,29,30,1641,1641,1612,1612
Sutter,10,2022-02-21,121,121,105,16,2108,2108,1821,287,0,2,2,0,219,219,217,217
Tehama,10,2022-02-21,96,96,78,18,1219,1219,993,226,8,10,10,2,199,199,189,189
Trinity,10,2022-02-21,15,15,12,3,199,199,160,39,0,0,0,0,20,20,20,20
Tulare,10,2022-02-21,774,774,622,152,10926,10926,8784,2142,86,15,15,9,1448,1448,1433,1433
Tuolumne,10,2022-02-21,107,107,90,17,1784,1784,1491,293,2,6,6,2,178,178,172,172
Ventura,10,2022-02-21,886,886,802,84,27543,27547,24930,2617,107,22,22,22,1464,1464,1442,1442
Yolo,10,2022-02-21,282,282,248,34,20981,20983,18403,2580,7,6,6,3,349,349,343,343
Yuba,10,2022-02-21,135,135,118,17,1679,1679,1466,213,22,1,1,8,116,116,115,115
Alameda,11,2022-02-28,1476,1476,1349,127,78761,78770,71943,6827,113,17,17,23,1833,1833,1816,1816
Amador,11,2022-02-28,56,56,48,8,2077,2077,1796,281,7,0,0,2,84,84,84,84
Butte,11,2022-02-28,188,188,175,13,4475,4475,4156,319,45,6,6,4,422,422,416,416
Calaveras,11,2022-02-28,40,40,35,5,1254,1254,1105,149,0,3,3,0,117,117,114,114
Colusa,11,2022-02-28,10,10,9,1,406,406,364,42,5,0,0,0,21,21,21,21
Contra Costa,11,2022-02-28,936,936,807,129,35020,35025,30199,4826,56,15,15,19,1278,1278,1263,1263
Del Norte,11,2022-02-28,84,84,75,9,2876,2876,2557,319,5,3,3,2,47,47,44,44
El Dorado,11,2022-02-28,105,105,93,12,3686,3686,3252,434,5,2,2,3,207,207,205,205
Fresno,11,2022-02-28,1308,1308,1136,172,26370,26374,22913,3461,196,28,28,44,2708,2708,2680,2680
Glenn,11,2022-02-28,18,18,16,2,435,435,386,49,1,0,0,0,52,52,52,52
Humboldt,11,2022-02-28,157,157,140,17,2956,2956,2632,324,6,1,1,1,140,140,139,139
Imperial,11,2022-02-28,264,264,233,31,4783,4783,4210,573,13,6,6,10,933,933,927,927
Inyo,11,2022-02-28,10,10,9,1,379,379,341,38,0,0,0,0,56,56,56,56
Kern,11,2022-02-28,792,792,713,79,24603,24607,22154,2453,77,16,16,16,2305,2305,2289,2289
Kings,11,2022-02-28,246,246,216,30,6079,6079,5356,723,19,7,7,3,440,440,433,433
Lake,11,2022-02-28,110,110,95,15,1956,1956,1695,261,0,4,4,1,136,136,132,132
Lassen,11,2022-02-28,44,44,40,4,2097,2097,1899,198,1,2,2,0,61,61,59,59
Los Angeles,11,2022-02-28,8218,8218,7920,298,1057519,1057657,1019106,38551,753,222,222,174,31335,31335,31113,31113
Madera,11,2022-02-28,189,189,164,25,4623,4623,4012,611,20,2,2,6,368,368,366,366
Marin,11,2022-02-28,160,160,140,20,7664,7664,6681,983,13,3,3,3,292,292,289,289
Mariposa,11,2022-02-28,29,29,25,4,347,347,298,49,0,1,1,0,26,26,25,25
Mendocino,11,2022-02-28,84,84,70,14,1889,1889,1571,318,11,2,2,2,121,121,119,119
Merced,11,2022-02-28,283,283,254,29,5030,5030,4509,521,25,7,7,5,801,801,794,794
Modoc,11,2022-02-28,6,6,5,1,57,57,51,6,1,0,0,0,7,7,7,7
Mono,11,2022-02-28,5,5,4,1,169,169,136,33,0,0,0,0,6,6,6,6
Monterey,11,2022-02-28,355,355,286,69,14337,14337,11561,2776,28,9,9,5,715,715,706,706
Napa,11,2022-02-28,194,194,176,18,5594,5594,5080,514,8,3,3,2,138,138,135,135
Nevada,11,2022-02-28,70,70,61,9,2016,2016,1753,263,9,0,0,1,127,127,127,127
Orange,11,2022-02-28,1688,1688,1551,137,126368,126385,116121,10264,198,42,42,35,6998,6998,6956,6956
Placer,11,2022-02-28,248,248,213,35,8421,8421,7233,1188,65,4,4,13,612,612,608,608
Plumas,11,2022-02-28,23,23,20,3,370,370,323,47,0,0,0,0,13,13,13,13
Riverside,11,2022-02-28,1687,1687,1508,179,63264,63272,56575,6697,185,37,37,35,6381,6381,6344,6344
Sacramento,11,2022-02-28,1163,1163,1032,131,45697,45702,40520,5182,163,24,24,35,2983,2983,2959,2959
San Benito,11,2022-02-28,55,55,50,5,1809,1809,1638,171,0,0,0,1,91,91,91,91
San Bernardino,11,2022-02-28,1174,1174,1072,102,61093,61100,55780,5320,157,60,60,45,7687,7687,7627,7627
San Diego,11,2022-02-28,3034,3034,2918,116,100026,100040,96236,3804,341,37,37,83,5256,5256,5219,5219
San Francisco,11,2022-02-28,836,836,662,174,40065,40070,31745,8325,74,16,16,19,845,845,829,829
San Joaquin,11,2022-02-28,657,657,576,81,26111,26114,22888,3226,58,11,11,24,2220,2220,2209,2209
San Luis Obispo,11,2022-02-28,378,378,341,37,8504,8504,7672,832,9,5,5,2,459,459,454,454
San Mateo,11,2022-02-28,597,597,549,48,41439,41444,38090,3354,33,4,4,7,695,695,691,691
Santa Barbara,11,2022-02-28,369,369,329,40,21385,21387,19065,2322,36,5,5,10,670,670,665,665
Santa Clara,11,2022-02-28,1730,1730,1660,70,103090,103105,98985,4120,191,22,22,46,2255,2255,2233,2233
Santa Cruz,11,2022-02-28,460,460,416,44,27974,27978,25347,2631,20,2,2,4,256,256,254,254
Shasta,11,2022-02-28,167,167,148,19,4926,4926,4373,553,36,11,11,8,537,537,526,526
Siskiyou,11,2022-02-28,25,25,23,2,475,475,432,43,4,2,2,1,79,79,77,77
Solano,11,2022-02-28,476,476,425,51,15357,15357,13725,1632,47,3,3,17,444,444,441,441
Sonoma,11,2022-02-28,454,454,407,47,16951,16952,15187,1765,28,3,3,5,483,483,480,480
Stanislaus,11,2022-02-28,470,470,396,74,13361,13361,11275,2086,124,11,11,21,1652,1652,1641,1641
Sutter,11,2022-02-28,106,106,95,11,2333,2333,2079,254,0,2,2,0,221,221,219,219
Tehama,11,2022-02-28,60,60,51,9,1221,1221,1039,182,7,1,1,2,200,200,199,199
Trinity,11,2022-02-28,5,5,4,1,118,118,99,19,0,0,0,0,20,20,20,20
Tulare,11,2022-02-28,464,464,390,74,11876,11876,9990,1886,67,15,15,9,1463,1463,1448,1448
Tuolumne,11,2022-02-28,69,69,60,9,1486,1486,1291,195,6,3,3,1,181,181,178,178
Ventura,11,2022-02-28,548,548,507,41,29889,29894,27653,2241,75,10,10,11,1474,1474,1464,1464
Yolo,11,2022-02-28,207,207,187,20,26252,26257,23711,2546,4,5,5,6,354,354,349,349
Yuba,11,2022-02-28,75,75,67,8,1711,1711,1537,174,12,1,1,6,117,117,116,116
Alameda,12,2022-03-07,1094,1094,1019,75,72443,72453,67465,4988,77,12,12,16,1845,1845,1833,1833
Amador,12,2022-03-07,75,75,67,8,1428,1428,1274,154,6,2,2,1,86,86,84,84
Butte,12,2022-03-07,98,98,92,6,3638,3638,3434,204,33,4,4,3,426,426,422,422
Calaveras,12,2022-03-07,25,25,23,2,1048,1048,948,100,1,1,1,0,118,118,117,117
Colusa,12,2022-03-07,9,9,8,1,355,355,326,29,6,0,0,0,21,21,21,21
Contra Costa,12,2022-03-07,627,627,558,69,30970,30975,27550,3425,47,8,8,13,1286,1286,1278,1278
Del Norte,12,2022-03-07,50,50,46,4,1779,1779,1624,155,7,0,0,1,47,47,47,47
El Dorado,12,2022-03-07,77,77,70,7,3200,3200,2899,301,5,3,3,2,210,210,207,207
Fresno,12,2022-03-07,859,859,769,90,22260,22264,19933,2331,145,18,18,27,2726,2726,2708,2708
Glenn,12,2022-03-07,19,19,17,2,395,395,359,36,2,1,1,0,53,53,52,52
Humboldt,12,2022-03-07,81,81,74,7,3045,3045,2779,266,10,3,3,4,143,143,140,140
Imperial,12,2022-03-07,122,122,110,12,4481,4481,4054,427,16,5,5,10,938,938,933,933
Inyo,12,2022-03-07,10,10,9,1,269,269,247,22,0,0,0,0,56,56,56,56
Kern,12,2022-03-07,433,433,398,35,20833,20836,19187,1649,67,12,12,16,2317,2317,2305,2305
Kings,12,2022-03-07,201,201,182,19,4986,4986,4514,472,13,4,4,2,444,444,440,440
Lake,12,2022-03-07,64,64,57,7,1760,1760,1572,188,2,2,2,1,138,138,136,136
Lassen,12,2022-03-07,96,96,89,7,1889,1889,1748,141,0,1,1,0,62,62,61,61
Los Angeles,12,2022-03-07,5537,5537,5380,157,876264,876396,851463,24933,573,171,171,133,31506,31506,31335,31335
Madera,12,2022-03-07,133,133,119,14,3916,3916,3502,414,15,1,1,2,369,369,368,368
Marin,12,2022-03-07,154,154,138,16,7558,7558,6778,780,10,1,1,2,293,293,292,292
Mariposa,12,2022-03-07,11,11,10,1,296,296,263,33,0,1,1,0,27,27,26,26
Mendocino,12,2022-03-07,65,65,56,9,1643,1643,1418,225,6,0,0,2,121,121,121,121
Merced,12,2022-03-07,173,173,159,14,4536,4536,4161,375,17,7,7,5,808,808,801,801
Modoc,12,2022-03-07,0,0,0,0,54,54,50,4,0,0,0,0,7,7,7,7
Mono,12,2022-03-07,2,2,2,0,128,128,108,20,0,0,0,1,6,6,6,6
Monterey,12,2022-03-07,244,244,206,38,11053,11053,9324,1729,19,5,5,2,720,720,715,715
Napa,12,2022-03-07,199,199,185,14,4874,4874,4518,356,2,1,1,2,139,139,138,138
Nevada,12,2022-03-07,50,50,45,5,1750,1750,1568,182,0,2,2,0,129,129,127,127
Orange,12,2022-03-07,1254,1254,1174,80,107453,107471,100565,6906,138,29,29,28,7027,7027,6998,6998
Placer,12,2022-03-07,164,164,145,19,7797,7797,6916,881,54,3,3,11,615,615,612,612
Plumas,12,2022-03-07,7,7,6,1,266,266,239,27,0,0,0,0,13,13,13,13
Riverside,12,2022-03-07,980,980,898,82,53631,53638,49124,4514,125,26,26,30,6407,6407,6381,6381
Sacramento,12,2022-03-07,773,773,704,69,40204,40209,36588,3621,124,18,18,28,3001,3001,2983,2983
San Benito,12,2022-03-07,41,41,38,3,1525,1525,1411,114,0,2,2,1,93,93,91,91
San Bernardino,12,2022-03-07,792,792,737,55,54190,54197,50460,3737,95,43,43,38,7730,7730,7687,7687
San Diego,12,2022-03-07,2338,2338,2268,70,96665,96679,93795,2884,237,31,31,57,5287,5287,5256,5256
San Francisco,12,2022-03-07,700,700,582,118,37421,37426,31068,6358,62,5,5,11,850,850,845,845
San Joaquin,12,2022-03-07,439,439,396,43,21215,21218,19137,2081,33,9,9,19,2229,2229,2220,2220
San Luis Obispo,12,2022-03-07,245,245,226,19,7300,7300,6735,565,7,5,5,1,464,464,459,459
San Mateo,12,2022-03-07,529,529,495,34,40058,40063,37475,2588,30,2,2,3,697,697,695,695
Santa Barbara,12,2022-03-07,203,203,186,17,17714,17716,16188,1528,15,4,4,8,674,674,670,670
Santa Clara,12,2022-03-07,1467,1467,1421,46,112126,112143,108573,3570,128,13,13,38,2268,2268,2255,2255
Santa Cruz,12,2022-03-07,335,335,310,25,24974,24978,23119,1859,11,0,0,7,256,256,256,256
Shasta,12,2022-03-07,140,140,127,13,4940,4940,4498,442,24,8,8,3,545,545,537,537
Siskiyou,12,2022-03-07,12,12,11,1,399,399,370,29,2,1,1,0,80,80,79,79
Solano,12,2022-03-07,352,352,322,30,14104,14104,12909,1195,46,2,2,10,446,446,444,444
Sonoma,12,2022-03-07,321,321,294,27,14921,14922,13685,1237,26,3,3,6,486,486,483,483
Stanislaus,12,2022-03-07,276,276,241,35,10858,10858,9500,1358,94,10,10,13,1662,1662,1652,1652
Sutter,12,2022-03-07,81,81,74,7,1908,1908,1742,166,0,1,1,0,222,222,221,221
Tehama,12,2022-03-07,40,40,35,5,1115,1115,980,135,5,2,2,1,202,202,200,200
Trinity,12,2022-03-07,4,4,3,1,114,114,100,14,0,0,0,0,20,20,20,20
Tulare,12,2022-03-07,302,302,263,39,10282,10282,8974,1308,37,13,13,3,1476,1476,1463,1463
Tuolumne,12,2022-03-07,48,48,43,5,1253,1253,1122,131,2,0,0,1,181,181,181,181
Ventura,12,2022-03-07,417,417,392,25,26717,26722,25141,1581,45,4,4,11,1478,1478,1474,1474
Yolo,12,2022-03-07,160,160,148,12,22162,22167,20462,1705,3,2,2,2,356,356,354,354
Yuba,12,2022-03-07,59,59,54,5,1553,1553,1426,127,13,0,0,6,117,117,117,117
Alameda,13,2022-03-14,878,878,830,48,68949,68963,65211,3752,64,9,9,6,1854,1854,1845,1845
Amador,13,2022-03-14,32,32,29,3,1439,1439,1315,124,4,0,0,0,86,86,86,86
Butte,13,2022-03-14,82,82,78,4,3592,3592,3432,160,24,1,1,0,427,427,426,426
Calaveras,13,2022-03-14,17,17,16,1,990,990,914,76,1,1,1,1,119,119,118,118
Colusa,13,2022-03-14,4,4,4,0,257,257,240,17,4,0,0,0,21,21,21,21
Contra Costa,13,2022-03-14,567,567,517,50,29143,29148,26578,2570,19,5,5,9,1291,1291,1286,1286
Del Norte,13,2022-03-14,31,31,29,2,1415,1415,1317,98,1,2,2,1,49,49,47,47
El Dorado,13,2022-03-14,44,44,41,3,2980,2980,2757,223,4,1,1,0,211,211,210,210
Fresno,13,2022-03-14,526,526,482,44,21169,21174,19405,1769,120,10,10,20,2736,2736,2726,2726
Glenn,13,2022-03-14,11,11,10,1,342,342,318,24,1,0,0,0,53,53,53,53
Humboldt,13,2022-03-14,56,56,52,4,2651,2651,2466,185,3,1,1,2,144,144,143,143
Imperial,13,2022-03-14,74,74,68,6,4551,4551,4203,348,5,2,2,7,940,940,938,938
Inyo,13,2022-03-14,6,6,6,0,165,165,154,11,0,0,0,0,56,56,56,56
Kern,13,2022-03-14,301,301,282,19,20273,20278,19007,1271,42,14,14,12,2331,2331,2317,2317
Kings,13,2022-03-14,155,155,143,12,4695,4695,4341,354,17,1,1,2,445,445,444,444
Lake,13,2022-03-14,48,48,44,4,1570,1570,1436,134,1,1,1,0,139,139,138,138
Lassen,13,2022-03-14,5,5,5,0,1515,1515,1426,89,0,0,0,0,62,62,62,62
Los Angeles,13,2022-03-14,4059,4059,3969,90,847363,847531,828635,18896,412,115,115,91,31621,31621,31506,31506
Madera,13,2022-03-14,52,52,48,4,3575,3575,3272,303,12,0,0,2,369,369,369,369
Marin,13,2022-03-14,170,170,156,14,6532,6532,5997,535,7,1,1,0,294,294,293,293
Mariposa,13,2022-03-14,9,9,8,1,222,222,202,20,0,0,0,0,27,27,27,27
Mendocino,13,2022-03-14,35,35,31,4,1434,1434,1276,158,4,2,2,1,123,123,121,121
Merced,13,2022-03-14,134,134,125,9,4167,4167,3895,272,17,2,2,4,810,810,808,808
Modoc,13,2022-03-14,3,3,3,0,52,52,49,3,1,0,0,0,7,7,7,7
Mono,13,2022-03-14,2,2,2,0,118,118,103,15,0,0,0,0,6,6,6,6
Monterey,13,2022-03-14,156,156,136,20,10113,10114,8835,1279,14,4,4,2,724,724,720,720
Napa,13,2022-03-14,121,121,114,7,4104,4104,3867,237,6,1,1,3,140,140,139,139
Nevada,13,2022-03-14,50,50,46,4,1571,1571,1441,130,2,0,0,0,129,129,129,129
Orange,13,2022-03-14,822,822,780,42,101559,101581,96425,5156,109,31,31,31,7058,7058,7027,7027
Placer,13,2022-03-14,148,148,135,13,7319,7319,6658,661,45,3,3,5,618,618,615,615
Plumas,13,2022-03-14,4,4,4,0,317,317,291,26,0,0,0,0,13,13,13,13
Riverside,13,2022-03-14,739,739,690,49,52736,52747,49230,3517,87,15,15,16,6422,6422,6407,6407
Sacramento,13,2022-03-14,587,587,545,42,35139,35145,32621,2524,122,16,16,22,3017,3017,3001,3001
San Benito,13,2022-03-14,36,36,34,2,1462,1462,1375,87,0,0,0,1,93,93,93,93
San Bernardino,13,2022-03-14,568,568,537,31,51685,51697,48876,2821,68,26,26,32,7756,7756,7730,7730
San Diego,13,2022-03-14,1844,1844,1801,43,96065,96085,93830,2255,174,17,17,47,5304,5304,5287,5287
San Francisco,13,2022-03-14,608,608,525,83,34320,34325,29604,4721,28,7,7,7,857,857,850,850
San Joaquin,13,2022-03-14,268,268,247,21,18891,18896,17409,1487,28,7,7,11,2236,2236,2229,2229
San Luis Obispo,13,2022-03-14,162,162,152,10,6664,6664,6254,410,7,7,7,1,471,471,464,464
San Mateo,13,2022-03-14,441,441,419,22,35834,35839,34005,1834,27,0,0,3,697,697,697,697
Santa Barbara,13,2022-03-14,196,196,183,13,16859,16864,15704,1160,16,7,7,2,681,681,674,674
Santa Clara,13,2022-03-14,1177,1177,1148,29,99875,99894,97396,2498,108,13,13,28,2281,2281,2268,2268
Santa Cruz,13,2022-03-14,239,239,225,14,22176,22180,20872,1308,10,3,3,3,259,259,256,256
Shasta,13,2022-03-14,97,97,90,7,4838,4838,4492,346,16,5,5,2,550,550,545,545
Siskiyou,13,2022-03-14,9,9,8,1,370,370,349,21,0,3,3,0,83,83,80,80
Solano,13,2022-03-14,221,221,206,15,12336,12337,11506,831,34,1,1,6,447,447,446,446
Sonoma,13,2022-03-14,228,228,213,15,13400,13402,12516,886,14,1,1,4,487,487,486,486
Stanislaus,13,2022-03-14,216,216,194,22,9401,9401,8454,947,82,11,11,17,1673,1673,1662,1662
Sutter,13,2022-03-14,41,41,38,3,1815,1815,1689,126,0,0,0,0,222,222,222,222
Tehama,13,2022-03-14,17,17,15,2,981,981,886,95,2,3,3,0,205,205,202,202
Trinity,13,2022-03-14,3,3,3,0,96,96,86,10,0,0,0,0,20,20,20,20
Tulare,13,2022-03-14,174,174,156,18,9301,9301,8348,953,33,0,0,6,1476,1476,1476,1476
Tuolumne,13,2022-03-14,22,22,20,2,1246,1246,1142,104,1,0,0,0,181,181,181,181
Ventura,13,2022-03-14,326,326,311,15,24591,24596,23445,1151,37,6,6,7,1484,1484,1478,1478
Yolo,13,2022-03-14,118,118,111,7,21627,21632,20313,1319,1,3,3,2,359,359,356,356
Yuba,13,2022-03-14,35,35,33,2,1417,1417,1325,92,10,0,0,3,117,117,117,117
Alameda,14,2022-03-21,722,722,691,31,65825,65842,63009,2833,58,7,7,3,1861,1861,1854,1854
Amador,14,2022-03-21,29,29,27,2,1356,1356,1263,93,2,0,0,0,86,86,86,86
Butte,14,2022-03-21,81,81,78,3,3158,3158,3048,110,17,0,0,2,427,427,427,427
Calaveras,14,2022-03-21,8,8,8,0,657,657,618,39,0,0,0,0,119,119,119,119
Colusa,14,2022-03-21,3,3,3,0,231,231,219,12,2,0,0,0,21,21,21,21
Contra Costa,14,2022-03-21,466,466,434,32,26932,26937,25044,1893,27,7,7,9,1298,1298,1291,1291
Del Norte,14,2022-03-21,19,19,18,1,1192,1192,1127,65,0,0,0,0,49,49,49,49
El Dorado,14,2022-03-21,46,46,43,3,2813,2813,2647,166,1,2,2,0,213,213,211,211
Fresno,14,2022-03-21,346,346,323,23,19379,19384,18098,1286,97,11,11,12,2747,2747,2736,2736
Glenn,14,2022-03-21,7,7,7,0,366,366,345,21,1,0,0,0,53,53,53,53
Humboldt,14,2022-03-21,31,31,29,2,2456,2456,2322,134,5,1,1,2,145,145,144,144
Imperial,14,2022-03-21,58,58,54,4,3965,3965,3727,238,4,3,3,4,943,943,940,940
Inyo,14,2022-03-21,1,1,1,0,148,148,140,8,0,0,0,0,56,56,56,56
Kern,14,2022-03-21,206,206,196,10,19490,19495,18529,966,34,4,4,9,2335,2335,2331,2331
Kings,14,2022-03-21,79,79,74,5,4411,4411,4147,264,7,1,1,1,446,446,445,445
Lake,14,2022-03-21,18,18,17,1,1365,1365,1272,93,0,0,0,0,139,139,139,139
Lassen,14,2022-03-21,10,10,10,0,1388,1388,1323,65,0,0,0,0,62,62,62,62
Los Angeles,14,2022-03-21,4130,4130,4059,71,823366,823570,809185,14385,338,76,76,66,31697,31697,31621,31621
Madera,14,2022-03-21,40,40,37,3,3392,3392,3164,228,9,1,1,1,370,370,369,369
Marin,14,2022-03-21,133,133,124,9,6231,6231,5825,406,6,1,1,0,295,295,294,294
Mariposa,14,2022-03-21,7,7,6,1,236,236,219,17,0,0,0,0,27,27,27,27
Mendocino,14,2022-03-21,28,28,26,2,1508,1508,1376,132,4,0,0,1,123,123,123,123
Merced,14,2022-03-21,87,87,82,5,3771,3771,3576,195,13,5,5,1,815,815,810,810
Modoc,14,2022-03-21,2,2,2,0,60,60,57,3,0,0,0,0,7,7,7,7
Mono,14,2022-03-21,4,4,4,0,134,134,120,14,1,0,0,0,6,6,6,6
Monterey,14,2022-03-21,152,152,137,15,10087,10089,9064,1025,22,0,0,1,724,724,724,724
Napa,14,2022-03-21,54,54,52,2,3451,3451,3294,157,6,1,1,2,141,141,140,140
Nevada,14,2022-03-21,18,18,17,1,1528,1528,1428,100,2,0,0,0,129,129,129,129
Orange,14,2022-03-21,757,757,727,30,96133,96157,92304,3853,100,12,12,25,7070,7070,7058,7058
Placer,14,2022-03-21,112,112,104,8,6475,6475,6010,465,40,2,2,6,620,620,618,618
Plumas,14,2022-03-21,2,2,2,0,228,228,213,15,0,0,0,0,13,13,13,13
Riverside,14,2022-03-21,616,616,583,33,51895,51907,49150,2757,69,13,13,18,6435,6435,6422,6422
Sacramento,14,2022-03-21,462,462,436,26,32986,32993,31121,1872,89,13,13,13,3030,3030,3017,3017
San Benito,14,2022-03-21,19,19,18,1,1385,1385,1320,65,0,1,1,0,94,94,93,93
San Bernardino,14,2022-03-21,473,473,453,20,49316,49328,47196,2132,49,20,20,31,7776,7776,7756,7756
San Diego,14,2022-03-21,1372,1372,1347,25,84591,84612,83056,1556,146,15,15,39,5319,5319,5304,5304
San Francisco,14,2022-03-21,687,687,612,75,33568,33576,29863,3713,34,3,3,3,860,860,857,857
San Joaquin,14,2022-03-21,221,221,207,14,15687,15691,14719,972,23,6,6,6,2242,2242,2236,2236
San Luis Obispo,14,2022-03-21,107,107,102,5,6416,6416,6103,313,3,5,5,0,476,476,471,471
San Mateo,14,2022-03-21,369,369,354,15,34927,34935,33530,1405,30,1,1,1,698,698,697,697
Santa Barbara,14,2022-03-21,160,160,151,9,14296,14300,13511,789,17,5,5,4,686,686,681,681
Santa Clara,14,2022-03-21,1099,1099,1078,21,95231,95254,93388,1866,101,5,5,20,2286,2286,2281,2281
Santa Cruz,14,2022-03-21,184,184,175,9,20037,20042,19106,936,8,0,0,3,259,259,259,259
Shasta,14,2022-03-21,41,41,39,2,4136,4136,3902,234,10,6,6,2,556,556,550,550
Siskiyou,14,2022-03-21,9,9,9,0,370,370,353,17,1,0,0,0,83,83,83,83
Solano,14,2022-03-21,187,187,177,10,11782,11784,11158,626,17,1,1,5,448,448,447,447
Sonoma,14,2022-03-21,229,229,217,12,12377,12379,11727,652,15,2,2,2,489,489,487,487
Stanislaus,14,2022-03-21,142,142,131,11,8428,8428,7752,676,59,12,12,8,1685,1685,1673,1673
Sutter,14,2022-03-21,34,34,32,2,1478,1478,1398,80,0,1,1,0,223,223,222,222
Tehama,14,2022-03-21,10,10,9,1,926,926,854,72,2,0,0,0,205,205,205,205
Trinity,14,2022-03-21,0,0,0,0,111,111,102,9,0,0,0,0,20,20,20,20
Tulare,14,2022-03-21,108,108,99,9,8166,8166,7499,667,27,5,5,4,1481,1481,1476,1476
Tuolumne,14,2022-03-21,19,19,18,1,1131,1131,1055,76,2,0,0,0,181,181,181,181
Ventura,14,2022-03-21,289,289,278,11,23283,23288,22428,860,30,5,5,6,1489,1489,1484,1484
Yolo,14,2022-03-21,107,107,102,5,21433,21438,20399,1039,1,0,0,1,359,359,359,359
Yuba,14,2022-03-21,42,42,40,2,1318,1318,1251,67,8,0,0,2,117,117,117,117
Alameda,15,2022-03-28,926,926,895,31,59262,59282,57283,1999,35,4,4,5,1865,1865,1861,1861
Amador,15,2022-03-28,8,8,8,0,1376,1376,1301,75,3,0,0,0,86,86,86,86
Butte,15,2022-03-28,64,64,62,2,2854,2854,2776,78,11,0,0,1,427,427,427,427
Calaveras,15,2022-03-28,15,15,14,1,580,580,553,27,0,0,0,0,119,119,119,119
Colusa,15,2022-03-28,4,4,4,0,207,207,199,8,0,0,0,0,21,21,21,21
Contra Costa,15,2022-03-28,534,534,505,29,24910,24919,23537,1382,29,1,1,6,1299,1299,1298,1298
Del Norte,15,2022-03-28,16,16,15,1,1038,1038,993,45,1,0,0,0,49,49,49,49
El Dorado,15,2022-03-28,60,60,57,3,2810,2810,2679,131,0,0,0,0,213,213,213,213
Fresno,15,2022-03-28,275,275,261,14,17945,17950,17008,942,71,5,5,18,2752,2752,2747,2747
Glenn,15,2022-03-28,8,8,8,0,333,333,318,15,0,0,0,0,53,53,53,53
Humboldt,15,2022-03-28,27,27,26,1,2608,2608,2495,113,4,0,0,3,145,145,145,145
Imperial,15,2022-03-28,62,62,59,3,3535,3535,3367,168,4,1,1,3,944,944,943,943
Inyo,15,2022-03-28,4,4,4,0,186,186,178,8,1,0,0,0,56,56,56,56
Kern,15,2022-03-28,144,144,138,6,18179,18185,17475,710,17,4,4,8,2339,2339,2335,2335
Kings,15,2022-03-28,57,57,54,3,4275,4275,4073,202,6,2,2,0,448,448,446,446
Lake,15,2022-03-28,10,10,9,1,1068,1068,1010,58,0,0,0,0,139,139,139,139
Lassen,15,2022-03-28,4,4,4,0,1284,1284,1236,48,0,0,0,0,62,62,62,62
Los Angeles,15,2022-03-28,4474,4474,4413,61,704214,704433,694698,9735,264,53,53,57,31750,31750,31697,31697
Madera,15,2022-03-28,24,24,23,1,3451,3451,3268,183,4,0,0,2,370,370,370,370
Marin,15,2022-03-28,180,180,171,9,6000,6000,5692,308,3,0,0,0,295,295,295,295
Mariposa,15,2022-03-28,5,5,5,0,179,179,169,10,0,1,1,0,28,28,27,27
Mendocino,15,2022-03-28,31,31,29,2,1314,1314,1223,91,0,1,1,0,124,124,123,123
Merced,15,2022-03-28,64,64,61,3,3359,3359,3223,136,5,1,1,3,816,816,815,815
Modoc,15,2022-03-28,3,3,3,0,45,45,43,2,0,0,0,0,7,7,7,7
Mono,15,2022-03-28,1,1,1,0,134,134,123,11,0,0,0,0,6,6,6,6
Monterey,15,2022-03-28,148,148,136,12,8782,8784,8071,713,14,1,1,0,725,725,724,724
Napa,15,2022-03-28,68,68,66,2,3329,3329,3210,119,1,2,2,1,143,143,141,141
Nevada,15,2022-03-28,27,27,26,1,1431,1431,1357,74,1,1,1,0,130,130,129,129
Orange,15,2022-03-28,809,809,784,25,90210,90238,87401,2837,81,12,12,17,7082,7082,7070,7070
Placer,15,2022-03-28,107,107,101,6,6222,6223,5871,352,26,4,4,6,624,624,620,620
Plumas,15,2022-03-28,3,3,3,0,267,267,253,14,0,0,0,0,13,13,13,13
Riverside,15,2022-03-28,522,522,500,22,43927,43940,42108,1832,47,7,7,10,6442,6442,6435,6435
Sacramento,15,2022-03-28,457,457,437,20,32473,32485,31035,1450,68,6,6,19,3036,3036,3030,3030
San Benito,15,2022-03-28,14,14,13,1,1365,1365,1315,50,0,0,0,0,94,94,94,94
San Bernardino,15,2022-03-28,545,545,527,18,41307,41320,39922,1398,40,18,18,24,7794,7794,7776,7776
San Diego,15,2022-03-28,1325,1325,1306,19,72132,72155,71119,1036,114,9,9,26,5328,5328,5319,5319
San Francisco,15,2022-03-28,844,844,770,74,32805,32817,29921,2896,23,5,5,5,865,865,860,860
San Joaquin,15,2022-03-28,189,189,180,9,17504,17510,16655,855,20,4,4,4,2246,2246,2242,2242
San Luis Obispo,15,2022-03-28,96,96,92,4,5701,5702,5485,217,5,1,1,1,477,477,476,476
San Mateo,15,2022-03-28,582,582,564,18,33959,33970,32895,1075,26,3,3,3,701,701,698,698
Santa Barbara,15,2022-03-28,135,135,129,6,10222,10223,9792,431,15,1,1,4,687,687,686,686
Santa Clara,15,2022-03-28,1276,1276,1257,19,95190,95219,93766,1453,88,10,10,18,2296,2296,2286,2286
Santa Cruz,15,2022-03-28,145,145,140,5,19692,19697,18980,717,3,0,0,2,259,259,259,259
Shasta,15,2022-03-28,34,34,32,2,3879,3879,3706,173,7,2,2,3,558,558,556,556
Siskiyou,15,2022-03-28,5,5,5,0,292,292,282,10,0,0,0,0,83,83,83,83
Solano,15,2022-03-28,169,169,162,7,10957,10961,10503,458,18,0,0,6,448,448,448,448
Sonoma,15,2022-03-28,260,260,250,10,8553,8554,8207,347,13,0,0,1,489,489,489,489
Stanislaus,15,2022-03-28,119,119,111,8,8184,8185,7666,519,28,2,2,3,1687,1687,1685,1685
Sutter,15,2022-03-28,25,25,24,1,1490,1490,1426,64,0,1,1,0,224,224,223,223
Tehama,15,2022-03-28,13,13,12,1,798,798,749,49,3,1,1,0,206,206,205,205
Trinity,15,2022-03-28,0,0,0,0,79,79,74,5,0,0,0,0,20,20,20,20
Tulare,15,2022-03-28,81,81,76,5,7838,7839,7332,507,20,6,6,1,1487,1487,1481,1481
Tuolumne,15,2022-03-28,7,7,7,0,1083,1083,1026,57,3,1,1,0,182,182,181,181
Ventura,15,2022-03-28,335,335,325,10,21204,21210,20596,614,23,6,6,3,1495,1495,1489,1489
Yolo,15,2022-03-28,103,103,99,4,20514,20521,19758,763,3,2,2,0,361,361,359,359
Yuba,15,2022-03-28,26,26,25,1,1214,1214,1165,49,2,2,2,1,119,119,117,117
Alameda,16,2022-04-04,1055,1055,1028,27,56224,56247,54752,1495,40,3,3,3,1868,1868,1865,1865
Amador,16,2022-04-04,2,2,2,0,1107,1107,1060,47,1,0,0,0,86,86,86,86
Butte,16,2022-04-04,44,44,43,1,2582,2582,2526,56,8,2,2,1,429,429,427,427
Calaveras,16,2022-04-04,8,8,8,0,589,589,567,22,0,0,0,0,119,119,119,119
Colusa,16,2022-04-04,2,2,2,0,202,202,196,6,0,0,0,0,21,21,21,21
Contra Costa,16,2022-04-04,544,544,520,24,23559,23571,22535,1036,13,1,1,4,1300,1300,1299,1299
Del Norte,16,2022-04-04,8,8,8,0,1118,1118,1080,38,0,0,0,1,49,49,49,49
El Dorado,16,2022-04-04,50,50,48,2,2717,2717,2617,100,0,1,1,1,214,214,213,213
Fresno,16,2022-04-04,188,188,180,8,16848,16855,16159,696,62,4,4,12,2756,2756,2752,2752
Glenn,16,2022-04-04,3,3,3,0,287,287,277,10,0,0,0,0,53,53,53,53
Humboldt,16,2022-04-04,23,23,22,1,2385,2385,2303,82,5,0,0,2,145,145,145,145
Imperial,16,2022-04-04,39,39,37,2,3451,3451,3322,129,3,0,0,2,944,944,944,944
Inyo,16,2022-04-04,9,9,9,0,182,182,176,6,0,0,0,0,56,56,56,56
Kern,16,2022-04-04,152,152,147,5,16751,16757,16242,515,16,2,2,7,2341,2341,2339,2339
Kings,16,2022-04-04,47,47,45,2,4178,4178,4022,156,2,0,0,1,448,448,448,448
Lake,16,2022-04-04,14,14,13,1,973,973,931,42,0,0,0,0,139,139,139,139
Lassen,16,2022-04-04,5,5,5,0,1284,1284,1247,37,0,0,0,0,62,62,62,62
Los Angeles,16,2022-04-04,5461,5462,5405,57,804182,804523,795903,8620,255,47,47,42,31797,31797,31750,31750
Madera,16,2022-04-04,27,27,26,1,3190,3190,3057,133,3,0,0,1,370,370,370,370
Marin,16,2022-04-04,167,167,160,7,6346,6347,6089,258,3,0,0,1,295,295,295,295
Mariposa,16,2022-04-04,7,7,7,0,235,235,225,10,0,0,0,0,28,28,28,28
Mendocino,16,2022-04-04,25,25,24,1,1196,1196,1130,66,2,0,0,0,124,124,124,124
Merced,16,2022-04-04,58,58,56,2,3350,3350,3243,107,2,2,2,0,818,818,816,816
Modoc,16,2022-04-04,4,4,4,0,43,43,42,1,0,0,0,0,7,7,7,7
Mono,16,2022-04-04,1,1,1,0,142,142,133,9,0,0,0,0,6,6,6,6
Monterey,16,2022-04-04,128,128,120,8,7487,7489,7009,480,8,3,3,0,728,728,725,725
Napa,16,2022-04-04,75,75,73,2,3146,3146,3058,88,1,0,0,1,143,143,143,143
Nevada,16,2022-04-04,30,30,29,1,1447,1447,1388,59,1,1,1,0,131,131,130,130
Orange,16,2022-04-04,989,989,965,24,81527,81561,79528,2033,56,17,17,14,7099,7099,7082,7082
Placer,16,2022-04-04,129,129,123,6,6693,6694,6395,299,19,1,1,5,625,625,624,624
Plumas,16,2022-04-04,4,4,4,0,235,235,225,10,0,0,0,0,13,13,13,13
Riverside,16,2022-04-04,692,692,670,22,38908,38926,37652,1274,36,5,5,8,6447,6447,6442,6442
Sacramento,16,2022-04-04,430,430,415,15,32890,32904,31748,1156,50,8,8,11,3044,3044,3036,3036
San Benito,16,2022-04-04,13,13,13,0,1187,1187,1153,34,0,0,0,0,94,94,94,94
San Bernardino,16,2022-04-04,613,613,597,16,42053,42071,40953,1118,32,11,11,13,7805,7805,7794,7794
San Diego,16,2022-04-04,1548,1548,1531,17,66684,66713,65969,744,88,7,7,29,5335,5335,5328,5328
San Francisco,16,2022-04-04,1001,1001,932,69,28766,28779,26769,2010,20,1,1,3,866,866,865,865
San Joaquin,16,2022-04-04,229,229,220,9,15715,15721,15116,605,9,2,2,8,2248,2248,2246,2246
San Luis Obispo,16,2022-04-04,99,99,96,3,5382,5383,5221,162,2,1,1,1,478,478,477,477
San Mateo,16,2022-04-04,725,725,707,18,29369,29382,28656,726,14,2,2,1,703,703,701,701
Santa Barbara,16,2022-04-04,187,187,181,6,15277,15282,14765,517,7,2,2,1,689,689,687,687
Santa Clara,16,2022-04-04,1492,1492,1474,18,88302,88340,87281,1059,89,2,2,18,2298,2298,2296,2296
Santa Cruz,16,2022-04-04,210,210,204,6,16701,16708,16218,490,4,0,0,2,259,259,259,259
Shasta,16,2022-04-04,29,29,28,1,3320,3320,3203,117,4,1,1,2,559,559,558,558
Siskiyou,16,2022-04-04,2,2,2,0,294,294,286,8,0,0,0,0,83,83,83,83
Solano,16,2022-04-04,173,173,167,6,10251,10256,9919,337,21,1,1,4,449,449,448,448
Sonoma,16,2022-04-04,330,330,320,10,10655,10660,10316,344,9,1,1,1,490,490,489,489
Stanislaus,16,2022-04-04,113,113,107,6,7960,7962,7564,398,21,3,3,5,1690,1690,1687,1687
Sutter,16,2022-04-04,24,24,23,1,1324,1324,1280,44,0,0,0,0,224,224,224,224
Tehama,16,2022-04-04,6,6,6,0,765,765,728,37,0,1,1,0,207,207,206,206
Trinity,16,2022-04-04,1,1,1,0,87,87,83,4,0,0,0,0,20,20,20,20
Tulare,16,2022-04-04,48,48,46,2,7740,7744,7348,396,13,3,3,0,1490,1490,1487,1487
Tuolumne,16,2022-04-04,10,10,10,0,1034,1034,991,43,1,1,1,0,183,183,182,182
Ventura,16,2022-04-04,298,298,291,7,20329,20336,19872,464,19,5,5,5,1500,1500,1495,1495
Yolo,16,2022-04-04,104,104,101,3,26257,26269,25482,787,0,0,0,0,361,361,361,361
Yuba,16,2022-04-04,11,11,11,0,1071,1071,1037,34,4,0,0,1,119,119,119,119
Alameda,17,2022-04-11,1494,1494,1464,30,49841,49866,48836,1030,51,6,6,2,1874,1874,1868,1868
Amador,17,2022-04-11,9,9,9,0,1068,1068,1032,36,1,0,0,0,86,86,86,86
Butte,17,2022-04-11,33,33,32,1,2262,2262,2224,38,3,0,0,1,429,429,429,429
Calaveras,17,2022-04-11,14,14,14,0,649,649,630,19,0,0,0,0,119,119,119,119
Colusa,17,2022-04-11,6,6,6,0,203,203,198,5,0,0,0,0,21,21,21,21
Contra Costa,17,2022-04-11,713,713,689,24,20840,20853,20143,710,15,1,1,5,1301,1301,1300,1300
Del Norte,17,2022-04-11,9,9,9,0,1012,1012,985,27,0,0,0,0,49,49,49,49
El Dorado,17,2022-04-11,48,48,47,1,2508,2508,2436,72,1,0,0,0,214,214,214,214
Fresno,17,2022-04-11,195,195,189,6,15778,15786,15272,514,54,3,3,6,2759,2759,2756,2756
Glenn,17,2022-04-11,2,2,2,0,258,258,251,7,0,0,0,0,53,53,53,53
Humboldt,17,2022-04-11,46,46,45,1,2347,2347,2284,63,5,1,1,2,146,146,145,145
Imperial,17,2022-04-11,28,28,27,1,3448,3448,3347,101,2,1,1,1,945,945,944,944
Inyo,17,2022-04-11,4,4,4,0,188,188,183,5,0,0,0,0,56,56,56,56
Kern,17,2022-04-11,135,135,132,3,16366,16374,15976,398,20,2,2,6,2343,2343,2341,2341
Kings,17,2022-04-11,31,31,30,1,4161,4161,4039,122,3,0,0,0,448,448,448,448
Lake,17,2022-04-11,22,22,21,1,869,869,840,29,0,0,0,0,139,139,139,139
Lassen,17,2022-04-11,1,1,1,0,1292,1292,1263,29,1,0,0,0,62,62,62,62
Los Angeles,17,2022-04-11,6736,6740,6685,55,676191,676542,670829,5713,234,46,46,36,31843,31843,31797,31797
Madera,17,2022-04-11,29,29,28,1,3076,3076,2975,101,4,0,0,2,370,370,370,370
Marin,17,2022-04-11,214,214,207,7,5555,5556,5380,176,6,0,0,1,295,295,295,295
Mariposa,17,2022-04-11,7,7,7,0,246,246,237,9,0,0,0,0,28,28,28,28
Mendocino,17,2022-04-11,32,32,31,1,1158,1158,1108,50,0,0,0,0,124,124,124,124
Merced,17,2022-04-11,69,69,67,2,3221,3221,3140,81,6,2,2,0,820,820,818,818
Modoc,17,2022-04-11,0,0,0,0,40,40,39,1,0,0,0,0,7,7,7,7
Mono,17,2022-04-11,9,9,9,0,170,170,161,9,0,0,0,0,6,6,6,6
Monterey,17,2022-04-11,109,109,103,6,6890,6895,6545,350,9,2,2,0,730,730,728,728
Napa,17,2022-04-11,120,120,117,3,2802,2802,2740,62,1,0,0,0,143,143,143,143
Nevada,17,2022-04-11,45,45,44,1,1431,1431,1385,46,2,0,0,0,131,131,131,131
Orange,17,2022-04-11,1165,1165,1143,22,62009,62042,60863,1179,70,9,9,16,7108,7108,7099,7099
Placer,17,2022-04-11,126,126,122,4,5632,5633,5434,199,18,2,2,2,627,627,625,625
Plumas,17,2022-04-11,7,7,7,0,247,247,239,8,0,0,0,0,13,13,13,13
Riverside,17,2022-04-11,728,728,710,18,37776,37796,36826,970,35,5,5,9,6452,6452,6447,6447
Sacramento,17,2022-04-11,508,508,494,14,30138,30154,29320,834,47,11,11,5,3055,3055,3044,3044
San Benito,17,2022-04-11,16,16,16,0,1182,1182,1155,27,0,0,0,0,94,94,94,94
San Bernardino,17,2022-04-11,914,914,895,19,42011,42034,41158,876,33,5,5,7,7810,7810,7805,7805
San Diego,17,2022-04-11,1831,1831,1815,16,74105,74144,73495,649,91,4,4,22,5339,5339,5335,5335
San Francisco,17,2022-04-11,1182,1182,1117,65,29897,29913,28256,1657,19,6,6,4,872,872,866,866
San Joaquin,17,2022-04-11,221,221,214,7,15242,15249,14787,462,10,0,0,1,2248,2248,2248,2248
San Luis Obispo,17,2022-04-11,120,120,117,3,4908,4909,4793,116,2,1,1,0,479,479,478,478
San Mateo,17,2022-04-11,858,858,842,16,30381,30397,29806,591,8,2,2,1,705,705,703,703
Santa Barbara,17,2022-04-11,303,303,295,8,15120,15127,14725,402,6,2,2,1,691,691,689,689
Santa Clara,17,2022-04-11,1662,1662,1647,15,81519,81562,80802,760,61,4,4,13,2302,2302,2298,2298
Santa Cruz,17,2022-04-11,328,328,321,7,10999,11006,10765,241,7,1,1,0,260,260,259,259
Shasta,17,2022-04-11,18,18,18,0,3123,3123,3036,87,2,1,1,1,560,560,559,559
Siskiyou,17,2022-04-11,1,1,1,0,340,340,332,8,0,0,0,0,83,83,83,83
Solano,17,2022-04-11,249,249,243,6,9441,9446,9202,244,16,0,0,1,449,449,449,449
Sonoma,17,2022-04-11,416,416,406,10,10688,10693,10422,271,8,1,1,0,491,491,490,490
Stanislaus,17,2022-04-11,124,124,119,5,7639,7643,7342,301,22,1,1,1,1691,1691,1690,1690
Sutter,17,2022-04-11,20,20,19,1,1237,1237,1204,33,0,1,1,0,225,225,224,224
Tehama,17,2022-04-11,9,9,9,0,753,753,724,29,1,0,0,0,207,207,207,207
Trinity,17,2022-04-11,0,0,0,0,77,77,74,3,0,0,0,0,20,20,20,20
Tulare,17,2022-04-11,58,58,56,2,7839,7844,7527,317,11,3,3,0,1493,1493,1490,1490
Tuolumne,17,2022-04-11,22,22,21,1,1062,1062,1027,35,1,0,0,0,183,183,183,183
Ventura,17,2022-04-11,323,323,317,6,17587,17596,17283,313,16,2,2,2,1502,1502,1500,1500
Yolo,17,2022-04-11,130,130,127,3,18081,18092,17672,420,1,0,0,0,361,361,361,361
Yuba,17,2022-04-11,15,15,15,0,1019,1019,994,25,2,0,0,0,119,119,119,119
Alameda,18,2022-04-18,1780,1780,1751,29,54179,54211,53329,882,42,4,4,4,1878,1878,1874,1874
Amador,18,2022-04-18,12,12,12,0,1194,1194,1162,32,2,0,0,0,86,86,86,86
Butte,18,2022-04-18,47,47,46,1,2268,2268,2238,30,5,2,2,0,431,431,429,429
Calaveras,18,2022-04-18,16,16,16,0,579,579,566,13,0,1,1,0,120,120,119,119
Colusa,18,2022-04-18,3,3,3,0,157,157,154,3,0,0,0,0,21,21,21,21
Contra Costa,18,2022-04-18,1050,1050,1022,28,24754,24769,24100,669,26,1,1,5,1302,1302,1301,1301
Del Norte,18,2022-04-18,14,14,14,0,1010,1010,989,21,0,0,0,0,49,49,49,49
El Dorado,18,2022-04-18,66,66,65,1,2455,2455,2400,55,0,0,0,0,214,214,214,214
Fresno,18,2022-04-18,247,247,241,6,13938,13946,13593,353,42,4,4,5,2763,2763,2759,2759
Glenn,18,2022-04-18,4,4,4,0,278,278,272,6,0,0,0,0,53,53,53,53
Humboldt,18,2022-04-18,107,107,105,2,2052,2052,2009,43,4,1,1,2,147,147,146,146
Imperial,18,2022-04-18,49,49,48,1,3219,3219,3145,74,2,0,0,1,945,945,945,945
Inyo,18,2022-04-18,2,2,2,0,164,164,161,3,0,0,0,0,56,56,56,56
Kern,18,2022-04-18,150,150,147,3,13634,13642,13385,257,9,1,1,5,2344,2344,2343,2343
Kings,18,2022-04-18,44,44,43,1,3580,3581,3499,82,3,1,1,1,449,449,448,448
Lake,18,2022-04-18,16,16,16,0,782,782,762,20,2,1,1,1,140,140,139,139
Lassen,18,2022-04-18,1,1,1,0,1340,1340,1316,24,0,0,0,0,62,62,62,62
Los Angeles,18,2022-04-18,8316,8321,8268,53,469809,470099,467122,2977,200,35,35,26,31878,31878,31843,31843
Madera,18,2022-04-18,23,23,22,1,2521,2521,2456,65,2,0,0,2,370,370,370,370
Marin,18,2022-04-18,322,322,314,8,5992,5997,5846,151,6,0,0,0,295,295,295,295
Mariposa,18,2022-04-18,18,18,18,0,248,248,241,7,0,0,0,0,28,28,28,28
Mendocino,18,2022-04-18,53,53,51,2,1285,1285,1241,44,0,1,1,0,125,125,124,124
Merced,18,2022-04-18,65,65,64,1,3047,3047,2987,60,3,2,2,0,822,822,820,820
Modoc,18,2022-04-18,1,1,1,0,40,40,39,1,0,0,0,0,7,7,7,7
Mono,18,2022-04-18,9,9,9,0,122,122,117,5,0,0,0,0,6,6,6,6
Monterey,18,2022-04-18,157,157,151,6,6522,6527,6268,259,2,1,1,0,731,731,730,730
Napa,18,2022-04-18,164,164,161,3,2860,2860,2811,49,1,0,0,0,143,143,143,143
Nevada,18,2022-04-18,41,41,40,1,1260,1260,1228,32,1,0,0,0,131,131,131,131
Orange,18,2022-04-18,1443,1443,1422,21,79760,79809,78600,1209,50,5,5,10,7113,7113,7108,7108
Placer,18,2022-04-18,161,161,157,4,4800,4801,4669,132,30,0,0,3,627,627,627,627
Plumas,18,2022-04-18,6,6,6,0,225,225,219,6,0,0,0,0,13,13,13,13
Riverside,18,2022-04-18,937,937,918,19,36721,36743,36002,741,36,7,7,7,6459,6459,6452,6452
Sacramento,18,2022-04-18,715,715,700,15,27855,27872,27271,601,47,9,9,8,3064,3064,3055,3055
San Benito,18,2022-04-18,24,24,24,0,1170,1170,1149,21,0,0,0,0,94,94,94,94
San Bernardino,18,2022-04-18,1058,1058,1041,17,40085,40109,39455,654,35,7,7,8,7817,7817,7810,7810
San Diego,18,2022-04-18,2047,2047,2033,14,67089,67130,66671,459,78,9,9,17,5348,5348,5339,5339
San Francisco,18,2022-04-18,1440,1440,1378,62,30566,30584,29246,1338,27,2,2,2,874,874,872,872
San Joaquin,18,2022-04-18,248,248,242,6,14745,14753,14402,351,8,1,1,4,2249,2249,2248,2248
San Luis Obispo,18,2022-04-18,180,180,177,3,4959,4961,4869,92,2,2,2,0,481,481,479,479
San Mateo,18,2022-04-18,1153,1153,1136,17,30636,30655,30191,464,15,2,2,2,707,707,705,705
Santa Barbara,18,2022-04-18,299,299,293,6,14686,14695,14389,306,8,0,0,0,691,691,691,691
Santa Clara,18,2022-04-18,2238,2238,2222,16,71271,71313,70792,521,67,4,4,16,2306,2306,2302,2302
Santa Cruz,18,2022-04-18,438,438,430,8,12234,12242,12027,215,3,0,0,1,260,260,260,260
Shasta,18,2022-04-18,32,32,31,1,2849,2849,2787,62,2,1,1,2,561,561,560,560
Siskiyou,18,2022-04-18,8,8,8,0,318,318,312,6,0,0,0,0,83,83,83,83
Solano,18,2022-04-18,254,254,249,5,9338,9343,9154,189,6,1,1,1,450,450,449,449
Sonoma,18,2022-04-18,502,502,492,10,11184,11190,10967,223,16,1,1,4,492,492,491,491
Stanislaus,18,2022-04-18,161,161,156,5,7667,7672,7433,239,15,0,0,3,1691,1691,1691,1691
Sutter,18,2022-04-18,24,24,24,0,1173,1173,1149,24,0,0,0,0,225,225,225,225
Tehama,18,2022-04-18,7,7,7,0,685,685,664,21,1,0,0,0,207,207,207,207
Trinity,18,2022-04-18,1,1,1,0,72,72,70,2,0,0,0,0,20,20,20,20
Tulare,18,2022-04-18,77,77,75,2,6660,6665,6454,211,13,0,0,0,1493,1493,1493,1493
Tuolumne,18,2022-04-18,26,26,25,1,1025,1025,999,26,1,0,0,0,183,183,183,183
Ventura,18,2022-04-18,367,367,362,5,16412,16423,16195,228,8,3,3,0,1505,1505,1502,1502
Yolo,18,2022-04-18,217,217,213,4,17921,17932,17603,329,2,1,1,0,362,362,361,361
Yuba,18,2022-04-18,28,28,27,1,996,996,977,19,1,0,0,1,119,119,119,119
Alameda,19,2022-04-25,2538,2538,2506,32,60892,60934,60166,768,44,6,6,4,1884,1884,1878,1878
Amador,19,2022-04-25,26,26,25,1,1316,1316,1289,27,0,0,0,0,86,86,86,86
Butte,19,2022-04-25,66,66,65,1,2597,2597,2570,27,5,1,1,1,432,432,431,431
Calaveras,19,2022-04-25,34,34,33,1,688,688,676,12,0,0,0,0,120,120,120,120
Colusa,19,2022-04-25,3,3,3,0,199,199,196,3,0,0,0,0,21,21,21,21
Contra Costa,19,2022-04-25,1508,1508,1476,32,27266,27285,26710,575,25,3,3,3,1305,1305,1302,1302
Del Norte,19,2022-04-25,25,25,25,0,1104,1104,1086,18,0,0,0,0,49,49,49,49
El Dorado,19,2022-04-25,103,103,101,2,2648,2648,2601,47,1,0,0,0,214,214,214,214
Fresno,19,2022-04-25,335,335,328,7,15894,15906,15589,317,34,3,3,2,2766,2766,2763,2763
Glenn,19,2022-04-25,4,4,4,0,287,287,282,5,0,0,0,0,53,53,53,53
Humboldt,19,2022-04-25,168,168,165,3,2853,2853,2806,47,2,0,0,2,147,147,147,147
Imperial,19,2022-04-25,65,65,64,1,3512,3514,3451,63,4,0,0,1,945,945,945,945
Inyo,19,2022-04-25,7,7,7,0,194,194,191,3,0,0,0,0,56,56,56,56
Kern,19,2022-04-25,251,251,247,4,18299,18313,18042,271,14,2,2,4,2346,2346,2344,2344
Kings,19,2022-04-25,54,54,53,1,4515,4519,4438,81,3,0,0,1,449,449,449,449
Lake,19,2022-04-25,21,21,21,0,887,887,869,18,0,0,0,0,140,140,140,140
Lassen,19,2022-04-25,1,1,1,0,1556,1556,1534,22,0,0,0,0,62,62,62,62
Los Angeles,19,2022-04-25,11369,11377,11320,57,885310,885924,881434,4490,207,29,29,25,31907,31907,31878,31878
Madera,19,2022-04-25,44,44,43,1,2916,2916,2857,59,2,0,0,0,370,370,370,370
Marin,19,2022-04-25,329,329,323,6,6440,6445,6319,126,7,0,0,0,295,295,295,295
Mariposa,19,2022-04-25,9,9,9,0,205,205,201,4,0,0,0,0,28,28,28,28
Mendocino,19,2022-04-25,55,55,54,1,1254,1254,1220,34,0,1,1,0,126,126,125,125
Merced,19,2022-04-25,99,99,98,1,3030,3031,2985,46,5,0,0,0,822,822,822,822
Modoc,19,2022-04-25,1,1,1,0,41,41,40,1,0,0,0,0,7,7,7,7
Mono,19,2022-04-25,4,4,4,0,94,94,91,3,0,0,0,0,6,6,6,6
Monterey,19,2022-04-25,322,322,312,10,8006,8012,7762,250,5,1,1,0,732,732,731,731
Napa,19,2022-04-25,199,199,196,3,3376,3377,3331,46,2,0,0,0,143,143,143,143
Nevada,19,2022-04-25,52,52,51,1,1399,1399,1371,28,1,0,0,1,131,131,131,131
Orange,19,2022-04-25,1969,1969,1946,23,86609,86670,85647,1023,53,7,7,13,7120,7120,7113,7113
Placer,19,2022-04-25,238,238,233,5,6091,6096,5964,132,18,0,0,4,627,627,627,627
Plumas,19,2022-04-25,2,2,2,0,228,228,223,5,0,0,0,0,13,13,13,13
Riverside,19,2022-04-25,1305,1305,1285,20,40534,40563,39923,640,33,4,4,5,6463,6463,6459,6459
Sacramento,19,2022-04-25,1023,1023,1006,17,31868,31889,31349,540,44,4,4,4,3068,3068,3064,3064
San Benito,19,2022-04-25,34,34,34,0,1118,1118,1102,16,0,0,0,0,94,94,94,94
San Bernardino,19,2022-04-25,1294,1294,1278,16,42974,43004,42456,548,21,10,10,7,7827,7827,7817,7817
San Diego,19,2022-04-25,3011,3011,2995,16,74322,74374,73978,396,86,5,5,10,5353,5353,5348,5348
San Francisco,19,2022-04-25,2001,2001,1933,68,32532,32554,31437,1117,23,1,1,3,875,875,874,874
San Joaquin,19,2022-04-25,387,387,380,7,15482,15494,15205,289,12,0,0,1,2249,2249,2249,2249
San Luis Obispo,19,2022-04-25,209,209,206,3,5036,5041,4968,73,6,0,0,0,481,481,481,481
San Mateo,19,2022-04-25,1538,1538,1520,18,32870,32892,32503,389,14,1,1,3,708,708,707,707
Santa Barbara,19,2022-04-25,371,371,365,6,15227,15237,14990,247,7,2,2,1,693,693,691,691
Santa Clara,19,2022-04-25,3142,3142,3124,18,77133,77187,76753,434,73,4,4,9,2310,2310,2306,2306
Santa Cruz,19,2022-04-25,474,474,468,6,20467,20480,20198,282,4,1,1,0,261,261,260,260
Shasta,19,2022-04-25,48,48,47,1,3317,3318,3262,56,3,0,0,1,561,561,561,561
Siskiyou,19,2022-04-25,7,7,7,0,322,322,318,4,0,0,0,0,83,83,83,83
Solano,19,2022-04-25,479,479,471,8,10655,10662,10493,169,11,0,0,2,450,450,450,450
Sonoma,19,2022-04-25,674,674,664,10,12065,12072,11884,188,19,0,0,2,492,492,492,492
Stanislaus,19,2022-04-25,241,241,235,6,7899,7904,7712,192,25,3,3,0,1694,1694,1691,1691
Sutter,19,2022-04-25,39,39,38,1,1399,1399,1376,23,0,1,1,0,226,226,225,225
Tehama,19,2022-04-25,17,17,17,0,711,711,694,17,1,0,0,0,207,207,207,207
Trinity,19,2022-04-25,1,1,1,0,72,72,70,2,0,0,0,0,20,20,20,20
Tulare,19,2022-04-25,90,90,88,2,6912,6917,6745,172,11,1,1,0,1494,1494,1493,1493
Tuolumne,19,2022-04-25,43,43,42,1,1124,1124,1101,23,2,0,0,0,183,183,183,183
Ventura,19,2022-04-25,604,604,597,7,18901,18914,18709,205,10,1,1,3,1506,1506,1505,1505
Yolo,19,2022-04-25,272,272,268,4,19383,19397,19119,278,1,0,0,0,362,362,362,362
Yuba,19,2022-04-25,31,31,31,0,1106,1106,1089,17,0,0,0,0,119,119,119,119
Alameda,20,2022-05-02,3377,3378,3345,33,68020,68072,67395,677,42,2,2,5,1886,1886,1884,1884
Amador,20,2022-05-02,19,19,19,0,1335,1335,1313,22,0,0,0,0,86,86,86,86
Butte,20,2022-05-02,91,91,90,1,2385,2385,2366,19,4,2,2,0,434,434,432,432
Calaveras,20,2022-05-02,23,23,23,0,727,727,717,10,0,0,0,0,120,120,120,120
Colusa,20,2022-05-02,2,2,2,0,203,203,201,2,0,0,0,0,21,21,21,21
Contra Costa,20,2022-05-02,1881,1881,1850,31,29266,29287,28803,484,40,2,2,5,1307,1307,1305,1305
Del Norte,20,2022-05-02,42,42,41,1,1202,1202,1187,15,1,0,0,0,49,49,49,49
El Dorado,20,2022-05-02,140,140,138,2,2756,2756,2718,38,1,1,1,0,215,215,214,214
Fresno,20,2022-05-02,503,503,495,8,16710,16723,16462,261,42,3,3,4,2769,2769,2766,2766
Glenn,20,2022-05-02,4,4,4,0,252,252,249,3,0,0,0,0,53,53,53,53
Humboldt,20,2022-05-02,269,269,266,3,2941,2942,2904,38,6,0,0,2,147,147,147,147
Imperial,20,2022-05-02,123,123,121,2,3645,3647,3595,52,1,0,0,1,945,945,945,945
Inyo,20,2022-05-02,2,2,2,0,179,179,177,2,0,0,0,0,56,56,56,56
Kern,20,2022-05-02,293,293,290,3,17932,17946,17738,208,10,0,0,5,2346,2346,2346,2346
Kings,20,2022-05-02,59,59,58,1,4847,4851,4783,68,3,0,0,1,449,449,449,449
Lake,20,2022-05-02,29,29,29,0,1003,1003,987,16,1,0,0,0,140,140,140,140
Lassen,20,2022-05-02,8,8,8,0,1608,1608,1590,18,0,0,0,0,62,62,62,62
Los Angeles,20,2022-05-02,14806,14818,14760,58,918018,918714,915068,3646,214,23,23,22,31930,31930,31907,31907
Madera,20,2022-05-02,76,76,75,1,3307,3307,3255,52,5,0,0,0,370,370,370,370
Marin,20,2022-05-02,427,427,421,6,6544,6549,6449,100,10,0,0,0,295,295,295,295
Mariposa,20,2022-05-02,7,7,7,0,244,244,240,4,0,0,0,0,28,28,28,28
Mendocino,20,2022-05-02,60,60,59,1,1222,1222,1196,26,0,0,0,0,126,126,126,126
Merced,20,2022-05-02,130,130,128,2,3283,3284,3245,39,8,4,4,0,826,826,822,822
Modoc,20,2022-05-02,0,0,0,0,36,37,36,1,0,0,0,0,7,7,7,7
Mono,20,2022-05-02,6,6,6,0,106,106,103,3,0,0,0,0,6,6,6,6
Monterey,20,2022-05-02,357,357,348,9,8386,8392,8186,206,8,1,1,0,733,733,732,732
Napa,20,2022-05-02,228,228,226,2,3547,3549,3511,38,4,0,0,0,143,143,143,143
Nevada,20,2022-05-02,80,80,79,1,1535,1535,1511,24,2,0,0,0,131,131,131,131
Orange,20,2022-05-02,2639,2639,2615,24,87486,87554,86745,809,61,5,5,13,7125,7125,7120,7120
Placer,20,2022-05-02,306,306,301,5,6373,6378,6270,108,20,0,0,4,627,627,627,627
Plumas,20,2022-05-02,9,9,9,0,256,256,252,4,0,0,0,0,13,13,13,13
Riverside,20,2022-05-02,2050,2050,2025,25,42958,42991,42461,530,37,3,3,5,6466,6466,6463,6463
Sacramento,20,2022-05-02,1393,1393,1375,18,33656,33682,33238,444,43,5,5,9,3073,3073,3068,3068
San Benito,20,2022-05-02,50,50,49,1,1285,1285,1271,14,0,0,0,0,94,94,94,94
San Bernardino,20,2022-05-02,1490,1490,1475,15,43533,43566,43132,434,30,7,7,6,7834,7834,7827,7827
San Diego,20,2022-05-02,4120,4121,4104,17,72928,72983,72681,302,79,3,3,13,5356,5356,5353,5353
San Francisco,20,2022-05-02,2424,2424,2359,65,35539,35566,34606,960,39,3,3,13,878,878,875,875
San Joaquin,20,2022-05-02,547,547,539,8,15216,15229,15007,222,14,1,1,1,2250,2250,2249,2249
San Luis Obispo,20,2022-05-02,249,249,246,3,5109,5114,5056,58,5,2,2,0,483,483,481,481
San Mateo,20,2022-05-02,1820,1820,1803,17,35990,36017,35683,334,22,2,2,5,710,710,708,708
Santa Barbara,20,2022-05-02,440,440,435,5,15309,15319,15124,195,10,0,0,2,693,693,693,693
Santa Clara,20,2022-05-02,4358,4359,4340,19,96570,96644,96215,429,88,5,5,15,2315,2315,2310,2310
Santa Cruz,20,2022-05-02,678,678,671,7,22027,22044,21806,238,2,1,1,0,262,262,261,261
Shasta,20,2022-05-02,68,68,67,1,3451,3452,3406,46,7,0,0,1,561,561,561,561
Siskiyou,20,2022-05-02,9,9,9,0,329,329,326,3,0,0,0,0,83,83,83,83
Solano,20,2022-05-02,624,624,616,8,11789,11798,11652,146,20,0,0,2,450,450,450,450
Sonoma,20,2022-05-02,898,898,887,11,12794,12803,12648,155,16,1,1,4,493,493,492,492
Stanislaus,20,2022-05-02,269,269,264,5,8083,8089,7935,154,22,0,0,3,1694,1694,1694,1694
Sutter,20,2022-05-02,47,47,46,1,1263,1263,1247,16,0,1,1,0,227,227,226,226
Tehama,20,2022-05-02,17,17,17,0,700,700,687,13,0,0,0,0,207,207,207,207
Trinity,20,2022-05-02,1,1,1,0,84,84,82,2,0,0,0,0,20,20,20,20
Tulare,20,2022-05-02,163,163,160,3,7286,7291,7149,142,10,3,3,0,1497,1497,1494,1494
Tuolumne,20,2022-05-02,93,93,92,1,1297,1297,1277,20,5,0,0,0,183,183,183,183
Ventura,20,2022-05-02,744,744,738,6,19920,19936,19767,169,15,4,4,1,1510,1510,1506,1506
Yolo,20,2022-05-02,352,352,348,4,18792,18808,18597,211,1,1,1,0,363,363,362,362
Yuba,20,2022-05-02,46,46,45,1,1052,1052,1040,12,2,0,0,1,119,119,119,119
Alameda,21,2022-05-09,4155,4158,4126,32,71490,71550,70996,554,44,7,7,6,1893,1893,1886,1886
Amador,21,2022-05-09,25,25,25,0,1518,1518,1499,19,0,0,0,0,86,86,86,86
Butte,21,2022-05-09,115,115,114,1,2412,2413,2398,15,5,0,0,0,434,434,434,434
Calaveras,21,2022-05-09,33,33,33,0,689,689,681,8,1,0,0,0,120,120,120,120
Colusa,21,2022-05-09,3,3,3,0,215,215,213,2,0,0,0,0,21,21,21,21
Contra Costa,21,2022-05-09,2515,2515,2483,32,30523,30550,30155,395,48,4,4,12,1311,1311,1307,1307
Del Norte,21,2022-05-09,49,49,49,0,1358,1358,1344,14,0,0,0,0,49,49,49,49
El Dorado,21,2022-05-09,179,179,177,2,2889,2890,2859,31,3,0,0,1,215,215,215,215
Fresno,21,2022-05-09,745,745,736,9,17853,17868,17650,218,29,1,1,1,2770,2770,2769,2769
Glenn,21,2022-05-09,8,8,8,0,228,228,226,2,0,0,0,0,53,53,53,53
Humboldt,21,2022-05-09,273,273,270,3,3149,3151,3119,32,5,0,0,2,147,147,147,147
Imperial,21,2022-05-09,131,131,130,1,3827,3830,3788,42,0,0,0,1,945,945,945,945
Inyo,21,2022-05-09,26,26,26,0,236,236,234,2,0,0,0,0,56,56,56,56
Kern,21,2022-05-09,467,467,463,4,18698,18714,18545,169,18,2,2,2,2348,2348,2346,2346
Kings,21,2022-05-09,91,91,90,1,4936,4941,4887,54,1,0,0,1,449,449,449,449
Lake,21,2022-05-09,30,30,30,0,1029,1029,1016,13,1,0,0,0,140,140,140,140
Lassen,21,2022-05-09,7,7,7,0,1689,1689,1675,14,0,0,0,0,62,62,62,62
Los Angeles,21,2022-05-09,18427,18442,18386,56,927351,928134,925266,2868,225,29,29,27,31959,31959,31930,31930
Madera,21,2022-05-09,132,132,130,2,3725,3729,3683,46,3,0,0,0,370,370,370,370
Marin,21,2022-05-09,711,711,703,8,7781,7787,7694,93,12,0,0,0,295,295,295,295
Mariposa,21,2022-05-09,32,32,32,0,287,287,283,4,0,0,0,0,28,28,28,28
Mendocino,21,2022-05-09,92,92,91,1,1264,1264,1243,21,0,1,1,0,127,127,126,126
Merced,21,2022-05-09,198,198,196,2,3431,3434,3402,32,4,1,1,0,827,827,826,826
Modoc,21,2022-05-09,2,2,2,0,41,42,41,1,0,0,0,0,7,7,7,7
Mono,21,2022-05-09,9,9,9,0,113,113,111,2,0,0,0,0,6,6,6,6
Monterey,21,2022-05-09,440,440,432,8,9377,9384,9203,181,11,0,0,0,733,733,733,733
Napa,21,2022-05-09,233,233,231,2,3121,3122,3096,26,2,0,0,0,143,143,143,143
Nevada,21,2022-05-09,102,102,101,1,1655,1655,1635,20,5,0,0,0,131,131,131,131
Orange,21,2022-05-09,3516,3517,3492,25,91780,91857,91194,663,84,8,8,17,7133,7133,7125,7125
Placer,21,2022-05-09,537,537,530,7,6752,6757,6667,90,25,0,0,2,627,627,627,627
Plumas,21,2022-05-09,13,13,13,0,274,274,271,3,0,0,0,0,13,13,13,13
Riverside,21,2022-05-09,2403,2403,2380,23,45141,45179,44743,436,42,4,4,8,6470,6470,6466,6466
Sacramento,21,2022-05-09,2255,2255,2232,23,36120,36149,35775,374,62,4,4,10,3077,3077,3073,3073
San Benito,21,2022-05-09,74,74,73,1,1433,1433,1421,12,0,0,0,0,94,94,94,94
San Bernardino,21,2022-05-09,1938,1938,1923,15,46592,46631,46268,363,31,5,5,4,7839,7839,7834,7834
San Diego,21,2022-05-09,5218,5223,5206,17,87126,87199,86915,284,98,2,2,11,5358,5358,5356,5356
San Francisco,21,2022-05-09,3049,3050,2986,64,38186,38217,37408,809,52,6,6,9,884,884,878,878
San Joaquin,21,2022-05-09,773,773,764,9,16059,16072,15889,183,11,1,1,3,2251,2251,2250,2250
San Luis Obispo,21,2022-05-09,290,290,287,3,5221,5226,5180,46,0,0,0,0,483,483,483,483
San Mateo,21,2022-05-09,2315,2315,2299,16,37695,37726,37453,273,26,3,3,1,713,713,710,710
Santa Barbara,21,2022-05-09,638,638,632,6,15589,15603,15448,155,10,0,0,3,693,693,693,693
Santa Clara,21,2022-05-09,5623,5630,5611,19,106179,106267,105899,368,87,3,3,23,2318,2318,2315,2315
Santa Cruz,21,2022-05-09,729,729,723,6,23980,23999,23797,202,2,0,0,0,262,262,262,262
Shasta,21,2022-05-09,107,107,106,1,3301,3303,3269,34,7,0,0,0,561,561,561,561
Siskiyou,21,2022-05-09,16,16,16,0,285,285,283,2,0,0,0,0,83,83,83,83
Solano,21,2022-05-09,920,920,911,9,12322,12332,12212,120,20,0,0,1,450,450,450,450
Sonoma,21,2022-05-09,1180,1180,1169,11,13977,13990,13857,133,18,1,1,2,494,494,493,493
Stanislaus,21,2022-05-09,460,460,453,7,8942,8950,8816,134,27,0,0,2,1694,1694,1694,1694
Sutter,21,2022-05-09,61,61,60,1,1565,1565,1549,16,0,0,0,0,227,227,227,227
Tehama,21,2022-05-09,28,28,28,0,692,692,682,10,1,0,0,0,207,207,207,207
Trinity,21,2022-05-09,4,4,4,0,69,69,68,1,0,0,0,0,20,20,20,20
Tulare,21,2022-05-09,183,183,180,3,7633,7639,7523,116,11,1,1,1,1498,1498,1497,1497
Tuolumne,21,2022-05-09,71,71,70,1,1429,1429,1412,17,1,2,2,0,185,185,183,183
Ventura,21,2022-05-09,1151,1151,1143,8,20949,20967,20828,139,15,1,1,2,1511,1511,1510,1510
Yolo,21,2022-05-09,493,493,489,4,19662,19679,19506,173,1,0,0,1,363,363,363,363
Yuba,21,2022-05-09,77,77,76,1,1241,1241,1229,12,2,0,0,0,119,119,119,119
Alameda,22,2022-05-16,4995,5000,4970,30,75030,75101,74646,455,73,8,8,6,1901,1901,1893,1893
Amador,22,2022-05-16,54,54,53,1,1672,1672,1655,17,0,0,0,0,86,86,86,86
Butte,22,2022-05-16,207,207,206,1,2664,2665,2652,13,7,2,2,0,436,436,434,434
Calaveras,22,2022-05-16,43,43,43,0,765,765,758,7,0,1,1,1,121,121,120,120
Colusa,22,2022-05-16,7,7,7,0,217,217,215,2,0,0,0,0,21,21,21,21
Contra Costa,22,2022-05-16,3488,3490,3455,35,33517,33549,33210,339,50,5,5,7,1316,1316,1311,1311
Del Norte,22,2022-05-16,175,175,174,1,1859,1859,1844,15,0,0,0,0,49,49,49,49
El Dorado,22,2022-05-16,266,266,264,2,3039,3041,3015,26,5,0,0,1,215,215,215,215
Fresno,22,2022-05-16,1140,1140,1129,11,19033,19051,18870,181,46,2,2,6,2772,2772,2770,2770
Glenn,22,2022-05-16,15,15,15,0,259,259,257,2,0,0,0,0,53,53,53,53
Humboldt,22,2022-05-16,274,274,272,2,3253,3257,3231,26,9,1,1,2,148,148,147,147
Imperial,22,2022-05-16,207,207,205,2,4276,4281,4244,37,1,0,0,1,945,945,945,945
Inyo,22,2022-05-16,19,19,19,0,228,228,226,2,1,0,0,0,56,56,56,56
Kern,22,2022-05-16,687,687,682,5,19978,19997,19856,141,22,3,3,3,2351,2351,2348,2348
Kings,22,2022-05-16,220,220,218,2,5418,5423,5377,46,0,1,1,0,450,450,449,449
Lake,22,2022-05-16,75,75,74,1,1118,1118,1107,11,2,0,0,0,140,140,140,140
Lassen,22,2022-05-16,21,21,21,0,1704,1704,1693,11,1,0,0,0,62,62,62,62
Los Angeles,22,2022-05-16,21419,21440,21389,51,938380,939275,937011,2264,283,39,39,44,31998,31998,31959,31959
Madera,22,2022-05-16,199,199,197,2,3632,3636,3601,35,2,0,0,0,370,370,370,370
Marin,22,2022-05-16,816,816,808,8,8391,8399,8320,79,12,0,0,0,295,295,295,295
Mariposa,22,2022-05-16,23,23,23,0,340,340,336,4,0,0,0,0,28,28,28,28
Mendocino,22,2022-05-16,99,99,98,1,1326,1326,1309,17,0,1,1,1,128,128,127,127
Merced,22,2022-05-16,314,314,312,2,4010,4015,3986,29,8,1,1,1,828,828,827,827
Modoc,22,2022-05-16,4,4,4,0,43,44,43,1,0,0,0,0,7,7,7,7
Mono,22,2022-05-16,11,11,11,0,112,112,110,2,0,0,0,0,6,6,6,6
Monterey,22,2022-05-16,509,509,501,8,9600,9608,9463,145,6,1,1,0,734,734,733,733
Napa,22,2022-05-16,299,299,297,2,3740,3745,3721,24,3,0,0,0,143,143,143,143
Nevada,22,2022-05-16,146,146,145,1,1834,1834,1817,17,2,0,0,0,131,131,131,131
Orange,22,2022-05-16,4552,4557,4532,25,94661,94751,94218,533,74,7,7,15,7140,7140,7133,7133
Placer,22,2022-05-16,742,742,734,8,7777,7784,7703,81,43,2,2,3,629,629,627,627
Plumas,22,2022-05-16,48,48,48,0,242,242,240,2,1,0,0,0,13,13,13,13
Riverside,22,2022-05-16,3344,3345,3320,25,47986,48032,47671,361,65,1,1,6,6471,6471,6470,6470
Sacramento,22,2022-05-16,3137,3138,3113,25,39840,39878,39556,322,89,8,8,12,3085,3085,3077,3077
San Benito,22,2022-05-16,110,110,109,1,1529,1529,1519,10,1,0,0,0,94,94,94,94
San Bernardino,22,2022-05-16,2473,2474,2459,15,49169,49216,48917,299,44,8,8,5,7847,7847,7839,7839
San Diego,22,2022-05-16,6664,6672,6655,17,94783,94873,94633,240,91,6,6,25,5364,5364,5358,5358
San Francisco,22,2022-05-16,3413,3416,3360,56,39359,39396,38743,653,68,5,5,8,889,889,884,884
San Joaquin,22,2022-05-16,1201,1201,1190,11,19015,19032,18863,169,16,1,1,1,2252,2252,2251,2251
San Luis Obispo,22,2022-05-16,426,426,423,3,6056,6062,6020,42,3,0,0,0,483,483,483,483
San Mateo,22,2022-05-16,2776,2777,2762,15,39916,39954,39729,225,39,1,1,1,714,714,713,713
Santa Barbara,22,2022-05-16,912,912,905,7,17041,17059,16927,132,13,0,0,2,693,693,693,693
Santa Clara,22,2022-05-16,7204,7211,7192,19,113212,113319,113013,306,111,9,9,15,2327,2327,2318,2318
Santa Cruz,22,2022-05-16,808,808,803,5,20748,20767,20627,140,5,0,0,0,262,262,262,262
Shasta,22,2022-05-16,126,126,125,1,3812,3816,3785,31,6,0,0,1,561,561,561,561
Siskiyou,22,2022-05-16,19,19,19,0,372,372,370,2,0,0,0,0,83,83,83,83
Solano,22,2022-05-16,1279,1279,1269,10,14209,14222,14114,108,29,0,0,2,450,450,450,450
Sonoma,22,2022-05-16,1572,1572,1561,11,15543,15557,15442,115,28,0,0,4,494,494,494,494
Stanislaus,22,2022-05-16,749,749,740,9,9951,9960,9844,116,33,2,2,5,1696,1696,1694,1694
Sutter,22,2022-05-16,109,109,108,1,1828,1828,1814,14,0,0,0,0,227,227,227,227
Tehama,22,2022-05-16,38,38,38,0,840,840,831,9,0,1,1,1,208,208,207,207
Trinity,22,2022-05-16,5,5,5,0,69,69,68,1,0,0,0,0,20,20,20,20
Tulare,22,2022-05-16,398,398,393,5,8314,8320,8221,99,14,1,1,0,1499,1499,1498,1498
Tuolumne,22,2022-05-16,139,139,138,1,1448,1448,1434,14,1,1,1,0,186,186,185,185
Ventura,22,2022-05-16,1552,1552,1544,8,23859,23880,23756,124,34,2,2,2,1513,1513,1511,1511
Yolo,22,2022-05-16,688,688,683,5,22156,22177,22025,152,0,0,0,1,363,363,363,363
Yuba,22,2022-05-16,119,119,118,1,1335,1335,1325,10,4,0,0,0,119,119,119,119
Alameda,23,2022-05-23,5607,5613,5587,26,77863,77945,77577,368,76,4,4,4,1905,1905,1901,1901
Amador,23,2022-05-23,80,80,79,1,1441,1441,1430,11,0,0,0,0,86,86,86,86
Butte,23,2022-05-23,284,284,283,1,2768,2771,2760,11,5,1,1,1,437,437,436,436
Calaveras,23,2022-05-23,52,52,52,0,744,744,739,5,0,1,1,0,122,122,121,121
Colusa,23,2022-05-23,7,7,7,0,232,232,231,1,0,0,0,0,21,21,21,21
Contra Costa,23,2022-05-23,3834,3839,3809,30,35373,35410,35130,280,71,10,10,7,1326,1326,1316,1316
Del Norte,23,2022-05-23,67,67,67,0,1346,1346,1338,8,0,1,1,0,50,50,49,49
El Dorado,23,2022-05-23,359,359,357,2,3419,3424,3401,23,6,2,2,0,217,217,215,215
Fresno,23,2022-05-23,1649,1649,1637,12,21384,21407,21248,159,63,2,2,8,2774,2774,2772,2772
Glenn,23,2022-05-23,26,26,26,0,273,273,271,2,0,0,0,0,53,53,53,53
Humboldt,23,2022-05-23,245,245,244,1,2911,2915,2897,18,14,1,1,3,149,149,148,148
Imperial,23,2022-05-23,343,343,341,2,4746,4751,4719,32,2,0,0,1,945,945,945,945
Inyo,23,2022-05-23,27,27,27,0,221,221,220,1,0,0,0,0,56,56,56,56
Kern,23,2022-05-23,1006,1006,1001,5,21275,21296,21179,117,34,0,0,7,2351,2351,2351,2351
Kings,23,2022-05-23,250,250,248,2,5644,5649,5611,38,1,0,0,0,450,450,450,450
Lake,23,2022-05-23,96,96,95,1,1238,1238,1228,10,1,0,0,1,140,140,140,140
Lassen,23,2022-05-23,41,41,41,0,1763,1763,1754,9,0,0,0,0,62,62,62,62
Los Angeles,23,2022-05-23,27745,27773,27721,52,946813,947802,946022,1780,366,31,31,53,32029,32029,31998,31998
Madera,23,2022-05-23,215,215,213,2,3764,3769,3740,29,1,0,0,2,370,370,370,370
Marin,23,2022-05-23,798,798,792,6,8785,8796,8732,64,15,0,0,1,295,295,295,295
Mariposa,23,2022-05-23,32,32,32,0,340,340,337,3,0,0,0,0,28,28,28,28
Mendocino,23,2022-05-23,150,150,149,1,1659,1659,1642,17,3,1,1,1,129,129,128,128
Merced,23,2022-05-23,409,409,407,2,4201,4206,4182,24,4,0,0,0,828,828,828,828
Modoc,23,2022-05-23,2,2,2,0,40,41,40,1,0,0,0,0,7,7,7,7
Mono,23,2022-05-23,14,14,14,0,163,163,161,2,0,0,0,0,6,6,6,6
Monterey,23,2022-05-23,702,702,694,8,9613,9625,9512,113,17,1,1,1,735,735,734,734
Napa,23,2022-05-23,332,332,330,2,3938,3943,3923,20,5,0,0,0,143,143,143,143
Nevada,23,2022-05-23,150,150,149,1,1904,1905,1891,14,2,0,0,0,131,131,131,131
Orange,23,2022-05-23,5624,5631,5607,24,94833,94932,94515,417,111,11,11,20,7151,7151,7140,7140
Placer,23,2022-05-23,887,887,880,7,7834,7841,7777,64,49,2,2,4,631,631,629,629
Plumas,23,2022-05-23,46,46,46,0,279,279,277,2,0,0,0,0,13,13,13,13
Riverside,23,2022-05-23,4454,4460,4434,26,52422,52477,52169,308,73,6,6,10,6477,6477,6471,6471
Sacramento,23,2022-05-23,3894,3899,3875,24,41041,41084,40824,260,122,7,7,10,3092,3092,3085,3085
San Benito,23,2022-05-23,168,168,167,1,1668,1668,1659,9,0,0,0,0,94,94,94,94
San Bernardino,23,2022-05-23,3325,3328,3312,16,50641,50694,50454,240,53,3,3,10,7850,7850,7847,7847
San Diego,23,2022-05-23,8834,8844,8827,17,103288,103396,103191,205,138,4,4,20,5368,5368,5364,5364
San Francisco,23,2022-05-23,3605,3609,3562,47,41636,41680,41139,541,85,6,6,9,895,895,889,889
San Joaquin,23,2022-05-23,1548,1548,1537,11,20968,20990,20844,146,20,3,3,7,2255,2255,2252,2252
San Luis Obispo,23,2022-05-23,669,669,665,4,7270,7277,7238,39,10,3,3,0,486,486,483,483
San Mateo,23,2022-05-23,3155,3158,3144,14,40829,40871,40691,180,35,0,0,0,714,714,714,714
Santa Barbara,23,2022-05-23,1064,1064,1058,6,17776,17794,17686,108,20,0,0,3,693,693,693,693
Santa Clara,23,2022-05-23,7829,7837,7821,16,111312,111429,111194,235,126,7,7,18,2334,2334,2327,2327
Santa Cruz,23,2022-05-23,505,505,502,3,7816,7824,7784,40,16,0,0,0,262,262,262,262
Shasta,23,2022-05-23,195,195,194,1,3606,3610,3587,23,4,1,1,3,562,562,561,561
Siskiyou,23,2022-05-23,29,29,29,0,364,364,362,2,1,0,0,0,83,83,83,83
Solano,23,2022-05-23,1513,1513,1504,9,14923,14939,14851,88,24,1,1,3,451,451,450,450
Sonoma,23,2022-05-23,1488,1488,1479,9,16334,16352,16257,95,34,2,2,3,496,496,494,494
Stanislaus,23,2022-05-23,872,872,864,8,10700,10712,10614,98,37,2,2,3,1698,1698,1696,1696
Sutter,23,2022-05-23,141,141,140,1,1912,1913,1902,11,0,1,1,0,228,228,227,227
Tehama,23,2022-05-23,50,50,50,0,812,812,805,7,1,0,0,1,208,208,208,208
Trinity,23,2022-05-23,3,3,3,0,90,90,89,1,0,0,0,0,20,20,20,20
Tulare,23,2022-05-23,558,558,553,5,9066,9074,8990,84,26,0,0,0,1499,1499,1499,1499
Tuolumne,23,2022-05-23,136,136,135,1,1576,1576,1564,12,0,1,1,0,187,187,186,186
Ventura,23,2022-05-23,1917,1917,1909,8,24017,24042,23945,97,36,1,1,1,1514,1514,1513,1513
Yolo,23,2022-05-23,731,731,727,4,22661,22684,22562,122,1,1,1,1,364,364,363,363
Yuba,23,2022-05-23,151,151,150,1,1453,1453,1445,8,6,0,0,1,119,119,119,119
Alameda,24,2022-05-30,4915,4921,4903,18,60796,60861,60631,230,95,4,4,7,1909,1909,1905,1905
Amador,24,2022-05-30,89,89,88,1,1191,1191,1184,7,0,1,1,0,87,87,86,86
Butte,24,2022-05-30,276,276,275,1,2709,2713,2705,8,20,0,0,1,437,437,437,437
Calaveras,24,2022-05-30,54,54,54,0,617,617,614,3,0,0,0,0,122,122,122,122
Colusa,24,2022-05-30,13,13,13,0,170,170,169,1,0,0,0,0,21,21,21,21
Contra Costa,24,2022-05-30,3320,3324,3303,21,28988,29020,28838,182,65,7,7,9,1333,1333,1326,1326
Del Norte,24,2022-05-30,36,36,36,0,975,975,970,5,2,1,1,0,51,51,50,50
El Dorado,24,2022-05-30,332,332,330,2,2940,2944,2928,16,6,2,2,2,219,219,217,217
Fresno,24,2022-05-30,1667,1667,1657,10,19525,19547,19431,116,71,6,6,7,2780,2780,2774,2774
Glenn,24,2022-05-30,27,27,27,0,290,290,289,1,2,0,0,0,53,53,53,53
Humboldt,24,2022-05-30,181,181,180,1,2296,2299,2288,11,10,0,0,5,149,149,149,149
Imperial,24,2022-05-30,332,332,330,2,4148,4153,4131,22,2,1,1,2,946,946,945,945
Inyo,24,2022-05-30,18,18,18,0,151,151,150,1,0,0,0,0,56,56,56,56
Kern,24,2022-05-30,1078,1078,1073,5,17986,18005,17926,79,36,0,0,6,2351,2351,2351,2351
Kings,24,2022-05-30,292,292,290,2,4664,4668,4643,25,2,0,0,1,450,450,450,450
Lake,24,2022-05-30,89,89,88,1,994,994,988,6,1,0,0,0,140,140,140,140
Lassen,24,2022-05-30,50,50,50,0,1615,1615,1608,7,1,0,0,0,62,62,62,62
Los Angeles,24,2022-05-30,26044,26074,26035,39,747122,747941,746814,1127,425,47,47,54,32076,32076,32029,32029
Madera,24,2022-05-30,235,235,234,1,3313,3317,3297,20,4,0,0,1,370,370,370,370
Marin,24,2022-05-30,650,650,646,4,7153,7161,7119,42,16,3,3,1,298,298,295,295
Mariposa,24,2022-05-30,39,39,39,0,303,303,301,2,0,0,0,0,28,28,28,28
Mendocino,24,2022-05-30,137,137,136,1,1264,1264,1254,10,4,0,0,1,129,129,129,129
Merced,24,2022-05-30,365,365,363,2,3406,3410,3395,15,6,0,0,2,828,828,828,828
Modoc,24,2022-05-30,4,4,4,0,38,39,38,1,0,0,0,0,7,7,7,7
Mono,24,2022-05-30,6,6,6,0,81,81,80,1,0,0,0,0,6,6,6,6
Monterey,24,2022-05-30,526,526,521,5,7151,7159,7092,67,19,1,1,1,736,736,735,735
Napa,24,2022-05-30,312,312,311,1,3180,3184,3171,13,4,0,0,0,143,143,143,143
Nevada,24,2022-05-30,181,181,180,1,1595,1595,1586,9,3,2,2,1,133,133,131,131
Orange,24,2022-05-30,5636,5643,5624,19,82150,82241,81953,288,122,12,12,18,7163,7163,7151,7151
Placer,24,2022-05-30,738,738,733,5,6133,6139,6099,40,52,0,0,8,631,631,631,631
Plumas,24,2022-05-30,35,35,35,0,200,200,199,1,1,0,0,0,13,13,13,13
Riverside,24,2022-05-30,3866,3870,3852,18,43863,43911,43706,205,82,3,3,10,6480,6480,6477,6477
Sacramento,24,2022-05-30,3840,3845,3826,19,33073,33109,32943,166,130,9,9,20,3101,3101,3092,3092
San Benito,24,2022-05-30,154,154,153,1,1276,1276,1271,5,0,0,0,0,94,94,94,94
San Bernardino,24,2022-05-30,3335,3339,3327,12,42867,42913,42752,161,49,5,5,10,7855,7855,7850,7850
San Diego,24,2022-05-30,8409,8419,8406,13,85853,85947,85812,135,153,10,10,26,5378,5378,5368,5368
San Francisco,24,2022-05-30,3133,3137,3105,32,33425,33461,33117,344,88,11,11,14,906,906,895,895
San Joaquin,24,2022-05-30,1398,1398,1390,8,17018,17036,16942,94,25,2,2,9,2257,2257,2255,2255
San Luis Obispo,24,2022-05-30,652,652,649,3,5437,5441,5418,23,12,1,1,0,487,487,486,486
San Mateo,24,2022-05-30,2753,2756,2746,10,31176,31209,31099,110,33,3,3,2,717,717,714,714
Santa Barbara,24,2022-05-30,1032,1032,1027,5,14449,14465,14395,70,23,2,2,5,695,695,693,693
Santa Clara,24,2022-05-30,7030,7037,7025,12,85313,85407,85264,143,154,10,10,22,2344,2344,2334,2334
Santa Cruz,24,2022-05-30,526,526,524,2,6255,6261,6235,26,7,1,1,1,263,263,262,262
Shasta,24,2022-05-30,133,133,132,1,2838,2840,2826,14,4,3,3,4,565,565,562,562
Siskiyou,24,2022-05-30,53,53,53,0,340,340,339,1,3,0,0,0,83,83,83,83
Solano,24,2022-05-30,1185,1185,1179,6,11566,11580,11525,55,28,0,0,7,451,451,451,451
Sonoma,24,2022-05-30,1201,1201,1196,5,13239,13253,13192,61,38,2,2,5,498,498,496,496
Stanislaus,24,2022-05-30,801,801,795,6,8585,8595,8533,62,55,2,2,3,1700,1700,1698,1698
Sutter,24,2022-05-30,158,158,157,1,1701,1702,1694,8,0,0,0,0,228,228,228,228
Tehama,24,2022-05-30,62,62,62,0,757,757,752,5,2,0,0,0,208,208,208,208
Trinity,24,2022-05-30,8,8,8,0,96,96,95,1,0,0,0,0,20,20,20,20
Tulare,24,2022-05-30,595,595,591,4,7483,7490,7434,56,19,0,0,0,1499,1499,1499,1499
Tuolumne,24,2022-05-30,122,122,121,1,1306,1306,1298,8,3,0,0,0,187,187,187,187
Ventura,24,2022-05-30,1681,1681,1676,5,19545,19567,19504,63,30,1,1,4,1515,1515,1514,1514
Yolo,24,2022-05-30,610,610,607,3,17640,17658,17583,75,4,0,0,1,364,364,364,364
Yuba,24,2022-05-30,144,144,143,1,1276,1276,1270,6,7,0,0,2,119,119,119,119
Alameda,25,2022-06-06,6494,6502,6483,19,73238,73323,73111,212,112,5,5,12,1914,1914,1909,1909
Amador,25,2022-06-06,114,114,113,1,1723,1723,1715,8,1,0,0,1,87,87,87,87
Butte,25,2022-06-06,453,453,452,1,3617,3622,3614,8,24,1,1,1,438,438,437,437
Calaveras,25,2022-06-06,73,73,73,0,737,737,734,3,0,2,2,0,124,124,122,122
Colusa,25,2022-06-06,22,22,22,0,276,276,275,1,3,0,0,0,21,21,21,21
Contra Costa,25,2022-06-06,4237,4242,4222,20,35708,35751,35577,174,107,9,9,7,1342,1342,1333,1333
Del Norte,25,2022-06-06,65,65,65,0,1134,1134,1130,4,2,0,0,0,51,51,51,51
El Dorado,25,2022-06-06,413,413,411,2,3637,3642,3627,15,5,0,0,5,219,219,219,219
Fresno,25,2022-06-06,2452,2454,2443,11,22694,22721,22617,104,94,2,2,6,2782,2782,2780,2780
Glenn,25,2022-06-06,41,41,41,0,325,325,324,1,3,0,0,0,53,53,53,53
Humboldt,25,2022-06-06,261,261,260,1,3054,3059,3048,11,14,1,1,3,150,150,149,149
Imperial,25,2022-06-06,466,466,464,2,4875,4880,4860,20,2,0,0,0,946,946,946,946
Inyo,25,2022-06-06,20,20,20,0,213,213,212,1,1,0,0,0,56,56,56,56
Kern,25,2022-06-06,1611,1611,1606,5,22977,23002,22924,78,35,1,1,6,2352,2352,2351,2351
Kings,25,2022-06-06,397,397,395,2,5504,5509,5486,23,10,0,0,1,450,450,450,450
Lake,25,2022-06-06,136,136,135,1,1180,1180,1174,6,5,0,0,2,140,140,140,140
Lassen,25,2022-06-06,71,71,71,0,2398,2400,2392,8,2,0,0,0,62,62,62,62
Los Angeles,25,2022-06-06,35101,35141,35101,40,1041900,1043120,1041917,1203,496,39,39,61,32115,32115,32076,32076
Madera,25,2022-06-06,353,353,351,2,4126,4131,4112,19,7,0,0,1,370,370,370,370
Marin,25,2022-06-06,740,740,737,3,7650,7660,7626,34,10,2,2,5,300,300,298,298
Mariposa,25,2022-06-06,57,57,57,0,403,403,401,2,0,0,0,0,28,28,28,28
Mendocino,25,2022-06-06,209,209,208,1,1711,1711,1700,11,9,1,1,2,130,130,129,129
Merced,25,2022-06-06,532,532,530,2,4529,4534,4518,16,16,0,0,0,828,828,828,828
Modoc,25,2022-06-06,11,11,11,0,37,38,37,1,0,0,0,0,7,7,7,7
Mono,25,2022-06-06,15,15,15,0,120,120,119,1,0,0,0,0,6,6,6,6
Monterey,25,2022-06-06,1002,1002,995,7,10243,10256,10181,75,17,2,2,1,738,738,736,736
Napa,25,2022-06-06,543,543,541,2,4232,4237,4224,13,8,1,1,0,144,144,143,143
Nevada,25,2022-06-06,246,246,245,1,2149,2151,2141,10,5,0,0,0,133,133,133,133
Orange,25,2022-06-06,7571,7580,7560,20,73558,73646,73449,197,140,12,12,18,7175,7175,7163,7163
Placer,25,2022-06-06,868,868,864,4,7604,7614,7576,38,65,0,0,11,631,631,631,631
Plumas,25,2022-06-06,40,40,40,0,321,321,320,1,0,0,0,0,13,13,13,13
Riverside,25,2022-06-06,5357,5364,5345,19,55968,56034,55833,201,88,6,6,10,6486,6486,6480,6480
Sacramento,25,2022-06-06,4951,4957,4938,19,42465,42514,42349,165,149,14,14,20,3115,3115,3101,3101
San Benito,25,2022-06-06,273,273,272,1,2016,2017,2011,6,0,0,0,1,94,94,94,94
San Bernardino,25,2022-06-06,5130,5137,5122,15,55836,55902,55740,162,77,7,7,14,7862,7862,7855,7855
San Diego,25,2022-06-06,10782,10795,10782,13,100449,100568,100446,122,185,8,8,22,5386,5386,5378,5378
San Francisco,25,2022-06-06,3525,3529,3501,28,38263,38308,38003,305,77,0,0,11,906,906,906,906
San Joaquin,25,2022-06-06,2132,2133,2124,9,22164,22190,22096,94,40,4,4,9,2261,2261,2257,2257
San Luis Obispo,25,2022-06-06,901,901,898,3,7531,7538,7513,25,16,1,1,1,488,488,487,487
San Mateo,25,2022-06-06,3212,3216,3207,9,37066,37109,37008,101,36,2,2,4,719,719,717,717
Santa Barbara,25,2022-06-06,1246,1246,1241,5,15068,15086,15030,56,22,1,1,5,696,696,695,695
Santa Clara,25,2022-06-06,8504,8514,8503,11,102647,102767,102635,132,176,6,6,22,2350,2350,2344,2344
Santa Cruz,25,2022-06-06,896,896,893,3,9720,9730,9700,30,24,1,1,3,264,264,263,263
Shasta,25,2022-06-06,210,210,209,1,4423,4428,4411,17,10,2,2,2,567,567,565,565
Siskiyou,25,2022-06-06,41,41,41,0,431,431,430,1,1,0,0,0,83,83,83,83
Solano,25,2022-06-06,1745,1745,1739,6,15188,15206,15151,55,29,2,2,1,453,453,451,451
Sonoma,25,2022-06-06,1636,1636,1630,6,13998,14014,13965,49,38,1,1,1,499,499,498,498
Stanislaus,25,2022-06-06,1183,1183,1176,7,10914,10927,10866,61,60,1,1,2,1701,1701,1700,1700
Sutter,25,2022-06-06,206,206,205,1,1941,1942,1935,7,0,0,0,0,228,228,228,228
Tehama,25,2022-06-06,83,83,83,0,1051,1051,1045,6,2,0,0,0,208,208,208,208
Trinity,25,2022-06-06,7,7,7,0,110,110,109,1,0,0,0,0,20,20,20,20
Tulare,25,2022-06-06,859,859,854,5,10775,10788,10727,61,24,0,0,0,1499,1499,1499,1499
Tuolumne,25,2022-06-06,124,124,123,1,1723,1724,1716,8,4,0,0,1,187,187,187,187
Ventura,25,2022-06-06,1973,1973,1968,5,24765,24794,24733,61,43,3,3,3,1518,1518,1515,1515
Yolo,25,2022-06-06,827,827,824,3,21447,21470,21400,70,2,1,1,0,365,365,364,364
Yuba,25,2022-06-06,187,187,186,1,1556,1556,1551,5,9,0,0,1,119,119,119,119
Alameda,26,2022-06-13,5083,5090,5079,11,55932,56001,55875,126,106,7,7,18,1921,1921,1914,1914
Amador,26,2022-06-13,131,131,131,0,1413,1413,1408,5,1,0,0,0,87,87,87,87
Butte,26,2022-06-13,394,394,393,1,3459,3464,3458,6,31,4,4,0,442,442,438,438
Calaveras,26,2022-06-13,69,69,69,0,658,658,656,2,0,0,0,0,124,124,124,124
Colusa,26,2022-06-13,12,12,12,0,328,328,327,1,17,0,0,0,21,21,21,21
Contra Costa,26,2022-06-13,3414,3419,3406,13,27987,28020,27914,106,89,8,8,12,1350,1350,1342,1342
Del Norte,26,2022-06-13,79,79,79,0,658,658,656,2,4,0,0,0,51,51,51,51
El Dorado,26,2022-06-13,324,324,323,1,3197,3202,3192,10,7,3,3,1,222,222,219,219
Fresno,26,2022-06-13,2398,2400,2392,8,20697,20723,20650,73,103,4,4,13,2786,2786,2782,2782
Glenn,26,2022-06-13,32,32,32,0,329,329,328,1,2,0,0,0,53,53,53,53
Humboldt,26,2022-06-13,262,262,261,1,2325,2328,2321,7,11,0,0,3,150,150,150,150
Imperial,26,2022-06-13,446,446,445,1,4530,4535,4521,14,6,1,1,0,947,947,946,946
Inyo,26,2022-06-13,13,13,13,0,189,189,188,1,0,0,0,0,56,56,56,56
Kern,26,2022-06-13,1565,1565,1561,4,21421,21448,21392,56,38,1,1,5,2353,2353,2352,2352
Kings,26,2022-06-13,357,357,356,1,5156,5161,5145,16,4,1,1,0,451,451,450,450
Lake,26,2022-06-13,138,138,137,1,1227,1227,1223,4,1,0,0,0,140,140,140,140
Lassen,26,2022-06-13,77,77,77,0,1994,1996,1991,5,2,0,0,0,62,62,62,62
Los Angeles,26,2022-06-13,29986,30022,29995,27,660785,661591,660992,599,519,54,54,60,32169,32169,32115,32115
Madera,26,2022-06-13,381,381,380,1,4230,4235,4220,15,7,0,0,2,370,370,370,370
Marin,26,2022-06-13,688,688,686,2,7040,7048,7023,25,16,2,2,2,302,302,300,300
Mariposa,26,2022-06-13,45,45,45,0,372,372,371,1,0,0,0,0,28,28,28,28
Mendocino,26,2022-06-13,162,162,161,1,1567,1567,1559,8,9,0,0,1,130,130,130,130
Merced,26,2022-06-13,561,561,559,2,4169,4174,4163,11,13,0,0,2,828,828,828,828
Modoc,26,2022-06-13,7,7,7,0,34,35,34,1,1,1,1,0,8,8,7,7
Mono,26,2022-06-13,19,19,19,0,92,92,91,1,0,0,0,0,6,6,6,6
Monterey,26,2022-06-13,838,838,833,5,8656,8668,8619,49,25,3,3,1,741,741,738,738
Napa,26,2022-06-13,433,433,432,1,3939,3944,3935,9,2,1,1,1,145,145,144,144
Nevada,26,2022-06-13,186,186,185,1,1874,1876,1869,7,8,0,0,0,133,133,133,133
Orange,26,2022-06-13,7000,7008,6994,14,65112,65192,65056,136,175,14,14,19,7189,7189,7175,7175
Placer,26,2022-06-13,790,790,787,3,6801,6810,6784,26,79,2,2,7,633,633,631,631
Plumas,26,2022-06-13,34,34,34,0,271,271,270,1,0,0,0,0,13,13,13,13
Riverside,26,2022-06-13,5045,5052,5038,14,47839,47897,47763,134,105,3,3,11,6489,6489,6486,6486
Sacramento,26,2022-06-13,4177,4182,4169,13,37535,37581,37468,113,190,12,12,20,3127,3127,3115,3115
San Benito,26,2022-06-13,200,200,200,0,1780,1781,1777,4,1,0,0,1,94,94,94,94
San Bernardino,26,2022-06-13,4675,4682,4672,10,48695,48754,48644,110,96,6,6,15,7868,7868,7862,7862
San Diego,26,2022-06-13,9614,9626,9617,9,84893,84999,84919,80,192,9,9,27,5395,5395,5386,5386
San Francisco,26,2022-06-13,3043,3047,3028,19,31136,31174,30981,193,72,11,11,13,917,917,906,906
San Joaquin,26,2022-06-13,1919,1919,1913,6,19010,19032,18969,63,32,5,5,3,2266,2266,2261,2261
San Luis Obispo,26,2022-06-13,661,661,659,2,6049,6056,6041,15,21,0,0,0,488,488,488,488
San Mateo,26,2022-06-13,2634,2637,2632,5,29172,29207,29146,61,44,3,3,3,722,722,719,719
Santa Barbara,26,2022-06-13,931,931,928,3,9475,9486,9459,27,15,1,1,5,697,697,696,696
Santa Clara,26,2022-06-13,7043,7051,7044,7,76835,76927,76850,77,182,13,13,23,2363,2363,2350,2350
Santa Cruz,26,2022-06-13,842,842,840,2,9962,9974,9950,24,23,0,0,1,264,264,264,264
Shasta,26,2022-06-13,220,220,219,1,3390,3394,3384,10,8,1,1,0,568,568,567,567
Siskiyou,26,2022-06-13,50,50,50,0,372,372,371,1,1,0,0,0,83,83,83,83
Solano,26,2022-06-13,1687,1687,1682,5,12902,12918,12882,36,33,0,0,2,453,453,453,453
Sonoma,26,2022-06-13,1336,1336,1332,4,11653,11668,11636,32,36,3,3,6,502,502,499,499
Stanislaus,26,2022-06-13,1132,1132,1127,5,9453,9465,9424,41,63,1,1,7,1702,1702,1701,1701
Sutter,26,2022-06-13,193,193,192,1,1721,1721,1716,5,0,0,0,0,228,228,228,228
Tehama,26,2022-06-13,88,88,88,0,967,967,963,4,3,0,0,0,208,208,208,208
Trinity,26,2022-06-13,11,11,11,0,84,85,84,1,0,0,0,0,20,20,20,20
Tulare,26,2022-06-13,823,823,819,4,9450,9461,9419,42,26,2,2,1,1501,1501,1499,1499
Tuolumne,26,2022-06-13,148,148,147,1,1445,1445,1440,5,2,0,0,0,187,187,187,187
Ventura,26,2022-06-13,1935,1935,1931,4,20980,21005,20965,40,38,3,3,5,1521,1521,1518,1518
Yolo,26,2022-06-13,767,767,765,2,14401,14417,14380,37,4,1,1,0,366,366,365,365
Yuba,26,2022-06-13,188,188,187,1,1420,1420,1416,4,8,0,0,1,119,119,119,119
Alameda,27,2022-06-20,4961,4968,4959,9,48657,48719,48634,85,105,12,12,14,1933,1933,1921,1921
Amador,27,2022-06-20,104,104,104,0,1247,1247,1243,4,2,0,0,0,87,87,87,87
Butte,27,2022-06-20,413,413,412,1,3560,3565,3560,5,28,4,4,1,446,446,442,442
Calaveras,27,2022-06-20,82,82,82,0,624,624,622,2,0,0,0,0,124,124,124,124
Colusa,27,2022-06-20,16,16,16,0,176,177,176,1,15,1,1,0,22,22,21,21
Contra Costa,27,2022-06-20,3342,3347,3337,10,26018,26051,25974,77,81,7,7,8,1357,1357,1350,1350
Del Norte,27,2022-06-20,82,82,82,0,611,611,610,1,3,1,1,1,52,52,51,51
El Dorado,27,2022-06-20,351,351,350,1,3074,3079,3071,8,5,2,2,1,224,224,222,222
Fresno,27,2022-06-20,2471,2473,2466,7,19498,19523,19469,54,100,2,2,16,2788,2788,2786,2786
Glenn,27,2022-06-20,41,41,41,0,314,314,313,1,3,0,0,0,53,53,53,53
Humboldt,27,2022-06-20,273,273,272,1,2273,2275,2270,5,11,0,0,3,150,150,150,150
Imperial,27,2022-06-20,602,602,601,1,3692,3697,3688,9,5,0,0,0,947,947,947,947
Inyo,27,2022-06-20,19,19,19,0,187,188,187,1,0,0,0,0,56,56,56,56
Kern,27,2022-06-20,1652,1652,1649,3,20130,20156,20115,41,39,5,5,9,2358,2358,2353,2353
Kings,27,2022-06-20,413,413,412,1,4866,4871,4859,12,6,1,1,0,452,452,451,451
Lake,27,2022-06-20,120,120,120,0,1237,1237,1233,4,1,0,0,2,140,140,140,140
Lassen,27,2022-06-20,43,43,43,0,1223,1224,1222,2,1,0,0,0,62,62,62,62
Los Angeles,27,2022-06-20,27528,27563,27544,19,351681,352123,351878,245,596,57,57,68,32226,32226,32169,32169
Madera,27,2022-06-20,340,340,339,1,4163,4167,4155,12,4,0,0,1,370,370,370,370
Marin,27,2022-06-20,694,694,692,2,6328,6335,6318,17,21,0,0,1,302,302,302,302
Mariposa,27,2022-06-20,53,53,53,0,335,335,334,1,0,0,0,0,28,28,28,28
Mendocino,27,2022-06-20,180,180,179,1,1580,1580,1574,6,3,0,0,0,130,130,130,130
Merced,27,2022-06-20,541,541,540,1,3955,3960,3952,8,7,3,3,1,831,831,828,828
Modoc,27,2022-06-20,5,5,5,0,37,38,37,1,0,0,0,0,8,8,8,8
Mono,27,2022-06-20,6,6,6,0,82,83,82,1,1,1,1,0,7,7,6,6
Monterey,27,2022-06-20,894,894,890,4,8906,8918,8879,39,38,1,1,2,742,742,741,741
Napa,27,2022-06-20,365,365,364,1,3129,3134,3128,6,3,1,1,0,146,146,145,145
Nevada,27,2022-06-20,170,170,170,0,1619,1619,1615,4,6,1,1,0,134,134,133,133
Orange,27,2022-06-20,7018,7027,7016,11,60425,60501,60403,98,152,10,10,23,7199,7199,7189,7189
Placer,27,2022-06-20,674,674,672,2,6053,6060,6042,18,69,1,1,7,634,634,633,633
Plumas,27,2022-06-20,38,38,38,0,239,239,238,1,0,0,0,0,13,13,13,13
Riverside,27,2022-06-20,4960,4967,4956,11,43307,43361,43266,95,112,5,5,14,6494,6494,6489,6489
Sacramento,27,2022-06-20,3929,3934,3925,9,34810,34852,34770,82,171,12,12,21,3139,3139,3127,3127
San Benito,27,2022-06-20,173,173,173,0,1598,1598,1595,3,0,1,1,2,95,95,94,94
San Bernardino,27,2022-06-20,4539,4546,4538,8,46252,46310,46229,81,105,12,12,17,7880,7880,7868,7868
San Diego,27,2022-06-20,9694,9706,9699,7,77518,77616,77559,57,203,9,9,17,5404,5404,5395,5395
San Francisco,27,2022-06-20,3058,3063,3048,15,28293,28329,28192,137,72,12,12,14,929,929,917,917
San Joaquin,27,2022-06-20,1669,1669,1665,4,17897,17919,17873,46,38,6,6,6,2272,2272,2266,2266
San Luis Obispo,27,2022-06-20,601,601,600,1,5812,5818,5806,12,27,10,10,0,498,498,488,488
San Mateo,27,2022-06-20,2623,2626,2622,4,25948,25982,25939,43,42,2,2,1,724,724,722,722
Santa Barbara,27,2022-06-20,934,934,932,2,8260,8272,8254,18,33,2,2,6,699,699,697,697
Santa Clara,27,2022-06-20,6809,6817,6812,5,63485,63566,63517,49,170,8,8,21,2371,2371,2363,2363
Santa Cruz,27,2022-06-20,818,818,816,2,9130,9142,9125,17,19,1,1,2,265,265,264,264
Shasta,27,2022-06-20,241,241,240,1,3372,3376,3368,8,9,1,1,1,569,569,568,568
Siskiyou,27,2022-06-20,61,61,61,0,394,394,393,1,5,1,1,0,84,84,83,83
Solano,27,2022-06-20,1419,1419,1416,3,11474,11490,11465,25,41,0,0,5,453,453,453,453
Sonoma,27,2022-06-20,1399,1399,1396,3,10797,10810,10787,23,28,1,1,3,503,503,502,502
Stanislaus,27,2022-06-20,1035,1035,1032,3,8832,8843,8813,30,70,5,5,7,1707,1707,1702,1702
Sutter,27,2022-06-20,197,197,197,0,1858,1859,1855,4,0,0,0,0,228,228,228,228
Tehama,27,2022-06-20,97,97,97,0,889,889,886,3,3,0,0,0,208,208,208,208
Trinity,27,2022-06-20,10,10,10,0,106,107,106,1,0,0,0,0,20,20,20,20
Tulare,27,2022-06-20,892,892,889,3,8725,8736,8706,30,32,8,8,0,1509,1509,1501,1501
Tuolumne,27,2022-06-20,141,141,141,0,1554,1554,1550,4,3,0,0,1,187,187,187,187
Ventura,27,2022-06-20,1835,1835,1832,3,18669,18692,18664,28,50,1,1,7,1522,1522,1521,1521
Yolo,27,2022-06-20,680,680,679,1,10859,10872,10850,22,1,2,2,2,368,368,366,366
Yuba,27,2022-06-20,149,149,149,0,1339,1339,1336,3,13,0,0,5,119,119,119,119
Alameda,28,2022-06-27,5475,5482,5475,7,48328,48391,48325,66,124,8,8,16,1941,1941,1933,1933
Amador,28,2022-06-27,88,88,88,0,1149,1149,1146,3,3,0,0,1,87,87,87,87
Butte,28,2022-06-27,410,410,410,0,3468,3473,3469,4,30,2,2,0,448,448,446,446
Calaveras,28,2022-06-27,69,69,69,0,571,571,570,1,1,2,2,0,126,126,124,124
Colusa,28,2022-06-27,28,28,28,0,282,283,282,1,6,0,0,0,22,22,22,22
Contra Costa,28,2022-06-27,3527,3532,3524,8,25919,25953,25894,59,82,11,11,7,1368,1368,1357,1357
Del Norte,28,2022-06-27,140,140,140,0,669,669,668,1,5,1,1,2,53,53,52,52
El Dorado,28,2022-06-27,427,427,426,1,3357,3362,3356,6,5,0,0,1,224,224,224,224
Fresno,28,2022-06-27,2827,2832,2826,6,19937,19964,19921,43,136,2,2,17,2790,2790,2788,2788
Glenn,28,2022-06-27,28,28,28,0,296,296,295,1,1,0,0,0,53,53,53,53
Humboldt,28,2022-06-27,261,261,261,0,2189,2192,2188,4,10,1,1,2,151,151,150,150
Imperial,28,2022-06-27,705,705,704,1,4019,4024,4016,8,7,0,0,4,947,947,947,947
Inyo,28,2022-06-27,32,32,32,0,311,311,310,1,1,0,0,0,56,56,56,56
Kern,28,2022-06-27,1812,1812,1809,3,17276,17298,17270,28,52,7,7,8,2365,2365,2358,2358
Kings,28,2022-06-27,470,470,469,1,3931,3936,3928,8,9,0,0,0,452,452,452,452
Lake,28,2022-06-27,122,122,122,0,1139,1139,1136,3,2,0,0,0,140,140,140,140
Lassen,28,2022-06-27,51,51,51,0,848,848,847,1,1,0,0,0,62,62,62,62
Los Angeles,28,2022-06-27,32760,32802,32784,18,364562,365037,364840,197,679,73,73,68,32299,32299,32226,32226
Madera,28,2022-06-27,414,414,413,1,4286,4291,4282,9,8,0,0,0,370,370,370,370
Marin,28,2022-06-27,660,660,659,1,6243,6250,6237,13,20,1,1,2,303,303,302,302
Mariposa,28,2022-06-27,55,55,55,0,310,310,309,1,0,0,0,0,28,28,28,28
Mendocino,28,2022-06-27,153,153,153,0,1447,1447,1443,4,5,1,1,1,131,131,130,130
Merced,28,2022-06-27,614,614,613,1,4036,4041,4034,7,14,2,2,0,833,833,831,831
Modoc,28,2022-06-27,7,7,7,0,32,33,32,1,0,0,0,0,8,8,8,8
Mono,28,2022-06-27,25,25,25,0,110,111,110,1,1,0,0,0,7,7,7,7
Monterey,28,2022-06-27,935,935,932,3,8274,8286,8258,28,44,2,2,3,744,744,742,742
Napa,28,2022-06-27,391,391,390,1,3313,3318,3313,5,3,2,2,1,148,148,146,146
Nevada,28,2022-06-27,189,189,189,0,1619,1619,1616,3,4,0,0,3,134,134,134,134
Orange,28,2022-06-27,7548,7559,7550,9,59329,59406,59331,75,183,16,16,26,7215,7215,7199,7199
Placer,28,2022-06-27,808,808,806,2,6185,6193,6178,15,79,6,6,6,640,640,634,634
Plumas,28,2022-06-27,50,50,50,0,257,257,256,1,1,0,0,0,13,13,13,13
Riverside,28,2022-06-27,6195,6203,6193,10,44962,45021,44945,76,141,11,11,17,6505,6505,6494,6494
Sacramento,28,2022-06-27,4164,4170,4162,8,35282,35328,35263,65,173,10,10,25,3149,3149,3139,3139
San Benito,28,2022-06-27,221,221,221,0,1655,1655,1653,2,0,0,0,1,95,95,95,95
San Bernardino,28,2022-06-27,5724,5732,5724,8,48816,48880,48813,67,130,12,12,24,7892,7892,7880,7880
San Diego,28,2022-06-27,10874,10888,10882,6,80651,80755,80709,46,264,9,9,28,5413,5413,5404,5404
San Francisco,28,2022-06-27,3270,3275,3263,12,29253,29291,29181,110,92,5,5,23,934,934,929,929
San Joaquin,28,2022-06-27,1893,1893,1889,4,17966,17990,17954,36,46,2,2,5,2274,2274,2272,2272
San Luis Obispo,28,2022-06-27,645,645,644,1,5644,5650,5641,9,25,3,3,0,501,501,498,498
San Mateo,28,2022-06-27,2890,2894,2890,4,26919,26954,26920,34,36,2,2,2,726,726,724,724
Santa Barbara,28,2022-06-27,1148,1148,1146,2,9812,9825,9808,17,26,2,2,2,701,701,699,699
Santa Clara,28,2022-06-27,7542,7552,7547,5,61416,61496,61459,37,213,11,11,19,2382,2382,2371,2371
Santa Cruz,28,2022-06-27,861,861,860,1,9188,9200,9186,14,26,2,2,1,267,267,265,265
Shasta,28,2022-06-27,339,339,338,1,3308,3313,3307,6,21,0,0,4,569,569,569,569
Siskiyou,28,2022-06-27,63,63,63,0,355,355,354,1,2,1,1,0,85,85,84,84
Solano,28,2022-06-27,1614,1614,1611,3,13049,13067,13045,22,47,0,0,4,453,453,453,453
Sonoma,28,2022-06-27,1368,1368,1366,2,10098,10112,10095,17,33,2,2,3,505,505,503,503
Stanislaus,28,2022-06-27,1212,1212,1209,3,8583,8595,8572,23,96,2,2,6,1709,1709,1707,1707
Sutter,28,2022-06-27,197,197,197,0,1843,1844,1841,3,0,0,0,0,228,228,228,228
Tehama,28,2022-06-27,93,93,93,0,888,888,886,2,3,0,0,0,208,208,208,208
Trinity,28,2022-06-27,24,24,24,0,142,143,142,1,1,0,0,0,20,20,20,20
Tulare,28,2022-06-27,909,909,907,2,7882,7891,7870,21,35,0,0,2,1509,1509,1509,1509
Tuolumne,28,2022-06-27,172,172,172,0,1405,1405,1402,3,1,4,4,1,191,191,187,187
Ventura,28,2022-06-27,2090,2091,2089,2,18528,18553,18531,22,61,3,3,1,1525,1525,1522,1522
Yolo,28,2022-06-27,794,794,793,1,11425,11440,11422,18,8,0,0,1,368,368,368,368
Yuba,28,2022-06-27,172,172,172,0,1435,1435,1433,2,10,2,2,2,121,121,119,119
Alameda,29,2022-07-04,4836,4843,4838,5,38880,38931,38889,42,128,11,11,10,1952,1952,1941,1941
Amador,29,2022-07-04,66,66,66,0,1534,1535,1532,3,3,0,0,1,87,87,87,87
Butte,29,2022-07-04,284,284,284,0,2489,2492,2490,2,28,2,2,1,450,450,448,448
Calaveras,29,2022-07-04,81,81,81,0,486,486,485,1,0,2,2,0,128,128,126,126
Colusa,29,2022-07-04,21,21,21,0,150,151,150,1,4,0,0,0,22,22,22,22
Contra Costa,29,2022-07-04,3319,3323,3317,6,20931,20959,20921,38,76,10,10,12,1378,1378,1368,1368
Del Norte,29,2022-07-04,140,140,140,0,587,587,586,1,3,0,0,0,53,53,53,53
El Dorado,29,2022-07-04,307,307,307,0,2395,2399,2395,4,10,1,1,0,225,225,224,224
Fresno,29,2022-07-04,2469,2473,2469,4,15677,15700,15673,27,158,6,6,17,2796,2796,2790,2790
Glenn,29,2022-07-04,24,24,24,0,157,158,157,1,1,0,0,0,53,53,53,53
Humboldt,29,2022-07-04,188,188,188,0,1584,1584,1582,2,12,2,2,3,153,153,151,151
Imperial,29,2022-07-04,698,698,697,1,3234,3238,3233,5,8,1,1,3,948,948,947,947
Inyo,29,2022-07-04,42,42,42,0,292,293,292,1,1,0,0,0,56,56,56,56
Kern,29,2022-07-04,1757,1757,1755,2,14149,14166,14148,18,63,4,4,9,2369,2369,2365,2365
Kings,29,2022-07-04,436,436,435,1,3446,3450,3445,5,5,0,0,0,452,452,452,452
Lake,29,2022-07-04,107,107,107,0,790,790,789,1,3,2,2,0,142,142,140,140
Lassen,29,2022-07-04,31,31,31,0,640,640,639,1,2,0,0,0,62,62,62,62
Los Angeles,29,2022-07-04,32266,32310,32296,14,286141,286522,286399,123,801,88,88,85,32387,32387,32299,32299
Madera,29,2022-07-04,341,341,340,1,3179,3182,3176,6,9,0,0,1,370,370,370,370
Marin,29,2022-07-04,608,608,607,1,5169,5175,5166,9,25,1,1,2,304,304,303,303
Mariposa,29,2022-07-04,36,36,36,0,222,223,222,1,0,0,0,0,28,28,28,28
Mendocino,29,2022-07-04,164,164,164,0,1119,1119,1116,3,6,2,2,1,133,133,131,131
Merced,29,2022-07-04,596,596,595,1,2920,2924,2920,4,14,2,2,1,835,835,833,833
Modoc,29,2022-07-04,10,10,10,0,31,32,31,1,0,0,0,0,8,8,8,8
Mono,29,2022-07-04,22,22,22,0,81,82,81,1,1,0,0,0,7,7,7,7
Monterey,29,2022-07-04,843,843,841,2,6318,6329,6312,17,39,2,2,4,746,746,744,744
Napa,29,2022-07-04,340,340,340,0,2557,2561,2558,3,13,0,0,1,148,148,148,148
Nevada,29,2022-07-04,177,177,177,0,1268,1268,1266,2,5,0,0,1,134,134,134,134
Orange,29,2022-07-04,6978,6989,6982,7,50719,50787,50736,51,203,25,25,34,7240,7240,7215,7215
Placer,29,2022-07-04,808,808,807,1,5049,5055,5046,9,72,3,3,6,643,643,640,640
Plumas,29,2022-07-04,32,32,32,0,172,173,172,1,0,0,0,0,13,13,13,13
Riverside,29,2022-07-04,6397,6406,6397,9,38525,38576,38524,52,137,5,5,8,6510,6510,6505,6505
Sacramento,29,2022-07-04,3578,3583,3578,5,26532,26568,26529,39,163,19,19,22,3168,3168,3149,3149
San Benito,29,2022-07-04,211,211,211,0,1274,1274,1272,2,3,0,0,0,95,95,95,95
San Bernardino,29,2022-07-04,6066,6073,6066,7,41595,41650,41605,45,147,12,12,26,7904,7904,7892,7892
San Diego,29,2022-07-04,9601,9613,9609,4,65499,65586,65556,30,262,10,10,43,5423,5423,5413,5413
San Francisco,29,2022-07-04,2890,2894,2885,9,24201,24234,24162,72,100,11,11,18,945,945,934,934
San Joaquin,29,2022-07-04,1682,1682,1679,3,14665,14685,14662,23,41,5,5,4,2279,2279,2274,2274
San Luis Obispo,29,2022-07-04,616,616,615,1,4165,4169,4164,5,24,0,0,0,501,501,501,501
San Mateo,29,2022-07-04,2600,2604,2601,3,21595,21625,21603,22,39,1,1,3,727,727,726,726
Santa Barbara,29,2022-07-04,1057,1057,1056,1,7665,7676,7665,11,26,4,4,4,705,705,701,701
Santa Clara,29,2022-07-04,6804,6812,6809,3,50744,50812,50788,24,191,16,16,34,2398,2398,2382,2382
Santa Cruz,29,2022-07-04,733,733,732,1,7158,7167,7158,9,22,0,0,0,267,267,267,267
Shasta,29,2022-07-04,280,280,280,0,2396,2399,2395,4,15,5,5,3,574,574,569,569
Siskiyou,29,2022-07-04,34,34,34,0,326,327,326,1,1,0,0,1,85,85,85,85
Solano,29,2022-07-04,1345,1345,1343,2,9845,9858,9845,13,50,0,0,5,453,453,453,453
Sonoma,29,2022-07-04,1088,1088,1087,1,8093,8104,8093,11,35,2,2,1,507,507,505,505
Stanislaus,29,2022-07-04,1165,1165,1163,2,6990,7001,6986,15,84,7,7,16,1716,1716,1709,1709
Sutter,29,2022-07-04,230,230,230,0,1671,1672,1670,2,0,0,0,0,228,228,228,228
Tehama,29,2022-07-04,132,132,132,0,821,821,819,2,3,1,1,0,209,209,208,208
Trinity,29,2022-07-04,17,17,17,0,143,144,143,1,2,0,0,0,20,20,20,20
Tulare,29,2022-07-04,945,945,943,2,6100,6108,6095,13,40,4,4,1,1513,1513,1509,1509
Tuolumne,29,2022-07-04,165,165,165,0,938,938,936,2,8,0,0,1,191,191,191,191
Ventura,29,2022-07-04,1948,1949,1947,2,15408,15429,15415,14,66,2,2,8,1527,1527,1525,1525
Yolo,29,2022-07-04,535,535,534,1,7265,7273,7264,9,6,3,3,2,371,371,368,368
Yuba,29,2022-07-04,168,168,168,0,1078,1078,1077,1,9,0,0,1,121,121,121,121
Alameda,30,2022-07-11,5799,5807,5802,5,48341,48408,48368,40,119,8,8,16,1960,1960,1952,1952
Amador,30,2022-07-11,92,92,92,0,1504,1505,1503,2,2,0,0,0,87,87,87,87
Butte,30,2022-07-11,497,497,497,0,3299,3304,3302,2,27,1,1,4,451,451,450,450
Calaveras,30,2022-07-11,78,78,78,0,566,566,565,1,0,1,1,1,129,129,128,128
Colusa,30,2022-07-11,26,26,26,0,483,484,483,1,0,0,0,0,22,22,22,22
Contra Costa,30,2022-07-11,3682,3687,3682,5,26546,26582,26545,37,91,11,11,11,1389,1389,1378,1378
Del Norte,30,2022-07-11,175,175,175,0,677,677,676,1,5,0,0,1,53,53,53,53
El Dorado,30,2022-07-11,384,384,384,0,3153,3158,3154,4,12,1,1,3,226,226,225,225
Fresno,30,2022-07-11,3664,3670,3665,5,21579,21609,21581,28,161,7,7,14,2803,2803,2796,2796
Glenn,30,2022-07-11,45,45,45,0,382,383,382,1,0,0,0,0,53,53,53,53
Humboldt,30,2022-07-11,291,291,291,0,2189,2192,2190,2,11,1,1,2,154,154,153,153
Imperial,30,2022-07-11,1118,1118,1117,1,4746,4752,4746,6,14,1,1,1,949,949,948,948
Inyo,30,2022-07-11,38,38,38,0,389,390,389,1,0,1,1,0,57,57,56,56
Kern,30,2022-07-11,2457,2460,2458,2,16952,16975,16959,16,77,2,2,9,2371,2371,2369,2369
Kings,30,2022-07-11,732,732,731,1,4341,4346,4341,5,11,4,4,0,456,456,452,452
Lake,30,2022-07-11,126,126,126,0,1115,1115,1113,2,0,0,0,0,142,142,142,142
Lassen,30,2022-07-11,59,59,59,0,821,821,820,1,2,1,1,0,63,63,62,62
Los Angeles,30,2022-07-11,43323,43382,43368,14,381622,382149,382023,126,1038,90,90,115,32477,32477,32387,32387
Madera,30,2022-07-11,532,532,531,1,4126,4131,4126,5,15,0,0,3,370,370,370,370
Marin,30,2022-07-11,603,603,602,1,5928,5936,5928,8,17,1,1,1,305,305,304,304
Mariposa,30,2022-07-11,52,52,52,0,283,284,283,1,0,0,0,0,28,28,28,28
Mendocino,30,2022-07-11,190,190,190,0,1387,1387,1385,2,4,0,0,0,133,133,133,133
Merced,30,2022-07-11,764,764,763,1,4273,4278,4274,4,16,5,5,1,840,840,835,835
Modoc,30,2022-07-11,28,28,28,0,57,58,57,1,0,0,0,0,8,8,8,8
Mono,30,2022-07-11,11,11,11,0,105,106,105,1,0,0,0,0,7,7,7,7
Monterey,30,2022-07-11,1096,1096,1094,2,7948,7960,7943,17,47,5,5,3,751,751,746,746
Napa,30,2022-07-11,367,367,367,0,3664,3669,3666,3,13,1,1,1,149,149,148,148
Nevada,30,2022-07-11,221,221,221,0,1826,1828,1826,2,7,0,0,1,134,134,134,134
Orange,30,2022-07-11,9749,9761,9754,7,64157,64245,64195,50,257,20,20,30,7260,7260,7240,7240
Placer,30,2022-07-11,784,784,783,1,5963,5972,5963,9,76,2,2,8,645,645,643,643
Plumas,30,2022-07-11,71,71,71,0,282,283,282,1,0,0,0,0,13,13,13,13
Riverside,30,2022-07-11,9208,9220,9211,9,52070,52142,52088,54,225,17,17,12,6527,6527,6510,6510
Sacramento,30,2022-07-11,4205,4211,4206,5,35516,35565,35525,40,184,22,22,24,3190,3190,3168,3168
San Benito,30,2022-07-11,235,235,235,0,1666,1668,1666,2,1,0,0,0,95,95,95,95
San Bernardino,30,2022-07-11,8441,8453,8446,7,57670,57749,57701,48,188,14,14,20,7918,7918,7904,7904
San Diego,30,2022-07-11,13667,13687,13682,5,85548,85665,85635,30,332,11,11,41,5434,5434,5423,5423
San Francisco,30,2022-07-11,2999,3004,2997,7,27842,27880,27816,64,105,11,11,23,956,956,945,945
San Joaquin,30,2022-07-11,2141,2143,2140,3,19354,19380,19356,24,55,7,7,11,2286,2286,2279,2279
San Luis Obispo,30,2022-07-11,754,754,753,1,5272,5279,5274,5,22,3,3,1,504,504,501,501
San Mateo,30,2022-07-11,2778,2782,2780,2,25663,25699,25679,20,42,6,6,4,733,733,727,727
Santa Barbara,30,2022-07-11,1326,1326,1325,1,9703,9717,9707,10,46,5,5,9,710,710,705,705
Santa Clara,30,2022-07-11,7403,7414,7411,3,59981,60063,60041,22,211,12,12,38,2410,2410,2398,2398
Santa Cruz,30,2022-07-11,1031,1031,1030,1,9513,9526,9517,9,16,0,0,0,267,267,267,267
Shasta,30,2022-07-11,328,328,328,0,3565,3569,3565,4,21,2,2,6,576,576,574,574
Siskiyou,30,2022-07-11,29,29,29,0,361,362,361,1,1,1,1,1,86,86,85,85
Solano,30,2022-07-11,1632,1632,1630,2,11661,11677,11665,12,40,1,1,6,454,454,453,453
Sonoma,30,2022-07-11,1300,1300,1299,1,9943,9956,9946,10,50,0,0,7,507,507,507,507
Stanislaus,30,2022-07-11,1493,1493,1491,2,8686,8699,8685,14,103,7,7,11,1723,1723,1716,1716
Sutter,30,2022-07-11,287,287,287,0,1777,1778,1776,2,0,0,0,0,228,228,228,228
Tehama,30,2022-07-11,134,134,134,0,925,925,924,1,5,0,0,1,209,209,209,209
Trinity,30,2022-07-11,35,35,35,0,120,121,120,1,0,0,0,0,20,20,20,20
Tulare,30,2022-07-11,1385,1385,1383,2,9558,9570,9554,16,47,4,4,2,1517,1517,1513,1513
Tuolumne,30,2022-07-11,254,254,254,0,1303,1303,1301,2,6,0,0,0,191,191,191,191
Ventura,30,2022-07-11,2549,2553,2551,2,19713,19740,19726,14,89,9,9,6,1536,1536,1527,1527
Yolo,30,2022-07-11,502,502,502,0,5432,5438,5433,5,4,3,3,4,374,374,371,371
Yuba,30,2022-07-11,218,218,218,0,1404,1404,1403,1,9,0,0,1,121,121,121,121
Alameda,31,2022-07-18,4953,4960,4957,3,42947,43008,42980,28,149,10,10,25,1970,1970,1960,1960
Amador,31,2022-07-18,85,85,85,0,1348,1349,1348,1,6,0,0,1,87,87,87,87
Butte,31,2022-07-18,334,334,334,0,2794,2798,2797,1,25,1,1,3,452,452,451,451
Calaveras,31,2022-07-18,78,78,78,0,545,546,545,1,0,0,0,0,129,129,129,129
Colusa,31,2022-07-18,23,23,23,0,349,350,349,1,2,0,0,0,22,22,22,22
Contra Costa,31,2022-07-18,3059,3064,3061,3,22722,22756,22731,25,88,4,4,16,1393,1393,1389,1389
Del Norte,31,2022-07-18,168,168,168,0,705,705,704,1,7,0,0,0,53,53,53,53
El Dorado,31,2022-07-18,279,279,279,0,2638,2643,2641,2,11,1,1,1,227,227,226,226
Fresno,31,2022-07-18,3702,3708,3704,4,21122,21154,21132,22,199,9,9,15,2812,2812,2803,2803
Glenn,31,2022-07-18,34,34,34,0,263,264,263,1,0,0,0,0,53,53,53,53
Humboldt,31,2022-07-18,294,294,294,0,2025,2027,2025,2,10,0,0,4,154,154,154,154
Imperial,31,2022-07-18,1022,1022,1021,1,4434,4439,4435,4,18,2,2,3,951,951,949,949
Inyo,31,2022-07-18,30,30,30,0,331,332,331,1,0,0,0,0,57,57,57,57
Kern,31,2022-07-18,2296,2298,2296,2,16469,16494,16482,12,72,10,10,14,2381,2381,2371,2371
Kings,31,2022-07-18,708,708,707,1,4154,4159,4155,4,16,1,1,0,457,457,456,456
Lake,31,2022-07-18,132,132,132,0,993,993,992,1,3,0,0,0,142,142,142,142
Lassen,31,2022-07-18,78,78,78,0,1239,1241,1240,1,1,0,0,0,63,63,63,63
Los Angeles,31,2022-07-18,41836,41897,41886,11,353192,353708,353618,90,1162,112,112,137,32589,32589,32477,32477
Madera,31,2022-07-18,529,529,528,1,3632,3637,3633,4,5,0,0,3,370,370,370,370
Marin,31,2022-07-18,516,516,515,1,5504,5511,5505,6,12,1,1,5,306,306,305,305
Mariposa,31,2022-07-18,42,42,42,0,242,243,242,1,0,1,1,0,29,29,28,28
Mendocino,31,2022-07-18,185,185,185,0,1491,1491,1489,2,6,0,0,2,133,133,133,133
Merced,31,2022-07-18,753,753,752,1,3981,3986,3983,3,15,1,1,1,841,841,840,840
Modoc,31,2022-07-18,13,13,13,0,34,35,34,1,1,0,0,0,8,8,8,8
Mono,31,2022-07-18,10,10,10,0,85,86,85,1,1,0,0,0,7,7,7,7
Monterey,31,2022-07-18,985,985,983,2,7188,7199,7187,12,46,6,6,4,757,757,751,751
Napa,31,2022-07-18,318,318,318,0,2954,2959,2957,2,10,2,2,2,151,151,149,149
Nevada,31,2022-07-18,135,135,135,0,1331,1332,1331,1,8,0,0,3,134,134,134,134
Orange,31,2022-07-18,8793,8805,8800,5,59782,59869,59833,36,253,24,24,45,7284,7284,7260,7260
Placer,31,2022-07-18,684,684,683,1,5240,5247,5241,6,89,1,1,5,646,646,645,645
Plumas,31,2022-07-18,60,60,60,0,279,280,279,1,0,0,0,0,13,13,13,13
Riverside,31,2022-07-18,8245,8257,8250,7,48075,48145,48106,39,222,16,16,17,6543,6543,6527,6527
Sacramento,31,2022-07-18,3540,3546,3543,3,30409,30453,30427,26,180,12,12,26,3202,3202,3190,3190
San Benito,31,2022-07-18,199,199,199,0,1588,1589,1588,1,1,1,1,0,96,96,95,95
San Bernardino,31,2022-07-18,7997,8009,8004,5,53733,53812,53777,35,214,13,13,35,7931,7931,7918,7918
San Diego,31,2022-07-18,13078,13097,13093,4,79857,79974,79952,22,402,18,18,52,5452,5452,5434,5434
San Francisco,31,2022-07-18,2491,2496,2492,4,25514,25550,25505,45,111,10,10,24,966,966,956,956
San Joaquin,31,2022-07-18,2053,2055,2053,2,18031,18057,18040,17,66,2,2,11,2288,2288,2286,2286
San Luis Obispo,31,2022-07-18,559,559,559,0,4627,4632,4629,3,17,3,3,1,507,507,504,504
San Mateo,31,2022-07-18,2290,2294,2293,1,23097,23130,23116,14,33,0,0,4,733,733,733,733
Santa Barbara,31,2022-07-18,1297,1297,1296,1,9270,9284,9276,8,47,1,1,6,711,711,710,710
Santa Clara,31,2022-07-18,6193,6202,6200,2,54685,54765,54749,16,199,12,12,30,2422,2422,2410,2410
Santa Cruz,31,2022-07-18,874,874,873,1,7449,7460,7455,5,24,1,1,2,268,268,267,267
Shasta,31,2022-07-18,320,320,320,0,3209,3213,3210,3,40,3,3,3,579,579,576,576
Siskiyou,31,2022-07-18,34,34,34,0,345,346,345,1,3,0,0,0,86,86,86,86
Solano,31,2022-07-18,1246,1246,1245,1,9543,9557,9549,8,49,1,1,6,455,455,454,454
Sonoma,31,2022-07-18,1053,1053,1052,1,8747,8760,8753,7,44,0,0,5,507,507,507,507
Stanislaus,31,2022-07-18,1395,1395,1393,2,8396,8410,8399,11,109,5,5,9,1728,1728,1723,1723
Sutter,31,2022-07-18,253,253,253,0,1673,1674,1673,1,0,0,0,0,228,228,228,228
Tehama,31,2022-07-18,110,110,110,0,896,896,895,1,7,1,1,0,210,210,209,209
Trinity,31,2022-07-18,20,20,20,0,111,112,111,1,1,0,0,0,20,20,20,20
Tulare,31,2022-07-18,1185,1185,1183,2,8085,8097,8087,10,45,0,0,0,1517,1517,1517,1517
Tuolumne,31,2022-07-18,239,239,239,0,1142,1142,1141,1,7,4,4,0,195,195,191,191
Ventura,31,2022-07-18,2324,2327,2326,1,19560,19588,19577,11,92,4,4,7,1540,1540,1536,1536
Yolo,31,2022-07-18,430,430,430,0,4664,4670,4667,3,2,3,3,1,377,377,374,374
Yuba,31,2022-07-18,213,213,213,0,1292,1292,1291,1,18,0,0,0,121,121,121,121
Alameda,32,2022-07-25,4403,4410,4408,2,40432,40493,40473,20,143,12,12,19,1982,1982,1970,1970
Amador,32,2022-07-25,90,90,90,0,1206,1206,1205,1,3,0,0,1,87,87,87,87
Butte,32,2022-07-25,359,359,359,0,2945,2949,2948,1,30,1,1,2,453,453,452,452
Calaveras,32,2022-07-25,82,82,82,0,558,559,558,1,0,2,2,1,131,131,129,129
Colusa,32,2022-07-25,26,26,26,0,373,374,373,1,1,0,0,0,22,22,22,22
Contra Costa,32,2022-07-25,2822,2827,2825,2,21982,22014,21995,19,102,7,7,18,1400,1400,1393,1393
Del Norte,32,2022-07-25,67,67,67,0,534,535,534,1,6,0,0,0,53,53,53,53
El Dorado,32,2022-07-25,270,270,270,0,2485,2490,2488,2,9,1,1,0,228,228,227,227
Fresno,32,2022-07-25,3358,3363,3360,3,20401,20433,20417,16,195,6,6,29,2818,2818,2812,2812
Glenn,32,2022-07-25,31,31,31,0,271,272,271,1,0,0,0,0,53,53,53,53
Humboldt,32,2022-07-25,230,230,230,0,1923,1926,1925,1,13,2,2,4,156,156,154,154
Imperial,32,2022-07-25,873,873,872,1,4341,4346,4343,3,18,1,1,6,952,952,951,951
Inyo,32,2022-07-25,18,18,18,0,284,285,284,1,2,1,1,0,58,58,57,57
Kern,32,2022-07-25,1899,1900,1899,1,14987,15010,15001,9,82,3,3,12,2384,2384,2381,2381
Kings,32,2022-07-25,571,571,571,0,3887,3892,3889,3,15,1,1,0,458,458,457,457
Lake,32,2022-07-25,128,128,128,0,1041,1041,1040,1,5,1,1,2,143,143,142,142
Lassen,32,2022-07-25,53,53,53,0,1071,1072,1071,1,1,0,0,0,63,63,63,63
Los Angeles,32,2022-07-25,37132,37188,37181,7,334739,335248,335181,67,1152,121,121,134,32710,32710,32589,32589
Madera,32,2022-07-25,539,539,539,0,3829,3834,3831,3,11,1,1,5,371,371,370,370
Marin,32,2022-07-25,489,489,489,0,5417,5424,5420,4,26,2,2,2,308,308,306,306
Mariposa,32,2022-07-25,40,40,40,0,232,233,232,1,0,0,0,0,29,29,29,29
Mendocino,32,2022-07-25,196,196,196,0,1426,1426,1424,2,6,0,0,0,133,133,133,133
Merced,32,2022-07-25,732,732,732,0,3917,3923,3921,2,22,2,2,2,843,843,841,841
Modoc,32,2022-07-25,5,5,5,0,28,29,28,1,0,1,1,0,9,9,8,8
Mono,32,2022-07-25,15,15,15,0,84,85,84,1,0,0,0,0,7,7,7,7
Monterey,32,2022-07-25,933,933,932,1,7142,7153,7144,9,39,1,1,3,758,758,757,757
Napa,32,2022-07-25,297,297,297,0,2933,2938,2936,2,6,3,3,0,154,154,151,151
Nevada,32,2022-07-25,116,116,116,0,1316,1317,1316,1,3,1,1,0,135,135,134,134
Orange,32,2022-07-25,8022,8034,8030,4,58144,58232,58205,27,306,37,37,35,7321,7321,7284,7284
Placer,32,2022-07-25,606,606,605,1,5086,5093,5089,4,77,5,5,11,651,651,646,646
Plumas,32,2022-07-25,25,25,25,0,188,189,188,1,0,0,0,0,13,13,13,13
Riverside,32,2022-07-25,7513,7525,7520,5,45936,46006,45977,29,259,16,16,27,6559,6559,6543,6543
Sacramento,32,2022-07-25,3632,3638,3636,2,29835,29880,29860,20,207,18,18,32,3220,3220,3202,3202
San Benito,32,2022-07-25,201,201,201,0,1836,1839,1838,1,0,1,1,0,97,97,96,96
San Bernardino,32,2022-07-25,7099,7111,7107,4,52139,52217,52191,26,214,30,30,23,7961,7961,7931,7931
San Diego,32,2022-07-25,11898,11916,11913,3,76173,76290,76274,16,393,19,19,41,5471,5471,5452,5452
San Francisco,32,2022-07-25,2300,2304,2301,3,24271,24308,24274,34,126,9,9,24,975,975,966,966
San Joaquin,32,2022-07-25,1837,1839,1838,1,16574,16600,16588,12,73,5,5,9,2293,2293,2288,2288
San Luis Obispo,32,2022-07-25,539,539,539,0,4382,4387,4384,3,16,4,4,1,511,511,507,507
San Mateo,32,2022-07-25,2030,2032,2031,1,21689,21722,21712,10,57,1,1,7,734,734,733,733
Santa Barbara,32,2022-07-25,1178,1178,1177,1,8770,8783,8777,6,37,4,4,3,715,715,711,711
Santa Clara,32,2022-07-25,5772,5779,5778,1,50880,50958,50947,11,238,16,16,26,2438,2438,2422,2422
Santa Cruz,32,2022-07-25,832,832,832,0,7664,7676,7672,4,23,0,0,0,268,268,268,268
Shasta,32,2022-07-25,305,305,305,0,3079,3084,3082,2,38,2,2,6,581,581,579,579
Siskiyou,32,2022-07-25,36,36,36,0,333,334,333,1,1,0,0,0,86,86,86,86
Solano,32,2022-07-25,1203,1203,1202,1,9484,9498,9492,6,56,0,0,5,455,455,455,455
Sonoma,32,2022-07-25,1066,1066,1065,1,8653,8667,8662,5,48,2,2,4,509,509,507,507
Stanislaus,32,2022-07-25,1377,1377,1376,1,8160,8173,8165,8,104,8,8,11,1736,1736,1728,1728
Sutter,32,2022-07-25,222,222,222,0,1723,1724,1723,1,0,0,0,0,228,228,228,228
Tehama,32,2022-07-25,103,103,103,0,920,920,919,1,5,2,2,0,212,212,210,210
Trinity,32,2022-07-25,12,12,12,0,102,103,102,1,0,0,0,0,20,20,20,20
Tulare,32,2022-07-25,1144,1144,1143,1,8015,8026,8018,8,42,2,2,2,1519,1519,1517,1517
Tuolumne,32,2022-07-25,200,200,200,0,1150,1150,1149,1,5,1,1,0,196,196,195,195
Ventura,32,2022-07-25,2153,2156,2155,1,18389,18417,18409,8,76,5,5,8,1545,1545,1540,1540
Yolo,32,2022-07-25,413,413,413,0,4402,4407,4404,3,4,3,3,1,380,380,377,377
Yuba,32,2022-07-25,175,175,175,0,1282,1282,1281,1,15,0,0,0,121,121,121,121
Alameda,33,2022-08-01,3815,3822,3821,1,37187,37246,37231,15,176,8,8,21,1990,1990,1982,1982
Amador,33,2022-08-01,53,53,53,0,1133,1133,1132,1,3,1,1,0,88,88,87,87
Butte,33,2022-08-01,368,368,368,0,2843,2847,2846,1,33,2,2,3,455,455,453,453
Calaveras,33,2022-08-01,68,68,68,0,573,574,573,1,2,1,1,2,132,132,131,131
Colusa,33,2022-08-01,26,26,26,0,362,363,362,1,7,0,0,0,22,22,22,22
Contra Costa,33,2022-08-01,2624,2629,2627,2,21023,21055,21041,14,86,13,13,15,1413,1413,1400,1400
Del Norte,33,2022-08-01,53,53,53,0,476,477,476,1,4,0,0,2,53,53,53,53
El Dorado,33,2022-08-01,232,232,232,0,2456,2461,2460,1,4,3,3,2,231,231,228,228
Fresno,33,2022-08-01,2995,3000,2998,2,18320,18348,18337,11,231,10,10,16,2828,2828,2818,2818
Glenn,33,2022-08-01,28,28,28,0,251,252,251,1,0,0,0,0,53,53,53,53
Humboldt,33,2022-08-01,224,224,224,0,1880,1883,1882,1,12,0,0,3,156,156,156,156
Imperial,33,2022-08-01,636,636,636,0,3530,3535,3533,2,22,5,5,3,957,957,952,952
Inyo,33,2022-08-01,20,20,20,0,280,281,280,1,2,0,0,0,58,58,58,58
Kern,33,2022-08-01,1692,1692,1691,1,14821,14844,14837,7,81,6,6,17,2390,2390,2384,2384
Kings,33,2022-08-01,624,624,624,0,4043,4048,4046,2,6,0,0,1,458,458,458,458
Lake,33,2022-08-01,125,125,125,0,994,994,993,1,7,0,0,2,143,143,143,143
Lassen,33,2022-08-01,103,103,103,0,947,949,948,1,0,0,0,0,63,63,63,63
Los Angeles,33,2022-08-01,30589,30637,30632,5,308963,309445,309397,48,1105,129,129,137,32839,32839,32710,32710
Madera,33,2022-08-01,463,463,463,0,3481,3486,3484,2,10,0,0,7,371,371,371,371
Marin,33,2022-08-01,411,411,411,0,5134,5142,5139,3,32,1,1,4,309,309,308,308
Mariposa,33,2022-08-01,22,22,22,0,225,226,225,1,0,0,0,0,29,29,29,29
Mendocino,33,2022-08-01,175,175,175,0,1258,1258,1257,1,6,1,1,1,134,134,133,133
Merced,33,2022-08-01,643,643,643,0,3567,3572,3570,2,22,6,6,2,849,849,843,843
Modoc,33,2022-08-01,16,16,16,0,31,32,31,1,0,0,0,0,9,9,9,9
Mono,33,2022-08-01,9,9,9,0,67,68,67,1,0,0,0,0,7,7,7,7
Monterey,33,2022-08-01,930,930,929,1,6430,6441,6435,6,33,2,2,1,760,760,758,758
Napa,33,2022-08-01,282,282,282,0,2838,2843,2842,1,8,0,0,2,154,154,154,154
Nevada,33,2022-08-01,125,125,125,0,1404,1405,1404,1,12,0,0,0,135,135,135,135
Orange,33,2022-08-01,6496,6507,6505,2,52422,52504,52485,19,246,34,34,49,7355,7355,7321,7321
Placer,33,2022-08-01,588,588,588,0,4744,4751,4748,3,71,1,1,11,652,652,651,651
Plumas,33,2022-08-01,23,23,23,0,162,163,162,1,0,0,0,0,13,13,13,13
Riverside,33,2022-08-01,6119,6130,6127,3,42287,42353,42332,21,200,5,5,23,6564,6564,6559,6559
Sacramento,33,2022-08-01,3095,3100,3098,2,27844,27887,27872,15,179,18,18,26,3238,3238,3220,3220
San Benito,33,2022-08-01,177,177,177,0,1561,1563,1562,1,2,1,1,0,98,98,97,97
San Bernardino,33,2022-08-01,6066,6076,6074,2,48914,48989,48970,19,184,26,26,23,7987,7987,7961,7961
San Diego,33,2022-08-01,9363,9378,9376,2,68638,68746,68735,11,396,16,16,46,5487,5487,5471,5471
San Francisco,33,2022-08-01,1817,1818,1816,2,21993,22027,22003,24,105,13,13,20,988,988,975,975
San Joaquin,33,2022-08-01,1734,1735,1734,1,16120,16146,16137,9,69,7,7,11,2300,2300,2293,2293
San Luis Obispo,33,2022-08-01,578,578,578,0,4141,4146,4144,2,14,3,3,0,514,514,511,511
San Mateo,33,2022-08-01,1773,1774,1773,1,20333,20366,20359,7,67,1,1,3,735,735,734,734
Santa Barbara,33,2022-08-01,1119,1119,1118,1,7779,7791,7787,4,40,1,1,3,716,716,715,715
Santa Clara,33,2022-08-01,4818,4825,4824,1,45489,45560,45552,8,230,19,19,36,2457,2457,2438,2438
Santa Cruz,33,2022-08-01,748,748,748,0,6875,6886,6883,3,20,1,1,3,269,269,268,268
Shasta,33,2022-08-01,245,245,245,0,2968,2972,2970,2,34,1,1,7,582,582,581,581
Siskiyou,33,2022-08-01,29,29,29,0,298,299,298,1,2,0,0,0,86,86,86,86
Solano,33,2022-08-01,1145,1145,1144,1,9149,9163,9158,5,53,0,0,4,455,455,455,455
Sonoma,33,2022-08-01,921,921,921,0,8186,8199,8195,4,46,3,3,3,512,512,509,509
Stanislaus,33,2022-08-01,1233,1233,1232,1,7720,7733,7727,6,115,6,6,8,1742,1742,1736,1736
Sutter,33,2022-08-01,232,232,232,0,1634,1635,1634,1,0,3,3,0,231,231,228,228
Tehama,33,2022-08-01,89,89,89,0,757,757,756,1,4,0,0,0,212,212,212,212
Trinity,33,2022-08-01,11,11,11,0,71,72,71,1,0,1,1,0,21,21,20,20
Tulare,33,2022-08-01,1035,1035,1034,1,7463,7474,7468,6,46,1,1,3,1520,1520,1519,1519
Tuolumne,33,2022-08-01,144,144,144,0,1111,1111,1110,1,4,0,0,1,196,196,196,196
Ventura,33,2022-08-01,1807,1808,1807,1,16968,16995,16989,6,75,10,10,10,1555,1555,1545,1545
Yolo,33,2022-08-01,333,333,333,0,4184,4190,4188,2,3,3,3,1,383,383,380,380
Yuba,33,2022-08-01,159,159,159,0,1216,1216,1215,1,10,0,0,3,121,121,121,121
Alameda,34,2022-08-08,3275,3281,3280,1,35235,35292,35281,11,133,15,15,20,2005,2005,1990,1990
Amador,34,2022-08-08,50,50,50,0,852,853,852,1,3,0,0,1,88,88,88,88
Butte,34,2022-08-08,334,334,334,0,2493,2498,2497,1,33,1,1,1,456,456,455,455
Calaveras,34,2022-08-08,57,57,57,0,559,560,559,1,1,1,1,0,133,133,132,132
Colusa,34,2022-08-08,15,15,15,0,362,363,362,1,0,0,0,0,22,22,22,22
Contra Costa,34,2022-08-08,2181,2185,2184,1,19794,19825,19815,10,102,4,4,14,1417,1417,1413,1413
Del Norte,34,2022-08-08,49,49,49,0,498,499,498,1,4,1,1,1,54,54,53,53
El Dorado,34,2022-08-08,191,191,191,0,2317,2322,2321,1,4,0,0,2,231,231,231,231
Fresno,34,2022-08-08,2424,2429,2428,1,17767,17796,17787,9,207,9,9,25,2837,2837,2828,2828
Glenn,34,2022-08-08,22,22,22,0,249,250,249,1,0,0,0,0,53,53,53,53
Humboldt,34,2022-08-08,208,208,208,0,1919,1922,1921,1,12,1,1,2,157,157,156,156
Imperial,34,2022-08-08,548,548,548,0,3278,3283,3282,1,16,2,2,2,959,959,957,957
Inyo,34,2022-08-08,8,8,8,0,276,277,276,1,1,0,0,1,58,58,58,58
Kern,34,2022-08-08,1314,1314,1314,0,13659,13681,13676,5,61,6,6,16,2396,2396,2390,2390
Kings,34,2022-08-08,467,467,467,0,3323,3328,3327,1,20,1,1,2,459,459,458,458
Lake,34,2022-08-08,106,106,106,0,893,894,893,1,4,0,0,1,143,143,143,143
Lassen,34,2022-08-08,132,132,132,0,1023,1025,1024,1,1,0,0,0,63,63,63,63
Los Angeles,34,2022-08-08,25754,25796,25793,3,291215,291687,291652,35,1030,128,128,121,32967,32967,32839,32839
Madera,34,2022-08-08,380,380,380,0,3175,3180,3178,2,16,0,0,3,371,371,371,371
Marin,34,2022-08-08,360,360,360,0,4484,4490,4488,2,26,2,2,2,311,311,309,309
Mariposa,34,2022-08-08,28,28,28,0,197,198,197,1,0,0,0,0,29,29,29,29
Mendocino,34,2022-08-08,132,132,132,0,1128,1128,1127,1,3,1,1,1,135,135,134,134
Merced,34,2022-08-08,538,538,538,0,3396,3401,3400,1,17,1,1,5,850,850,849,849
Modoc,34,2022-08-08,2,2,2,0,22,23,22,1,0,0,0,0,9,9,9,9
Mono,34,2022-08-08,10,10,10,0,85,86,85,1,0,0,0,0,7,7,7,7
Monterey,34,2022-08-08,736,736,735,1,5773,5783,5779,4,28,1,1,0,761,761,760,760
Napa,34,2022-08-08,252,252,252,0,2611,2616,2615,1,10,2,2,3,156,156,154,154
Nevada,34,2022-08-08,94,94,94,0,1290,1291,1290,1,4,0,0,0,135,135,135,135
Orange,34,2022-08-08,5283,5291,5290,1,48047,48125,48111,14,242,29,29,40,7384,7384,7355,7355
Placer,34,2022-08-08,513,513,513,0,4519,4526,4524,2,65,3,3,9,655,655,652,652
Plumas,34,2022-08-08,23,23,23,0,190,191,190,1,1,0,0,0,13,13,13,13
Riverside,34,2022-08-08,5508,5517,5515,2,40564,40630,40615,15,174,13,13,13,6577,6577,6564,6564
Sacramento,34,2022-08-08,2622,2627,2626,1,26966,27009,26998,11,156,17,17,20,3255,3255,3238,3238
San Benito,34,2022-08-08,186,186,186,0,1433,1435,1434,1,1,0,0,0,98,98,98,98
San Bernardino,34,2022-08-08,5054,5061,5059,2,45838,45912,45898,14,204,20,20,15,8007,8007,7987,7987
San Diego,34,2022-08-08,7275,7287,7286,1,64412,64516,64508,8,337,11,11,30,5498,5498,5487,5487
San Francisco,34,2022-08-08,1494,1494,1493,1,20620,20654,20637,17,94,11,11,21,999,999,988,988
San Joaquin,34,2022-08-08,1522,1523,1522,1,15717,15742,15735,7,55,6,6,12,2306,2306,2300,2300
San Luis Obispo,34,2022-08-08,509,509,509,0,3610,3615,3614,1,14,0,0,2,514,514,514,514
San Mateo,34,2022-08-08,1519,1519,1519,0,18510,18539,18534,5,60,0,0,5,735,735,735,735
Santa Barbara,34,2022-08-08,964,964,964,0,7519,7531,7528,3,46,3,3,4,719,719,716,716
Santa Clara,34,2022-08-08,4139,4146,4145,1,40868,40934,40928,6,203,17,17,40,2474,2474,2457,2457
Santa Cruz,34,2022-08-08,619,619,619,0,6055,6066,6064,2,28,1,1,0,270,270,269,269
Shasta,34,2022-08-08,197,197,197,0,2831,2835,2834,1,33,1,1,3,583,583,582,582
Siskiyou,34,2022-08-08,27,27,27,0,291,292,291,1,0,1,1,0,87,87,86,86
Solano,34,2022-08-08,883,883,883,0,7967,7981,7978,3,54,0,0,9,455,455,455,455
Sonoma,34,2022-08-08,839,839,839,0,7725,7738,7735,3,34,4,4,3,516,516,512,512
Stanislaus,34,2022-08-08,1035,1035,1034,1,7175,7188,7184,4,90,7,7,11,1749,1749,1742,1742
Sutter,34,2022-08-08,223,223,223,0,1551,1552,1551,1,0,0,0,0,231,231,231,231
Tehama,34,2022-08-08,77,77,77,0,681,682,681,1,0,0,0,1,212,212,212,212
Trinity,34,2022-08-08,5,5,5,0,71,72,71,1,0,0,0,0,21,21,21,21
Tulare,34,2022-08-08,887,887,886,1,7321,7331,7327,4,46,4,4,3,1524,1524,1520,1520
Tuolumne,34,2022-08-08,118,118,118,0,1054,1054,1053,1,4,2,2,0,198,198,196,196
Ventura,34,2022-08-08,1502,1502,1502,0,15930,15954,15950,4,67,7,7,7,1562,1562,1555,1555
Yolo,34,2022-08-08,287,287,287,0,3894,3899,3898,1,4,1,1,3,384,384,383,383
Yuba,34,2022-08-08,136,136,136,0,1086,1087,1086,1,6,1,1,0,122,122,121,121
Alameda,35,2022-08-15,2560,2565,2564,1,33707,33763,33755,8,105,9,9,22,2014,2014,2005,2005
Amador,35,2022-08-15,47,47,47,0,848,849,848,1,2,0,0,0,88,88,88,88
Butte,35,2022-08-15,262,262,262,0,2244,2249,2248,1,19,0,0,2,456,456,456,456
Calaveras,35,2022-08-15,46,46,46,0,528,529,528,1,0,0,0,0,133,133,133,133
Colusa,35,2022-08-15,16,16,16,0,359,360,359,1,1,0,0,0,22,22,22,22
Contra Costa,35,2022-08-15,1777,1778,1777,1,18966,18998,18990,8,72,6,6,9,1423,1423,1417,1417
Del Norte,35,2022-08-15,53,53,53,0,499,500,499,1,2,0,0,1,54,54,54,54
El Dorado,35,2022-08-15,177,177,177,0,2304,2309,2308,1,5,0,0,3,231,231,231,231
Fresno,35,2022-08-15,1868,1871,1870,1,16176,16204,16198,6,170,7,7,17,2844,2844,2837,2837
Glenn,35,2022-08-15,15,15,15,0,225,226,225,1,3,0,0,0,53,53,53,53
Humboldt,35,2022-08-15,179,179,179,0,1587,1589,1588,1,16,0,0,2,157,157,157,157
Imperial,35,2022-08-15,365,365,365,0,3099,3104,3103,1,11,0,0,2,959,959,959,959
Inyo,35,2022-08-15,14,14,14,0,236,237,236,1,2,1,1,0,59,59,58,58
Kern,35,2022-08-15,1216,1216,1216,0,13481,13502,13498,4,59,7,7,16,2403,2403,2396,2396
Kings,35,2022-08-15,332,332,332,0,3234,3239,3238,1,9,0,0,1,459,459,459,459
Lake,35,2022-08-15,104,104,104,0,1028,1030,1029,1,3,1,1,2,144,144,143,143
Lassen,35,2022-08-15,59,59,59,0,897,898,897,1,0,0,0,0,63,63,63,63
Los Angeles,35,2022-08-15,20923,20957,20955,2,287956,288434,288407,27,905,110,110,117,33077,33077,32967,32967
Madera,35,2022-08-15,305,305,305,0,2954,2959,2958,1,12,0,0,3,371,371,371,371
Marin,35,2022-08-15,294,294,294,0,4111,4117,4115,2,15,0,0,0,311,311,311,311
Mariposa,35,2022-08-15,15,15,15,0,192,193,192,1,0,0,0,0,29,29,29,29
Mendocino,35,2022-08-15,104,104,104,0,996,996,995,1,7,0,0,3,135,135,135,135
Merced,35,2022-08-15,453,453,453,0,3426,3431,3430,1,12,2,2,1,852,852,850,850
Modoc,35,2022-08-15,4,4,4,0,23,24,23,1,0,0,0,0,9,9,9,9
Mono,35,2022-08-15,4,4,4,0,61,62,61,1,0,0,0,0,7,7,7,7
Monterey,35,2022-08-15,662,662,662,0,5824,5835,5832,3,30,0,0,1,761,761,761,761
Napa,35,2022-08-15,212,212,212,0,2280,2285,2284,1,13,0,0,0,156,156,156,156
Nevada,35,2022-08-15,98,98,98,0,1209,1211,1210,1,7,0,0,0,135,135,135,135
Orange,35,2022-08-15,4577,4584,4583,1,43031,43104,43094,10,270,31,31,44,7415,7415,7384,7384
Placer,35,2022-08-15,411,411,411,0,4469,4476,4474,2,61,1,1,11,656,656,655,655
Plumas,35,2022-08-15,17,17,17,0,184,185,184,1,0,0,0,0,13,13,13,13
Riverside,35,2022-08-15,4561,4568,4567,1,38035,38098,38087,11,143,16,16,22,6593,6593,6577,6577
Sacramento,35,2022-08-15,2353,2358,2357,1,25411,25452,25444,8,149,11,11,22,3266,3266,3255,3255
San Benito,35,2022-08-15,140,140,140,0,1334,1337,1336,1,3,1,1,1,99,99,98,98
San Bernardino,35,2022-08-15,4699,4706,4705,1,44152,44227,44216,11,144,14,14,22,8021,8021,8007,8007
San Diego,35,2022-08-15,5499,5507,5506,1,59501,59599,59593,6,288,14,14,34,5512,5512,5498,5498
San Francisco,35,2022-08-15,1266,1266,1265,1,19571,19604,19591,13,103,15,15,11,1014,1014,999,999
San Joaquin,35,2022-08-15,1443,1443,1442,1,15217,15243,15238,5,64,8,8,8,2314,2314,2306,2306
San Luis Obispo,35,2022-08-15,325,325,325,0,3301,3306,3305,1,15,4,4,3,518,518,514,514
San Mateo,35,2022-08-15,1220,1220,1220,0,17369,17398,17394,4,56,1,1,5,736,736,735,735
Santa Barbara,35,2022-08-15,831,831,831,0,7119,7131,7129,2,44,1,1,4,720,720,719,719
Santa Clara,35,2022-08-15,3332,3339,3339,0,39767,39834,39830,4,200,8,8,24,2482,2482,2474,2474
Santa Cruz,35,2022-08-15,493,493,493,0,7543,7556,7554,2,23,3,3,1,273,273,270,270
Shasta,35,2022-08-15,194,194,194,0,2786,2790,2789,1,19,1,1,1,584,584,583,583
Siskiyou,35,2022-08-15,19,19,19,0,284,285,284,1,3,0,0,1,87,87,87,87
Solano,35,2022-08-15,663,663,663,0,7459,7472,7470,2,45,0,0,10,455,455,455,455
Sonoma,35,2022-08-15,631,631,631,0,7286,7298,7296,2,39,2,2,2,518,518,516,516
Stanislaus,35,2022-08-15,940,940,940,0,7657,7670,7666,4,99,9,9,11,1758,1758,1749,1749
Sutter,35,2022-08-15,197,197,197,0,1587,1589,1588,1,0,1,1,0,232,232,231,231
Tehama,35,2022-08-15,60,60,60,0,645,646,645,1,1,0,0,0,212,212,212,212
Trinity,35,2022-08-15,8,8,8,0,58,59,58,1,0,0,0,0,21,21,21,21
Tulare,35,2022-08-15,735,735,735,0,7326,7337,7334,3,32,3,3,1,1527,1527,1524,1524
Tuolumne,35,2022-08-15,110,110,110,0,991,992,991,1,1,0,0,0,198,198,198,198
Ventura,35,2022-08-15,1494,1494,1494,0,15260,15284,15281,3,70,6,6,7,1568,1568,1562,1562
Yolo,35,2022-08-15,264,264,264,0,3548,3553,3552,1,2,4,4,1,388,388,384,384
Yuba,35,2022-08-15,128,128,128,0,1080,1081,1080,1,9,0,0,0,122,122,122,122
Alameda,36,2022-08-22,2232,2237,2237,0,33141,33197,33191,6,117,9,9,21,2023,2023,2014,2014
Amador,36,2022-08-22,49,49,49,0,815,816,815,1,2,1,1,0,89,89,88,88
Butte,36,2022-08-22,222,222,222,0,2131,2136,2135,1,17,1,1,2,457,457,456,456
Calaveras,36,2022-08-22,43,43,43,0,572,573,572,1,1,0,0,0,133,133,133,133
Colusa,36,2022-08-22,16,16,16,0,394,395,394,1,0,0,0,0,22,22,22,22
Contra Costa,36,2022-08-22,1530,1530,1530,0,18837,18868,18862,6,56,5,5,9,1428,1428,1423,1423
Del Norte,36,2022-08-22,32,32,32,0,461,462,461,1,3,1,1,0,55,55,54,54
El Dorado,36,2022-08-22,152,152,152,0,2219,2224,2223,1,4,1,1,0,232,232,231,231
Fresno,36,2022-08-22,1596,1597,1597,0,15784,15811,15806,5,162,6,6,14,2850,2850,2844,2844
Glenn,36,2022-08-22,23,23,23,0,227,228,227,1,1,0,0,0,53,53,53,53
Humboldt,36,2022-08-22,151,151,151,0,1677,1682,1681,1,6,1,1,3,158,158,157,157
Imperial,36,2022-08-22,292,292,292,0,2844,2849,2848,1,15,0,0,0,959,959,959,959
Inyo,36,2022-08-22,8,8,8,0,213,214,213,1,0,0,0,0,59,59,59,59
Kern,36,2022-08-22,982,982,982,0,13745,13769,13766,3,69,6,6,10,2409,2409,2403,2403
Kings,36,2022-08-22,369,369,369,0,3636,3641,3640,1,10,2,2,0,461,461,459,459
Lake,36,2022-08-22,104,104,104,0,884,885,884,1,5,0,0,0,144,144,144,144
Lassen,36,2022-08-22,36,36,36,0,833,834,833,1,0,0,0,0,63,63,63,63
Los Angeles,36,2022-08-22,18455,18487,18486,1,274743,275212,275192,20,811,121,121,104,33198,33198,33077,33077
Madera,36,2022-08-22,300,300,300,0,2613,2618,2617,1,14,2,2,4,373,373,371,371
Marin,36,2022-08-22,250,250,250,0,3967,3973,3972,1,17,0,0,3,311,311,311,311
Mariposa,36,2022-08-22,14,14,14,0,172,173,172,1,0,0,0,0,29,29,29,29
Mendocino,36,2022-08-22,121,121,121,0,1145,1146,1145,1,3,0,0,2,135,135,135,135
Merced,36,2022-08-22,447,447,447,0,3657,3662,3661,1,12,4,4,1,856,856,852,852
Modoc,36,2022-08-22,6,6,6,0,27,28,27,1,0,0,0,0,9,9,9,9
Mono,36,2022-08-22,4,4,4,0,63,64,63,1,0,0,0,0,7,7,7,7
Monterey,36,2022-08-22,548,548,548,0,5923,5933,5930,3,27,1,1,2,762,762,761,761
Napa,36,2022-08-22,128,128,128,0,1999,2004,2003,1,5,2,2,1,158,158,156,156
Nevada,36,2022-08-22,84,84,84,0,1180,1182,1181,1,6,0,0,0,135,135,135,135
Orange,36,2022-08-22,3808,3815,3814,1,40768,40837,40830,7,224,21,21,35,7436,7436,7415,7415
Placer,36,2022-08-22,384,384,384,0,4303,4310,4309,1,61,1,1,14,657,657,656,656
Plumas,36,2022-08-22,20,20,20,0,175,176,175,1,1,0,0,0,13,13,13,13
Riverside,36,2022-08-22,4382,4389,4388,1,37513,37577,37568,9,142,13,13,19,6606,6606,6593,6593
Sacramento,36,2022-08-22,2079,2084,2083,1,24955,24998,24992,6,144,15,15,25,3281,3281,3266,3266
San Benito,36,2022-08-22,102,102,102,0,1268,1270,1269,1,1,1,1,1,100,100,99,99
San Bernardino,36,2022-08-22,4616,4623,4622,1,44256,44332,44324,8,160,18,18,22,8039,8039,8021,8021
San Diego,36,2022-08-22,4784,4791,4791,0,57535,57635,57631,4,287,6,6,28,5518,5518,5512,5512
San Francisco,36,2022-08-22,1096,1096,1095,1,18859,18891,18881,10,81,16,16,12,1030,1030,1014,1014
San Joaquin,36,2022-08-22,1195,1195,1195,0,15726,15753,15749,4,56,1,1,8,2315,2315,2314,2314
San Luis Obispo,36,2022-08-22,259,259,259,0,3089,3094,3093,1,16,1,1,0,519,519,518,518
San Mateo,36,2022-08-22,1014,1014,1014,0,17204,17233,17230,3,42,0,0,2,736,736,736,736
Santa Barbara,36,2022-08-22,736,736,736,0,7435,7448,7446,2,37,1,1,2,721,721,720,720
Santa Clara,36,2022-08-22,3013,3019,3019,0,40204,40273,40270,3,173,10,10,27,2492,2492,2482,2482
Santa Cruz,36,2022-08-22,502,502,502,0,11963,11983,11981,2,13,0,0,0,273,273,273,273
Shasta,36,2022-08-22,174,174,174,0,2757,2761,2760,1,10,2,2,2,586,586,584,584
Siskiyou,36,2022-08-22,25,25,25,0,249,250,249,1,4,1,1,2,88,88,87,87
Solano,36,2022-08-22,534,534,534,0,7222,7235,7233,2,35,0,0,12,455,455,455,455
Sonoma,36,2022-08-22,605,605,605,0,7371,7384,7382,2,42,1,1,1,519,519,518,518
Stanislaus,36,2022-08-22,893,893,893,0,7650,7663,7660,3,79,7,7,16,1765,1765,1758,1758
Sutter,36,2022-08-22,189,189,189,0,1657,1660,1659,1,0,0,0,0,232,232,232,232
Tehama,36,2022-08-22,53,53,53,0,629,630,629,1,1,0,0,0,212,212,212,212
Trinity,36,2022-08-22,10,10,10,0,63,64,63,1,0,0,0,0,21,21,21,21
Tulare,36,2022-08-22,730,730,730,0,6781,6792,6790,2,33,4,4,1,1531,1531,1527,1527
Tuolumne,36,2022-08-22,106,106,106,0,1018,1019,1018,1,0,1,1,0,199,199,198,198
Ventura,36,2022-08-22,1318,1318,1318,0,14997,15021,15019,2,59,4,4,9,1572,1572,1568,1568
Yolo,36,2022-08-22,200,200,200,0,3493,3498,3497,1,10,1,1,1,389,389,388,388
Yuba,36,2022-08-22,127,127,127,0,1106,1107,1106,1,13,0,0,3,122,122,122,122
Alameda,37,2022-08-29,1959,1964,1964,0,34173,34233,34228,5,99,12,12,20,2035,2035,2023,2023
Amador,37,2022-08-29,46,46,46,0,804,805,804,1,2,1,1,0,90,90,89,89
Butte,37,2022-08-29,236,236,236,0,2170,2175,2174,1,18,0,0,3,457,457,457,457
Calaveras,37,2022-08-29,59,59,59,0,592,593,592,1,1,0,0,0,133,133,133,133
Colusa,37,2022-08-29,11,11,11,0,329,330,329,1,3,0,0,0,22,22,22,22
Contra Costa,37,2022-08-29,1357,1357,1357,0,18798,18830,18825,5,44,5,5,7,1433,1433,1428,1428
Del Norte,37,2022-08-29,28,28,28,0,431,432,431,1,5,0,0,1,55,55,55,55
El Dorado,37,2022-08-29,143,143,143,0,1947,1953,1952,1,1,0,0,1,232,232,232,232
Fresno,37,2022-08-29,1419,1419,1419,0,15741,15769,15765,4,159,3,3,15,2853,2853,2850,2850
Glenn,37,2022-08-29,22,22,22,0,220,221,220,1,1,0,0,0,53,53,53,53
Humboldt,37,2022-08-29,124,124,124,0,1662,1665,1664,1,4,0,0,0,158,158,158,158
Imperial,37,2022-08-29,294,294,294,0,2936,2941,2940,1,14,1,1,2,960,960,959,959
Inyo,37,2022-08-29,8,8,8,0,175,176,175,1,0,0,0,0,59,59,59,59
Kern,37,2022-08-29,885,885,885,0,13225,13248,13246,2,50,0,0,8,2409,2409,2409,2409
Kings,37,2022-08-29,314,314,314,0,3490,3495,3494,1,8,0,0,0,461,461,461,461
Lake,37,2022-08-29,93,93,93,0,870,871,870,1,1,1,1,0,145,145,144,144
Lassen,37,2022-08-29,28,28,28,0,771,772,771,1,0,0,0,0,63,63,63,63
Los Angeles,37,2022-08-29,15524,15551,15550,1,271431,271907,271891,16,753,86,86,83,33284,33284,33198,33198
Madera,37,2022-08-29,302,302,302,0,3019,3024,3023,1,13,0,0,3,373,373,373,373
Marin,37,2022-08-29,215,215,215,0,3847,3853,3852,1,16,2,2,2,313,313,311,311
Mariposa,37,2022-08-29,25,25,25,0,186,187,186,1,0,0,0,0,29,29,29,29
Mendocino,37,2022-08-29,87,87,87,0,969,970,969,1,2,0,0,1,135,135,135,135
Merced,37,2022-08-29,393,393,393,0,3417,3422,3421,1,11,3,3,0,859,859,856,856
Modoc,37,2022-08-29,1,1,1,0,30,31,30,1,0,0,0,0,9,9,9,9
Mono,37,2022-08-29,2,2,2,0,45,46,45,1,0,0,0,0,7,7,7,7
Monterey,37,2022-08-29,395,395,395,0,5380,5390,5388,2,33,2,2,5,764,764,762,762
Napa,37,2022-08-29,128,128,128,0,2159,2165,2164,1,10,0,0,1,158,158,158,158
Nevada,37,2022-08-29,116,116,116,0,1206,1208,1207,1,6,0,0,0,135,135,135,135
Orange,37,2022-08-29,2950,2955,2955,0,39171,39240,39235,5,195,18,18,25,7454,7454,7436,7436
Placer,37,2022-08-29,370,370,370,0,4210,4217,4216,1,55,1,1,12,658,658,657,657
Plumas,37,2022-08-29,18,18,18,0,159,160,159,1,1,0,0,0,13,13,13,13
Riverside,37,2022-08-29,3652,3659,3658,1,36835,36901,36894,7,124,9,9,11,6615,6615,6606,6606
Sacramento,37,2022-08-29,1856,1859,1859,0,24695,24738,24733,5,137,11,11,20,3292,3292,3281,3281
San Benito,37,2022-08-29,120,120,120,0,1410,1413,1412,1,1,0,0,0,100,100,100,100
San Bernardino,37,2022-08-29,3621,3628,3627,1,42081,42155,42149,6,156,14,14,18,8053,8053,8039,8039
San Diego,37,2022-08-29,3934,3941,3941,0,56587,56685,56682,3,222,12,12,25,5530,5530,5518,5518
San Francisco,37,2022-08-29,875,875,875,0,19135,19169,19161,8,57,7,7,12,1037,1037,1030,1030
San Joaquin,37,2022-08-29,1005,1005,1005,0,14301,14328,14325,3,27,5,5,11,2320,2320,2315,2315
San Luis Obispo,37,2022-08-29,326,326,326,0,3216,3221,3220,1,17,3,3,0,522,522,519,519
San Mateo,37,2022-08-29,853,853,853,0,16785,16814,16812,2,26,0,0,5,736,736,736,736
Santa Barbara,37,2022-08-29,638,638,638,0,7623,7636,7635,1,24,1,1,3,722,722,721,721
Santa Clara,37,2022-08-29,2308,2313,2313,0,39573,39644,39641,3,135,5,5,24,2497,2497,2492,2492
Santa Cruz,37,2022-08-29,385,385,385,0,12678,12699,12697,2,16,0,0,1,273,273,273,273
Shasta,37,2022-08-29,130,130,130,0,2576,2580,2579,1,19,1,1,1,587,587,586,586
Siskiyou,37,2022-08-29,24,24,24,0,249,250,249,1,0,1,1,0,89,89,88,88
Solano,37,2022-08-29,549,549,549,0,7290,7303,7302,1,33,1,1,8,456,456,455,455
Sonoma,37,2022-08-29,486,486,486,0,7105,7118,7117,1,37,1,1,4,520,520,519,519
Stanislaus,37,2022-08-29,849,849,849,0,8083,8098,8096,2,79,7,7,6,1772,1772,1765,1765
Sutter,37,2022-08-29,170,170,170,0,1638,1641,1640,1,0,0,0,0,232,232,232,232
Tehama,37,2022-08-29,67,67,67,0,738,739,738,1,4,0,0,1,212,212,212,212
Trinity,37,2022-08-29,9,9,9,0,56,57,56,1,0,0,0,0,21,21,21,21
Tulare,37,2022-08-29,683,683,683,0,7370,7383,7381,2,42,0,0,1,1531,1531,1531,1531
Tuolumne,37,2022-08-29,91,91,91,0,856,857,856,1,1,0,0,0,199,199,199,199
Ventura,37,2022-08-29,1020,1020,1020,0,14599,14624,14622,2,71,6,6,7,1578,1578,1572,1572
Yolo,37,2022-08-29,204,204,204,0,3719,3724,3723,1,5,0,0,3,389,389,389,389
Yuba,37,2022-08-29,135,135,135,0,1176,1177,1176,1,14,0,0,1,122,122,122,122
Alameda,38,2022-09-05,1435,1436,1436,0,28120,28171,28168,3,89,4,4,16,2039,2039,2035,2035
Amador,38,2022-09-05,44,44,44,0,748,749,748,1,3,0,0,2,90,90,90,90
Butte,38,2022-09-05,193,193,193,0,2122,2126,2125,1,14,2,2,2,459,459,457,457
Calaveras,38,2022-09-05,22,22,22,0,451,452,451,1,0,0,0,0,133,133,133,133
Colusa,38,2022-09-05,8,8,8,0,197,198,197,1,2,0,0,0,22,22,22,22
Contra Costa,38,2022-09-05,954,954,954,0,15427,15455,15452,3,62,5,5,9,1438,1438,1433,1433
Del Norte,38,2022-09-05,9,9,9,0,347,348,347,1,1,0,0,1,55,55,55,55
El Dorado,38,2022-09-05,90,90,90,0,1523,1526,1525,1,3,1,1,3,233,233,232,232
Fresno,38,2022-09-05,1085,1085,1085,0,13052,13076,13074,2,162,10,10,16,2863,2863,2853,2853
Glenn,38,2022-09-05,11,11,11,0,188,189,188,1,1,0,0,0,53,53,53,53
Humboldt,38,2022-09-05,110,110,110,0,1294,1296,1295,1,9,1,1,2,159,159,158,158
Imperial,38,2022-09-05,235,235,235,0,2521,2526,2525,1,8,1,1,2,961,961,960,960
Inyo,38,2022-09-05,12,12,12,0,139,140,139,1,0,0,0,1,59,59,59,59
Kern,38,2022-09-05,719,719,719,0,11238,11257,11255,2,50,5,5,8,2414,2414,2409,2409
Kings,38,2022-09-05,229,229,229,0,2869,2874,2873,1,8,0,0,0,461,461,461,461
Lake,38,2022-09-05,62,62,62,0,655,656,655,1,1,3,3,1,148,148,145,145
Lassen,38,2022-09-05,19,19,19,0,633,634,633,1,0,0,0,0,63,63,63,63
Los Angeles,38,2022-09-05,10673,10693,10693,0,222137,222537,222527,10,695,96,96,91,33380,33380,33284,33284
Madera,38,2022-09-05,205,205,205,0,2505,2510,2509,1,12,0,0,4,373,373,373,373
Marin,38,2022-09-05,191,191,191,0,3557,3563,3562,1,12,0,0,1,313,313,313,313
Mariposa,38,2022-09-05,16,16,16,0,166,167,166,1,0,0,0,0,29,29,29,29
Mendocino,38,2022-09-05,57,57,57,0,828,829,828,1,2,1,1,1,136,136,135,135
Merced,38,2022-09-05,251,251,251,0,2637,2642,2641,1,12,2,2,1,861,861,859,859
Modoc,38,2022-09-05,3,3,3,0,17,18,17,1,0,0,0,0,9,9,9,9
Mono,38,2022-09-05,4,4,4,0,52,53,52,1,1,0,0,0,7,7,7,7
Monterey,38,2022-09-05,245,245,245,0,4379,4388,4387,1,24,4,4,0,768,768,764,764
Napa,38,2022-09-05,102,102,102,0,1725,1730,1729,1,6,1,1,2,159,159,158,158
Nevada,38,2022-09-05,81,81,81,0,899,900,899,1,3,0,0,0,135,135,135,135
Orange,38,2022-09-05,2171,2175,2175,0,32128,32185,32182,3,169,13,13,34,7467,7467,7454,7454
Placer,38,2022-09-05,238,238,238,0,3469,3476,3475,1,36,0,0,4,658,658,658,658
Plumas,38,2022-09-05,9,9,9,0,130,131,130,1,0,0,0,0,13,13,13,13
Riverside,38,2022-09-05,2402,2406,2406,0,28561,28614,28610,4,99,7,7,14,6622,6622,6615,6615
Sacramento,38,2022-09-05,1243,1243,1243,0,19661,19697,19694,3,139,12,12,22,3304,3304,3292,3292
San Benito,38,2022-09-05,65,65,65,0,1086,1087,1086,1,0,0,0,2,100,100,100,100
San Bernardino,38,2022-09-05,2333,2337,2337,0,34212,34273,34269,4,122,14,14,19,8067,8067,8053,8053
San Diego,38,2022-09-05,2801,2805,2805,0,48218,48305,48303,2,212,15,15,25,5545,5545,5530,5530
San Francisco,38,2022-09-05,678,678,678,0,15724,15754,15749,5,52,9,9,9,1046,1046,1037,1037
San Joaquin,38,2022-09-05,831,831,831,0,11953,11975,11973,2,43,4,4,10,2324,2324,2320,2320
San Luis Obispo,38,2022-09-05,176,176,176,0,2676,2681,2680,1,7,2,2,1,524,524,522,522
San Mateo,38,2022-09-05,611,611,611,0,13543,13566,13565,1,23,1,1,2,737,737,736,736
Santa Barbara,38,2022-09-05,485,485,485,0,6632,6644,6643,1,39,4,4,3,726,726,722,722
Santa Clara,38,2022-09-05,1892,1896,1896,0,33058,33117,33115,2,127,10,10,20,2507,2507,2497,2497
Santa Cruz,38,2022-09-05,282,282,282,0,10218,10236,10235,1,16,0,0,0,273,273,273,273
Shasta,38,2022-09-05,103,103,103,0,2022,2026,2025,1,15,0,0,0,587,587,587,587
Siskiyou,38,2022-09-05,30,30,30,0,216,217,216,1,0,0,0,0,89,89,89,89
Solano,38,2022-09-05,368,368,368,0,5962,5973,5972,1,34,1,1,11,457,457,456,456
Sonoma,38,2022-09-05,368,368,368,0,6002,6013,6012,1,40,0,0,2,520,520,520,520
Stanislaus,38,2022-09-05,547,547,547,0,6347,6359,6358,1,69,5,5,4,1777,1777,1772,1772
Sutter,38,2022-09-05,118,118,118,0,1482,1485,1484,1,0,0,0,0,232,232,232,232
Tehama,38,2022-09-05,50,50,50,0,581,582,581,1,2,1,1,0,213,213,212,212
Trinity,38,2022-09-05,4,4,4,0,51,52,51,1,0,0,0,0,21,21,21,21
Tulare,38,2022-09-05,429,429,429,0,5163,5171,5170,1,37,2,2,1,1533,1533,1531,1531
Tuolumne,38,2022-09-05,68,68,68,0,737,738,737,1,1,0,0,0,199,199,199,199
Ventura,38,2022-09-05,864,864,864,0,12305,12326,12325,1,48,8,8,1,1586,1586,1578,1578
Yolo,38,2022-09-05,140,140,140,0,2907,2912,2911,1,1,3,3,2,392,392,389,389
Yuba,38,2022-09-05,88,88,88,0,975,976,975,1,14,0,0,1,122,122,122,122
Alameda,39,2022-09-12,1607,1609,1609,0,32011,32072,32069,3,94,5,5,16,2044,2044,2039,2039
Amador,39,2022-09-12,32,32,32,0,873,874,873,1,3,0,0,2,90,90,90,90
Butte,39,2022-09-12,196,196,196,0,2466,2471,2470,1,15,3,3,2,462,462,459,459
Calaveras,39,2022-09-12,14,14,14,0,501,502,501,1,1,0,0,0,133,133,133,133
Colusa,39,2022-09-12,17,17,17,0,414,415,414,1,0,0,0,0,22,22,22,22
Contra Costa,39,2022-09-12,979,979,979,0,17329,17362,17359,3,59,6,6,12,1444,1444,1438,1438
Del Norte,39,2022-09-12,34,34,34,0,595,596,595,1,1,0,0,1,55,55,55,55
El Dorado,39,2022-09-12,104,104,104,0,1899,1904,1903,1,3,0,0,1,233,233,233,233
Fresno,39,2022-09-12,906,906,906,0,14677,14705,14703,2,155,6,6,15,2869,2869,2863,2863
Glenn,39,2022-09-12,15,15,15,0,208,209,208,1,0,0,0,0,53,53,53,53
Humboldt,39,2022-09-12,113,113,113,0,1652,1657,1656,1,6,0,0,5,159,159,159,159
Imperial,39,2022-09-12,258,258,258,0,3287,3293,3292,1,10,0,0,2,961,961,961,961
Inyo,39,2022-09-12,15,15,15,0,194,195,194,1,0,1,1,0,60,60,59,59
Kern,39,2022-09-12,638,638,638,0,12821,12844,12843,1,45,7,7,13,2421,2421,2414,2414
Kings,39,2022-09-12,229,229,229,0,3171,3177,3176,1,6,1,1,0,462,462,461,461
Lake,39,2022-09-12,48,48,48,0,882,883,882,1,3,0,0,1,148,148,148,148
Lassen,39,2022-09-12,20,20,20,0,917,918,917,1,0,0,0,0,63,63,63,63
Los Angeles,39,2022-09-12,10981,11001,11001,0,282702,283234,283224,10,652,85,85,83,33465,33465,33380,33380
Madera,39,2022-09-12,242,242,242,0,2923,2929,2928,1,8,0,0,3,373,373,373,373
Marin,39,2022-09-12,174,174,174,0,3912,3919,3918,1,12,2,2,2,315,315,313,313
Mariposa,39,2022-09-12,16,16,16,0,192,193,192,1,0,0,0,0,29,29,29,29
Mendocino,39,2022-09-12,58,58,58,0,952,953,952,1,2,0,0,1,136,136,136,136
Merced,39,2022-09-12,237,237,237,0,3317,3323,3322,1,6,2,2,1,863,863,861,861
Modoc,39,2022-09-12,2,2,2,0,22,23,22,1,0,0,0,0,9,9,9,9
Mono,39,2022-09-12,7,7,7,0,76,77,76,1,0,0,0,0,7,7,7,7
Monterey,39,2022-09-12,229,229,229,0,5123,5133,5132,1,22,1,1,1,769,769,768,768
Napa,39,2022-09-12,119,119,119,0,2249,2255,2254,1,10,0,0,1,159,159,159,159
Nevada,39,2022-09-12,61,61,61,0,1179,1181,1180,1,2,1,1,0,136,136,135,135
Orange,39,2022-09-12,2093,2098,2098,0,36677,36746,36743,3,159,28,28,22,7495,7495,7467,7467
Placer,39,2022-09-12,239,239,239,0,4074,4081,4080,1,38,0,0,5,658,658,658,658
Plumas,39,2022-09-12,22,22,22,0,194,195,194,1,1,0,0,0,13,13,13,13
Riverside,39,2022-09-12,2249,2254,2254,0,32987,33048,33044,4,124,5,5,12,6627,6627,6622,6622
Sacramento,39,2022-09-12,1275,1276,1276,0,23403,23446,23443,3,119,16,16,15,3320,3320,3304,3304
San Benito,39,2022-09-12,93,93,93,0,1503,1507,1506,1,1,0,0,1,100,100,100,100
San Bernardino,39,2022-09-12,1932,1936,1936,0,38567,38640,38637,3,92,13,13,26,8080,8080,8067,8067
San Diego,39,2022-09-12,3034,3039,3039,0,55707,55811,55809,2,194,7,7,24,5552,5552,5545,5545
San Francisco,39,2022-09-12,814,814,814,0,17415,17447,17443,4,58,8,8,15,1054,1054,1046,1046
San Joaquin,39,2022-09-12,643,643,643,0,14275,14302,14300,2,35,6,6,9,2330,2330,2324,2324
San Luis Obispo,39,2022-09-12,187,187,187,0,3219,3226,3225,1,10,0,0,1,524,524,524,524
San Mateo,39,2022-09-12,658,658,658,0,14181,14209,14208,1,20,1,1,2,738,738,737,737
Santa Barbara,39,2022-09-12,329,329,329,0,7232,7246,7245,1,27,1,1,2,727,727,726,726
Santa Clara,39,2022-09-12,1882,1886,1886,0,38056,38128,38127,1,144,8,8,28,2515,2515,2507,2507
Santa Cruz,39,2022-09-12,272,272,272,0,13346,13371,13370,1,15,0,0,0,273,273,273,273
Shasta,39,2022-09-12,181,181,181,0,2589,2594,2593,1,26,1,1,2,588,588,587,587
Siskiyou,39,2022-09-12,27,27,27,0,289,290,289,1,1,0,0,0,89,89,89,89
Solano,39,2022-09-12,416,416,416,0,6739,6753,6752,1,32,0,0,4,457,457,457,457
Sonoma,39,2022-09-12,398,398,398,0,7021,7035,7034,1,39,3,3,1,523,523,520,520
Stanislaus,39,2022-09-12,447,447,447,0,7741,7755,7754,1,73,1,1,4,1778,1778,1777,1777
Sutter,39,2022-09-12,119,119,119,0,1531,1533,1532,1,0,0,0,0,232,232,232,232
Tehama,39,2022-09-12,48,48,48,0,699,700,699,1,2,0,0,0,213,213,213,213
Trinity,39,2022-09-12,2,2,2,0,74,75,74,1,0,0,0,0,21,21,21,21
Tulare,39,2022-09-12,370,370,370,0,6886,6899,6898,1,39,4,4,0,1537,1537,1533,1533
Tuolumne,39,2022-09-12,61,61,61,0,810,811,810,1,2,0,0,1,199,199,199,199
Ventura,39,2022-09-12,842,842,842,0,14804,14833,14832,1,49,1,1,7,1587,1587,1586,1586
Yolo,39,2022-09-12,143,143,143,0,3453,3461,3460,1,1,2,2,3,394,394,392,392
Yuba,39,2022-09-12,93,93,93,0,1162,1163,1162,1,6,0,0,0,122,122,122,122
Alameda,40,2022-09-19,1227,1227,1227,0,29124,29182,29180,2,80,4,4,7,2048,2048,2044,2044
Amador,40,2022-09-19,33,33,33,0,759,760,759,1,1,3,3,1,93,93,90,90
Butte,40,2022-09-19,121,121,121,0,2119,2124,2123,1,18,0,0,1,462,462,462,462
Calaveras,40,2022-09-19,28,28,28,0,476,477,476,1,0,0,0,0,133,133,133,133
Colusa,40,2022-09-19,13,13,13,0,289,290,289,1,3,0,0,0,22,22,22,22
Contra Costa,40,2022-09-19,826,826,826,0,16772,16806,16804,2,52,8,8,8,1452,1452,1444,1444
Del Norte,40,2022-09-19,22,22,22,0,478,479,478,1,2,0,0,0,55,55,55,55
El Dorado,40,2022-09-19,79,79,79,0,1616,1621,1620,1,3,0,0,0,233,233,233,233
Fresno,40,2022-09-19,605,605,605,0,13301,13328,13327,1,110,7,7,14,2876,2876,2869,2869
Glenn,40,2022-09-19,14,14,14,0,201,202,201,1,2,0,0,0,53,53,53,53
Humboldt,40,2022-09-19,105,105,105,0,1457,1462,1461,1,8,0,0,3,159,159,159,159
Imperial,40,2022-09-19,150,150,150,0,2866,2872,2871,1,11,0,0,2,961,961,961,961
Inyo,40,2022-09-19,8,8,8,0,169,170,169,1,0,0,0,0,60,60,60,60
Kern,40,2022-09-19,439,439,439,0,11535,11558,11557,1,34,2,2,6,2423,2423,2421,2421
Kings,40,2022-09-19,137,137,137,0,2642,2648,2647,1,7,2,2,0,464,464,462,462
Lake,40,2022-09-19,37,37,37,0,903,904,903,1,0,0,0,0,148,148,148,148
Lassen,40,2022-09-19,7,7,7,0,704,705,704,1,0,0,0,0,63,63,63,63
Los Angeles,40,2022-09-19,8527,8544,8544,0,254849,255355,255348,7,564,66,66,69,33531,33531,33465,33465
Madera,40,2022-09-19,109,109,109,0,2691,2697,2696,1,9,1,1,2,374,374,373,373
Marin,40,2022-09-19,137,137,137,0,3701,3709,3708,1,6,0,0,0,315,315,315,315
Mariposa,40,2022-09-19,12,12,12,0,170,171,170,1,0,1,1,0,30,30,29,29
Mendocino,40,2022-09-19,43,43,43,0,928,929,928,1,0,0,0,1,136,136,136,136
Merced,40,2022-09-19,170,170,170,0,2911,2917,2916,1,8,3,3,1,866,866,863,863
Modoc,40,2022-09-19,2,2,2,0,17,18,17,1,0,0,0,0,9,9,9,9
Mono,40,2022-09-19,4,4,4,0,63,64,63,1,0,0,0,0,7,7,7,7
Monterey,40,2022-09-19,162,162,162,0,4268,4277,4276,1,14,1,1,2,770,770,769,769
Napa,40,2022-09-19,101,101,101,0,1772,1778,1777,1,4,0,0,0,159,159,159,159
Nevada,40,2022-09-19,66,66,66,0,1110,1112,1111,1,2,0,0,0,136,136,136,136
Orange,40,2022-09-19,1722,1726,1726,0,33955,34022,34020,2,129,16,16,19,7511,7511,7495,7495
Placer,40,2022-09-19,223,223,223,0,3830,3838,3837,1,51,1,1,4,659,659,658,658
Plumas,40,2022-09-19,22,22,22,0,183,184,183,1,1,0,0,0,13,13,13,13
Riverside,40,2022-09-19,1416,1417,1417,0,29083,29140,29138,2,68,4,4,19,6631,6631,6627,6627
Sacramento,40,2022-09-19,1018,1018,1018,0,21293,21334,21332,2,102,7,7,17,3327,3327,3320,3320
San Benito,40,2022-09-19,54,54,54,0,1231,1234,1233,1,0,0,0,0,100,100,100,100
San Bernardino,40,2022-09-19,1465,1466,1466,0,32531,32595,32593,2,83,7,7,19,8087,8087,8080,8080
San Diego,40,2022-09-19,2563,2569,2569,0,55907,56019,56017,2,175,9,9,19,5561,5561,5552,5552
San Francisco,40,2022-09-19,691,691,691,0,16822,16855,16852,3,43,9,9,11,1063,1063,1054,1054
San Joaquin,40,2022-09-19,457,457,457,0,12858,12884,12883,1,35,5,5,2,2335,2335,2330,2330
San Luis Obispo,40,2022-09-19,155,155,155,0,2764,2770,2769,1,8,0,0,0,524,524,524,524
San Mateo,40,2022-09-19,585,585,585,0,13587,13614,13613,1,20,0,0,2,738,738,738,738
Santa Barbara,40,2022-09-19,269,269,269,0,6790,6803,6802,1,34,2,2,0,729,729,727,727
Santa Clara,40,2022-09-19,1414,1414,1414,0,37023,37096,37095,1,137,7,7,21,2522,2522,2515,2515
Santa Cruz,40,2022-09-19,148,148,148,0,12319,12343,12342,1,5,0,0,1,273,273,273,273
Shasta,40,2022-09-19,100,100,100,0,2112,2117,2116,1,21,0,0,3,588,588,588,588
Siskiyou,40,2022-09-19,21,21,21,0,233,234,233,1,2,1,1,0,90,90,89,89
Solano,40,2022-09-19,274,274,274,0,6128,6141,6140,1,24,1,1,5,458,458,457,457
Sonoma,40,2022-09-19,319,319,319,0,6359,6372,6371,1,27,3,3,1,526,526,523,523
Stanislaus,40,2022-09-19,333,333,333,0,6290,6303,6302,1,57,4,4,4,1782,1782,1778,1778
Sutter,40,2022-09-19,75,75,75,0,1388,1390,1389,1,0,0,0,0,232,232,232,232
Tehama,40,2022-09-19,35,35,35,0,599,600,599,1,2,1,1,0,214,214,213,213
Trinity,40,2022-09-19,3,3,3,0,53,54,53,1,0,0,0,0,21,21,21,21
Tulare,40,2022-09-19,234,234,234,0,5725,5736,5735,1,32,1,1,0,1538,1538,1537,1537
Tuolumne,40,2022-09-19,59,59,59,0,717,718,717,1,0,0,0,0,199,199,199,199
Ventura,40,2022-09-19,615,615,615,0,13372,13398,13397,1,42,2,2,6,1589,1589,1587,1587
Yolo,40,2022-09-19,83,83,83,0,3731,3739,3738,1,2,3,3,2,397,397,394,394
Yuba,40,2022-09-19,60,60,60,0,1029,1030,1029,1,3,0,0,0,122,122,122,122
Alameda,41,2022-09-26,1129,1129,1129,0,27663,27720,27719,1,77,2,2,4,2050,2050,2048,2048
Amador,41,2022-09-26,27,27,27,0,721,722,721,1,1,0,0,1,93,93,93,93
Butte,41,2022-09-26,90,90,90,0,1793,1798,1797,1,23,0,0,1,462,462,462,462
Calaveras,41,2022-09-26,20,20,20,0,390,391,390,1,2,1,1,0,134,134,133,133
Colusa,41,2022-09-26,7,7,7,0,299,300,299,1,1,0,0,0,22,22,22,22
Contra Costa,41,2022-09-26,775,775,775,0,16343,16376,16375,1,48,5,5,7,1457,1457,1452,1452
Del Norte,41,2022-09-26,22,22,22,0,469,470,469,1,2,0,0,0,55,55,55,55
El Dorado,41,2022-09-26,86,86,86,0,1580,1584,1583,1,5,0,0,0,233,233,233,233
Fresno,41,2022-09-26,517,517,517,0,12119,12144,12143,1,84,3,3,13,2879,2879,2876,2876
Glenn,41,2022-09-26,7,7,7,0,176,177,176,1,2,0,0,0,53,53,53,53
Humboldt,41,2022-09-26,98,98,98,0,1311,1314,1313,1,10,2,2,0,161,161,159,159
Imperial,41,2022-09-26,115,115,115,0,2628,2634,2633,1,4,1,1,1,962,962,961,961
Inyo,41,2022-09-26,5,5,5,0,165,166,165,1,0,0,0,0,60,60,60,60
Kern,41,2022-09-26,344,344,344,0,10734,10756,10755,1,32,3,3,7,2426,2426,2423,2423
Kings,41,2022-09-26,107,107,107,0,2620,2626,2625,1,2,0,0,0,464,464,464,464
Lake,41,2022-09-26,26,26,26,0,815,816,815,1,0,0,0,0,148,148,148,148
Lassen,41,2022-09-26,13,13,13,0,533,534,533,1,0,0,0,0,63,63,63,63
Los Angeles,41,2022-09-26,7699,7715,7715,0,239537,240034,240029,5,443,63,63,53,33594,33594,33531,33531
Madera,41,2022-09-26,84,84,84,0,2231,2236,2235,1,8,0,0,2,374,374,374,374
Marin,41,2022-09-26,173,173,173,0,3657,3665,3664,1,10,0,0,0,315,315,315,315
Mariposa,41,2022-09-26,4,4,4,0,155,156,155,1,0,0,0,0,30,30,30,30
Mendocino,41,2022-09-26,41,41,41,0,850,851,850,1,1,0,0,0,136,136,136,136
Merced,41,2022-09-26,127,127,127,0,2854,2860,2859,1,10,1,1,0,867,867,866,866
Modoc,41,2022-09-26,0,0,0,0,13,14,13,1,0,0,0,0,9,9,9,9
Mono,41,2022-09-26,1,1,1,0,60,61,60,1,0,0,0,0,7,7,7,7
Monterey,41,2022-09-26,135,135,135,0,4050,4059,4058,1,14,0,0,2,770,770,770,770
Napa,41,2022-09-26,85,85,85,0,1955,1961,1960,1,5,0,0,1,159,159,159,159
Nevada,41,2022-09-26,49,49,49,0,1077,1079,1078,1,1,0,0,0,136,136,136,136
Orange,41,2022-09-26,1672,1676,1676,0,31082,31148,31146,2,117,19,19,23,7530,7530,7511,7511
Placer,41,2022-09-26,209,209,209,0,3592,3601,3600,1,42,1,1,4,660,660,659,659
Plumas,41,2022-09-26,21,21,21,0,151,152,151,1,1,0,0,0,13,13,13,13
Riverside,41,2022-09-26,1280,1280,1280,0,25783,25838,25836,2,55,8,8,15,6639,6639,6631,6631
Sacramento,41,2022-09-26,918,918,918,0,19151,19191,19190,1,106,11,11,20,3338,3338,3327,3327
San Benito,41,2022-09-26,50,50,50,0,1160,1163,1162,1,0,1,1,2,101,101,100,100
San Bernardino,41,2022-09-26,1217,1218,1218,0,27813,27871,27870,1,75,5,5,12,8092,8092,8087,8087
San Diego,41,2022-09-26,2484,2490,2490,0,50929,51035,51034,1,201,7,7,15,5568,5568,5561,5561
San Francisco,41,2022-09-26,677,677,677,0,16151,16185,16183,2,45,2,2,9,1065,1065,1063,1063
San Joaquin,41,2022-09-26,408,408,408,0,11073,11097,11096,1,35,1,1,3,2336,2336,2335,2335
San Luis Obispo,41,2022-09-26,131,131,131,0,2520,2526,2525,1,7,1,1,0,525,525,524,524
San Mateo,41,2022-09-26,593,593,593,0,13030,13058,13057,1,25,0,0,1,738,738,738,738
Santa Barbara,41,2022-09-26,259,259,259,0,6379,6393,6392,1,22,2,2,0,731,731,729,729
Santa Clara,41,2022-09-26,1363,1364,1364,0,35857,35931,35930,1,113,10,10,17,2532,2532,2522,2522
Santa Cruz,41,2022-09-26,225,225,225,0,12503,12529,12528,1,13,0,0,0,273,273,273,273
Shasta,41,2022-09-26,74,74,74,0,1739,1744,1743,1,14,0,0,3,588,588,588,588
Siskiyou,41,2022-09-26,18,18,18,0,183,184,183,1,1,2,2,0,92,92,90,90
Solano,41,2022-09-26,310,310,310,0,5728,5742,5741,1,23,1,1,2,459,459,458,458
Sonoma,41,2022-09-26,291,291,291,0,6334,6348,6347,1,31,1,1,2,527,527,526,526
Stanislaus,41,2022-09-26,261,261,261,0,5812,5825,5824,1,46,2,2,3,1784,1784,1782,1782
Sutter,41,2022-09-26,69,69,69,0,1146,1148,1147,1,0,0,0,0,232,232,232,232
Tehama,41,2022-09-26,36,36,36,0,550,551,550,1,1,2,2,0,216,216,214,214
Trinity,41,2022-09-26,3,3,3,0,44,45,44,1,0,0,0,0,21,21,21,21
Tulare,41,2022-09-26,168,168,168,0,5090,5101,5100,1,18,3,3,2,1541,1541,1538,1538
Tuolumne,41,2022-09-26,44,44,44,0,689,690,689,1,1,0,0,0,199,199,199,199
Ventura,41,2022-09-26,551,551,551,0,11570,11594,11593,1,33,4,4,1,1593,1593,1589,1589
Yolo,41,2022-09-26,129,129,129,0,3980,3990,3989,1,2,3,3,3,400,400,397,397
Yuba,41,2022-09-26,41,41,41,0,933,934,933,1,6,0,0,1,122,122,122,122
Alameda,42,2022-10-03,1123,1123,1123,0,26140,26197,26196,1,54,3,3,5,2053,2053,2050,2050
Amador,42,2022-10-03,14,14,14,0,690,691,690,1,0,0,0,1,93,93,93,93
Butte,42,2022-10-03,67,67,67,0,1751,1756,1755,1,11,2,2,2,464,464,462,462
Calaveras,42,2022-10-03,19,19,19,0,336,337,336,1,1,0,0,0,134,134,134,134
Colusa,42,2022-10-03,7,7,7,0,188,189,188,1,0,0,0,0,22,22,22,22
Contra Costa,42,2022-10-03,741,741,741,0,15771,15805,15804,1,34,3,3,6,1460,1460,1457,1457
Del Norte,42,2022-10-03,12,12,12,0,382,383,382,1,1,0,0,1,55,55,55,55
El Dorado,42,2022-10-03,80,80,80,0,1449,1454,1453,1,3,0,0,1,233,233,233,233
Fresno,42,2022-10-03,463,463,463,0,11208,11232,11231,1,77,2,2,11,2881,2881,2879,2879
Glenn,42,2022-10-03,7,7,7,0,155,156,155,1,0,0,0,0,53,53,53,53
Humboldt,42,2022-10-03,79,79,79,0,1157,1159,1158,1,6,0,0,1,161,161,161,161
Imperial,42,2022-10-03,140,140,140,0,2565,2571,2570,1,6,0,0,0,962,962,962,962
Inyo,42,2022-10-03,5,5,5,0,159,160,159,1,0,0,0,1,60,60,60,60
Kern,42,2022-10-03,285,285,285,0,9961,9983,9982,1,24,4,4,5,2430,2430,2426,2426
Kings,42,2022-10-03,87,87,87,0,2414,2420,2419,1,2,0,0,0,464,464,464,464
Lake,42,2022-10-03,35,35,35,0,759,760,759,1,3,1,1,0,149,149,148,148
Lassen,42,2022-10-03,7,7,7,0,530,531,530,1,2,0,0,0,63,63,63,63
Los Angeles,42,2022-10-03,7004,7020,7020,0,220229,220707,220703,4,439,50,50,69,33644,33644,33594,33594
Madera,42,2022-10-03,65,65,65,0,1563,1568,1567,1,6,0,0,2,374,374,374,374
Marin,42,2022-10-03,191,191,191,0,3475,3482,3481,1,6,0,0,2,315,315,315,315
Mariposa,42,2022-10-03,5,5,5,0,131,132,131,1,0,0,0,0,30,30,30,30
Mendocino,42,2022-10-03,50,50,50,0,778,779,778,1,4,0,0,0,136,136,136,136
Merced,42,2022-10-03,109,109,109,0,2610,2616,2615,1,5,3,3,1,870,870,867,867
Modoc,42,2022-10-03,2,2,2,0,14,15,14,1,0,0,0,0,9,9,9,9
Mono,42,2022-10-03,4,4,4,0,69,70,69,1,0,0,0,0,7,7,7,7
Monterey,42,2022-10-03,111,111,111,0,3785,3796,3795,1,11,1,1,1,771,771,770,770
Napa,42,2022-10-03,88,88,88,0,1698,1704,1703,1,4,0,0,2,159,159,159,159
Nevada,42,2022-10-03,51,51,51,0,954,956,955,1,1,0,0,4,136,136,136,136
Orange,42,2022-10-03,1532,1536,1536,0,27925,27986,27985,1,131,22,22,16,7552,7552,7530,7530
Placer,42,2022-10-03,208,208,208,0,3336,3344,3343,1,41,2,2,3,662,662,660,660
Plumas,42,2022-10-03,12,12,12,0,107,108,107,1,1,0,0,0,13,13,13,13
Riverside,42,2022-10-03,1138,1138,1138,0,22051,22100,22099,1,59,7,7,12,6646,6646,6639,6639
Sacramento,42,2022-10-03,901,901,901,0,18059,18100,18099,1,88,12,12,19,3350,3350,3338,3338
San Benito,42,2022-10-03,34,34,34,0,1105,1108,1107,1,0,0,0,0,101,101,101,101
San Bernardino,42,2022-10-03,1211,1213,1213,0,24842,24898,24897,1,77,4,4,7,8096,8096,8092,8092
San Diego,42,2022-10-03,2085,2090,2090,0,46607,46708,46707,1,162,9,9,18,5577,5577,5568,5568
San Francisco,42,2022-10-03,646,646,646,0,15333,15365,15363,2,44,3,3,9,1068,1068,1065,1065
San Joaquin,42,2022-10-03,343,343,343,0,9932,9954,9953,1,25,4,4,3,2340,2340,2336,2336
San Luis Obispo,42,2022-10-03,150,150,150,0,2382,2388,2387,1,2,1,1,1,526,526,525,525
San Mateo,42,2022-10-03,549,549,549,0,12299,12327,12326,1,22,0,0,2,738,738,738,738
Santa Barbara,42,2022-10-03,253,253,253,0,6288,6304,6303,1,15,0,0,2,731,731,731,731
Santa Clara,42,2022-10-03,1402,1403,1403,0,32167,32237,32236,1,109,6,6,20,2538,2538,2532,2532
Santa Cruz,42,2022-10-03,227,227,227,0,11229,11254,11253,1,10,0,0,1,273,273,273,273
Shasta,42,2022-10-03,55,55,55,0,1441,1445,1444,1,10,0,0,2,588,588,588,588
Siskiyou,42,2022-10-03,10,10,10,0,204,205,204,1,0,0,0,0,92,92,92,92
Solano,42,2022-10-03,251,251,251,0,5361,5375,5374,1,17,0,0,2,459,459,459,459
Sonoma,42,2022-10-03,323,323,323,0,5932,5945,5944,1,17,0,0,3,527,527,527,527
Stanislaus,42,2022-10-03,200,200,200,0,5353,5367,5366,1,49,1,1,6,1785,1785,1784,1784
Sutter,42,2022-10-03,57,57,57,0,1108,1110,1109,1,0,0,0,0,232,232,232,232
Tehama,42,2022-10-03,20,20,20,0,526,527,526,1,1,0,0,0,216,216,216,216
Trinity,42,2022-10-03,1,1,1,0,43,44,43,1,0,0,0,0,21,21,21,21
Tulare,42,2022-10-03,163,163,163,0,5046,5058,5057,1,19,4,4,1,1545,1545,1541,1541
Tuolumne,42,2022-10-03,26,26,26,0,622,623,622,1,0,1,1,0,200,200,199,199
Ventura,42,2022-10-03,477,477,477,0,10424,10449,10448,1,41,2,2,2,1595,1595,1593,1593
Yolo,42,2022-10-03,122,122,122,0,2988,2995,2994,1,3,2,2,2,402,402,400,400
Yuba,42,2022-10-03,35,35,35,0,801,802,801,1,4,0,0,1,122,122,122,122
Alameda,43,2022-10-10,1133,1133,1133,0,27784,27848,27847,1,45,2,2,7,2055,2055,2053,2053
Amador,43,2022-10-10,15,15,15,0,801,802,801,1,0,0,0,2,93,93,93,93
Butte,43,2022-10-10,65,65,65,0,1750,1754,1753,1,12,3,3,1,466,466,463,463
Calaveras,43,2022-10-10,15,15,15,0,374,375,374,1,0,1,1,0,135,135,134,134
Colusa,43,2022-10-10,1,1,1,0,120,121,120,1,1,0,0,0,22,22,22,22
Contra Costa,43,2022-10-10,774,774,774,0,16851,16890,16889,1,31,7,7,6,1465,1465,1458,1458
Del Norte,43,2022-10-10,10,10,10,0,492,493,492,1,1,0,0,1,55,55,55,55
El Dorado,43,2022-10-10,81,81,81,0,1748,1755,1754,1,7,0,0,4,233,233,233,233
Fresno,43,2022-10-10,483,483,483,0,12471,12498,12497,1,60,3,3,9,2884,2884,2881,2881
Glenn,43,2022-10-10,10,10,10,0,226,227,226,1,1,0,0,0,53,53,53,53
Humboldt,43,2022-10-10,98,98,98,0,1418,1420,1419,1,7,1,1,0,162,162,161,161
Imperial,43,2022-10-10,203,203,203,0,2960,2967,2966,1,7,0,0,0,962,962,962,962
Inyo,43,2022-10-10,4,4,4,0,123,124,123,1,0,0,0,0,60,60,60,60
Kern,43,2022-10-10,325,325,325,0,11655,11683,11682,1,24,2,2,2,2432,2432,2430,2430
Kings,43,2022-10-10,102,102,102,0,2751,2758,2757,1,1,1,1,0,465,465,464,464
Lake,43,2022-10-10,33,33,33,0,920,921,920,1,1,0,0,0,149,149,149,149
Lassen,43,2022-10-10,3,3,3,0,573,574,573,1,0,0,0,0,63,63,63,63
Los Angeles,43,2022-10-10,6734,6748,6748,0,226816,227337,227334,3,436,70,70,51,33706,33706,33636,33636
Madera,43,2022-10-10,68,68,68,0,1717,1723,1722,1,7,1,1,2,375,375,374,374
Marin,43,2022-10-10,207,207,207,0,3777,3785,3784,1,9,0,0,0,315,315,315,315
Mariposa,43,2022-10-10,8,8,8,0,128,129,128,1,0,0,0,0,30,30,30,30
Mendocino,43,2022-10-10,32,32,32,0,973,974,973,1,1,0,0,2,136,136,136,136
Merced,43,2022-10-10,111,111,111,0,2788,2795,2794,1,8,1,1,3,871,871,870,870
Modoc,43,2022-10-10,5,5,5,0,12,13,12,1,0,0,0,0,9,9,9,9
Mono,43,2022-10-10,1,1,1,0,55,56,55,1,0,0,0,0,7,7,7,7
Monterey,43,2022-10-10,108,108,108,0,4372,4385,4384,1,9,0,0,1,771,771,771,771
Napa,43,2022-10-10,78,78,78,0,1766,1772,1771,1,3,0,0,2,159,159,159,159
Nevada,43,2022-10-10,42,42,42,0,980,981,980,1,1,0,0,1,136,136,136,136
Orange,43,2022-10-10,1478,1480,1480,0,29654,29721,29720,1,129,14,14,19,7564,7564,7550,7550
Placer,43,2022-10-10,187,187,187,0,3819,3828,3827,1,24,0,0,7,662,662,662,662
Plumas,43,2022-10-10,20,20,20,0,106,107,106,1,0,0,0,0,13,13,13,13
Riverside,43,2022-10-10,1177,1177,1177,0,23898,23953,23952,1,56,5,5,4,6651,6651,6646,6646
Sacramento,43,2022-10-10,943,943,943,0,20312,20360,20359,1,81,5,5,16,3355,3355,3350,3350
San Benito,43,2022-10-10,35,35,35,0,1267,1271,1270,1,3,0,0,0,101,101,101,101
San Bernardino,43,2022-10-10,1096,1096,1096,0,27130,27193,27192,1,66,0,0,13,8096,8096,8096,8096
San Diego,43,2022-10-10,1991,1997,1997,0,51325,51443,51442,1,130,7,7,21,5582,5582,5575,5575
San Francisco,43,2022-10-10,687,687,687,0,16055,16090,16089,1,37,2,2,9,1070,1070,1068,1068
San Joaquin,43,2022-10-10,431,431,431,0,11577,11603,11602,1,17,2,2,8,2342,2342,2340,2340
San Luis Obispo,43,2022-10-10,88,88,88,0,2567,2574,2573,1,2,2,2,0,528,528,526,526
San Mateo,43,2022-10-10,647,647,647,0,13627,13659,13658,1,19,0,0,0,738,738,738,738
Santa Barbara,43,2022-10-10,242,242,242,0,7841,7860,7859,1,20,1,1,1,732,732,731,731
Santa Clara,43,2022-10-10,1423,1423,1423,0,34088,34168,34167,1,107,4,4,18,2542,2542,2538,2538
Santa Cruz,43,2022-10-10,338,338,338,0,12278,12307,12306,1,9,0,0,1,273,273,273,273
Shasta,43,2022-10-10,99,99,99,0,1292,1295,1294,1,13,3,3,1,591,591,588,588
Siskiyou,43,2022-10-10,9,9,9,0,244,245,244,1,0,1,1,0,93,93,92,92
Solano,43,2022-10-10,333,333,333,0,6280,6297,6296,1,23,0,0,4,459,459,459,459
Sonoma,43,2022-10-10,286,286,286,0,6771,6788,6787,1,15,1,1,3,528,528,527,527
Stanislaus,43,2022-10-10,208,208,208,0,5925,5940,5939,1,51,7,7,7,1790,1790,1783,1783
Sutter,43,2022-10-10,57,57,57,0,1126,1128,1127,1,0,0,0,0,232,232,232,232
Tehama,43,2022-10-10,21,21,21,0,566,567,566,1,1,0,0,0,216,216,216,216
Trinity,43,2022-10-10,1,1,1,0,53,54,53,1,0,0,0,0,21,21,21,21
Tulare,43,2022-10-10,168,168,168,0,4979,4991,4990,1,16,1,1,1,1546,1546,1545,1545
Tuolumne,43,2022-10-10,36,36,36,0,661,662,661,1,1,1,1,0,201,201,200,200
Ventura,43,2022-10-10,430,430,430,0,10969,10997,10996,1,41,4,4,1,1598,1598,1594,1594
Yolo,43,2022-10-10,126,126,126,0,3087,3095,3094,1,4,2,2,0,404,404,402,402
Yuba,43,2022-10-10,23,23,23,0,924,925,924,1,0,0,0,0,122,122,122,122
Alameda,44,2022-10-17,913,913,913,0,24484,24544,24543,1,60,5,5,8,2060,2060,2055,2055
Amador,44,2022-10-17,15,15,15,0,591,592,591,1,1,0,0,0,93,93,93,93
Butte,44,2022-10-17,76,76,76,0,1424,1429,1428,1,13,0,0,0,466,466,466,466
Calaveras,44,2022-10-17,19,19,19,0,306,307,306,1,0,0,0,0,135,135,135,135
Colusa,44,2022-10-17,4,4,4,0,80,81,80,1,0,0,0,0,22,22,22,22
Contra Costa,44,2022-10-17,669,669,669,0,14536,14573,14572,1,30,4,4,6,1469,1469,1465,1465
Del Norte,44,2022-10-17,11,11,11,0,379,380,379,1,1,0,0,0,55,55,55,55
El Dorado,44,2022-10-17,89,89,89,0,1380,1385,1384,1,2,0,0,1,233,233,233,233
Fresno,44,2022-10-17,350,350,350,0,10197,10224,10223,1,62,2,2,11,2886,2886,2884,2884
Glenn,44,2022-10-17,6,6,6,0,141,142,141,1,1,0,0,0,53,53,53,53
Humboldt,44,2022-10-17,70,70,70,0,1146,1149,1148,1,1,0,0,0,162,162,162,162
Imperial,44,2022-10-17,117,117,117,0,2320,2326,2325,1,5,0,0,0,962,962,962,962
Inyo,44,2022-10-17,6,6,6,0,122,123,122,1,1,0,0,0,60,60,60,60
Kern,44,2022-10-17,230,230,230,0,9626,9650,9649,1,32,0,0,1,2432,2432,2432,2432
Kings,44,2022-10-17,70,70,70,0,2320,2326,2325,1,2,1,1,0,466,466,465,465
Lake,44,2022-10-17,25,25,25,0,774,776,775,1,1,0,0,0,149,149,149,149
Lassen,44,2022-10-17,7,7,7,0,513,514,513,1,1,0,0,0,63,63,63,63
Los Angeles,44,2022-10-17,5076,5088,5088,0,188408,188861,188859,2,350,42,42,53,33748,33748,33706,33706
Madera,44,2022-10-17,59,59,59,0,1465,1469,1468,1,3,0,0,2,375,375,375,375
Marin,44,2022-10-17,132,132,132,0,3095,3104,3103,1,8,0,0,1,315,315,315,315
Mariposa,44,2022-10-17,6,6,6,0,119,120,119,1,0,0,0,0,30,30,30,30
Mendocino,44,2022-10-17,48,48,48,0,742,743,742,1,2,0,0,0,136,136,136,136
Merced,44,2022-10-17,129,129,129,0,2343,2349,2348,1,15,0,0,2,871,871,871,871
Modoc,44,2022-10-17,1,1,1,0,7,8,7,1,0,0,0,0,9,9,9,9
Mono,44,2022-10-17,6,6,6,0,41,42,41,1,1,0,0,0,7,7,7,7
Monterey,44,2022-10-17,125,125,125,0,3550,3560,3559,1,12,1,1,1,772,772,771,771
Napa,44,2022-10-17,60,60,60,0,1416,1421,1420,1,2,0,0,1,159,159,159,159
Nevada,44,2022-10-17,49,49,49,0,777,778,777,1,0,0,0,5,136,136,136,136
Orange,44,2022-10-17,1084,1084,1084,0,24751,24810,24809,1,91,21,21,18,7585,7585,7564,7564
Placer,44,2022-10-17,148,148,148,0,2919,2928,2927,1,32,0,0,3,662,662,662,662
Plumas,44,2022-10-17,11,11,11,0,98,99,98,1,0,0,0,0,13,13,13,13
Riverside,44,2022-10-17,885,885,885,0,20669,20718,20717,1,66,2,2,2,6653,6653,6651,6651
Sacramento,44,2022-10-17,853,853,853,0,16072,16110,16109,1,84,9,9,14,3364,3364,3355,3355
San Benito,44,2022-10-17,28,28,28,0,880,882,881,1,0,1,1,0,102,102,101,101
San Bernardino,44,2022-10-17,816,816,816,0,23222,23279,23278,1,63,1,1,9,8097,8097,8096,8096
San Diego,44,2022-10-17,1648,1653,1653,0,43407,43510,43509,1,117,8,8,24,5590,5590,5582,5582
San Francisco,44,2022-10-17,564,564,564,0,14423,14457,14456,1,34,3,3,13,1073,1073,1070,1070
San Joaquin,44,2022-10-17,353,353,353,0,9076,9098,9097,1,8,2,2,8,2344,2344,2342,2342
San Luis Obispo,44,2022-10-17,109,109,109,0,2130,2136,2135,1,4,1,1,0,529,529,528,528
San Mateo,44,2022-10-17,542,542,542,0,11236,11264,11263,1,21,0,0,1,738,738,738,738
Santa Barbara,44,2022-10-17,182,182,182,0,5624,5639,5638,1,18,0,0,2,732,732,732,732
Santa Clara,44,2022-10-17,1136,1136,1136,0,28440,28509,28508,1,93,5,5,16,2547,2547,2542,2542
Santa Cruz,44,2022-10-17,284,284,284,0,10290,10316,10315,1,7,1,1,0,274,274,273,273
Shasta,44,2022-10-17,82,82,82,0,1105,1106,1105,1,12,0,0,2,591,591,591,591
Siskiyou,44,2022-10-17,12,12,12,0,181,182,181,1,2,1,1,0,94,94,93,93
Solano,44,2022-10-17,265,265,265,0,4845,4859,4858,1,25,1,1,3,460,460,459,459
Sonoma,44,2022-10-17,244,244,244,0,5371,5385,5384,1,20,1,1,1,529,529,528,528
Stanislaus,44,2022-10-17,222,222,222,0,5293,5307,5306,1,45,1,1,5,1791,1791,1790,1790
Sutter,44,2022-10-17,40,40,40,0,909,911,910,1,0,0,0,0,232,232,232,232
Tehama,44,2022-10-17,21,21,21,0,396,397,396,1,0,0,0,0,216,216,216,216
Trinity,44,2022-10-17,0,0,0,0,34,35,34,1,0,0,0,0,21,21,21,21
Tulare,44,2022-10-17,136,136,136,0,4270,4281,4280,1,11,1,1,1,1547,1547,1546,1546
Tuolumne,44,2022-10-17,35,35,35,0,620,621,620,1,2,0,0,0,201,201,201,201
Ventura,44,2022-10-17,376,376,376,0,9333,9356,9355,1,32,3,3,1,1601,1601,1598,1598
Yolo,44,2022-10-17,103,103,103,0,2204,2210,2209,1,3,2,2,3,406,406,404,404
Yuba,44,2022-10-17,44,44,44,0,767,768,767,1,1,0,0,0,122,122,122,122
Alameda,45,2022-10-24,925,925,925,0,23194,23254,23253,1,46,8,8,10,2068,2068,2060,2060
Amador,45,2022-10-24,18,18,18,0,635,636,635,1,2,0,0,0,93,93,93,93
Butte,45,2022-10-24,68,68,68,0,1406,1410,1409,1,10,1,1,1,467,467,466,466
Calaveras,45,2022-10-24,20,20,20,0,322,323,322,1,0,0,0,0,135,135,135,135
Colusa,45,2022-10-24,3,3,3,0,95,96,95,1,0,0,0,0,22,22,22,22
Contra Costa,45,2022-10-24,624,624,624,0,13908,13944,13943,1,37,5,5,5,1474,1474,1469,1469
Del Norte,45,2022-10-24,6,6,6,0,361,362,361,1,0,0,0,1,55,55,55,55
El Dorado,45,2022-10-24,91,91,91,0,1519,1525,1524,1,1,0,0,0,233,233,233,233
Fresno,45,2022-10-24,376,376,376,0,9743,9769,9768,1,63,0,0,6,2886,2886,2886,2886
Glenn,45,2022-10-24,9,9,9,0,148,149,148,1,0,0,0,0,53,53,53,53
Humboldt,45,2022-10-24,69,69,69,0,1148,1151,1150,1,7,0,0,2,162,162,162,162
Imperial,45,2022-10-24,96,96,96,0,2344,2350,2349,1,8,1,1,0,963,963,962,962
Inyo,45,2022-10-24,8,8,8,0,272,273,272,1,0,0,0,0,60,60,60,60
Kern,45,2022-10-24,269,269,269,0,9631,9658,9657,1,24,2,2,2,2434,2434,2432,2432
Kings,45,2022-10-24,88,88,88,0,2338,2344,2343,1,8,0,0,0,466,466,466,466
Lake,45,2022-10-24,22,22,22,0,643,644,643,1,1,1,1,1,150,150,149,149
Lassen,45,2022-10-24,16,16,16,0,484,485,484,1,1,0,0,0,63,63,63,63
Los Angeles,45,2022-10-24,5316,5329,5329,0,186077,186550,186548,2,332,54,54,43,33802,33802,33748,33748
Madera,45,2022-10-24,61,61,61,0,1388,1393,1392,1,4,0,0,2,375,375,375,375
Marin,45,2022-10-24,138,138,138,0,3079,3088,3087,1,12,1,1,2,316,316,315,315
Mariposa,45,2022-10-24,12,12,12,0,120,121,120,1,0,0,0,0,30,30,30,30
Mendocino,45,2022-10-24,42,42,42,0,770,771,770,1,2,0,0,0,136,136,136,136
Merced,45,2022-10-24,88,88,88,0,2409,2415,2414,1,7,3,3,3,874,874,871,871
Modoc,45,2022-10-24,1,1,1,0,13,14,13,1,0,0,0,0,9,9,9,9
Mono,45,2022-10-24,3,3,3,0,63,64,63,1,0,1,1,0,8,8,7,7
Monterey,45,2022-10-24,131,131,131,0,3718,3729,3728,1,18,0,0,0,772,772,772,772
Napa,45,2022-10-24,51,51,51,0,1467,1473,1472,1,3,0,0,0,159,159,159,159
Nevada,45,2022-10-24,38,38,38,0,784,786,785,1,6,0,0,0,136,136,136,136
Orange,45,2022-10-24,1129,1131,1131,0,25652,25718,25717,1,84,12,12,14,7597,7597,7585,7585
Placer,45,2022-10-24,190,190,190,0,3026,3035,3034,1,39,0,0,6,662,662,662,662
Plumas,45,2022-10-24,12,12,12,0,91,92,91,1,0,0,0,0,13,13,13,13
Riverside,45,2022-10-24,919,919,919,0,20049,20100,20099,1,53,0,0,6,6653,6653,6653,6653
Sacramento,45,2022-10-24,798,798,798,0,15200,15238,15237,1,84,5,5,19,3369,3369,3364,3364
San Benito,45,2022-10-24,41,41,41,0,844,845,844,1,0,0,0,1,102,102,102,102
San Bernardino,45,2022-10-24,778,778,778,0,21411,21466,21465,1,39,3,3,10,8100,8100,8097,8097
San Diego,45,2022-10-24,1684,1688,1688,0,41861,41968,41967,1,83,5,5,18,5595,5595,5590,5590
San Francisco,45,2022-10-24,508,508,508,0,13870,13906,13905,1,35,1,1,5,1074,1074,1073,1073
San Joaquin,45,2022-10-24,271,271,271,0,8493,8516,8515,1,13,2,2,3,2346,2346,2344,2344
San Luis Obispo,45,2022-10-24,89,89,89,0,2053,2059,2058,1,2,0,0,0,529,529,529,529
San Mateo,45,2022-10-24,466,466,466,0,11067,11097,11096,1,19,0,0,2,738,738,738,738
Santa Barbara,45,2022-10-24,164,164,164,0,5728,5744,5743,1,19,2,2,4,734,734,732,732
Santa Clara,45,2022-10-24,1181,1183,1183,0,29140,29216,29215,1,92,3,3,9,2550,2550,2547,2547
Santa Cruz,45,2022-10-24,240,240,240,0,10202,10230,10229,1,14,1,1,0,275,275,274,274
Shasta,45,2022-10-24,73,73,73,0,983,985,984,1,5,0,0,2,591,591,591,591
Siskiyou,45,2022-10-24,12,12,12,0,171,172,171,1,0,0,0,0,94,94,94,94
Solano,45,2022-10-24,239,239,239,0,5023,5037,5036,1,20,0,0,1,460,460,460,460
Sonoma,45,2022-10-24,246,246,246,0,5438,5452,5451,1,23,0,0,1,529,529,529,529
Stanislaus,45,2022-10-24,199,199,199,0,4851,4865,4864,1,40,3,3,3,1794,1794,1791,1791
Sutter,45,2022-10-24,28,28,28,0,881,883,882,1,0,0,0,0,232,232,232,232
Tehama,45,2022-10-24,36,36,36,0,405,406,405,1,1,0,0,0,216,216,216,216
Trinity,45,2022-10-24,1,1,1,0,35,36,35,1,0,0,0,0,21,21,21,21
Tulare,45,2022-10-24,110,110,110,0,4341,4352,4351,1,16,1,1,1,1548,1548,1547,1547
Tuolumne,45,2022-10-24,33,33,33,0,625,626,625,1,1,1,1,0,202,202,201,201
Ventura,45,2022-10-24,293,293,293,0,9021,9045,9044,1,40,3,3,6,1604,1604,1601,1601
Yolo,45,2022-10-24,91,91,91,0,2042,2048,2047,1,5,1,1,0,407,407,406,406
Yuba,45,2022-10-24,51,51,51,0,799,800,799,1,5,0,0,1,122,122,122,122
Alameda,46,2022-10-31,1030,1031,1031,0,22825,22888,22887,1,57,5,5,4,2073,2073,2068,2068
Amador,46,2022-10-31,18,18,18,0,577,578,577,1,2,1,1,0,94,94,93,93
Butte,46,2022-10-31,82,82,82,0,1458,1464,1463,1,11,0,0,3,467,467,467,467
Calaveras,46,2022-10-31,13,13,13,0,257,258,257,1,0,0,0,0,135,135,135,135
Colusa,46,2022-10-31,11,11,11,0,95,96,95,1,0,0,0,0,22,22,22,22
Contra Costa,46,2022-10-31,748,748,748,0,13885,13923,13922,1,37,6,6,7,1480,1480,1474,1474
Del Norte,46,2022-10-31,16,16,16,0,357,358,357,1,1,0,0,0,55,55,55,55
El Dorado,46,2022-10-31,100,100,100,0,1404,1410,1409,1,2,0,0,0,233,233,233,233
Fresno,46,2022-10-31,426,426,426,0,10495,10524,10523,1,57,4,4,8,2890,2890,2886,2886
Glenn,46,2022-10-31,16,16,16,0,156,157,156,1,1,0,0,0,53,53,53,53
Humboldt,46,2022-10-31,44,44,44,0,1019,1022,1021,1,6,0,0,2,162,162,162,162
Imperial,46,2022-10-31,126,126,126,0,2786,2795,2794,1,7,0,0,0,963,963,963,963
Inyo,46,2022-10-31,7,7,7,0,242,243,242,1,0,0,0,0,60,60,60,60
Kern,46,2022-10-31,330,330,330,0,9783,9810,9809,1,20,2,2,2,2436,2436,2434,2434
Kings,46,2022-10-31,118,118,118,0,2460,2467,2466,1,3,0,0,1,466,466,466,466
Lake,46,2022-10-31,30,30,30,0,752,753,752,1,1,0,0,1,150,150,150,150
Lassen,46,2022-10-31,19,19,19,0,522,523,522,1,1,0,0,0,63,63,63,63
Los Angeles,46,2022-10-31,6208,6225,6225,0,191253,191771,191769,2,344,37,37,44,33839,33839,33802,33802
Madera,46,2022-10-31,54,54,54,0,1433,1437,1436,1,3,0,0,2,375,375,375,375
Marin,46,2022-10-31,137,137,137,0,3505,3517,3516,1,10,1,1,1,317,317,316,316
Mariposa,46,2022-10-31,8,8,8,0,126,127,126,1,0,0,0,0,30,30,30,30
Mendocino,46,2022-10-31,23,23,23,0,709,710,709,1,1,0,0,2,136,136,136,136
Merced,46,2022-10-31,114,114,114,0,2138,2144,2143,1,5,1,1,0,875,875,874,874
Modoc,46,2022-10-31,1,1,1,0,13,14,13,1,0,0,0,0,9,9,9,9
Mono,46,2022-10-31,1,1,1,0,85,86,85,1,1,0,0,0,8,8,8,8
Monterey,46,2022-10-31,150,150,150,0,3688,3699,3698,1,18,2,2,0,774,774,772,772
Napa,46,2022-10-31,54,54,54,0,1505,1511,1510,1,2,0,0,0,159,159,159,159
Nevada,46,2022-10-31,37,37,37,0,774,776,775,1,6,0,0,0,136,136,136,136
Orange,46,2022-10-31,1152,1154,1154,0,26767,26839,26838,1,91,14,14,14,7611,7611,7597,7597
Placer,46,2022-10-31,149,149,149,0,2746,2754,2753,1,40,0,0,5,662,662,662,662
Plumas,46,2022-10-31,5,5,5,0,87,88,87,1,0,0,0,0,13,13,13,13
Riverside,46,2022-10-31,1029,1030,1030,0,19442,19494,19493,1,64,5,5,5,6658,6658,6653,6653
Sacramento,46,2022-10-31,730,730,730,0,14046,14084,14083,1,80,8,8,16,3377,3377,3369,3369
San Benito,46,2022-10-31,33,33,33,0,744,745,744,1,1,0,0,1,102,102,102,102
San Bernardino,46,2022-10-31,1030,1031,1031,0,22281,22341,22340,1,64,2,2,11,8102,8102,8100,8100
San Diego,46,2022-10-31,1772,1778,1778,0,42543,42657,42656,1,109,5,5,13,5600,5600,5595,5595
San Francisco,46,2022-10-31,615,615,615,0,14584,14623,14622,1,45,3,3,3,1077,1077,1074,1074
San Joaquin,46,2022-10-31,330,330,330,0,8592,8617,8616,1,21,6,6,3,2352,2352,2346,2346
San Luis Obispo,46,2022-10-31,81,81,81,0,2010,2016,2015,1,1,1,1,0,530,530,529,529
San Mateo,46,2022-10-31,511,511,511,0,11505,11537,11536,1,30,0,0,2,738,738,738,738
Santa Barbara,46,2022-10-31,181,181,181,0,6033,6050,6049,1,20,1,1,6,735,735,734,734
Santa Clara,46,2022-10-31,1257,1260,1260,0,30687,30771,30770,1,85,3,3,16,2553,2553,2550,2550
Santa Cruz,46,2022-10-31,188,188,188,0,9953,9982,9981,1,7,0,0,0,275,275,275,275
Shasta,46,2022-10-31,64,64,64,0,829,830,829,1,6,2,2,1,593,593,591,591
Siskiyou,46,2022-10-31,17,17,17,0,216,217,216,1,1,1,1,0,95,95,94,94
Solano,46,2022-10-31,312,312,312,0,5250,5264,5263,1,16,0,0,4,460,460,460,460
Sonoma,46,2022-10-31,205,205,205,0,5598,5614,5613,1,24,0,0,3,529,529,529,529
Stanislaus,46,2022-10-31,234,234,234,0,4830,4843,4842,1,49,1,1,8,1795,1795,1794,1794
Sutter,46,2022-10-31,55,55,55,0,901,903,902,1,0,0,0,0,232,232,232,232
Tehama,46,2022-10-31,26,26,26,0,395,396,395,1,1,0,0,0,216,216,216,216
Trinity,46,2022-10-31,18,18,18,0,73,74,73,1,5,0,0,0,21,21,21,21
Tulare,46,2022-10-31,153,153,153,0,3675,3685,3684,1,12,0,0,0,1548,1548,1548,1548
Tuolumne,46,2022-10-31,27,27,27,0,518,519,518,1,3,0,0,0,202,202,202,202
Ventura,46,2022-10-31,377,377,377,0,9538,9564,9563,1,24,2,2,2,1606,1606,1604,1604
Yolo,46,2022-10-31,82,82,82,0,1825,1831,1830,1,3,0,0,1,407,407,407,407
Yuba,46,2022-10-31,46,46,46,0,775,776,775,1,3,0,0,0,122,122,122,122
Alameda,47,2022-11-07,1304,1309,1309,0,24308,24381,24380,1,58,8,8,11,2081,2081,2073,2073
Amador,47,2022-11-07,32,32,32,0,685,687,686,1,3,0,0,0,94,94,94,94
Butte,47,2022-11-07,119,119,119,0,1369,1375,1374,1,11,0,0,2,467,467,467,467
Calaveras,47,2022-11-07,16,16,16,0,333,334,333,1,0,0,0,0,135,135,135,135
Colusa,47,2022-11-07,2,2,2,0,102,103,102,1,0,0,0,0,22,22,22,22
Contra Costa,47,2022-11-07,879,879,879,0,15661,15707,15706,1,43,3,3,4,1483,1483,1480,1480
Del Norte,47,2022-11-07,10,10,10,0,400,401,400,1,0,0,0,0,55,55,55,55
El Dorado,47,2022-11-07,108,108,108,0,1598,1604,1603,1,7,2,2,0,235,235,233,233
Fresno,47,2022-11-07,598,598,598,0,10701,10733,10732,1,61,3,3,9,2893,2893,2890,2890
Glenn,47,2022-11-07,29,29,29,0,131,132,131,1,0,0,0,0,53,53,53,53
Humboldt,47,2022-11-07,85,85,85,0,1022,1026,1025,1,9,0,0,2,162,162,162,162
Imperial,47,2022-11-07,209,209,209,0,3708,3721,3720,1,7,0,0,0,963,963,963,963
Inyo,47,2022-11-07,19,19,19,0,264,265,264,1,0,0,0,0,60,60,60,60
Kern,47,2022-11-07,454,454,454,0,10640,10671,10670,1,29,1,1,5,2437,2437,2436,2436
Kings,47,2022-11-07,149,149,149,0,2457,2465,2464,1,7,1,1,0,467,467,466,466
Lake,47,2022-11-07,51,51,51,0,795,797,796,1,3,0,0,1,150,150,150,150
Lassen,47,2022-11-07,10,10,10,0,451,452,451,1,0,0,0,0,63,63,63,63
Los Angeles,47,2022-11-07,8082,8105,8105,0,191143,191703,191701,2,387,55,55,53,33894,33894,33839,33839
Madera,47,2022-11-07,78,78,78,0,1612,1619,1618,1,3,0,0,4,375,375,375,375
Marin,47,2022-11-07,152,152,152,0,3367,3379,3378,1,9,0,0,0,317,317,317,317
Mariposa,47,2022-11-07,14,14,14,0,121,122,121,1,0,0,0,0,30,30,30,30
Mendocino,47,2022-11-07,37,37,37,0,819,820,819,1,4,1,1,0,137,137,136,136
Merced,47,2022-11-07,142,142,142,0,2592,2600,2599,1,9,4,4,0,879,879,875,875
Modoc,47,2022-11-07,2,2,2,0,6,7,6,1,0,0,0,0,9,9,9,9
Mono,47,2022-11-07,3,3,3,0,96,97,96,1,0,0,0,0,8,8,8,8
Monterey,47,2022-11-07,219,219,219,0,3931,3943,3942,1,18,1,1,0,775,775,774,774
Napa,47,2022-11-07,77,77,77,0,1756,1762,1761,1,6,0,0,0,159,159,159,159
Nevada,47,2022-11-07,60,60,60,0,743,745,744,1,3,0,0,1,136,136,136,136
Orange,47,2022-11-07,1248,1252,1252,0,28539,28623,28622,1,94,11,11,20,7622,7622,7611,7611
Placer,47,2022-11-07,228,228,228,0,3331,3341,3340,1,53,2,2,7,664,664,662,662
Plumas,47,2022-11-07,5,5,5,0,69,70,69,1,0,0,0,0,13,13,13,13
Riverside,47,2022-11-07,1492,1499,1499,0,21551,21613,21612,1,71,2,2,5,6660,6660,6658,6658
Sacramento,47,2022-11-07,1090,1092,1092,0,15903,15949,15948,1,90,7,7,9,3384,3384,3377,3377
San Benito,47,2022-11-07,43,43,43,0,924,927,926,1,1,0,0,0,102,102,102,102
San Bernardino,47,2022-11-07,1431,1436,1436,0,23833,23902,23901,1,76,2,2,17,8104,8104,8102,8102
San Diego,47,2022-11-07,2155,2163,2163,0,45390,45522,45521,1,117,8,8,24,5608,5608,5600,5600
San Francisco,47,2022-11-07,714,714,714,0,14870,14914,14913,1,42,2,2,8,1079,1079,1077,1077
San Joaquin,47,2022-11-07,482,482,482,0,8807,8833,8832,1,24,2,2,3,2354,2354,2352,2352
San Luis Obispo,47,2022-11-07,130,130,130,0,2269,2275,2274,1,4,0,0,2,530,530,530,530
San Mateo,47,2022-11-07,566,566,566,0,12247,12283,12282,1,27,0,0,3,738,738,738,738
Santa Barbara,47,2022-11-07,226,226,226,0,6670,6690,6689,1,18,1,1,2,736,736,735,735
Santa Clara,47,2022-11-07,1627,1634,1634,0,31249,31341,31340,1,76,7,7,19,2560,2560,2553,2553
Santa Cruz,47,2022-11-07,282,282,282,0,11332,11367,11366,1,8,0,0,0,275,275,275,275
Shasta,47,2022-11-07,95,95,95,0,1052,1055,1054,1,11,1,1,3,594,594,593,593
Siskiyou,47,2022-11-07,15,15,15,0,295,296,295,1,1,0,0,0,95,95,95,95
Solano,47,2022-11-07,384,384,384,0,5515,5533,5532,1,22,2,2,3,462,462,460,460
Sonoma,47,2022-11-07,250,250,250,0,5931,5950,5949,1,11,2,2,2,531,531,529,529
Stanislaus,47,2022-11-07,300,300,300,0,4929,4943,4942,1,42,2,2,9,1797,1797,1795,1795
Sutter,47,2022-11-07,86,86,86,0,958,960,959,1,0,0,0,0,232,232,232,232
Tehama,47,2022-11-07,47,47,47,0,472,473,472,1,2,0,0,0,216,216,216,216
Trinity,47,2022-11-07,2,2,2,0,34,35,34,1,0,0,0,0,21,21,21,21
Tulare,47,2022-11-07,160,160,160,0,4365,4381,4380,1,14,0,0,0,1548,1548,1548,1548
Tuolumne,47,2022-11-07,82,82,82,0,681,682,681,1,2,0,0,0,202,202,202,202
Ventura,47,2022-11-07,446,446,446,0,10368,10399,10398,1,36,2,2,1,1608,1608,1606,1606
Yolo,47,2022-11-07,173,173,173,0,2237,2245,2244,1,3,2,2,0,409,409,407,407
Yuba,47,2022-11-07,47,47,47,0,902,904,903,1,3,0,0,2,122,122,122,122
Alameda,48,2022-11-14,1469,1474,1474,0,24070,24145,24144,1,77,3,3,9,2084,2084,2081,2081
Amador,48,2022-11-14,20,20,20,0,656,658,657,1,2,0,0,0,94,94,94,94
Butte,48,2022-11-14,119,119,119,0,1378,1383,1382,1,20,0,0,1,467,467,467,467
Calaveras,48,2022-11-14,30,30,30,0,341,342,341,1,0,0,0,0,135,135,135,135
Colusa,48,2022-11-14,11,11,11,0,100,101,100,1,1,0,0,0,22,22,22,22
Contra Costa,48,2022-11-14,967,968,968,0,15937,15987,15986,1,56,1,1,5,1484,1484,1483,1483
Del Norte,48,2022-11-14,20,20,20,0,429,430,429,1,1,0,0,0,55,55,55,55
El Dorado,48,2022-11-14,143,143,143,0,1590,1596,1595,1,7,0,0,1,235,235,235,235
Fresno,48,2022-11-14,771,772,772,0,11264,11299,11298,1,72,8,8,13,2901,2901,2893,2893
Glenn,48,2022-11-14,20,20,20,0,160,161,160,1,0,0,0,0,53,53,53,53
Humboldt,48,2022-11-14,86,86,86,0,1103,1108,1107,1,6,0,0,0,162,162,162,162
Imperial,48,2022-11-14,251,251,251,0,3221,3232,3231,1,4,0,0,1,963,963,963,963
Inyo,48,2022-11-14,11,11,11,0,542,543,542,1,0,0,0,0,60,60,60,60
Kern,48,2022-11-14,445,445,445,0,10602,10635,10634,1,26,1,1,6,2438,2438,2437,2437
Kings,48,2022-11-14,201,201,201,0,2624,2634,2633,1,6,2,2,0,469,469,467,467
Lake,48,2022-11-14,54,54,54,0,803,805,804,1,2,0,0,1,150,150,150,150
Lassen,48,2022-11-14,35,35,35,0,544,545,544,1,0,1,1,0,64,64,63,63
Los Angeles,48,2022-11-14,9388,9417,9417,0,195663,196278,196276,2,477,49,49,75,33943,33943,33894,33894
Madera,48,2022-11-14,95,95,95,0,1712,1720,1719,1,4,0,0,3,375,375,375,375
Marin,48,2022-11-14,175,175,175,0,3569,3581,3580,1,8,0,0,2,317,317,317,317
Mariposa,48,2022-11-14,18,18,18,0,137,138,137,1,0,0,0,0,30,30,30,30
Mendocino,48,2022-11-14,39,39,39,0,908,910,909,1,3,0,0,1,137,137,137,137
Merced,48,2022-11-14,186,186,186,0,2638,2647,2646,1,6,0,0,0,879,879,879,879
Modoc,48,2022-11-14,3,3,3,0,11,12,11,1,0,0,0,0,9,9,9,9
Mono,48,2022-11-14,10,10,10,0,122,123,122,1,0,0,0,0,8,8,8,8
Monterey,48,2022-11-14,200,200,200,0,4156,4169,4168,1,20,1,1,1,776,776,775,775
Napa,48,2022-11-14,105,105,105,0,1918,1924,1923,1,5,0,0,0,159,159,159,159
Nevada,48,2022-11-14,65,65,65,0,797,799,798,1,3,0,0,2,136,136,136,136
Orange,48,2022-11-14,1560,1567,1567,0,26772,26856,26855,1,118,8,8,21,7630,7630,7622,7622
Placer,48,2022-11-14,313,313,313,0,3834,3848,3847,1,54,1,1,5,665,665,664,664
Plumas,48,2022-11-14,4,4,4,0,79,80,79,1,0,0,0,0,13,13,13,13
Riverside,48,2022-11-14,1642,1649,1649,0,22363,22434,22433,1,95,4,4,10,6664,6664,6660,6660
Sacramento,48,2022-11-14,1182,1187,1187,0,16853,16905,16904,1,82,6,6,18,3390,3390,3384,3384
San Benito,48,2022-11-14,42,42,42,0,979,982,981,1,1,0,0,0,102,102,102,102
San Bernardino,48,2022-11-14,1780,1787,1787,0,23980,24056,24055,1,83,0,0,14,8104,8104,8104,8104
San Diego,48,2022-11-14,2455,2463,2463,0,43498,43634,43633,1,124,7,7,21,5615,5615,5608,5608
San Francisco,48,2022-11-14,710,710,710,0,13676,13719,13718,1,52,7,7,5,1086,1086,1079,1079
San Joaquin,48,2022-11-14,609,609,609,0,9500,9531,9530,1,20,0,0,5,2354,2354,2354,2354
San Luis Obispo,48,2022-11-14,121,121,121,0,2200,2209,2208,1,6,0,0,1,530,530,530,530
San Mateo,48,2022-11-14,639,639,639,0,11297,11334,11333,1,27,0,0,2,738,738,738,738
Santa Barbara,48,2022-11-14,192,192,192,0,5891,5912,5911,1,15,1,1,2,737,737,736,736
Santa Clara,48,2022-11-14,1730,1737,1737,0,30462,30561,30560,1,117,3,3,14,2563,2563,2560,2560
Santa Cruz,48,2022-11-14,249,249,249,0,9602,9633,9632,1,11,1,1,0,276,276,275,275
Shasta,48,2022-11-14,101,101,101,0,1070,1073,1072,1,10,1,1,2,595,595,594,594
Siskiyou,48,2022-11-14,27,27,27,0,397,398,397,1,2,0,0,0,95,95,95,95
Solano,48,2022-11-14,439,439,439,0,5419,5438,5437,1,26,0,0,3,462,462,462,462
Sonoma,48,2022-11-14,268,268,268,0,6034,6054,6053,1,23,1,1,0,532,532,531,531
Stanislaus,48,2022-11-14,328,328,328,0,5222,5239,5238,1,48,0,0,10,1797,1797,1797,1797
Sutter,48,2022-11-14,95,95,95,0,1182,1187,1186,1,0,0,0,0,232,232,232,232
Tehama,48,2022-11-14,49,49,49,0,574,575,574,1,1,0,0,0,216,216,216,216
Trinity,48,2022-11-14,11,11,11,0,52,53,52,1,0,1,1,0,22,22,21,21
Tulare,48,2022-11-14,308,308,308,0,4283,4298,4297,1,16,0,0,1,1548,1548,1548,1548
Tuolumne,48,2022-11-14,77,77,77,0,695,696,695,1,2,0,0,0,202,202,202,202
Ventura,48,2022-11-14,573,573,573,0,10629,10663,10662,1,28,1,1,4,1609,1609,1608,1608
Yolo,48,2022-11-14,152,152,152,0,2158,2166,2165,1,2,6,6,0,415,415,409,409
Yuba,48,2022-11-14,60,60,60,0,987,991,990,1,6,0,0,1,122,122,122,122
Alameda,49,2022-11-21,1708,1715,1715,0,25225,25313,25312,1,82,9,9,16,2093,2093,2084,2084
Amador,49,2022-11-21,28,28,28,0,833,836,835,1,2,0,0,0,94,94,94,94
Butte,49,2022-11-21,143,143,143,0,1327,1333,1332,1,21,0,0,1,467,467,467,467
Calaveras,49,2022-11-21,40,40,40,0,421,422,421,1,2,0,0,0,135,135,135,135
Colusa,49,2022-11-21,9,9,9,0,110,111,110,1,0,0,0,0,22,22,22,22
Contra Costa,49,2022-11-21,1028,1031,1031,0,16512,16570,16569,1,52,3,3,8,1487,1487,1484,1484
Del Norte,49,2022-11-21,18,18,18,0,489,490,489,1,4,0,0,0,55,55,55,55
El Dorado,49,2022-11-21,186,186,186,0,1827,1835,1834,1,10,0,0,1,235,235,235,235
Fresno,49,2022-11-21,1068,1072,1072,0,12140,12183,12182,1,114,5,5,9,2906,2906,2901,2901
Glenn,49,2022-11-21,21,21,21,0,214,215,214,1,0,0,0,0,53,53,53,53
Humboldt,49,2022-11-21,123,123,123,0,1172,1177,1176,1,4,1,1,1,163,163,162,162
Imperial,49,2022-11-21,280,280,280,0,3123,3137,3136,1,3,1,1,1,964,964,963,963
Inyo,49,2022-11-21,29,29,29,0,402,403,402,1,0,1,1,0,61,61,60,60
Kern,49,2022-11-21,483,483,483,0,10095,10130,10129,1,54,3,3,10,2441,2441,2438,2438
Kings,49,2022-11-21,295,295,295,0,2779,2790,2789,1,4,2,2,1,471,471,469,469
Lake,49,2022-11-21,55,55,55,0,928,932,931,1,0,1,1,1,151,151,150,150
Lassen,49,2022-11-21,34,34,34,0,540,542,541,1,0,0,0,0,64,64,64,64
Los Angeles,49,2022-11-21,13166,13212,13212,0,198282,198972,198970,2,648,69,69,93,34012,34012,33943,33943
Madera,49,2022-11-21,168,168,168,0,1861,1869,1868,1,11,0,0,1,375,375,375,375
Marin,49,2022-11-21,179,179,179,0,3351,3364,3363,1,8,0,0,0,317,317,317,317
Mariposa,49,2022-11-21,19,19,19,0,170,171,170,1,0,0,0,0,30,30,30,30
Mendocino,49,2022-11-21,38,38,38,0,889,891,890,1,4,0,0,1,137,137,137,137
Merced,49,2022-11-21,269,269,269,0,2931,2943,2942,1,9,2,2,4,881,881,879,879
Modoc,49,2022-11-21,8,8,8,0,13,14,13,1,0,0,0,0,9,9,9,9
Mono,49,2022-11-21,3,3,3,0,107,108,107,1,0,0,0,0,8,8,8,8
Monterey,49,2022-11-21,228,228,228,0,4442,4457,4456,1,17,1,1,0,777,777,776,776
Napa,49,2022-11-21,145,145,145,0,2037,2045,2044,1,4,0,0,1,159,159,159,159
Nevada,49,2022-11-21,92,92,92,0,933,936,935,1,2,0,0,2,136,136,136,136
Orange,49,2022-11-21,2162,2170,2170,0,28140,28240,28239,1,170,14,14,32,7644,7644,7630,7630
Placer,49,2022-11-21,361,361,361,0,4059,4073,4072,1,53,0,0,6,665,665,665,665
Plumas,49,2022-11-21,7,7,7,0,104,105,104,1,1,0,0,0,13,13,13,13
Riverside,49,2022-11-21,2144,2152,2152,0,24363,24448,24447,1,110,7,7,9,6671,6671,6664,6664
Sacramento,49,2022-11-21,1521,1527,1527,0,18921,18987,18986,1,105,3,3,18,3393,3393,3390,3390
San Benito,49,2022-11-21,64,64,64,0,1154,1159,1158,1,2,0,0,0,102,102,102,102
San Bernardino,49,2022-11-21,2333,2341,2341,0,26601,26693,26692,1,89,1,1,19,8105,8105,8104,8104
San Diego,49,2022-11-21,3171,3183,3183,0,43786,43939,43938,1,198,3,3,26,5618,5618,5615,5615
San Francisco,49,2022-11-21,943,944,944,0,15065,15119,15118,1,54,5,5,7,1091,1091,1086,1086
San Joaquin,49,2022-11-21,763,763,763,0,11077,11115,11114,1,36,1,1,5,2355,2355,2354,2354
San Luis Obispo,49,2022-11-21,170,170,170,0,2350,2359,2358,1,4,1,1,0,531,531,530,530
San Mateo,49,2022-11-21,740,741,741,0,12300,12345,12344,1,36,0,0,1,738,738,738,738
Santa Barbara,49,2022-11-21,321,321,321,0,6106,6129,6128,1,15,3,3,3,740,740,737,737
Santa Clara,49,2022-11-21,2153,2160,2160,0,34256,34377,34376,1,119,10,10,23,2573,2573,2563,2563
Santa Cruz,49,2022-11-21,286,286,286,0,9522,9557,9556,1,12,0,0,2,276,276,276,276
Shasta,49,2022-11-21,91,91,91,0,1051,1056,1055,1,14,0,0,1,595,595,595,595
Siskiyou,49,2022-11-21,24,24,24,0,342,343,342,1,1,0,0,0,95,95,95,95
Solano,49,2022-11-21,491,491,491,0,5667,5687,5686,1,32,1,1,5,463,463,462,462
Sonoma,49,2022-11-21,326,326,326,0,5780,5800,5799,1,22,0,0,4,532,532,532,532
Stanislaus,49,2022-11-21,445,445,445,0,5969,5990,5989,1,51,0,0,10,1797,1797,1797,1797
Sutter,49,2022-11-21,91,91,91,0,1139,1144,1143,1,0,0,0,0,232,232,232,232
Tehama,49,2022-11-21,72,72,72,0,673,674,673,1,3,0,0,2,216,216,216,216
Trinity,49,2022-11-21,5,5,5,0,51,52,51,1,0,0,0,0,22,22,22,22
Tulare,49,2022-11-21,431,431,431,0,5503,5523,5522,1,23,0,0,1,1548,1548,1548,1548
Tuolumne,49,2022-11-21,97,97,97,0,765,767,766,1,3,1,1,0,203,203,202,202
Ventura,49,2022-11-21,728,728,728,0,10722,10760,10759,1,43,1,1,2,1610,1610,1609,1609
Yolo,49,2022-11-21,132,132,132,0,2238,2246,2245,1,7,4,4,2,419,419,415,415
Yuba,49,2022-11-21,70,70,70,0,1027,1033,1032,1,10,0,0,1,122,122,122,122
Alameda,50,2022-11-28,2232,2240,2240,0,22049,22137,22136,1,103,6,6,13,2099,2099,2093,2093
Amador,50,2022-11-28,32,32,32,0,757,760,759,1,5,1,1,1,95,95,94,94
Butte,50,2022-11-28,204,204,204,0,1477,1484,1483,1,41,0,0,1,467,467,467,467
Calaveras,50,2022-11-28,32,32,32,0,402,403,402,1,3,0,0,0,135,135,135,135
Colusa,50,2022-11-28,14,14,14,0,184,185,184,1,0,0,0,0,22,22,22,22
Contra Costa,50,2022-11-28,1471,1477,1477,0,15533,15595,15594,1,67,4,4,8,1491,1491,1487,1487
Del Norte,50,2022-11-28,33,33,33,0,458,459,458,1,1,1,1,0,56,56,55,55
El Dorado,50,2022-11-28,185,185,185,0,1548,1556,1555,1,13,1,1,1,236,236,235,235
Fresno,50,2022-11-28,1321,1327,1327,0,11704,11752,11751,1,136,5,5,19,2911,2911,2906,2906
Glenn,50,2022-11-28,17,17,17,0,194,195,194,1,3,0,0,0,53,53,53,53
Humboldt,50,2022-11-28,114,114,114,0,1042,1047,1046,1,10,0,0,0,163,163,163,163
Imperial,50,2022-11-28,379,379,379,0,2791,2803,2802,1,6,1,1,1,965,965,964,964
Inyo,50,2022-11-28,34,34,34,0,376,377,376,1,2,0,0,0,61,61,61,61
Kern,50,2022-11-28,586,587,587,0,9374,9412,9411,1,60,4,4,6,2445,2445,2441,2441
Kings,50,2022-11-28,244,244,244,0,2544,2555,2554,1,10,0,0,0,471,471,471,471
Lake,50,2022-11-28,49,49,49,0,848,852,851,1,1,0,0,0,151,151,151,151
Lassen,50,2022-11-28,27,27,27,0,493,494,493,1,0,0,0,0,64,64,64,64
Los Angeles,50,2022-11-28,18876,18950,18950,0,183386,184118,184116,2,918,89,89,122,34101,34101,34012,34012
Madera,50,2022-11-28,162,162,162,0,1627,1635,1634,1,13,0,0,2,375,375,375,375
Marin,50,2022-11-28,298,298,298,0,3071,3083,3082,1,19,0,0,1,317,317,317,317
Mariposa,50,2022-11-28,23,23,23,0,136,137,136,1,0,0,0,0,30,30,30,30
Mendocino,50,2022-11-28,49,49,49,0,726,729,728,1,5,0,0,2,137,137,137,137
Merced,50,2022-11-28,349,349,349,0,2550,2562,2561,1,18,5,5,2,886,886,881,881
Modoc,50,2022-11-28,5,5,5,0,10,11,10,1,0,0,0,0,9,9,9,9
Mono,50,2022-11-28,4,4,4,0,94,95,94,1,0,0,0,0,8,8,8,8
Monterey,50,2022-11-28,283,283,283,0,3890,3907,3906,1,26,1,1,0,778,778,777,777
Napa,50,2022-11-28,141,141,141,0,1884,1893,1892,1,6,0,0,3,159,159,159,159
Nevada,50,2022-11-28,118,118,118,0,1008,1013,1012,1,9,0,0,0,136,136,136,136
Orange,50,2022-11-28,3106,3120,3120,0,26227,26332,26331,1,221,17,17,34,7661,7661,7644,7644
Placer,50,2022-11-28,387,387,387,0,3778,3793,3792,1,69,3,3,5,668,668,665,665
Plumas,50,2022-11-28,6,6,6,0,143,144,143,1,0,0,0,0,13,13,13,13
Riverside,50,2022-11-28,3191,3205,3205,0,23286,23379,23378,1,188,12,12,22,6683,6683,6671,6671
Sacramento,50,2022-11-28,1787,1794,1794,0,17967,18039,18038,1,126,8,8,14,3401,3401,3393,3393
San Benito,50,2022-11-28,131,131,131,0,1221,1225,1224,1,1,0,0,0,102,102,102,102
San Bernardino,50,2022-11-28,3301,3316,3316,0,25798,25901,25900,1,146,1,1,20,8106,8106,8105,8105
San Diego,50,2022-11-28,4094,4110,4110,0,31679,31806,31805,1,259,7,7,27,5625,5625,5618,5618
San Francisco,50,2022-11-28,1161,1167,1167,0,12719,12769,12768,1,67,6,6,8,1097,1097,1091,1091
San Joaquin,50,2022-11-28,992,996,996,0,10941,10987,10986,1,50,3,3,11,2358,2358,2355,2355
San Luis Obispo,50,2022-11-28,179,179,179,0,2248,2259,2258,1,9,3,3,1,534,534,531,531
San Mateo,50,2022-11-28,1088,1093,1093,0,10982,11028,11027,1,42,1,1,3,739,739,738,738
Santa Barbara,50,2022-11-28,466,466,466,0,5210,5232,5231,1,27,2,2,5,742,742,740,740
Santa Clara,50,2022-11-28,2889,2902,2902,0,28045,28157,28156,1,159,9,9,22,2582,2582,2573,2573
Santa Cruz,50,2022-11-28,371,372,372,0,6665,6693,6692,1,20,0,0,2,276,276,276,276
Shasta,50,2022-11-28,97,97,97,0,1010,1014,1013,1,16,1,1,3,596,596,595,595
Siskiyou,50,2022-11-28,27,27,27,0,277,278,277,1,2,0,0,0,95,95,95,95
Solano,50,2022-11-28,590,591,591,0,5183,5205,5204,1,34,2,2,7,465,465,463,463
Sonoma,50,2022-11-28,456,456,456,0,5011,5032,5031,1,48,2,2,3,534,534,532,532
Stanislaus,50,2022-11-28,523,523,523,0,5363,5385,5384,1,77,3,3,4,1800,1800,1797,1797
Sutter,50,2022-11-28,82,82,82,0,1119,1125,1124,1,0,0,0,0,232,232,232,232
Tehama,50,2022-11-28,70,70,70,0,632,634,633,1,6,0,0,3,216,216,216,216
Trinity,50,2022-11-28,3,3,3,0,60,61,60,1,0,0,0,0,22,22,22,22
Tulare,50,2022-11-28,509,510,510,0,4931,4950,4949,1,34,0,0,0,1548,1548,1548,1548
Tuolumne,50,2022-11-28,72,72,72,0,676,679,678,1,4,0,0,0,203,203,203,203
Ventura,50,2022-11-28,963,968,968,0,10608,10652,10651,1,58,2,2,2,1612,1612,1610,1610
Yolo,50,2022-11-28,169,169,169,0,2027,2036,2035,1,3,4,4,1,423,423,419,419
Yuba,50,2022-11-28,92,92,92,0,926,931,930,1,12,0,0,0,122,122,122,122
Alameda,51,2022-12-05,2779,2792,2792,0,29026,29153,29152,1,126,7,7,13,2106,2106,2099,2099
Amador,51,2022-12-05,41,41,41,0,812,815,814,1,3,0,0,2,95,95,95,95
Butte,51,2022-12-05,239,239,239,0,1886,1896,1895,1,38,7,7,5,474,474,467,467
Calaveras,51,2022-12-05,46,46,46,0,486,487,486,1,0,1,1,0,136,136,135,135
Colusa,51,2022-12-05,12,12,12,0,206,207,206,1,4,0,0,0,22,22,22,22
Contra Costa,51,2022-12-05,1779,1787,1787,0,19286,19370,19369,1,78,0,0,11,1491,1491,1491,1491
Del Norte,51,2022-12-05,39,39,39,0,566,568,567,1,2,0,0,0,56,56,56,56
El Dorado,51,2022-12-05,182,182,182,0,1576,1583,1582,1,14,1,1,0,237,237,236,236
Fresno,51,2022-12-05,1538,1545,1545,0,14288,14350,14349,1,177,6,6,17,2917,2917,2911,2911
Glenn,51,2022-12-05,24,24,24,0,232,234,233,1,2,0,0,0,53,53,53,53
Humboldt,51,2022-12-05,134,134,134,0,1083,1089,1088,1,17,1,1,2,164,164,163,163
Imperial,51,2022-12-05,587,588,588,0,3396,3412,3411,1,18,2,2,5,967,967,965,965
Inyo,51,2022-12-05,26,26,26,0,332,333,332,1,1,1,1,0,62,62,61,61
Kern,51,2022-12-05,797,801,801,0,10542,10588,10587,1,55,1,1,10,2446,2446,2445,2445
Kings,51,2022-12-05,295,295,295,0,3047,3061,3060,1,8,0,0,0,471,471,471,471
Lake,51,2022-12-05,64,64,64,0,830,835,834,1,2,0,0,0,151,151,151,151
Lassen,51,2022-12-05,14,14,14,0,444,446,445,1,0,0,0,0,64,64,64,64
Los Angeles,51,2022-12-05,22381,22479,22479,0,242078,243137,243134,3,1119,110,110,151,34211,34211,34101,34101
Madera,51,2022-12-05,205,205,205,0,1982,1991,1990,1,12,0,0,3,375,375,375,375
Marin,51,2022-12-05,311,311,311,0,3507,3524,3523,1,14,0,0,2,317,317,317,317
Mariposa,51,2022-12-05,19,19,19,0,174,175,174,1,0,0,0,0,30,30,30,30
Mendocino,51,2022-12-05,47,47,47,0,797,803,802,1,6,1,1,2,138,138,137,137
Merced,51,2022-12-05,352,352,352,0,3210,3224,3223,1,23,2,2,2,888,888,886,886
Modoc,51,2022-12-05,12,12,12,0,13,14,13,1,0,0,0,0,9,9,9,9
Mono,51,2022-12-05,9,9,9,0,91,92,91,1,0,0,0,0,8,8,8,8
Monterey,51,2022-12-05,271,271,271,0,4384,4404,4403,1,34,1,1,0,779,779,778,778
Napa,51,2022-12-05,161,161,161,0,2341,2353,2352,1,7,0,0,0,159,159,159,159
Nevada,51,2022-12-05,115,115,115,0,1123,1128,1127,1,8,0,0,2,136,136,136,136
Orange,51,2022-12-05,4184,4203,4203,0,34027,34176,34175,1,301,21,21,48,7682,7682,7661,7661
Placer,51,2022-12-05,392,392,392,0,4041,4061,4060,1,72,1,1,4,669,669,668,668
Plumas,51,2022-12-05,22,22,22,0,184,185,184,1,1,0,0,0,13,13,13,13
Riverside,51,2022-12-05,3960,3978,3978,0,27258,27377,27376,1,186,13,13,25,6696,6696,6683,6683
Sacramento,51,2022-12-05,2120,2130,2130,0,21126,21218,21217,1,128,9,9,28,3410,3410,3401,3401
San Benito,51,2022-12-05,219,219,219,0,1483,1489,1488,1,6,1,1,3,103,103,102,102
San Bernardino,51,2022-12-05,4017,4036,4036,0,28260,28381,28380,1,167,0,0,34,8106,8106,8106,8106
San Diego,51,2022-12-05,5675,5699,5699,0,44337,44531,44530,1,302,12,12,30,5637,5637,5625,5625
San Francisco,51,2022-12-05,1486,1493,1493,0,15939,16009,16008,1,77,7,7,7,1104,1104,1097,1097
San Joaquin,51,2022-12-05,1118,1124,1124,0,12629,12683,12682,1,70,8,8,16,2366,2366,2358,2358
San Luis Obispo,51,2022-12-05,206,206,206,0,2660,2674,2673,1,15,3,3,1,537,537,534,534
San Mateo,51,2022-12-05,1226,1233,1233,0,13442,13502,13501,1,56,1,1,1,740,740,739,739
Santa Barbara,51,2022-12-05,521,521,521,0,6764,6795,6794,1,38,1,1,9,743,743,742,742
Santa Clara,51,2022-12-05,3444,3458,3458,0,35389,35543,35542,1,207,11,11,26,2593,2593,2582,2582
Santa Cruz,51,2022-12-05,471,471,471,0,12732,12788,12787,1,22,0,0,3,276,276,276,276
Shasta,51,2022-12-05,132,132,132,0,1107,1113,1112,1,23,0,0,5,596,596,596,596
Siskiyou,51,2022-12-05,22,22,22,0,309,310,309,1,2,0,0,0,95,95,95,95
Solano,51,2022-12-05,642,643,643,0,6611,6642,6641,1,33,1,1,7,466,466,465,465
Sonoma,51,2022-12-05,505,505,505,0,5882,5909,5908,1,35,5,5,1,539,539,534,534
Stanislaus,51,2022-12-05,640,641,641,0,6730,6761,6760,1,76,1,1,7,1801,1801,1800,1800
Sutter,51,2022-12-05,96,96,96,0,1171,1177,1176,1,0,1,1,0,233,233,232,232
Tehama,51,2022-12-05,93,93,93,0,817,822,821,1,9,2,2,0,218,218,216,216
Trinity,51,2022-12-05,3,3,3,0,39,40,39,1,0,0,0,0,22,22,22,22
Tulare,51,2022-12-05,522,523,523,0,5950,5976,5975,1,35,0,0,1,1548,1548,1548,1548
Tuolumne,51,2022-12-05,107,107,107,0,852,856,855,1,2,0,0,0,203,203,203,203
Ventura,51,2022-12-05,1102,1107,1107,0,12184,12236,12235,1,71,2,2,6,1614,1614,1612,1612
Yolo,51,2022-12-05,214,214,214,0,2646,2660,2659,1,2,1,1,3,424,424,423,423
Yuba,51,2022-12-05,82,82,82,0,1038,1044,1043,1,11,0,0,1,122,122,122,122
Alameda,52,2022-12-12,2640,2652,2652,0,29274,29417,29416,1,147,11,11,20,2117,2117,2106,2106
Amador,52,2022-12-12,32,32,32,0,789,792,791,1,3,0,0,0,95,95,95,95
Butte,52,2022-12-12,183,183,183,0,1834,1844,1843,1,39,2,2,2,476,476,474,474
Calaveras,52,2022-12-12,41,41,41,0,454,455,454,1,1,0,0,0,136,136,136,136
Colusa,52,2022-12-12,12,12,12,0,272,273,272,1,1,0,0,0,22,22,22,22
Contra Costa,52,2022-12-12,1737,1746,1746,0,18421,18510,18509,1,78,10,10,4,1501,1501,1491,1491
Del Norte,52,2022-12-12,34,34,34,0,534,536,535,1,3,0,0,0,56,56,56,56
El Dorado,52,2022-12-12,146,146,146,0,1410,1419,1418,1,8,1,1,3,238,238,237,237
Fresno,52,2022-12-12,1478,1485,1485,0,13850,13918,13917,1,186,12,12,18,2929,2929,2917,2917
Glenn,52,2022-12-12,17,17,17,0,230,231,230,1,6,0,0,0,53,53,53,53
Humboldt,52,2022-12-12,106,106,106,0,1011,1018,1017,1,13,1,1,2,165,165,164,164
Imperial,52,2022-12-12,455,455,455,0,2943,2959,2958,1,27,3,3,3,970,970,967,967
Inyo,52,2022-12-12,22,22,22,0,303,304,303,1,1,0,0,0,62,62,62,62
Kern,52,2022-12-12,940,945,945,0,10846,10900,10899,1,55,2,2,4,2448,2448,2446,2446
Kings,52,2022-12-12,256,256,256,0,2855,2869,2868,1,8,2,2,0,473,473,471,471
Lake,52,2022-12-12,56,56,56,0,761,766,765,1,3,0,0,1,151,151,151,151
Lassen,52,2022-12-12,15,15,15,0,423,425,424,1,0,0,0,0,64,64,64,64
Los Angeles,52,2022-12-12,17498,17583,17583,0,226020,227124,227121,3,1113,158,161,154,34369,34372,34211,34211
Madera,52,2022-12-12,212,212,212,0,2174,2185,2184,1,15,0,0,2,375,375,375,375
Marin,52,2022-12-12,315,315,315,0,3616,3636,3635,1,24,0,0,2,317,317,317,317
Mariposa,52,2022-12-12,18,18,18,0,122,123,122,1,0,0,0,0,30,30,30,30
Mendocino,52,2022-12-12,53,53,53,0,657,661,660,1,7,1,1,0,139,139,138,138
Merced,52,2022-12-12,318,318,318,0,3323,3339,3338,1,14,0,0,2,888,888,888,888
Modoc,52,2022-12-12,5,5,5,0,10,11,10,1,0,0,0,0,9,9,9,9
Mono,52,2022-12-12,9,9,9,0,122,123,122,1,0,0,0,0,8,8,8,8
Monterey,52,2022-12-12,265,265,265,0,4255,4278,4277,1,25,3,3,2,782,782,779,779
Napa,52,2022-12-12,162,162,162,0,2173,2184,2183,1,9,1,1,0,160,160,159,159
Nevada,52,2022-12-12,90,90,90,0,969,975,974,1,5,0,0,2,136,136,136,136
Orange,52,2022-12-12,3425,3441,3441,0,31018,31169,31168,1,300,35,35,48,7717,7717,7682,7682
Placer,52,2022-12-12,331,331,331,0,3884,3903,3902,1,73,5,5,6,674,674,669,669
Plumas,52,2022-12-12,7,7,7,0,186,187,186,1,2,0,0,0,13,13,13,13
Riverside,52,2022-12-12,3301,3318,3318,0,24510,24628,24627,1,204,19,19,25,6715,6715,6696,6696
Sacramento,52,2022-12-12,1803,1811,1811,0,20060,20158,20157,1,173,7,7,31,3417,3417,3410,3410
San Benito,52,2022-12-12,125,125,125,0,1329,1336,1335,1,2,2,2,2,105,105,103,103
San Bernardino,52,2022-12-12,3542,3561,3561,0,26669,26799,26798,1,226,3,3,36,8109,8109,8106,8106
San Diego,52,2022-12-12,4839,4862,4862,0,40212,40408,40407,1,331,15,15,45,5652,5652,5637,5637
San Francisco,52,2022-12-12,1417,1424,1424,0,16730,16813,16812,1,103,7,7,12,1111,1111,1104,1104
San Joaquin,52,2022-12-12,999,1004,1004,0,12711,12773,12772,1,68,6,6,19,2372,2372,2366,2366
San Luis Obispo,52,2022-12-12,231,231,231,0,2650,2665,2664,1,10,1,1,0,538,538,537,537
San Mateo,52,2022-12-12,1147,1154,1154,0,12351,12413,12412,1,59,0,0,3,740,740,740,740
Santa Barbara,52,2022-12-12,512,513,513,0,5761,5791,5790,1,36,2,2,6,745,745,743,743
Santa Clara,52,2022-12-12,3200,3215,3215,0,34812,34983,34982,1,198,17,17,30,2610,2610,2593,2593
Santa Cruz,52,2022-12-12,578,581,581,0,12934,12999,12998,1,29,0,0,1,276,276,276,276
Shasta,52,2022-12-12,104,104,104,0,1154,1161,1160,1,22,0,0,5,596,596,596,596
Siskiyou,52,2022-12-12,15,15,15,0,244,245,244,1,2,0,0,0,95,95,95,95
Solano,52,2022-12-12,636,639,639,0,6176,6208,6207,1,42,2,2,7,468,468,466,466
Sonoma,52,2022-12-12,560,561,561,0,5592,5619,5618,1,41,2,2,7,541,541,539,539
Stanislaus,52,2022-12-12,593,595,595,0,6381,6414,6413,1,104,8,8,12,1809,1809,1801,1801
Sutter,52,2022-12-12,114,114,114,0,1154,1161,1160,1,0,0,0,0,233,233,233,233
Tehama,52,2022-12-12,80,80,80,0,774,779,778,1,6,1,1,0,219,219,218,218
Trinity,52,2022-12-12,3,3,3,0,45,46,45,1,0,0,0,0,22,22,22,22
Tulare,52,2022-12-12,437,438,438,0,5891,5921,5920,1,27,2,2,2,1550,1550,1548,1548
Tuolumne,52,2022-12-12,133,133,133,0,934,940,939,1,5,0,0,0,203,203,203,203
Ventura,52,2022-12-12,914,919,919,0,10652,10705,10704,1,72,4,4,7,1618,1618,1614,1614
Yolo,52,2022-12-12,210,210,210,0,2296,2308,2307,1,5,2,2,2,426,426,424,424
Yuba,52,2022-12-12,75,75,75,0,948,954,953,1,13,0,0,0,122,122,122,122
Alameda,53,2022-12-19,2299,2311,2311,0,26706,26846,26845,1,144,11,11,19,2128,2128,2117,2117
Amador,53,2022-12-19,42,42,42,0,806,812,811,1,6,0,0,0,95,95,95,95
Butte,53,2022-12-19,128,128,128,0,1638,1648,1647,1,34,3,3,2,479,479,476,476
Calaveras,53,2022-12-19,29,29,29,0,441,442,441,1,1,1,1,0,137,137,136,136
Colusa,53,2022-12-19,12,12,12,0,214,215,214,1,1,0,0,0,22,22,22,22
Contra Costa,53,2022-12-19,1718,1726,1726,0,17332,17422,17421,1,95,6,6,7,1507,1507,1501,1501
Del Norte,53,2022-12-19,39,39,39,0,553,556,555,1,3,0,0,0,56,56,56,56
El Dorado,53,2022-12-19,160,160,160,0,1632,1642,1641,1,9,1,1,2,239,239,238,238
Fresno,53,2022-12-19,1177,1184,1184,0,12884,12950,12949,1,212,7,7,22,2936,2936,2929,2929
Glenn,53,2022-12-19,21,21,21,0,205,206,205,1,6,0,0,0,53,53,53,53
Humboldt,53,2022-12-19,113,113,113,0,942,948,947,1,9,0,0,1,165,165,165,165
Imperial,53,2022-12-19,262,262,262,0,2546,2561,2560,1,16,1,1,0,971,971,970,970
Inyo,53,2022-12-19,12,12,12,0,324,325,324,1,1,0,0,0,62,62,62,62
Kern,53,2022-12-19,921,926,926,0,10637,10693,10692,1,60,3,3,5,2451,2451,2448,2448
Kings,53,2022-12-19,229,229,229,0,2770,2786,2785,1,6,4,4,1,477,477,473,473
Lake,53,2022-12-19,70,70,70,0,794,799,798,1,4,1,1,0,152,152,151,151
Lassen,53,2022-12-19,8,8,8,0,466,468,467,1,0,0,0,0,64,64,64,64
Los Angeles,53,2022-12-19,15231,15311,15311,0,202248,203311,203309,2,1096,130,133,155,34499,34505,34369,34372
Madera,53,2022-12-19,186,186,186,0,1889,1899,1898,1,10,0,0,1,375,375,375,375
Marin,53,2022-12-19,268,268,268,0,3233,3251,3250,1,17,0,0,0,317,317,317,317
Mariposa,53,2022-12-19,25,25,25,0,133,134,133,1,0,0,0,0,30,30,30,30
Mendocino,53,2022-12-19,66,66,66,0,755,759,758,1,4,0,0,0,139,139,139,139
Merced,53,2022-12-19,262,262,262,0,2773,2788,2787,1,15,2,2,2,890,890,888,888
Modoc,53,2022-12-19,8,8,8,0,21,22,21,1,0,0,0,0,9,9,9,9
Mono,53,2022-12-19,11,11,11,0,121,122,121,1,1,0,0,0,8,8,8,8
Monterey,53,2022-12-19,232,232,232,0,3876,3897,3896,1,13,1,1,1,783,783,782,782
Napa,53,2022-12-19,181,181,181,0,2092,2103,2102,1,8,0,0,0,160,160,160,160
Nevada,53,2022-12-19,72,72,72,0,883,889,888,1,5,0,0,2,136,136,136,136
Orange,53,2022-12-19,3224,3242,3242,0,29780,29936,29935,1,296,32,32,51,7749,7749,7717,7717
Placer,53,2022-12-19,361,361,361,0,3830,3851,3850,1,90,1,1,10,675,675,674,674
Plumas,53,2022-12-19,7,7,7,0,188,189,188,1,0,0,0,0,13,13,13,13
Riverside,53,2022-12-19,3101,3118,3118,0,22625,22744,22743,1,177,21,21,22,6736,6736,6715,6715
Sacramento,53,2022-12-19,1717,1726,1726,0,19655,19758,19757,1,210,15,15,22,3432,3432,3417,3417
San Benito,53,2022-12-19,105,105,105,0,1136,1142,1141,1,0,4,4,1,109,109,105,105
San Bernardino,53,2022-12-19,3158,3175,3175,0,24750,24882,24881,1,200,4,4,38,8113,8113,8109,8109
San Diego,53,2022-12-19,4849,4874,4874,0,39025,39232,39231,1,381,16,16,45,5668,5668,5652,5652
San Francisco,53,2022-12-19,1218,1225,1225,0,15628,15709,15708,1,106,11,11,17,1122,1122,1111,1111
San Joaquin,53,2022-12-19,851,856,856,0,12989,13059,13058,1,58,11,11,19,2383,2383,2372,2372
San Luis Obispo,53,2022-12-19,242,242,242,0,2423,2437,2436,1,17,1,1,0,539,539,538,538
San Mateo,53,2022-12-19,917,922,922,0,11730,11793,11792,1,62,0,0,5,740,740,740,740
Santa Barbara,53,2022-12-19,468,469,469,0,5246,5276,5275,1,35,4,4,5,749,749,745,745
Santa Clara,53,2022-12-19,2781,2795,2795,0,32127,32296,32295,1,205,14,14,30,2624,2624,2610,2610
Santa Cruz,53,2022-12-19,260,260,260,0,11201,11261,11260,1,31,0,0,1,276,276,276,276
Shasta,53,2022-12-19,109,109,109,0,1126,1132,1131,1,24,1,1,4,597,597,596,596
Siskiyou,53,2022-12-19,15,15,15,0,258,259,258,1,2,0,0,0,95,95,95,95
Solano,53,2022-12-19,636,639,639,0,6177,6210,6209,1,41,0,0,6,468,468,468,468
Sonoma,53,2022-12-19,478,479,479,0,5421,5451,5450,1,38,1,1,4,542,542,541,541
Stanislaus,53,2022-12-19,474,474,474,0,5996,6029,6028,1,94,1,1,12,1810,1810,1809,1809
Sutter,53,2022-12-19,81,81,81,0,1074,1082,1081,1,0,1,1,0,234,234,233,233
Tehama,53,2022-12-19,67,67,67,0,676,681,680,1,6,1,1,0,220,220,219,219
Trinity,53,2022-12-19,2,2,2,0,31,32,31,1,0,0,0,0,22,22,22,22
Tulare,53,2022-12-19,468,469,469,0,5381,5410,5409,1,53,5,5,1,1555,1555,1550,1550
Tuolumne,53,2022-12-19,88,88,88,0,841,847,846,1,2,1,1,1,204,204,203,203
Ventura,53,2022-12-19,936,942,942,0,9961,10015,10014,1,81,4,4,9,1622,1622,1618,1618
Yolo,53,2022-12-19,172,172,172,0,1959,1970,1969,1,5,4,4,0,430,430,426,426
Yuba,53,2022-12-19,81,81,81,0,900,906,905,1,7,0,0,0,122,122,122,122
Alameda,54,2022-12-26,1938,1950,1950,0,20336,20458,20457,1,150,10,10,17,2138,2138,2128,2128
Amador,54,2022-12-26,43,43,43,0,758,764,763,1,5,1,1,0,96,96,95,95
Butte,54,2022-12-26,96,96,96,0,1294,1303,1302,1,33,0,0,1,479,479,479,479
Calaveras,54,2022-12-26,24,24,24,0,366,367,366,1,0,1,1,0,138,138,137,137
Colusa,54,2022-12-26,14,14,14,0,150,151,150,1,0,0,0,0,22,22,22,22
Contra Costa,54,2022-12-26,1454,1463,1463,0,13732,13814,13813,1,89,10,10,11,1517,1517,1507,1507
Del Norte,54,2022-12-26,33,33,33,0,420,423,422,1,3,0,0,0,56,56,56,56
El Dorado,54,2022-12-26,152,152,152,0,1317,1326,1325,1,7,1,1,0,240,240,239,239
Fresno,54,2022-12-26,1080,1087,1087,0,10644,10708,10707,1,186,10,10,33,2946,2946,2936,2936
Glenn,54,2022-12-26,12,12,12,0,196,198,197,1,0,0,0,0,53,53,53,53
Humboldt,54,2022-12-26,82,82,82,0,629,635,634,1,5,2,2,2,167,167,165,165
Imperial,54,2022-12-26,235,235,235,0,2162,2175,2174,1,67,2,2,0,973,973,971,971
Inyo,54,2022-12-26,13,13,13,0,158,159,158,1,1,0,0,0,62,62,62,62
Kern,54,2022-12-26,690,695,695,0,8722,8776,8775,1,51,9,9,8,2460,2460,2451,2451
Kings,54,2022-12-26,201,201,201,0,2297,2313,2312,1,5,0,0,2,477,477,477,477
Lake,54,2022-12-26,58,58,58,0,600,604,603,1,3,0,0,1,152,152,152,152
Lassen,54,2022-12-26,27,27,27,0,485,487,486,1,0,0,0,0,64,64,64,64
Los Angeles,54,2022-12-26,13442,13523,13523,0,132217,133007,133005,2,1032,170,177,164,34669,34682,34499,34505
Madera,54,2022-12-26,166,166,166,0,1563,1574,1573,1,6,0,0,1,375,375,375,375
Marin,54,2022-12-26,215,215,215,0,2555,2570,2569,1,29,0,0,2,317,317,317,317
Mariposa,54,2022-12-26,22,22,22,0,105,106,105,1,0,0,0,0,30,30,30,30
Mendocino,54,2022-12-26,75,75,75,0,646,652,651,1,10,0,0,0,139,139,139,139
Merced,54,2022-12-26,212,212,212,0,1964,1977,1976,1,17,5,5,3,895,895,890,890
Modoc,54,2022-12-26,4,4,4,0,11,12,11,1,0,0,0,0,9,9,9,9
Mono,54,2022-12-26,10,10,10,0,82,83,82,1,0,0,0,0,8,8,8,8
Monterey,54,2022-12-26,190,190,190,0,2956,2975,2974,1,21,4,4,0,787,787,783,783
Napa,54,2022-12-26,142,142,142,0,1718,1730,1729,1,12,0,0,0,160,160,160,160
Nevada,54,2022-12-26,66,66,66,0,750,756,755,1,9,0,0,1,136,136,136,136
Orange,54,2022-12-26,3157,3176,3176,0,24462,24610,24609,1,274,38,38,31,7787,7787,7749,7749
Placer,54,2022-12-26,291,291,291,0,3038,3056,3055,1,87,2,2,12,677,677,675,675
Plumas,54,2022-12-26,10,10,10,0,123,124,123,1,0,0,0,0,13,13,13,13
Riverside,54,2022-12-26,2851,2868,2868,0,18272,18381,18380,1,194,12,12,18,6748,6748,6736,6736
Sacramento,54,2022-12-26,1366,1373,1373,0,14467,14554,14553,1,179,12,12,25,3444,3444,3432,3432
San Benito,54,2022-12-26,106,106,106,0,810,815,814,1,1,0,0,1,109,109,109,109
San Bernardino,54,2022-12-26,2867,2885,2885,0,19898,20017,20016,1,210,7,7,26,8120,8120,8113,8113
San Diego,54,2022-12-26,4592,4619,4619,0,28541,28714,28713,1,395,25,25,45,5693,5693,5668,5668
San Francisco,54,2022-12-26,1011,1017,1017,0,11737,11808,11807,1,90,20,20,15,1142,1142,1122,1122
San Joaquin,54,2022-12-26,749,754,754,0,10079,10140,10139,1,60,7,7,10,2390,2390,2383,2383
San Luis Obispo,54,2022-12-26,212,212,212,0,1972,1984,1983,1,20,3,3,0,542,542,539,539
San Mateo,54,2022-12-26,818,823,823,0,8789,8842,8841,1,55,0,0,6,740,740,740,740
Santa Barbara,54,2022-12-26,486,488,488,0,4096,4121,4120,1,40,0,0,4,749,749,749,749
Santa Clara,54,2022-12-26,2267,2279,2279,0,23758,23902,23901,1,179,9,9,35,2633,2633,2624,2624
Santa Cruz,54,2022-12-26,221,221,221,0,4639,4669,4668,1,25,0,0,2,276,276,276,276
Shasta,54,2022-12-26,100,100,100,0,923,929,928,1,18,0,0,1,597,597,597,597
Siskiyou,54,2022-12-26,17,17,17,0,266,267,266,1,1,0,0,0,95,95,95,95
Solano,54,2022-12-26,648,653,653,0,5238,5271,5270,1,59,2,2,7,470,470,468,468
Sonoma,54,2022-12-26,454,454,454,0,4246,4273,4272,1,39,1,1,4,543,543,542,542
Stanislaus,54,2022-12-26,451,451,451,0,4898,4927,4926,1,96,10,10,5,1820,1820,1810,1810
Sutter,54,2022-12-26,128,128,128,0,928,934,933,1,0,0,0,0,234,234,234,234
Tehama,54,2022-12-26,48,48,48,0,607,612,611,1,2,3,3,0,223,223,220,220
Trinity,54,2022-12-26,3,3,3,0,39,40,39,1,0,0,0,0,22,22,22,22
Tulare,54,2022-12-26,442,443,443,0,3938,3962,3961,1,41,7,7,3,1562,1562,1555,1555
Tuolumne,54,2022-12-26,93,93,93,0,758,764,763,1,6,2,2,2,206,206,204,204
Ventura,54,2022-12-26,888,894,894,0,7860,7907,7906,1,71,16,16,11,1638,1638,1622,1622
Yolo,54,2022-12-26,140,140,140,0,1603,1614,1613,1,9,2,2,1,432,432,430,430
Yuba,54,2022-12-26,99,99,99,0,754,760,759,1,14,0,0,0,122,122,122,122
Alameda,55,2023-01-02,1819,1831,1831,0,19727,19867,19866,1,175,14,14,19,2152,2152,2138,2138
Amador,55,2023-01-02,34,34,34,0,675,681,680,1,3,1,1,0,97,97,96,96
Butte,55,2023-01-02,98,98,98,0,1327,1338,1337,1,35,3,3,2,482,482,479,479
Calaveras,55,2023-01-02,33,33,33,0,361,363,362,1,0,2,2,0,140,140,138,138
Colusa,55,2023-01-02,5,5,5,0,94,95,94,1,0,0,0,0,22,22,22,22
Contra Costa,55,2023-01-02,1379,1389,1389,0,14028,14127,14126,1,89,5,5,13,1522,1522,1517,1517
Del Norte,55,2023-01-02,32,32,32,0,408,411,410,1,3,0,0,2,56,56,56,56
El Dorado,55,2023-01-02,147,147,147,0,1408,1420,1419,1,7,1,1,2,241,241,240,240
Fresno,55,2023-01-02,1063,1071,1071,0,11335,11416,11415,1,195,16,16,28,2962,2962,2946,2946
Glenn,55,2023-01-02,12,12,12,0,190,192,191,1,0,0,0,0,53,53,53,53
Humboldt,55,2023-01-02,47,47,47,0,614,620,619,1,2,0,0,2,167,167,167,167
Imperial,55,2023-01-02,205,205,205,0,2034,2049,2048,1,11,0,0,1,973,973,973,973
Inyo,55,2023-01-02,16,16,16,0,226,227,226,1,1,0,0,0,62,62,62,62
Kern,55,2023-01-02,888,894,894,0,9582,9650,9649,1,66,3,3,8,2463,2463,2460,2460
Kings,55,2023-01-02,186,186,186,0,2165,2182,2181,1,4,2,2,1,479,479,477,477
Lake,55,2023-01-02,46,46,46,0,603,610,609,1,3,1,1,0,153,153,152,152
Lassen,55,2023-01-02,13,13,13,0,490,494,493,1,0,0,0,0,64,64,64,64
Los Angeles,55,2023-01-02,13342,13436,13436,0,135916,136881,136879,2,1091,142,149,154,34811,34831,34669,34682
Madera,55,2023-01-02,153,153,153,0,1650,1663,1662,1,7,0,0,0,375,375,375,375
Marin,55,2023-01-02,224,224,224,0,2408,2428,2427,1,24,0,0,2,317,317,317,317
Mariposa,55,2023-01-02,15,15,15,0,94,95,94,1,0,0,0,0,30,30,30,30
Mendocino,55,2023-01-02,59,59,59,0,687,693,692,1,6,1,1,3,140,140,139,139
Merced,55,2023-01-02,194,194,194,0,2012,2028,2027,1,8,2,2,4,897,897,895,895
Modoc,55,2023-01-02,9,9,9,0,13,14,13,1,0,0,0,0,9,9,9,9
Mono,55,2023-01-02,10,10,10,0,66,67,66,1,0,0,0,0,8,8,8,8
Monterey,55,2023-01-02,215,215,215,0,3041,3064,3063,1,27,0,0,0,787,787,787,787
Napa,55,2023-01-02,124,124,124,0,1676,1689,1688,1,8,1,1,1,161,161,160,160
Nevada,55,2023-01-02,54,54,54,0,721,727,726,1,8,0,0,2,136,136,136,136
Orange,55,2023-01-02,3188,3210,3210,0,24749,24924,24923,1,312,37,37,28,7824,7824,7787,7787
Placer,55,2023-01-02,302,302,302,0,3231,3255,3254,1,108,1,1,8,678,678,677,677
Plumas,55,2023-01-02,12,12,12,0,145,146,145,1,1,1,1,0,14,14,13,13
Riverside,55,2023-01-02,3037,3059,3059,0,19662,19802,19801,1,223,9,9,31,6757,6757,6748,6748
Sacramento,55,2023-01-02,1506,1517,1517,0,15212,15320,15319,1,201,19,19,26,3463,3463,3444,3444
San Benito,55,2023-01-02,58,58,58,0,790,795,794,1,1,0,0,1,109,109,109,109
San Bernardino,55,2023-01-02,2820,2840,2840,0,20608,20754,20753,1,183,3,3,31,8123,8123,8120,8120
San Diego,55,2023-01-02,4633,4665,4665,0,29186,29393,29392,1,401,25,25,43,5718,5718,5693,5693
San Francisco,55,2023-01-02,879,884,884,0,10123,10195,10194,1,77,11,11,15,1153,1153,1142,1142
San Joaquin,55,2023-01-02,752,758,758,0,10407,10481,10480,1,62,6,6,12,2396,2396,2390,2390
San Luis Obispo,55,2023-01-02,210,210,210,0,1994,2009,2008,1,17,6,6,0,548,548,542,542
San Mateo,55,2023-01-02,719,724,724,0,7887,7944,7943,1,50,0,0,9,740,740,740,740
Santa Barbara,55,2023-01-02,433,436,436,0,4040,4071,4070,1,47,1,1,5,750,750,749,749
Santa Clara,55,2023-01-02,2389,2406,2406,0,23023,23187,23186,1,200,15,15,32,2648,2648,2633,2633
Santa Cruz,55,2023-01-02,171,171,171,0,3000,3022,3021,1,27,0,0,0,276,276,276,276
Shasta,55,2023-01-02,98,98,98,0,945,953,952,1,20,0,0,1,597,597,597,597
Siskiyou,55,2023-01-02,15,15,15,0,268,269,268,1,1,0,0,0,95,95,95,95
Solano,55,2023-01-02,638,643,643,0,5296,5335,5334,1,60,3,3,11,473,473,470,470
Sonoma,55,2023-01-02,422,423,423,0,4256,4288,4287,1,56,0,0,2,543,543,543,543
Stanislaus,55,2023-01-02,473,477,477,0,5017,5054,5053,1,88,6,6,8,1826,1826,1820,1820
Sutter,55,2023-01-02,97,97,97,0,887,894,893,1,0,0,0,0,234,234,234,234
Tehama,55,2023-01-02,54,54,54,0,621,627,626,1,2,5,5,0,228,228,223,223
Trinity,55,2023-01-02,4,4,4,0,41,42,41,1,0,0,0,0,22,22,22,22
Tulare,55,2023-01-02,469,473,473,0,4714,4748,4747,1,52,1,1,6,1563,1563,1562,1562
Tuolumne,55,2023-01-02,66,66,66,0,662,668,667,1,5,0,0,0,206,206,206,206
Ventura,55,2023-01-02,902,909,909,0,7461,7515,7514,1,87,10,10,13,1648,1648,1638,1638
Yolo,55,2023-01-02,135,135,135,0,1520,1533,1532,1,4,3,3,1,435,435,432,432
Yuba,55,2023-01-02,79,79,79,0,730,736,735,1,19,0,0,1,122,122,122,122
Alameda,56,2023-01-09,1466,1479,1479,0,23072,23264,23263,1,149,12,12,11,2164,2164,2152,2152
Amador,56,2023-01-09,28,28,28,0,706,713,712,1,2,0,0,0,97,97,97,97
Butte,56,2023-01-09,86,86,86,0,1199,1210,1209,1,39,2,2,3,484,484,482,482
Calaveras,56,2023-01-09,19,19,19,0,341,345,344,1,0,0,0,1,140,140,140,140
Colusa,56,2023-01-09,8,8,8,0,92,93,92,1,0,0,0,0,22,22,22,22
Contra Costa,56,2023-01-09,1053,1061,1061,0,15349,15476,15475,1,85,6,6,11,1528,1528,1522,1522
Del Norte,56,2023-01-09,17,17,17,0,367,371,370,1,5,0,0,2,56,56,56,56
El Dorado,56,2023-01-09,87,87,87,0,1453,1465,1464,1,4,0,0,0,241,241,241,241
Fresno,56,2023-01-09,805,811,811,0,11449,11543,11542,1,171,7,7,23,2969,2969,2962,2962
Glenn,56,2023-01-09,8,8,8,0,185,187,186,1,0,0,0,0,53,53,53,53
Humboldt,56,2023-01-09,57,57,57,0,705,712,711,1,7,0,0,4,167,167,167,167
Imperial,56,2023-01-09,162,162,162,0,2438,2458,2457,1,12,2,2,2,975,975,973,973
Inyo,56,2023-01-09,10,10,10,0,205,207,206,1,0,0,0,0,62,62,62,62
Kern,56,2023-01-09,613,618,618,0,10477,10565,10564,1,73,4,4,8,2467,2467,2463,2463
Kings,56,2023-01-09,184,184,184,0,2314,2334,2333,1,9,0,0,0,479,479,479,479
Lake,56,2023-01-09,45,45,45,0,622,628,627,1,3,1,1,0,154,154,153,153
Lassen,56,2023-01-09,19,19,19,0,506,511,510,1,2,0,0,0,64,64,64,64
Los Angeles,56,2023-01-09,10146,10228,10228,0,188163,189725,189723,2,965,141,149,136,34952,34980,34811,34831
Madera,56,2023-01-09,100,100,100,0,1645,1659,1658,1,8,0,0,1,375,375,375,375
Marin,56,2023-01-09,146,146,146,0,2558,2580,2579,1,18,0,0,3,317,317,317,317
Mariposa,56,2023-01-09,9,9,9,0,105,106,105,1,0,1,1,0,31,31,30,30
Mendocino,56,2023-01-09,40,40,40,0,643,649,648,1,10,2,2,3,142,142,140,140
Merced,56,2023-01-09,185,185,185,0,2150,2169,2168,1,11,1,1,1,898,898,897,897
Modoc,56,2023-01-09,8,8,8,0,14,15,14,1,0,0,0,0,9,9,9,9
Mono,56,2023-01-09,12,12,12,0,78,79,78,1,0,0,0,0,8,8,8,8
Monterey,56,2023-01-09,170,170,170,0,3119,3145,3144,1,20,4,4,3,791,791,787,787
Napa,56,2023-01-09,132,132,132,0,1877,1894,1893,1,9,0,0,3,161,161,161,161
Nevada,56,2023-01-09,42,42,42,0,759,768,767,1,6,0,0,0,136,136,136,136
Orange,56,2023-01-09,2399,2419,2419,0,27564,27791,27790,1,267,37,37,34,7861,7861,7824,7824
Placer,56,2023-01-09,259,259,259,0,3386,3414,3413,1,89,0,0,6,678,678,678,678
Plumas,56,2023-01-09,5,5,5,0,89,90,89,1,1,0,0,0,14,14,14,14
Riverside,56,2023-01-09,1973,1989,1989,0,20862,21034,21033,1,186,13,13,26,6770,6770,6757,6757
Sacramento,56,2023-01-09,1012,1021,1021,0,15551,15680,15679,1,178,17,17,28,3480,3480,3463,3463
San Benito,56,2023-01-09,51,51,51,0,817,824,823,1,1,0,0,2,109,109,109,109
San Bernardino,56,2023-01-09,1719,1733,1733,0,20419,20589,20588,1,179,6,6,36,8129,8129,8123,8123
San Diego,56,2023-01-09,3582,3612,3612,0,34792,35082,35081,1,397,24,24,40,5742,5742,5718,5718
San Francisco,56,2023-01-09,786,793,793,0,12709,12815,12814,1,75,6,6,17,1159,1159,1153,1153
San Joaquin,56,2023-01-09,585,591,591,0,10952,11045,11044,1,51,10,10,12,2406,2406,2396,2396
San Luis Obispo,56,2023-01-09,186,186,186,0,2146,2165,2164,1,12,3,3,0,551,551,548,548
San Mateo,56,2023-01-09,597,602,602,0,9544,9625,9624,1,47,0,0,5,740,740,740,740
Santa Barbara,56,2023-01-09,367,369,369,0,4502,4540,4539,1,39,3,3,1,753,753,750,750
Santa Clara,56,2023-01-09,1934,1950,1950,0,28149,28385,28384,1,182,11,11,28,2659,2659,2648,2648
Santa Cruz,56,2023-01-09,152,152,152,0,4061,4096,4095,1,27,0,0,1,276,276,276,276
Shasta,56,2023-01-09,59,59,59,0,889,897,896,1,17,0,0,2,597,597,597,597
Siskiyou,56,2023-01-09,20,20,20,0,233,234,233,1,0,0,0,0,95,95,95,95
Solano,56,2023-01-09,402,405,405,0,5181,5225,5224,1,54,1,1,6,474,474,473,473
Sonoma,56,2023-01-09,287,287,287,0,4754,4794,4793,1,31,3,3,4,546,546,543,543
Stanislaus,56,2023-01-09,303,304,304,0,5177,5220,5219,1,87,6,6,8,1832,1832,1826,1826
Sutter,56,2023-01-09,62,62,62,0,869,878,877,1,0,0,0,0,234,234,234,234
Tehama,56,2023-01-09,28,28,28,0,491,497,496,1,1,2,2,0,230,230,228,228
Trinity,56,2023-01-09,3,3,3,0,30,31,30,1,0,0,0,0,22,22,22,22
Tulare,56,2023-01-09,334,335,335,0,5103,5147,5146,1,53,4,4,2,1567,1567,1563,1563
Tuolumne,56,2023-01-09,74,74,74,0,654,661,660,1,2,1,1,0,207,207,206,206
Ventura,56,2023-01-09,662,668,668,0,9378,9457,9456,1,65,5,5,12,1653,1653,1648,1648
Yolo,56,2023-01-09,107,107,107,0,1654,1668,1667,1,2,2,2,1,437,437,435,435
Yuba,56,2023-01-09,48,48,48,0,735,743,742,1,21,0,0,1,122,122,122,122
Alameda,57,2023-01-16,864,872,872,0,18929,19111,19110,1,105,5,5,11,2169,2169,2164,2164
Amador,57,2023-01-16,21,21,21,0,585,594,593,1,4,0,0,0,97,97,97,97
Butte,57,2023-01-16,58,58,58,0,1157,1169,1168,1,21,1,1,0,485,485,484,484
Calaveras,57,2023-01-16,10,10,10,0,308,311,310,1,2,0,0,1,140,140,140,140
Colusa,57,2023-01-16,7,7,7,0,86,87,86,1,1,0,0,0,22,22,22,22
Contra Costa,57,2023-01-16,615,622,622,0,12084,12200,12199,1,61,5,5,11,1533,1533,1528,1528
Del Norte,57,2023-01-16,10,10,10,0,303,306,305,1,3,2,2,1,58,58,56,56
El Dorado,57,2023-01-16,60,60,60,0,978,989,988,1,2,1,1,1,242,242,241,241
Fresno,57,2023-01-16,461,466,466,0,9714,9809,9808,1,162,7,7,13,2976,2976,2969,2969
Glenn,57,2023-01-16,3,3,3,0,163,165,164,1,0,0,0,0,53,53,53,53
Humboldt,57,2023-01-16,35,35,35,0,494,501,500,1,9,1,1,2,168,168,167,167
Imperial,57,2023-01-16,127,127,127,0,2068,2088,2087,1,10,2,2,2,977,977,975,975
Inyo,57,2023-01-16,11,11,11,0,199,201,200,1,0,0,0,0,62,62,62,62
Kern,57,2023-01-16,383,387,387,0,8223,8304,8303,1,55,4,4,13,2471,2471,2467,2467
Kings,57,2023-01-16,125,125,125,0,1982,2002,2001,1,5,2,2,0,481,481,479,479
Lake,57,2023-01-16,23,23,23,0,576,582,581,1,2,1,1,1,155,155,154,154
Lassen,57,2023-01-16,6,6,6,0,440,446,445,1,0,0,0,0,64,64,64,64
Los Angeles,57,2023-01-16,6110,6170,6170,0,147825,149254,149252,2,855,143,151,113,35095,35131,34952,34980
Madera,57,2023-01-16,67,67,67,0,1349,1364,1363,1,4,0,0,2,375,375,375,375
Marin,57,2023-01-16,125,125,125,0,2137,2158,2157,1,20,0,0,1,317,317,317,317
Mariposa,57,2023-01-16,11,11,11,0,95,96,95,1,0,0,0,0,31,31,31,31
Mendocino,57,2023-01-16,25,25,25,0,499,505,504,1,6,0,0,0,142,142,142,142
Merced,57,2023-01-16,120,120,120,0,1681,1698,1697,1,12,3,3,5,901,901,898,898
Modoc,57,2023-01-16,2,2,2,0,9,10,9,1,0,0,0,0,9,9,9,9
Mono,57,2023-01-16,6,6,6,0,68,69,68,1,0,0,0,0,8,8,8,8
Monterey,57,2023-01-16,113,113,113,0,2601,2627,2626,1,20,3,3,2,794,794,791,791
Napa,57,2023-01-16,63,63,63,0,1508,1524,1523,1,5,0,0,0,161,161,161,161
Nevada,57,2023-01-16,25,25,25,0,564,572,571,1,4,0,0,0,136,136,136,136
Orange,57,2023-01-16,1447,1459,1459,0,23903,24134,24133,1,245,37,38,32,7898,7899,7861,7861
Placer,57,2023-01-16,163,163,163,0,2631,2658,2657,1,68,0,0,6,678,678,678,678
Plumas,57,2023-01-16,2,2,2,0,73,74,73,1,1,0,0,0,14,14,14,14
Riverside,57,2023-01-16,1213,1225,1225,0,16949,17113,17112,1,169,15,15,36,6785,6785,6770,6770
Sacramento,57,2023-01-16,568,575,575,0,12388,12510,12509,1,149,18,19,23,3498,3499,3480,3480
San Benito,57,2023-01-16,28,28,28,0,467,473,472,1,0,1,1,0,110,110,109,109
San Bernardino,57,2023-01-16,985,994,994,0,16605,16767,16766,1,148,2,2,35,8131,8131,8129,8129
San Diego,57,2023-01-16,2062,2082,2082,0,28430,28706,28705,1,327,15,15,39,5757,5757,5742,5742
San Francisco,57,2023-01-16,439,444,444,0,10123,10222,10221,1,75,1,1,12,1160,1160,1159,1159
San Joaquin,57,2023-01-16,356,360,360,0,8774,8861,8860,1,42,8,8,11,2414,2414,2406,2406
San Luis Obispo,57,2023-01-16,108,108,108,0,1777,1796,1795,1,12,2,2,3,553,553,551,551
San Mateo,57,2023-01-16,388,393,393,0,7656,7731,7730,1,37,0,0,3,740,740,740,740
Santa Barbara,57,2023-01-16,242,242,242,0,3918,3957,3956,1,34,2,2,0,755,755,753,753
Santa Clara,57,2023-01-16,1090,1101,1101,0,23748,23978,23977,1,106,15,15,16,2674,2674,2659,2659
Santa Cruz,57,2023-01-16,171,171,171,0,6495,6559,6558,1,23,0,0,1,276,276,276,276
Shasta,57,2023-01-16,40,40,40,0,690,697,696,1,13,2,2,2,599,599,597,597
Siskiyou,57,2023-01-16,6,6,6,0,208,209,208,1,0,0,0,0,95,95,95,95
Solano,57,2023-01-16,222,222,222,0,3709,3745,3744,1,49,0,0,6,474,474,474,474
Sonoma,57,2023-01-16,189,189,189,0,3769,3806,3805,1,26,5,5,2,551,551,546,546
Stanislaus,57,2023-01-16,206,206,206,0,4244,4286,4285,1,72,3,3,3,1835,1835,1832,1832
Sutter,57,2023-01-16,47,47,47,0,713,722,721,1,0,0,0,0,234,234,234,234
Tehama,57,2023-01-16,16,16,16,0,367,373,372,1,1,0,0,0,230,230,230,230
Trinity,57,2023-01-16,3,3,3,0,23,24,23,1,0,0,0,0,22,22,22,22
Tulare,57,2023-01-16,264,265,265,0,4121,4163,4162,1,45,3,3,2,1570,1570,1567,1567
Tuolumne,57,2023-01-16,44,44,44,0,548,556,555,1,1,2,2,0,209,209,207,207
Ventura,57,2023-01-16,413,418,418,0,7838,7915,7914,1,53,4,4,12,1657,1657,1653,1653
Yolo,57,2023-01-16,74,74,74,0,1251,1265,1264,1,2,2,2,0,439,439,437,437
Yuba,57,2023-01-16,38,38,38,0,595,603,602,1,9,0,0,2,122,122,122,122
Alameda,58,2023-01-23,737,744,744,0,21020,21254,21253,1,100,11,11,9,2180,2180,2169,2169
Amador,58,2023-01-23,34,34,34,0,590,598,597,1,1,1,1,0,98,98,97,97
Butte,58,2023-01-23,43,43,43,0,1081,1095,1094,1,13,1,1,0,486,486,485,485
Calaveras,58,2023-01-23,15,15,15,0,279,283,282,1,0,0,0,0,140,140,140,140
Colusa,58,2023-01-23,10,10,10,0,142,144,143,1,0,0,0,0,22,22,22,22
Contra Costa,58,2023-01-23,515,522,522,0,13285,13433,13432,1,61,6,6,6,1539,1539,1533,1533
Del Norte,58,2023-01-23,22,22,22,0,359,365,364,1,1,0,0,0,58,58,58,58
El Dorado,58,2023-01-23,40,40,40,0,1080,1094,1093,1,2,0,0,0,242,242,242,242
Fresno,58,2023-01-23,441,447,447,0,10084,10198,10197,1,117,5,5,19,2981,2981,2976,2976
Glenn,58,2023-01-23,3,3,3,0,153,155,154,1,0,0,0,0,53,53,53,53
Humboldt,58,2023-01-23,34,34,34,0,549,556,555,1,9,1,1,4,169,169,168,168
Imperial,58,2023-01-23,85,85,85,0,2257,2283,2282,1,10,1,1,1,978,978,977,977
Inyo,58,2023-01-23,6,6,6,0,164,166,165,1,0,1,1,0,63,63,62,62
Kern,58,2023-01-23,300,303,303,0,9213,9316,9315,1,34,5,5,8,2476,2476,2471,2471
Kings,58,2023-01-23,108,108,108,0,1984,2006,2005,1,6,0,0,0,481,481,481,481
Lake,58,2023-01-23,28,28,28,0,579,586,585,1,2,2,2,2,157,157,155,155
Lassen,58,2023-01-23,5,5,5,0,465,472,471,1,0,0,0,0,64,64,64,64
Los Angeles,58,2023-01-23,5598,5660,5660,0,169609,171497,171495,2,665,108,116,96,35203,35247,35095,35131
Madera,58,2023-01-23,51,51,51,0,1433,1450,1449,1,6,0,0,2,375,375,375,375
Marin,58,2023-01-23,108,108,108,0,2350,2377,2376,1,18,0,0,3,317,317,317,317
Mariposa,58,2023-01-23,7,7,7,0,103,104,103,1,0,0,0,0,31,31,31,31
Mendocino,58,2023-01-23,21,21,21,0,546,552,551,1,4,0,0,0,142,142,142,142
Merced,58,2023-01-23,126,126,126,0,1922,1945,1944,1,9,2,2,3,903,903,901,901
Modoc,58,2023-01-23,1,1,1,0,11,12,11,1,1,0,0,0,9,9,9,9
Mono,58,2023-01-23,5,5,5,0,73,74,73,1,0,0,0,0,8,8,8,8
Monterey,58,2023-01-23,106,106,106,0,2753,2785,2784,1,15,1,1,2,795,795,794,794
Napa,58,2023-01-23,77,77,77,0,1505,1523,1522,1,4,0,0,1,161,161,161,161
Nevada,58,2023-01-23,20,20,20,0,600,607,606,1,3,0,0,2,136,136,136,136
Orange,58,2023-01-23,1157,1169,1169,0,23848,24114,24113,1,177,23,23,27,7921,7922,7898,7899
Placer,58,2023-01-23,139,139,139,0,2717,2749,2748,1,42,1,1,7,679,679,678,678
Plumas,58,2023-01-23,5,5,5,0,91,92,91,1,1,0,0,0,14,14,14,14
Riverside,58,2023-01-23,1009,1021,1021,0,16073,16252,16251,1,111,14,14,22,6799,6799,6785,6785
Sacramento,58,2023-01-23,594,601,601,0,13675,13828,13827,1,134,10,10,21,3508,3509,3498,3499
San Benito,58,2023-01-23,27,27,27,0,563,570,569,1,0,0,0,0,110,110,110,110
San Bernardino,58,2023-01-23,1025,1035,1035,0,18966,19179,19178,1,127,1,1,33,8132,8132,8131,8131
San Diego,58,2023-01-23,2028,2051,2051,0,33038,33408,33407,1,236,11,11,37,5768,5768,5757,5757
San Francisco,58,2023-01-23,450,456,456,0,11231,11355,11354,1,58,6,6,5,1166,1166,1160,1160
San Joaquin,58,2023-01-23,242,243,243,0,8400,8496,8495,1,29,3,3,8,2417,2417,2414,2414
San Luis Obispo,58,2023-01-23,110,110,110,0,1949,1970,1969,1,8,3,3,2,556,556,553,553
San Mateo,58,2023-01-23,346,351,351,0,8645,8742,8741,1,21,0,0,0,740,740,740,740
Santa Barbara,58,2023-01-23,209,210,210,0,4241,4289,4288,1,28,2,2,4,757,757,755,755
Santa Clara,58,2023-01-23,1010,1021,1021,0,24371,24644,24643,1,119,5,5,23,2679,2679,2674,2674
Santa Cruz,58,2023-01-23,121,121,121,0,9481,9588,9587,1,16,0,0,0,276,276,276,276
Shasta,58,2023-01-23,23,23,23,0,755,765,764,1,6,1,1,1,600,600,599,599
Siskiyou,58,2023-01-23,6,6,6,0,178,179,178,1,0,0,0,0,95,95,95,95
Solano,58,2023-01-23,228,230,230,0,4212,4261,4260,1,33,0,0,2,474,474,474,474
Sonoma,58,2023-01-23,198,198,198,0,4277,4326,4325,1,26,0,0,4,551,551,551,551
Stanislaus,58,2023-01-23,180,180,180,0,4287,4335,4334,1,57,2,2,6,1837,1837,1835,1835
Sutter,58,2023-01-23,41,41,41,0,778,787,786,1,0,1,1,0,235,235,234,234
Tehama,58,2023-01-23,15,15,15,0,339,344,343,1,1,0,0,0,230,230,230,230
Trinity,58,2023-01-23,4,4,4,0,31,32,31,1,0,1,1,0,23,23,22,22
Tulare,58,2023-01-23,221,222,222,0,4168,4216,4215,1,27,1,1,5,1571,1571,1570,1570
Tuolumne,58,2023-01-23,36,36,36,0,484,491,490,1,0,1,1,1,210,210,209,209
Ventura,58,2023-01-23,367,372,372,0,8578,8675,8674,1,57,5,5,3,1662,1662,1657,1657
Yolo,58,2023-01-23,85,85,85,0,1364,1380,1379,1,2,3,3,0,442,442,439,439
Yuba,58,2023-01-23,30,30,30,0,725,733,732,1,3,0,0,0,122,122,122,122
Alameda,59,2023-01-30,833,843,843,0,18320,18550,18549,1,85,4,4,4,2184,2184,2180,2180
Amador,59,2023-01-30,24,24,24,0,620,629,628,1,3,0,0,0,98,98,98,98
Butte,59,2023-01-30,55,55,55,0,1124,1139,1138,1,13,2,2,2,488,488,486,486
Calaveras,59,2023-01-30,16,16,16,0,318,324,323,1,0,1,1,0,141,141,140,140
Colusa,59,2023-01-30,7,7,7,0,169,172,171,1,0,0,0,0,22,22,22,22
Contra Costa,59,2023-01-30,647,655,655,0,12402,12557,12556,1,38,9,9,6,1548,1548,1539,1539
Del Norte,59,2023-01-30,31,31,31,0,382,389,388,1,1,1,1,0,59,59,58,58
El Dorado,59,2023-01-30,60,60,60,0,1190,1205,1204,1,4,2,2,0,244,244,242,242
Fresno,59,2023-01-30,445,452,452,0,9854,9978,9977,1,117,8,8,10,2989,2989,2981,2981
Glenn,59,2023-01-30,2,2,2,0,155,157,156,1,0,0,0,0,53,53,53,53
Humboldt,59,2023-01-30,29,29,29,0,563,571,570,1,6,0,0,1,169,169,169,169
Imperial,59,2023-01-30,103,103,103,0,2068,2096,2095,1,7,1,1,0,979,979,978,978
Inyo,59,2023-01-30,10,10,10,0,202,204,203,1,1,0,0,0,63,63,63,63
Kern,59,2023-01-30,299,303,303,0,8706,8815,8814,1,36,1,1,8,2477,2477,2476,2476
Kings,59,2023-01-30,136,136,136,0,2211,2239,2238,1,7,1,1,1,482,482,481,481
Lake,59,2023-01-30,26,26,26,0,555,563,562,1,5,2,2,1,159,159,157,157
Lassen,59,2023-01-30,4,4,4,0,490,496,495,1,0,0,0,0,64,64,64,64
Los Angeles,59,2023-01-30,5783,5857,5857,0,151837,153747,153745,2,633,105,115,72,35308,35362,35203,35247
Madera,59,2023-01-30,48,48,48,0,1479,1499,1498,1,7,0,0,0,375,375,375,375
Marin,59,2023-01-30,100,100,100,0,2155,2183,2182,1,19,0,0,1,317,317,317,317
Mariposa,59,2023-01-30,5,5,5,0,105,106,105,1,0,0,0,0,31,31,31,31
Mendocino,59,2023-01-30,24,24,24,0,518,525,524,1,2,0,0,1,142,142,142,142
Merced,59,2023-01-30,135,135,135,0,1797,1821,1820,1,11,0,0,3,903,903,903,903
Modoc,59,2023-01-30,0,0,0,0,8,9,8,1,1,0,0,0,9,9,9,9
Mono,59,2023-01-30,2,2,2,0,67,68,67,1,0,0,0,0,8,8,8,8
Monterey,59,2023-01-30,155,155,155,0,2843,2881,2880,1,8,1,1,1,796,796,795,795
Napa,59,2023-01-30,73,73,73,0,1370,1388,1387,1,4,0,0,0,161,161,161,161
Nevada,59,2023-01-30,29,29,29,0,589,598,597,1,2,0,0,1,136,136,136,136
Orange,59,2023-01-30,1182,1195,1195,0,22514,22798,22797,1,136,11,11,25,7932,7933,7921,7922
Placer,59,2023-01-30,171,171,171,0,2705,2740,2739,1,49,2,2,3,681,681,679,679
Plumas,59,2023-01-30,3,3,3,0,75,76,75,1,0,0,0,0,14,14,14,14
Riverside,59,2023-01-30,1070,1084,1084,0,15878,16078,16077,1,84,5,5,17,6804,6804,6799,6799
Sacramento,59,2023-01-30,671,679,679,0,13344,13513,13512,1,117,8,8,13,3516,3517,3508,3509
San Benito,59,2023-01-30,30,30,30,0,562,570,569,1,0,0,0,0,110,110,110,110
San Bernardino,59,2023-01-30,924,935,935,0,17118,17335,17334,1,140,0,0,19,8132,8132,8132,8132
San Diego,59,2023-01-30,1858,1882,1882,0,30025,30404,30403,1,202,10,10,32,5778,5778,5768,5768
San Francisco,59,2023-01-30,472,479,479,0,10852,10989,10988,1,51,2,2,4,1168,1168,1166,1166
San Joaquin,59,2023-01-30,301,306,306,0,7657,7754,7753,1,22,3,3,5,2420,2420,2417,2417
San Luis Obispo,59,2023-01-30,141,141,141,0,1912,1937,1936,1,13,5,5,0,561,561,556,556
San Mateo,59,2023-01-30,426,431,431,0,8559,8668,8667,1,25,0,0,3,740,740,740,740
Santa Barbara,59,2023-01-30,226,228,228,0,4263,4318,4317,1,25,1,1,2,758,758,757,757
Santa Clara,59,2023-01-30,1168,1183,1183,0,23403,23698,23697,1,132,5,5,14,2684,2684,2679,2679
Santa Cruz,59,2023-01-30,133,133,133,0,9328,9447,9446,1,12,0,0,0,276,276,276,276
Shasta,59,2023-01-30,18,18,18,0,665,675,674,1,7,0,0,0,600,600,600,600
Siskiyou,59,2023-01-30,6,6,6,0,195,196,195,1,0,0,0,0,95,95,95,95
Solano,59,2023-01-30,234,235,235,0,4167,4221,4220,1,40,0,0,1,474,474,474,474
Sonoma,59,2023-01-30,156,157,157,0,3596,3643,3642,1,23,1,1,1,552,552,551,551
Stanislaus,59,2023-01-30,229,230,230,0,4127,4179,4178,1,43,2,2,3,1839,1839,1837,1837
Sutter,59,2023-01-30,36,36,36,0,609,618,617,1,0,1,1,0,236,236,235,235
Tehama,59,2023-01-30,8,8,8,0,317,323,322,1,1,1,1,0,231,231,230,230
Trinity,59,2023-01-30,7,7,7,0,26,27,26,1,0,0,0,0,23,23,23,23
Tulare,59,2023-01-30,262,264,264,0,4020,4073,4072,1,28,3,3,3,1574,1574,1571,1571
Tuolumne,59,2023-01-30,45,45,45,0,600,609,608,1,3,0,0,0,210,210,210,210
Ventura,59,2023-01-30,363,369,369,0,8119,8222,8221,1,46,7,7,8,1669,1669,1662,1662
Yolo,59,2023-01-30,86,86,86,0,1296,1312,1311,1,2,1,1,0,443,443,442,442
Yuba,59,2023-01-30,31,31,31,0,656,665,664,1,3,0,0,1,122,122,122,122
Alameda,60,2023-02-06,1095,1111,1111,0,18118,18379,18378,1,86,5,5,9,2189,2189,2184,2184
Amador,60,2023-02-06,29,29,29,0,637,647,646,1,1,0,0,0,98,98,98,98
Butte,60,2023-02-06,83,83,83,0,1208,1225,1224,1,20,0,0,1,488,488,488,488
Calaveras,60,2023-02-06,14,14,14,0,323,329,328,1,0,0,0,0,141,141,141,141
Colusa,60,2023-02-06,6,6,6,0,184,187,186,1,0,0,0,0,22,22,22,22
Contra Costa,60,2023-02-06,709,719,719,0,11845,12015,12014,1,50,2,2,9,1550,1550,1548,1548
Del Norte,60,2023-02-06,58,58,58,0,394,401,400,1,0,0,0,0,59,59,59,59
El Dorado,60,2023-02-06,59,59,59,0,1132,1149,1148,1,3,0,0,0,244,244,244,244
Fresno,60,2023-02-06,502,510,510,0,9023,9153,9152,1,89,4,4,15,2993,2993,2989,2989
Glenn,60,2023-02-06,10,10,10,0,170,172,171,1,0,0,0,0,53,53,53,53
Humboldt,60,2023-02-06,56,56,56,0,565,574,573,1,6,1,1,0,170,170,169,169
Imperial,60,2023-02-06,121,121,121,0,2097,2128,2127,1,7,1,1,0,980,980,979,979
Inyo,60,2023-02-06,9,9,9,0,209,213,212,1,0,0,0,0,63,63,63,63
Kern,60,2023-02-06,327,332,332,0,8524,8647,8646,1,34,2,2,4,2479,2479,2477,2477
Kings,60,2023-02-06,126,126,126,0,2055,2086,2085,1,3,0,0,1,482,482,482,482
Lake,60,2023-02-06,25,25,25,0,561,570,569,1,5,1,1,0,160,160,159,159
Lassen,60,2023-02-06,6,6,6,0,445,453,452,1,0,0,0,0,64,64,64,64
Los Angeles,60,2023-02-06,5883,5966,5966,0,141377,143400,143398,2,609,88,99,83,35396,35461,35308,35362
Madera,60,2023-02-06,55,55,55,0,1308,1326,1325,1,4,1,1,0,376,376,375,375
Marin,60,2023-02-06,144,144,144,0,2131,2162,2161,1,13,0,0,3,317,317,317,317
Mariposa,60,2023-02-06,2,2,2,0,105,106,105,1,0,0,0,0,31,31,31,31
Mendocino,60,2023-02-06,31,31,31,0,513,521,520,1,4,0,0,2,142,142,142,142
Merced,60,2023-02-06,166,166,166,0,1885,1912,1911,1,12,0,0,0,903,903,903,903
Modoc,60,2023-02-06,2,2,2,0,6,7,6,1,0,0,0,0,9,9,9,9
Mono,60,2023-02-06,4,4,4,0,92,93,92,1,0,0,0,0,8,8,8,8
Monterey,60,2023-02-06,226,229,229,0,2937,2980,2979,1,22,3,3,1,799,799,796,796
Napa,60,2023-02-06,109,109,109,0,1404,1426,1425,1,4,0,0,3,161,161,161,161
Nevada,60,2023-02-06,32,32,32,0,572,581,580,1,4,0,0,0,136,136,136,136
Orange,60,2023-02-06,1277,1297,1297,0,22045,22361,22360,1,154,15,16,20,7947,7949,7932,7933
Placer,60,2023-02-06,164,164,164,0,2650,2689,2688,1,41,0,0,4,681,681,681,681
Plumas,60,2023-02-06,2,2,2,0,72,73,72,1,0,1,1,0,15,15,14,14
Riverside,60,2023-02-06,1119,1136,1136,0,15374,15595,15594,1,89,3,3,14,6807,6807,6804,6804
Sacramento,60,2023-02-06,728,738,738,0,13142,13331,13330,1,96,5,5,19,3521,3522,3516,3517
San Benito,60,2023-02-06,50,50,50,0,538,547,546,1,1,0,0,0,110,110,110,110
San Bernardino,60,2023-02-06,1061,1077,1077,0,17310,17558,17557,1,152,0,0,17,8132,8132,8132,8132
San Diego,60,2023-02-06,1869,1896,1896,0,29906,30335,30334,1,230,8,8,23,5786,5786,5778,5778
San Francisco,60,2023-02-06,573,581,581,0,10493,10643,10642,1,58,3,3,2,1171,1171,1168,1168
San Joaquin,60,2023-02-06,433,441,441,0,6926,7027,7026,1,32,1,1,3,2421,2421,2420,2420
San Luis Obispo,60,2023-02-06,150,152,152,0,1904,1934,1933,1,7,1,1,0,562,562,561,561
San Mateo,60,2023-02-06,528,535,535,0,8136,8255,8254,1,42,0,0,1,740,740,740,740
Santa Barbara,60,2023-02-06,238,242,242,0,4364,4429,4428,1,21,1,1,0,759,759,758,758
Santa Clara,60,2023-02-06,1296,1316,1316,0,23215,23548,23547,1,123,9,9,23,2693,2693,2684,2684
Santa Cruz,60,2023-02-06,232,234,234,0,10394,10545,10544,1,11,0,0,0,276,276,276,276
Shasta,60,2023-02-06,24,24,24,0,649,661,660,1,9,0,0,0,600,600,600,600
Siskiyou,60,2023-02-06,11,11,11,0,221,224,223,1,0,0,0,0,95,95,95,95
Solano,60,2023-02-06,284,289,289,0,3852,3908,3907,1,41,0,0,5,474,474,474,474
Sonoma,60,2023-02-06,265,270,270,0,3566,3617,3616,1,17,2,2,1,554,554,552,552
Stanislaus,60,2023-02-06,276,281,281,0,3926,3982,3981,1,54,1,1,6,1840,1840,1839,1839
Sutter,60,2023-02-06,50,50,50,0,705,716,715,1,0,0,0,0,236,236,236,236
Tehama,60,2023-02-06,17,17,17,0,323,330,329,1,2,0,0,0,231,231,231,231
Trinity,60,2023-02-06,1,1,1,0,19,20,19,1,0,0,0,0,23,23,23,23
Tulare,60,2023-02-06,274,279,279,0,4389,4455,4454,1,28,2,2,3,1576,1576,1574,1574
Tuolumne,60,2023-02-06,48,48,48,0,555,564,563,1,1,0,0,0,210,210,210,210
Ventura,60,2023-02-06,325,331,331,0,6921,7022,7021,1,39,1,1,5,1670,1670,1669,1669
Yolo,60,2023-02-06,79,79,79,0,1247,1267,1266,1,4,1,1,2,444,444,443,443
Yuba,60,2023-02-06,22,22,22,0,623,632,631,1,3,0,0,1,122,122,122,122
Alameda,61,2023-02-13,1094,1112,1112,0,17503,17794,17793,1,90,2,2,8,2191,2191,2189,2189
Amador,61,2023-02-13,19,19,19,0,497,506,505,1,0,0,0,0,98,98,98,98
Butte,61,2023-02-13,86,86,86,0,1250,1272,1271,1,25,1,1,2,489,489,488,488
Calaveras,61,2023-02-13,14,14,14,0,295,301,300,1,0,0,0,0,141,141,141,141
Colusa,61,2023-02-13,8,8,8,0,137,139,138,1,0,0,0,0,22,22,22,22
Contra Costa,61,2023-02-13,689,701,701,0,11531,11722,11721,1,44,2,2,10,1552,1552,1550,1550
Del Norte,61,2023-02-13,19,19,19,0,299,306,305,1,2,0,0,0,59,59,59,59
El Dorado,61,2023-02-13,65,65,65,0,1099,1118,1117,1,2,0,0,0,244,244,244,244
Fresno,61,2023-02-13,467,475,475,0,8720,8866,8865,1,106,4,4,7,2997,2997,2993,2993
Glenn,61,2023-02-13,11,11,11,0,175,178,177,1,5,0,0,0,53,53,53,53
Humboldt,61,2023-02-13,37,37,37,0,577,588,587,1,7,0,0,1,170,170,170,170
Imperial,61,2023-02-13,143,143,143,0,1855,1886,1885,1,3,0,0,5,980,980,980,980
Inyo,61,2023-02-13,6,6,6,0,199,203,202,1,0,0,0,0,63,63,63,63
Kern,61,2023-02-13,321,328,328,0,7971,8104,8103,1,37,2,2,6,2481,2481,2479,2479
Kings,61,2023-02-13,88,88,88,0,1890,1922,1921,1,6,1,1,0,483,483,482,482
Lake,61,2023-02-13,20,20,20,0,567,578,577,1,2,0,0,0,160,160,160,160
Lassen,61,2023-02-13,5,5,5,0,361,369,368,1,0,0,0,0,64,64,64,64
Los Angeles,61,2023-02-13,5892,5992,5992,0,129613,131757,131756,1,613,71,83,67,35467,35544,35396,35461
Madera,61,2023-02-13,60,60,60,0,1238,1260,1259,1,7,0,0,2,376,376,376,376
Marin,61,2023-02-13,141,141,141,0,1929,1961,1960,1,19,0,0,3,317,317,317,317
Mariposa,61,2023-02-13,3,3,3,0,102,103,102,1,0,0,0,0,31,31,31,31
Mendocino,61,2023-02-13,28,28,28,0,538,548,547,1,3,2,2,1,144,144,142,142
Merced,61,2023-02-13,167,168,168,0,1856,1888,1887,1,8,0,0,0,903,903,903,903
Modoc,61,2023-02-13,0,0,0,0,2,3,2,1,0,0,0,0,9,9,9,9
Mono,61,2023-02-13,1,1,1,0,66,67,66,1,0,0,0,0,8,8,8,8
Monterey,61,2023-02-13,221,225,225,0,2488,2529,2528,1,25,3,3,1,802,802,799,799
Napa,61,2023-02-13,92,92,92,0,1364,1387,1386,1,4,0,0,0,161,161,161,161
Nevada,61,2023-02-13,37,37,37,0,596,607,606,1,4,0,0,1,136,136,136,136
Orange,61,2023-02-13,1366,1388,1388,0,20350,20685,20684,1,161,8,8,21,7955,7957,7947,7949
Placer,61,2023-02-13,160,161,161,0,2612,2655,2654,1,35,0,0,6,681,681,681,681
Plumas,61,2023-02-13,3,3,3,0,80,81,80,1,1,0,0,0,15,15,15,15
Riverside,61,2023-02-13,1088,1107,1107,0,15940,16204,16203,1,93,7,7,16,6814,6814,6807,6807
Sacramento,61,2023-02-13,813,826,826,0,13020,13237,13236,1,113,5,5,19,3526,3527,3521,3522
San Benito,61,2023-02-13,42,42,42,0,565,575,574,1,1,0,0,0,110,110,110,110
San Bernardino,61,2023-02-13,1009,1026,1026,0,16811,17091,17090,1,134,0,0,18,8132,8132,8132,8132
San Diego,61,2023-02-13,2022,2056,2056,0,29014,29495,29494,1,218,4,4,25,5790,5790,5786,5786
San Francisco,61,2023-02-13,591,600,600,0,10651,10827,10826,1,59,3,3,5,1174,1174,1171,1171
San Joaquin,61,2023-02-13,451,459,459,0,6959,7076,7075,1,28,1,1,3,2422,2422,2421,2421
San Luis Obispo,61,2023-02-13,133,134,134,0,1680,1708,1707,1,4,1,1,4,563,563,562,562
San Mateo,61,2023-02-13,520,528,528,0,8128,8264,8263,1,29,0,0,5,740,740,740,740
Santa Barbara,61,2023-02-13,188,190,190,0,3936,4002,4001,1,16,1,1,5,760,760,759,759
Santa Clara,61,2023-02-13,1358,1380,1380,0,22921,23303,23302,1,114,8,9,25,2701,2702,2693,2693
Santa Cruz,61,2023-02-13,207,209,209,0,9620,9780,9779,1,19,0,0,0,276,276,276,276
Shasta,61,2023-02-13,33,33,33,0,669,682,681,1,7,0,0,0,600,600,600,600
Siskiyou,61,2023-02-13,11,11,11,0,199,201,200,1,0,0,0,0,95,95,95,95
Solano,61,2023-02-13,258,263,263,0,3775,3838,3837,1,28,0,0,3,474,474,474,474
Sonoma,61,2023-02-13,234,238,238,0,3422,3480,3479,1,32,1,1,1,555,555,554,554
Stanislaus,61,2023-02-13,266,272,272,0,3808,3872,3871,1,47,1,1,9,1841,1841,1840,1840
Sutter,61,2023-02-13,46,46,46,0,658,670,669,1,0,1,1,0,237,237,236,236
Tehama,61,2023-02-13,16,16,16,0,295,301,300,1,1,2,2,0,233,233,231,231
Trinity,61,2023-02-13,1,1,1,0,26,27,26,1,0,0,0,0,23,23,23,23
Tulare,61,2023-02-13,247,252,252,0,4114,4183,4182,1,29,2,2,1,1578,1578,1576,1576
Tuolumne,61,2023-02-13,36,36,36,0,508,517,516,1,2,0,0,0,210,210,210,210
Ventura,61,2023-02-13,315,321,321,0,6655,6765,6764,1,29,3,3,6,1673,1673,1670,1670
Yolo,61,2023-02-13,73,73,73,0,1241,1262,1261,1,3,0,0,1,444,444,444,444
Yuba,61,2023-02-13,30,30,30,0,643,656,655,1,8,0,0,0,122,122,122,122
Alameda,62,2023-02-20,1010,1029,1029,0,15336,15637,15636,1,79,3,3,5,2194,2194,2191,2191
Amador,62,2023-02-20,25,25,25,0,496,506,505,1,1,0,0,1,98,98,98,98
Butte,62,2023-02-20,44,44,44,0,1051,1073,1072,1,7,2,2,1,491,491,489,489
Calaveras,62,2023-02-20,17,17,17,0,289,295,294,1,0,0,0,1,141,141,141,141
Colusa,62,2023-02-20,12,12,12,0,92,93,92,1,0,0,0,0,22,22,22,22
Contra Costa,62,2023-02-20,667,681,681,0,9982,10179,10178,1,57,5,7,6,1557,1559,1552,1552
Del Norte,62,2023-02-20,11,11,11,0,258,266,265,1,2,0,0,0,59,59,59,59
El Dorado,62,2023-02-20,51,51,51,0,975,997,996,1,2,0,0,1,244,244,244,244
Fresno,62,2023-02-20,454,461,461,0,8222,8386,8385,1,84,5,6,17,3002,3003,2997,2997
Glenn,62,2023-02-20,5,5,5,0,146,149,148,1,5,0,0,0,53,53,53,53
Humboldt,62,2023-02-20,33,33,33,0,575,588,587,1,7,0,0,1,170,170,170,170
Imperial,62,2023-02-20,119,119,119,0,1779,1816,1815,1,8,0,0,0,980,980,980,980
Inyo,62,2023-02-20,6,6,6,0,162,166,165,1,0,0,0,0,63,63,63,63
Kern,62,2023-02-20,399,407,407,0,7387,7535,7534,1,29,3,4,5,2484,2485,2481,2481
Kings,62,2023-02-20,77,77,77,0,1638,1671,1670,1,5,1,1,0,484,484,483,483
Lake,62,2023-02-20,18,18,18,0,483,495,494,1,2,0,0,1,160,160,160,160
Lassen,62,2023-02-20,2,2,2,0,327,335,334,1,0,0,0,0,64,64,64,64
Los Angeles,62,2023-02-20,5621,5733,5733,0,117794,120109,120108,1,601,72,90,76,35539,35634,35467,35544
Madera,62,2023-02-20,61,61,61,0,1089,1111,1110,1,3,0,0,2,376,376,376,376
Marin,62,2023-02-20,153,156,156,0,1851,1887,1886,1,13,0,0,2,317,317,317,317
Mariposa,62,2023-02-20,6,6,6,0,121,123,122,1,0,0,0,0,31,31,31,31
Mendocino,62,2023-02-20,25,25,25,0,489,500,499,1,3,0,0,0,144,144,144,144
Merced,62,2023-02-20,122,122,122,0,1753,1789,1788,1,19,0,0,1,903,903,903,903
Modoc,62,2023-02-20,1,1,1,0,15,16,15,1,0,0,0,0,9,9,9,9
Mono,62,2023-02-20,2,2,2,0,67,68,67,1,0,0,0,0,8,8,8,8
Monterey,62,2023-02-20,153,155,155,0,2319,2364,2363,1,22,0,0,0,802,802,802,802
Napa,62,2023-02-20,77,77,77,0,1085,1107,1106,1,3,1,1,1,162,162,161,161
Nevada,62,2023-02-20,28,28,28,0,611,624,623,1,7,1,1,1,137,137,136,136
Orange,62,2023-02-20,1319,1344,1344,0,19208,19586,19585,1,158,9,11,21,7964,7968,7955,7957
Placer,62,2023-02-20,161,164,164,0,2413,2463,2462,1,48,1,1,3,682,682,681,681
Plumas,62,2023-02-20,8,8,8,0,75,76,75,1,0,0,0,0,15,15,15,15
Riverside,62,2023-02-20,984,1003,1003,0,15072,15368,15367,1,92,6,8,9,6820,6822,6814,6814
Sacramento,62,2023-02-20,726,741,741,0,11510,11739,11738,1,103,11,14,16,3537,3541,3526,3527
San Benito,62,2023-02-20,27,27,27,0,476,486,485,1,1,2,2,0,112,112,110,110
San Bernardino,62,2023-02-20,891,908,908,0,15068,15365,15364,1,117,0,0,27,8132,8132,8132,8132
San Diego,62,2023-02-20,1762,1797,1797,0,25193,25689,25688,1,201,7,9,25,5797,5799,5790,5790
San Francisco,62,2023-02-20,589,603,603,0,9881,10075,10074,1,79,0,0,7,1174,1174,1174,1174
San Joaquin,62,2023-02-20,411,418,418,0,7361,7507,7506,1,30,1,1,7,2423,2423,2422,2422
San Luis Obispo,62,2023-02-20,96,96,96,0,1435,1465,1464,1,11,0,0,0,563,563,563,563
San Mateo,62,2023-02-20,466,475,475,0,7371,7517,7516,1,44,0,0,3,740,740,740,740
Santa Barbara,62,2023-02-20,206,211,211,0,3628,3701,3700,1,18,0,0,5,760,760,760,760
Santa Clara,62,2023-02-20,1213,1238,1238,0,19310,19688,19687,1,111,11,13,26,2712,2715,2701,2702
Santa Cruz,62,2023-02-20,136,137,137,0,6262,6383,6382,1,20,0,0,2,276,276,276,276
Shasta,62,2023-02-20,18,18,18,0,728,743,742,1,2,0,0,0,600,600,600,600
Siskiyou,62,2023-02-20,14,14,14,0,198,204,203,1,0,0,0,0,95,95,95,95
Solano,62,2023-02-20,230,234,234,0,3262,3327,3326,1,26,0,0,3,474,474,474,474
Sonoma,62,2023-02-20,260,266,266,0,3198,3263,3262,1,24,1,1,4,556,556,555,555
Stanislaus,62,2023-02-20,265,271,271,0,3643,3714,3713,1,55,0,0,4,1841,1841,1841,1841
Sutter,62,2023-02-20,38,38,38,0,539,551,550,1,0,1,1,0,238,238,237,237
Tehama,62,2023-02-20,13,13,13,0,279,286,285,1,0,0,0,0,233,233,233,233
Trinity,62,2023-02-20,0,0,0,0,30,31,30,1,0,0,0,0,23,23,23,23
Tulare,62,2023-02-20,214,218,218,0,3794,3870,3869,1,23,0,0,0,1578,1578,1578,1578
Tuolumne,62,2023-02-20,32,32,32,0,446,455,454,1,0,0,0,0,210,210,210,210
Ventura,62,2023-02-20,282,289,289,0,5618,5730,5729,1,30,4,4,7,1677,1677,1673,1673
Yolo,62,2023-02-20,87,87,87,0,1277,1303,1302,1,1,2,2,1,446,446,444,444
Yuba,62,2023-02-20,25,25,25,0,507,518,517,1,6,0,0,0,122,122,122,122
Alameda,63,2023-02-27,1106,1134,1134,0,18447,18910,18909,1,96,6,9,9,2200,2203,2194,2194
Amador,63,2023-02-27,19,19,19,0,521,535,534,1,1,0,0,1,98,98,98,98
Butte,63,2023-02-27,53,53,53,0,944,969,968,1,8,1,1,1,492,492,491,491
Calaveras,63,2023-02-27,15,15,15,0,306,315,314,1,1,0,0,0,141,141,141,141
Colusa,63,2023-02-27,12,12,12,0,85,87,86,1,0,0,0,0,22,22,22,22
Contra Costa,63,2023-02-27,712,730,730,0,11406,11692,11691,1,63,3,3,11,1560,1562,1557,1559
Del Norte,63,2023-02-27,7,7,7,0,288,296,295,1,0,0,0,0,59,59,59,59
El Dorado,63,2023-02-27,61,61,61,0,1037,1064,1063,1,2,1,1,0,245,245,244,244
Fresno,63,2023-02-27,464,476,476,0,8995,9223,9222,1,93,2,3,7,3004,3006,3002,3003
Glenn,63,2023-02-27,3,3,3,0,143,146,145,1,1,0,0,0,53,53,53,53
Humboldt,63,2023-02-27,28,28,28,0,489,503,502,1,4,0,0,1,170,170,170,170
Imperial,63,2023-02-27,173,179,179,0,1833,1881,1880,1,13,0,0,0,980,980,980,980
Inyo,63,2023-02-27,4,4,4,0,154,159,158,1,0,0,0,0,63,63,63,63
Kern,63,2023-02-27,397,407,407,0,8167,8371,8370,1,42,3,4,7,2487,2489,2484,2485
Kings,63,2023-02-27,63,63,63,0,1685,1727,1726,1,4,0,0,0,484,484,484,484
Lake,63,2023-02-27,22,22,22,0,465,477,476,1,2,1,1,1,161,161,160,160
Lassen,63,2023-02-27,3,3,3,0,352,362,361,1,0,0,0,0,64,64,64,64
Los Angeles,63,2023-02-27,5309,5444,5444,0,134095,137446,137444,2,573,59,85,75,35598,35719,35539,35634
Madera,63,2023-02-27,62,62,62,0,1187,1217,1216,1,7,0,0,1,376,376,376,376
Marin,63,2023-02-27,144,147,147,0,1963,2014,2013,1,16,0,0,3,317,317,317,317
Mariposa,63,2023-02-27,7,7,7,0,97,99,98,1,0,0,0,0,31,31,31,31
Mendocino,63,2023-02-27,21,21,21,0,492,505,504,1,5,0,0,1,144,144,144,144
Merced,63,2023-02-27,122,123,123,0,1885,1933,1932,1,19,0,0,1,903,903,903,903
Modoc,63,2023-02-27,1,1,1,0,8,9,8,1,0,0,0,0,9,9,9,9
Mono,63,2023-02-27,5,5,5,0,52,53,52,1,0,0,0,0,8,8,8,8
Monterey,63,2023-02-27,174,179,179,0,2577,2643,2642,1,30,2,3,1,804,805,802,802
Napa,63,2023-02-27,79,79,79,0,1316,1351,1350,1,7,1,1,4,163,163,162,162
Nevada,63,2023-02-27,25,25,25,0,565,581,580,1,2,0,0,0,137,137,137,137
Orange,63,2023-02-27,1178,1208,1208,0,19396,19883,19882,1,161,16,24,21,7980,7992,7964,7968
Placer,63,2023-02-27,181,187,187,0,2564,2630,2629,1,44,0,0,7,682,682,682,682
Plumas,63,2023-02-27,3,3,3,0,88,90,89,1,0,0,0,0,15,15,15,15
Riverside,63,2023-02-27,913,936,936,0,15323,15706,15705,1,76,7,10,15,6827,6832,6820,6822
Sacramento,63,2023-02-27,925,950,950,0,12716,13036,13035,1,121,5,8,19,3542,3549,3537,3541
San Benito,63,2023-02-27,29,29,29,0,473,487,486,1,2,0,0,0,112,112,112,112
San Bernardino,63,2023-02-27,856,877,877,0,16204,16613,16612,1,111,0,0,24,8132,8132,8132,8132
San Diego,63,2023-02-27,1798,1842,1842,0,27275,27959,27958,1,210,5,7,21,5802,5806,5797,5799
San Francisco,63,2023-02-27,661,678,678,0,11535,11826,11825,1,76,5,7,8,1179,1181,1174,1174
San Joaquin,63,2023-02-27,413,423,423,0,7514,7705,7704,1,33,2,4,3,2425,2427,2423,2423
San Luis Obispo,63,2023-02-27,83,84,84,0,1670,1712,1711,1,11,2,3,0,565,566,563,563
San Mateo,63,2023-02-27,476,488,488,0,7369,7555,7554,1,43,0,0,4,740,740,740,740
Santa Barbara,63,2023-02-27,176,181,181,0,3558,3649,3648,1,18,1,2,8,761,762,760,760
Santa Clara,63,2023-02-27,1327,1359,1359,0,21345,21883,21882,1,126,8,11,26,2720,2726,2712,2715
Santa Cruz,63,2023-02-27,161,165,165,0,8753,8975,8974,1,7,0,0,1,276,276,276,276
Shasta,63,2023-02-27,37,37,37,0,653,671,670,1,9,0,0,1,600,600,600,600
Siskiyou,63,2023-02-27,11,11,11,0,235,243,242,1,0,0,0,0,95,95,95,95
Solano,63,2023-02-27,293,301,301,0,3675,3768,3767,1,30,0,0,8,474,474,474,474
Sonoma,63,2023-02-27,217,223,223,0,3407,3493,3492,1,33,1,2,5,557,558,556,556
Stanislaus,63,2023-02-27,243,250,250,0,3839,3936,3935,1,58,0,0,3,1841,1841,1841,1841
Sutter,63,2023-02-27,46,46,46,0,503,517,516,1,0,0,0,0,238,238,238,238
Tehama,63,2023-02-27,14,14,14,0,267,276,275,1,2,0,0,1,233,233,233,233
Trinity,63,2023-02-27,0,0,0,0,20,21,20,1,0,0,0,0,23,23,23,23
Tulare,63,2023-02-27,217,224,224,0,4010,4111,4110,1,22,3,3,2,1581,1581,1578,1578
Tuolumne,63,2023-02-27,40,40,40,0,472,485,484,1,0,0,0,1,210,210,210,210
Ventura,63,2023-02-27,274,282,282,0,5911,6060,6059,1,35,2,2,7,1679,1679,1677,1677
Yolo,63,2023-02-27,91,92,92,0,1360,1395,1394,1,3,1,2,1,447,448,446,446
Yuba,63,2023-02-27,35,35,35,0,508,522,521,1,0,0,0,0,122,122,122,122
Alameda,64,2023-03-06,911,943,943,0,16459,17037,17036,1,96,2,4,12,2202,2207,2200,2203
Amador,64,2023-03-06,13,13,13,0,461,478,477,1,0,0,0,0,98,98,98,98
Butte,64,2023-03-06,35,35,35,0,590,611,610,1,5,0,0,0,492,492,492,492
Calaveras,64,2023-03-06,18,18,18,0,269,279,278,1,0,1,3,0,142,144,141,141
Colusa,64,2023-03-06,13,13,13,0,161,167,166,1,0,0,0,0,22,22,22,22
Contra Costa,64,2023-03-06,676,699,699,0,10210,10571,10570,1,64,3,6,8,1563,1568,1560,1562
Del Norte,64,2023-03-06,6,6,6,0,253,264,263,1,1,1,3,1,60,62,59,59
El Dorado,64,2023-03-06,52,53,53,0,955,990,989,1,2,0,0,0,245,245,245,245
Fresno,64,2023-03-06,388,402,402,0,7963,8244,8243,1,77,3,6,16,3007,3012,3004,3006
Glenn,64,2023-03-06,4,4,4,0,163,170,169,1,0,0,0,0,53,53,53,53
Humboldt,64,2023-03-06,20,20,20,0,489,507,506,1,1,0,0,1,170,170,170,170
Imperial,64,2023-03-06,167,175,175,0,1604,1664,1663,1,9,0,0,0,980,980,980,980
Inyo,64,2023-03-06,4,4,4,0,135,139,138,1,1,0,0,0,63,63,63,63
Kern,64,2023-03-06,325,337,337,0,7702,7973,7972,1,35,0,0,4,2487,2489,2487,2489
Kings,64,2023-03-06,64,65,65,0,1564,1620,1619,1,1,0,0,0,484,484,484,484
Lake,64,2023-03-06,18,18,18,0,487,505,504,1,1,0,0,0,161,161,161,161
Lassen,64,2023-03-06,4,4,4,0,306,318,317,1,1,0,0,0,64,64,64,64
Los Angeles,64,2023-03-06,4542,4702,4702,0,122591,126887,126886,1,509,51,96,60,35649,35815,35598,35719
Madera,64,2023-03-06,82,85,85,0,1144,1186,1185,1,5,0,0,0,376,376,376,376
Marin,64,2023-03-06,138,145,145,0,1773,1837,1836,1,21,0,0,2,317,317,317,317
Mariposa,64,2023-03-06,0,0,0,0,69,71,70,1,0,0,0,0,31,31,31,31
Mendocino,64,2023-03-06,25,25,25,0,448,464,463,1,7,0,0,1,144,144,144,144
Merced,64,2023-03-06,146,152,152,0,1717,1778,1777,1,14,0,0,2,903,903,903,903
Modoc,64,2023-03-06,1,1,1,0,9,10,9,1,0,0,0,0,9,9,9,9
Mono,64,2023-03-06,5,5,5,0,56,57,56,1,0,0,0,0,8,8,8,8
Monterey,64,2023-03-06,146,152,152,0,2156,2232,2231,1,29,2,5,3,806,810,804,805
Napa,64,2023-03-06,52,52,52,0,1053,1091,1090,1,9,0,0,2,163,163,163,163
Nevada,64,2023-03-06,17,17,17,0,483,501,500,1,2,0,0,0,137,137,137,137
Orange,64,2023-03-06,968,1002,1002,0,18717,19380,19379,1,111,11,22,18,7991,8014,7980,7992
Placer,64,2023-03-06,169,176,176,0,2455,2544,2543,1,62,0,0,5,682,682,682,682
Plumas,64,2023-03-06,1,1,1,0,68,70,69,1,0,0,0,0,15,15,15,15
Riverside,64,2023-03-06,870,901,901,0,13826,14310,14309,1,78,3,6,8,6830,6838,6827,6832
Sacramento,64,2023-03-06,851,883,883,0,11755,12170,12169,1,113,2,3,6,3544,3552,3542,3549
San Benito,64,2023-03-06,16,16,16,0,462,479,478,1,1,0,0,0,112,112,112,112
San Bernardino,64,2023-03-06,739,763,763,0,14898,15422,15421,1,99,0,0,18,8132,8132,8132,8132
San Diego,64,2023-03-06,1403,1452,1452,0,25080,25961,25960,1,179,11,21,13,5813,5827,5802,5806
San Francisco,64,2023-03-06,599,619,619,0,10639,11013,11012,1,73,2,4,11,1181,1185,1179,1181
San Joaquin,64,2023-03-06,381,395,395,0,6801,7042,7041,1,42,0,0,8,2425,2427,2425,2427
San Luis Obispo,64,2023-03-06,91,92,92,0,1305,1352,1351,1,9,3,6,0,568,572,565,566
San Mateo,64,2023-03-06,421,436,436,0,7155,7407,7406,1,28,0,0,3,740,740,740,740
Santa Barbara,64,2023-03-06,147,153,153,0,3675,3806,3805,1,18,1,2,1,762,764,761,762
Santa Clara,64,2023-03-06,1066,1104,1104,0,20674,21391,21390,1,133,3,7,32,2723,2733,2720,2726
Santa Cruz,64,2023-03-06,129,134,134,0,5121,5297,5296,1,20,0,0,0,276,276,276,276
Shasta,64,2023-03-06,24,24,24,0,633,656,655,1,5,0,0,2,600,600,600,600
Siskiyou,64,2023-03-06,6,6,6,0,223,232,231,1,1,0,0,0,95,95,95,95
Solano,64,2023-03-06,256,265,265,0,3332,3450,3449,1,34,0,0,5,474,474,474,474
Sonoma,64,2023-03-06,209,216,216,0,3230,3345,3344,1,23,0,0,2,557,558,557,558
Stanislaus,64,2023-03-06,257,266,266,0,3546,3674,3673,1,67,0,0,9,1841,1841,1841,1841
Sutter,64,2023-03-06,36,36,36,0,592,613,612,1,0,0,0,0,238,238,238,238
Tehama,64,2023-03-06,12,12,12,0,251,261,260,1,5,0,0,1,233,233,233,233
Trinity,64,2023-03-06,2,2,2,0,18,19,18,1,0,0,0,0,23,23,23,23
Tulare,64,2023-03-06,210,218,218,0,3264,3378,3377,1,29,0,0,3,1581,1581,1581,1581
Tuolumne,64,2023-03-06,36,36,36,0,401,415,414,1,1,0,0,0,210,210,210,210
Ventura,64,2023-03-06,245,254,254,0,4966,5141,5140,1,42,2,4,5,1681,1683,1679,1679
Yolo,64,2023-03-06,62,62,62,0,1258,1304,1303,1,4,0,0,0,447,448,447,448
Yuba,64,2023-03-06,38,38,38,0,509,528,527,1,7,0,0,0,122,122,122,122
Alameda,65,2023-03-13,834,889,889,0,15194,16182,16181,1,76,0,0,18,2202,2207,2202,2207
Amador,65,2023-03-13,14,14,14,0,378,405,404,1,5,0,0,1,98,98,98,98
Butte,65,2023-03-13,38,39,39,0,599,639,638,1,9,0,0,1,492,492,492,492
Calaveras,65,2023-03-13,14,14,14,0,243,259,258,1,0,0,0,0,142,144,142,144
Colusa,65,2023-03-13,4,4,4,0,159,173,172,1,0,1,5,0,23,27,22,22
Contra Costa,65,2023-03-13,575,613,613,0,9838,10492,10491,1,44,0,0,7,1563,1568,1563,1568
Del Norte,65,2023-03-13,8,8,8,0,256,274,273,1,1,0,0,0,60,62,60,62
El Dorado,65,2023-03-13,46,47,47,0,895,958,957,1,1,0,0,0,245,245,245,245
Fresno,65,2023-03-13,373,398,398,0,7721,8225,8224,1,79,0,0,10,3007,3012,3007,3012
Glenn,65,2023-03-13,10,10,10,0,141,156,155,1,0,0,0,0,53,53,53,53
Humboldt,65,2023-03-13,29,30,30,0,503,539,538,1,4,0,0,1,170,170,170,170
Imperial,65,2023-03-13,207,220,220,0,2033,2165,2164,1,12,0,0,0,980,980,980,980
Inyo,65,2023-03-13,0,0,0,0,259,277,276,1,0,0,0,0,63,63,63,63
Kern,65,2023-03-13,321,344,344,0,7555,8062,8061,1,52,0,0,12,2487,2489,2487,2489
Kings,65,2023-03-13,58,62,62,0,1416,1510,1509,1,1,0,0,0,484,484,484,484
Lake,65,2023-03-13,10,10,10,0,410,438,437,1,1,0,0,0,161,161,161,161
Lassen,65,2023-03-13,6,6,6,0,334,358,357,1,0,0,0,0,64,64,64,64
Los Angeles,65,2023-03-13,3655,3899,3899,0,119329,127145,127144,1,418,29,133,56,35678,35948,35649,35815
Madera,65,2023-03-13,50,51,51,0,1145,1221,1220,1,6,0,0,0,376,376,376,376
Marin,65,2023-03-13,96,104,104,0,1714,1831,1830,1,21,0,0,1,317,317,317,317
Mariposa,65,2023-03-13,5,5,5,0,92,101,100,1,0,0,0,0,31,31,31,31
Mendocino,65,2023-03-13,17,17,17,0,459,490,489,1,6,0,0,1,144,144,144,144
Merced,65,2023-03-13,98,106,106,0,1474,1573,1572,1,12,0,0,2,903,903,903,903
Modoc,65,2023-03-13,1,1,1,0,12,13,12,1,0,0,0,0,9,9,9,9
Mono,65,2023-03-13,1,1,1,0,50,53,52,1,0,0,0,0,8,8,8,8
Monterey,65,2023-03-13,70,76,76,0,1805,1926,1925,1,27,0,0,2,806,810,806,810
Napa,65,2023-03-13,54,57,57,0,936,1000,999,1,4,0,0,2,163,163,163,163
Nevada,65,2023-03-13,16,16,16,0,467,501,500,1,4,0,0,0,137,137,137,137
Orange,65,2023-03-13,880,938,938,0,17781,18937,18936,1,129,12,57,21,8003,8071,7991,8014
Placer,65,2023-03-13,166,176,176,0,2128,2271,2270,1,66,0,0,8,682,682,682,682
Plumas,65,2023-03-13,5,5,5,0,63,68,67,1,0,0,0,0,15,15,15,15
Riverside,65,2023-03-13,860,916,916,0,14386,15318,15317,1,79,4,15,14,6834,6853,6830,6838
Sacramento,65,2023-03-13,693,740,740,0,10636,11352,11351,1,105,0,0,21,3544,3552,3544,3552
San Benito,65,2023-03-13,13,13,13,0,410,439,438,1,0,0,0,0,112,112,112,112
San Bernardino,65,2023-03-13,688,735,735,0,14540,15510,15509,1,94,0,0,20,8132,8132,8132,8132
San Diego,65,2023-03-13,1310,1396,1396,0,23262,24772,24771,1,177,7,31,13,5820,5858,5813,5827
San Francisco,65,2023-03-13,547,582,582,0,9306,9918,9917,1,73,0,0,14,1181,1185,1181,1185
San Joaquin,65,2023-03-13,358,383,383,0,6777,7235,7234,1,34,0,0,6,2425,2427,2425,2427
San Luis Obispo,65,2023-03-13,76,81,81,0,1318,1409,1408,1,9,0,0,0,568,572,568,572
San Mateo,65,2023-03-13,364,388,388,0,6645,7080,7079,1,24,0,0,5,740,740,740,740
Santa Barbara,65,2023-03-13,153,163,163,0,3403,3627,3626,1,12,0,0,1,762,764,762,764
Santa Clara,65,2023-03-13,1016,1083,1083,0,20480,21802,21801,1,139,0,0,20,2723,2733,2723,2733
Santa Cruz,65,2023-03-13,105,113,113,0,3212,3424,3423,1,21,0,0,1,276,276,276,276
Shasta,65,2023-03-13,22,22,22,0,581,622,621,1,6,0,0,1,600,600,600,600
Siskiyou,65,2023-03-13,10,10,10,0,159,170,169,1,0,0,0,0,95,95,95,95
Solano,65,2023-03-13,229,245,245,0,3069,3273,3272,1,27,0,0,4,474,474,474,474
Sonoma,65,2023-03-13,193,206,206,0,2814,2999,2998,1,41,0,0,4,557,558,557,558
Stanislaus,65,2023-03-13,193,204,204,0,3436,3669,3668,1,52,0,0,4,1841,1841,1841,1841
Sutter,65,2023-03-13,27,27,27,0,518,554,553,1,0,0,0,0,238,238,238,238
Tehama,65,2023-03-13,16,16,16,0,227,244,243,1,1,0,0,0,233,233,233,233
Trinity,65,2023-03-13,0,0,0,0,21,22,21,1,0,0,0,0,23,23,23,23
Tulare,65,2023-03-13,159,170,170,0,3260,3479,3478,1,31,1,3,2,1582,1584,1581,1581
Tuolumne,65,2023-03-13,18,18,18,0,367,392,391,1,2,0,0,0,210,210,210,210
Ventura,65,2023-03-13,222,235,235,0,4350,4637,4636,1,25,0,0,5,1681,1683,1681,1683
Yolo,65,2023-03-13,70,75,75,0,1065,1138,1137,1,2,0,0,0,447,448,447,448
Yuba,65,2023-03-13,32,33,33,0,471,505,504,1,7,0,0,0,122,122,122,122
Alameda,66,2023-03-20,637,1925,1925,0,12621,30670,30669,1,69,0,0,10,2202,2207,2202,2207
Amador,66,2023-03-20,8,16,16,0,303,664,663,1,3,0,0,1,98,98,98,98
Butte,66,2023-03-20,28,55,55,0,408,1083,1082,1,5,0,0,3,492,492,492,492
Calaveras,66,2023-03-20,7,39,39,0,203,521,520,1,0,0,0,0,142,144,142,144
Colusa,66,2023-03-20,2,3,3,0,95,208,207,1,0,0,0,0,23,27,23,27
Contra Costa,66,2023-03-20,357,1036,1036,0,8055,20348,20347,1,31,0,0,8,1563,1568,1563,1568
Del Norte,66,2023-03-20,2,2,2,0,165,400,399,1,0,0,0,1,60,62,60,62
El Dorado,66,2023-03-20,36,90,90,0,666,1459,1458,1,2,0,0,0,245,245,245,245
Fresno,66,2023-03-20,308,817,817,0,6558,16294,16293,1,66,0,0,16,3007,3012,3007,3012
Glenn,66,2023-03-20,4,8,8,0,57,168,167,1,0,0,0,0,53,53,53,53
Humboldt,66,2023-03-20,16,22,22,0,385,1304,1303,1,4,0,0,2,170,170,170,170
Imperial,66,2023-03-20,129,450,450,0,1337,3915,3914,1,9,0,0,1,980,980,980,980
Inyo,66,2023-03-20,5,7,7,0,201,427,426,1,0,0,0,0,63,63,63,63
Kern,66,2023-03-20,164,348,348,0,5530,9305,9304,1,29,0,0,8,2487,2489,2487,2489
Kings,66,2023-03-20,38,54,54,0,1152,2774,2773,1,1,1,14,0,485,498,484,484
Lake,66,2023-03-20,12,14,14,0,363,1086,1085,1,2,0,0,0,161,161,161,161
Lassen,66,2023-03-20,4,4,4,0,216,401,400,1,0,0,0,0,64,64,64,64
Los Angeles,66,2023-03-20,2103,3212,3212,0,68310,91952,91951,1,397,16,192,44,35694,36140,35678,35948
Madera,66,2023-03-20,32,48,48,0,914,2165,2164,1,4,0,0,0,376,376,376,376
Marin,66,2023-03-20,77,194,194,0,1255,3171,3170,1,25,0,0,2,317,317,317,317
Mariposa,66,2023-03-20,1,1,1,0,73,173,172,1,0,0,0,0,31,31,31,31
Mendocino,66,2023-03-20,8,38,38,0,386,1333,1332,1,2,0,0,0,144,144,144,144
Merced,66,2023-03-20,70,220,220,0,1086,2497,2496,1,6,0,0,2,903,903,903,903
Modoc,66,2023-03-20,1,15,15,0,9,27,26,1,0,0,0,0,9,9,9,9
Mono,66,2023-03-20,4,5,5,0,49,166,165,1,0,0,0,0,8,8,8,8
Monterey,66,2023-03-20,45,101,101,0,1131,2756,2755,1,21,0,0,1,806,810,806,810
Napa,66,2023-03-20,23,91,91,0,710,2282,2281,1,3,0,0,1,163,163,163,163
Nevada,66,2023-03-20,14,33,33,0,320,627,626,1,4,0,0,0,137,137,137,137
Orange,66,2023-03-20,616,1650,1650,0,13475,32161,32160,1,115,0,0,25,8003,8071,8003,8071
Placer,66,2023-03-20,103,333,333,0,1889,5131,5130,1,58,0,0,8,682,682,682,682
Plumas,66,2023-03-20,1,1,1,0,43,184,183,1,0,0,0,0,15,15,15,15
Riverside,66,2023-03-20,411,837,837,0,9233,17966,17965,1,57,0,0,7,6834,6853,6834,6853
Sacramento,66,2023-03-20,417,1198,1198,0,7886,20417,20416,1,85,0,0,16,3544,3552,3544,3552
San Benito,66,2023-03-20,29,168,168,0,447,1615,1614,1,0,0,0,0,112,112,112,112
San Bernardino,66,2023-03-20,384,783,783,0,10249,19565,19564,1,77,0,0,12,8132,8132,8132,8132
San Diego,66,2023-03-20,896,2009,2009,0,18022,37835,37834,1,139,0,0,13,5820,5858,5820,5858
San Francisco,66,2023-03-20,328,852,852,0,7202,18186,18185,1,63,0,0,8,1181,1185,1181,1185
San Joaquin,66,2023-03-20,266,830,830,0,4613,10759,10758,1,28,0,0,5,2425,2427,2425,2427
San Luis Obispo,66,2023-03-20,34,98,98,0,882,1949,1948,1,9,0,0,0,568,572,568,572
San Mateo,66,2023-03-20,245,743,743,0,5317,12496,12495,1,24,0,0,1,740,740,740,740
Santa Barbara,66,2023-03-20,88,239,239,0,2654,6734,6733,1,15,1,11,1,763,775,762,764
Santa Clara,66,2023-03-20,644,1853,1853,0,13904,30702,30701,1,151,0,0,22,2723,2733,2723,2733
Santa Cruz,66,2023-03-20,73,114,114,0,2270,3601,3600,1,9,0,0,1,276,276,276,276
Shasta,66,2023-03-20,13,19,19,0,443,680,679,1,2,0,0,3,600,600,600,600
Siskiyou,66,2023-03-20,2,2,2,0,139,364,363,1,0,0,0,0,95,95,95,95
Solano,66,2023-03-20,166,647,647,0,2481,8186,8185,1,26,0,0,5,474,474,474,474
Sonoma,66,2023-03-20,162,510,510,0,2446,6318,6317,1,33,0,0,1,557,558,557,558
Stanislaus,66,2023-03-20,161,422,422,0,2717,7397,7396,1,48,0,0,6,1841,1841,1841,1841
Sutter,66,2023-03-20,37,145,145,0,465,1452,1451,1,0,0,0,0,238,238,238,238
Tehama,66,2023-03-20,10,14,14,0,153,245,244,1,2,0,0,0,233,233,233,233
Trinity,66,2023-03-20,0,0,0,0,15,34,33,1,0,0,0,0,23,23,23,23
Tulare,66,2023-03-20,79,214,214,0,1872,3957,3956,1,25,0,0,0,1582,1584,1582,1584
Tuolumne,66,2023-03-20,13,40,40,0,321,990,989,1,0,0,0,0,210,210,210,210
Ventura,66,2023-03-20,145,353,353,0,3507,8926,8925,1,39,0,0,2,1681,1683,1681,1683
Yolo,66,2023-03-20,44,81,81,0,828,1986,1985,1,6,0,0,1,447,448,447,448
Yuba,66,2023-03-20,16,82,82,0,408,1256,1255,1,7,0,0,0,122,122,122,122
California,1,2021-12-20,84321,84321,47197,37124,2163575,2163639,1234520,929119,2585,503,503,932,77360,77360,76857,76857
California,2,2021-12-27,241933,241937,151915,90022,1954444,1954509,1192734,761775,3348,496,496,1030,77856,77856,77360,77360
California,3,2022-01-03,549742,549752,369378,180374,2956876,2956987,1966892,990095,6125,592,592,1280,78448,78448,77856,77856
California,4,2022-01-10,867286,867310,619881,247429,4667301,4667504,3354632,1312872,10002,946,946,1813,79394,79394,78448,78448
California,5,2022-01-17,661879,661893,493169,168724,3984388,3984591,3022601,961990,12343,1432,1432,2311,80826,80826,79394,79394
California,6,2022-01-24,527387,527403,412577,114826,3989563,3989818,3194006,795812,12648,1778,1778,2600,82604,82604,80826,80826
California,7,2022-01-31,270351,270356,219722,50634,3155596,3155828,2636795,519033,10873,1907,1907,2494,84511,84511,82604,82604
California,8,2022-02-07,149323,149327,125792,23535,2670732,2670940,2318684,352256,8405,1778,1778,2007,86289,86289,84511,84511
California,9,2022-02-14,85819,85819,74808,11011,2323201,2323414,2080164,243250,6407,1434,1434,1564,87723,87723,86289,86289
California,10,2022-02-21,48088,48088,43061,5027,1851061,1851256,1692464,158792,4557,1004,1004,1098,88727,88727,87723,87723
California,11,2022-02-28,32662,32662,29951,2711,2099030,2099286,1962325,136961,3357,695,695,772,89422,89422,88727,88727
California,12,2022-03-07,22987,22987,21481,1506,1819716,1819968,1725368,94600,2435,501,501,581,89923,89923,89422,89422
California,13,2022-03-14,16974,16974,16097,877,1727267,1727592,1657193,70399,1844,358,358,419,90281,90281,89923,89923
California,14,2022-03-21,14642,14642,14059,583,1647006,1647386,1594654,52732,1537,253,253,313,90534,90534,90281,90281
California,15,2022-03-28,15469,15469,14988,481,1463749,1464185,1426566,37619,1150,180,180,264,90714,90714,90534,90534
California,16,2022-04-04,17686,17687,17270,417,1525977,1526601,1497047,29554,943,141,141,211,90855,90855,90714,90714
California,17,2022-04-11,21514,21518,21125,393,1343922,1344601,1323741,20860,905,125,125,148,90980,90980,90855,90855
California,18,2022-04-18,26868,26873,26484,389,1132391,1133058,1118152,14906,823,110,110,141,91090,91090,90980,90980
California,19,2022-04-25,37236,37244,36816,428,1623135,1624243,1609375,14868,838,91,91,112,91181,91181,91090,91090
California,20,2022-05-02,48946,48961,48526,435,1702314,1703587,1691345,12242,950,85,85,143,91266,91266,91181,91181
California,21,2022-05-09,63352,63384,62939,445,1771079,1772550,1762504,10046,1050,86,86,153,91352,91352,91266,91266
California,22,2022-05-16,80335,80390,79938,452,1840508,1842239,1833981,8258,1345,120,120,182,91472,91472,91352,91352
California,23,2022-05-23,97913,97998,97578,420,1870988,1872932,1866330,6602,1714,117,117,217,91589,91589,91472,91472
California,24,2022-05-30,90558,90642,90332,310,1499521,1501143,1496890,4253,1918,152,152,272,91741,91741,91589,91589
California,25,2022-06-06,120604,120720,120402,318,1939388,1941643,1937544,4099,2305,138,138,276,91879,91879,91741,91741
California,26,2022-06-13,105286,105390,105173,217,1407061,1408761,1406278,2483,2471,180,180,291,92059,92059,91879,91879
California,27,2022-06-20,101454,101559,101398,161,1027097,1028376,1026785,1591,2552,209,209,310,92268,92268,92059,92059
California,28,2022-06-27,115555,115681,115543,138,1044197,1045544,1044292,1252,3006,220,220,339,92488,92488,92268,92268
California,29,2022-07-04,108314,108434,108332,102,837058,838165,837359,806,3167,271,271,393,92759,92759,92488,92488
California,30,2022-07-11,141388,141557,141458,99,1082950,1084428,1083637,791,3824,298,298,453,93057,93057,92759,92759
California,31,2022-07-18,129772,129937,129864,73,994011,995449,994885,564,4148,296,296,528,93353,93353,93057,93057
California,32,2022-07-25,117667,117819,117771,48,949043,950472,950047,425,4310,360,360,516,93713,93713,93353,93353
California,33,2022-08-01,99248,99376,99343,33,875544,876902,876589,313,4119,362,362,535,94075,94075,93713,93713
California,34,2022-08-08,83113,83219,83200,19,820318,821641,821410,231,3754,335,335,474,94410,94410,94075,94075
California,35,2022-08-15,68774,68858,68846,12,790421,791739,791557,182,3363,297,297,448,94707,94707,94410,94410
California,36,2022-08-22,61148,61225,61219,6,774148,775473,775327,146,3087,288,288,418,94995,94995,94707,94707
California,37,2022-08-29,51542,51608,51605,3,763937,765283,765162,121,2752,219,219,351,95214,95214,94995,94995
California,38,2022-09-05,36459,36500,36500,0,626445,627581,627493,88,2525,247,247,350,95461,95461,95214,95214
California,39,2022-09-12,36220,36266,36266,0,751178,752602,752518,84,2422,225,225,346,95686,95686,95461,95461
California,40,2022-09-19,27597,27626,27626,0,685803,687178,687107,71,2041,181,181,272,95867,95867,95686,95686
California,41,2022-09-26,25288,25316,25316,0,637770,639118,639055,63,1818,167,167,230,96034,96034,95867,95867
California,42,2022-10-03,23282,23310,23310,0,584432,585735,585675,60,1647,149,149,247,96183,96183,96034,96034
California,43,2022-10-10,23329,23351,23351,0,624822,626281,626223,58,1537,154,154,228,96319,96319,96165,96165
California,44,2022-10-17,18591,18608,18608,0,520867,522149,522092,57,1397,119,119,218,96438,96438,96319,96319
California,45,2022-10-24,18471,18492,18492,0,511381,512714,512657,57,1324,120,120,190,96558,96558,96438,96438
California,46,2022-10-31,20600,20631,20631,0,520745,522175,522118,57,1401,113,113,191,96671,96671,96558,96558
California,47,2022-11-07,26746,26807,26807,0,545534,547157,547100,57,1525,134,134,231,96805,96805,96671,96671
California,48,2022-11-14,30653,30730,30730,0,546683,548430,548373,57,1775,114,114,260,96919,96919,96805,96805
California,49,2022-11-21,40005,40116,40116,0,571884,573909,573852,57,2268,153,153,330,97072,97072,96919,96919
California,50,2022-11-28,54084,54281,54281,0,514888,516975,516918,57,3153,204,204,379,97276,97276,97072,97072
California,51,2022-12-05,65700,65963,65963,0,653345,656230,656172,58,3715,242,242,493,97518,97518,97276,97276
California,52,2022-12-12,56446,56697,56697,0,617709,620761,620703,58,3944,347,350,527,97865,97868,97518,97518
California,53,2022-12-19,50648,50889,50889,0,571048,574083,574026,57,3997,324,327,523,98189,98195,97865,97868
California,54,2022-12-26,45211,45455,45455,0,415572,418100,418043,57,3906,403,410,510,98592,98605,98189,98195
California,55,2023-01-02,44983,45277,45277,0,420026,423051,422994,57,4077,356,363,528,98948,98968,98592,98605
California,56,2023-01-09,33653,33903,33903,0,503282,507498,507441,57,3672,337,345,487,99285,99313,98948,98968
California,57,2023-01-16,20310,20485,20485,0,408638,412645,412588,57,3075,317,327,425,99602,99640,99285,99313
California,58,2023-01-23,18452,18633,18633,0,451654,456730,456673,57,2400,239,247,369,99841,99887,99602,99640
California,59,2023-01-30,19338,19556,19556,0,418685,423997,423940,57,2214,206,216,266,100047,100103,99841,99887
California,60,2023-02-06,21285,21577,21577,0,403285,409110,409053,57,2231,162,174,280,100209,100277,100047,100103
California,61,2023-02-13,21251,21585,21585,0,383018,389399,389343,56,2223,136,149,287,100345,100426,100209,100277
California,62,2023-02-20,19672,20039,20039,0,344174,350988,350932,56,2159,149,182,292,100494,100608,100345,100426
California,63,2023-02-27,19789,20274,20274,0,380197,389775,389718,57,2220,137,196,310,100631,100804,100494,100608
California,64,2023-03-06,17116,17707,17707,0,346124,358311,358255,56,2074,101,198,262,100732,101002,100631,100804
California,65,2023-03-13,15035,16014,16014,0,330102,351832,351776,56,1939,54,244,278,100786,101246,100732,101002
California,66,2023-03-20,9518,23085,23085,0,226439,459268,459212,56,1701,18,217,237,100804,101463,100786,101246
