county,time,date,cases,est_cases,est_omicron_cases,est_other_cases,tests,est_tests,est_omicron_tests,est_other_tests,hospitalizations,deaths,est_deaths,icu,cum_deaths,cum_est_deaths,prev_cum_deaths,prev_cum_est_deaths
Alameda,1,2021-12-20,2983,2983,1419,1564,89769,89774,41920,47854,47,9,9,14,1549,1549,1540,1540
Amador,1,2021-12-20,49,49,18,31,1716,1716,602,1114,2,0,0,3,70,70,70,70
Butte,1,2021-12-20,193,193,101,92,4386,4386,2286,2100,24,5,5,1,359,359,354,354
Calaveras,1,2021-12-20,59,59,23,36,1520,1520,582,938,1,2,2,0,92,92,90,90
Colusa,1,2021-12-20,11,11,5,6,397,397,170,227,1,0,0,0,21,21,21,21
Contra Costa,1,2021-12-20,1684,1684,590,1094,43227,43227,14847,28380,27,4,4,7,1080,1080,1076,1076
Del Norte,1,2021-12-20,19,19,8,11,1378,1378,570,808,0,0,0,0,42,42,42,42
El Dorado,1,2021-12-20,238,238,93,145,4466,4466,1729,2737,4,4,4,3,179,179,175,175
Fresno,1,2021-12-20,1057,1057,380,677,25057,25057,8919,16138,131,19,19,45,2419,2419,2400,2400
Glenn,1,2021-12-20,20,20,8,12,462,462,185,277,0,0,0,0,41,41,41,41
Humboldt,1,2021-12-20,164,164,67,97,3772,3772,1529,2243,11,1,1,2,121,121,120,120
Imperial,1,2021-12-20,585,585,225,360,5535,5535,2109,3426,40,9,9,27,817,817,808,808
Inyo,1,2021-12-20,31,31,14,17,358,358,154,204,1,1,1,0,49,49,48,48
Kern,1,2021-12-20,927,927,401,526,26093,26093,11160,14933,84,24,24,27,2023,2023,1999,1999
Kings,1,2021-12-20,244,244,94,150,6912,6912,2638,4274,15,6,6,3,389,389,383,383
Lake,1,2021-12-20,37,37,13,24,1317,1317,464,853,0,0,0,0,116,116,116,116
Lassen,1,2021-12-20,11,11,5,6,2387,2387,1093,1294,0,0,0,0,54,54,54,54
Los Angeles,1,2021-12-20,31628,31628,22008,9620,985592,985636,676269,309367,574,107,107,174,27374,27374,27267,27267
Madera,1,2021-12-20,159,159,56,103,6014,6014,2122,3892,9,3,3,5,334,334,331,331
Marin,1,2021-12-20,566,566,210,356,11810,11810,4294,7516,5,1,1,1,256,256,255,255
Mariposa,1,2021-12-20,21,21,7,14,448,448,154,294,0,0,0,0,21,21,21,21
Mendocino,1,2021-12-20,91,91,27,64,2687,2687,789,1898,3,2,2,4,103,103,101,101
Merced,1,2021-12-20,323,323,138,185,5616,5616,2366,3250,11,6,6,12,693,693,687,687
Modoc,1,2021-12-20,5,5,2,3,67,67,30,37,2,0,0,0,6,6,6,6
Mono,1,2021-12-20,37,37,10,27,313,313,81,232,1,0,0,0,4,4,4,4
Monterey,1,2021-12-20,481,481,126,355,13259,13259,3421,9838,23,3,3,8,642,642,639,639
Napa,1,2021-12-20,229,229,106,123,5390,5390,2432,2958,2,1,1,2,108,108,107,107
Nevada,1,2021-12-20,161,161,58,103,2764,2764,999,1765,4,1,1,2,110,110,109,109
Orange,1,2021-12-20,4863,4863,2403,2460,99380,99385,48408,50977,132,34,34,56,6019,6019,5985,5985
Placer,1,2021-12-20,555,555,190,365,11155,11155,3769,7386,53,6,6,24,501,501,495,495
Plumas,1,2021-12-20,16,16,6,10,513,513,195,318,0,0,0,0,12,12,12,12
Riverside,1,2021-12-20,5609,5609,2352,3257,78334,78338,32451,45887,238,40,40,82,5579,5579,5539,5539
Sacramento,1,2021-12-20,2148,2148,857,1291,53573,53573,21167,32406,101,21,21,41,2490,2490,2469,2469
San Benito,1,2021-12-20,91,91,41,50,1928,1928,860,1068,2,3,3,2,81,81,78,78
San Bernardino,1,2021-12-20,5010,5010,2368,2642,79698,79703,37183,42520,299,66,66,112,6510,6510,6444,6444
San Diego,1,2021-12-20,8681,8681,5933,2748,149629,149636,101541,48095,249,29,29,94,4479,4479,4450,4450
San Francisco,1,2021-12-20,2988,2988,741,2247,57003,57004,13806,43198,28,3,3,10,693,693,690,690
San Joaquin,1,2021-12-20,954,954,360,594,25345,25345,9400,15945,48,13,13,27,1972,1972,1959,1959
San Luis Obispo,1,2021-12-20,425,425,187,238,9993,9993,4349,5644,11,3,3,6,371,371,368,368
San Mateo,1,2021-12-20,1560,1560,771,789,50631,50631,24529,26102,9,0,0,5,601,601,601,601
Santa Barbara,1,2021-12-20,789,789,326,463,15818,15818,6434,9384,18,8,8,12,570,570,562,562
Santa Clara,1,2021-12-20,2948,2948,1981,967,118952,118957,78837,40120,85,8,8,38,1978,1978,1970,1970
Santa Cruz,1,2021-12-20,404,404,182,222,19816,19816,8760,11056,11,2,2,5,230,230,228,228
Shasta,1,2021-12-20,163,163,65,98,6035,6035,2392,3643,28,8,8,8,448,448,440,440
Siskiyou,1,2021-12-20,20,20,9,11,449,449,207,242,2,2,2,2,63,63,61,61
Solano,1,2021-12-20,497,497,207,290,14795,14795,6087,8708,21,4,4,5,389,389,385,385
Sonoma,1,2021-12-20,752,752,320,432,20780,20780,8668,12112,22,1,1,6,420,420,419,419
Stanislaus,1,2021-12-20,670,670,210,460,13020,13020,4035,8985,90,13,13,22,1432,1432,1419,1419
Sutter,1,2021-12-20,123,123,51,72,2315,2315,947,1368,0,2,2,0,193,193,191,191
Tehama,1,2021-12-20,52,52,17,35,1324,1324,425,899,4,0,0,3,165,165,165,165
Trinity,1,2021-12-20,1,1,0,1,98,98,31,67,0,1,1,0,19,19,18,18
Tulare,1,2021-12-20,404,404,125,279,12352,12352,3799,8553,36,19,19,13,1308,1308,1289,1289
Tuolumne,1,2021-12-20,97,97,35,62,1940,1940,693,1247,7,0,0,0,150,150,150,150
Ventura,1,2021-12-20,2046,2046,1052,994,39239,39239,19902,19337,62,9,9,14,1216,1216,1207,1207
Yolo,1,2021-12-20,329,329,146,183,24708,24708,10824,13884,4,0,0,1,295,295,295,295
Yuba,1,2021-12-20,100,100,43,57,1874,1874,799,1075,3,0,0,4,102,102,102,102
Alameda,2,2021-12-27,7516,7516,4028,3488,87418,87422,46209,41213,89,12,12,19,1561,1561,1549,1549
Amador,2,2021-12-27,92,92,38,54,1445,1445,590,855,2,0,0,3,70,70,70,70
Butte,2,2021-12-27,540,540,318,222,4551,4551,2662,1889,37,3,3,3,362,362,359,359
Calaveras,2,2021-12-27,100,100,45,55,989,989,442,547,1,1,1,1,93,93,92,92
Colusa,2,2021-12-27,27,27,14,13,243,243,119,124,4,0,0,0,21,21,21,21
Contra Costa,2,2021-12-27,5142,5142,2106,3036,46336,46337,18596,27741,44,3,3,16,1083,1083,1080,1080
Del Norte,2,2021-12-27,25,25,12,13,1423,1423,679,744,0,0,0,1,42,42,42,42
El Dorado,2,2021-12-27,512,512,232,280,4086,4086,1816,2270,7,0,0,4,179,179,179,179
Fresno,2,2021-12-27,2209,2209,935,1274,23916,23916,9955,13961,122,16,16,41,2435,2435,2419,2419
Glenn,2,2021-12-27,53,53,24,29,451,451,207,244,0,1,1,0,42,42,41,41
Humboldt,2,2021-12-27,501,501,238,263,3456,3456,1617,1839,10,1,1,0,122,122,121,121
Imperial,2,2021-12-27,881,881,396,485,5910,5910,2617,3293,35,10,10,26,827,827,817,817
Inyo,2,2021-12-27,109,109,54,55,447,447,219,228,0,1,1,0,50,50,49,49
Kern,2,2021-12-27,1988,1988,996,992,22592,22592,11165,11427,79,18,18,36,2041,2041,2023,2023
Kings,2,2021-12-27,506,506,229,277,5481,5481,2433,3048,17,1,1,3,390,390,389,389
Lake,2,2021-12-27,67,67,28,39,1203,1203,495,708,0,1,1,0,117,117,116,116
Lassen,2,2021-12-27,21,21,11,10,2242,2242,1160,1082,0,0,0,0,54,54,54,54
Los Angeles,2,2021-12-27,96114,96120,71587,24533,717698,717732,530961,186771,862,115,115,207,27489,27489,27374,27374
Madera,2,2021-12-27,341,341,144,197,4210,4210,1748,2462,9,2,2,4,336,336,334,334
Marin,2,2021-12-27,1607,1607,688,919,16774,16774,7084,9690,3,0,0,1,256,256,256,256
Mariposa,2,2021-12-27,36,36,15,21,493,493,195,298,0,0,0,0,21,21,21,21
Mendocino,2,2021-12-27,152,152,55,97,2496,2496,862,1634,5,0,0,2,103,103,103,103
Merced,2,2021-12-27,653,653,322,331,5100,5100,2471,2629,11,7,7,10,700,700,693,693
Modoc,2,2021-12-27,3,3,1,2,38,38,19,19,1,0,0,0,6,6,6,6
Mono,2,2021-12-27,123,123,38,85,366,366,110,256,1,0,0,0,4,4,4,4
Monterey,2,2021-12-27,1009,1009,318,691,12882,12882,3971,8911,21,3,3,11,645,645,642,642
Napa,2,2021-12-27,809,809,422,387,6660,6660,3443,3217,6,0,0,1,108,108,108,108
Nevada,2,2021-12-27,236,236,100,136,1984,1984,815,1169,6,1,1,1,111,111,110,110
Orange,2,2021-12-27,18032,18032,10058,7974,130303,130310,71861,58449,256,31,31,66,6050,6050,6019,6019
Placer,2,2021-12-27,1251,1251,502,749,10769,10769,4261,6508,63,2,2,27,503,503,501,501
Plumas,2,2021-12-27,18,18,8,10,299,299,129,170,0,0,0,0,12,12,12,12
Riverside,2,2021-12-27,13685,13685,6601,7084,87498,87503,41715,45788,306,53,53,81,5632,5632,5579,5579
Sacramento,2,2021-12-27,5197,5197,2413,2784,52471,52472,24000,28472,135,22,22,44,2512,2512,2490,2490
San Benito,2,2021-12-27,317,317,163,154,2307,2307,1173,1134,1,3,3,3,84,84,81,81
San Bernardino,2,2021-12-27,14385,14385,7729,6656,87891,87895,46456,41439,341,69,69,141,6579,6579,6510,6510
San Diego,2,2021-12-27,27099,27099,19916,7183,177595,177604,129646,47958,315,34,34,96,4513,4513,4479,4479
San Francisco,2,2021-12-27,6857,6857,2009,4848,65930,65934,19044,46890,31,1,1,14,694,694,693,693
San Joaquin,2,2021-12-27,2352,2352,1037,1315,22785,22785,9888,12897,61,15,15,25,1987,1987,1972,1972
San Luis Obispo,2,2021-12-27,1153,1153,583,570,11182,11182,5563,5619,11,1,1,8,372,372,371,371
San Mateo,2,2021-12-27,5283,5283,2933,2350,55543,55545,30397,25148,19,2,2,5,603,603,601,601
Santa Barbara,2,2021-12-27,2142,2142,1022,1120,15278,15278,7172,8106,33,5,5,10,575,575,570,570
Santa Clara,2,2021-12-27,9051,9051,6550,2501,107056,107061,76808,30253,95,10,10,38,1988,1988,1978,1978
Santa Cruz,2,2021-12-27,946,946,489,457,12423,12423,6305,6118,11,0,0,2,230,230,230,230
Shasta,2,2021-12-27,262,262,122,140,4624,4624,2123,2501,32,5,5,12,453,453,448,448
Siskiyou,2,2021-12-27,21,21,11,10,360,360,190,170,0,0,0,0,63,63,63,63
Solano,2,2021-12-27,1300,1300,627,673,17100,17100,8112,8988,25,5,5,5,394,394,389,389
Sonoma,2,2021-12-27,1912,1912,933,979,21664,21664,10424,11240,19,1,1,5,421,421,420,420
Stanislaus,2,2021-12-27,1249,1249,468,781,11151,11151,4114,7037,94,17,17,18,1449,1449,1432,1432
Sutter,2,2021-12-27,226,226,108,118,2131,2131,1006,1125,0,2,2,0,195,195,193,193
Tehama,2,2021-12-27,103,103,40,63,1106,1106,419,687,6,2,2,3,167,167,165,165
Trinity,2,2021-12-27,4,4,2,2,101,101,37,64,0,0,0,0,19,19,19,19
Tulare,2,2021-12-27,815,815,301,514,11116,11116,4057,7059,36,10,10,9,1318,1318,1308,1308
Tuolumne,2,2021-12-27,171,171,72,99,1672,1672,692,980,5,0,0,1,150,150,150,150
Ventura,2,2021-12-27,5720,5720,3307,2413,39329,39330,22501,16829,66,8,8,19,1224,1224,1216,1216
Yolo,2,2021-12-27,817,817,417,400,22131,22131,11087,11044,7,1,1,4,296,296,295,295
Yuba,2,2021-12-27,164,164,81,83,1534,1534,749,785,8,1,1,4,103,103,102,102
Alameda,3,2022-01-03,17663,17663,10484,7179,117296,117303,69479,47824,156,5,5,31,1566,1566,1561,1561
Amador,3,2022-01-03,218,218,104,114,2179,2179,1029,1150,5,1,1,2,71,71,70,70
Butte,3,2022-01-03,1201,1201,778,423,6876,6876,4433,2443,32,0,0,4,362,362,362,362
Calaveras,3,2022-01-03,232,232,120,112,1305,1305,666,639,0,1,1,1,94,94,93,93
Colusa,3,2022-01-03,48,48,26,22,393,393,217,176,5,0,0,0,21,21,21,21
Contra Costa,3,2022-01-03,13515,13515,6287,7228,69127,69131,32072,37059,76,10,10,21,1093,1093,1083,1083
Del Norte,3,2022-01-03,86,86,47,39,2132,2132,1143,989,0,0,0,0,42,42,42,42
El Dorado,3,2022-01-03,1290,1290,660,630,6062,6062,3079,2983,7,4,4,6,183,183,179,179
Fresno,3,2022-01-03,6595,6595,3170,3425,38678,38679,18464,20215,175,14,14,44,2449,2449,2435,2435
Glenn,3,2022-01-03,76,76,39,37,610,610,318,292,0,1,1,0,43,43,42,42
Humboldt,3,2022-01-03,883,883,472,411,5295,5295,2810,2485,9,1,1,3,123,123,122,122
Imperial,3,2022-01-03,1878,1878,956,922,9148,9148,4619,4529,35,14,14,29,841,841,827,827
Inyo,3,2022-01-03,265,265,147,118,713,713,394,319,3,0,0,0,50,50,50,50
Kern,3,2022-01-03,5835,5835,3271,2564,35876,35877,19999,15878,100,16,16,32,2057,2057,2041,2041
Kings,3,2022-01-03,1096,1096,561,535,8511,8511,4310,4201,13,3,3,5,393,393,390,390
Lake,3,2022-01-03,220,220,106,114,1777,1777,847,930,1,0,0,1,117,117,117,117
Lassen,3,2022-01-03,61,61,35,26,3119,3119,1806,1313,2,0,0,0,54,54,54,54
Los Angeles,3,2022-01-03,204109,204121,160534,43587,1088042,1088103,856057,232046,1937,149,149,303,27638,27638,27489,27489
Madera,3,2022-01-03,830,830,398,432,6362,6362,3024,3338,17,3,3,6,339,339,336,336
Marin,3,2022-01-03,2363,2363,1148,1215,17674,17674,8532,9142,15,1,1,3,257,257,256,256
Mariposa,3,2022-01-03,103,103,48,55,657,657,304,353,0,0,0,0,21,21,21,21
Mendocino,3,2022-01-03,453,453,187,266,3572,3572,1454,2118,7,1,1,2,104,104,103,103
Merced,3,2022-01-03,1551,1551,852,699,8548,8548,4667,3881,3,9,9,4,709,709,700,700
Modoc,3,2022-01-03,15,15,8,7,59,59,33,26,0,0,0,0,6,6,6,6
Mono,3,2022-01-03,180,180,65,115,435,435,156,279,2,0,0,0,4,4,4,4
Monterey,3,2022-01-03,2466,2466,908,1558,20639,20639,7547,13092,30,4,4,10,649,649,645,645
Napa,3,2022-01-03,1856,1856,1076,780,11756,11756,6790,4966,9,1,1,3,109,109,108,108
Nevada,3,2022-01-03,647,647,314,333,3071,3071,1485,1586,7,1,1,3,112,112,111,111
Orange,3,2022-01-03,45472,45473,27786,17687,220202,220214,134355,85859,504,34,34,110,6084,6084,6050,6050
Placer,3,2022-01-03,2913,2913,1336,1577,15070,15070,6862,8208,113,15,15,24,518,518,503,503
Plumas,3,2022-01-03,55,55,28,27,496,496,248,248,1,0,0,0,12,12,12,12
Riverside,3,2022-01-03,32037,32037,17304,14733,138449,138456,74450,64006,564,54,54,94,5686,5686,5632,5632
Sacramento,3,2022-01-03,14133,14133,7380,6753,80498,80502,41836,38666,219,25,25,57,2537,2537,2512,2512
San Benito,3,2022-01-03,739,739,422,317,3464,3464,1976,1488,3,1,1,2,85,85,84,84
San Bernardino,3,2022-01-03,33795,33795,19988,13807,135048,135055,79603,55452,571,94,94,136,6673,6673,6579,6579
San Diego,3,2022-01-03,61073,61077,47447,13630,253655,253668,196963,56705,561,34,34,121,4547,4547,4513,4513
San Francisco,3,2022-01-03,11438,11438,3973,7465,85526,85530,29513,56017,78,5,5,22,699,699,694,694
San Joaquin,3,2022-01-03,6977,6977,3479,3498,36140,36141,17906,18235,80,13,13,27,2000,2000,1987,1987
San Luis Obispo,3,2022-01-03,2473,2473,1386,1087,15963,15963,8917,7046,24,5,5,7,377,377,372,372
San Mateo,3,2022-01-03,10630,10630,6508,4122,81980,81985,50099,31886,37,4,4,7,607,607,603,603
Santa Barbara,3,2022-01-03,5325,5325,2850,2475,28192,28192,15052,13140,53,5,5,7,580,580,575,575
Santa Clara,3,2022-01-03,23029,23029,17704,5325,170169,170178,130642,39536,186,10,10,58,1998,1998,1988,1988
Santa Cruz,3,2022-01-03,2411,2411,1389,1022,21662,21662,12485,9177,15,5,5,3,235,235,230,230
Shasta,3,2022-01-03,601,601,318,283,6174,6174,3228,2946,33,2,2,13,455,455,453,453
Siskiyou,3,2022-01-03,74,74,44,30,590,590,348,242,0,0,0,0,63,63,63,63
Solano,3,2022-01-03,4071,4071,2180,1891,26219,26219,14027,12192,54,3,3,9,397,397,394,394
Sonoma,3,2022-01-03,4539,4539,2479,2060,32189,32190,17530,14660,25,7,7,4,428,428,421,421
Stanislaus,3,2022-01-03,3333,3333,1436,1897,17985,17985,7689,10296,129,9,9,20,1458,1458,1449,1449
Sutter,3,2022-01-03,547,547,296,251,2980,2980,1594,1386,0,2,2,0,197,197,195,195
Tehama,3,2022-01-03,216,216,97,119,1474,1474,652,822,4,1,1,2,168,168,167,167
Trinity,3,2022-01-03,14,14,6,8,107,107,46,61,0,0,0,0,19,19,19,19
Tulare,3,2022-01-03,2141,2141,917,1224,16003,16003,6774,9229,57,5,5,7,1323,1323,1318,1318
Tuolumne,3,2022-01-03,383,383,186,197,2544,2544,1227,1317,7,3,3,0,153,153,150,150
Ventura,3,2022-01-03,12669,12669,7985,4684,59673,59677,37564,22113,136,11,11,28,1235,1235,1224,1224
Yolo,3,2022-01-03,2320,2320,1323,997,31713,31714,17939,13775,8,4,4,3,300,300,296,296
Yuba,3,2022-01-03,473,473,262,211,2331,2331,1284,1047,17,1,1,6,104,104,103,103
Alameda,4,2022-01-10,31205,31205,20216,10989,193868,193881,125736,68145,277,14,14,46,1580,1580,1566,1566
Amador,4,2022-01-10,392,392,210,182,2726,2726,1447,1279,4,0,0,4,71,71,71,71
Butte,4,2022-01-10,1998,1998,1394,604,10460,10460,7287,3173,55,2,2,4,364,364,362,362
Calaveras,4,2022-01-10,523,523,299,224,2607,2607,1479,1128,0,1,1,2,95,95,94,94
Colusa,4,2022-01-10,105,105,65,40,756,756,462,294,5,0,0,0,21,21,21,21
Contra Costa,4,2022-01-10,19741,19741,10339,9402,102258,102264,53549,48715,152,12,12,24,1105,1105,1093,1093
Del Norte,4,2022-01-10,178,178,106,72,3958,3958,2363,1595,2,0,0,0,42,42,42,42
El Dorado,4,2022-01-10,2215,2215,1261,954,9363,9363,5325,4038,14,6,6,2,189,189,183,183
Fresno,4,2022-01-10,14395,14395,7779,6616,60056,60061,32387,27674,301,14,14,47,2463,2463,2449,2449
Glenn,4,2022-01-10,219,219,127,92,938,938,544,394,2,0,0,0,43,43,43,43
Humboldt,4,2022-01-10,1403,1403,828,575,8356,8356,4925,3431,18,5,5,2,128,128,123,123
Imperial,4,2022-01-10,3622,3622,2047,1575,13842,13842,7805,6037,58,11,11,25,852,852,841,841
Inyo,4,2022-01-10,408,408,248,160,1356,1356,826,530,4,2,2,0,52,52,50,50
Kern,4,2022-01-10,11946,11946,7346,4600,57114,57119,35084,22035,181,26,26,35,2083,2083,2057,2057
Kings,4,2022-01-10,2413,2413,1381,1032,13013,13013,7401,5612,33,1,1,4,394,394,393,393
Lake,4,2022-01-10,499,499,268,231,2761,2761,1477,1284,0,3,3,1,120,120,117,117
Lassen,4,2022-01-10,194,194,124,70,3438,3438,2185,1253,1,0,0,0,54,54,54,54
Los Angeles,4,2022-01-10,329017,329040,270822,58218,1915102,1915237,1576905,338332,3253,270,270,513,27908,27908,27638,27638
Madera,4,2022-01-10,1912,1912,1028,884,10379,10379,5546,4833,19,1,1,6,340,340,339,339
Marin,4,2022-01-10,2940,2940,1602,1338,21011,21011,11437,9574,18,3,3,5,260,260,257,257
Mariposa,4,2022-01-10,199,199,105,94,1158,1158,607,551,0,1,1,0,22,22,21,21
Mendocino,4,2022-01-10,877,877,412,465,5538,5538,2581,2957,8,2,2,2,106,106,104,104
Merced,4,2022-01-10,3692,3692,2235,1457,14514,14514,8774,5740,33,10,10,11,719,719,709,709
Modoc,4,2022-01-10,13,13,8,5,109,109,67,42,0,0,0,0,6,6,6,6
Mono,4,2022-01-10,253,253,106,147,863,863,360,503,1,1,1,0,5,5,4,4
Monterey,4,2022-01-10,4979,4979,2117,2862,33231,33231,14051,19180,44,5,5,12,654,654,649,649
Napa,4,2022-01-10,2646,2646,1679,967,14353,14353,9103,5250,14,1,1,4,110,110,109,109
Nevada,4,2022-01-10,1189,1189,646,543,5233,5233,2839,2394,10,2,2,3,114,114,112,112
Orange,4,2022-01-10,60076,60081,39990,20091,317664,317687,211522,106165,854,100,100,159,6184,6184,6084,6084
Placer,4,2022-01-10,5193,5193,2691,2502,22555,22555,11665,10890,179,6,6,29,524,524,518,518
Plumas,4,2022-01-10,141,141,79,62,803,803,446,357,5,0,0,0,12,12,12,12
Riverside,4,2022-01-10,48252,48257,28850,19407,187754,187767,112221,75546,762,83,83,139,5769,5769,5686,5686
Sacramento,4,2022-01-10,27514,27514,15921,11593,121788,121796,70486,51310,375,37,37,89,2574,2574,2537,2537
San Benito,4,2022-01-10,1037,1037,654,383,4615,4615,2909,1706,3,1,1,2,86,86,85,85
San Bernardino,4,2022-01-10,50718,50723,32858,17865,192768,192780,124826,67954,784,113,113,187,6786,6786,6673,6673
San Diego,4,2022-01-10,82762,82768,67440,15328,330085,330108,269018,61090,895,66,66,166,4613,4613,4547,4547
San Francisco,4,2022-01-10,15089,15089,6032,9057,117285,117292,46957,70335,158,12,12,35,711,711,699,699
San Joaquin,4,2022-01-10,14515,14515,8088,6427,66859,66864,37196,29668,151,15,15,45,2015,2015,2000,2000
San Luis Obispo,4,2022-01-10,4336,4336,2675,1661,21621,21621,13356,8265,30,2,2,7,379,379,377,377
San Mateo,4,2022-01-10,15021,15021,10005,5016,113103,113111,75333,37778,95,5,5,16,612,612,607,607
Santa Barbara,4,2022-01-10,8537,8537,5053,3484,47382,47387,28054,19333,84,9,9,10,589,589,580,580
Santa Clara,4,2022-01-10,36503,36503,29458,7045,271165,271183,218795,52388,350,26,26,68,2024,2024,1998,1998
Santa Cruz,4,2022-01-10,4543,4543,2861,1682,42815,42818,26981,15837,25,2,2,2,237,237,235,235
Shasta,4,2022-01-10,1058,1058,618,440,8406,8406,4894,3512,37,7,7,12,462,462,455,455
Siskiyou,4,2022-01-10,120,120,77,43,919,919,591,328,3,1,1,1,64,64,63,63
Solano,4,2022-01-10,6924,6924,4126,2798,37199,37199,22176,15023,94,6,6,15,403,403,397,397
Sonoma,4,2022-01-10,8867,8867,5342,3525,47198,47202,28455,18747,72,9,9,8,437,437,428,428
Stanislaus,4,2022-01-10,6740,6740,3302,3438,29317,29317,14323,14994,173,13,13,19,1471,1471,1458,1458
Sutter,4,2022-01-10,1245,1245,743,502,5062,5062,3006,2056,0,2,2,0,199,199,197,197
Tehama,4,2022-01-10,512,512,257,255,2482,2482,1241,1241,13,1,1,1,169,169,168,168
Trinity,4,2022-01-10,38,38,19,19,275,275,135,140,0,0,0,0,19,19,19,19
Tulare,4,2022-01-10,5210,5210,2539,2671,24074,24074,11670,12404,66,9,9,8,1332,1332,1323,1323
Tuolumne,4,2022-01-10,805,805,436,369,4178,4178,2257,1921,13,1,1,1,154,154,153,153
Ventura,4,2022-01-10,17507,17507,11972,5535,88214,88219,60306,27913,227,23,23,34,1258,1258,1235,1235
Yolo,4,2022-01-10,3760,3760,2341,1419,48251,48256,30011,18245,6,4,4,1,304,304,300,300
Yuba,4,2022-01-10,1022,1022,624,398,4108,4108,2504,1604,41,0,0,7,104,104,104,104
Alameda,5,2022-01-17,24703,24703,17329,7374,170503,170517,119547,50970,366,33,33,62,1613,1613,1580,1580
Amador,5,2022-01-17,476,476,282,194,3557,3557,2081,1476,10,2,2,3,73,73,71,71
Butte,5,2022-01-17,2061,2061,1537,524,9328,9328,6950,2378,58,6,6,6,370,370,364,364
Calaveras,5,2022-01-17,564,564,353,211,2472,2472,1542,930,3,2,2,3,97,97,95,95
Colusa,5,2022-01-17,161,161,107,54,719,719,476,243,3,0,0,0,21,21,21,21
Contra Costa,5,2022-01-17,16221,16221,9471,6750,88048,88054,51329,36725,198,22,22,41,1127,1127,1105,1105
Del Norte,5,2022-01-17,200,200,131,69,3758,3758,2429,1329,2,0,0,1,42,42,42,42
El Dorado,5,2022-01-17,1968,1968,1230,738,8063,8063,5041,3022,9,4,4,2,193,193,189,189
Fresno,5,2022-01-17,18245,18245,10927,7318,66175,66180,39601,26579,386,27,27,61,2490,2490,2463,2463
Glenn,5,2022-01-17,307,307,194,113,1076,1076,683,393,3,2,2,0,45,45,43,43
Humboldt,5,2022-01-17,1145,1145,740,405,8322,8322,5364,2958,10,1,1,4,129,129,128,128
Imperial,5,2022-01-17,3411,3411,2121,1290,13242,13242,8232,5010,69,12,12,29,864,864,852,852
Inyo,5,2022-01-17,327,327,216,111,1040,1040,688,352,4,0,0,0,52,52,52,52
Kern,5,2022-01-17,11693,11693,7803,3890,51809,51813,34534,17279,242,29,29,44,2112,2112,2083,2083
Kings,5,2022-01-17,3199,3199,1998,1201,14866,14866,9258,5608,40,4,4,1,398,398,394,394
Lake,5,2022-01-17,583,583,348,235,3246,3246,1936,1310,2,1,1,2,121,121,120,120
Lassen,5,2022-01-17,283,283,195,88,3322,3322,2278,1044,0,0,0,0,54,54,54,54
Los Angeles,5,2022-01-17,218427,218444,186873,31571,1610410,1610535,1376833,233702,4034,504,504,680,28412,28412,27908,27908
Madera,5,2022-01-17,2400,2400,1431,969,10611,10611,6301,4310,32,5,5,10,345,345,340,340
Marin,5,2022-01-17,2420,2420,1461,959,17702,17702,10678,7024,38,4,4,6,264,264,260,260
Mariposa,5,2022-01-17,163,163,95,68,1115,1115,648,467,0,0,0,0,22,22,22,22
Mendocino,5,2022-01-17,921,921,486,435,5015,5015,2630,2385,18,3,3,2,109,109,106,106
Merced,5,2022-01-17,3970,3970,2618,1352,13639,13639,8989,4650,41,18,18,11,737,737,719,719
Modoc,5,2022-01-17,13,13,9,4,102,102,68,34,0,1,1,0,7,7,6,6
Mono,5,2022-01-17,198,198,94,104,809,809,386,423,2,0,0,0,5,5,5,5
Monterey,5,2022-01-17,5902,5902,2860,3042,28328,28328,13710,14618,69,6,6,14,660,660,654,654
Napa,5,2022-01-17,1929,1929,1328,601,11914,11914,8177,3737,21,2,2,5,112,112,110,110
Nevada,5,2022-01-17,1253,1253,753,500,5431,5431,3262,2169,19,1,1,1,115,115,114,114
Orange,5,2022-01-17,41328,41332,29647,11685,251493,251513,180243,71270,998,111,111,199,6295,6295,6184,6184
Placer,5,2022-01-17,4320,4320,2495,1825,19460,19460,11216,8244,178,14,14,36,538,538,524,524
Plumas,5,2022-01-17,194,194,119,75,852,852,524,328,3,0,0,0,12,12,12,12
Riverside,5,2022-01-17,41252,41256,26970,14286,168056,168068,109886,58182,920,97,97,158,5866,5866,5769,5769
Sacramento,5,2022-01-17,21446,21446,13648,7798,101464,101472,64499,36973,473,64,64,97,2638,2638,2574,2574
San Benito,5,2022-01-17,903,903,618,285,4273,4273,2922,1351,4,1,1,4,87,87,86,86
San Bernardino,5,2022-01-17,38500,38503,26933,11570,164350,164363,114973,49390,936,146,146,227,6932,6932,6786,6786
San Diego,5,2022-01-17,60724,60729,51550,9179,265928,265949,225773,40176,1067,103,103,193,4716,4716,4613,4613
San Francisco,5,2022-01-17,11263,11263,5202,6061,94012,94019,43308,50711,212,14,14,44,725,725,711,711
San Joaquin,5,2022-01-17,12721,12721,7805,4916,58136,58141,35677,22464,201,20,20,57,2035,2035,2015,2015
San Luis Obispo,5,2022-01-17,3935,3935,2647,1288,21023,21023,14126,6897,46,12,12,10,391,391,379,379
San Mateo,5,2022-01-17,12482,12482,8944,3538,95951,95957,68675,27282,92,10,10,30,622,622,612,612
Santa Barbara,5,2022-01-17,6851,6851,4444,2407,40485,40489,26232,14257,123,12,12,12,601,601,589,589
Santa Clara,5,2022-01-17,29559,29559,24870,4689,235960,235978,198426,37552,451,24,24,84,2048,2048,2024,2024
Santa Cruz,5,2022-01-17,4185,4185,2868,1317,42205,42208,28865,13343,23,3,3,3,240,240,237,237
Shasta,5,2022-01-17,1347,1347,863,484,9163,9163,5844,3319,55,7,7,14,469,469,462,462
Siskiyou,5,2022-01-17,158,158,110,48,927,927,640,287,3,1,1,2,65,65,64,64
Solano,5,2022-01-17,6434,6434,4199,2235,35261,35263,23012,12251,121,6,6,22,409,409,403,403
Sonoma,5,2022-01-17,7623,7623,5023,2600,42780,42783,28135,14648,73,7,7,15,444,444,437,437
Stanislaus,5,2022-01-17,7325,7325,4017,3308,29058,29058,15916,13142,206,10,10,31,1481,1481,1471,1471
Sutter,5,2022-01-17,1248,1248,812,436,4863,4863,3161,1702,0,4,4,0,203,203,199,199
Tehama,5,2022-01-17,614,614,343,271,2420,2420,1349,1071,15,5,5,2,174,174,169,169
Trinity,5,2022-01-17,41,41,23,18,255,255,140,115,0,1,1,0,20,20,19,19
Tulare,5,2022-01-17,7475,7475,4069,3406,27090,27090,14725,12365,97,16,16,16,1348,1348,1332,1332
Tuolumne,5,2022-01-17,886,886,532,354,3836,3836,2287,1549,10,8,8,1,162,162,154,154
Ventura,5,2022-01-17,11974,11974,8780,3194,66929,66934,49018,17916,300,41,41,56,1299,1299,1258,1258
Yolo,5,2022-01-17,2805,2805,1899,906,39505,39509,26713,12796,15,4,4,4,308,308,304,304
Yuba,5,2022-01-17,1064,1064,707,357,3747,3747,2489,1258,42,2,2,6,106,106,104,104
Alameda,6,2022-01-24,19752,19752,14829,4923,171786,171801,129151,42650,373,41,41,68,1654,1654,1613,1613
Amador,6,2022-01-24,544,544,352,192,4667,4667,3019,1648,8,0,0,5,73,73,73,73
Butte,6,2022-01-24,1904,1904,1501,403,9612,9612,7594,2018,82,10,10,9,380,380,370,370
Calaveras,6,2022-01-24,556,556,378,178,2506,2506,1705,801,6,2,2,2,99,99,97,97
Colusa,6,2022-01-24,177,177,127,50,951,951,680,271,6,0,0,0,21,21,21,21
Contra Costa,6,2022-01-24,13595,13595,8737,4858,85320,85326,54894,30432,217,25,25,64,1152,1152,1127,1127
Del Norte,6,2022-01-24,348,348,246,102,4326,4326,3042,1284,3,0,0,3,42,42,42,42
El Dorado,6,2022-01-24,1400,1400,954,446,7329,7329,5001,2328,17,2,2,6,195,195,193,193
Fresno,6,2022-01-24,17706,17706,11601,6105,68853,68858,45200,23658,491,43,43,83,2533,2533,2490,2490
Glenn,6,2022-01-24,250,250,172,78,971,971,670,301,0,0,0,0,45,45,45,45
Humboldt,6,2022-01-24,919,919,643,276,7714,7714,5409,2305,25,3,3,3,132,132,129,129
Imperial,6,2022-01-24,3617,3617,2455,1162,13189,13189,8970,4219,70,14,14,27,878,878,864,864
Inyo,6,2022-01-24,142,142,102,40,625,625,449,176,1,1,1,0,53,53,52,52
Kern,6,2022-01-24,10554,10554,7599,2955,53946,53951,38893,15058,267,47,47,51,2159,2159,2112,2112
Kings,6,2022-01-24,4305,4305,2924,1381,19064,19064,12977,6087,40,4,4,4,402,402,398,398
Lake,6,2022-01-24,746,746,488,258,3417,3417,2234,1183,6,2,2,3,123,123,121,121
Lassen,6,2022-01-24,418,418,307,111,3982,3982,2932,1050,6,0,0,0,54,54,54,54
Los Angeles,6,2022-01-24,164876,164890,145655,19235,1659202,1659344,1466808,192536,3769,611,611,785,29023,29023,28412,28412
Madera,6,2022-01-24,2714,2714,1770,944,12170,12170,7938,4232,49,7,7,10,352,352,345,345
Marin,6,2022-01-24,1857,1857,1227,630,17548,17548,11608,5940,38,4,4,10,268,268,264,264
Mariposa,6,2022-01-24,133,133,85,48,945,945,605,340,0,0,0,0,22,22,22,22
Mendocino,6,2022-01-24,917,917,538,379,4873,4873,2854,2019,23,2,2,3,111,111,109,109
Merced,6,2022-01-24,3233,3233,2306,927,12906,12906,9213,3693,55,9,9,12,746,746,737,737
Modoc,6,2022-01-24,14,14,10,4,114,114,82,32,2,0,0,0,7,7,7,7
Mono,6,2022-01-24,97,97,52,45,422,422,227,195,1,0,0,0,5,5,5,5
Monterey,6,2022-01-24,5086,5086,2773,2313,31797,31798,17335,14463,80,9,9,17,669,669,660,660
Napa,6,2022-01-24,1672,1672,1236,436,12465,12465,9206,3259,23,5,5,4,117,117,112,112
Nevada,6,2022-01-24,1001,1001,659,342,4806,4806,3170,1636,29,1,1,6,116,116,115,115
Orange,6,2022-01-24,26684,26684,20392,6292,230898,230918,176714,54204,923,177,177,191,6472,6472,6295,6295
Placer,6,2022-01-24,3660,3660,2330,1330,18644,18644,11867,6777,215,8,8,43,546,546,538,538
Plumas,6,2022-01-24,215,215,144,71,836,836,559,277,5,0,0,0,12,12,12,12
Riverside,6,2022-01-24,31908,31909,22577,9332,158776,158789,112471,46318,901,122,122,168,5988,5988,5866,5866
Sacramento,6,2022-01-24,17468,17468,12086,5382,98837,98845,68431,30414,542,64,64,105,2702,2702,2638,2638
San Benito,6,2022-01-24,776,776,570,206,3929,3929,2889,1040,7,1,1,3,88,88,87,87
San Bernardino,6,2022-01-24,28078,28079,21043,7036,153566,153579,115206,38373,975,170,170,223,7102,7102,6932,6932
San Diego,6,2022-01-24,51508,51513,45212,6301,252113,252135,221542,30593,1056,131,131,232,4847,4847,4716,4716
San Francisco,6,2022-01-24,8101,8101,4235,3866,88915,88921,46541,42380,232,19,19,37,744,744,725,725
San Joaquin,6,2022-01-24,11052,11052,7402,3650,59112,59117,39673,19444,241,34,34,71,2069,2069,2035,2035
San Luis Obispo,6,2022-01-24,3561,3561,2582,979,21516,21516,15603,5913,42,10,10,12,401,401,391,391
San Mateo,6,2022-01-24,8506,8506,6498,2008,95138,95146,72746,22400,139,19,19,28,641,641,622,622
Santa Barbara,6,2022-01-24,6483,6483,4558,1925,43826,43831,30825,13006,127,12,12,19,613,613,601,601
Santa Clara,6,2022-01-24,22785,22785,19871,2914,233308,233328,203474,29854,412,48,48,88,2096,2096,2048,2048
Santa Cruz,6,2022-01-24,5045,5045,3710,1335,45621,45625,33578,12047,31,1,1,2,241,241,240,240
Shasta,6,2022-01-24,1486,1486,1032,454,10135,10135,7033,3102,78,7,7,9,476,476,469,469
Siskiyou,6,2022-01-24,159,159,118,41,857,857,635,222,6,3,3,1,68,68,65,65
Solano,6,2022-01-24,5127,5127,3627,1500,32696,32699,23144,9555,143,14,14,26,423,423,409,409
Sonoma,6,2022-01-24,6922,6922,4928,1994,42475,42479,30250,12229,94,7,7,18,451,451,444,444
Stanislaus,6,2022-01-24,6377,6377,3877,2500,28268,28268,17211,11057,277,27,27,44,1508,1508,1481,1481
Sutter,6,2022-01-24,1047,1047,737,310,5002,5002,3521,1481,0,2,2,0,205,205,203,203
Tehama,6,2022-01-24,579,579,358,221,2702,2702,1674,1028,19,4,4,5,178,178,174,174
Trinity,6,2022-01-24,63,63,38,25,322,322,196,126,0,0,0,0,20,20,20,20
Tulare,6,2022-01-24,7683,7683,4635,3048,29530,29532,17856,11676,138,11,11,14,1359,1359,1348,1348
Tuolumne,6,2022-01-24,953,953,627,326,3827,3827,2510,1317,17,2,2,3,164,164,162,162
Ventura,6,2022-01-24,9413,9413,7332,2081,68518,68523,53430,15093,269,28,28,68,1327,1327,1299,1299
Yolo,6,2022-01-24,2300,2300,1677,623,40471,40475,29510,10965,18,12,12,5,320,320,308,308
Yuba,6,2022-01-24,910,910,653,257,3779,3779,2711,1068,54,3,3,10,109,109,106,106
Alameda,7,2022-01-31,11000,11000,8743,2257,137323,137338,109284,28054,336,50,50,75,1704,1704,1654,1654
Amador,7,2022-01-31,350,350,246,104,3226,3226,2273,953,15,1,1,4,74,74,73,73
Butte,7,2022-01-31,1168,1168,967,201,7609,7609,6306,1303,80,6,6,7,386,386,380,380
Calaveras,7,2022-01-31,264,264,194,70,1940,1940,1424,516,3,5,5,2,104,104,99,99
Colusa,7,2022-01-31,106,106,81,25,704,704,540,164,9,0,0,0,21,21,21,21
Contra Costa,7,2022-01-31,7315,7315,5100,2215,68627,68632,47924,20708,207,39,39,54,1191,1191,1152,1152
Del Norte,7,2022-01-31,315,315,237,78,3957,3957,2977,980,6,2,2,2,44,44,42,42
El Dorado,7,2022-01-31,742,742,545,197,6021,6021,4421,1600,13,4,4,5,199,199,195,195
Fresno,7,2022-01-31,10959,10959,7772,3187,54945,54950,39023,15927,503,39,39,98,2572,2572,2533,2533
Glenn,7,2022-01-31,190,190,140,50,759,759,563,196,2,2,2,0,47,47,45,45
Humboldt,7,2022-01-31,585,585,440,145,5790,5790,4348,1442,18,3,3,3,135,135,132,132
Imperial,7,2022-01-31,2193,2193,1599,594,11303,11303,8264,3039,71,17,17,28,895,895,878,878
Inyo,7,2022-01-31,55,55,42,13,467,467,357,110,5,3,3,0,56,56,53,53
Kern,7,2022-01-31,5650,5650,4340,1310,42263,42268,32507,9761,264,47,47,54,2206,2206,2159,2159
Kings,7,2022-01-31,2388,2388,1747,641,13681,13681,10017,3664,55,5,5,4,407,407,402,402
Lake,7,2022-01-31,478,478,338,140,3193,3193,2258,935,4,4,4,4,127,127,123,123
Lassen,7,2022-01-31,311,311,243,68,3624,3624,2838,786,7,1,1,0,55,55,54,54
Los Angeles,7,2022-01-31,74560,74567,67635,6932,1302831,1302962,1182646,120316,2991,640,640,719,29663,29663,29023,29023
Madera,7,2022-01-31,1743,1743,1232,511,9630,9630,6815,2815,50,6,6,7,358,358,352,352
Marin,7,2022-01-31,1064,1064,760,304,13816,13816,9888,3928,26,5,5,9,273,273,268,268
Mariposa,7,2022-01-31,101,101,70,31,840,840,584,256,0,2,2,0,24,24,22,22
Mendocino,7,2022-01-31,464,464,299,165,3486,3486,2252,1234,12,3,3,4,114,114,111,111
Merced,7,2022-01-31,2125,2125,1618,507,10465,10465,7975,2490,54,12,12,14,758,758,746,746
Modoc,7,2022-01-31,12,12,9,3,89,89,68,21,1,0,0,0,7,7,7,7
Mono,7,2022-01-31,41,41,25,16,339,339,203,136,0,0,0,0,5,5,5,5
Monterey,7,2022-01-31,3558,3558,2154,1404,26742,26744,16230,10514,82,9,9,13,678,678,669,669
Napa,7,2022-01-31,989,989,776,213,9376,9376,7355,2021,17,7,7,10,124,124,117,117
Nevada,7,2022-01-31,567,567,403,164,3912,3912,2788,1124,26,3,3,5,119,119,116,116
Orange,7,2022-01-31,11999,11999,9680,2319,177030,177048,142945,34103,708,170,170,164,6642,6642,6472,6472
Placer,7,2022-01-31,2256,2256,1560,696,15375,15375,10647,4728,152,19,19,42,565,565,546,546
Plumas,7,2022-01-31,137,137,98,39,753,753,542,211,1,0,0,0,12,12,12,12
Riverside,7,2022-01-31,15947,15947,12053,3894,121040,121052,91699,29353,740,111,111,171,6099,6099,5988,5988
Sacramento,7,2022-01-31,10132,10132,7518,2614,77583,77590,57655,19935,501,93,93,106,2795,2795,2702,2702
San Benito,7,2022-01-31,474,474,370,104,3323,3323,2596,727,5,2,2,3,90,90,88,88
San Bernardino,7,2022-01-31,13249,13249,10514,2735,116538,116550,92604,23946,744,185,185,207,7287,7287,7102,7102
San Diego,7,2022-01-31,24892,24893,22459,2434,181384,181401,163809,17592,944,105,105,214,4952,4952,4847,4847
San Francisco,7,2022-01-31,4049,4049,2361,1688,69165,69170,40404,28766,208,24,24,45,768,768,744,744
San Joaquin,7,2022-01-31,5699,5699,4123,1576,43684,43689,31672,12017,210,36,36,75,2105,2105,2069,2069
San Luis Obispo,7,2022-01-31,1981,1981,1530,451,16236,16236,12541,3695,40,12,12,10,413,413,401,401
San Mateo,7,2022-01-31,4325,4325,3486,839,75105,75110,60573,14537,131,10,10,19,651,651,641,641
Santa Barbara,7,2022-01-31,3634,3634,2733,901,35024,35029,26387,8642,103,23,23,13,636,636,613,613
Santa Clara,7,2022-01-31,13839,13839,12418,1421,207116,207137,185919,21218,427,54,54,93,2150,2150,2096,2096
Santa Cruz,7,2022-01-31,3438,3438,2679,759,51420,51425,40154,11271,35,5,5,6,246,246,241,241
Shasta,7,2022-01-31,900,900,670,230,8419,8419,6269,2150,59,13,13,11,489,489,476,476
Siskiyou,7,2022-01-31,119,119,94,25,691,691,545,146,8,2,2,2,70,70,68,68
Solano,7,2022-01-31,3813,3813,2885,928,28763,28764,21767,6997,126,6,6,30,429,429,423,423
Sonoma,7,2022-01-31,3568,3568,2710,858,32149,32153,24457,7696,84,12,12,15,463,463,451,451
Stanislaus,7,2022-01-31,3687,3687,2458,1229,22306,22307,14898,7409,261,33,33,53,1541,1541,1508,1508
Sutter,7,2022-01-31,619,619,466,153,3764,3764,2837,927,0,4,4,0,209,209,205,205
Tehama,7,2022-01-31,378,378,256,122,2022,2022,1368,654,17,3,3,5,181,181,178,178
Trinity,7,2022-01-31,43,43,29,14,227,227,151,76,0,0,0,0,20,20,20,20
Tulare,7,2022-01-31,4685,4685,3097,1588,22909,22910,15179,7731,150,22,22,21,1381,1381,1359,1359
Tuolumne,7,2022-01-31,709,709,502,207,3265,3265,2315,950,12,2,2,4,166,166,164,164
Ventura,7,2022-01-31,4600,4600,3767,833,52326,52331,42906,9425,253,39,39,48,1366,1366,1327,1327
Yolo,7,2022-01-31,1353,1353,1049,304,37512,37517,29112,8405,19,5,5,5,325,325,320,320
Yuba,7,2022-01-31,523,523,400,123,2930,2930,2243,687,78,2,2,11,111,111,109,109
Alameda,8,2022-02-07,5967,5967,4968,999,115667,115681,96380,19301,254,44,44,62,1748,1748,1704,1704
Amador,8,2022-02-07,205,205,154,51,2909,2909,2187,722,14,4,4,5,78,78,74,74
Butte,8,2022-02-07,782,782,673,109,6394,6394,5506,888,74,8,8,12,394,394,386,386
Calaveras,8,2022-02-07,182,182,142,40,1426,1426,1111,315,2,2,2,1,106,106,104,104
Colusa,8,2022-02-07,71,71,57,14,555,555,449,106,0,0,0,0,21,21,21,21
Contra Costa,8,2022-02-07,4138,4138,3094,1044,54156,54161,40512,13649,149,32,32,52,1223,1223,1191,1191
Del Norte,8,2022-02-07,286,286,228,58,4003,4003,3184,819,5,0,0,0,44,44,44,44
El Dorado,8,2022-02-07,427,427,333,94,5037,5037,3929,1108,20,1,1,5,200,200,199,199
Fresno,8,2022-02-07,6379,6379,4832,1547,42579,42584,32298,10286,450,49,49,87,2621,2621,2572,2572
Glenn,8,2022-02-07,113,113,88,25,620,620,488,132,4,3,3,0,50,50,47,47
Humboldt,8,2022-02-07,468,468,372,96,4875,4875,3874,1001,15,1,1,2,136,136,135,135
Imperial,8,2022-02-07,1095,1095,851,244,7941,7941,6174,1767,46,12,12,26,907,907,895,895
Inyo,8,2022-02-07,38,38,30,8,447,447,361,86,5,0,0,0,56,56,56,56
Kern,8,2022-02-07,3475,3475,2813,662,34657,34662,28092,6570,190,32,32,43,2238,2238,2206,2206
Kings,8,2022-02-07,1351,1351,1051,300,10246,10246,7975,2271,52,14,14,5,421,421,407,407
Lake,8,2022-02-07,351,351,265,86,2625,2625,1985,640,11,1,1,5,128,128,127,127
Lassen,8,2022-02-07,140,140,115,25,3023,3023,2487,536,5,2,2,0,57,57,55,55
Los Angeles,8,2022-02-07,37345,37350,34593,2757,1151458,1151595,1067034,84561,2155,638,638,547,30301,30301,29663,29663
Madera,8,2022-02-07,1060,1060,802,258,8081,8081,6118,1963,38,4,4,9,362,362,358,358
Marin,8,2022-02-07,656,656,500,156,11291,11291,8617,2674,29,8,8,6,281,281,273,273
Mariposa,8,2022-02-07,51,51,38,13,579,579,431,148,0,0,0,0,24,24,24,24
Mendocino,8,2022-02-07,327,327,229,98,2817,2817,1974,843,12,2,2,5,116,116,114,114
Merced,8,2022-02-07,1209,1209,973,236,8063,8063,6492,1571,53,13,13,12,771,771,758,758
Modoc,8,2022-02-07,25,25,20,5,219,219,179,40,3,0,0,0,7,7,7,7
Mono,8,2022-02-07,44,44,29,15,271,271,178,93,0,0,0,0,5,5,5,5
Monterey,8,2022-02-07,2224,2224,1476,748,22461,22463,14940,7523,68,11,11,14,689,689,678,678
Napa,8,2022-02-07,742,742,611,131,7766,7766,6396,1370,16,6,6,2,130,130,124,124
Nevada,8,2022-02-07,357,357,271,86,3187,3187,2429,758,24,3,3,1,122,122,119,119
Orange,8,2022-02-07,6394,6394,5391,1003,152285,152303,128454,23849,494,118,118,125,6760,6760,6642,6642
Placer,8,2022-02-07,1290,1290,957,333,11886,11886,8830,3056,148,22,22,34,587,587,565,565
Plumas,8,2022-02-07,79,79,60,19,521,521,399,122,1,1,1,0,13,13,12,12
Riverside,8,2022-02-07,8145,8145,6513,1632,93427,93439,74782,18657,548,107,107,116,6206,6206,6099,6099
Sacramento,8,2022-02-07,6074,6074,4783,1291,63991,63997,50435,13562,390,72,72,95,2867,2867,2795,2795
San Benito,8,2022-02-07,312,312,256,56,2660,2660,2184,476,3,0,0,4,90,90,90,90
San Bernardino,8,2022-02-07,7049,7049,5863,1186,90089,90101,75001,15100,528,140,140,156,7427,7427,7287,7287
San Diego,8,2022-02-07,13645,13645,12587,1058,151885,151903,140187,11716,773,116,116,169,5068,5068,4952,4952
San Francisco,8,2022-02-07,2408,2408,1552,856,55777,55782,35915,19867,171,25,25,40,793,793,768,768
San Joaquin,8,2022-02-07,3346,3346,2580,766,36551,36556,28230,8326,186,42,42,62,2147,2147,2105,2105
San Luis Obispo,8,2022-02-07,1203,1203,978,225,12341,12341,10042,2299,23,16,16,7,429,429,413,413
San Mateo,8,2022-02-07,2462,2462,2074,388,62131,62137,52357,9780,83,16,16,18,667,667,651,651
Santa Barbara,8,2022-02-07,2282,2282,1814,468,30723,30728,24436,6292,75,15,15,17,651,651,636,636
Santa Clara,8,2022-02-07,8034,8034,7376,658,175344,175365,161045,14320,377,31,31,74,2181,2181,2150,2150
Santa Cruz,8,2022-02-07,1900,1900,1560,340,38681,38685,31767,6918,28,4,4,5,250,250,246,246
Shasta,8,2022-02-07,677,677,534,143,6857,6857,5413,1444,64,15,15,10,504,504,489,489
Siskiyou,8,2022-02-07,91,91,75,16,720,720,595,125,10,2,2,0,72,72,70,70
Solano,8,2022-02-07,2238,2238,1784,454,24263,24266,19392,4874,91,5,5,28,434,434,429,429
Sonoma,8,2022-02-07,2086,2086,1676,410,27054,27058,21739,5319,57,7,7,11,470,470,463,463
Stanislaus,8,2022-02-07,2491,2491,1792,699,18738,18739,13502,5237,243,43,43,43,1584,1584,1541,1541
Sutter,8,2022-02-07,360,360,286,74,3305,3305,2631,674,0,5,5,0,214,214,209,209
Tehama,8,2022-02-07,282,282,205,77,1644,1644,1197,447,17,3,3,6,184,184,181,181
Trinity,8,2022-02-07,18,18,13,5,136,136,98,38,0,0,0,0,20,20,20,20
Tulare,8,2022-02-07,2703,2703,1932,771,17911,17912,12835,5077,130,26,26,21,1407,1407,1381,1381
Tuolumne,8,2022-02-07,348,348,263,85,2576,2576,1953,623,10,2,2,1,168,168,166,166
Ventura,8,2022-02-07,2697,2697,2302,395,42327,42332,36170,6162,207,40,40,45,1406,1406,1366,1366
Yolo,8,2022-02-07,864,864,706,158,30859,30864,25186,5678,12,11,11,6,336,336,325,325
Yuba,8,2022-02-07,333,333,269,64,2405,2405,1942,463,42,4,4,13,115,115,111,111
Alameda,9,2022-02-14,3410,3410,2948,462,98991,99006,85619,13387,190,40,40,48,1788,1788,1748,1748
Amador,9,2022-02-14,109,109,87,22,2345,2345,1866,479,8,3,3,3,81,81,78,78
Butte,9,2022-02-14,464,464,412,52,5317,5317,4721,596,64,10,10,9,404,404,394,394
Calaveras,9,2022-02-14,79,79,64,15,1161,1161,949,212,4,2,2,2,108,108,106,106
Colusa,9,2022-02-14,35,35,29,6,406,406,341,65,5,0,0,0,21,21,21,21
Contra Costa,9,2022-02-14,2406,2406,1905,501,44864,44869,35547,9322,123,23,23,31,1246,1246,1223,1223
Del Norte,9,2022-02-14,210,210,175,35,3338,3338,2775,563,6,0,0,3,44,44,44,44
El Dorado,9,2022-02-14,260,260,213,47,4433,4433,3631,802,21,4,4,3,204,204,200,200
Fresno,9,2022-02-14,3865,3865,3094,771,34936,34941,27982,6959,375,32,32,75,2653,2653,2621,2621
Glenn,9,2022-02-14,58,58,48,10,482,482,398,84,3,1,1,0,51,51,50,50
Humboldt,9,2022-02-14,331,331,275,56,4202,4202,3495,707,23,0,0,2,136,136,136,136
Imperial,9,2022-02-14,588,588,480,108,5962,5962,4871,1091,44,14,14,18,921,921,907,907
Inyo,9,2022-02-14,29,29,24,5,413,413,348,65,3,0,0,0,56,56,56,56
Kern,9,2022-02-14,2014,2014,1701,313,27232,27236,23015,4221,156,28,28,40,2266,2266,2238,2238
Kings,9,2022-02-14,774,774,633,141,8001,8001,6548,1453,43,8,8,5,429,429,421,421
Lake,9,2022-02-14,256,256,205,51,2307,2307,1842,465,6,2,2,5,130,130,128,128
Lassen,9,2022-02-14,154,154,132,22,2789,2789,2383,406,3,2,2,0,59,59,57,57
Los Angeles,9,2022-02-14,21434,21436,20183,1253,1052387,1052524,991174,61350,1572,490,490,423,30791,30791,30301,30301
Madera,9,2022-02-14,619,619,495,124,6463,6463,5165,1298,29,2,2,7,364,364,362,362
Marin,9,2022-02-14,383,383,309,74,10150,10150,8173,1977,23,5,5,4,286,286,281,281
Mariposa,9,2022-02-14,24,24,19,5,433,433,342,91,0,0,0,0,24,24,24,24
Mendocino,9,2022-02-14,207,207,155,52,2445,2445,1834,611,13,1,1,7,117,117,116,116
Merced,9,2022-02-14,745,745,627,118,6832,6832,5744,1088,37,13,13,8,784,784,771,771
Modoc,9,2022-02-14,16,16,13,3,124,124,104,20,0,0,0,0,7,7,7,7
Mono,9,2022-02-14,10,10,7,3,179,179,127,52,0,0,0,0,5,5,5,5
Monterey,9,2022-02-14,1227,1227,880,347,16949,16949,12154,4795,48,12,12,12,701,701,689,689
Napa,9,2022-02-14,400,400,343,57,6577,6577,5635,942,10,1,1,1,131,131,130,130
Nevada,9,2022-02-14,169,169,136,33,2568,2568,2066,502,19,1,1,5,123,123,122,122
Orange,9,2022-02-14,4001,4001,3496,505,132323,132341,115567,16774,354,115,115,77,6875,6875,6760,6760
Placer,9,2022-02-14,595,595,468,127,9967,9967,7844,2123,105,12,12,23,599,599,587,587
Plumas,9,2022-02-14,43,43,35,8,431,431,348,83,1,0,0,0,13,13,13,13
Riverside,9,2022-02-14,4606,4606,3854,752,74750,74761,62573,12188,400,85,85,86,6291,6291,6206,6206
Sacramento,9,2022-02-14,3415,3415,2822,593,53019,53024,43830,9194,349,59,59,66,2926,2926,2867,2867
San Benito,9,2022-02-14,158,158,135,23,2159,2159,1845,314,0,1,1,3,91,91,90,90
San Bernardino,9,2022-02-14,3704,3704,3199,505,72754,72764,62878,9886,338,117,117,128,7544,7544,7427,7427
San Diego,9,2022-02-14,8089,8089,7591,498,126079,126095,118383,7712,589,89,89,135,5157,5157,5068,5068
San Francisco,9,2022-02-14,1610,1610,1124,486,47601,47606,33266,14340,130,25,25,39,818,818,793,793
San Joaquin,9,2022-02-14,1986,1986,1613,373,30667,30672,24923,5749,123,37,37,53,2184,2184,2147,2147
San Luis Obispo,9,2022-02-14,798,798,677,121,10050,10050,8529,1521,24,9,9,7,438,438,429,429
San Mateo,9,2022-02-14,1345,1345,1174,171,55007,55012,48011,7001,63,16,16,11,683,683,667,667
Santa Barbara,9,2022-02-14,1057,1057,881,176,22481,22484,18755,3729,68,8,8,14,659,659,651,651
Santa Clara,9,2022-02-14,4635,4635,4334,301,155254,155275,145194,10081,296,27,27,59,2208,2208,2181,2181
Santa Cruz,9,2022-02-14,981,981,838,143,30369,30373,25923,4450,23,3,3,4,253,253,250,250
Shasta,9,2022-02-14,443,443,366,77,5851,5851,4841,1010,62,13,13,13,517,517,504,504
Siskiyou,9,2022-02-14,66,66,57,9,520,520,447,73,7,1,1,2,73,73,72,72
Solano,9,2022-02-14,1201,1201,1003,198,19021,19021,15903,3118,73,2,2,20,436,436,434,434
Sonoma,9,2022-02-14,1135,1135,953,182,21178,21181,17767,3414,55,8,8,7,478,478,470,470
Stanislaus,9,2022-02-14,1364,1364,1046,318,15081,15081,11572,3509,206,28,28,41,1612,1612,1584,1584
Sutter,9,2022-02-14,229,229,191,38,2862,2862,2386,476,0,3,3,0,217,217,214,214
Tehama,9,2022-02-14,180,180,139,41,1404,1404,1088,316,15,5,5,5,189,189,184,184
Trinity,9,2022-02-14,22,22,17,5,171,171,131,40,0,0,0,0,20,20,20,20
Tulare,9,2022-02-14,1479,1479,1127,352,15049,15049,11498,3551,116,27,27,19,1434,1434,1407,1407
Tuolumne,9,2022-02-14,192,192,154,38,2222,2222,1778,444,12,4,4,1,172,172,168,168
Ventura,9,2022-02-14,1512,1512,1334,178,35526,35531,31350,4181,141,36,36,26,1442,1442,1406,1406
Yolo,9,2022-02-14,479,479,407,72,26821,26825,22792,4033,10,7,7,3,343,343,336,336
Yuba,9,2022-02-14,220,220,185,35,2109,2109,1777,332,19,0,0,11,115,115,115,115
Alameda,10,2022-02-21,1927,1927,1717,210,77634,77646,69071,8575,138,28,28,26,1816,1816,1788,1788
Amador,10,2022-02-21,70,70,58,12,1921,1921,1598,323,7,3,3,3,84,84,81,81
Butte,10,2022-02-21,255,255,232,23,4426,4426,4027,399,63,12,12,4,416,416,404,404
Calaveras,10,2022-02-21,44,44,37,7,838,838,712,126,3,6,6,0,114,114,108,108
Colusa,10,2022-02-21,26,26,23,3,362,362,315,47,4,0,0,0,21,21,21,21
Contra Costa,10,2022-02-21,1305,1305,1081,224,34149,34154,28274,5880,66,17,17,30,1263,1263,1246,1246
Del Norte,10,2022-02-21,130,130,112,18,2704,2704,2329,375,8,0,0,1,44,44,44,44
El Dorado,10,2022-02-21,156,156,133,23,3612,3612,3078,534,8,1,1,5,205,205,204,204
Fresno,10,2022-02-21,2008,2008,1680,328,26913,26918,22518,4400,272,26,26,54,2679,2679,2653,2653
Glenn,10,2022-02-21,28,28,24,4,405,405,348,57,2,1,1,0,52,52,51,51
Humboldt,10,2022-02-21,193,193,166,27,3331,3331,2873,458,22,3,3,1,139,139,136,136
Imperial,10,2022-02-21,394,394,335,59,4756,4756,4047,709,31,6,6,10,927,927,921,921
Inyo,10,2022-02-21,10,10,9,1,326,326,284,42,1,0,0,0,56,56,56,56
Kern,10,2022-02-21,1285,1285,1123,162,24323,24328,21268,3060,95,23,23,25,2289,2289,2266,2266
Kings,10,2022-02-21,454,454,387,67,6543,6543,5576,967,32,4,4,5,433,433,429,429
Lake,10,2022-02-21,185,185,155,30,1935,1935,1614,321,7,2,2,1,132,132,130,130
Lassen,10,2022-02-21,111,111,98,13,2135,2135,1883,252,1,0,0,0,59,59,59,59
Los Angeles,10,2022-02-21,11809,11809,11262,547,832204,832327,793295,39032,997,322,322,279,31113,31113,30791,30791
Madera,10,2022-02-21,317,317,265,52,5176,5176,4315,861,27,2,2,7,366,366,364,364
Marin,10,2022-02-21,198,198,166,32,8845,8845,7425,1420,13,3,3,4,289,289,286,286
Mariposa,10,2022-02-21,23,23,19,4,372,372,307,65,0,1,1,0,25,25,24,24
Mendocino,10,2022-02-21,113,113,90,23,1942,1942,1539,403,9,2,2,3,119,119,117,117
Merced,10,2022-02-21,427,427,372,55,5160,5160,4489,671,26,10,10,7,794,794,784,784
Modoc,10,2022-02-21,9,9,8,1,65,65,57,8,2,0,0,0,7,7,7,7
Mono,10,2022-02-21,7,7,5,2,162,162,123,39,0,1,1,0,6,6,5,5
Monterey,10,2022-02-21,780,780,596,184,12977,12977,9894,3083,47,5,5,7,706,706,701,701
Napa,10,2022-02-21,229,229,202,27,4985,4985,4405,580,6,4,4,3,135,135,131,131
Nevada,10,2022-02-21,102,102,85,17,1985,1985,1665,320,16,2,2,5,125,125,123,123
Orange,10,2022-02-21,2463,2463,2213,250,110416,110434,99039,11395,256,79,79,69,6954,6954,6875,6875
Placer,10,2022-02-21,328,328,271,57,8679,8679,7157,1522,92,9,9,13,608,608,599,599
Plumas,10,2022-02-21,21,21,18,3,328,328,276,52,0,0,0,0,13,13,13,13
Riverside,10,2022-02-21,2439,2439,2115,324,61414,61424,53283,8141,262,53,53,61,6344,6344,6291,6291
Sacramento,10,2022-02-21,1959,1959,1681,278,42786,42791,36701,6090,249,33,33,47,2959,2959,2926,2926
San Benito,10,2022-02-21,104,104,92,12,1696,1696,1494,202,0,0,0,1,91,91,91,91
San Bernardino,10,2022-02-21,1901,1901,1693,208,60248,60259,53636,6623,251,82,82,78,7626,7626,7544,7544
San Diego,10,2022-02-21,4626,4626,4401,225,100589,100604,95703,4901,468,61,61,106,5218,5218,5157,5157
San Francisco,10,2022-02-21,975,975,730,245,40355,40360,30111,10249,98,11,11,24,829,829,818,818
San Joaquin,10,2022-02-21,1049,1049,888,161,23867,23872,20190,3682,91,25,25,31,2209,2209,2184,2184
San Luis Obispo,10,2022-02-21,441,441,386,55,7650,7650,6704,946,16,16,16,3,454,454,438,438
San Mateo,10,2022-02-21,695,695,624,71,42575,42580,38165,4415,47,8,8,8,691,691,683,683
Santa Barbara,10,2022-02-21,610,610,527,83,19195,19198,16580,2618,40,6,6,10,665,665,659,659
Santa Clara,10,2022-02-21,2515,2515,2385,130,120311,120330,114040,6290,224,25,25,53,2233,2233,2208,2208
Santa Cruz,10,2022-02-21,578,578,509,69,25013,25017,22018,2999,21,1,1,4,254,254,253,253
Shasta,10,2022-02-21,263,263,225,38,4976,4976,4276,700,46,9,9,10,526,526,517,517
Siskiyou,10,2022-02-21,47,47,42,5,450,450,398,52,6,4,4,1,77,77,73,73
Solano,10,2022-02-21,698,698,605,93,15143,15143,13122,2021,51,5,5,15,441,441,436,436
Sonoma,10,2022-02-21,628,628,546,82,16824,16826,14605,2221,36,2,2,8,480,480,478,478
Stanislaus,10,2022-02-21,732,732,590,142,11759,11759,9489,2270,168,29,29,30,1641,1641,1612,1612
Sutter,10,2022-02-21,121,121,105,16,2108,2108,1821,287,0,2,2,0,219,219,217,217
Tehama,10,2022-02-21,96,96,78,18,1219,1219,993,226,8,10,10,2,199,199,189,189
Trinity,10,2022-02-21,15,15,12,3,199,199,160,39,0,0,0,0,20,20,20,20
Tulare,10,2022-02-21,776,776,623,153,10927,10927,8785,2142,86,15,15,9,1449,1449,1434,1434
Tuolumne,10,2022-02-21,107,107,90,17,1784,1784,1491,293,2,6,6,2,178,178,172,172
Ventura,10,2022-02-21,886,886,802,84,27543,27548,24931,2617,107,22,22,22,1464,1464,1442,1442
Yolo,10,2022-02-21,282,282,248,34,20978,20982,18402,2580,7,6,6,3,349,349,343,343
Yuba,10,2022-02-21,134,134,117,17,1679,1679,1466,213,22,1,1,8,116,116,115,115
Alameda,11,2022-02-28,1477,1477,1350,127,78764,78781,71953,6828,113,17,17,23,1833,1833,1816,1816
Amador,11,2022-02-28,56,56,48,8,2077,2077,1796,281,7,0,0,2,84,84,84,84
Butte,11,2022-02-28,188,188,175,13,4475,4475,4156,319,45,6,6,4,422,422,416,416
Calaveras,11,2022-02-28,40,40,35,5,1254,1254,1105,149,0,3,3,0,117,117,114,114
Colusa,11,2022-02-28,10,10,9,1,406,406,364,42,5,0,0,0,21,21,21,21
Contra Costa,11,2022-02-28,936,936,807,129,35020,35025,30199,4826,56,15,15,19,1278,1278,1263,1263
Del Norte,11,2022-02-28,84,84,75,9,2876,2876,2557,319,5,3,3,2,47,47,44,44
El Dorado,11,2022-02-28,106,106,94,12,3686,3686,3252,434,5,2,2,3,207,207,205,205
Fresno,11,2022-02-28,1307,1307,1136,171,26369,26374,22913,3461,196,28,28,44,2707,2707,2679,2679
Glenn,11,2022-02-28,18,18,16,2,435,435,386,49,1,0,0,0,52,52,52,52
Humboldt,11,2022-02-28,157,157,140,17,2956,2956,2632,324,6,1,1,1,140,140,139,139
Imperial,11,2022-02-28,264,264,233,31,4783,4783,4210,573,13,6,6,10,933,933,927,927
Inyo,11,2022-02-28,10,10,9,1,379,379,341,38,0,0,0,0,56,56,56,56
Kern,11,2022-02-28,791,791,712,79,24603,24608,22155,2453,77,16,16,16,2305,2305,2289,2289
Kings,11,2022-02-28,246,246,216,30,6079,6079,5356,723,19,7,7,3,440,440,433,433
Lake,11,2022-02-28,110,110,95,15,1956,1956,1695,261,0,4,4,1,136,136,132,132
Lassen,11,2022-02-28,44,44,40,4,2097,2097,1899,198,1,2,2,0,61,61,59,59
Los Angeles,11,2022-02-28,8217,8217,7919,298,1057291,1057500,1018955,38545,753,222,222,174,31335,31335,31113,31113
Madera,11,2022-02-28,189,189,164,25,4623,4623,4012,611,20,2,2,6,368,368,366,366
Marin,11,2022-02-28,160,160,140,20,7664,7664,6681,983,13,3,3,3,292,292,289,289
Mariposa,11,2022-02-28,29,29,25,4,347,347,298,49,0,1,1,0,26,26,25,25
Mendocino,11,2022-02-28,84,84,70,14,1889,1889,1571,318,11,2,2,2,121,121,119,119
Merced,11,2022-02-28,283,283,254,29,5030,5030,4509,521,25,7,7,5,801,801,794,794
Modoc,11,2022-02-28,6,6,5,1,57,57,51,6,1,0,0,0,7,7,7,7
Mono,11,2022-02-28,5,5,4,1,169,169,136,33,0,0,0,0,6,6,6,6
Monterey,11,2022-02-28,355,355,286,69,14337,14339,11563,2776,28,9,9,5,715,715,706,706
Napa,11,2022-02-28,194,194,176,18,5593,5593,5079,514,8,3,3,2,138,138,135,135
Nevada,11,2022-02-28,70,70,61,9,2016,2016,1753,263,9,0,0,1,125,125,125,125
Orange,11,2022-02-28,1688,1688,1551,137,126368,126393,116128,10265,198,42,42,35,6996,6996,6954,6954
Placer,11,2022-02-28,248,248,213,35,8421,8421,7233,1188,65,4,4,13,612,612,608,608
Plumas,11,2022-02-28,23,23,20,3,370,370,323,47,0,0,0,0,13,13,13,13
Riverside,11,2022-02-28,1686,1686,1507,179,63264,63278,56580,6698,185,37,37,35,6381,6381,6344,6344
Sacramento,11,2022-02-28,1162,1162,1031,131,45696,45704,40522,5182,163,24,24,35,2983,2983,2959,2959
San Benito,11,2022-02-28,55,55,50,5,1809,1809,1638,171,0,0,0,1,91,91,91,91
San Bernardino,11,2022-02-28,1174,1174,1072,102,61093,61106,55785,5321,157,60,60,45,7686,7686,7626,7626
San Diego,11,2022-02-28,3035,3035,2919,116,100026,100046,96242,3804,341,37,37,83,5255,5255,5218,5218
San Francisco,11,2022-02-28,835,835,662,173,40065,40071,31746,8325,74,16,16,19,845,845,829,829
San Joaquin,11,2022-02-28,658,658,577,81,26110,26115,22889,3226,58,11,11,24,2220,2220,2209,2209
San Luis Obispo,11,2022-02-28,378,378,341,37,8504,8504,7672,832,9,5,5,2,459,459,454,454
San Mateo,11,2022-02-28,597,597,549,48,41439,41446,38092,3354,33,4,4,7,695,695,691,691
Santa Barbara,11,2022-02-28,369,369,329,40,21385,21390,19067,2323,36,5,5,10,670,670,665,665
Santa Clara,11,2022-02-28,1730,1730,1660,70,103090,103110,98990,4120,191,22,22,46,2255,2255,2233,2233
Santa Cruz,11,2022-02-28,460,460,416,44,27974,27979,25348,2631,20,2,2,4,256,256,254,254
Shasta,11,2022-02-28,167,167,148,19,4926,4926,4373,553,36,11,11,8,537,537,526,526
Siskiyou,11,2022-02-28,25,25,23,2,475,475,432,43,4,2,2,1,79,79,77,77
Solano,11,2022-02-28,476,476,425,51,15357,15360,13728,1632,47,3,3,17,444,444,441,441
Sonoma,11,2022-02-28,454,454,407,47,16951,16955,15190,1765,28,3,3,5,483,483,480,480
Stanislaus,11,2022-02-28,470,470,396,74,13361,13363,11277,2086,124,11,11,21,1652,1652,1641,1641
Sutter,11,2022-02-28,106,106,95,11,2333,2333,2079,254,0,2,2,0,221,221,219,219
Tehama,11,2022-02-28,60,60,51,9,1221,1221,1039,182,7,1,1,2,200,200,199,199
Trinity,11,2022-02-28,5,5,4,1,118,118,99,19,0,0,0,0,20,20,20,20
Tulare,11,2022-02-28,463,463,389,74,11876,11878,9992,1886,67,15,15,9,1464,1464,1449,1449
Tuolumne,11,2022-02-28,68,68,59,9,1486,1486,1291,195,6,3,3,1,181,181,178,178
Ventura,11,2022-02-28,548,548,507,41,29889,29894,27653,2241,75,10,10,11,1474,1474,1464,1464
Yolo,11,2022-02-28,207,207,187,20,26246,26251,23705,2546,4,5,5,6,354,354,349,349
Yuba,11,2022-02-28,75,75,67,8,1711,1711,1537,174,12,1,1,6,117,117,116,116
Alameda,12,2022-03-07,1095,1095,1020,75,72387,72405,67420,4985,77,12,12,16,1845,1845,1833,1833
Amador,12,2022-03-07,75,75,67,8,1428,1428,1274,154,6,2,2,1,86,86,84,84
Butte,12,2022-03-07,98,98,92,6,3638,3638,3434,204,33,4,4,3,426,426,422,422
Calaveras,12,2022-03-07,25,25,23,2,1048,1048,948,100,1,1,1,0,118,118,117,117
Colusa,12,2022-03-07,9,9,8,1,355,355,326,29,6,0,0,0,21,21,21,21
Contra Costa,12,2022-03-07,627,627,558,69,30970,30976,27551,3425,47,8,8,13,1286,1286,1278,1278
Del Norte,12,2022-03-07,50,50,46,4,1779,1779,1624,155,7,0,0,1,47,47,47,47
El Dorado,12,2022-03-07,77,77,70,7,3200,3200,2899,301,5,3,3,2,210,210,207,207
Fresno,12,2022-03-07,859,859,769,90,22260,22265,19933,2332,145,18,18,27,2725,2725,2707,2707
Glenn,12,2022-03-07,19,19,17,2,395,395,359,36,2,1,1,0,53,53,52,52
Humboldt,12,2022-03-07,81,81,74,7,3045,3045,2779,266,10,3,3,4,143,143,140,140
Imperial,12,2022-03-07,122,122,110,12,4481,4481,4054,427,16,5,5,10,938,938,933,933
Inyo,12,2022-03-07,10,10,9,1,269,269,247,22,0,0,0,0,56,56,56,56
Kern,12,2022-03-07,433,433,398,35,20833,20838,19189,1649,67,12,12,16,2317,2317,2305,2305
Kings,12,2022-03-07,201,201,182,19,4986,4986,4514,472,13,4,4,2,444,444,440,440
Lake,12,2022-03-07,64,64,57,7,1760,1760,1572,188,2,2,2,1,138,138,136,136
Lassen,12,2022-03-07,96,96,89,7,1889,1889,1748,141,0,1,1,0,62,62,61,61
Los Angeles,12,2022-03-07,5537,5537,5380,157,876056,876272,851343,24929,573,171,171,133,31506,31506,31335,31335
Madera,12,2022-03-07,133,133,119,14,3916,3916,3502,414,15,1,1,2,369,369,368,368
Marin,12,2022-03-07,154,154,138,16,7558,7558,6778,780,10,1,1,2,293,293,292,292
Mariposa,12,2022-03-07,11,11,10,1,296,296,263,33,0,1,1,0,27,27,26,26
Mendocino,12,2022-03-07,65,65,56,9,1643,1643,1418,225,6,0,0,2,121,121,121,121
Merced,12,2022-03-07,172,172,158,14,4536,4536,4161,375,17,7,7,5,808,808,801,801
Modoc,12,2022-03-07,0,0,0,0,54,54,50,4,0,0,0,0,7,7,7,7
Mono,12,2022-03-07,2,2,2,0,128,128,108,20,0,0,0,1,6,6,6,6
Monterey,12,2022-03-07,246,246,207,39,11053,11055,9326,1729,19,5,5,2,720,720,715,715
Napa,12,2022-03-07,199,199,185,14,4874,4874,4518,356,2,1,1,2,139,139,138,138
Nevada,12,2022-03-07,50,50,45,5,1750,1750,1568,182,0,1,1,0,126,126,125,125
Orange,12,2022-03-07,1254,1254,1174,80,107453,107480,100574,6906,138,29,29,28,7025,7025,6996,6996
Placer,12,2022-03-07,164,164,145,19,7797,7798,6917,881,54,3,3,11,615,615,612,612
Plumas,12,2022-03-07,7,7,6,1,266,266,239,27,0,0,0,0,13,13,13,13
Riverside,12,2022-03-07,980,980,898,82,53631,53644,49129,4515,125,26,26,30,6407,6407,6381,6381
Sacramento,12,2022-03-07,773,773,704,69,40204,40214,36593,3621,124,18,18,28,3001,3001,2983,2983
San Benito,12,2022-03-07,41,41,38,3,1525,1525,1411,114,0,2,2,1,93,93,91,91
San Bernardino,12,2022-03-07,792,792,737,55,54190,54203,50465,3738,95,43,43,38,7729,7729,7686,7686
San Diego,12,2022-03-07,2338,2338,2268,70,96665,96688,93803,2885,237,31,31,57,5286,5286,5255,5255
San Francisco,12,2022-03-07,700,700,582,118,37419,37429,31070,6359,62,5,5,11,850,850,845,845
San Joaquin,12,2022-03-07,439,439,396,43,21215,21220,19139,2081,33,9,9,19,2229,2229,2220,2220
San Luis Obispo,12,2022-03-07,245,245,226,19,7300,7301,6736,565,7,5,5,1,464,464,459,459
San Mateo,12,2022-03-07,529,529,495,34,40057,40066,37478,2588,30,2,2,3,697,697,695,695
Santa Barbara,12,2022-03-07,203,203,186,17,17714,17719,16191,1528,15,4,4,8,674,674,670,670
Santa Clara,12,2022-03-07,1467,1467,1421,46,112126,112153,108583,3570,128,13,13,38,2268,2268,2255,2255
Santa Cruz,12,2022-03-07,335,335,310,25,24974,24980,23121,1859,11,0,0,7,256,256,256,256
Shasta,12,2022-03-07,140,140,127,13,4940,4940,4498,442,24,8,8,3,545,545,537,537
Siskiyou,12,2022-03-07,12,12,11,1,399,399,370,29,2,1,1,0,80,80,79,79
Solano,12,2022-03-07,352,352,322,30,14104,14108,12913,1195,46,2,2,10,446,446,444,444
Sonoma,12,2022-03-07,321,321,294,27,14921,14925,13688,1237,26,3,3,6,486,486,483,483
Stanislaus,12,2022-03-07,276,276,241,35,10858,10859,9501,1358,94,10,10,13,1662,1662,1652,1652
Sutter,12,2022-03-07,83,83,76,7,1908,1908,1742,166,0,1,1,0,222,222,221,221
Tehama,12,2022-03-07,40,40,35,5,1115,1115,980,135,5,2,2,1,202,202,200,200
Trinity,12,2022-03-07,4,4,3,1,114,114,100,14,0,0,0,0,20,20,20,20
Tulare,12,2022-03-07,303,303,264,39,10282,10283,8975,1308,37,13,13,3,1477,1477,1464,1464
Tuolumne,12,2022-03-07,48,48,43,5,1253,1253,1122,131,2,0,0,1,181,181,181,181
Ventura,12,2022-03-07,417,417,392,25,26717,26723,25142,1581,45,4,4,11,1478,1478,1474,1474
Yolo,12,2022-03-07,160,160,148,12,22155,22160,20456,1704,3,2,2,2,356,356,354,354
Yuba,12,2022-03-07,59,59,54,5,1553,1553,1426,127,13,0,0,6,117,117,117,117
Alameda,13,2022-03-14,877,877,829,48,68949,68972,65220,3752,64,9,9,6,1854,1854,1845,1845
Amador,13,2022-03-14,32,32,29,3,1439,1439,1315,124,4,0,0,0,86,86,86,86
Butte,13,2022-03-14,82,82,78,4,3592,3592,3432,160,24,1,1,0,427,427,426,426
Calaveras,13,2022-03-14,17,17,16,1,990,990,914,76,1,1,1,1,119,119,118,118
Colusa,13,2022-03-14,4,4,4,0,257,257,240,17,4,0,0,0,21,21,21,21
Contra Costa,13,2022-03-14,567,567,517,50,29143,29152,26582,2570,19,5,5,9,1291,1291,1286,1286
Del Norte,13,2022-03-14,31,31,29,2,1415,1415,1317,98,1,2,2,1,49,49,47,47
El Dorado,13,2022-03-14,44,44,41,3,2980,2980,2757,223,4,1,1,0,211,211,210,210
Fresno,13,2022-03-14,524,524,480,44,21169,21175,19406,1769,120,10,10,20,2735,2735,2725,2725
Glenn,13,2022-03-14,11,11,10,1,342,342,318,24,1,0,0,0,53,53,53,53
Humboldt,13,2022-03-14,56,56,52,4,2651,2651,2466,185,3,1,1,2,144,144,143,143
Imperial,13,2022-03-14,74,74,68,6,4551,4551,4203,348,5,2,2,7,940,940,938,938
Inyo,13,2022-03-14,6,6,6,0,165,165,154,11,0,0,0,0,56,56,56,56
Kern,13,2022-03-14,301,301,282,19,20273,20279,19008,1271,42,14,14,12,2331,2331,2317,2317
Kings,13,2022-03-14,155,155,143,12,4695,4695,4341,354,17,1,1,2,445,445,444,444
Lake,13,2022-03-14,48,48,44,4,1570,1570,1436,134,1,1,1,0,139,139,138,138
Lassen,13,2022-03-14,5,5,5,0,1515,1515,1426,89,0,0,0,0,62,62,62,62
Los Angeles,13,2022-03-14,4057,4057,3967,90,845619,845886,827026,18860,412,115,115,91,31621,31621,31506,31506
Madera,13,2022-03-14,52,52,48,4,3575,3575,3272,303,12,0,0,2,369,369,369,369
Marin,13,2022-03-14,170,170,156,14,6532,6532,5997,535,7,1,1,0,294,294,293,293
Mariposa,13,2022-03-14,9,9,8,1,222,222,202,20,0,0,0,0,27,27,27,27
Mendocino,13,2022-03-14,35,35,31,4,1434,1434,1276,158,4,2,2,1,123,123,121,121
Merced,13,2022-03-14,134,134,125,9,4167,4167,3895,272,17,2,2,4,810,810,808,808
Modoc,13,2022-03-14,3,3,3,0,52,52,49,3,1,0,0,0,7,7,7,7
Mono,13,2022-03-14,2,2,2,0,118,118,103,15,0,0,0,0,6,6,6,6
Monterey,13,2022-03-14,156,156,136,20,10113,10115,8836,1279,14,4,4,2,724,724,720,720
Napa,13,2022-03-14,120,120,113,7,4104,4104,3867,237,6,1,1,3,140,140,139,139
Nevada,13,2022-03-14,50,50,46,4,1571,1571,1441,130,2,0,0,0,126,126,126,126
Orange,13,2022-03-14,821,821,779,42,101559,101591,96435,5156,109,31,31,31,7056,7056,7025,7025
Placer,13,2022-03-14,148,148,135,13,7319,7320,6659,661,45,3,3,5,618,618,615,615
Plumas,13,2022-03-14,4,4,4,0,317,317,291,26,0,0,0,0,13,13,13,13
Riverside,13,2022-03-14,739,739,690,49,52736,52753,49236,3517,87,15,15,16,6422,6422,6407,6407
Sacramento,13,2022-03-14,587,587,545,42,35139,35151,32627,2524,122,16,16,22,3017,3017,3001,3001
San Benito,13,2022-03-14,36,36,34,2,1462,1462,1375,87,0,0,0,1,93,93,93,93
San Bernardino,13,2022-03-14,568,568,537,31,51684,51701,48880,2821,68,26,26,32,7755,7755,7729,7729
San Diego,13,2022-03-14,1843,1843,1800,43,96065,96096,93841,2255,174,17,17,47,5303,5303,5286,5286
San Francisco,13,2022-03-14,608,608,525,83,34320,34332,29610,4722,28,7,7,7,857,857,850,850
San Joaquin,13,2022-03-14,268,268,247,21,18891,18896,17409,1487,28,7,7,11,2236,2236,2229,2229
San Luis Obispo,13,2022-03-14,162,162,152,10,6664,6665,6255,410,7,7,7,1,471,471,464,464
San Mateo,13,2022-03-14,441,441,419,22,35834,35844,34009,1835,27,0,0,3,697,697,697,697
Santa Barbara,13,2022-03-14,196,196,183,13,16859,16864,15704,1160,16,7,7,2,681,681,674,674
Santa Clara,13,2022-03-14,1177,1177,1148,29,99875,99905,97406,2499,108,13,13,28,2281,2281,2268,2268
Santa Cruz,13,2022-03-14,239,239,225,14,22176,22183,20875,1308,10,3,3,3,259,259,256,256
Shasta,13,2022-03-14,97,97,90,7,4838,4838,4492,346,16,5,5,2,550,550,545,545
Siskiyou,13,2022-03-14,9,9,8,1,370,370,349,21,0,3,3,0,83,83,80,80
Solano,13,2022-03-14,221,221,206,15,12336,12341,11510,831,34,1,1,6,447,447,446,446
Sonoma,13,2022-03-14,228,228,213,15,13400,13404,12518,886,14,1,1,4,487,487,486,486
Stanislaus,13,2022-03-14,216,216,194,22,9401,9404,8456,948,82,11,11,17,1673,1673,1662,1662
Sutter,13,2022-03-14,41,41,38,3,1815,1815,1689,126,0,0,0,0,222,222,222,222
Tehama,13,2022-03-14,17,17,15,2,981,981,886,95,2,3,3,0,205,205,202,202
Trinity,13,2022-03-14,3,3,3,0,96,96,86,10,0,0,0,0,20,20,20,20
Tulare,13,2022-03-14,173,173,155,18,9301,9304,8351,953,33,0,0,6,1477,1477,1477,1477
Tuolumne,13,2022-03-14,22,22,20,2,1246,1246,1142,104,1,0,0,0,181,181,181,181
Ventura,13,2022-03-14,326,326,311,15,24591,24597,23446,1151,37,6,6,7,1484,1484,1478,1478
Yolo,13,2022-03-14,118,118,111,7,21624,21629,20311,1318,1,3,3,2,359,359,356,356
Yuba,13,2022-03-14,35,35,33,2,1417,1417,1325,92,10,0,0,3,117,117,117,117
Alameda,14,2022-03-21,721,721,690,31,65826,65853,63020,2833,58,7,7,3,1861,1861,1854,1854
Amador,14,2022-03-21,29,29,27,2,1356,1356,1263,93,2,0,0,0,86,86,86,86
Butte,14,2022-03-21,81,81,78,3,3158,3158,3048,110,17,0,0,2,427,427,427,427
Calaveras,14,2022-03-21,8,8,8,0,657,657,618,39,0,0,0,0,119,119,119,119
Colusa,14,2022-03-21,3,3,3,0,231,231,219,12,2,0,0,0,21,21,21,21
Contra Costa,14,2022-03-21,466,466,434,32,26932,26944,25051,1893,27,7,7,9,1298,1298,1291,1291
Del Norte,14,2022-03-21,19,19,18,1,1192,1192,1127,65,0,0,0,0,49,49,49,49
El Dorado,14,2022-03-21,46,46,43,3,2813,2813,2647,166,1,2,2,0,213,213,211,211
Fresno,14,2022-03-21,349,349,326,23,19379,19387,18101,1286,97,11,11,12,2746,2746,2735,2735
Glenn,14,2022-03-21,7,7,7,0,366,366,345,21,1,0,0,0,53,53,53,53
Humboldt,14,2022-03-21,31,31,29,2,2456,2456,2322,134,5,1,1,2,145,145,144,144
Imperial,14,2022-03-21,58,58,54,4,3965,3965,3727,238,4,3,3,4,943,943,940,940
Inyo,14,2022-03-21,1,1,1,0,148,148,140,8,0,0,0,0,56,56,56,56
Kern,14,2022-03-21,206,206,196,10,19490,19497,18531,966,34,4,4,9,2335,2335,2331,2331
Kings,14,2022-03-21,79,79,74,5,4411,4411,4147,264,7,1,1,1,446,446,445,445
Lake,14,2022-03-21,18,18,17,1,1365,1365,1272,93,0,0,0,0,139,139,139,139
Lassen,14,2022-03-21,10,10,10,0,1388,1388,1323,65,0,0,0,0,62,62,62,62
Los Angeles,14,2022-03-21,4130,4130,4059,71,822836,823185,808807,14378,338,76,76,66,31697,31697,31621,31621
Madera,14,2022-03-21,40,40,37,3,3392,3392,3164,228,9,1,1,1,370,370,369,369
Marin,14,2022-03-21,133,133,124,9,6231,6233,5827,406,6,1,1,0,295,295,294,294
Mariposa,14,2022-03-21,7,7,6,1,236,236,219,17,0,0,0,0,27,27,27,27
Mendocino,14,2022-03-21,28,28,26,2,1508,1508,1376,132,4,0,0,1,123,123,123,123
Merced,14,2022-03-21,87,87,82,5,3771,3771,3576,195,13,5,5,1,815,815,810,810
Modoc,14,2022-03-21,2,2,2,0,60,60,57,3,0,0,0,0,7,7,7,7
Mono,14,2022-03-21,4,4,4,0,134,134,120,14,1,0,0,0,6,6,6,6
Monterey,14,2022-03-21,152,152,137,15,10087,10092,9067,1025,22,0,0,1,724,724,724,724
Napa,14,2022-03-21,54,54,52,2,3451,3451,3294,157,6,1,1,2,141,141,140,140
Nevada,14,2022-03-21,18,18,17,1,1528,1528,1428,100,2,0,0,0,126,126,126,126
Orange,14,2022-03-21,757,757,727,30,96133,96174,92320,3854,100,12,12,25,7068,7068,7056,7056
Placer,14,2022-03-21,111,111,103,8,6475,6476,6011,465,40,2,2,6,620,620,618,618
Plumas,14,2022-03-21,2,2,2,0,228,228,213,15,0,0,0,0,13,13,13,13
Riverside,14,2022-03-21,615,615,582,33,51895,51916,49158,2758,69,13,13,18,6435,6435,6422,6422
Sacramento,14,2022-03-21,461,461,435,26,32984,32998,31126,1872,89,13,13,13,3030,3030,3017,3017
San Benito,14,2022-03-21,19,19,18,1,1385,1385,1320,65,0,1,1,0,94,94,93,93
San Bernardino,14,2022-03-21,473,473,453,20,49316,49337,47205,2132,49,20,20,31,7775,7775,7755,7755
San Diego,14,2022-03-21,1372,1372,1347,25,84591,84626,83069,1557,146,15,15,39,5318,5318,5303,5303
San Francisco,14,2022-03-21,688,688,613,75,33568,33582,29868,3714,34,3,3,3,860,860,857,857
San Joaquin,14,2022-03-21,221,221,207,14,15687,15693,14720,973,23,6,6,6,2242,2242,2236,2236
San Luis Obispo,14,2022-03-21,107,107,102,5,6416,6418,6105,313,3,5,5,0,476,476,471,471
San Mateo,14,2022-03-21,367,367,352,15,34927,34943,33538,1405,30,1,1,1,698,698,697,697
Santa Barbara,14,2022-03-21,160,160,151,9,14296,14301,13512,789,17,5,5,4,686,686,681,681
Santa Clara,14,2022-03-21,1100,1100,1079,21,95231,95273,93407,1866,101,5,5,20,2286,2286,2281,2281
Santa Cruz,14,2022-03-21,184,184,175,9,20037,20045,19109,936,8,0,0,3,259,259,259,259
Shasta,14,2022-03-21,41,41,39,2,4136,4136,3902,234,10,6,6,2,556,556,550,550
Siskiyou,14,2022-03-21,9,9,9,0,370,370,353,17,1,0,0,0,83,83,83,83
Solano,14,2022-03-21,187,187,177,10,11782,11787,11160,627,17,1,1,5,448,448,447,447
Sonoma,14,2022-03-21,229,229,217,12,12377,12382,11730,652,15,2,2,2,489,489,487,487
Stanislaus,14,2022-03-21,142,142,131,11,8428,8433,7757,676,59,12,12,8,1685,1685,1673,1673
Sutter,14,2022-03-21,35,35,33,2,1478,1478,1398,80,0,1,1,0,223,223,222,222
Tehama,14,2022-03-21,11,11,10,1,926,926,854,72,2,0,0,0,205,205,205,205
Trinity,14,2022-03-21,0,0,0,0,111,111,102,9,0,0,0,0,20,20,20,20
Tulare,14,2022-03-21,110,110,101,9,8167,8172,7505,667,27,5,5,4,1482,1482,1477,1477
Tuolumne,14,2022-03-21,19,19,18,1,1131,1131,1055,76,2,0,0,0,181,181,181,181
Ventura,14,2022-03-21,289,289,278,11,23283,23293,22433,860,30,5,5,6,1489,1489,1484,1484
Yolo,14,2022-03-21,107,107,102,5,21433,21444,20405,1039,1,0,0,1,359,359,359,359
Yuba,14,2022-03-21,42,42,40,2,1318,1318,1251,67,8,0,0,2,117,117,117,117
Alameda,15,2022-03-28,927,927,896,31,59262,59291,57291,2000,35,4,4,5,1865,1865,1861,1861
Amador,15,2022-03-28,8,8,8,0,1376,1376,1301,75,3,0,0,0,86,86,86,86
Butte,15,2022-03-28,64,64,62,2,2854,2854,2776,78,11,0,0,1,427,427,427,427
Calaveras,15,2022-03-28,15,15,14,1,580,580,553,27,0,0,0,0,119,119,119,119
Colusa,15,2022-03-28,4,4,4,0,207,207,199,8,0,0,0,0,21,21,21,21
Contra Costa,15,2022-03-28,534,534,505,29,24910,24924,23542,1382,29,1,1,6,1299,1299,1298,1298
Del Norte,15,2022-03-28,16,16,15,1,1038,1038,993,45,1,0,0,0,49,49,49,49
El Dorado,15,2022-03-28,60,60,57,3,2810,2810,2679,131,0,0,0,0,213,213,213,213
Fresno,15,2022-03-28,275,275,261,14,17945,17956,17014,942,71,5,5,18,2751,2751,2746,2746
Glenn,15,2022-03-28,8,8,8,0,333,333,318,15,0,0,0,0,53,53,53,53
Humboldt,15,2022-03-28,27,27,26,1,2608,2608,2495,113,4,0,0,3,145,145,145,145
Imperial,15,2022-03-28,62,62,59,3,3535,3535,3367,168,4,1,1,3,944,944,943,943
Inyo,15,2022-03-28,4,4,4,0,186,186,178,8,1,0,0,0,56,56,56,56
Kern,15,2022-03-28,144,144,138,6,18179,18188,17478,710,17,4,4,8,2339,2339,2335,2335
Kings,15,2022-03-28,57,57,54,3,4275,4275,4073,202,6,2,2,0,448,448,446,446
Lake,15,2022-03-28,10,10,9,1,1068,1068,1010,58,0,0,0,0,139,139,139,139
Lassen,15,2022-03-28,4,4,4,0,1284,1284,1236,48,0,0,0,0,62,62,62,62
Los Angeles,15,2022-03-28,4472,4472,4411,61,703823,704187,694455,9732,264,52,52,57,31749,31749,31697,31697
Madera,15,2022-03-28,24,24,23,1,3451,3451,3268,183,4,0,0,2,370,370,370,370
Marin,15,2022-03-28,180,180,171,9,6000,6002,5694,308,3,0,0,0,295,295,295,295
Mariposa,15,2022-03-28,5,5,5,0,179,179,169,10,0,1,1,0,28,28,27,27
Mendocino,15,2022-03-28,31,31,29,2,1314,1314,1223,91,0,1,1,0,124,124,123,123
Merced,15,2022-03-28,64,64,61,3,3359,3359,3223,136,5,1,1,3,816,816,815,815
Modoc,15,2022-03-28,3,3,3,0,45,45,43,2,0,0,0,0,7,7,7,7
Mono,15,2022-03-28,1,1,1,0,134,134,123,11,0,0,0,0,6,6,6,6
Monterey,15,2022-03-28,151,151,139,12,8782,8787,8073,714,14,1,1,0,725,725,724,724
Napa,15,2022-03-28,67,67,65,2,3329,3329,3210,119,1,2,2,1,143,143,141,141
Nevada,15,2022-03-28,27,27,26,1,1431,1431,1357,74,1,1,1,0,127,127,126,126
Orange,15,2022-03-28,809,809,784,25,90210,90259,87421,2838,81,12,12,17,7080,7080,7068,7068
Placer,15,2022-03-28,107,107,101,6,6222,6225,5872,353,26,4,4,6,624,624,620,620
Plumas,15,2022-03-28,3,3,3,0,267,267,253,14,0,0,0,0,13,13,13,13
Riverside,15,2022-03-28,521,521,500,21,43927,43950,42118,1832,47,7,7,10,6442,6442,6435,6435
Sacramento,15,2022-03-28,458,458,438,20,32473,32490,31039,1451,68,6,6,19,3036,3036,3030,3030
San Benito,15,2022-03-28,14,14,13,1,1365,1365,1315,50,0,0,0,0,94,94,94,94
San Bernardino,15,2022-03-28,545,545,527,18,41307,41329,39931,1398,40,18,18,24,7793,7793,7775,7775
San Diego,15,2022-03-28,1325,1325,1306,19,72132,72170,71134,1036,114,9,9,26,5327,5327,5318,5318
San Francisco,15,2022-03-28,845,845,771,74,32805,32822,29926,2896,23,5,5,5,865,865,860,860
San Joaquin,15,2022-03-28,190,190,181,9,17505,17513,16658,855,20,4,4,4,2246,2246,2242,2242
San Luis Obispo,15,2022-03-28,96,96,92,4,5701,5704,5487,217,5,1,1,1,477,477,476,476
San Mateo,15,2022-03-28,582,582,564,18,33959,33978,32902,1076,26,3,3,3,701,701,698,698
Santa Barbara,15,2022-03-28,135,135,129,6,10222,10228,9797,431,15,1,1,4,687,687,686,686
Santa Clara,15,2022-03-28,1275,1275,1256,19,95189,95238,93785,1453,88,10,10,18,2296,2296,2286,2286
Santa Cruz,15,2022-03-28,145,145,140,5,19692,19702,18985,717,3,0,0,2,259,259,259,259
Shasta,15,2022-03-28,34,34,32,2,3879,3880,3707,173,7,2,2,3,558,558,556,556
Siskiyou,15,2022-03-28,5,5,5,0,292,292,282,10,0,0,0,0,83,83,83,83
Solano,15,2022-03-28,169,169,162,7,10957,10962,10504,458,18,0,0,6,448,448,448,448
Sonoma,15,2022-03-28,259,259,249,10,8553,8558,8211,347,13,0,0,1,489,489,489,489
Stanislaus,15,2022-03-28,119,119,111,8,8184,8189,7670,519,28,2,2,3,1687,1687,1685,1685
Sutter,15,2022-03-28,25,25,24,1,1490,1490,1426,64,0,1,1,0,224,224,223,223
Tehama,15,2022-03-28,13,13,12,1,798,798,749,49,3,1,1,0,206,206,205,205
Trinity,15,2022-03-28,0,0,0,0,79,79,74,5,0,0,0,0,20,20,20,20
Tulare,15,2022-03-28,81,81,76,5,7838,7843,7335,508,20,6,6,1,1488,1488,1482,1482
Tuolumne,15,2022-03-28,7,7,7,0,1083,1083,1026,57,3,1,1,0,182,182,181,181
Ventura,15,2022-03-28,335,335,325,10,21204,21216,20601,615,23,6,6,3,1495,1495,1489,1489
Yolo,15,2022-03-28,103,103,99,4,20514,20526,19762,764,3,2,2,0,361,361,359,359
Yuba,15,2022-03-28,26,26,25,1,1214,1214,1165,49,2,2,2,1,119,119,117,117
Alameda,16,2022-04-04,1055,1055,1028,27,56224,56257,54762,1495,40,3,3,3,1868,1868,1865,1865
Amador,16,2022-04-04,2,2,2,0,1107,1107,1060,47,1,0,0,0,86,86,86,86
Butte,16,2022-04-04,44,44,43,1,2582,2582,2526,56,8,2,2,1,429,429,427,427
Calaveras,16,2022-04-04,8,8,8,0,589,589,567,22,0,0,0,0,119,119,119,119
Colusa,16,2022-04-04,2,2,2,0,202,202,196,6,0,0,0,0,21,21,21,21
Contra Costa,16,2022-04-04,544,544,520,24,23559,23574,22538,1036,13,1,1,4,1300,1300,1299,1299
Del Norte,16,2022-04-04,8,8,8,0,1118,1118,1080,38,0,0,0,1,49,49,49,49
El Dorado,16,2022-04-04,50,50,48,2,2717,2717,2617,100,0,1,1,1,214,214,213,213
Fresno,16,2022-04-04,188,188,180,8,16848,16859,16163,696,62,4,4,12,2755,2755,2751,2751
Glenn,16,2022-04-04,3,3,3,0,287,287,277,10,0,0,0,0,53,53,53,53
Humboldt,16,2022-04-04,23,23,22,1,2385,2385,2303,82,5,0,0,2,145,145,145,145
Imperial,16,2022-04-04,39,39,37,2,3451,3452,3323,129,3,0,0,2,944,944,944,944
Inyo,16,2022-04-04,9,9,9,0,182,182,176,6,0,0,0,0,56,56,56,56
Kern,16,2022-04-04,152,152,147,5,16751,16760,16245,515,16,2,2,7,2341,2341,2339,2339
Kings,16,2022-04-04,47,47,45,2,4178,4180,4024,156,2,0,0,1,448,448,448,448
Lake,16,2022-04-04,14,14,13,1,973,973,931,42,0,0,0,0,139,139,139,139
Lassen,16,2022-04-04,5,5,5,0,1284,1284,1247,37,0,0,0,0,62,62,62,62
Los Angeles,16,2022-04-04,5460,5461,5404,57,803344,803826,795213,8613,255,47,47,42,31796,31796,31749,31749
Madera,16,2022-04-04,27,27,26,1,3190,3190,3057,133,3,0,0,1,370,370,370,370
Marin,16,2022-04-04,167,167,160,7,6346,6351,6093,258,3,0,0,1,295,295,295,295
Mariposa,16,2022-04-04,7,7,7,0,235,235,225,10,0,0,0,0,28,28,28,28
Mendocino,16,2022-04-04,25,25,24,1,1196,1196,1130,66,2,0,0,0,124,124,124,124
Merced,16,2022-04-04,58,58,56,2,3350,3351,3244,107,2,2,2,0,818,818,816,816
Modoc,16,2022-04-04,4,4,4,0,43,43,42,1,0,0,0,0,7,7,7,7
Mono,16,2022-04-04,1,1,1,0,142,142,133,9,0,0,0,0,6,6,6,6
Monterey,16,2022-04-04,128,128,120,8,7487,7492,7012,480,8,3,3,0,728,728,725,725
Napa,16,2022-04-04,75,75,73,2,3146,3147,3059,88,1,0,0,1,143,143,143,143
Nevada,16,2022-04-04,30,30,29,1,1447,1447,1388,59,1,1,1,0,128,128,127,127
Orange,16,2022-04-04,989,989,965,24,81527,81576,79543,2033,56,17,17,14,7097,7097,7080,7080
Placer,16,2022-04-04,129,129,123,6,6693,6698,6399,299,19,1,1,5,625,625,624,624
Plumas,16,2022-04-04,4,4,4,0,235,235,225,10,0,0,0,0,13,13,13,13
Riverside,16,2022-04-04,692,692,670,22,38908,38932,37658,1274,36,5,5,8,6447,6447,6442,6442
Sacramento,16,2022-04-04,430,430,415,15,32890,32910,31754,1156,50,8,8,11,3044,3044,3036,3036
San Benito,16,2022-04-04,13,13,13,0,1187,1187,1153,34,0,0,0,0,94,94,94,94
San Bernardino,16,2022-04-04,613,613,597,16,42053,42078,40959,1119,32,11,11,13,7804,7804,7793,7793
San Diego,16,2022-04-04,1548,1548,1531,17,66684,66725,65981,744,88,7,7,29,5334,5334,5327,5327
San Francisco,16,2022-04-04,1001,1001,932,69,28766,28783,26772,2011,20,1,1,3,866,866,865,865
San Joaquin,16,2022-04-04,229,229,220,9,15715,15724,15119,605,9,2,2,8,2248,2248,2246,2246
San Luis Obispo,16,2022-04-04,99,99,96,3,5382,5386,5224,162,2,1,1,1,478,478,477,477
San Mateo,16,2022-04-04,724,724,706,18,29369,29386,28660,726,14,2,2,1,703,703,701,701
Santa Barbara,16,2022-04-04,188,188,182,6,15277,15285,14768,517,7,2,2,1,689,689,687,687
Santa Clara,16,2022-04-04,1492,1492,1474,18,88302,88355,87296,1059,89,2,2,18,2298,2298,2296,2296
Santa Cruz,16,2022-04-04,210,210,204,6,16701,16709,16219,490,4,0,0,2,259,259,259,259
Shasta,16,2022-04-04,29,29,28,1,3320,3321,3204,117,4,1,1,2,559,559,558,558
Siskiyou,16,2022-04-04,2,2,2,0,294,294,286,8,0,0,0,0,83,83,83,83
Solano,16,2022-04-04,173,173,167,6,10251,10257,9920,337,21,1,1,4,449,449,448,448
Sonoma,16,2022-04-04,330,330,320,10,10655,10660,10316,344,9,1,1,1,490,490,489,489
Stanislaus,16,2022-04-04,113,113,107,6,7960,7965,7567,398,21,3,3,5,1690,1690,1687,1687
Sutter,16,2022-04-04,24,24,23,1,1324,1324,1280,44,0,0,0,0,224,224,224,224
Tehama,16,2022-04-04,6,6,6,0,765,765,728,37,0,1,1,0,207,207,206,206
Trinity,16,2022-04-04,1,1,1,0,87,87,83,4,0,0,0,0,20,20,20,20
Tulare,16,2022-04-04,48,48,46,2,7740,7745,7349,396,13,3,3,0,1491,1491,1488,1488
Tuolumne,16,2022-04-04,10,10,10,0,1034,1034,991,43,1,1,1,0,183,183,182,182
Ventura,16,2022-04-04,298,298,291,7,20329,20342,19878,464,19,5,5,5,1500,1500,1495,1495
Yolo,16,2022-04-04,104,104,101,3,26255,26272,25485,787,0,0,0,0,361,361,361,361
Yuba,16,2022-04-04,11,11,11,0,1071,1071,1037,34,4,0,0,1,119,119,119,119
Alameda,17,2022-04-11,1494,1494,1464,30,49841,49876,48846,1030,51,6,6,2,1874,1874,1868,1868
Amador,17,2022-04-11,9,9,9,0,1068,1068,1032,36,1,0,0,0,86,86,86,86
Butte,17,2022-04-11,33,33,32,1,2262,2262,2224,38,3,0,0,1,429,429,429,429
Calaveras,17,2022-04-11,14,14,14,0,649,649,630,19,0,0,0,0,119,119,119,119
Colusa,17,2022-04-11,6,6,6,0,203,203,198,5,0,0,0,0,21,21,21,21
Contra Costa,17,2022-04-11,713,713,689,24,20839,20853,20143,710,15,1,1,5,1301,1301,1300,1300
Del Norte,17,2022-04-11,9,9,9,0,1012,1012,985,27,0,0,0,0,49,49,49,49
El Dorado,17,2022-04-11,48,48,47,1,2508,2508,2436,72,1,0,0,0,214,214,214,214
Fresno,17,2022-04-11,196,196,190,6,15778,15790,15275,515,54,3,3,6,2758,2758,2755,2755
Glenn,17,2022-04-11,2,2,2,0,258,258,251,7,0,0,0,0,53,53,53,53
Humboldt,17,2022-04-11,46,46,45,1,2347,2347,2284,63,5,1,1,2,146,146,145,145
Imperial,17,2022-04-11,28,28,27,1,3448,3449,3348,101,2,1,1,1,945,945,944,944
Inyo,17,2022-04-11,4,4,4,0,188,188,183,5,0,0,0,0,56,56,56,56
Kern,17,2022-04-11,135,135,132,3,16366,16378,15980,398,20,2,2,6,2343,2343,2341,2341
Kings,17,2022-04-11,31,31,30,1,4161,4165,4043,122,3,0,0,0,448,448,448,448
Lake,17,2022-04-11,22,22,21,1,869,869,840,29,0,0,0,0,139,139,139,139
Lassen,17,2022-04-11,1,1,1,0,1292,1292,1263,29,1,0,0,0,62,62,62,62
Los Angeles,17,2022-04-11,6734,6739,6684,55,675657,676124,670414,5710,234,46,46,36,31842,31842,31796,31796
Madera,17,2022-04-11,29,29,28,1,3076,3076,2975,101,4,0,0,2,370,370,370,370
Marin,17,2022-04-11,214,214,207,7,5555,5560,5384,176,6,0,0,1,295,295,295,295
Mariposa,17,2022-04-11,7,7,7,0,246,246,237,9,0,0,0,0,28,28,28,28
Mendocino,17,2022-04-11,32,32,31,1,1158,1158,1108,50,0,0,0,0,124,124,124,124
Merced,17,2022-04-11,69,69,67,2,3221,3222,3141,81,6,2,2,0,820,820,818,818
Modoc,17,2022-04-11,0,0,0,0,40,40,39,1,0,0,0,0,7,7,7,7
Mono,17,2022-04-11,9,9,9,0,170,170,161,9,0,0,0,0,6,6,6,6
Monterey,17,2022-04-11,109,109,103,6,6890,6895,6545,350,9,2,2,0,730,730,728,728
Napa,17,2022-04-11,120,120,117,3,2802,2802,2740,62,1,0,0,0,143,143,143,143
Nevada,17,2022-04-11,45,45,44,1,1431,1431,1385,46,2,0,0,0,128,128,128,128
Orange,17,2022-04-11,1164,1164,1142,22,62009,62052,60873,1179,70,9,9,16,7106,7106,7097,7097
Placer,17,2022-04-11,126,126,122,4,5632,5637,5438,199,18,2,2,2,627,627,625,625
Plumas,17,2022-04-11,7,7,7,0,247,247,239,8,0,0,0,0,13,13,13,13
Riverside,17,2022-04-11,728,728,710,18,37776,37804,36834,970,35,5,5,9,6452,6452,6447,6447
Sacramento,17,2022-04-11,508,508,494,14,30137,30157,29323,834,47,11,11,5,3055,3055,3044,3044
San Benito,17,2022-04-11,16,16,16,0,1182,1182,1155,27,0,0,0,0,94,94,94,94
San Bernardino,17,2022-04-11,914,914,895,19,42011,42040,41164,876,33,5,5,7,7809,7809,7804,7804
San Diego,17,2022-04-11,1833,1833,1817,16,74105,74157,73508,649,91,4,4,22,5338,5338,5334,5334
San Francisco,17,2022-04-11,1182,1182,1117,65,29897,29916,28259,1657,19,6,6,4,872,872,866,866
San Joaquin,17,2022-04-11,221,221,214,7,15242,15253,14791,462,10,0,0,1,2248,2248,2248,2248
San Luis Obispo,17,2022-04-11,120,120,117,3,4908,4912,4796,116,2,1,1,0,479,479,478,478
San Mateo,17,2022-04-11,858,858,842,16,30381,30401,29810,591,8,2,2,1,705,705,703,703
Santa Barbara,17,2022-04-11,303,303,295,8,15120,15130,14728,402,6,2,2,1,691,691,689,689
Santa Clara,17,2022-04-11,1662,1662,1647,15,81519,81575,80815,760,61,4,4,13,2302,2302,2298,2298
Santa Cruz,17,2022-04-11,327,327,320,7,10999,11006,10765,241,7,1,1,0,260,260,259,259
Shasta,17,2022-04-11,18,18,18,0,3123,3124,3037,87,2,1,1,1,560,560,559,559
Siskiyou,17,2022-04-11,1,1,1,0,340,340,332,8,0,0,0,0,83,83,83,83
Solano,17,2022-04-11,249,249,243,6,9441,9447,9203,244,16,0,0,1,449,449,449,449
Sonoma,17,2022-04-11,416,416,406,10,10688,10695,10424,271,8,1,1,0,491,491,490,490
Stanislaus,17,2022-04-11,124,124,119,5,7639,7644,7343,301,22,1,1,1,1691,1691,1690,1690
Sutter,17,2022-04-11,20,20,19,1,1237,1237,1204,33,0,1,1,0,225,225,224,224
Tehama,17,2022-04-11,9,9,9,0,753,753,724,29,1,0,0,0,207,207,207,207
Trinity,17,2022-04-11,0,0,0,0,77,77,74,3,0,0,0,0,20,20,20,20
Tulare,17,2022-04-11,58,58,56,2,7840,7845,7528,317,11,3,3,0,1494,1494,1491,1491
Tuolumne,17,2022-04-11,22,22,21,1,1062,1062,1027,35,1,0,0,0,183,183,183,183
Ventura,17,2022-04-11,323,323,317,6,17587,17599,17286,313,16,2,2,2,1502,1502,1500,1500
Yolo,17,2022-04-11,130,130,127,3,18074,18086,17666,420,1,0,0,0,361,361,361,361
Yuba,17,2022-04-11,15,15,15,0,1019,1019,994,25,2,0,0,0,119,119,119,119
Alameda,18,2022-04-18,1779,1779,1750,29,54177,54217,53335,882,42,4,4,4,1878,1878,1874,1874
Amador,18,2022-04-18,12,12,12,0,1194,1194,1162,32,2,0,0,0,86,86,86,86
Butte,18,2022-04-18,47,47,46,1,2268,2268,2238,30,5,2,2,0,431,431,429,429
Calaveras,18,2022-04-18,16,16,16,0,579,579,566,13,0,1,1,0,120,120,119,119
Colusa,18,2022-04-18,3,3,3,0,157,157,154,3,0,0,0,0,21,21,21,21
Contra Costa,18,2022-04-18,1050,1050,1022,28,24754,24773,24103,670,26,1,1,5,1302,1302,1301,1301
Del Norte,18,2022-04-18,13,13,13,0,1010,1010,989,21,0,0,0,0,49,49,49,49
El Dorado,18,2022-04-18,66,66,65,1,2455,2456,2401,55,0,0,0,0,214,214,214,214
Fresno,18,2022-04-18,247,247,241,6,13938,13949,13596,353,42,4,4,5,2762,2762,2758,2758
Glenn,18,2022-04-18,4,4,4,0,278,278,272,6,0,0,0,0,53,53,53,53
Humboldt,18,2022-04-18,107,107,105,2,2052,2052,2009,43,4,1,1,2,147,147,146,146
Imperial,18,2022-04-18,49,49,48,1,3219,3221,3147,74,2,0,0,1,945,945,945,945
Inyo,18,2022-04-18,2,2,2,0,164,164,161,3,0,0,0,0,56,56,56,56
Kern,18,2022-04-18,150,150,147,3,13634,13644,13387,257,9,1,1,5,2344,2344,2343,2343
Kings,18,2022-04-18,44,44,43,1,3580,3582,3500,82,3,1,1,1,449,449,448,448
Lake,18,2022-04-18,16,16,16,0,782,782,762,20,2,1,1,1,140,140,139,139
Lassen,18,2022-04-18,1,1,1,0,1340,1340,1316,24,0,0,0,0,62,62,62,62
Los Angeles,18,2022-04-18,8314,8322,8269,53,469196,469556,466582,2974,200,35,35,26,31877,31877,31842,31842
Madera,18,2022-04-18,23,23,22,1,2521,2521,2456,65,2,0,0,2,370,370,370,370
Marin,18,2022-04-18,322,322,314,8,5992,5997,5846,151,6,0,0,0,295,295,295,295
Mariposa,18,2022-04-18,18,18,18,0,248,248,241,7,0,0,0,0,28,28,28,28
Mendocino,18,2022-04-18,53,53,51,2,1285,1285,1241,44,0,1,1,0,125,125,124,124
Merced,18,2022-04-18,65,65,64,1,3047,3048,2988,60,3,2,2,0,822,822,820,820
Modoc,18,2022-04-18,1,1,1,0,40,40,39,1,0,0,0,0,7,7,7,7
Mono,18,2022-04-18,9,9,9,0,122,122,117,5,0,0,0,0,6,6,6,6
Monterey,18,2022-04-18,157,157,151,6,6522,6527,6268,259,2,1,1,0,731,731,730,730
Napa,18,2022-04-18,164,164,161,3,2860,2861,2812,49,1,0,0,0,143,143,143,143
Nevada,18,2022-04-18,41,41,40,1,1260,1260,1228,32,1,0,0,0,128,128,128,128
Orange,18,2022-04-18,1443,1443,1422,21,79760,79820,78611,1209,50,5,5,10,7111,7111,7106,7106
Placer,18,2022-04-18,161,161,157,4,4800,4805,4673,132,30,0,0,3,627,627,627,627
Plumas,18,2022-04-18,6,6,6,0,225,225,219,6,0,0,0,0,13,13,13,13
Riverside,18,2022-04-18,937,937,918,19,36721,36749,36008,741,36,7,7,7,6459,6459,6452,6452
Sacramento,18,2022-04-18,715,715,700,15,27855,27876,27275,601,47,9,9,8,3064,3064,3055,3055
San Benito,18,2022-04-18,24,24,24,0,1170,1170,1149,21,0,0,0,0,94,94,94,94
San Bernardino,18,2022-04-18,1059,1059,1042,17,40085,40115,39461,654,35,7,7,8,7816,7816,7809,7809
San Diego,18,2022-04-18,2047,2047,2033,14,67089,67139,66680,459,78,9,9,17,5347,5347,5338,5338
San Francisco,18,2022-04-18,1440,1440,1378,62,30566,30590,29252,1338,27,2,2,2,874,874,872,872
San Joaquin,18,2022-04-18,248,248,242,6,14745,14757,14406,351,8,1,1,4,2249,2249,2248,2248
San Luis Obispo,18,2022-04-18,180,180,177,3,4959,4963,4871,92,2,2,2,0,481,481,479,479
San Mateo,18,2022-04-18,1153,1153,1136,17,30636,30660,30196,464,15,2,2,2,707,707,705,705
Santa Barbara,18,2022-04-18,299,299,293,6,14686,14696,14390,306,8,0,0,0,691,691,691,691
Santa Clara,18,2022-04-18,2238,2238,2222,16,71271,71325,70804,521,67,4,4,16,2306,2306,2302,2302
Santa Cruz,18,2022-04-18,438,438,430,8,12234,12244,12029,215,3,0,0,1,260,260,260,260
Shasta,18,2022-04-18,33,33,32,1,2849,2850,2788,62,2,1,1,2,561,561,560,560
Siskiyou,18,2022-04-18,8,8,8,0,318,318,312,6,0,0,0,0,83,83,83,83
Solano,18,2022-04-18,254,254,249,5,9338,9345,9156,189,6,1,1,1,450,450,449,449
Sonoma,18,2022-04-18,502,502,492,10,11184,11191,10968,223,16,1,1,4,492,492,491,491
Stanislaus,18,2022-04-18,161,161,156,5,7667,7672,7433,239,15,0,0,3,1691,1691,1691,1691
Sutter,18,2022-04-18,24,24,24,0,1173,1173,1149,24,0,0,0,0,225,225,225,225
Tehama,18,2022-04-18,7,7,7,0,685,685,664,21,1,0,0,0,207,207,207,207
Trinity,18,2022-04-18,1,1,1,0,72,72,70,2,0,0,0,0,20,20,20,20
Tulare,18,2022-04-18,77,77,75,2,6660,6665,6454,211,13,0,0,0,1494,1494,1494,1494
Tuolumne,18,2022-04-18,26,26,25,1,1025,1025,999,26,1,0,0,0,183,183,183,183
Ventura,18,2022-04-18,367,367,362,5,16412,16424,16196,228,8,3,3,0,1505,1505,1502,1502
Yolo,18,2022-04-18,217,217,213,4,17916,17930,17601,329,2,1,1,0,362,362,361,361
Yuba,18,2022-04-18,28,28,27,1,996,996,977,19,1,0,0,1,119,119,119,119
Alameda,19,2022-04-25,2541,2542,2510,32,60892,60944,60176,768,44,6,6,4,1884,1884,1878,1878
Amador,19,2022-04-25,26,26,25,1,1316,1316,1289,27,0,0,0,0,86,86,86,86
Butte,19,2022-04-25,66,66,65,1,2597,2598,2571,27,5,1,1,1,432,432,431,431
Calaveras,19,2022-04-25,34,34,33,1,688,688,676,12,0,0,0,0,120,120,120,120
Colusa,19,2022-04-25,3,3,3,0,199,199,196,3,0,0,0,0,21,21,21,21
Contra Costa,19,2022-04-25,1508,1508,1476,32,27266,27287,26712,575,25,3,3,3,1305,1305,1302,1302
Del Norte,19,2022-04-25,25,25,25,0,1104,1104,1086,18,0,0,0,0,49,49,49,49
El Dorado,19,2022-04-25,103,103,101,2,2648,2649,2602,47,1,0,0,0,214,214,214,214
Fresno,19,2022-04-25,334,334,327,7,15893,15906,15589,317,34,3,3,2,2765,2765,2762,2762
Glenn,19,2022-04-25,4,4,4,0,287,287,282,5,0,0,0,0,53,53,53,53
Humboldt,19,2022-04-25,168,168,165,3,2853,2854,2807,47,2,0,0,2,147,147,147,147
Imperial,19,2022-04-25,65,65,64,1,3512,3514,3451,63,4,0,0,1,945,945,945,945
Inyo,19,2022-04-25,7,7,7,0,194,194,191,3,0,0,0,0,56,56,56,56
Kern,19,2022-04-25,251,251,247,4,18299,18315,18044,271,14,2,2,4,2346,2346,2344,2344
Kings,19,2022-04-25,54,54,53,1,4515,4519,4438,81,3,0,0,1,449,449,449,449
Lake,19,2022-04-25,21,21,21,0,887,887,869,18,0,0,0,0,140,140,140,140
Lassen,19,2022-04-25,1,1,1,0,1556,1556,1534,22,0,0,0,0,62,62,62,62
Los Angeles,19,2022-04-25,11367,11375,11318,57,884890,885637,881148,4489,207,29,29,25,31906,31906,31877,31877
Madera,19,2022-04-25,44,44,43,1,2916,2917,2858,59,2,0,0,0,370,370,370,370
Marin,19,2022-04-25,329,329,323,6,6440,6445,6319,126,7,0,0,0,295,295,295,295
Mariposa,19,2022-04-25,9,9,9,0,205,205,201,4,0,0,0,0,28,28,28,28
Mendocino,19,2022-04-25,55,55,54,1,1254,1254,1220,34,0,1,1,0,126,126,125,125
Merced,19,2022-04-25,99,99,98,1,3030,3031,2985,46,5,0,0,0,822,822,822,822
Modoc,19,2022-04-25,1,1,1,0,41,41,40,1,0,0,0,0,7,7,7,7
Mono,19,2022-04-25,4,4,4,0,94,94,91,3,0,0,0,0,6,6,6,6
Monterey,19,2022-04-25,322,322,312,10,8006,8012,7762,250,5,1,1,0,732,732,731,731
Napa,19,2022-04-25,199,199,196,3,3376,3378,3332,46,2,0,0,0,143,143,143,143
Nevada,19,2022-04-25,52,52,51,1,1399,1399,1371,28,1,0,0,1,128,128,128,128
Orange,19,2022-04-25,1969,1969,1946,23,86610,86683,85660,1023,53,7,7,13,7118,7118,7111,7111
Placer,19,2022-04-25,238,238,233,5,6091,6096,5964,132,18,0,0,4,627,627,627,627
Plumas,19,2022-04-25,2,2,2,0,228,228,223,5,0,0,0,0,13,13,13,13
Riverside,19,2022-04-25,1304,1304,1284,20,40534,40569,39929,640,33,4,4,5,6463,6463,6459,6459
Sacramento,19,2022-04-25,1023,1023,1006,17,31868,31894,31354,540,44,4,4,4,3068,3068,3064,3064
San Benito,19,2022-04-25,34,34,34,0,1118,1118,1102,16,0,0,0,0,94,94,94,94
San Bernardino,19,2022-04-25,1294,1294,1278,16,42974,43011,42463,548,21,10,10,7,7826,7826,7816,7816
San Diego,19,2022-04-25,3011,3012,2996,16,74322,74384,73988,396,86,5,5,10,5352,5352,5347,5347
San Francisco,19,2022-04-25,2001,2001,1933,68,32532,32560,31442,1118,23,1,1,3,875,875,874,874
San Joaquin,19,2022-04-25,387,387,380,7,15482,15496,15207,289,12,0,0,1,2249,2249,2249,2249
San Luis Obispo,19,2022-04-25,209,209,206,3,5036,5041,4968,73,6,0,0,0,481,481,481,481
San Mateo,19,2022-04-25,1538,1538,1520,18,32870,32898,32509,389,14,1,1,3,708,708,707,707
Santa Barbara,19,2022-04-25,371,371,365,6,15227,15240,14993,247,7,2,2,1,693,693,691,691
Santa Clara,19,2022-04-25,3142,3143,3125,18,77133,77199,76765,434,73,4,4,9,2310,2310,2306,2306
Santa Cruz,19,2022-04-25,474,474,468,6,20467,20484,20202,282,4,1,1,0,261,261,260,260
Shasta,19,2022-04-25,48,48,47,1,3317,3320,3264,56,3,0,0,1,561,561,561,561
Siskiyou,19,2022-04-25,7,7,7,0,322,322,318,4,0,0,0,0,83,83,83,83
Solano,19,2022-04-25,479,479,471,8,10655,10664,10495,169,11,0,0,2,450,450,450,450
Sonoma,19,2022-04-25,673,673,663,10,12065,12074,11886,188,19,0,0,2,492,492,492,492
Stanislaus,19,2022-04-25,241,241,235,6,7899,7906,7714,192,25,3,3,0,1694,1694,1691,1691
Sutter,19,2022-04-25,39,39,38,1,1399,1399,1376,23,0,1,1,0,226,226,225,225
Tehama,19,2022-04-25,17,17,17,0,711,711,694,17,1,0,0,0,207,207,207,207
Trinity,19,2022-04-25,1,1,1,0,72,72,70,2,0,0,0,0,20,20,20,20
Tulare,19,2022-04-25,91,91,89,2,6913,6918,6746,172,11,1,1,0,1495,1495,1494,1494
Tuolumne,19,2022-04-25,43,43,42,1,1124,1124,1101,23,2,0,0,0,183,183,183,183
Ventura,19,2022-04-25,604,604,597,7,18900,18917,18712,205,10,1,1,3,1506,1506,1505,1505
Yolo,19,2022-04-25,272,272,268,4,19381,19398,19120,278,1,0,0,0,362,362,362,362
Yuba,19,2022-04-25,31,31,31,0,1106,1106,1089,17,0,0,0,0,119,119,119,119
Alameda,20,2022-05-02,3376,3377,3344,33,68023,68088,67411,677,42,2,2,5,1886,1886,1884,1884
Amador,20,2022-05-02,19,19,19,0,1335,1335,1313,22,0,0,0,0,86,86,86,86
Butte,20,2022-05-02,91,91,90,1,2385,2386,2367,19,4,2,2,0,434,434,432,432
Calaveras,20,2022-05-02,23,23,23,0,727,727,717,10,0,0,0,0,120,120,120,120
Colusa,20,2022-05-02,2,2,2,0,203,203,201,2,0,0,0,0,21,21,21,21
Contra Costa,20,2022-05-02,1881,1881,1850,31,29265,29292,28808,484,40,2,2,5,1307,1307,1305,1305
Del Norte,20,2022-05-02,40,40,39,1,1202,1202,1187,15,1,0,0,0,49,49,49,49
El Dorado,20,2022-05-02,140,140,138,2,2756,2758,2720,38,1,1,1,0,215,215,214,214
Fresno,20,2022-05-02,503,503,495,8,16710,16727,16466,261,42,3,3,4,2768,2768,2765,2765
Glenn,20,2022-05-02,4,4,4,0,252,252,249,3,0,0,0,0,53,53,53,53
Humboldt,20,2022-05-02,269,269,266,3,2941,2943,2905,38,6,0,0,2,147,147,147,147
Imperial,20,2022-05-02,123,123,121,2,3645,3648,3596,52,1,0,0,1,945,945,945,945
Inyo,20,2022-05-02,2,2,2,0,179,179,177,2,0,0,0,0,56,56,56,56
Kern,20,2022-05-02,293,293,290,3,17932,17949,17741,208,10,0,0,5,2346,2346,2346,2346
Kings,20,2022-05-02,58,58,57,1,4847,4852,4784,68,3,0,0,1,449,449,449,449
Lake,20,2022-05-02,29,29,29,0,1003,1003,987,16,1,0,0,0,140,140,140,140
Lassen,20,2022-05-02,8,8,8,0,1608,1608,1590,18,0,0,0,0,62,62,62,62
Los Angeles,20,2022-05-02,14803,14816,14758,58,917589,918463,914818,3645,214,23,23,22,31929,31929,31906,31906
Madera,20,2022-05-02,75,75,74,1,3307,3311,3259,52,5,0,0,0,370,370,370,370
Marin,20,2022-05-02,427,427,421,6,6544,6550,6450,100,10,0,0,0,295,295,295,295
Mariposa,20,2022-05-02,7,7,7,0,244,244,240,4,0,0,0,0,28,28,28,28
Mendocino,20,2022-05-02,60,60,59,1,1222,1222,1196,26,0,0,0,0,126,126,126,126
Merced,20,2022-05-02,130,130,128,2,3283,3285,3246,39,8,4,4,0,826,826,822,822
Modoc,20,2022-05-02,0,0,0,0,36,37,36,1,0,0,0,0,7,7,7,7
Mono,20,2022-05-02,6,6,6,0,106,106,103,3,0,0,0,0,6,6,6,6
Monterey,20,2022-05-02,356,356,347,9,8386,8392,8186,206,8,1,1,0,733,733,732,732
Napa,20,2022-05-02,228,228,226,2,3547,3552,3514,38,4,0,0,0,143,143,143,143
Nevada,20,2022-05-02,80,80,79,1,1535,1535,1511,24,2,0,0,0,128,128,128,128
Orange,20,2022-05-02,2638,2639,2615,24,87485,87568,86759,809,61,5,5,13,7123,7123,7118,7118
Placer,20,2022-05-02,306,306,301,5,6373,6379,6271,108,20,0,0,4,627,627,627,627
Plumas,20,2022-05-02,9,9,9,0,256,256,252,4,0,0,0,0,13,13,13,13
Riverside,20,2022-05-02,2050,2050,2025,25,42958,42999,42469,530,37,3,3,5,6466,6466,6463,6463
Sacramento,20,2022-05-02,1392,1392,1374,18,33656,33688,33244,444,43,5,5,9,3073,3073,3068,3068
San Benito,20,2022-05-02,50,50,49,1,1285,1285,1271,14,0,0,0,0,94,94,94,94
San Bernardino,20,2022-05-02,1489,1489,1474,15,43530,43570,43136,434,30,7,7,6,7833,7833,7826,7826
San Diego,20,2022-05-02,4122,4127,4110,17,72928,72998,72696,302,79,3,3,13,5355,5355,5352,5352
San Francisco,20,2022-05-02,2424,2425,2360,65,35539,35572,34612,960,39,3,3,13,878,878,875,875
San Joaquin,20,2022-05-02,547,547,539,8,15216,15231,15009,222,14,1,1,1,2250,2250,2249,2249
San Luis Obispo,20,2022-05-02,249,249,246,3,5109,5114,5056,58,5,2,2,0,483,483,481,481
San Mateo,20,2022-05-02,1820,1820,1803,17,35990,36025,35691,334,22,2,2,5,710,710,708,708
Santa Barbara,20,2022-05-02,440,440,435,5,15309,15324,15129,195,10,0,0,2,693,693,693,693
Santa Clara,20,2022-05-02,4358,4364,4345,19,96570,96662,96233,429,88,5,5,15,2315,2315,2310,2310
Santa Cruz,20,2022-05-02,678,678,671,7,22027,22048,21810,238,2,1,1,0,262,262,261,261
Shasta,20,2022-05-02,68,68,67,1,3451,3454,3408,46,7,0,0,1,561,561,561,561
Siskiyou,20,2022-05-02,9,9,9,0,329,329,326,3,0,0,0,0,83,83,83,83
Solano,20,2022-05-02,624,624,616,8,11789,11801,11655,146,20,0,0,2,450,450,450,450
Sonoma,20,2022-05-02,898,898,887,11,12794,12807,12652,155,16,1,1,4,493,493,492,492
Stanislaus,20,2022-05-02,269,269,264,5,8083,8091,7937,154,22,0,0,3,1694,1694,1694,1694
Sutter,20,2022-05-02,47,47,46,1,1263,1263,1247,16,0,1,1,0,227,227,226,226
Tehama,20,2022-05-02,17,17,17,0,700,700,687,13,0,0,0,0,207,207,207,207
Trinity,20,2022-05-02,1,1,1,0,84,84,82,2,0,0,0,0,20,20,20,20
Tulare,20,2022-05-02,163,163,160,3,7286,7292,7150,142,10,3,3,0,1498,1498,1495,1495
Tuolumne,20,2022-05-02,93,93,92,1,1297,1297,1277,20,5,0,0,0,183,183,183,183
Ventura,20,2022-05-02,744,744,738,6,19921,19940,19771,169,15,4,4,1,1510,1510,1506,1506
Yolo,20,2022-05-02,352,352,348,4,18791,18808,18597,211,1,1,1,0,363,363,362,362
Yuba,20,2022-05-02,46,46,45,1,1052,1052,1040,12,2,0,0,1,119,119,119,119
Alameda,21,2022-05-09,4153,4158,4126,32,71485,71559,71004,555,44,7,7,6,1893,1893,1886,1886
Amador,21,2022-05-09,25,25,25,0,1518,1518,1499,19,0,0,0,0,86,86,86,86
Butte,21,2022-05-09,115,115,114,1,2412,2413,2398,15,5,0,0,0,434,434,434,434
Calaveras,21,2022-05-09,33,33,33,0,689,689,681,8,1,0,0,0,120,120,120,120
Colusa,21,2022-05-09,3,3,3,0,215,215,213,2,0,0,0,0,21,21,21,21
Contra Costa,21,2022-05-09,2516,2517,2485,32,30523,30555,30160,395,48,4,4,12,1311,1311,1307,1307
Del Norte,21,2022-05-09,49,49,49,0,1358,1358,1344,14,0,0,0,0,49,49,49,49
El Dorado,21,2022-05-09,179,179,177,2,2889,2892,2861,31,3,0,0,1,215,215,215,215
Fresno,21,2022-05-09,745,745,736,9,17853,17871,17653,218,29,1,1,1,2769,2769,2768,2768
Glenn,21,2022-05-09,8,8,8,0,228,228,226,2,0,0,0,0,53,53,53,53
Humboldt,21,2022-05-09,274,274,271,3,3149,3154,3122,32,5,0,0,2,147,147,147,147
Imperial,21,2022-05-09,131,131,130,1,3827,3831,3789,42,0,0,0,1,945,945,945,945
Inyo,21,2022-05-09,26,26,26,0,236,236,234,2,0,0,0,0,56,56,56,56
Kern,21,2022-05-09,467,467,463,4,18697,18717,18548,169,18,2,2,2,2348,2348,2346,2346
Kings,21,2022-05-09,91,91,90,1,4936,4941,4887,54,1,0,0,1,449,449,449,449
Lake,21,2022-05-09,30,30,30,0,1029,1029,1016,13,1,0,0,0,140,140,140,140
Lassen,21,2022-05-09,6,6,6,0,1689,1689,1675,14,0,0,0,0,62,62,62,62
Los Angeles,21,2022-05-09,18423,18443,18387,56,926865,927832,924965,2867,225,29,29,27,31958,31958,31929,31929
Madera,21,2022-05-09,132,132,130,2,3725,3729,3683,46,3,0,0,0,370,370,370,370
Marin,21,2022-05-09,711,711,703,8,7781,7789,7696,93,12,0,0,0,295,295,295,295
Mariposa,21,2022-05-09,32,32,32,0,287,287,283,4,0,0,0,0,28,28,28,28
Mendocino,21,2022-05-09,92,92,91,1,1264,1264,1243,21,0,1,1,0,127,127,126,126
Merced,21,2022-05-09,198,198,196,2,3431,3436,3404,32,4,1,1,0,827,827,826,826
Modoc,21,2022-05-09,2,2,2,0,41,42,41,1,0,0,0,0,7,7,7,7
Mono,21,2022-05-09,9,9,9,0,113,113,111,2,0,0,0,0,6,6,6,6
Monterey,21,2022-05-09,441,441,433,8,9377,9386,9205,181,11,0,0,0,733,733,733,733
Napa,21,2022-05-09,233,233,231,2,3121,3126,3100,26,2,0,0,0,143,143,143,143
Nevada,21,2022-05-09,102,102,101,1,1655,1655,1635,20,5,0,0,0,128,128,128,128
Orange,21,2022-05-09,3516,3521,3496,25,91769,91865,91202,663,84,8,8,17,7131,7131,7123,7123
Placer,21,2022-05-09,537,537,530,7,6752,6758,6668,90,25,0,0,2,627,627,627,627
Plumas,21,2022-05-09,13,13,13,0,274,274,271,3,0,0,0,0,13,13,13,13
Riverside,21,2022-05-09,2400,2401,2378,23,45141,45189,44753,436,42,4,4,8,6470,6470,6466,6466
Sacramento,21,2022-05-09,2261,2262,2239,23,36120,36158,35784,374,62,4,4,10,3077,3077,3073,3073
San Benito,21,2022-05-09,74,74,73,1,1433,1433,1421,12,0,0,0,0,94,94,94,94
San Bernardino,21,2022-05-09,1933,1933,1918,15,46593,46642,46279,363,31,5,5,4,7838,7838,7833,7833
San Diego,21,2022-05-09,5217,5224,5207,17,87126,87217,86933,284,98,2,2,11,5357,5357,5355,5355
San Francisco,21,2022-05-09,3048,3049,2985,64,38186,38226,37417,809,52,6,6,9,884,884,878,878
San Joaquin,21,2022-05-09,773,773,764,9,16059,16075,15892,183,11,1,1,3,2251,2251,2250,2250
San Luis Obispo,21,2022-05-09,289,289,286,3,5221,5226,5180,46,0,0,0,0,483,483,483,483
San Mateo,21,2022-05-09,2315,2316,2300,16,37695,37734,37461,273,26,3,3,1,713,713,710,710
Santa Barbara,21,2022-05-09,638,638,632,6,15589,15606,15451,155,10,0,0,3,693,693,693,693
Santa Clara,21,2022-05-09,5623,5630,5611,19,106179,106289,105921,368,87,3,3,23,2318,2318,2315,2315
Santa Cruz,21,2022-05-09,729,729,723,6,23980,24006,23804,202,2,0,0,0,262,262,262,262
Shasta,21,2022-05-09,106,106,105,1,3301,3304,3270,34,7,0,0,0,561,561,561,561
Siskiyou,21,2022-05-09,16,16,16,0,285,285,283,2,0,0,0,0,83,83,83,83
Solano,21,2022-05-09,920,920,911,9,12322,12334,12214,120,20,0,0,1,450,450,450,450
Sonoma,21,2022-05-09,1179,1179,1168,11,13977,13991,13858,133,18,1,1,2,494,494,493,493
Stanislaus,21,2022-05-09,460,460,453,7,8942,8951,8817,134,27,0,0,2,1694,1694,1694,1694
Sutter,21,2022-05-09,61,61,60,1,1565,1565,1549,16,0,0,0,0,227,227,227,227
Tehama,21,2022-05-09,28,28,28,0,692,692,682,10,1,0,0,0,207,207,207,207
Trinity,21,2022-05-09,4,4,4,0,69,69,68,1,0,0,0,0,20,20,20,20
Tulare,21,2022-05-09,183,183,180,3,7633,7640,7524,116,11,1,1,1,1499,1499,1498,1498
Tuolumne,21,2022-05-09,71,71,70,1,1429,1429,1412,17,1,2,2,0,185,185,183,183
Ventura,21,2022-05-09,1151,1151,1143,8,20949,20970,20831,139,15,1,1,2,1511,1511,1510,1510
Yolo,21,2022-05-09,493,493,489,4,19656,19676,19503,173,1,0,0,1,363,363,363,363
Yuba,21,2022-05-09,77,77,76,1,1241,1241,1229,12,2,0,0,0,119,119,119,119
Alameda,22,2022-05-16,4995,5001,4971,30,75024,75108,74653,455,73,8,8,6,1901,1901,1893,1893
Amador,22,2022-05-16,54,54,53,1,1672,1672,1655,17,0,0,0,0,86,86,86,86
Butte,22,2022-05-16,207,207,206,1,2664,2667,2654,13,7,2,2,0,436,436,434,434
Calaveras,22,2022-05-16,43,43,43,0,765,765,758,7,0,1,1,1,121,121,120,120
Colusa,22,2022-05-16,7,7,7,0,217,217,215,2,0,0,0,0,21,21,21,21
Contra Costa,22,2022-05-16,3488,3493,3458,35,33517,33553,33214,339,50,5,5,7,1316,1316,1311,1311
Del Norte,22,2022-05-16,174,174,173,1,1859,1860,1845,15,0,0,0,0,49,49,49,49
El Dorado,22,2022-05-16,266,266,264,2,3039,3043,3017,26,5,0,0,1,215,215,215,215
Fresno,22,2022-05-16,1140,1140,1129,11,19033,19054,18873,181,46,2,2,6,2771,2771,2769,2769
Glenn,22,2022-05-16,15,15,15,0,259,259,257,2,0,0,0,0,53,53,53,53
Humboldt,22,2022-05-16,275,275,273,2,3253,3258,3232,26,9,1,1,2,148,148,147,147
Imperial,22,2022-05-16,207,207,205,2,4276,4281,4244,37,1,0,0,1,945,945,945,945
Inyo,22,2022-05-16,19,19,19,0,228,228,226,2,1,0,0,0,56,56,56,56
Kern,22,2022-05-16,687,687,682,5,19978,19999,19858,141,22,3,3,3,2351,2351,2348,2348
Kings,22,2022-05-16,220,220,218,2,5418,5423,5377,46,0,1,1,0,450,450,449,449
Lake,22,2022-05-16,74,74,73,1,1118,1118,1107,11,2,0,0,0,140,140,140,140
Lassen,22,2022-05-16,20,20,20,0,1704,1704,1693,11,1,0,0,0,62,62,62,62
Los Angeles,22,2022-05-16,21414,21438,21387,51,938055,939094,936831,2263,283,39,39,44,31997,31997,31958,31958
Madera,22,2022-05-16,199,199,197,2,3632,3637,3602,35,2,0,0,0,370,370,370,370
Marin,22,2022-05-16,816,816,808,8,8391,8402,8323,79,12,0,0,0,295,295,295,295
Mariposa,22,2022-05-16,23,23,23,0,340,340,336,4,0,0,0,0,28,28,28,28
Mendocino,22,2022-05-16,99,99,98,1,1326,1326,1309,17,0,1,1,1,128,128,127,127
Merced,22,2022-05-16,314,314,312,2,4010,4015,3986,29,8,1,1,1,828,828,827,827
Modoc,22,2022-05-16,4,4,4,0,43,44,43,1,0,0,0,0,7,7,7,7
Mono,22,2022-05-16,11,11,11,0,112,112,110,2,0,0,0,0,6,6,6,6
Monterey,22,2022-05-16,509,509,501,8,9600,9612,9467,145,6,1,1,0,734,734,733,733
Napa,22,2022-05-16,299,299,297,2,3740,3745,3721,24,3,0,0,0,143,143,143,143
Nevada,22,2022-05-16,146,146,145,1,1834,1834,1817,17,2,0,0,0,128,128,128,128
Orange,22,2022-05-16,4549,4555,4530,25,94622,94726,94193,533,74,7,7,15,7138,7138,7131,7131
Placer,22,2022-05-16,742,742,734,8,7777,7784,7703,81,43,2,2,3,629,629,627,627
Plumas,22,2022-05-16,48,48,48,0,242,242,240,2,1,0,0,0,13,13,13,13
Riverside,22,2022-05-16,3344,3347,3322,25,47984,48036,47675,361,65,1,1,6,6471,6471,6470,6470
Sacramento,22,2022-05-16,3139,3142,3117,25,39840,39885,39563,322,89,8,8,12,3085,3085,3077,3077
San Benito,22,2022-05-16,110,110,109,1,1529,1529,1519,10,1,0,0,0,94,94,94,94
San Bernardino,22,2022-05-16,2471,2472,2457,15,49169,49223,48924,299,44,8,8,5,7846,7846,7838,7838
San Diego,22,2022-05-16,6664,6672,6655,17,94782,94888,94648,240,91,6,6,25,5363,5363,5357,5357
San Francisco,22,2022-05-16,3413,3417,3361,56,39359,39403,38750,653,68,5,5,8,889,889,884,884
San Joaquin,22,2022-05-16,1201,1201,1190,11,19015,19036,18867,169,16,1,1,1,2252,2252,2251,2251
San Luis Obispo,22,2022-05-16,425,425,422,3,6056,6062,6020,42,3,0,0,0,483,483,483,483
San Mateo,22,2022-05-16,2776,2777,2762,15,39916,39961,39736,225,39,1,1,1,714,714,713,713
Santa Barbara,22,2022-05-16,912,912,905,7,17041,17059,16927,132,13,0,0,2,693,693,693,693
Santa Clara,22,2022-05-16,7203,7211,7192,19,113211,113336,113030,306,111,9,9,15,2327,2327,2318,2318
Santa Cruz,22,2022-05-16,808,808,803,5,20748,20770,20630,140,5,0,0,0,262,262,262,262
Shasta,22,2022-05-16,126,126,125,1,3812,3816,3785,31,6,0,0,1,561,561,561,561
Siskiyou,22,2022-05-16,19,19,19,0,372,372,370,2,0,0,0,0,83,83,83,83
Solano,22,2022-05-16,1279,1279,1269,10,14209,14226,14118,108,29,0,0,2,450,450,450,450
Sonoma,22,2022-05-16,1570,1570,1559,11,15543,15560,15445,115,28,0,0,4,494,494,494,494
Stanislaus,22,2022-05-16,748,748,739,9,9951,9963,9847,116,33,2,2,5,1696,1696,1694,1694
Sutter,22,2022-05-16,109,109,108,1,1828,1828,1814,14,0,0,0,0,227,227,227,227
Tehama,22,2022-05-16,38,38,38,0,840,840,831,9,0,1,1,1,208,208,207,207
Trinity,22,2022-05-16,5,5,5,0,69,69,68,1,0,0,0,0,20,20,20,20
Tulare,22,2022-05-16,398,398,393,5,8314,8323,8224,99,14,1,1,0,1500,1500,1499,1499
Tuolumne,22,2022-05-16,139,139,138,1,1448,1448,1434,14,1,1,1,0,186,186,185,185
Ventura,22,2022-05-16,1552,1552,1544,8,23859,23886,23762,124,34,2,2,2,1513,1513,1511,1511
Yolo,22,2022-05-16,688,688,683,5,22152,22176,22024,152,0,0,0,1,363,363,363,363
Yuba,22,2022-05-16,119,119,118,1,1335,1335,1325,10,4,0,0,0,119,119,119,119
Alameda,23,2022-05-23,5604,5611,5585,26,77850,77941,77573,368,76,4,4,4,1905,1905,1901,1901
Amador,23,2022-05-23,80,80,79,1,1441,1441,1430,11,0,0,0,0,86,86,86,86
Butte,23,2022-05-23,284,284,283,1,2768,2771,2760,11,5,1,1,1,437,437,436,436
Calaveras,23,2022-05-23,52,52,52,0,744,744,739,5,0,1,1,0,122,122,121,121
Colusa,23,2022-05-23,7,7,7,0,232,232,231,1,0,0,0,0,21,21,21,21
Contra Costa,23,2022-05-23,3833,3838,3808,30,35373,35415,35135,280,71,10,10,7,1326,1326,1316,1316
Del Norte,23,2022-05-23,67,67,67,0,1346,1346,1338,8,0,1,1,0,50,50,49,49
El Dorado,23,2022-05-23,360,360,358,2,3419,3424,3401,23,6,2,2,0,217,217,215,215
Fresno,23,2022-05-23,1646,1646,1634,12,21382,21407,21248,159,63,2,2,8,2773,2773,2771,2771
Glenn,23,2022-05-23,26,26,26,0,273,273,271,2,0,0,0,0,53,53,53,53
Humboldt,23,2022-05-23,245,245,244,1,2911,2916,2898,18,14,1,1,3,149,149,148,148
Imperial,23,2022-05-23,343,343,341,2,4746,4751,4719,32,2,0,0,1,945,945,945,945
Inyo,23,2022-05-23,27,27,27,0,221,221,220,1,0,0,0,0,56,56,56,56
Kern,23,2022-05-23,1005,1005,1000,5,21275,21299,21182,117,34,0,0,7,2351,2351,2351,2351
Kings,23,2022-05-23,250,250,248,2,5644,5649,5611,38,1,0,0,0,450,450,450,450
Lake,23,2022-05-23,96,96,95,1,1238,1238,1228,10,1,0,0,1,140,140,140,140
Lassen,23,2022-05-23,41,41,41,0,1763,1764,1755,9,0,0,0,0,62,62,62,62
Los Angeles,23,2022-05-23,27738,27771,27719,52,946341,947451,945671,1780,366,31,31,53,32028,32028,31997,31997
Madera,23,2022-05-23,215,215,213,2,3764,3769,3740,29,1,0,0,2,370,370,370,370
Marin,23,2022-05-23,798,798,792,6,8785,8797,8733,64,15,0,0,1,295,295,295,295
Mariposa,23,2022-05-23,32,32,32,0,340,340,337,3,0,0,0,0,28,28,28,28
Mendocino,23,2022-05-23,150,150,149,1,1659,1659,1642,17,3,1,1,1,129,129,128,128
Merced,23,2022-05-23,409,409,407,2,4202,4207,4183,24,4,0,0,0,828,828,828,828
Modoc,23,2022-05-23,2,2,2,0,40,41,40,1,0,0,0,0,7,7,7,7
Mono,23,2022-05-23,14,14,14,0,163,163,161,2,0,0,0,0,6,6,6,6
Monterey,23,2022-05-23,701,701,693,8,9612,9624,9511,113,17,1,1,1,735,735,734,734
Napa,23,2022-05-23,332,332,330,2,3938,3943,3923,20,5,0,0,0,143,143,143,143
Nevada,23,2022-05-23,150,150,149,1,1904,1905,1891,14,2,0,0,0,128,128,128,128
Orange,23,2022-05-23,5577,5584,5560,24,94584,94694,94278,416,111,11,11,20,7149,7149,7138,7138
Placer,23,2022-05-23,887,887,880,7,7834,7842,7778,64,49,2,2,4,631,631,629,629
Plumas,23,2022-05-23,46,46,46,0,279,279,277,2,0,0,0,0,13,13,13,13
Riverside,23,2022-05-23,4452,4459,4433,26,52422,52484,52176,308,73,6,6,10,6477,6477,6471,6471
Sacramento,23,2022-05-23,3898,3903,3878,25,41040,41088,40828,260,122,7,7,10,3092,3092,3085,3085
San Benito,23,2022-05-23,168,168,167,1,1668,1668,1659,9,0,0,0,0,94,94,94,94
San Bernardino,23,2022-05-23,3320,3325,3309,16,50641,50700,50460,240,53,3,3,10,7849,7849,7846,7846
San Diego,23,2022-05-23,8837,8848,8831,17,103288,103409,103204,205,138,4,4,20,5367,5367,5363,5363
San Francisco,23,2022-05-23,3605,3610,3563,47,41637,41685,41144,541,85,6,6,9,895,895,889,889
San Joaquin,23,2022-05-23,1548,1548,1537,11,20968,20993,20847,146,20,3,3,7,2255,2255,2252,2252
San Luis Obispo,23,2022-05-23,670,670,666,4,7270,7279,7240,39,10,3,3,0,486,486,483,483
San Mateo,23,2022-05-23,3156,3161,3147,14,40829,40876,40696,180,35,0,0,0,714,714,714,714
Santa Barbara,23,2022-05-23,1064,1064,1058,6,17776,17797,17689,108,20,0,0,3,693,693,693,693
Santa Clara,23,2022-05-23,7828,7837,7821,16,111309,111440,111205,235,126,7,7,18,2334,2334,2327,2327
Santa Cruz,23,2022-05-23,505,505,502,3,7816,7824,7784,40,16,0,0,0,262,262,262,262
Shasta,23,2022-05-23,195,195,194,1,3606,3611,3588,23,4,1,1,3,562,562,561,561
Siskiyou,23,2022-05-23,29,29,29,0,364,364,362,2,1,0,0,0,83,83,83,83
Solano,23,2022-05-23,1511,1511,1502,9,14922,14940,14852,88,24,1,1,3,451,451,450,450
Sonoma,23,2022-05-23,1488,1488,1479,9,16334,16353,16258,95,34,2,2,3,496,496,494,494
Stanislaus,23,2022-05-23,872,872,864,8,10700,10714,10616,98,37,2,2,3,1698,1698,1696,1696
Sutter,23,2022-05-23,140,140,139,1,1912,1913,1902,11,0,1,1,0,228,228,227,227
Tehama,23,2022-05-23,50,50,50,0,812,812,805,7,1,0,0,1,208,208,208,208
Trinity,23,2022-05-23,3,3,3,0,90,90,89,1,0,0,0,0,20,20,20,20
Tulare,23,2022-05-23,560,560,555,5,9068,9079,8995,84,26,0,0,0,1500,1500,1500,1500
Tuolumne,23,2022-05-23,136,136,135,1,1576,1576,1564,12,0,1,1,0,187,187,186,186
Ventura,23,2022-05-23,1917,1917,1909,8,24017,24045,23948,97,36,1,1,1,1514,1514,1513,1513
Yolo,23,2022-05-23,731,731,727,4,22658,22685,22563,122,1,1,1,1,364,364,363,363
Yuba,23,2022-05-23,151,151,150,1,1453,1453,1445,8,6,0,0,1,119,119,119,119
Alameda,24,2022-05-30,4907,4913,4895,18,60785,60859,60629,230,95,4,4,7,1909,1909,1905,1905
Amador,24,2022-05-30,89,89,88,1,1191,1191,1184,7,0,1,1,0,87,87,86,86
Butte,24,2022-05-30,276,276,275,1,2709,2713,2705,8,20,0,0,1,437,437,437,437
Calaveras,24,2022-05-30,54,54,54,0,617,617,614,3,0,0,0,0,122,122,122,122
Colusa,24,2022-05-30,13,13,13,0,170,170,169,1,0,0,0,0,21,21,21,21
Contra Costa,24,2022-05-30,3318,3322,3301,21,28988,29024,28841,183,65,7,7,9,1333,1333,1326,1326
Del Norte,24,2022-05-30,36,36,36,0,975,975,970,5,2,1,1,0,51,51,50,50
El Dorado,24,2022-05-30,332,332,330,2,2940,2944,2928,16,6,2,2,2,219,219,217,217
Fresno,24,2022-05-30,1667,1667,1657,10,19525,19550,19434,116,71,6,6,7,2779,2779,2773,2773
Glenn,24,2022-05-30,27,27,27,0,290,290,289,1,2,0,0,0,53,53,53,53
Humboldt,24,2022-05-30,181,181,180,1,2296,2300,2289,11,10,0,0,5,149,149,149,149
Imperial,24,2022-05-30,332,332,330,2,4148,4153,4131,22,2,1,1,2,946,946,945,945
Inyo,24,2022-05-30,18,18,18,0,151,151,150,1,0,0,0,0,56,56,56,56
Kern,24,2022-05-30,1078,1078,1073,5,17987,18009,17930,79,36,0,0,6,2351,2351,2351,2351
Kings,24,2022-05-30,292,292,290,2,4664,4669,4644,25,2,0,0,1,450,450,450,450
Lake,24,2022-05-30,89,89,88,1,994,994,988,6,1,0,0,0,140,140,140,140
Lassen,24,2022-05-30,50,50,50,0,1615,1615,1608,7,1,0,0,0,62,62,62,62
Los Angeles,24,2022-05-30,26033,26065,26026,39,746741,747651,746524,1127,425,47,47,54,32075,32075,32028,32028
Madera,24,2022-05-30,235,235,234,1,3313,3317,3297,20,4,0,0,1,370,370,370,370
Marin,24,2022-05-30,650,650,646,4,7153,7163,7121,42,16,3,3,1,298,298,295,295
Mariposa,24,2022-05-30,39,39,39,0,303,303,301,2,0,0,0,0,28,28,28,28
Mendocino,24,2022-05-30,137,137,136,1,1264,1264,1254,10,4,0,0,1,129,129,129,129
Merced,24,2022-05-30,365,365,363,2,3407,3411,3395,16,6,0,0,2,828,828,828,828
Modoc,24,2022-05-30,4,4,4,0,38,39,38,1,0,0,0,0,7,7,7,7
Mono,24,2022-05-30,6,6,6,0,81,81,80,1,0,0,0,0,6,6,6,6
Monterey,24,2022-05-30,526,526,521,5,7149,7159,7092,67,19,1,1,1,736,736,735,735
Napa,24,2022-05-30,312,312,311,1,3180,3184,3171,13,4,0,0,0,143,143,143,143
Nevada,24,2022-05-30,181,181,180,1,1595,1596,1587,9,3,2,2,1,130,130,128,128
Orange,24,2022-05-30,5598,5605,5586,19,81970,82070,81783,287,122,12,12,18,7161,7161,7149,7149
Placer,24,2022-05-30,737,737,732,5,6133,6141,6101,40,52,0,0,8,631,631,631,631
Plumas,24,2022-05-30,35,35,35,0,200,200,199,1,1,0,0,0,13,13,13,13
Riverside,24,2022-05-30,3866,3871,3853,18,43863,43918,43713,205,82,3,3,10,6480,6480,6477,6477
Sacramento,24,2022-05-30,3845,3850,3831,19,33074,33114,32948,166,130,9,9,20,3101,3101,3092,3092
San Benito,24,2022-05-30,154,154,153,1,1276,1276,1271,5,0,0,0,0,94,94,94,94
San Bernardino,24,2022-05-30,3332,3336,3324,12,42867,42918,42757,161,49,5,5,10,7854,7854,7849,7849
San Diego,24,2022-05-30,8413,8424,8411,13,85853,85957,85822,135,153,10,10,26,5377,5377,5367,5367
San Francisco,24,2022-05-30,3134,3139,3107,32,33428,33468,33124,344,88,11,11,14,906,906,895,895
San Joaquin,24,2022-05-30,1398,1398,1390,8,17018,17038,16944,94,25,2,2,9,2257,2257,2255,2255
San Luis Obispo,24,2022-05-30,660,660,657,3,5437,5443,5420,23,12,1,1,0,487,487,486,486
San Mateo,24,2022-05-30,2752,2755,2745,10,31176,31214,31104,110,33,3,3,2,717,717,714,714
Santa Barbara,24,2022-05-30,1030,1030,1025,5,14449,14467,14397,70,23,2,2,5,695,695,693,693
Santa Clara,24,2022-05-30,7028,7037,7025,12,85313,85417,85274,143,154,10,10,22,2344,2344,2334,2334
Santa Cruz,24,2022-05-30,526,526,524,2,6255,6263,6237,26,7,1,1,1,263,263,262,262
Shasta,24,2022-05-30,133,133,132,1,2838,2841,2827,14,4,3,3,4,565,565,562,562
Siskiyou,24,2022-05-30,53,53,53,0,340,340,339,1,3,0,0,0,83,83,83,83
Solano,24,2022-05-30,1185,1185,1179,6,11566,11580,11525,55,28,0,0,7,451,451,451,451
Sonoma,24,2022-05-30,1198,1198,1193,5,13239,13256,13195,61,38,2,2,5,498,498,496,496
Stanislaus,24,2022-05-30,801,801,795,6,8585,8597,8535,62,55,2,2,3,1700,1700,1698,1698
Sutter,24,2022-05-30,158,158,157,1,1701,1702,1694,8,0,0,0,0,228,228,228,228
Tehama,24,2022-05-30,62,62,62,0,757,757,752,5,2,0,0,0,208,208,208,208
Trinity,24,2022-05-30,8,8,8,0,96,96,95,1,0,0,0,0,20,20,20,20
Tulare,24,2022-05-30,594,594,590,4,7483,7491,7435,56,19,0,0,0,1500,1500,1500,1500
Tuolumne,24,2022-05-30,121,121,120,1,1306,1306,1298,8,3,0,0,0,187,187,187,187
Ventura,24,2022-05-30,1681,1681,1676,5,19545,19570,19507,63,30,1,1,4,1515,1515,1514,1514
Yolo,24,2022-05-30,610,610,607,3,17639,17660,17585,75,4,0,0,1,364,364,364,364
Yuba,24,2022-05-30,144,144,143,1,1276,1276,1270,6,7,0,0,2,119,119,119,119
Alameda,25,2022-06-06,6487,6495,6476,19,73222,73315,73103,212,112,5,5,12,1914,1914,1909,1909
Amador,25,2022-06-06,114,114,113,1,1723,1723,1715,8,1,0,0,1,87,87,87,87
Butte,25,2022-06-06,453,453,452,1,3617,3622,3614,8,24,1,1,1,438,438,437,437
Calaveras,25,2022-06-06,73,73,73,0,737,737,734,3,0,2,2,0,124,124,122,122
Colusa,25,2022-06-06,22,22,22,0,276,276,275,1,3,0,0,0,21,21,21,21
Contra Costa,25,2022-06-06,4235,4240,4220,20,35705,35750,35576,174,107,9,9,7,1342,1342,1333,1333
Del Norte,25,2022-06-06,65,65,65,0,1134,1134,1130,4,2,0,0,0,51,51,51,51
El Dorado,25,2022-06-06,413,413,411,2,3637,3642,3627,15,5,0,0,5,219,219,219,219
Fresno,25,2022-06-06,2448,2451,2440,11,22694,22721,22617,104,94,2,2,6,2781,2781,2779,2779
Glenn,25,2022-06-06,41,41,41,0,325,325,324,1,3,0,0,0,53,53,53,53
Humboldt,25,2022-06-06,261,261,260,1,3054,3059,3048,11,14,1,1,3,150,150,149,149
Imperial,25,2022-06-06,466,466,464,2,4875,4880,4860,20,2,0,0,0,946,946,946,946
Inyo,25,2022-06-06,20,20,20,0,213,213,212,1,1,0,0,0,56,56,56,56
Kern,25,2022-06-06,1611,1611,1606,5,22977,23006,22928,78,35,1,1,6,2352,2352,2351,2351
Kings,25,2022-06-06,397,397,395,2,5504,5510,5487,23,10,0,0,1,450,450,450,450
Lake,25,2022-06-06,136,136,135,1,1180,1180,1174,6,5,0,0,2,140,140,140,140
Lassen,25,2022-06-06,69,69,69,0,2398,2400,2392,8,2,0,0,0,62,62,62,62
Los Angeles,25,2022-06-06,35093,35138,35098,40,1041664,1042971,1041768,1203,496,39,39,61,32114,32114,32075,32075
Madera,25,2022-06-06,353,353,351,2,4126,4131,4112,19,7,0,0,1,370,370,370,370
Marin,25,2022-06-06,739,739,736,3,7650,7660,7626,34,10,2,2,5,300,300,298,298
Mariposa,25,2022-06-06,57,57,57,0,403,403,401,2,0,0,0,0,28,28,28,28
Mendocino,25,2022-06-06,209,209,208,1,1711,1711,1700,11,9,1,1,2,130,130,129,129
Merced,25,2022-06-06,531,531,529,2,4529,4534,4518,16,16,0,0,0,828,828,828,828
Modoc,25,2022-06-06,11,11,11,0,37,38,37,1,0,0,0,0,7,7,7,7
Mono,25,2022-06-06,15,15,15,0,120,120,119,1,0,0,0,0,6,6,6,6
Monterey,25,2022-06-06,1001,1001,994,7,10243,10256,10181,75,17,2,2,1,738,738,736,736
Napa,25,2022-06-06,543,543,541,2,4232,4237,4224,13,8,1,1,0,144,144,143,143
Nevada,25,2022-06-06,246,246,245,1,2149,2152,2142,10,5,0,0,0,130,130,130,130
Orange,25,2022-06-06,7569,7580,7560,20,73558,73650,73453,197,140,12,12,18,7173,7173,7161,7161
Placer,25,2022-06-06,868,868,864,4,7604,7614,7576,38,65,0,0,11,631,631,631,631
Plumas,25,2022-06-06,40,40,40,0,321,321,320,1,0,0,0,0,13,13,13,13
Riverside,25,2022-06-06,5352,5359,5340,19,55968,56038,55837,201,88,6,6,10,6486,6486,6480,6480
Sacramento,25,2022-06-06,4951,4957,4938,19,42460,42513,42348,165,149,14,14,20,3115,3115,3101,3101
San Benito,25,2022-06-06,273,273,272,1,2016,2018,2012,6,0,0,0,1,94,94,94,94
San Bernardino,25,2022-06-06,5122,5129,5114,15,55836,55907,55745,162,77,7,7,14,7861,7861,7854,7854
San Diego,25,2022-06-06,10784,10797,10784,13,100449,100574,100452,122,185,8,8,22,5385,5385,5377,5377
San Francisco,25,2022-06-06,3525,3530,3502,28,38263,38312,38007,305,77,0,0,11,906,906,906,906
San Joaquin,25,2022-06-06,2132,2133,2124,9,22164,22192,22098,94,40,4,4,9,2261,2261,2257,2257
San Luis Obispo,25,2022-06-06,900,900,897,3,7531,7540,7515,25,16,1,1,1,488,488,487,487
San Mateo,25,2022-06-06,3212,3216,3207,9,37066,37113,37012,101,36,2,2,4,719,719,717,717
Santa Barbara,25,2022-06-06,1247,1247,1242,5,15068,15087,15031,56,22,1,1,5,696,696,695,695
Santa Clara,25,2022-06-06,8504,8514,8503,11,102647,102776,102644,132,176,6,6,22,2350,2350,2344,2344
Santa Cruz,25,2022-06-06,896,896,893,3,9720,9732,9702,30,24,1,1,3,264,264,263,263
Shasta,25,2022-06-06,208,208,207,1,4423,4429,4412,17,10,2,2,2,567,567,565,565
Siskiyou,25,2022-06-06,40,40,40,0,431,431,430,1,1,0,0,0,83,83,83,83
Solano,25,2022-06-06,1743,1743,1737,6,15186,15205,15150,55,29,2,2,1,453,453,451,451
Sonoma,25,2022-06-06,1635,1635,1629,6,13998,14016,13967,49,38,1,1,1,499,499,498,498
Stanislaus,25,2022-06-06,1183,1183,1176,7,10914,10928,10867,61,60,1,1,2,1701,1701,1700,1700
Sutter,25,2022-06-06,206,206,205,1,1941,1942,1935,7,0,0,0,0,228,228,228,228
Tehama,25,2022-06-06,83,83,83,0,1051,1051,1045,6,2,0,0,0,208,208,208,208
Trinity,25,2022-06-06,7,7,7,0,110,110,109,1,0,0,0,0,20,20,20,20
Tulare,25,2022-06-06,860,860,855,5,10775,10789,10728,61,24,0,0,0,1500,1500,1500,1500
Tuolumne,25,2022-06-06,124,124,123,1,1723,1725,1717,8,4,0,0,1,187,187,187,187
Ventura,25,2022-06-06,1973,1973,1968,5,24765,24796,24735,61,43,3,3,3,1518,1518,1515,1515
Yolo,25,2022-06-06,828,828,825,3,21441,21469,21399,70,2,1,1,0,365,365,364,364
Yuba,25,2022-06-06,186,186,185,1,1556,1556,1551,5,9,0,0,1,119,119,119,119
Alameda,26,2022-06-13,5082,5089,5078,11,55930,56003,55877,126,106,6,6,18,1920,1920,1914,1914
Amador,26,2022-06-13,131,131,131,0,1413,1413,1408,5,1,0,0,0,87,87,87,87
Butte,26,2022-06-13,394,394,393,1,3459,3464,3458,6,31,4,4,0,442,442,438,438
Calaveras,26,2022-06-13,69,69,69,0,658,658,656,2,0,0,0,0,124,124,124,124
Colusa,26,2022-06-13,12,12,12,0,328,328,327,1,17,0,0,0,21,21,21,21
Contra Costa,26,2022-06-13,3413,3418,3405,13,27983,28020,27914,106,89,8,8,12,1350,1350,1342,1342
Del Norte,26,2022-06-13,79,79,79,0,658,658,656,2,4,0,0,0,51,51,51,51
El Dorado,26,2022-06-13,324,324,323,1,3197,3202,3192,10,7,3,3,1,222,222,219,219
Fresno,26,2022-06-13,2397,2399,2391,8,20697,20725,20652,73,103,4,4,13,2785,2785,2781,2781
Glenn,26,2022-06-13,32,32,32,0,329,329,328,1,2,0,0,0,53,53,53,53
Humboldt,26,2022-06-13,262,262,261,1,2325,2329,2322,7,11,0,0,3,150,150,150,150
Imperial,26,2022-06-13,445,445,444,1,4530,4535,4521,14,6,1,1,0,947,947,946,946
Inyo,26,2022-06-13,13,13,13,0,189,189,188,1,0,0,0,0,56,56,56,56
Kern,26,2022-06-13,1565,1565,1561,4,21421,21448,21392,56,38,1,1,5,2353,2353,2352,2352
Kings,26,2022-06-13,356,356,355,1,5156,5161,5145,16,4,1,1,0,451,451,450,450
Lake,26,2022-06-13,138,138,137,1,1227,1227,1223,4,1,0,0,0,140,140,140,140
Lassen,26,2022-06-13,77,77,77,0,1994,1997,1992,5,2,0,0,0,62,62,62,62
Los Angeles,26,2022-06-13,29977,30017,29990,27,660451,661309,660710,599,519,54,54,60,32168,32168,32114,32114
Madera,26,2022-06-13,381,381,380,1,4230,4235,4220,15,7,0,0,2,370,370,370,370
Marin,26,2022-06-13,685,685,683,2,7040,7050,7025,25,16,2,2,2,302,302,300,300
Mariposa,26,2022-06-13,45,45,45,0,372,372,371,1,0,0,0,0,28,28,28,28
Mendocino,26,2022-06-13,161,161,160,1,1567,1567,1559,8,9,0,0,1,130,130,130,130
Merced,26,2022-06-13,561,561,559,2,4169,4174,4163,11,13,0,0,2,828,828,828,828
Modoc,26,2022-06-13,7,7,7,0,34,35,34,1,1,1,1,0,8,8,7,7
Mono,26,2022-06-13,19,19,19,0,92,92,91,1,0,0,0,0,6,6,6,6
Monterey,26,2022-06-13,839,839,834,5,8656,8668,8619,49,25,3,3,1,741,741,738,738
Napa,26,2022-06-13,433,433,432,1,3939,3944,3935,9,2,1,1,1,145,145,144,144
Nevada,26,2022-06-13,186,186,185,1,1874,1876,1869,7,8,0,0,0,130,130,130,130
Orange,26,2022-06-13,7000,7008,6994,14,65112,65196,65060,136,175,14,14,19,7187,7187,7173,7173
Placer,26,2022-06-13,789,789,786,3,6801,6810,6784,26,79,2,2,7,633,633,631,631
Plumas,26,2022-06-13,34,34,34,0,271,271,270,1,0,0,0,0,13,13,13,13
Riverside,26,2022-06-13,5041,5048,5034,14,47839,47902,47768,134,105,3,3,11,6489,6489,6486,6486
Sacramento,26,2022-06-13,4178,4184,4171,13,37535,37583,37470,113,190,12,12,20,3127,3127,3115,3115
San Benito,26,2022-06-13,200,200,200,0,1780,1781,1777,4,1,0,0,1,94,94,94,94
San Bernardino,26,2022-06-13,4667,4674,4664,10,48695,48758,48648,110,96,6,6,15,7867,7867,7861,7861
San Diego,26,2022-06-13,9616,9628,9619,9,84893,85004,84924,80,192,9,9,27,5394,5394,5385,5385
San Francisco,26,2022-06-13,3045,3050,3031,19,31136,31174,30981,193,72,11,11,13,917,917,906,906
San Joaquin,26,2022-06-13,1919,1919,1913,6,19010,19035,18972,63,32,5,5,3,2266,2266,2261,2261
San Luis Obispo,26,2022-06-13,661,661,659,2,6049,6056,6041,15,21,0,0,0,488,488,488,488
San Mateo,26,2022-06-13,2635,2640,2635,5,29173,29212,29151,61,44,3,3,3,722,722,719,719
Santa Barbara,26,2022-06-13,931,931,928,3,9475,9488,9461,27,15,1,1,5,697,697,696,696
Santa Clara,26,2022-06-13,7042,7051,7044,7,76835,76935,76858,77,182,13,13,23,2363,2363,2350,2350
Santa Cruz,26,2022-06-13,842,842,840,2,9962,9974,9950,24,23,0,0,1,264,264,264,264
Shasta,26,2022-06-13,220,220,219,1,3390,3395,3385,10,8,1,1,0,568,568,567,567
Siskiyou,26,2022-06-13,50,50,50,0,372,372,371,1,1,0,0,0,83,83,83,83
Solano,26,2022-06-13,1686,1686,1681,5,12902,12918,12882,36,33,0,0,2,453,453,453,453
Sonoma,26,2022-06-13,1336,1336,1332,4,11653,11668,11636,32,36,3,3,6,502,502,499,499
Stanislaus,26,2022-06-13,1132,1132,1127,5,9453,9466,9425,41,63,1,1,7,1702,1702,1701,1701
Sutter,26,2022-06-13,193,193,192,1,1721,1722,1717,5,0,0,0,0,228,228,228,228
Tehama,26,2022-06-13,88,88,88,0,967,967,963,4,3,0,0,0,208,208,208,208
Trinity,26,2022-06-13,11,11,11,0,84,85,84,1,0,0,0,0,20,20,20,20
Tulare,26,2022-06-13,822,822,818,4,9450,9463,9421,42,26,2,2,1,1502,1502,1500,1500
Tuolumne,26,2022-06-13,148,148,147,1,1445,1445,1440,5,2,0,0,0,187,187,187,187
Ventura,26,2022-06-13,1934,1934,1930,4,20979,21007,20967,40,38,3,3,5,1521,1521,1518,1518
Yolo,26,2022-06-13,767,767,765,2,14398,14416,14379,37,4,1,1,0,366,366,365,365
Yuba,26,2022-06-13,188,188,187,1,1420,1420,1416,4,8,0,0,1,119,119,119,119
Alameda,27,2022-06-20,4964,4971,4962,9,48648,48713,48628,85,105,12,12,14,1932,1932,1920,1920
Amador,27,2022-06-20,104,104,104,0,1247,1247,1243,4,2,0,0,0,87,87,87,87
Butte,27,2022-06-20,413,413,412,1,3559,3564,3559,5,28,4,4,1,446,446,442,442
Calaveras,27,2022-06-20,82,82,82,0,624,624,622,2,0,0,0,0,124,124,124,124
Colusa,27,2022-06-20,16,16,16,0,176,177,176,1,15,1,1,0,22,22,21,21
Contra Costa,27,2022-06-20,3341,3346,3336,10,26015,26051,25974,77,81,7,7,8,1357,1357,1350,1350
Del Norte,27,2022-06-20,82,82,82,0,611,611,610,1,3,1,1,1,52,52,51,51
El Dorado,27,2022-06-20,351,351,350,1,3074,3079,3071,8,5,2,2,1,224,224,222,222
Fresno,27,2022-06-20,2469,2473,2466,7,19498,19523,19469,54,100,2,2,16,2787,2787,2785,2785
Glenn,27,2022-06-20,41,41,41,0,314,314,313,1,3,0,0,0,53,53,53,53
Humboldt,27,2022-06-20,273,273,272,1,2273,2275,2270,5,11,0,0,3,150,150,150,150
Imperial,27,2022-06-20,602,602,601,1,3692,3697,3688,9,5,0,0,0,947,947,947,947
Inyo,27,2022-06-20,18,18,18,0,187,188,187,1,0,0,0,0,56,56,56,56
Kern,27,2022-06-20,1652,1652,1649,3,20130,20157,20116,41,39,5,5,9,2358,2358,2353,2353
Kings,27,2022-06-20,413,413,412,1,4866,4871,4859,12,6,1,1,0,452,452,451,451
Lake,27,2022-06-20,120,120,120,0,1237,1237,1233,4,1,0,0,2,140,140,140,140
Lassen,27,2022-06-20,43,43,43,0,1223,1224,1222,2,1,0,0,0,62,62,62,62
Los Angeles,27,2022-06-20,27522,27559,27540,19,351458,351928,351684,244,596,57,57,68,32225,32225,32168,32168
Madera,27,2022-06-20,338,338,337,1,4163,4167,4155,12,4,0,0,1,370,370,370,370
Marin,27,2022-06-20,693,693,691,2,6328,6337,6320,17,21,0,0,1,302,302,302,302
Mariposa,27,2022-06-20,53,53,53,0,335,335,334,1,0,0,0,0,28,28,28,28
Mendocino,27,2022-06-20,180,180,179,1,1580,1580,1574,6,3,0,0,0,130,130,130,130
Merced,27,2022-06-20,541,541,540,1,3955,3960,3952,8,7,3,3,1,831,831,828,828
Modoc,27,2022-06-20,5,5,5,0,37,38,37,1,0,0,0,0,8,8,8,8
Mono,27,2022-06-20,6,6,6,0,82,83,82,1,1,1,1,0,7,7,6,6
Monterey,27,2022-06-20,891,891,887,4,8906,8918,8879,39,38,1,1,2,742,742,741,741
Napa,27,2022-06-20,365,365,364,1,3129,3134,3128,6,3,1,1,0,146,146,145,145
Nevada,27,2022-06-20,170,170,170,0,1619,1620,1616,4,6,1,1,0,131,131,130,130
Orange,27,2022-06-20,6998,7007,6996,11,60425,60505,60407,98,152,10,10,23,7197,7197,7187,7187
Placer,27,2022-06-20,674,674,672,2,6053,6060,6042,18,69,1,1,7,634,634,633,633
Plumas,27,2022-06-20,38,38,38,0,239,239,238,1,0,0,0,0,13,13,13,13
Riverside,27,2022-06-20,4957,4964,4953,11,43303,43361,43266,95,112,5,5,14,6494,6494,6489,6489
Sacramento,27,2022-06-20,3928,3934,3925,9,34808,34854,34772,82,171,12,12,21,3139,3139,3127,3127
San Benito,27,2022-06-20,173,173,173,0,1598,1598,1595,3,0,1,1,2,95,95,94,94
San Bernardino,27,2022-06-20,4522,4529,4521,8,46252,46314,46233,81,105,12,12,17,7879,7879,7867,7867
San Diego,27,2022-06-20,9694,9706,9699,7,77518,77620,77563,57,203,9,9,17,5403,5403,5394,5394
San Francisco,27,2022-06-20,3064,3069,3054,15,28302,28339,28201,138,72,12,12,14,929,929,917,917
San Joaquin,27,2022-06-20,1668,1668,1664,4,17897,17921,17875,46,38,6,6,6,2272,2272,2266,2266
San Luis Obispo,27,2022-06-20,601,601,600,1,5812,5818,5806,12,27,10,10,0,498,498,488,488
San Mateo,27,2022-06-20,2622,2626,2622,4,25938,25972,25929,43,42,2,2,1,724,724,722,722
Santa Barbara,27,2022-06-20,934,934,932,2,8260,8272,8254,18,33,2,2,6,699,699,697,697
Santa Clara,27,2022-06-20,6806,6814,6809,5,63481,63565,63516,49,170,8,8,21,2371,2371,2363,2363
Santa Cruz,27,2022-06-20,818,818,816,2,9130,9142,9125,17,19,1,1,2,265,265,264,264
Shasta,27,2022-06-20,241,241,240,1,3372,3377,3369,8,9,1,1,1,569,569,568,568
Siskiyou,27,2022-06-20,61,61,61,0,394,394,393,1,5,1,1,0,84,84,83,83
Solano,27,2022-06-20,1420,1420,1417,3,11473,11489,11464,25,41,0,0,5,453,453,453,453
Sonoma,27,2022-06-20,1399,1399,1396,3,10797,10811,10788,23,28,1,1,3,503,503,502,502
Stanislaus,27,2022-06-20,1035,1035,1032,3,8832,8844,8814,30,70,5,5,7,1707,1707,1702,1702
Sutter,27,2022-06-20,197,197,197,0,1858,1859,1855,4,0,0,0,0,228,228,228,228
Tehama,27,2022-06-20,97,97,97,0,889,889,886,3,3,0,0,0,208,208,208,208
Trinity,27,2022-06-20,10,10,10,0,106,107,106,1,0,0,0,0,20,20,20,20
Tulare,27,2022-06-20,889,889,886,3,8724,8735,8705,30,32,8,8,0,1510,1510,1502,1502
Tuolumne,27,2022-06-20,141,141,141,0,1554,1554,1550,4,3,0,0,1,187,187,187,187
Ventura,27,2022-06-20,1835,1835,1832,3,18669,18694,18666,28,50,1,1,7,1522,1522,1521,1521
Yolo,27,2022-06-20,678,678,677,1,10856,10870,10848,22,1,2,2,2,368,368,366,366
Yuba,27,2022-06-20,149,149,149,0,1339,1339,1336,3,13,0,0,5,119,119,119,119
Alameda,28,2022-06-27,5479,5487,5480,7,48325,48393,48327,66,124,8,8,16,1940,1940,1932,1932
Amador,28,2022-06-27,88,88,88,0,1149,1149,1146,3,3,0,0,1,87,87,87,87
Butte,28,2022-06-27,410,410,410,0,3468,3473,3469,4,30,2,2,0,448,448,446,446
Calaveras,28,2022-06-27,68,68,68,0,570,570,569,1,1,2,2,0,126,126,124,124
Colusa,28,2022-06-27,28,28,28,0,282,283,282,1,6,0,0,0,22,22,22,22
Contra Costa,28,2022-06-27,3526,3532,3524,8,25918,25954,25895,59,82,11,11,7,1368,1368,1357,1357
Del Norte,28,2022-06-27,140,140,140,0,669,669,668,1,5,1,1,2,53,53,52,52
El Dorado,28,2022-06-27,427,427,426,1,3357,3362,3356,6,5,0,0,1,224,224,224,224
Fresno,28,2022-06-27,2825,2830,2824,6,19937,19964,19921,43,136,2,2,17,2789,2789,2787,2787
Glenn,28,2022-06-27,28,28,28,0,296,296,295,1,1,0,0,0,53,53,53,53
Humboldt,28,2022-06-27,261,261,261,0,2189,2192,2188,4,10,1,1,2,151,151,150,150
Imperial,28,2022-06-27,705,705,704,1,4019,4024,4016,8,7,0,0,4,947,947,947,947
Inyo,28,2022-06-27,32,32,32,0,311,311,310,1,1,0,0,0,56,56,56,56
Kern,28,2022-06-27,1813,1813,1810,3,17277,17300,17272,28,52,7,7,8,2365,2365,2358,2358
Kings,28,2022-06-27,470,470,469,1,3931,3936,3928,8,9,0,0,0,452,452,452,452
Lake,28,2022-06-27,122,122,122,0,1139,1139,1136,3,2,0,0,0,140,140,140,140
Lassen,28,2022-06-27,51,51,51,0,848,848,847,1,1,0,0,0,62,62,62,62
Los Angeles,28,2022-06-27,32748,32793,32775,18,364314,364818,364621,197,679,73,73,68,32298,32298,32225,32225
Madera,28,2022-06-27,414,414,413,1,4286,4292,4283,9,8,0,0,0,370,370,370,370
Marin,28,2022-06-27,660,660,659,1,6243,6252,6239,13,20,1,1,2,303,303,302,302
Mariposa,28,2022-06-27,55,55,55,0,310,310,309,1,0,0,0,0,28,28,28,28
Mendocino,28,2022-06-27,153,153,153,0,1447,1447,1443,4,5,1,1,1,131,131,130,130
Merced,28,2022-06-27,614,614,613,1,4035,4040,4033,7,14,2,2,0,833,833,831,831
Modoc,28,2022-06-27,7,7,7,0,32,33,32,1,0,0,0,0,8,8,8,8
Mono,28,2022-06-27,25,25,25,0,110,111,110,1,1,0,0,0,7,7,7,7
Monterey,28,2022-06-27,935,935,932,3,8274,8286,8258,28,44,2,2,3,744,744,742,742
Napa,28,2022-06-27,391,391,390,1,3313,3318,3313,5,3,2,2,1,148,148,146,146
Nevada,28,2022-06-27,189,189,189,0,1619,1621,1618,3,4,0,0,3,131,131,131,131
Orange,28,2022-06-27,7541,7552,7543,9,59326,59409,59334,75,183,16,16,26,7213,7213,7197,7197
Placer,28,2022-06-27,808,808,806,2,6185,6193,6178,15,79,6,6,6,640,640,634,634
Plumas,28,2022-06-27,50,50,50,0,257,257,256,1,1,0,0,0,13,13,13,13
Riverside,28,2022-06-27,6192,6200,6190,10,44955,45016,44940,76,141,11,11,17,6505,6505,6494,6494
Sacramento,28,2022-06-27,4164,4170,4162,8,35277,35325,35260,65,173,10,10,25,3149,3149,3139,3139
San Benito,28,2022-06-27,221,221,221,0,1655,1656,1654,2,0,0,0,1,95,95,95,95
San Bernardino,28,2022-06-27,5723,5731,5723,8,48816,48884,48817,67,130,12,12,24,7891,7891,7879,7879
San Diego,28,2022-06-27,10873,10887,10881,6,80651,80763,80717,46,264,9,9,28,5412,5412,5403,5403
San Francisco,28,2022-06-27,3280,3285,3273,12,29264,29305,29195,110,92,5,5,23,934,934,929,929
San Joaquin,28,2022-06-27,1894,1895,1891,4,17966,17991,17955,36,46,2,2,5,2274,2274,2272,2272
San Luis Obispo,28,2022-06-27,645,645,644,1,5644,5651,5642,9,25,3,3,0,501,501,498,498
San Mateo,28,2022-06-27,2888,2892,2888,4,26904,26941,26907,34,36,2,2,2,726,726,724,724
Santa Barbara,28,2022-06-27,1147,1147,1145,2,9811,9825,9808,17,26,2,2,2,701,701,699,699
Santa Clara,28,2022-06-27,7541,7552,7547,5,61415,61500,61463,37,213,11,11,19,2382,2382,2371,2371
Santa Cruz,28,2022-06-27,861,861,860,1,9188,9200,9186,14,26,2,2,1,267,267,265,265
Shasta,28,2022-06-27,339,339,338,1,3308,3313,3307,6,21,0,0,4,569,569,569,569
Siskiyou,28,2022-06-27,63,63,63,0,355,355,354,1,2,1,1,0,85,85,84,84
Solano,28,2022-06-27,1614,1614,1611,3,13047,13065,13043,22,47,0,0,4,453,453,453,453
Sonoma,28,2022-06-27,1368,1368,1366,2,10098,10112,10095,17,33,2,2,3,505,505,503,503
Stanislaus,28,2022-06-27,1210,1210,1207,3,8582,8594,8571,23,96,2,2,6,1709,1709,1707,1707
Sutter,28,2022-06-27,197,197,197,0,1843,1844,1841,3,0,0,0,0,228,228,228,228
Tehama,28,2022-06-27,93,93,93,0,888,888,886,2,3,0,0,0,208,208,208,208
Trinity,28,2022-06-27,24,24,24,0,142,143,142,1,1,0,0,0,20,20,20,20
Tulare,28,2022-06-27,911,911,909,2,7883,7894,7873,21,35,0,0,2,1510,1510,1510,1510
Tuolumne,28,2022-06-27,172,172,172,0,1405,1405,1402,3,1,4,4,1,191,191,187,187
Ventura,28,2022-06-27,2090,2091,2089,2,18528,18554,18532,22,61,3,3,1,1525,1525,1522,1522
Yolo,28,2022-06-27,794,794,793,1,11418,11434,11416,18,8,0,0,1,368,368,368,368
Yuba,28,2022-06-27,171,171,171,0,1434,1434,1432,2,10,2,2,2,121,121,119,119
Alameda,29,2022-07-04,4836,4843,4838,5,38879,38936,38894,42,128,11,11,10,1951,1951,1940,1940
Amador,29,2022-07-04,66,66,66,0,1534,1535,1532,3,3,1,1,1,88,88,87,87
Butte,29,2022-07-04,284,284,284,0,2489,2492,2490,2,28,2,2,1,450,450,448,448
Calaveras,29,2022-07-04,81,81,81,0,486,486,485,1,0,2,2,0,128,128,126,126
Colusa,29,2022-07-04,21,21,21,0,150,151,150,1,4,0,0,0,22,22,22,22
Contra Costa,29,2022-07-04,3320,3326,3320,6,20929,20959,20921,38,76,10,10,12,1378,1378,1368,1368
Del Norte,29,2022-07-04,140,140,140,0,587,587,586,1,3,0,0,0,53,53,53,53
El Dorado,29,2022-07-04,307,307,307,0,2395,2399,2395,4,10,1,1,0,225,225,224,224
Fresno,29,2022-07-04,2469,2473,2469,4,15677,15700,15673,27,158,6,6,17,2795,2795,2789,2789
Glenn,29,2022-07-04,24,24,24,0,157,158,157,1,1,0,0,0,53,53,53,53
Humboldt,29,2022-07-04,188,188,188,0,1584,1585,1583,2,12,2,2,3,153,153,151,151
Imperial,29,2022-07-04,698,698,697,1,3234,3238,3233,5,8,1,1,3,948,948,947,947
Inyo,29,2022-07-04,42,42,42,0,292,293,292,1,1,0,0,0,56,56,56,56
Kern,29,2022-07-04,1757,1758,1756,2,14149,14171,14153,18,63,4,4,9,2369,2369,2365,2365
Kings,29,2022-07-04,436,436,435,1,3446,3450,3445,5,5,0,0,0,452,452,452,452
Lake,29,2022-07-04,107,107,107,0,790,790,789,1,3,2,2,0,142,142,140,140
Lassen,29,2022-07-04,31,31,31,0,640,640,639,1,2,0,0,0,62,62,62,62
Los Angeles,29,2022-07-04,32259,32306,32292,14,285893,286309,286186,123,801,88,88,85,32386,32386,32298,32298
Madera,29,2022-07-04,341,341,340,1,3179,3182,3176,6,9,0,0,1,370,370,370,370
Marin,29,2022-07-04,608,608,607,1,5169,5176,5167,9,25,1,1,2,304,304,303,303
Mariposa,29,2022-07-04,36,36,36,0,222,223,222,1,0,0,0,0,28,28,28,28
Mendocino,29,2022-07-04,164,164,164,0,1119,1119,1116,3,6,2,2,1,133,133,131,131
Merced,29,2022-07-04,597,597,596,1,2920,2924,2920,4,14,2,2,1,835,835,833,833
Modoc,29,2022-07-04,10,10,10,0,31,32,31,1,0,0,0,0,8,8,8,8
Mono,29,2022-07-04,22,22,22,0,81,82,81,1,1,0,0,0,7,7,7,7
Monterey,29,2022-07-04,843,843,841,2,6318,6329,6312,17,39,2,2,4,746,746,744,744
Napa,29,2022-07-04,340,340,340,0,2557,2561,2558,3,13,0,0,1,148,148,148,148
Nevada,29,2022-07-04,177,177,177,0,1268,1269,1267,2,5,0,0,1,131,131,131,131
Orange,29,2022-07-04,6971,6982,6975,7,50716,50789,50738,51,203,25,25,34,7238,7238,7213,7213
Placer,29,2022-07-04,808,808,807,1,5048,5054,5045,9,72,3,3,6,643,643,640,640
Plumas,29,2022-07-04,32,32,32,0,172,173,172,1,0,0,0,0,13,13,13,13
Riverside,29,2022-07-04,6397,6408,6399,9,38526,38582,38530,52,137,5,5,8,6510,6510,6505,6505
Sacramento,29,2022-07-04,3578,3583,3578,5,26532,26570,26531,39,163,19,19,22,3168,3168,3149,3149
San Benito,29,2022-07-04,211,211,211,0,1274,1275,1273,2,3,0,0,0,95,95,95,95
San Bernardino,29,2022-07-04,6067,6077,6070,7,41595,41655,41610,45,147,12,12,26,7903,7903,7891,7891
San Diego,29,2022-07-04,9602,9617,9613,4,65499,65593,65563,30,262,10,10,43,5422,5422,5412,5412
San Francisco,29,2022-07-04,2890,2894,2885,9,24203,24238,24166,72,100,11,11,18,945,945,934,934
San Joaquin,29,2022-07-04,1678,1678,1675,3,14664,14685,14662,23,41,5,5,4,2279,2279,2274,2274
San Luis Obispo,29,2022-07-04,616,616,615,1,4165,4169,4164,5,24,0,0,0,501,501,501,501
San Mateo,29,2022-07-04,2600,2604,2601,3,21586,21617,21595,22,39,1,1,3,727,727,726,726
Santa Barbara,29,2022-07-04,1057,1057,1056,1,7665,7676,7665,11,26,4,4,4,705,705,701,701
Santa Clara,29,2022-07-04,6804,6814,6811,3,50743,50816,50792,24,191,16,16,34,2398,2398,2382,2382
Santa Cruz,29,2022-07-04,733,733,732,1,7158,7169,7160,9,22,0,0,0,267,267,267,267
Shasta,29,2022-07-04,280,280,280,0,2396,2399,2395,4,15,5,5,3,574,574,569,569
Siskiyou,29,2022-07-04,34,34,34,0,326,327,326,1,1,0,0,1,85,85,85,85
Solano,29,2022-07-04,1346,1346,1344,2,9845,9860,9847,13,50,0,0,5,453,453,453,453
Sonoma,29,2022-07-04,1088,1088,1087,1,8092,8104,8093,11,35,2,2,1,507,507,505,505
Stanislaus,29,2022-07-04,1166,1166,1164,2,6989,7000,6985,15,84,7,7,16,1716,1716,1709,1709
Sutter,29,2022-07-04,230,230,230,0,1671,1673,1671,2,0,0,0,0,228,228,228,228
Tehama,29,2022-07-04,132,132,132,0,821,821,819,2,3,1,1,0,209,209,208,208
Trinity,29,2022-07-04,17,17,17,0,143,144,143,1,2,0,0,0,20,20,20,20
Tulare,29,2022-07-04,944,944,942,2,6100,6108,6095,13,40,4,4,1,1514,1514,1510,1510
Tuolumne,29,2022-07-04,165,165,165,0,938,938,936,2,8,0,0,1,191,191,191,191
Ventura,29,2022-07-04,1948,1950,1948,2,15408,15432,15418,14,66,2,2,8,1527,1527,1525,1525
Yolo,29,2022-07-04,535,535,534,1,7260,7270,7261,9,6,3,3,2,371,371,368,368
Yuba,29,2022-07-04,168,168,168,0,1078,1078,1077,1,9,0,0,1,121,121,121,121
Alameda,30,2022-07-11,5798,5807,5802,5,48339,48413,48373,40,119,8,8,16,1959,1959,1951,1951
Amador,30,2022-07-11,92,92,92,0,1504,1505,1503,2,2,0,0,0,88,88,88,88
Butte,30,2022-07-11,497,497,497,0,3299,3304,3302,2,27,1,1,4,451,451,450,450
Calaveras,30,2022-07-11,78,78,78,0,566,566,565,1,0,1,1,1,129,129,128,128
Colusa,30,2022-07-11,26,26,26,0,483,484,483,1,0,0,0,0,22,22,22,22
Contra Costa,30,2022-07-11,3682,3688,3683,5,26545,26586,26549,37,91,11,11,11,1389,1389,1378,1378
Del Norte,30,2022-07-11,175,175,175,0,677,677,676,1,5,0,0,1,53,53,53,53
El Dorado,30,2022-07-11,384,384,384,0,3153,3158,3154,4,12,1,1,3,226,226,225,225
Fresno,30,2022-07-11,3662,3668,3663,5,21579,21613,21585,28,161,7,7,14,2802,2802,2795,2795
Glenn,30,2022-07-11,45,45,45,0,382,383,382,1,0,0,0,0,53,53,53,53
Humboldt,30,2022-07-11,291,291,291,0,2189,2193,2191,2,11,1,1,2,154,154,153,153
Imperial,30,2022-07-11,1118,1118,1117,1,4746,4753,4747,6,14,1,1,1,949,949,948,948
Inyo,30,2022-07-11,38,38,38,0,389,390,389,1,0,1,1,0,57,57,56,56
Kern,30,2022-07-11,2457,2460,2458,2,16952,16978,16962,16,77,2,2,9,2371,2371,2369,2369
Kings,30,2022-07-11,732,732,731,1,4341,4346,4341,5,11,4,4,0,456,456,452,452
Lake,30,2022-07-11,126,126,126,0,1115,1115,1113,2,0,0,0,0,142,142,142,142
Lassen,30,2022-07-11,59,59,59,0,821,821,820,1,2,1,1,0,63,63,62,62
Los Angeles,30,2022-07-11,43310,43376,43362,14,381155,381734,381609,125,1038,90,90,115,32476,32476,32386,32386
Madera,30,2022-07-11,532,532,531,1,4126,4131,4126,5,15,0,0,3,370,370,370,370
Marin,30,2022-07-11,603,603,602,1,5928,5938,5930,8,17,1,1,1,305,305,304,304
Mariposa,30,2022-07-11,52,52,52,0,283,284,283,1,0,0,0,0,28,28,28,28
Mendocino,30,2022-07-11,190,190,190,0,1387,1388,1386,2,4,0,0,0,133,133,133,133
Merced,30,2022-07-11,763,763,762,1,4273,4278,4274,4,16,5,5,1,840,840,835,835
Modoc,30,2022-07-11,28,28,28,0,57,58,57,1,0,0,0,0,8,8,8,8
Mono,30,2022-07-11,11,11,11,0,105,106,105,1,0,0,0,0,7,7,7,7
Monterey,30,2022-07-11,1096,1096,1094,2,7948,7961,7944,17,47,5,5,3,751,751,746,746
Napa,30,2022-07-11,367,367,367,0,3664,3669,3666,3,13,1,1,1,149,149,148,148
Nevada,30,2022-07-11,221,221,221,0,1826,1829,1827,2,7,0,0,1,131,131,131,131
Orange,30,2022-07-11,9748,9762,9755,7,64155,64252,64202,50,257,20,20,30,7258,7258,7238,7238
Placer,30,2022-07-11,784,784,783,1,5963,5972,5963,9,76,2,2,8,645,645,643,643
Plumas,30,2022-07-11,71,71,71,0,282,283,282,1,0,0,0,0,13,13,13,13
Riverside,30,2022-07-11,9209,9221,9212,9,52065,52143,52089,54,225,17,17,12,6527,6527,6510,6510
Sacramento,30,2022-07-11,4205,4211,4206,5,35516,35568,35528,40,184,22,22,24,3190,3190,3168,3168
San Benito,30,2022-07-11,235,235,235,0,1666,1668,1666,2,1,0,0,0,95,95,95,95
San Bernardino,30,2022-07-11,8441,8453,8446,7,57670,57758,57710,48,188,14,14,20,7917,7917,7903,7903
San Diego,30,2022-07-11,13669,13690,13685,5,85548,85678,85648,30,332,11,11,41,5433,5433,5422,5422
San Francisco,30,2022-07-11,2998,3003,2996,7,27841,27884,27820,64,105,11,11,23,956,956,945,945
San Joaquin,30,2022-07-11,2142,2146,2143,3,19354,19385,19361,24,55,7,7,11,2286,2286,2279,2279
San Luis Obispo,30,2022-07-11,755,755,754,1,5272,5279,5274,5,22,3,3,1,504,504,501,501
San Mateo,30,2022-07-11,2778,2783,2781,2,25654,25693,25673,20,42,6,6,4,733,733,727,727
Santa Barbara,30,2022-07-11,1326,1326,1325,1,9703,9717,9707,10,46,5,5,9,710,710,705,705
Santa Clara,30,2022-07-11,7401,7413,7410,3,59980,60071,60049,22,211,12,12,38,2410,2410,2398,2398
Santa Cruz,30,2022-07-11,1031,1031,1030,1,9513,9526,9517,9,16,0,0,0,267,267,267,267
Shasta,30,2022-07-11,328,328,328,0,3565,3570,3566,4,21,2,2,6,576,576,574,574
Siskiyou,30,2022-07-11,29,29,29,0,361,362,361,1,1,1,1,1,86,86,85,85
Solano,30,2022-07-11,1632,1633,1631,2,11661,11679,11667,12,40,1,1,6,454,454,453,453
Sonoma,30,2022-07-11,1300,1300,1299,1,9943,9958,9948,10,50,0,0,7,507,507,507,507
Stanislaus,30,2022-07-11,1493,1493,1491,2,8686,8699,8685,14,103,7,7,11,1723,1723,1716,1716
Sutter,30,2022-07-11,287,287,287,0,1777,1779,1777,2,0,0,0,0,228,228,228,228
Tehama,30,2022-07-11,134,134,134,0,925,925,924,1,5,0,0,1,209,209,209,209
Trinity,30,2022-07-11,35,35,35,0,120,121,120,1,0,0,0,0,20,20,20,20
Tulare,30,2022-07-11,1384,1384,1382,2,9558,9573,9557,16,47,4,4,2,1518,1518,1514,1514
Tuolumne,30,2022-07-11,254,254,254,0,1303,1303,1301,2,6,0,0,0,191,191,191,191
Ventura,30,2022-07-11,2549,2553,2551,2,19713,19743,19729,14,89,9,9,6,1536,1536,1527,1527
Yolo,30,2022-07-11,502,502,502,0,5426,5433,5428,5,4,3,3,4,374,374,371,371
Yuba,30,2022-07-11,218,218,218,0,1404,1404,1403,1,9,0,0,1,121,121,121,121
Alameda,31,2022-07-18,4956,4963,4960,3,42949,43016,42988,28,149,10,10,25,1969,1969,1959,1959
Amador,31,2022-07-18,85,85,85,0,1348,1349,1348,1,6,0,0,1,88,88,88,88
Butte,31,2022-07-18,334,334,334,0,2794,2798,2797,1,25,1,1,3,452,452,451,451
Calaveras,31,2022-07-18,78,78,78,0,545,546,545,1,0,0,0,0,129,129,129,129
Colusa,31,2022-07-18,23,23,23,0,349,350,349,1,2,0,0,0,22,22,22,22
Contra Costa,31,2022-07-18,3059,3064,3061,3,22722,22757,22732,25,88,4,4,16,1393,1393,1389,1389
Del Norte,31,2022-07-18,168,168,168,0,705,705,704,1,7,0,0,0,53,53,53,53
El Dorado,31,2022-07-18,279,279,279,0,2638,2643,2641,2,11,1,1,1,227,227,226,226
Fresno,31,2022-07-18,3701,3707,3703,4,21121,21154,21132,22,199,9,9,15,2811,2811,2802,2802
Glenn,31,2022-07-18,34,34,34,0,263,264,263,1,0,0,0,0,53,53,53,53
Humboldt,31,2022-07-18,294,294,294,0,2025,2029,2027,2,10,0,0,4,154,154,154,154
Imperial,31,2022-07-18,1022,1022,1021,1,4434,4439,4435,4,18,2,2,3,951,951,949,949
Inyo,31,2022-07-18,30,30,30,0,331,332,331,1,0,0,0,0,57,57,57,57
Kern,31,2022-07-18,2296,2301,2299,2,16469,16494,16482,12,72,10,10,14,2381,2381,2371,2371
Kings,31,2022-07-18,708,708,707,1,4154,4159,4155,4,16,1,1,0,457,457,456,456
Lake,31,2022-07-18,132,132,132,0,993,993,992,1,3,0,0,0,142,142,142,142
Lassen,31,2022-07-18,78,78,78,0,1239,1241,1240,1,1,0,0,0,63,63,63,63
Los Angeles,31,2022-07-18,41822,41889,41878,11,352136,352688,352598,90,1162,112,112,137,32588,32588,32476,32476
Madera,31,2022-07-18,529,529,528,1,3632,3637,3633,4,5,0,0,3,370,370,370,370
Marin,31,2022-07-18,516,516,515,1,5504,5512,5506,6,12,1,1,5,306,306,305,305
Mariposa,31,2022-07-18,42,42,42,0,242,243,242,1,0,1,1,0,29,29,28,28
Mendocino,31,2022-07-18,185,185,185,0,1491,1491,1489,2,6,0,0,2,133,133,133,133
Merced,31,2022-07-18,754,754,753,1,3981,3986,3983,3,15,1,1,1,841,841,840,840
Modoc,31,2022-07-18,13,13,13,0,34,35,34,1,1,0,0,0,8,8,8,8
Mono,31,2022-07-18,10,10,10,0,85,86,85,1,1,0,0,0,7,7,7,7
Monterey,31,2022-07-18,985,985,983,2,7188,7200,7188,12,46,6,6,4,757,757,751,751
Napa,31,2022-07-18,318,318,318,0,2954,2959,2957,2,10,2,2,2,151,151,149,149
Nevada,31,2022-07-18,135,135,135,0,1331,1332,1331,1,8,0,0,3,131,131,131,131
Orange,31,2022-07-18,8793,8806,8801,5,59781,59875,59839,36,253,24,24,45,7282,7282,7258,7258
Placer,31,2022-07-18,684,684,683,1,5240,5248,5242,6,89,1,1,5,646,646,645,645
Plumas,31,2022-07-18,60,60,60,0,279,280,279,1,0,0,0,0,13,13,13,13
Riverside,31,2022-07-18,8247,8259,8252,7,48075,48150,48111,39,222,16,16,17,6543,6543,6527,6527
Sacramento,31,2022-07-18,3541,3547,3544,3,30407,30455,30429,26,180,12,12,26,3202,3202,3190,3190
San Benito,31,2022-07-18,199,199,199,0,1588,1590,1589,1,1,1,1,0,96,96,95,95
San Bernardino,31,2022-07-18,7997,8009,8004,5,53733,53818,53783,35,214,13,13,35,7930,7930,7917,7917
San Diego,31,2022-07-18,13080,13101,13097,4,79857,79981,79959,22,402,18,18,52,5451,5451,5433,5433
San Francisco,31,2022-07-18,2490,2495,2491,4,25513,25554,25509,45,111,10,10,24,966,966,956,956
San Joaquin,31,2022-07-18,2053,2056,2054,2,18031,18061,18044,17,66,2,2,11,2288,2288,2286,2286
San Luis Obispo,31,2022-07-18,560,560,560,0,4628,4634,4631,3,17,3,3,1,507,507,504,504
San Mateo,31,2022-07-18,2289,2293,2292,1,23091,23128,23114,14,33,0,0,4,733,733,733,733
Santa Barbara,31,2022-07-18,1297,1297,1296,1,9270,9284,9276,8,47,1,1,6,711,711,710,710
Santa Clara,31,2022-07-18,6194,6203,6201,2,54685,54771,54755,16,199,12,12,30,2422,2422,2410,2410
Santa Cruz,31,2022-07-18,874,874,873,1,7449,7460,7455,5,24,1,1,2,268,268,267,267
Shasta,31,2022-07-18,320,320,320,0,3209,3214,3211,3,40,3,3,3,579,579,576,576
Siskiyou,31,2022-07-18,34,34,34,0,345,346,345,1,3,0,0,0,86,86,86,86
Solano,31,2022-07-18,1246,1246,1245,1,9543,9558,9550,8,49,1,1,6,455,455,454,454
Sonoma,31,2022-07-18,1053,1053,1052,1,8747,8761,8754,7,44,0,0,5,507,507,507,507
Stanislaus,31,2022-07-18,1394,1394,1392,2,8396,8410,8399,11,109,5,5,9,1728,1728,1723,1723
Sutter,31,2022-07-18,253,253,253,0,1673,1674,1673,1,0,0,0,0,228,228,228,228
Tehama,31,2022-07-18,110,110,110,0,896,896,895,1,7,1,1,0,210,210,209,209
Trinity,31,2022-07-18,20,20,20,0,111,112,111,1,1,0,0,0,20,20,20,20
Tulare,31,2022-07-18,1184,1184,1182,2,8085,8098,8088,10,45,0,0,0,1518,1518,1518,1518
Tuolumne,31,2022-07-18,239,239,239,0,1142,1142,1141,1,7,4,4,0,195,195,191,191
Ventura,31,2022-07-18,2324,2329,2328,1,19560,19590,19579,11,92,4,4,7,1540,1540,1536,1536
Yolo,31,2022-07-18,430,430,430,0,4656,4664,4661,3,2,3,3,1,377,377,374,374
Yuba,31,2022-07-18,213,213,213,0,1292,1292,1291,1,18,0,0,0,121,121,121,121
Alameda,32,2022-07-25,4404,4411,4409,2,40437,40503,40483,20,143,12,12,19,1981,1981,1969,1969
Amador,32,2022-07-25,90,90,90,0,1206,1206,1205,1,3,0,0,1,88,88,88,88
Butte,32,2022-07-25,359,359,359,0,2945,2950,2949,1,30,1,1,2,453,453,452,452
Calaveras,32,2022-07-25,82,82,82,0,558,559,558,1,0,2,2,1,131,131,129,129
Colusa,32,2022-07-25,26,26,26,0,373,374,373,1,1,0,0,0,22,22,22,22
Contra Costa,32,2022-07-25,2823,2828,2826,2,21981,22017,21998,19,102,7,7,18,1400,1400,1393,1393
Del Norte,32,2022-07-25,67,67,67,0,534,535,534,1,6,0,0,0,53,53,53,53
El Dorado,32,2022-07-25,270,270,270,0,2485,2490,2488,2,9,1,1,0,228,228,227,227
Fresno,32,2022-07-25,3358,3363,3360,3,20401,20434,20418,16,195,6,6,29,2817,2817,2811,2811
Glenn,32,2022-07-25,31,31,31,0,271,272,271,1,0,0,0,0,53,53,53,53
Humboldt,32,2022-07-25,230,230,230,0,1923,1928,1927,1,13,2,2,4,156,156,154,154
Imperial,32,2022-07-25,873,873,872,1,4341,4347,4344,3,18,1,1,6,952,952,951,951
Inyo,32,2022-07-25,18,18,18,0,284,285,284,1,2,1,1,0,58,58,57,57
Kern,32,2022-07-25,1899,1900,1899,1,14987,15011,15002,9,82,3,3,12,2384,2384,2381,2381
Kings,32,2022-07-25,571,571,571,0,3887,3892,3889,3,15,1,1,0,458,458,457,457
Lake,32,2022-07-25,128,128,128,0,1041,1041,1040,1,5,1,1,2,143,143,142,142
Lassen,32,2022-07-25,53,53,53,0,1071,1072,1071,1,1,0,0,0,63,63,63,63
Los Angeles,32,2022-07-25,37124,37185,37178,7,334146,334686,334619,67,1152,121,121,134,32709,32709,32588,32588
Madera,32,2022-07-25,539,539,539,0,3829,3834,3831,3,11,1,1,5,371,371,370,370
Marin,32,2022-07-25,489,489,489,0,5417,5426,5422,4,26,2,2,2,308,308,306,306
Mariposa,32,2022-07-25,40,40,40,0,232,233,232,1,0,0,0,0,29,29,29,29
Mendocino,32,2022-07-25,196,196,196,0,1426,1426,1424,2,6,0,0,0,133,133,133,133
Merced,32,2022-07-25,732,732,732,0,3917,3923,3921,2,22,2,2,2,843,843,841,841
Modoc,32,2022-07-25,5,5,5,0,28,29,28,1,0,1,1,0,9,9,8,8
Mono,32,2022-07-25,15,15,15,0,84,85,84,1,0,0,0,0,7,7,7,7
Monterey,32,2022-07-25,933,933,932,1,7142,7154,7145,9,39,1,1,3,758,758,757,757
Napa,32,2022-07-25,297,297,297,0,2933,2938,2936,2,6,3,3,0,154,154,151,151
Nevada,32,2022-07-25,116,116,116,0,1316,1317,1316,1,3,1,1,0,132,132,131,131
Orange,32,2022-07-25,8017,8029,8025,4,58143,58238,58211,27,306,37,37,35,7319,7319,7282,7282
Placer,32,2022-07-25,606,606,605,1,5086,5094,5090,4,77,5,5,11,651,651,646,646
Plumas,32,2022-07-25,25,25,25,0,188,189,188,1,0,0,0,0,13,13,13,13
Riverside,32,2022-07-25,7513,7525,7520,5,45936,46010,45981,29,259,16,16,27,6559,6559,6543,6543
Sacramento,32,2022-07-25,3633,3639,3637,2,29835,29884,29864,20,207,18,18,32,3220,3220,3202,3202
San Benito,32,2022-07-25,200,200,200,0,1836,1839,1838,1,0,1,1,0,97,97,96,96
San Bernardino,32,2022-07-25,7099,7111,7107,4,52137,52222,52196,26,214,30,30,23,7960,7960,7930,7930
San Diego,32,2022-07-25,11897,11916,11913,3,76173,76295,76279,16,393,19,19,41,5470,5470,5451,5451
San Francisco,32,2022-07-25,2299,2304,2301,3,24270,24309,24275,34,126,9,9,24,975,975,966,966
San Joaquin,32,2022-07-25,1837,1839,1838,1,16574,16601,16589,12,73,5,5,9,2293,2293,2288,2288
San Luis Obispo,32,2022-07-25,539,539,539,0,4382,4388,4385,3,16,4,4,1,511,511,507,507
San Mateo,32,2022-07-25,2030,2032,2031,1,21675,21710,21700,10,57,1,1,7,734,734,733,733
Santa Barbara,32,2022-07-25,1178,1178,1177,1,8770,8785,8779,6,37,4,4,3,715,715,711,711
Santa Clara,32,2022-07-25,5772,5782,5781,1,50880,50962,50951,11,238,16,16,26,2438,2438,2422,2422
Santa Cruz,32,2022-07-25,832,832,832,0,7663,7675,7671,4,23,0,0,0,268,268,268,268
Shasta,32,2022-07-25,305,305,305,0,3079,3084,3082,2,38,2,2,6,581,581,579,579
Siskiyou,32,2022-07-25,36,36,36,0,333,334,333,1,1,0,0,0,86,86,86,86
Solano,32,2022-07-25,1203,1203,1202,1,9484,9501,9495,6,56,0,0,5,455,455,455,455
Sonoma,32,2022-07-25,1066,1066,1065,1,8653,8667,8662,5,48,2,2,4,509,509,507,507
Stanislaus,32,2022-07-25,1377,1377,1376,1,8159,8173,8165,8,104,8,8,11,1736,1736,1728,1728
Sutter,32,2022-07-25,222,222,222,0,1721,1722,1721,1,0,0,0,0,228,228,228,228
Tehama,32,2022-07-25,103,103,103,0,920,920,919,1,5,2,2,0,212,212,210,210
Trinity,32,2022-07-25,12,12,12,0,102,103,102,1,0,0,0,0,20,20,20,20
Tulare,32,2022-07-25,1144,1144,1143,1,8015,8027,8019,8,42,2,2,2,1520,1520,1518,1518
Tuolumne,32,2022-07-25,200,200,200,0,1150,1150,1149,1,5,1,1,0,196,196,195,195
Ventura,32,2022-07-25,2152,2157,2156,1,18388,18418,18410,8,76,5,5,8,1545,1545,1540,1540
Yolo,32,2022-07-25,413,413,413,0,4397,4404,4401,3,4,3,3,1,380,380,377,377
Yuba,32,2022-07-25,175,175,175,0,1282,1282,1281,1,15,0,0,0,121,121,121,121
Alameda,33,2022-08-01,3819,3826,3825,1,37191,37253,37238,15,176,8,8,21,1989,1989,1981,1981
Amador,33,2022-08-01,53,53,53,0,1133,1133,1132,1,3,1,1,0,89,89,88,88
Butte,33,2022-08-01,368,368,368,0,2843,2848,2847,1,33,2,2,3,455,455,453,453
Calaveras,33,2022-08-01,68,68,68,0,573,574,573,1,2,1,1,2,132,132,131,131
Colusa,33,2022-08-01,26,26,26,0,362,363,362,1,7,0,0,0,22,22,22,22
Contra Costa,33,2022-08-01,2622,2627,2625,2,21019,21052,21038,14,86,13,13,15,1413,1413,1400,1400
Del Norte,33,2022-08-01,53,53,53,0,476,477,476,1,4,0,0,2,53,53,53,53
El Dorado,33,2022-08-01,232,232,232,0,2456,2461,2460,1,4,3,3,2,231,231,228,228
Fresno,33,2022-08-01,2994,2999,2997,2,18320,18351,18340,11,231,10,10,16,2827,2827,2817,2817
Glenn,33,2022-08-01,28,28,28,0,251,252,251,1,0,0,0,0,53,53,53,53
Humboldt,33,2022-08-01,224,224,224,0,1880,1883,1882,1,12,0,0,3,156,156,156,156
Imperial,33,2022-08-01,636,636,636,0,3530,3535,3533,2,22,5,5,3,957,957,952,952
Inyo,33,2022-08-01,20,20,20,0,280,281,280,1,2,0,0,0,58,58,58,58
Kern,33,2022-08-01,1692,1694,1693,1,14821,14844,14837,7,81,6,6,17,2390,2390,2384,2384
Kings,33,2022-08-01,624,624,624,0,4043,4048,4046,2,6,0,0,1,458,458,458,458
Lake,33,2022-08-01,125,125,125,0,994,994,993,1,7,0,0,2,143,143,143,143
Lassen,33,2022-08-01,103,103,103,0,947,949,948,1,0,0,0,0,63,63,63,63
Los Angeles,33,2022-08-01,30586,30637,30632,5,308922,309434,309386,48,1105,129,129,137,32838,32838,32709,32709
Madera,33,2022-08-01,463,463,463,0,3481,3486,3484,2,10,0,0,7,371,371,371,371
Marin,33,2022-08-01,411,411,411,0,5134,5142,5139,3,32,1,1,4,309,309,308,308
Mariposa,33,2022-08-01,22,22,22,0,225,226,225,1,0,0,0,0,29,29,29,29
Mendocino,33,2022-08-01,175,175,175,0,1258,1258,1257,1,6,1,1,1,134,134,133,133
Merced,33,2022-08-01,641,641,641,0,3567,3572,3570,2,22,6,6,2,849,849,843,843
Modoc,33,2022-08-01,16,16,16,0,31,32,31,1,0,0,0,0,9,9,9,9
Mono,33,2022-08-01,9,9,9,0,67,68,67,1,0,0,0,0,7,7,7,7
Monterey,33,2022-08-01,930,930,929,1,6430,6442,6436,6,33,2,2,1,760,760,758,758
Napa,33,2022-08-01,282,282,282,0,2838,2843,2842,1,8,0,0,2,154,154,154,154
Nevada,33,2022-08-01,125,125,125,0,1404,1406,1405,1,12,0,0,0,132,132,132,132
Orange,33,2022-08-01,6491,6503,6501,2,52422,52508,52489,19,246,34,34,49,7353,7353,7319,7319
Placer,33,2022-08-01,587,587,587,0,4744,4752,4749,3,71,1,1,11,652,652,651,651
Plumas,33,2022-08-01,23,23,23,0,162,163,162,1,0,0,0,0,13,13,13,13
Riverside,33,2022-08-01,6120,6131,6128,3,42287,42356,42335,21,200,5,5,23,6564,6564,6559,6559
Sacramento,33,2022-08-01,3095,3101,3099,2,27845,27891,27876,15,179,18,18,26,3238,3238,3220,3220
San Benito,33,2022-08-01,177,177,177,0,1560,1562,1561,1,2,1,1,0,98,98,97,97
San Bernardino,33,2022-08-01,6065,6075,6073,2,48913,48994,48975,19,184,26,26,23,7986,7986,7960,7960
San Diego,33,2022-08-01,9364,9379,9377,2,68638,68751,68740,11,396,16,16,46,5486,5486,5470,5470
San Francisco,33,2022-08-01,1817,1819,1817,2,21993,22030,22006,24,105,13,13,20,988,988,975,975
San Joaquin,33,2022-08-01,1734,1735,1734,1,16120,16147,16138,9,69,7,7,11,2300,2300,2293,2293
San Luis Obispo,33,2022-08-01,578,578,578,0,4141,4146,4144,2,14,3,3,0,514,514,511,511
San Mateo,33,2022-08-01,1773,1774,1773,1,20330,20364,20357,7,67,1,1,3,735,735,734,734
Santa Barbara,33,2022-08-01,1119,1119,1118,1,7779,7792,7788,4,40,1,1,3,716,716,715,715
Santa Clara,33,2022-08-01,4818,4825,4824,1,45489,45565,45557,8,230,19,19,36,2457,2457,2438,2438
Santa Cruz,33,2022-08-01,748,748,748,0,6875,6886,6883,3,20,1,1,3,269,269,268,268
Shasta,33,2022-08-01,245,245,245,0,2968,2973,2971,2,34,1,1,7,582,582,581,581
Siskiyou,33,2022-08-01,29,29,29,0,298,299,298,1,2,0,0,0,86,86,86,86
Solano,33,2022-08-01,1145,1145,1144,1,9149,9164,9159,5,53,0,0,4,455,455,455,455
Sonoma,33,2022-08-01,921,921,921,0,8186,8199,8195,4,46,3,3,3,512,512,509,509
Stanislaus,33,2022-08-01,1233,1233,1232,1,7720,7733,7727,6,115,6,6,8,1742,1742,1736,1736
Sutter,33,2022-08-01,232,232,232,0,1634,1635,1634,1,0,3,3,0,231,231,228,228
Tehama,33,2022-08-01,89,89,89,0,757,757,756,1,4,0,0,0,212,212,212,212
Trinity,33,2022-08-01,11,11,11,0,71,72,71,1,0,1,1,0,21,21,20,20
Tulare,33,2022-08-01,1036,1036,1035,1,7462,7475,7469,6,46,1,1,3,1521,1521,1520,1520
Tuolumne,33,2022-08-01,144,144,144,0,1111,1111,1110,1,4,0,0,1,196,196,196,196
Ventura,33,2022-08-01,1806,1809,1808,1,16967,16996,16990,6,75,10,10,10,1555,1555,1545,1545
Yolo,33,2022-08-01,333,333,333,0,4180,4187,4185,2,3,3,3,1,383,383,380,380
Yuba,33,2022-08-01,159,159,159,0,1216,1216,1215,1,10,0,0,3,121,121,121,121
Alameda,34,2022-08-08,3284,3290,3289,1,35241,35301,35290,11,133,15,15,20,2004,2004,1989,1989
Amador,34,2022-08-08,50,50,50,0,852,853,852,1,3,0,0,1,89,89,89,89
Butte,34,2022-08-08,334,334,334,0,2493,2498,2497,1,33,1,1,1,456,456,455,455
Calaveras,34,2022-08-08,57,57,57,0,559,560,559,1,1,1,1,0,133,133,132,132
Colusa,34,2022-08-08,15,15,15,0,362,363,362,1,0,0,0,0,22,22,22,22
Contra Costa,34,2022-08-08,2180,2184,2183,1,19793,19826,19816,10,102,4,4,14,1417,1417,1413,1413
Del Norte,34,2022-08-08,49,49,49,0,498,499,498,1,4,1,1,1,54,54,53,53
El Dorado,34,2022-08-08,191,191,191,0,2317,2322,2321,1,4,0,0,2,231,231,231,231
Fresno,34,2022-08-08,2421,2426,2425,1,17767,17798,17789,9,207,9,9,25,2836,2836,2827,2827
Glenn,34,2022-08-08,22,22,22,0,249,250,249,1,0,0,0,0,53,53,53,53
Humboldt,34,2022-08-08,208,208,208,0,1919,1924,1923,1,12,1,1,2,157,157,156,156
Imperial,34,2022-08-08,548,548,548,0,3278,3283,3282,1,16,2,2,2,959,959,957,957
Inyo,34,2022-08-08,8,8,8,0,276,277,276,1,1,0,0,1,58,58,58,58
Kern,34,2022-08-08,1314,1314,1314,0,13659,13683,13678,5,61,6,6,16,2396,2396,2390,2390
Kings,34,2022-08-08,467,467,467,0,3323,3328,3327,1,20,1,1,2,459,459,458,458
Lake,34,2022-08-08,106,106,106,0,893,894,893,1,4,0,0,1,143,143,143,143
Lassen,34,2022-08-08,132,132,132,0,1023,1025,1024,1,1,0,0,0,63,63,63,63
Los Angeles,34,2022-08-08,25744,25787,25784,3,290995,291491,291456,35,1030,128,128,121,32966,32966,32838,32838
Madera,34,2022-08-08,380,380,380,0,3175,3180,3178,2,16,0,0,3,371,371,371,371
Marin,34,2022-08-08,360,360,360,0,4484,4491,4489,2,26,2,2,2,311,311,309,309
Mariposa,34,2022-08-08,28,28,28,0,197,198,197,1,0,0,0,0,29,29,29,29
Mendocino,34,2022-08-08,132,132,132,0,1128,1128,1127,1,3,1,1,1,135,135,134,134
Merced,34,2022-08-08,538,538,538,0,3396,3401,3400,1,17,1,1,5,850,850,849,849
Modoc,34,2022-08-08,2,2,2,0,22,23,22,1,0,0,0,0,9,9,9,9
Mono,34,2022-08-08,10,10,10,0,85,86,85,1,0,0,0,0,7,7,7,7
Monterey,34,2022-08-08,736,736,735,1,5773,5783,5779,4,28,1,1,0,761,761,760,760
Napa,34,2022-08-08,252,252,252,0,2611,2616,2615,1,10,2,2,3,156,156,154,154
Nevada,34,2022-08-08,94,94,94,0,1290,1292,1291,1,4,0,0,0,132,132,132,132
Orange,34,2022-08-08,5280,5289,5288,1,48046,48128,48114,14,242,29,29,40,7382,7382,7353,7353
Placer,34,2022-08-08,513,513,513,0,4518,4525,4523,2,65,3,3,9,655,655,652,652
Plumas,34,2022-08-08,23,23,23,0,190,191,190,1,1,0,0,0,13,13,13,13
Riverside,34,2022-08-08,5508,5518,5516,2,40564,40632,40617,15,174,13,13,13,6577,6577,6564,6564
Sacramento,34,2022-08-08,2623,2628,2627,1,26966,27012,27001,11,156,17,17,20,3255,3255,3238,3238
San Benito,34,2022-08-08,186,186,186,0,1433,1435,1434,1,1,0,0,0,98,98,98,98
San Bernardino,34,2022-08-08,5055,5064,5062,2,45835,45913,45899,14,204,20,20,15,8006,8006,7986,7986
San Diego,34,2022-08-08,7275,7287,7286,1,64412,64521,64513,8,337,11,11,30,5497,5497,5486,5486
San Francisco,34,2022-08-08,1494,1494,1493,1,20620,20655,20638,17,94,11,11,21,999,999,988,988
San Joaquin,34,2022-08-08,1522,1523,1522,1,15717,15744,15737,7,55,6,6,12,2306,2306,2300,2300
San Luis Obispo,34,2022-08-08,509,509,509,0,3610,3615,3614,1,14,0,0,2,514,514,514,514
San Mateo,34,2022-08-08,1517,1517,1517,0,18502,18534,18529,5,60,0,0,5,735,735,735,735
Santa Barbara,34,2022-08-08,963,963,963,0,7518,7531,7528,3,46,3,3,4,719,719,716,716
Santa Clara,34,2022-08-08,4139,4146,4145,1,40868,40937,40931,6,203,17,17,40,2474,2474,2457,2457
Santa Cruz,34,2022-08-08,619,619,619,0,6055,6066,6064,2,28,1,1,0,270,270,269,269
Shasta,34,2022-08-08,197,197,197,0,2831,2836,2835,1,33,1,1,3,583,583,582,582
Siskiyou,34,2022-08-08,27,27,27,0,291,292,291,1,0,1,1,0,87,87,86,86
Solano,34,2022-08-08,884,884,884,0,7967,7981,7978,3,54,0,0,9,455,455,455,455
Sonoma,34,2022-08-08,839,839,839,0,7725,7738,7735,3,34,4,4,3,516,516,512,512
Stanislaus,34,2022-08-08,1033,1033,1032,1,7172,7185,7181,4,90,7,7,11,1749,1749,1742,1742
Sutter,34,2022-08-08,223,223,223,0,1551,1552,1551,1,0,0,0,0,231,231,231,231
Tehama,34,2022-08-08,77,77,77,0,681,682,681,1,0,0,0,1,212,212,212,212
Trinity,34,2022-08-08,5,5,5,0,71,72,71,1,0,0,0,0,21,21,21,21
Tulare,34,2022-08-08,887,887,886,1,7320,7331,7327,4,46,4,4,3,1525,1525,1521,1521
Tuolumne,34,2022-08-08,118,118,118,0,1054,1054,1053,1,4,2,2,0,198,198,196,196
Ventura,34,2022-08-08,1504,1504,1504,0,15931,15958,15954,4,67,7,7,7,1562,1562,1555,1555
Yolo,34,2022-08-08,287,287,287,0,3886,3892,3891,1,4,1,1,3,384,384,383,383
Yuba,34,2022-08-08,136,136,136,0,1086,1087,1086,1,6,1,1,0,122,122,121,121
Alameda,35,2022-08-15,2565,2570,2569,1,33713,33772,33764,8,105,9,9,22,2013,2013,2004,2004
Amador,35,2022-08-15,47,47,47,0,848,849,848,1,2,0,0,0,89,89,89,89
Butte,35,2022-08-15,262,262,262,0,2244,2249,2248,1,19,0,0,2,456,456,456,456
Calaveras,35,2022-08-15,46,46,46,0,528,529,528,1,0,0,0,0,133,133,133,133
Colusa,35,2022-08-15,16,16,16,0,359,360,359,1,1,0,0,0,22,22,22,22
Contra Costa,35,2022-08-15,1776,1777,1776,1,18963,18997,18989,8,72,6,6,9,1423,1423,1417,1417
Del Norte,35,2022-08-15,53,53,53,0,499,500,499,1,2,0,0,1,54,54,54,54
El Dorado,35,2022-08-15,177,177,177,0,2304,2309,2308,1,5,0,0,3,231,231,231,231
Fresno,35,2022-08-15,1869,1872,1871,1,16175,16203,16197,6,170,7,7,17,2843,2843,2836,2836
Glenn,35,2022-08-15,15,15,15,0,225,226,225,1,3,0,0,0,53,53,53,53
Humboldt,35,2022-08-15,179,179,179,0,1587,1590,1589,1,16,0,0,2,157,157,157,157
Imperial,35,2022-08-15,365,365,365,0,3099,3104,3103,1,11,0,0,2,959,959,959,959
Inyo,35,2022-08-15,14,14,14,0,236,237,236,1,2,1,1,0,59,59,58,58
Kern,35,2022-08-15,1216,1216,1216,0,13479,13502,13498,4,59,7,7,16,2403,2403,2396,2396
Kings,35,2022-08-15,332,332,332,0,3234,3239,3238,1,9,0,0,1,459,459,459,459
Lake,35,2022-08-15,104,104,104,0,1028,1030,1029,1,3,1,1,2,144,144,143,143
Lassen,35,2022-08-15,59,59,59,0,897,899,898,1,0,0,0,0,63,63,63,63
Los Angeles,35,2022-08-15,20912,20948,20946,2,287477,287982,287955,27,905,110,110,117,33076,33076,32966,32966
Madera,35,2022-08-15,305,305,305,0,2954,2959,2958,1,12,0,0,3,371,371,371,371
Marin,35,2022-08-15,293,293,293,0,4111,4117,4115,2,15,0,0,0,311,311,311,311
Mariposa,35,2022-08-15,15,15,15,0,192,193,192,1,0,0,0,0,29,29,29,29
Mendocino,35,2022-08-15,104,104,104,0,996,996,995,1,7,0,0,3,135,135,135,135
Merced,35,2022-08-15,452,452,452,0,3426,3432,3431,1,12,2,2,1,852,852,850,850
Modoc,35,2022-08-15,4,4,4,0,23,24,23,1,0,0,0,0,9,9,9,9
Mono,35,2022-08-15,4,4,4,0,61,62,61,1,0,0,0,0,7,7,7,7
Monterey,35,2022-08-15,662,662,662,0,5824,5836,5833,3,30,0,0,1,761,761,761,761
Napa,35,2022-08-15,212,212,212,0,2280,2285,2284,1,13,0,0,0,156,156,156,156
Nevada,35,2022-08-15,98,98,98,0,1209,1211,1210,1,7,0,0,0,132,132,132,132
Orange,35,2022-08-15,4576,4583,4582,1,43031,43105,43095,10,270,31,31,44,7413,7413,7382,7382
Placer,35,2022-08-15,411,411,411,0,4469,4477,4475,2,61,1,1,11,656,656,655,655
Plumas,35,2022-08-15,17,17,17,0,184,185,184,1,0,0,0,0,13,13,13,13
Riverside,35,2022-08-15,4560,4567,4566,1,38035,38101,38090,11,143,16,16,22,6593,6593,6577,6577
Sacramento,35,2022-08-15,2352,2357,2356,1,25411,25456,25448,8,149,11,11,22,3266,3266,3255,3255
San Benito,35,2022-08-15,140,140,140,0,1334,1337,1336,1,3,1,1,1,99,99,98,98
San Bernardino,35,2022-08-15,4699,4707,4706,1,44149,44226,44215,11,144,14,14,22,8020,8020,8006,8006
San Diego,35,2022-08-15,5499,5509,5508,1,59502,59607,59601,6,288,14,14,34,5511,5511,5497,5497
San Francisco,35,2022-08-15,1266,1266,1265,1,19570,19604,19591,13,103,15,15,11,1014,1014,999,999
San Joaquin,35,2022-08-15,1444,1445,1444,1,15217,15244,15239,5,64,8,8,8,2314,2314,2306,2306
San Luis Obispo,35,2022-08-15,325,325,325,0,3301,3306,3305,1,15,4,4,3,518,518,514,514
San Mateo,35,2022-08-15,1220,1220,1220,0,17366,17396,17392,4,56,1,1,5,736,736,735,735
Santa Barbara,35,2022-08-15,831,831,831,0,7118,7131,7129,2,44,1,1,4,720,720,719,719
Santa Clara,35,2022-08-15,3332,3339,3339,0,39767,39836,39832,4,200,8,8,24,2482,2482,2474,2474
Santa Cruz,35,2022-08-15,493,493,493,0,7543,7557,7555,2,23,3,3,1,273,273,270,270
Shasta,35,2022-08-15,194,194,194,0,2786,2790,2789,1,19,1,1,1,584,584,583,583
Siskiyou,35,2022-08-15,19,19,19,0,284,285,284,1,3,0,0,1,87,87,87,87
Solano,35,2022-08-15,662,662,662,0,7458,7471,7469,2,45,0,0,10,455,455,455,455
Sonoma,35,2022-08-15,631,631,631,0,7286,7299,7297,2,39,2,2,2,518,518,516,516
Stanislaus,35,2022-08-15,940,940,940,0,7657,7670,7666,4,99,9,9,11,1758,1758,1749,1749
Sutter,35,2022-08-15,197,197,197,0,1587,1589,1588,1,0,1,1,0,232,232,231,231
Tehama,35,2022-08-15,60,60,60,0,645,646,645,1,1,0,0,0,212,212,212,212
Trinity,35,2022-08-15,8,8,8,0,58,59,58,1,0,0,0,0,21,21,21,21
Tulare,35,2022-08-15,735,735,735,0,7326,7337,7334,3,32,3,3,1,1528,1528,1525,1525
Tuolumne,35,2022-08-15,110,110,110,0,991,992,991,1,1,0,0,0,198,198,198,198
Ventura,35,2022-08-15,1494,1494,1494,0,15260,15287,15284,3,70,6,6,7,1568,1568,1562,1562
Yolo,35,2022-08-15,264,264,264,0,3542,3547,3546,1,2,4,4,1,388,388,384,384
Yuba,35,2022-08-15,128,128,128,0,1080,1081,1080,1,9,0,0,0,122,122,122,122
Alameda,36,2022-08-22,2240,2245,2245,0,33144,33205,33199,6,117,9,9,21,2022,2022,2013,2013
Amador,36,2022-08-22,49,49,49,0,815,816,815,1,2,1,1,0,90,90,89,89
Butte,36,2022-08-22,222,222,222,0,2130,2135,2134,1,17,1,1,2,457,457,456,456
Calaveras,36,2022-08-22,43,43,43,0,572,573,572,1,1,0,0,0,133,133,133,133
Colusa,36,2022-08-22,16,16,16,0,394,395,394,1,0,0,0,0,22,22,22,22
Contra Costa,36,2022-08-22,1528,1530,1530,0,18834,18869,18863,6,56,5,5,9,1428,1428,1423,1423
Del Norte,36,2022-08-22,32,32,32,0,461,462,461,1,3,1,1,0,55,55,54,54
El Dorado,36,2022-08-22,152,152,152,0,2219,2224,2223,1,4,1,1,0,232,232,231,231
Fresno,36,2022-08-22,1595,1597,1597,0,15784,15812,15807,5,162,6,6,14,2849,2849,2843,2843
Glenn,36,2022-08-22,23,23,23,0,227,228,227,1,1,0,0,0,53,53,53,53
Humboldt,36,2022-08-22,151,151,151,0,1677,1682,1681,1,6,1,1,3,158,158,157,157
Imperial,36,2022-08-22,291,291,291,0,2844,2849,2848,1,15,0,0,0,959,959,959,959
Inyo,36,2022-08-22,8,8,8,0,213,214,213,1,0,0,0,0,59,59,59,59
Kern,36,2022-08-22,982,982,982,0,13745,13770,13767,3,69,6,6,10,2409,2409,2403,2403
Kings,36,2022-08-22,369,369,369,0,3636,3641,3640,1,10,2,2,0,461,461,459,459
Lake,36,2022-08-22,104,104,104,0,884,885,884,1,5,0,0,0,144,144,144,144
Lassen,36,2022-08-22,36,36,36,0,833,834,833,1,0,0,0,0,63,63,63,63
Los Angeles,36,2022-08-22,18452,18484,18483,1,274620,275115,275095,20,811,120,120,104,33196,33196,33076,33076
Madera,36,2022-08-22,299,299,299,0,2612,2617,2616,1,14,2,2,4,373,373,371,371
Marin,36,2022-08-22,250,250,250,0,3967,3973,3972,1,17,0,0,3,311,311,311,311
Mariposa,36,2022-08-22,14,14,14,0,172,173,172,1,0,0,0,0,29,29,29,29
Mendocino,36,2022-08-22,121,121,121,0,1145,1146,1145,1,3,0,0,2,135,135,135,135
Merced,36,2022-08-22,447,447,447,0,3657,3663,3662,1,12,4,4,1,856,856,852,852
Modoc,36,2022-08-22,6,6,6,0,27,28,27,1,0,0,0,0,9,9,9,9
Mono,36,2022-08-22,4,4,4,0,63,64,63,1,0,0,0,0,7,7,7,7
Monterey,36,2022-08-22,547,547,547,0,5923,5934,5931,3,27,1,1,2,762,762,761,761
Napa,36,2022-08-22,128,128,128,0,1999,2005,2004,1,5,2,2,1,158,158,156,156
Nevada,36,2022-08-22,84,84,84,0,1180,1182,1181,1,6,0,0,0,132,132,132,132
Orange,36,2022-08-22,3807,3814,3813,1,40768,40841,40834,7,224,21,21,35,7434,7434,7413,7413
Placer,36,2022-08-22,384,384,384,0,4303,4311,4310,1,61,1,1,14,657,657,656,656
Plumas,36,2022-08-22,20,20,20,0,175,176,175,1,1,0,0,0,13,13,13,13
Riverside,36,2022-08-22,4379,4387,4386,1,37513,37582,37573,9,142,13,13,19,6606,6606,6593,6593
Sacramento,36,2022-08-22,2079,2084,2083,1,24955,25000,24994,6,144,14,14,25,3280,3280,3266,3266
San Benito,36,2022-08-22,102,102,102,0,1268,1270,1269,1,1,1,1,1,100,100,99,99
San Bernardino,36,2022-08-22,4616,4624,4623,1,44244,44324,44316,8,160,18,18,22,8038,8038,8020,8020
San Diego,36,2022-08-22,4784,4793,4793,0,57539,57643,57639,4,287,6,6,28,5517,5517,5511,5511
San Francisco,36,2022-08-22,1096,1096,1095,1,18859,18893,18883,10,81,16,16,12,1030,1030,1014,1014
San Joaquin,36,2022-08-22,1195,1195,1195,0,15726,15754,15750,4,56,1,1,8,2315,2315,2314,2314
San Luis Obispo,36,2022-08-22,259,259,259,0,3089,3094,3093,1,16,1,1,0,519,519,518,518
San Mateo,36,2022-08-22,1013,1013,1013,0,17202,17232,17229,3,42,0,0,2,736,736,736,736
Santa Barbara,36,2022-08-22,736,736,736,0,7435,7448,7446,2,37,1,1,2,721,721,720,720
Santa Clara,36,2022-08-22,3013,3019,3019,0,40203,40276,40273,3,173,10,10,27,2492,2492,2482,2482
Santa Cruz,36,2022-08-22,502,502,502,0,11963,11984,11982,2,13,0,0,0,273,273,273,273
Shasta,36,2022-08-22,174,174,174,0,2757,2762,2761,1,10,2,2,2,586,586,584,584
Siskiyou,36,2022-08-22,25,25,25,0,249,250,249,1,4,1,1,2,88,88,87,87
Solano,36,2022-08-22,532,532,532,0,7219,7232,7230,2,35,0,0,12,455,455,455,455
Sonoma,36,2022-08-22,605,605,605,0,7371,7385,7383,2,42,1,1,1,519,519,518,518
Stanislaus,36,2022-08-22,893,893,893,0,7650,7663,7660,3,79,7,7,16,1765,1765,1758,1758
Sutter,36,2022-08-22,189,189,189,0,1657,1660,1659,1,0,0,0,0,232,232,232,232
Tehama,36,2022-08-22,53,53,53,0,629,630,629,1,1,0,0,0,212,212,212,212
Trinity,36,2022-08-22,10,10,10,0,63,64,63,1,0,0,0,0,21,21,21,21
Tulare,36,2022-08-22,729,729,729,0,6781,6793,6791,2,33,4,4,1,1532,1532,1528,1528
Tuolumne,36,2022-08-22,106,106,106,0,1018,1019,1018,1,0,1,1,0,199,199,198,198
Ventura,36,2022-08-22,1318,1318,1318,0,14997,15024,15022,2,59,4,4,9,1572,1572,1568,1568
Yolo,36,2022-08-22,200,200,200,0,3488,3493,3492,1,10,1,1,1,389,389,388,388
Yuba,36,2022-08-22,127,127,127,0,1106,1107,1106,1,13,0,0,3,122,122,122,122
Alameda,37,2022-08-29,1971,1976,1976,0,34186,34251,34246,5,99,11,11,20,2033,2033,2022,2022
Amador,37,2022-08-29,46,46,46,0,804,805,804,1,2,1,1,0,91,91,90,90
Butte,37,2022-08-29,236,236,236,0,2170,2176,2175,1,18,0,0,3,457,457,457,457
Calaveras,37,2022-08-29,59,59,59,0,592,593,592,1,1,0,0,0,133,133,133,133
Colusa,37,2022-08-29,11,11,11,0,329,330,329,1,3,0,0,0,22,22,22,22
Contra Costa,37,2022-08-29,1354,1354,1354,0,18792,18828,18823,5,44,5,5,7,1433,1433,1428,1428
Del Norte,37,2022-08-29,28,28,28,0,431,432,431,1,5,0,0,1,55,55,55,55
El Dorado,37,2022-08-29,143,143,143,0,1947,1953,1952,1,1,0,0,1,232,232,232,232
Fresno,37,2022-08-29,1418,1418,1418,0,15741,15769,15765,4,159,3,3,15,2852,2852,2849,2849
Glenn,37,2022-08-29,22,22,22,0,220,221,220,1,1,0,0,0,53,53,53,53
Humboldt,37,2022-08-29,124,124,124,0,1662,1667,1666,1,4,0,0,0,158,158,158,158
Imperial,37,2022-08-29,294,294,294,0,2935,2940,2939,1,14,1,1,2,960,960,959,959
Inyo,37,2022-08-29,8,8,8,0,175,176,175,1,0,0,0,0,59,59,59,59
Kern,37,2022-08-29,885,885,885,0,13225,13249,13247,2,50,0,0,8,2409,2409,2409,2409
Kings,37,2022-08-29,314,314,314,0,3490,3496,3495,1,8,0,0,0,461,461,461,461
Lake,37,2022-08-29,93,93,93,0,870,871,870,1,1,1,1,0,145,145,144,144
Lassen,37,2022-08-29,28,28,28,0,771,772,771,1,0,0,0,0,63,63,63,63
Los Angeles,37,2022-08-29,15520,15549,15548,1,271296,271806,271790,16,753,86,86,83,33282,33282,33196,33196
Madera,37,2022-08-29,301,301,301,0,3019,3025,3024,1,13,0,0,3,373,373,373,373
Marin,37,2022-08-29,215,215,215,0,3847,3853,3852,1,16,2,2,2,313,313,311,311
Mariposa,37,2022-08-29,25,25,25,0,186,187,186,1,0,0,0,0,29,29,29,29
Mendocino,37,2022-08-29,87,87,87,0,969,970,969,1,2,0,0,1,135,135,135,135
Merced,37,2022-08-29,393,393,393,0,3417,3422,3421,1,11,3,3,0,859,859,856,856
Modoc,37,2022-08-29,1,1,1,0,30,31,30,1,0,0,0,0,9,9,9,9
Mono,37,2022-08-29,2,2,2,0,45,46,45,1,0,0,0,0,7,7,7,7
Monterey,37,2022-08-29,395,395,395,0,5379,5390,5388,2,33,2,2,5,764,764,762,762
Napa,37,2022-08-29,128,128,128,0,2159,2165,2164,1,10,0,0,1,158,158,158,158
Nevada,37,2022-08-29,116,116,116,0,1206,1208,1207,1,6,0,0,0,132,132,132,132
Orange,37,2022-08-29,2949,2955,2955,0,39169,39244,39239,5,195,18,18,25,7452,7452,7434,7434
Placer,37,2022-08-29,370,370,370,0,4210,4217,4216,1,55,1,1,12,658,658,657,657
Plumas,37,2022-08-29,18,18,18,0,159,160,159,1,1,0,0,0,13,13,13,13
Riverside,37,2022-08-29,3649,3656,3655,1,36835,36904,36897,7,124,9,9,11,6615,6615,6606,6606
Sacramento,37,2022-08-29,1855,1860,1860,0,24694,24741,24736,5,137,11,11,20,3291,3291,3280,3280
San Benito,37,2022-08-29,120,120,120,0,1410,1413,1412,1,1,0,0,0,100,100,100,100
San Bernardino,37,2022-08-29,3621,3628,3627,1,42073,42152,42146,6,156,14,14,18,8052,8052,8038,8038
San Diego,37,2022-08-29,3934,3941,3941,0,56591,56697,56694,3,222,12,12,25,5529,5529,5517,5517
San Francisco,37,2022-08-29,875,875,875,0,19135,19171,19163,8,57,7,7,12,1037,1037,1030,1030
San Joaquin,37,2022-08-29,1004,1004,1004,0,14300,14327,14324,3,27,5,5,11,2320,2320,2315,2315
San Luis Obispo,37,2022-08-29,326,326,326,0,3216,3221,3220,1,17,3,3,0,522,522,519,519
San Mateo,37,2022-08-29,852,852,852,0,16779,16811,16809,2,26,0,0,5,736,736,736,736
Santa Barbara,37,2022-08-29,638,638,638,0,7623,7637,7636,1,24,1,1,3,722,722,721,721
Santa Clara,37,2022-08-29,2308,2313,2313,0,39573,39648,39645,3,135,5,5,24,2497,2497,2492,2492
Santa Cruz,37,2022-08-29,384,384,384,0,12676,12700,12698,2,16,0,0,1,273,273,273,273
Shasta,37,2022-08-29,130,130,130,0,2576,2581,2580,1,19,1,1,1,587,587,586,586
Siskiyou,37,2022-08-29,24,24,24,0,249,250,249,1,0,1,1,0,89,89,88,88
Solano,37,2022-08-29,549,549,549,0,7290,7303,7302,1,33,1,1,8,456,456,455,455
Sonoma,37,2022-08-29,486,486,486,0,7105,7118,7117,1,37,1,1,4,520,520,519,519
Stanislaus,37,2022-08-29,848,848,848,0,8083,8099,8097,2,79,7,7,6,1772,1772,1765,1765
Sutter,37,2022-08-29,170,170,170,0,1638,1642,1641,1,0,0,0,0,232,232,232,232
Tehama,37,2022-08-29,66,66,66,0,737,738,737,1,4,0,0,1,212,212,212,212
Trinity,37,2022-08-29,9,9,9,0,56,57,56,1,0,0,0,0,21,21,21,21
Tulare,37,2022-08-29,682,682,682,0,7370,7386,7384,2,42,0,0,1,1532,1532,1532,1532
Tuolumne,37,2022-08-29,91,91,91,0,856,857,856,1,1,0,0,0,199,199,199,199
Ventura,37,2022-08-29,1020,1020,1020,0,14599,14628,14626,2,71,6,6,7,1578,1578,1572,1572
Yolo,37,2022-08-29,204,204,204,0,3714,3721,3720,1,5,0,0,3,389,389,389,389
Yuba,37,2022-08-29,135,135,135,0,1176,1177,1176,1,14,0,0,1,122,122,122,122
Alameda,38,2022-09-05,1435,1436,1436,0,28120,28176,28173,3,89,4,4,16,2037,2037,2033,2033
Amador,38,2022-09-05,44,44,44,0,748,749,748,1,3,0,0,2,91,91,91,91
Butte,38,2022-09-05,193,193,193,0,2122,2126,2125,1,14,2,2,2,459,459,457,457
Calaveras,38,2022-09-05,22,22,22,0,451,452,451,1,0,0,0,0,133,133,133,133
Colusa,38,2022-09-05,8,8,8,0,197,198,197,1,2,0,0,0,22,22,22,22
Contra Costa,38,2022-09-05,955,955,955,0,15426,15455,15452,3,62,5,5,9,1438,1438,1433,1433
Del Norte,38,2022-09-05,9,9,9,0,347,348,347,1,1,0,0,1,55,55,55,55
El Dorado,38,2022-09-05,90,90,90,0,1523,1528,1527,1,3,1,1,3,233,233,232,232
Fresno,38,2022-09-05,1083,1083,1083,0,13052,13077,13075,2,162,10,10,16,2862,2862,2852,2852
Glenn,38,2022-09-05,11,11,11,0,188,189,188,1,1,0,0,0,53,53,53,53
Humboldt,38,2022-09-05,110,110,110,0,1294,1298,1297,1,9,1,1,2,159,159,158,158
Imperial,38,2022-09-05,235,235,235,0,2521,2526,2525,1,8,1,1,2,961,961,960,960
Inyo,38,2022-09-05,12,12,12,0,139,140,139,1,0,0,0,1,59,59,59,59
Kern,38,2022-09-05,719,719,719,0,11238,11259,11257,2,50,5,5,8,2414,2414,2409,2409
Kings,38,2022-09-05,229,229,229,0,2869,2875,2874,1,8,0,0,0,461,461,461,461
Lake,38,2022-09-05,62,62,62,0,655,656,655,1,1,3,3,1,148,148,145,145
Lassen,38,2022-09-05,19,19,19,0,633,634,633,1,0,0,0,0,63,63,63,63
Los Angeles,38,2022-09-05,10669,10690,10690,0,221979,222418,222408,10,695,96,96,91,33378,33378,33282,33282
Madera,38,2022-09-05,205,205,205,0,2505,2510,2509,1,12,0,0,4,373,373,373,373
Marin,38,2022-09-05,191,191,191,0,3557,3563,3562,1,12,0,0,1,313,313,313,313
Mariposa,38,2022-09-05,16,16,16,0,166,167,166,1,0,0,0,0,29,29,29,29
Mendocino,38,2022-09-05,57,57,57,0,828,829,828,1,2,1,1,1,136,136,135,135
Merced,38,2022-09-05,251,251,251,0,2637,2642,2641,1,12,2,2,1,861,861,859,859
Modoc,38,2022-09-05,3,3,3,0,17,18,17,1,0,0,0,0,9,9,9,9
Mono,38,2022-09-05,4,4,4,0,52,53,52,1,1,0,0,0,7,7,7,7
Monterey,38,2022-09-05,245,245,245,0,4379,4389,4388,1,24,4,4,0,768,768,764,764
Napa,38,2022-09-05,102,102,102,0,1725,1730,1729,1,6,1,1,2,159,159,158,158
Nevada,38,2022-09-05,81,81,81,0,899,900,899,1,3,0,0,0,132,132,132,132
Orange,38,2022-09-05,2171,2175,2175,0,32128,32192,32189,3,169,13,13,34,7465,7465,7452,7452
Placer,38,2022-09-05,238,238,238,0,3469,3476,3475,1,36,0,0,4,658,658,658,658
Plumas,38,2022-09-05,9,9,9,0,130,131,130,1,0,0,0,0,13,13,13,13
Riverside,38,2022-09-05,2402,2406,2406,0,28561,28618,28614,4,99,7,7,14,6622,6622,6615,6615
Sacramento,38,2022-09-05,1243,1244,1244,0,19661,19698,19695,3,139,12,12,22,3303,3303,3291,3291
San Benito,38,2022-09-05,65,65,65,0,1086,1088,1087,1,0,0,0,2,100,100,100,100
San Bernardino,38,2022-09-05,2333,2337,2337,0,34203,34270,34266,4,122,14,14,19,8066,8066,8052,8052
San Diego,38,2022-09-05,2801,2806,2806,0,48218,48314,48312,2,212,15,15,25,5544,5544,5529,5529
San Francisco,38,2022-09-05,678,678,678,0,15724,15755,15750,5,52,9,9,9,1046,1046,1037,1037
San Joaquin,38,2022-09-05,831,831,831,0,11953,11976,11974,2,43,4,4,10,2324,2324,2320,2320
San Luis Obispo,38,2022-09-05,176,176,176,0,2676,2681,2680,1,7,2,2,1,524,524,522,522
San Mateo,38,2022-09-05,611,611,611,0,13543,13570,13569,1,23,1,1,2,737,737,736,736
Santa Barbara,38,2022-09-05,485,485,485,0,6632,6645,6644,1,39,4,4,3,726,726,722,722
Santa Clara,38,2022-09-05,1892,1896,1896,0,33058,33123,33121,2,127,10,10,20,2507,2507,2497,2497
Santa Cruz,38,2022-09-05,282,282,282,0,10218,10239,10238,1,16,0,0,0,273,273,273,273
Shasta,38,2022-09-05,103,103,103,0,2022,2026,2025,1,15,0,0,0,587,587,587,587
Siskiyou,38,2022-09-05,30,30,30,0,216,217,216,1,0,0,0,0,89,89,89,89
Solano,38,2022-09-05,368,368,368,0,5962,5975,5974,1,34,1,1,11,457,457,456,456
Sonoma,38,2022-09-05,368,368,368,0,6002,6015,6014,1,40,0,0,2,520,520,520,520
Stanislaus,38,2022-09-05,547,547,547,0,6347,6359,6358,1,69,5,5,4,1777,1777,1772,1772
Sutter,38,2022-09-05,118,118,118,0,1482,1485,1484,1,0,0,0,0,232,232,232,232
Tehama,38,2022-09-05,50,50,50,0,581,582,581,1,2,1,1,0,213,213,212,212
Trinity,38,2022-09-05,4,4,4,0,51,52,51,1,0,0,0,0,21,21,21,21
Tulare,38,2022-09-05,429,429,429,0,5163,5172,5171,1,37,2,2,1,1534,1534,1532,1532
Tuolumne,38,2022-09-05,68,68,68,0,737,738,737,1,1,0,0,0,199,199,199,199
Ventura,38,2022-09-05,864,864,864,0,12305,12330,12329,1,48,8,8,1,1586,1586,1578,1578
Yolo,38,2022-09-05,140,140,140,0,2902,2908,2907,1,1,3,3,2,392,392,389,389
Yuba,38,2022-09-05,88,88,88,0,975,976,975,1,14,0,0,1,122,122,122,122
Alameda,39,2022-09-12,1608,1612,1612,0,32012,32078,32075,3,94,5,5,16,2042,2042,2037,2037
Amador,39,2022-09-12,32,32,32,0,873,874,873,1,3,0,0,2,91,91,91,91
Butte,39,2022-09-12,196,196,196,0,2466,2472,2471,1,15,3,3,2,462,462,459,459
Calaveras,39,2022-09-12,14,14,14,0,501,502,501,1,1,0,0,0,133,133,133,133
Colusa,39,2022-09-12,17,17,17,0,414,415,414,1,0,0,0,0,22,22,22,22
Contra Costa,39,2022-09-12,979,979,979,0,17329,17365,17362,3,59,6,6,12,1444,1444,1438,1438
Del Norte,39,2022-09-12,34,34,34,0,595,596,595,1,1,0,0,1,55,55,55,55
El Dorado,39,2022-09-12,104,104,104,0,1899,1905,1904,1,3,0,0,1,233,233,233,233
Fresno,39,2022-09-12,906,906,906,0,14677,14708,14706,2,155,6,6,15,2868,2868,2862,2862
Glenn,39,2022-09-12,15,15,15,0,208,209,208,1,0,0,0,0,53,53,53,53
Humboldt,39,2022-09-12,113,113,113,0,1652,1657,1656,1,6,0,0,5,159,159,159,159
Imperial,39,2022-09-12,258,258,258,0,3287,3294,3293,1,10,0,0,2,961,961,961,961
Inyo,39,2022-09-12,15,15,15,0,194,195,194,1,0,1,1,0,60,60,59,59
Kern,39,2022-09-12,638,638,638,0,12821,12847,12846,1,45,7,7,13,2421,2421,2414,2414
Kings,39,2022-09-12,229,229,229,0,3171,3177,3176,1,6,1,1,0,462,462,461,461
Lake,39,2022-09-12,48,48,48,0,882,884,883,1,3,0,0,1,148,148,148,148
Lassen,39,2022-09-12,20,20,20,0,917,919,918,1,0,0,0,0,63,63,63,63
Los Angeles,39,2022-09-12,10979,11002,11002,0,282448,283033,283023,10,652,85,85,83,33463,33463,33378,33378
Madera,39,2022-09-12,242,242,242,0,2923,2929,2928,1,8,0,0,3,373,373,373,373
Marin,39,2022-09-12,174,174,174,0,3912,3921,3920,1,12,2,2,2,315,315,313,313
Mariposa,39,2022-09-12,16,16,16,0,192,193,192,1,0,0,0,0,29,29,29,29
Mendocino,39,2022-09-12,58,58,58,0,952,953,952,1,2,0,0,1,136,136,136,136
Merced,39,2022-09-12,237,237,237,0,3317,3324,3323,1,6,2,2,1,863,863,861,861
Modoc,39,2022-09-12,2,2,2,0,22,23,22,1,0,0,0,0,9,9,9,9
Mono,39,2022-09-12,7,7,7,0,76,77,76,1,0,0,0,0,7,7,7,7
Monterey,39,2022-09-12,229,229,229,0,5123,5135,5134,1,22,1,1,1,769,769,768,768
Napa,39,2022-09-12,119,119,119,0,2249,2255,2254,1,10,0,0,1,159,159,159,159
Nevada,39,2022-09-12,61,61,61,0,1179,1182,1181,1,2,0,0,0,132,132,132,132
Orange,39,2022-09-12,2093,2098,2098,0,36677,36754,36751,3,159,27,27,22,7492,7492,7465,7465
Placer,39,2022-09-12,239,239,239,0,4074,4083,4082,1,38,0,0,5,658,658,658,658
Plumas,39,2022-09-12,22,22,22,0,194,195,194,1,1,0,0,0,13,13,13,13
Riverside,39,2022-09-12,2249,2254,2254,0,32986,33054,33050,4,124,5,5,12,6627,6627,6622,6622
Sacramento,39,2022-09-12,1275,1276,1276,0,23403,23452,23449,3,119,16,16,15,3319,3319,3303,3303
San Benito,39,2022-09-12,93,93,93,0,1503,1507,1506,1,1,0,0,1,100,100,100,100
San Bernardino,39,2022-09-12,1929,1934,1934,0,38560,38640,38637,3,92,13,13,26,8079,8079,8066,8066
San Diego,39,2022-09-12,3034,3040,3040,0,55707,55822,55820,2,194,7,7,24,5551,5551,5544,5544
San Francisco,39,2022-09-12,813,813,813,0,17414,17451,17447,4,58,8,8,15,1054,1054,1046,1046
San Joaquin,39,2022-09-12,643,643,643,0,14275,14305,14303,2,35,6,6,9,2330,2330,2324,2324
San Luis Obispo,39,2022-09-12,187,187,187,0,3219,3226,3225,1,10,0,0,1,524,524,524,524
San Mateo,39,2022-09-12,658,658,658,0,14178,14207,14206,1,20,1,1,2,738,738,737,737
Santa Barbara,39,2022-09-12,329,329,329,0,7232,7247,7246,1,27,1,1,2,727,727,726,726
Santa Clara,39,2022-09-12,1882,1887,1887,0,38056,38135,38134,1,144,8,8,28,2515,2515,2507,2507
Santa Cruz,39,2022-09-12,272,272,272,0,13346,13374,13373,1,15,0,0,0,273,273,273,273
Shasta,39,2022-09-12,181,181,181,0,2589,2595,2594,1,26,1,1,2,588,588,587,587
Siskiyou,39,2022-09-12,27,27,27,0,289,290,289,1,1,0,0,0,89,89,89,89
Solano,39,2022-09-12,416,416,416,0,6739,6753,6752,1,32,0,0,4,457,457,457,457
Sonoma,39,2022-09-12,397,397,397,0,7021,7035,7034,1,39,3,3,1,523,523,520,520
Stanislaus,39,2022-09-12,447,447,447,0,7741,7756,7755,1,73,1,1,4,1778,1778,1777,1777
Sutter,39,2022-09-12,119,119,119,0,1531,1534,1533,1,0,0,0,0,232,232,232,232
Tehama,39,2022-09-12,48,48,48,0,699,700,699,1,2,0,0,0,213,213,213,213
Trinity,39,2022-09-12,2,2,2,0,74,75,74,1,0,0,0,0,21,21,21,21
Tulare,39,2022-09-12,370,370,370,0,6886,6900,6899,1,39,4,4,0,1538,1538,1534,1534
Tuolumne,39,2022-09-12,61,61,61,0,810,811,810,1,2,0,0,1,199,199,199,199
Ventura,39,2022-09-12,842,842,842,0,14804,14834,14833,1,49,1,1,7,1587,1587,1586,1586
Yolo,39,2022-09-12,143,143,143,0,3448,3456,3455,1,1,2,2,3,394,394,392,392
Yuba,39,2022-09-12,93,93,93,0,1162,1163,1162,1,6,0,0,0,122,122,122,122
Alameda,40,2022-09-19,1227,1227,1227,0,29125,29188,29186,2,80,4,4,7,2046,2046,2042,2042
Amador,40,2022-09-19,33,33,33,0,759,760,759,1,1,3,3,1,94,94,91,91
Butte,40,2022-09-19,121,121,121,0,2119,2125,2124,1,18,0,0,1,462,462,462,462
Calaveras,40,2022-09-19,28,28,28,0,476,477,476,1,0,0,0,0,133,133,133,133
Colusa,40,2022-09-19,13,13,13,0,289,290,289,1,3,0,0,0,22,22,22,22
Contra Costa,40,2022-09-19,828,828,828,0,16771,16808,16806,2,52,8,8,8,1452,1452,1444,1444
Del Norte,40,2022-09-19,22,22,22,0,478,479,478,1,2,0,0,0,55,55,55,55
El Dorado,40,2022-09-19,79,79,79,0,1616,1621,1620,1,3,0,0,0,233,233,233,233
Fresno,40,2022-09-19,605,605,605,0,13301,13329,13328,1,110,7,7,14,2875,2875,2868,2868
Glenn,40,2022-09-19,14,14,14,0,201,202,201,1,2,0,0,0,53,53,53,53
Humboldt,40,2022-09-19,105,105,105,0,1457,1462,1461,1,8,0,0,3,159,159,159,159
Imperial,40,2022-09-19,150,150,150,0,2866,2872,2871,1,11,0,0,2,961,961,961,961
Inyo,40,2022-09-19,8,8,8,0,169,170,169,1,0,0,0,0,60,60,60,60
Kern,40,2022-09-19,440,440,440,0,11537,11562,11561,1,34,2,2,6,2423,2423,2421,2421
Kings,40,2022-09-19,137,137,137,0,2642,2648,2647,1,7,2,2,0,464,464,462,462
Lake,40,2022-09-19,37,37,37,0,903,904,903,1,0,0,0,0,148,148,148,148
Lassen,40,2022-09-19,7,7,7,0,704,705,704,1,0,0,0,0,63,63,63,63
Los Angeles,40,2022-09-19,8526,8545,8545,0,254629,255184,255177,7,564,65,65,69,33528,33528,33463,33463
Madera,40,2022-09-19,109,109,109,0,2691,2697,2696,1,9,1,1,2,374,374,373,373
Marin,40,2022-09-19,137,137,137,0,3701,3711,3710,1,6,0,0,0,315,315,315,315
Mariposa,40,2022-09-19,12,12,12,0,170,171,170,1,0,1,1,0,30,30,29,29
Mendocino,40,2022-09-19,43,43,43,0,928,929,928,1,0,0,0,1,136,136,136,136
Merced,40,2022-09-19,170,170,170,0,2911,2917,2916,1,8,3,3,1,866,866,863,863
Modoc,40,2022-09-19,2,2,2,0,17,18,17,1,0,0,0,0,9,9,9,9
Mono,40,2022-09-19,4,4,4,0,63,64,63,1,0,0,0,0,7,7,7,7
Monterey,40,2022-09-19,162,162,162,0,4268,4278,4277,1,14,1,1,2,770,770,769,769
Napa,40,2022-09-19,101,101,101,0,1772,1778,1777,1,4,0,0,0,159,159,159,159
Nevada,40,2022-09-19,66,66,66,0,1110,1112,1111,1,2,0,0,0,132,132,132,132
Orange,40,2022-09-19,1722,1727,1727,0,33954,34028,34026,2,129,16,16,19,7508,7508,7492,7492
Placer,40,2022-09-19,223,223,223,0,3830,3839,3838,1,51,1,1,4,659,659,658,658
Plumas,40,2022-09-19,22,22,22,0,183,184,183,1,1,0,0,0,13,13,13,13
Riverside,40,2022-09-19,1416,1419,1419,0,29083,29146,29144,2,68,4,4,19,6631,6631,6627,6627
Sacramento,40,2022-09-19,1018,1018,1018,0,21293,21339,21337,2,102,7,7,17,3326,3326,3319,3319
San Benito,40,2022-09-19,54,54,54,0,1231,1234,1233,1,0,0,0,0,100,100,100,100
San Bernardino,40,2022-09-19,1464,1467,1467,0,32527,32598,32596,2,83,7,7,19,8086,8086,8079,8079
San Diego,40,2022-09-19,2562,2568,2568,0,55905,56026,56024,2,175,9,9,19,5560,5560,5551,5551
San Francisco,40,2022-09-19,690,690,690,0,16822,16859,16856,3,43,9,9,11,1063,1063,1054,1054
San Joaquin,40,2022-09-19,457,457,457,0,12858,12886,12885,1,35,5,5,2,2335,2335,2330,2330
San Luis Obispo,40,2022-09-19,155,155,155,0,2764,2770,2769,1,8,0,0,0,524,524,524,524
San Mateo,40,2022-09-19,585,585,585,0,13587,13617,13616,1,20,0,0,2,738,738,738,738
Santa Barbara,40,2022-09-19,269,269,269,0,6790,6804,6803,1,34,2,2,0,729,729,727,727
Santa Clara,40,2022-09-19,1415,1417,1417,0,37023,37103,37102,1,137,7,7,21,2522,2522,2515,2515
Santa Cruz,40,2022-09-19,148,148,148,0,12319,12346,12345,1,5,0,0,1,273,273,273,273
Shasta,40,2022-09-19,100,100,100,0,2112,2118,2117,1,21,0,0,3,588,588,588,588
Siskiyou,40,2022-09-19,21,21,21,0,233,234,233,1,2,1,1,0,90,90,89,89
Solano,40,2022-09-19,274,274,274,0,6128,6141,6140,1,24,1,1,5,458,458,457,457
Sonoma,40,2022-09-19,319,319,319,0,6359,6373,6372,1,27,3,3,1,526,526,523,523
Stanislaus,40,2022-09-19,333,333,333,0,6290,6304,6303,1,57,4,4,4,1782,1782,1778,1778
Sutter,40,2022-09-19,75,75,75,0,1388,1391,1390,1,0,0,0,0,232,232,232,232
Tehama,40,2022-09-19,35,35,35,0,599,600,599,1,2,1,1,0,214,214,213,213
Trinity,40,2022-09-19,3,3,3,0,53,54,53,1,0,0,0,0,21,21,21,21
Tulare,40,2022-09-19,234,234,234,0,5725,5737,5736,1,32,1,1,0,1539,1539,1538,1538
Tuolumne,40,2022-09-19,59,59,59,0,717,718,717,1,0,0,0,0,199,199,199,199
Ventura,40,2022-09-19,615,615,615,0,13372,13401,13400,1,42,2,2,6,1589,1589,1587,1587
Yolo,40,2022-09-19,83,83,83,0,3730,3738,3737,1,2,3,3,2,397,397,394,394
Yuba,40,2022-09-19,60,60,60,0,1029,1030,1029,1,3,0,0,0,122,122,122,122
Alameda,41,2022-09-26,1129,1130,1130,0,27663,27725,27724,1,77,2,2,4,2048,2048,2046,2046
Amador,41,2022-09-26,27,27,27,0,721,722,721,1,1,0,0,1,94,94,94,94
Butte,41,2022-09-26,90,90,90,0,1792,1797,1796,1,23,0,0,1,462,462,462,462
Calaveras,41,2022-09-26,20,20,20,0,390,391,390,1,2,1,1,0,134,134,133,133
Colusa,41,2022-09-26,7,7,7,0,299,300,299,1,1,0,0,0,22,22,22,22
Contra Costa,41,2022-09-26,782,782,782,0,16343,16381,16380,1,48,5,5,7,1457,1457,1452,1452
Del Norte,41,2022-09-26,22,22,22,0,469,470,469,1,2,0,0,0,55,55,55,55
El Dorado,41,2022-09-26,86,86,86,0,1580,1584,1583,1,5,0,0,0,233,233,233,233
Fresno,41,2022-09-26,517,517,517,0,12119,12147,12146,1,84,3,3,13,2878,2878,2875,2875
Glenn,41,2022-09-26,7,7,7,0,176,177,176,1,2,0,0,0,53,53,53,53
Humboldt,41,2022-09-26,98,98,98,0,1311,1314,1313,1,10,2,2,0,161,161,159,159
Imperial,41,2022-09-26,115,115,115,0,2628,2634,2633,1,4,1,1,1,962,962,961,961
Inyo,41,2022-09-26,5,5,5,0,165,166,165,1,0,0,0,0,60,60,60,60
Kern,41,2022-09-26,344,344,344,0,10734,10757,10756,1,32,3,3,7,2426,2426,2423,2423
Kings,41,2022-09-26,107,107,107,0,2620,2626,2625,1,2,0,0,0,464,464,464,464
Lake,41,2022-09-26,26,26,26,0,815,817,816,1,0,0,0,0,148,148,148,148
Lassen,41,2022-09-26,13,13,13,0,533,534,533,1,0,0,0,0,63,63,63,63
Los Angeles,41,2022-09-26,7697,7715,7715,0,239298,239844,239839,5,443,63,63,53,33591,33591,33528,33528
Madera,41,2022-09-26,84,84,84,0,2231,2236,2235,1,8,0,0,2,374,374,374,374
Marin,41,2022-09-26,173,173,173,0,3657,3666,3665,1,10,0,0,0,315,315,315,315
Mariposa,41,2022-09-26,4,4,4,0,155,156,155,1,0,0,0,0,30,30,30,30
Mendocino,41,2022-09-26,41,41,41,0,850,851,850,1,1,0,0,0,136,136,136,136
Merced,41,2022-09-26,127,127,127,0,2854,2861,2860,1,10,1,1,0,867,867,866,866
Modoc,41,2022-09-26,0,0,0,0,13,14,13,1,0,0,0,0,9,9,9,9
Mono,41,2022-09-26,1,1,1,0,60,61,60,1,0,0,0,0,7,7,7,7
Monterey,41,2022-09-26,135,135,135,0,4050,4060,4059,1,14,0,0,2,770,770,770,770
Napa,41,2022-09-26,85,85,85,0,1955,1961,1960,1,5,0,0,1,159,159,159,159
Nevada,41,2022-09-26,49,49,49,0,1077,1079,1078,1,1,0,0,0,132,132,132,132
Orange,41,2022-09-26,1672,1677,1677,0,31082,31152,31150,2,117,19,19,23,7527,7527,7508,7508
Placer,41,2022-09-26,209,209,209,0,3592,3601,3600,1,42,1,1,4,660,660,659,659
Plumas,41,2022-09-26,21,21,21,0,151,152,151,1,1,0,0,0,13,13,13,13
Riverside,41,2022-09-26,1280,1282,1282,0,25779,25838,25836,2,55,8,8,15,6639,6639,6631,6631
Sacramento,41,2022-09-26,918,918,918,0,19151,19195,19194,1,106,11,11,20,3337,3337,3326,3326
San Benito,41,2022-09-26,50,50,50,0,1160,1163,1162,1,0,1,1,2,101,101,100,100
San Bernardino,41,2022-09-26,1217,1218,1218,0,27810,27873,27872,1,75,5,5,12,8091,8091,8086,8086
San Diego,41,2022-09-26,2484,2490,2490,0,50929,51045,51044,1,201,7,7,15,5567,5567,5560,5560
San Francisco,41,2022-09-26,678,678,678,0,16151,16188,16186,2,45,2,2,9,1065,1065,1063,1063
San Joaquin,41,2022-09-26,408,408,408,0,11073,11098,11097,1,35,1,1,3,2336,2336,2335,2335
San Luis Obispo,41,2022-09-26,131,131,131,0,2520,2526,2525,1,7,1,1,0,525,525,524,524
San Mateo,41,2022-09-26,593,593,593,0,13030,13060,13059,1,25,0,0,1,738,738,738,738
Santa Barbara,41,2022-09-26,259,259,259,0,6379,6396,6395,1,22,2,2,0,731,731,729,729
Santa Clara,41,2022-09-26,1363,1365,1365,0,35857,35938,35937,1,113,10,10,17,2532,2532,2522,2522
Santa Cruz,41,2022-09-26,224,224,224,0,12503,12530,12529,1,13,0,0,0,273,273,273,273
Shasta,41,2022-09-26,74,74,74,0,1739,1744,1743,1,14,0,0,3,588,588,588,588
Siskiyou,41,2022-09-26,18,18,18,0,183,184,183,1,1,2,2,0,92,92,90,90
Solano,41,2022-09-26,310,310,310,0,5728,5742,5741,1,23,1,1,2,459,459,458,458
Sonoma,41,2022-09-26,291,291,291,0,6334,6349,6348,1,31,1,1,2,527,527,526,526
Stanislaus,41,2022-09-26,261,261,261,0,5812,5826,5825,1,46,2,2,3,1784,1784,1782,1782
Sutter,41,2022-09-26,69,69,69,0,1146,1148,1147,1,0,0,0,0,232,232,232,232
Tehama,41,2022-09-26,36,36,36,0,550,551,550,1,1,2,2,0,216,216,214,214
Trinity,41,2022-09-26,3,3,3,0,44,45,44,1,0,0,0,0,21,21,21,21
Tulare,41,2022-09-26,168,168,168,0,5090,5101,5100,1,18,3,3,2,1542,1542,1539,1539
Tuolumne,41,2022-09-26,44,44,44,0,689,690,689,1,1,0,0,0,199,199,199,199
Ventura,41,2022-09-26,551,551,551,0,11570,11597,11596,1,33,4,4,1,1593,1593,1589,1589
Yolo,41,2022-09-26,129,129,129,0,3977,3987,3986,1,2,3,3,3,400,400,397,397
Yuba,41,2022-09-26,41,41,41,0,933,934,933,1,6,0,0,1,122,122,122,122
Alameda,42,2022-10-03,1123,1124,1124,0,26140,26203,26202,1,54,3,3,5,2051,2051,2048,2048
Amador,42,2022-10-03,14,14,14,0,690,692,691,1,0,0,0,1,94,94,94,94
Butte,42,2022-10-03,67,67,67,0,1751,1756,1755,1,11,2,2,2,464,464,462,462
Calaveras,42,2022-10-03,20,20,20,0,336,337,336,1,1,0,0,0,134,134,134,134
Colusa,42,2022-10-03,7,7,7,0,188,189,188,1,0,0,0,0,22,22,22,22
Contra Costa,42,2022-10-03,742,742,742,0,15771,15810,15809,1,34,3,3,6,1460,1460,1457,1457
Del Norte,42,2022-10-03,12,12,12,0,382,383,382,1,1,0,0,1,55,55,55,55
El Dorado,42,2022-10-03,80,80,80,0,1449,1454,1453,1,3,0,0,1,233,233,233,233
Fresno,42,2022-10-03,462,462,462,0,11208,11235,11234,1,77,2,2,11,2880,2880,2878,2878
Glenn,42,2022-10-03,7,7,7,0,155,156,155,1,0,0,0,0,53,53,53,53
Humboldt,42,2022-10-03,79,79,79,0,1157,1161,1160,1,6,0,0,1,161,161,161,161
Imperial,42,2022-10-03,140,140,140,0,2564,2570,2569,1,6,0,0,0,962,962,962,962
Inyo,42,2022-10-03,5,5,5,0,159,160,159,1,0,0,0,1,60,60,60,60
Kern,42,2022-10-03,285,285,285,0,9961,9987,9986,1,24,4,4,5,2430,2430,2426,2426
Kings,42,2022-10-03,87,87,87,0,2414,2420,2419,1,2,0,0,0,464,464,464,464
Lake,42,2022-10-03,35,35,35,0,759,760,759,1,3,1,1,0,149,149,148,148
Lassen,42,2022-10-03,7,7,7,0,530,531,530,1,2,0,0,0,63,63,63,63
Los Angeles,42,2022-10-03,7002,7020,7020,0,220017,220546,220542,4,439,50,50,69,33641,33641,33591,33591
Madera,42,2022-10-03,65,65,65,0,1563,1568,1567,1,6,0,0,2,374,374,374,374
Marin,42,2022-10-03,191,191,191,0,3475,3484,3483,1,6,0,0,2,315,315,315,315
Mariposa,42,2022-10-03,5,5,5,0,131,132,131,1,0,0,0,0,30,30,30,30
Mendocino,42,2022-10-03,50,50,50,0,778,779,778,1,4,0,0,0,136,136,136,136
Merced,42,2022-10-03,109,109,109,0,2610,2616,2615,1,5,3,3,1,870,870,867,867
Modoc,42,2022-10-03,2,2,2,0,14,15,14,1,0,0,0,0,9,9,9,9
Mono,42,2022-10-03,4,4,4,0,69,70,69,1,0,0,0,0,7,7,7,7
Monterey,42,2022-10-03,111,111,111,0,3785,3796,3795,1,11,1,1,1,771,771,770,770
Napa,42,2022-10-03,88,88,88,0,1698,1704,1703,1,4,0,0,2,159,159,159,159
Nevada,42,2022-10-03,51,51,51,0,954,956,955,1,1,0,0,4,132,132,132,132
Orange,42,2022-10-03,1533,1538,1538,0,27925,27992,27991,1,131,22,22,16,7549,7549,7527,7527
Placer,42,2022-10-03,208,208,208,0,3336,3345,3344,1,41,2,2,3,662,662,660,660
Plumas,42,2022-10-03,12,12,12,0,107,108,107,1,1,0,0,0,13,13,13,13
Riverside,42,2022-10-03,1138,1138,1138,0,22050,22103,22102,1,59,7,7,12,6646,6646,6639,6639
Sacramento,42,2022-10-03,901,901,901,0,18059,18102,18101,1,88,12,12,19,3349,3349,3337,3337
San Benito,42,2022-10-03,34,34,34,0,1105,1108,1107,1,0,0,0,0,101,101,101,101
San Bernardino,42,2022-10-03,1210,1212,1212,0,24838,24897,24896,1,77,4,4,7,8095,8095,8091,8091
San Diego,42,2022-10-03,2085,2091,2091,0,46607,46720,46719,1,162,9,9,18,5576,5576,5567,5567
San Francisco,42,2022-10-03,646,646,646,0,15333,15370,15368,2,44,3,3,9,1068,1068,1065,1065
San Joaquin,42,2022-10-03,343,343,343,0,9932,9955,9954,1,25,4,4,3,2340,2340,2336,2336
San Luis Obispo,42,2022-10-03,150,150,150,0,2382,2388,2387,1,2,1,1,1,526,526,525,525
San Mateo,42,2022-10-03,549,549,549,0,12299,12330,12329,1,22,0,0,2,738,738,738,738
Santa Barbara,42,2022-10-03,253,253,253,0,6288,6304,6303,1,15,0,0,2,731,731,731,731
Santa Clara,42,2022-10-03,1403,1406,1406,0,32167,32244,32243,1,109,6,6,20,2538,2538,2532,2532
Santa Cruz,42,2022-10-03,227,227,227,0,11229,11255,11254,1,10,0,0,1,273,273,273,273
Shasta,42,2022-10-03,55,55,55,0,1441,1445,1444,1,10,0,0,2,588,588,588,588
Siskiyou,42,2022-10-03,10,10,10,0,204,205,204,1,0,0,0,0,92,92,92,92
Solano,42,2022-10-03,251,251,251,0,5361,5375,5374,1,17,0,0,2,459,459,459,459
Sonoma,42,2022-10-03,323,323,323,0,5932,5947,5946,1,17,0,0,3,527,527,527,527
Stanislaus,42,2022-10-03,200,200,200,0,5353,5368,5367,1,49,1,1,6,1785,1785,1784,1784
Sutter,42,2022-10-03,57,57,57,0,1108,1111,1110,1,0,0,0,0,232,232,232,232
Tehama,42,2022-10-03,20,20,20,0,526,527,526,1,1,0,0,0,216,216,216,216
Trinity,42,2022-10-03,1,1,1,0,43,44,43,1,0,0,0,0,21,21,21,21
Tulare,42,2022-10-03,163,163,163,0,5046,5058,5057,1,19,4,4,1,1546,1546,1542,1542
Tuolumne,42,2022-10-03,26,26,26,0,622,623,622,1,0,0,0,0,199,199,199,199
Ventura,42,2022-10-03,477,477,477,0,10424,10449,10448,1,41,2,2,2,1595,1595,1593,1593
Yolo,42,2022-10-03,122,122,122,0,2985,2992,2991,1,3,2,2,2,402,402,400,400
Yuba,42,2022-10-03,35,35,35,0,801,802,801,1,4,0,0,1,122,122,122,122
Alameda,43,2022-10-10,1131,1131,1131,0,27784,27855,27854,1,45,2,2,7,2053,2053,2051,2051
Amador,43,2022-10-10,15,15,15,0,801,802,801,1,0,0,0,2,94,94,94,94
Butte,43,2022-10-10,65,65,65,0,1750,1754,1753,1,12,3,3,1,466,466,463,463
Calaveras,43,2022-10-10,15,15,15,0,374,375,374,1,0,1,1,0,135,135,134,134
Colusa,43,2022-10-10,1,1,1,0,120,121,120,1,1,0,0,0,22,22,22,22
Contra Costa,43,2022-10-10,775,775,775,0,16851,16893,16892,1,31,7,7,6,1465,1465,1458,1458
Del Norte,43,2022-10-10,10,10,10,0,492,493,492,1,1,0,0,1,55,55,55,55
El Dorado,43,2022-10-10,81,81,81,0,1748,1755,1754,1,7,0,0,4,233,233,233,233
Fresno,43,2022-10-10,483,483,483,0,12471,12504,12503,1,60,3,3,9,2883,2883,2880,2880
Glenn,43,2022-10-10,10,10,10,0,226,227,226,1,1,0,0,0,53,53,53,53
Humboldt,43,2022-10-10,98,98,98,0,1418,1423,1422,1,7,1,1,0,162,162,161,161
Imperial,43,2022-10-10,203,203,203,0,2960,2967,2966,1,7,0,0,0,962,962,962,962
Inyo,43,2022-10-10,4,4,4,0,123,124,123,1,0,0,0,0,60,60,60,60
Kern,43,2022-10-10,325,325,325,0,11655,11685,11684,1,24,2,2,2,2432,2432,2430,2430
Kings,43,2022-10-10,102,102,102,0,2751,2759,2758,1,1,1,1,0,465,465,464,464
Lake,43,2022-10-10,33,33,33,0,920,921,920,1,1,0,0,0,149,149,149,149
Lassen,43,2022-10-10,3,3,3,0,573,574,573,1,0,0,0,0,63,63,63,63
Los Angeles,43,2022-10-10,6727,6745,6745,0,226549,227127,227124,3,436,70,70,51,33703,33703,33633,33633
Madera,43,2022-10-10,68,68,68,0,1717,1723,1722,1,7,1,1,2,375,375,374,374
Marin,43,2022-10-10,207,207,207,0,3777,3787,3786,1,9,0,0,0,315,315,315,315
Mariposa,43,2022-10-10,8,8,8,0,128,129,128,1,0,0,0,0,30,30,30,30
Mendocino,43,2022-10-10,32,32,32,0,973,974,973,1,1,0,0,2,136,136,136,136
Merced,43,2022-10-10,111,111,111,0,2788,2795,2794,1,8,1,1,3,871,871,870,870
Modoc,43,2022-10-10,5,5,5,0,12,13,12,1,0,0,0,0,9,9,9,9
Mono,43,2022-10-10,1,1,1,0,55,56,55,1,0,0,0,0,7,7,7,7
Monterey,43,2022-10-10,108,108,108,0,4372,4385,4384,1,9,0,0,1,771,771,771,771
Napa,43,2022-10-10,78,78,78,0,1766,1773,1772,1,3,0,0,2,159,159,159,159
Nevada,43,2022-10-10,42,42,42,0,980,981,980,1,1,0,0,1,132,132,132,132
Orange,43,2022-10-10,1476,1480,1480,0,29654,29731,29730,1,129,14,14,19,7561,7561,7547,7547
Placer,43,2022-10-10,187,187,187,0,3819,3830,3829,1,24,0,0,7,662,662,662,662
Plumas,43,2022-10-10,20,20,20,0,106,107,106,1,0,0,0,0,13,13,13,13
Riverside,43,2022-10-10,1177,1179,1179,0,23898,23958,23957,1,56,5,5,4,6651,6651,6646,6646
Sacramento,43,2022-10-10,943,943,943,0,20312,20364,20363,1,81,5,5,16,3354,3354,3349,3349
San Benito,43,2022-10-10,35,35,35,0,1267,1271,1270,1,3,0,0,0,101,101,101,101
San Bernardino,43,2022-10-10,1096,1096,1096,0,27130,27198,27197,1,66,0,0,13,8095,8095,8095,8095
San Diego,43,2022-10-10,1991,1997,1997,0,51325,51457,51456,1,130,7,7,21,5581,5581,5574,5574
San Francisco,43,2022-10-10,689,689,689,0,16055,16096,16095,1,37,2,2,9,1070,1070,1068,1068
San Joaquin,43,2022-10-10,431,431,431,0,11577,11606,11605,1,17,2,2,8,2342,2342,2340,2340
San Luis Obispo,43,2022-10-10,88,88,88,0,2567,2574,2573,1,2,2,2,0,528,528,526,526
San Mateo,43,2022-10-10,647,647,647,0,13627,13664,13663,1,19,0,0,0,738,738,738,738
Santa Barbara,43,2022-10-10,242,242,242,0,7841,7861,7860,1,20,1,1,1,732,732,731,731
Santa Clara,43,2022-10-10,1423,1426,1426,0,34086,34174,34173,1,107,4,4,18,2542,2542,2538,2538
Santa Cruz,43,2022-10-10,338,338,338,0,12278,12310,12309,1,9,0,0,1,273,273,273,273
Shasta,43,2022-10-10,99,99,99,0,1292,1296,1295,1,13,3,3,1,591,591,588,588
Siskiyou,43,2022-10-10,9,9,9,0,244,245,244,1,0,1,1,0,93,93,92,92
Solano,43,2022-10-10,333,333,333,0,6280,6297,6296,1,23,0,0,4,459,459,459,459
Sonoma,43,2022-10-10,288,288,288,0,6771,6788,6787,1,15,1,1,3,528,528,527,527
Stanislaus,43,2022-10-10,208,208,208,0,5925,5941,5940,1,51,7,7,7,1790,1790,1783,1783
Sutter,43,2022-10-10,57,57,57,0,1126,1128,1127,1,0,0,0,0,232,232,232,232
Tehama,43,2022-10-10,21,21,21,0,566,567,566,1,1,0,0,0,216,216,216,216
Trinity,43,2022-10-10,1,1,1,0,53,54,53,1,0,0,0,0,21,21,21,21
Tulare,43,2022-10-10,170,170,170,0,4979,4991,4990,1,16,1,1,1,1547,1547,1546,1546
Tuolumne,43,2022-10-10,36,36,36,0,661,662,661,1,1,1,1,0,200,200,199,199
Ventura,43,2022-10-10,430,430,430,0,10969,10997,10996,1,41,4,4,1,1598,1598,1594,1594
Yolo,43,2022-10-10,125,125,125,0,3086,3094,3093,1,4,2,2,0,404,404,402,402
Yuba,43,2022-10-10,23,23,23,0,924,925,924,1,0,0,0,0,122,122,122,122
Alameda,44,2022-10-17,913,913,913,0,24484,24550,24549,1,60,5,5,8,2058,2058,2053,2053
Amador,44,2022-10-17,15,15,15,0,591,593,592,1,1,0,0,0,94,94,94,94
Butte,44,2022-10-17,76,76,76,0,1424,1430,1429,1,13,0,0,0,466,466,466,466
Calaveras,44,2022-10-17,19,19,19,0,306,307,306,1,0,0,0,0,135,135,135,135
Colusa,44,2022-10-17,4,4,4,0,80,81,80,1,0,0,0,0,22,22,22,22
Contra Costa,44,2022-10-17,669,669,669,0,14536,14576,14575,1,30,4,4,6,1469,1469,1465,1465
Del Norte,44,2022-10-17,11,11,11,0,379,380,379,1,1,0,0,0,55,55,55,55
El Dorado,44,2022-10-17,89,89,89,0,1380,1385,1384,1,2,0,0,1,233,233,233,233
Fresno,44,2022-10-17,349,349,349,0,10197,10224,10223,1,62,2,2,11,2885,2885,2883,2883
Glenn,44,2022-10-17,6,6,6,0,141,142,141,1,1,0,0,0,53,53,53,53
Humboldt,44,2022-10-17,70,70,70,0,1146,1149,1148,1,1,0,0,0,162,162,162,162
Imperial,44,2022-10-17,117,117,117,0,2320,2326,2325,1,5,0,0,0,962,962,962,962
Inyo,44,2022-10-17,6,6,6,0,122,123,122,1,1,0,0,0,60,60,60,60
Kern,44,2022-10-17,230,230,230,0,9626,9654,9653,1,32,0,0,1,2432,2432,2432,2432
Kings,44,2022-10-17,70,70,70,0,2320,2327,2326,1,2,0,0,0,465,465,465,465
Lake,44,2022-10-17,25,25,25,0,774,776,775,1,1,0,0,0,149,149,149,149
Lassen,44,2022-10-17,7,7,7,0,513,514,513,1,1,0,0,0,63,63,63,63
Los Angeles,44,2022-10-17,5076,5089,5089,0,188183,188692,188690,2,350,41,41,53,33744,33744,33703,33703
Madera,44,2022-10-17,59,59,59,0,1465,1471,1470,1,3,0,0,2,375,375,375,375
Marin,44,2022-10-17,132,132,132,0,3095,3104,3103,1,8,0,0,1,315,315,315,315
Mariposa,44,2022-10-17,6,6,6,0,119,120,119,1,0,0,0,0,30,30,30,30
Mendocino,44,2022-10-17,48,48,48,0,742,743,742,1,2,0,0,0,136,136,136,136
Merced,44,2022-10-17,129,129,129,0,2343,2349,2348,1,15,0,0,2,871,871,871,871
Modoc,44,2022-10-17,1,1,1,0,7,8,7,1,0,0,0,0,9,9,9,9
Mono,44,2022-10-17,6,6,6,0,41,42,41,1,1,0,0,0,7,7,7,7
Monterey,44,2022-10-17,125,125,125,0,3550,3561,3560,1,12,1,1,1,772,772,771,771
Napa,44,2022-10-17,60,60,60,0,1416,1421,1420,1,2,0,0,1,159,159,159,159
Nevada,44,2022-10-17,49,49,49,0,777,778,777,1,0,0,0,5,132,132,132,132
Orange,44,2022-10-17,1085,1086,1086,0,24751,24818,24817,1,91,21,21,18,7582,7582,7561,7561
Placer,44,2022-10-17,148,148,148,0,2919,2928,2927,1,32,0,0,3,662,662,662,662
Plumas,44,2022-10-17,11,11,11,0,98,99,98,1,0,0,0,0,13,13,13,13
Riverside,44,2022-10-17,885,885,885,0,20669,20724,20723,1,66,2,2,2,6653,6653,6651,6651
Sacramento,44,2022-10-17,853,854,854,0,16072,16116,16115,1,84,9,9,14,3363,3363,3354,3354
San Benito,44,2022-10-17,28,28,28,0,880,883,882,1,0,1,1,0,102,102,101,101
San Bernardino,44,2022-10-17,815,815,815,0,23219,23282,23281,1,63,1,1,9,8096,8096,8095,8095
San Diego,44,2022-10-17,1648,1654,1654,0,43407,43525,43524,1,117,8,8,24,5589,5589,5581,5581
San Francisco,44,2022-10-17,565,565,565,0,14423,14461,14460,1,34,3,3,13,1073,1073,1070,1070
San Joaquin,44,2022-10-17,353,353,353,0,9076,9101,9100,1,8,2,2,8,2344,2344,2342,2342
San Luis Obispo,44,2022-10-17,109,109,109,0,2130,2136,2135,1,4,1,1,0,529,529,528,528
San Mateo,44,2022-10-17,541,541,541,0,11236,11266,11265,1,21,0,0,1,738,738,738,738
Santa Barbara,44,2022-10-17,182,182,182,0,5624,5640,5639,1,18,0,0,2,732,732,732,732
Santa Clara,44,2022-10-17,1136,1138,1138,0,28440,28518,28517,1,93,5,5,16,2547,2547,2542,2542
Santa Cruz,44,2022-10-17,284,284,284,0,10290,10319,10318,1,7,1,1,0,274,274,273,273
Shasta,44,2022-10-17,82,82,82,0,1105,1108,1107,1,12,0,0,2,591,591,591,591
Siskiyou,44,2022-10-17,12,12,12,0,181,182,181,1,2,1,1,0,94,94,93,93
Solano,44,2022-10-17,265,265,265,0,4845,4859,4858,1,25,1,1,3,460,460,459,459
Sonoma,44,2022-10-17,244,244,244,0,5371,5385,5384,1,20,1,1,1,529,529,528,528
Stanislaus,44,2022-10-17,222,222,222,0,5293,5308,5307,1,45,1,1,5,1791,1791,1790,1790
Sutter,44,2022-10-17,40,40,40,0,909,912,911,1,0,0,0,0,232,232,232,232
Tehama,44,2022-10-17,21,21,21,0,396,397,396,1,0,0,0,0,216,216,216,216
Trinity,44,2022-10-17,0,0,0,0,34,35,34,1,0,0,0,0,21,21,21,21
Tulare,44,2022-10-17,136,136,136,0,4269,4281,4280,1,11,1,1,1,1548,1548,1547,1547
Tuolumne,44,2022-10-17,35,35,35,0,620,621,620,1,2,0,0,0,200,200,200,200
Ventura,44,2022-10-17,376,376,376,0,9333,9358,9357,1,32,3,3,1,1601,1601,1598,1598
Yolo,44,2022-10-17,103,103,103,0,2204,2211,2210,1,3,2,2,3,406,406,404,404
Yuba,44,2022-10-17,44,44,44,0,767,768,767,1,1,0,0,0,122,122,122,122
Alameda,45,2022-10-24,925,926,926,0,23194,23262,23261,1,46,8,8,10,2066,2066,2058,2058
Amador,45,2022-10-24,18,18,18,0,635,637,636,1,2,0,0,0,94,94,94,94
Butte,45,2022-10-24,68,68,68,0,1406,1412,1411,1,10,1,1,1,467,467,466,466
Calaveras,45,2022-10-24,20,20,20,0,322,323,322,1,0,0,0,0,135,135,135,135
Colusa,45,2022-10-24,3,3,3,0,95,96,95,1,0,0,0,0,22,22,22,22
Contra Costa,45,2022-10-24,624,624,624,0,13907,13948,13947,1,37,5,5,5,1474,1474,1469,1469
Del Norte,45,2022-10-24,6,6,6,0,361,362,361,1,0,0,0,1,55,55,55,55
El Dorado,45,2022-10-24,91,91,91,0,1519,1525,1524,1,1,0,0,0,233,233,233,233
Fresno,45,2022-10-24,376,376,376,0,9743,9773,9772,1,63,0,0,6,2885,2885,2885,2885
Glenn,45,2022-10-24,9,9,9,0,148,149,148,1,0,0,0,0,53,53,53,53
Humboldt,45,2022-10-24,69,69,69,0,1148,1153,1152,1,7,0,0,2,162,162,162,162
Imperial,45,2022-10-24,96,96,96,0,2344,2351,2350,1,8,1,1,0,963,963,962,962
Inyo,45,2022-10-24,8,8,8,0,272,273,272,1,0,0,0,0,60,60,60,60
Kern,45,2022-10-24,269,269,269,0,9631,9659,9658,1,24,2,2,2,2434,2434,2432,2432
Kings,45,2022-10-24,88,88,88,0,2338,2345,2344,1,8,0,0,0,465,465,465,465
Lake,45,2022-10-24,22,22,22,0,643,644,643,1,1,1,1,1,150,150,149,149
Lassen,45,2022-10-24,16,16,16,0,484,485,484,1,1,0,0,0,63,63,63,63
Los Angeles,45,2022-10-24,5315,5331,5331,0,185812,186356,186354,2,332,54,54,43,33798,33798,33744,33744
Madera,45,2022-10-24,61,61,61,0,1388,1394,1393,1,4,0,0,2,375,375,375,375
Marin,45,2022-10-24,138,138,138,0,3079,3090,3089,1,12,1,1,2,316,316,315,315
Mariposa,45,2022-10-24,12,12,12,0,120,121,120,1,0,0,0,0,30,30,30,30
Mendocino,45,2022-10-24,42,42,42,0,770,771,770,1,2,0,0,0,136,136,136,136
Merced,45,2022-10-24,88,88,88,0,2409,2416,2415,1,7,3,3,3,874,874,871,871
Modoc,45,2022-10-24,1,1,1,0,13,14,13,1,0,0,0,0,9,9,9,9
Mono,45,2022-10-24,3,3,3,0,63,64,63,1,0,1,1,0,8,8,7,7
Monterey,45,2022-10-24,131,131,131,0,3718,3730,3729,1,18,0,0,0,772,772,772,772
Napa,45,2022-10-24,51,51,51,0,1467,1473,1472,1,3,0,0,0,159,159,159,159
Nevada,45,2022-10-24,38,38,38,0,784,786,785,1,6,0,0,0,132,132,132,132
Orange,45,2022-10-24,1128,1131,1131,0,25651,25726,25725,1,84,11,11,14,7593,7593,7582,7582
Placer,45,2022-10-24,190,190,190,0,3026,3035,3034,1,39,0,0,6,662,662,662,662
Plumas,45,2022-10-24,12,12,12,0,91,92,91,1,0,0,0,0,13,13,13,13
Riverside,45,2022-10-24,919,920,920,0,20049,20108,20107,1,53,0,0,6,6653,6653,6653,6653
Sacramento,45,2022-10-24,798,798,798,0,15200,15245,15244,1,84,5,5,19,3368,3368,3363,3363
San Benito,45,2022-10-24,41,41,41,0,844,846,845,1,0,0,0,1,102,102,102,102
San Bernardino,45,2022-10-24,778,778,778,0,21409,21471,21470,1,39,3,3,10,8099,8099,8096,8096
San Diego,45,2022-10-24,1684,1689,1689,0,41861,41983,41982,1,83,5,5,18,5594,5594,5589,5589
San Francisco,45,2022-10-24,508,508,508,0,13870,13911,13910,1,35,1,1,5,1074,1074,1073,1073
San Joaquin,45,2022-10-24,271,271,271,0,8493,8519,8518,1,13,2,2,3,2346,2346,2344,2344
San Luis Obispo,45,2022-10-24,89,89,89,0,2053,2059,2058,1,2,0,0,0,529,529,529,529
San Mateo,45,2022-10-24,466,466,466,0,11067,11101,11100,1,19,0,0,2,738,738,738,738
Santa Barbara,45,2022-10-24,164,164,164,0,5728,5745,5744,1,19,2,2,4,734,734,732,732
Santa Clara,45,2022-10-24,1181,1183,1183,0,29140,29227,29226,1,92,3,3,9,2550,2550,2547,2547
Santa Cruz,45,2022-10-24,240,240,240,0,10202,10234,10233,1,14,1,1,0,275,275,274,274
Shasta,45,2022-10-24,73,73,73,0,983,986,985,1,5,0,0,2,591,591,591,591
Siskiyou,45,2022-10-24,12,12,12,0,171,172,171,1,0,0,0,0,94,94,94,94
Solano,45,2022-10-24,239,239,239,0,5023,5038,5037,1,20,0,0,1,460,460,460,460
Sonoma,45,2022-10-24,246,246,246,0,5438,5455,5454,1,23,0,0,1,529,529,529,529
Stanislaus,45,2022-10-24,199,199,199,0,4851,4866,4865,1,40,3,3,3,1794,1794,1791,1791
Sutter,45,2022-10-24,28,28,28,0,881,884,883,1,0,0,0,0,232,232,232,232
Tehama,45,2022-10-24,36,36,36,0,405,406,405,1,1,0,0,0,216,216,216,216
Trinity,45,2022-10-24,1,1,1,0,35,36,35,1,0,0,0,0,21,21,21,21
Tulare,45,2022-10-24,110,110,110,0,4341,4355,4354,1,16,1,1,1,1549,1549,1548,1548
Tuolumne,45,2022-10-24,33,33,33,0,625,626,625,1,1,1,1,0,201,201,200,200
Ventura,45,2022-10-24,293,293,293,0,9021,9048,9047,1,40,3,3,6,1604,1604,1601,1601
Yolo,45,2022-10-24,91,91,91,0,2042,2050,2049,1,5,1,1,0,407,407,406,406
Yuba,45,2022-10-24,51,51,51,0,799,800,799,1,5,0,0,1,122,122,122,122
Alameda,46,2022-10-31,1030,1032,1032,0,22825,22896,22895,1,57,5,5,4,2071,2071,2066,2066
Amador,46,2022-10-31,18,18,18,0,577,579,578,1,2,1,1,0,95,95,94,94
Butte,46,2022-10-31,82,82,82,0,1457,1463,1462,1,11,0,0,3,467,467,467,467
Calaveras,46,2022-10-31,13,13,13,0,257,258,257,1,0,0,0,0,135,135,135,135
Colusa,46,2022-10-31,11,11,11,0,95,96,95,1,0,0,0,0,22,22,22,22
Contra Costa,46,2022-10-31,749,750,750,0,13885,13929,13928,1,37,6,6,7,1480,1480,1474,1474
Del Norte,46,2022-10-31,16,16,16,0,357,358,357,1,1,0,0,0,55,55,55,55
El Dorado,46,2022-10-31,100,100,100,0,1404,1410,1409,1,2,0,0,0,233,233,233,233
Fresno,46,2022-10-31,426,426,426,0,10495,10530,10529,1,57,4,4,8,2889,2889,2885,2885
Glenn,46,2022-10-31,16,16,16,0,156,157,156,1,1,0,0,0,53,53,53,53
Humboldt,46,2022-10-31,44,44,44,0,1019,1023,1022,1,6,0,0,2,162,162,162,162
Imperial,46,2022-10-31,126,126,126,0,2786,2796,2795,1,7,0,0,0,963,963,963,963
Inyo,46,2022-10-31,7,7,7,0,242,243,242,1,0,0,0,0,60,60,60,60
Kern,46,2022-10-31,330,330,330,0,9783,9814,9813,1,20,2,2,2,2436,2436,2434,2434
Kings,46,2022-10-31,117,117,117,0,2460,2469,2468,1,3,0,0,1,465,465,465,465
Lake,46,2022-10-31,30,30,30,0,752,754,753,1,1,0,0,1,150,150,150,150
Lassen,46,2022-10-31,19,19,19,0,522,523,522,1,1,0,0,0,63,63,63,63
Los Angeles,46,2022-10-31,6201,6221,6221,0,190964,191564,191562,2,344,37,37,44,33835,33835,33798,33798
Madera,46,2022-10-31,54,54,54,0,1433,1441,1440,1,3,0,0,2,375,375,375,375
Marin,46,2022-10-31,137,137,137,0,3505,3517,3516,1,10,1,1,1,317,317,316,316
Mariposa,46,2022-10-31,8,8,8,0,126,127,126,1,0,0,0,0,30,30,30,30
Mendocino,46,2022-10-31,23,23,23,0,709,710,709,1,1,0,0,2,136,136,136,136
Merced,46,2022-10-31,113,113,113,0,2138,2144,2143,1,5,1,1,0,875,875,874,874
Modoc,46,2022-10-31,1,1,1,0,13,14,13,1,0,0,0,0,9,9,9,9
Mono,46,2022-10-31,1,1,1,0,85,86,85,1,1,0,0,0,8,8,8,8
Monterey,46,2022-10-31,150,150,150,0,3688,3700,3699,1,18,2,2,0,774,774,772,772
Napa,46,2022-10-31,54,54,54,0,1505,1511,1510,1,2,0,0,0,159,159,159,159
Nevada,46,2022-10-31,37,37,37,0,774,776,775,1,6,0,0,0,132,132,132,132
Orange,46,2022-10-31,1151,1156,1156,0,26767,26851,26850,1,91,14,14,14,7607,7607,7593,7593
Placer,46,2022-10-31,149,149,149,0,2746,2756,2755,1,40,0,0,5,662,662,662,662
Plumas,46,2022-10-31,5,5,5,0,87,88,87,1,0,0,0,0,13,13,13,13
Riverside,46,2022-10-31,1029,1031,1031,0,19442,19503,19502,1,64,5,5,5,6658,6658,6653,6653
Sacramento,46,2022-10-31,731,731,731,0,14046,14090,14089,1,80,8,8,16,3376,3376,3368,3368
San Benito,46,2022-10-31,33,33,33,0,744,745,744,1,1,0,0,1,102,102,102,102
San Bernardino,46,2022-10-31,1030,1033,1033,0,22279,22349,22348,1,64,2,2,11,8101,8101,8099,8099
San Diego,46,2022-10-31,1772,1779,1779,0,42543,42676,42675,1,109,5,5,13,5599,5599,5594,5594
San Francisco,46,2022-10-31,615,615,615,0,14584,14630,14629,1,45,3,3,3,1077,1077,1074,1074
San Joaquin,46,2022-10-31,331,331,331,0,8592,8620,8619,1,21,6,6,3,2352,2352,2346,2346
San Luis Obispo,46,2022-10-31,81,81,81,0,2010,2016,2015,1,1,1,1,0,530,530,529,529
San Mateo,46,2022-10-31,511,511,511,0,11505,11543,11542,1,30,0,0,2,738,738,738,738
Santa Barbara,46,2022-10-31,181,181,181,0,6033,6053,6052,1,20,1,1,6,735,735,734,734
Santa Clara,46,2022-10-31,1259,1264,1264,0,30687,30784,30783,1,85,3,3,16,2553,2553,2550,2550
Santa Cruz,46,2022-10-31,188,188,188,0,9953,9985,9984,1,7,0,0,0,275,275,275,275
Shasta,46,2022-10-31,64,64,64,0,829,831,830,1,6,2,2,1,593,593,591,591
Siskiyou,46,2022-10-31,17,17,17,0,216,217,216,1,1,1,1,0,95,95,94,94
Solano,46,2022-10-31,312,312,312,0,5250,5268,5267,1,16,0,0,4,460,460,460,460
Sonoma,46,2022-10-31,205,205,205,0,5597,5616,5615,1,24,0,0,3,529,529,529,529
Stanislaus,46,2022-10-31,235,235,235,0,4830,4846,4845,1,49,1,1,8,1795,1795,1794,1794
Sutter,46,2022-10-31,55,55,55,0,901,903,902,1,0,0,0,0,232,232,232,232
Tehama,46,2022-10-31,26,26,26,0,395,396,395,1,1,0,0,0,216,216,216,216
Trinity,46,2022-10-31,18,18,18,0,73,74,73,1,5,0,0,0,21,21,21,21
Tulare,46,2022-10-31,153,153,153,0,3675,3687,3686,1,12,0,0,0,1549,1549,1549,1549
Tuolumne,46,2022-10-31,27,27,27,0,518,519,518,1,3,0,0,0,201,201,201,201
Ventura,46,2022-10-31,377,377,377,0,9516,9547,9546,1,24,2,2,2,1606,1606,1604,1604
Yolo,46,2022-10-31,82,82,82,0,1825,1833,1832,1,3,0,0,1,407,407,407,407
Yuba,46,2022-10-31,46,46,46,0,775,776,775,1,3,0,0,0,122,122,122,122
Alameda,47,2022-11-07,1304,1311,1311,0,24308,24394,24393,1,58,8,8,11,2079,2079,2071,2071
Amador,47,2022-11-07,32,32,32,0,685,687,686,1,3,0,0,0,95,95,95,95
Butte,47,2022-11-07,118,118,118,0,1369,1375,1374,1,11,0,0,2,467,467,467,467
Calaveras,47,2022-11-07,16,16,16,0,333,334,333,1,0,0,0,0,135,135,135,135
Colusa,47,2022-11-07,2,2,2,0,102,103,102,1,0,0,0,0,22,22,22,22
Contra Costa,47,2022-11-07,879,880,880,0,15660,15714,15713,1,43,3,3,4,1483,1483,1480,1480
Del Norte,47,2022-11-07,10,10,10,0,400,401,400,1,0,0,0,0,55,55,55,55
El Dorado,47,2022-11-07,108,108,108,0,1598,1605,1604,1,7,2,2,0,235,235,233,233
Fresno,47,2022-11-07,597,597,597,0,10700,10737,10736,1,61,3,3,9,2892,2892,2889,2889
Glenn,47,2022-11-07,29,29,29,0,131,132,131,1,0,0,0,0,53,53,53,53
Humboldt,47,2022-11-07,85,85,85,0,1022,1027,1026,1,9,0,0,2,162,162,162,162
Imperial,47,2022-11-07,209,209,209,0,3708,3723,3722,1,7,0,0,0,963,963,963,963
Inyo,47,2022-11-07,19,19,19,0,264,265,264,1,0,0,0,0,60,60,60,60
Kern,47,2022-11-07,454,454,454,0,10640,10678,10677,1,29,1,1,5,2437,2437,2436,2436
Kings,47,2022-11-07,149,149,149,0,2457,2467,2466,1,7,1,1,0,466,466,465,465
Lake,47,2022-11-07,50,50,50,0,795,797,796,1,3,0,0,1,150,150,150,150
Lassen,47,2022-11-07,10,10,10,0,451,452,451,1,0,0,0,0,63,63,63,63
Los Angeles,47,2022-11-07,8074,8102,8102,0,190491,191156,191154,2,387,55,55,53,33890,33890,33835,33835
Madera,47,2022-11-07,78,78,78,0,1612,1620,1619,1,3,0,0,4,375,375,375,375
Marin,47,2022-11-07,152,152,152,0,3367,3380,3379,1,9,0,0,0,317,317,317,317
Mariposa,47,2022-11-07,14,14,14,0,121,122,121,1,0,0,0,0,30,30,30,30
Mendocino,47,2022-11-07,37,37,37,0,819,821,820,1,4,1,1,0,137,137,136,136
Merced,47,2022-11-07,143,143,143,0,2593,2604,2603,1,9,4,4,0,879,879,875,875
Modoc,47,2022-11-07,2,2,2,0,6,7,6,1,0,0,0,0,9,9,9,9
Mono,47,2022-11-07,3,3,3,0,96,97,96,1,0,0,0,0,8,8,8,8
Monterey,47,2022-11-07,219,219,219,0,3931,3945,3944,1,18,1,1,0,775,775,774,774
Napa,47,2022-11-07,77,77,77,0,1756,1762,1761,1,6,0,0,0,159,159,159,159
Nevada,47,2022-11-07,60,60,60,0,743,745,744,1,3,0,0,1,132,132,132,132
Orange,47,2022-11-07,1248,1254,1254,0,28539,28638,28637,1,94,11,11,20,7618,7618,7607,7607
Placer,47,2022-11-07,228,228,228,0,3331,3344,3343,1,53,2,2,7,664,664,662,662
Plumas,47,2022-11-07,5,5,5,0,69,70,69,1,0,0,0,0,13,13,13,13
Riverside,47,2022-11-07,1492,1499,1499,0,21551,21626,21625,1,71,2,2,5,6660,6660,6658,6658
Sacramento,47,2022-11-07,1090,1094,1094,0,15903,15958,15957,1,90,7,7,9,3383,3383,3376,3376
San Benito,47,2022-11-07,43,43,43,0,924,928,927,1,1,0,0,0,102,102,102,102
San Bernardino,47,2022-11-07,1429,1436,1436,0,23829,23912,23911,1,76,2,2,17,8103,8103,8101,8101
San Diego,47,2022-11-07,2155,2163,2163,0,45390,45549,45548,1,117,8,8,24,5607,5607,5599,5599
San Francisco,47,2022-11-07,715,716,716,0,14870,14922,14921,1,42,2,2,8,1079,1079,1077,1077
San Joaquin,47,2022-11-07,482,482,482,0,8807,8839,8838,1,24,2,2,3,2354,2354,2352,2352
San Luis Obispo,47,2022-11-07,130,130,130,0,2269,2277,2276,1,4,0,0,2,530,530,530,530
San Mateo,47,2022-11-07,565,565,565,0,12247,12291,12290,1,27,0,0,3,738,738,738,738
Santa Barbara,47,2022-11-07,225,225,225,0,6670,6694,6693,1,18,1,1,2,736,736,735,735
Santa Clara,47,2022-11-07,1627,1634,1634,0,31249,31359,31358,1,76,7,7,19,2560,2560,2553,2553
Santa Cruz,47,2022-11-07,282,282,282,0,11332,11373,11372,1,8,0,0,0,275,275,275,275
Shasta,47,2022-11-07,95,95,95,0,1052,1056,1055,1,11,1,1,3,594,594,593,593
Siskiyou,47,2022-11-07,15,15,15,0,295,296,295,1,1,0,0,0,95,95,95,95
Solano,47,2022-11-07,384,384,384,0,5515,5534,5533,1,22,2,2,3,462,462,460,460
Sonoma,47,2022-11-07,250,250,250,0,5931,5952,5951,1,11,2,2,2,531,531,529,529
Stanislaus,47,2022-11-07,300,300,300,0,4929,4947,4946,1,42,2,2,9,1797,1797,1795,1795
Sutter,47,2022-11-07,87,87,87,0,958,961,960,1,0,0,0,0,232,232,232,232
Tehama,47,2022-11-07,47,47,47,0,472,473,472,1,2,0,0,0,216,216,216,216
Trinity,47,2022-11-07,2,2,2,0,34,35,34,1,0,0,0,0,21,21,21,21
Tulare,47,2022-11-07,160,160,160,0,4365,4381,4380,1,14,0,0,0,1549,1549,1549,1549
Tuolumne,47,2022-11-07,82,82,82,0,681,683,682,1,2,0,0,0,201,201,201,201
Ventura,47,2022-11-07,446,446,446,0,10346,10383,10382,1,36,2,2,1,1608,1608,1606,1606
Yolo,47,2022-11-07,173,173,173,0,2237,2247,2246,1,3,2,2,0,409,409,407,407
Yuba,47,2022-11-07,47,47,47,0,902,906,905,1,3,0,0,2,122,122,122,122
Alameda,48,2022-11-14,1469,1476,1476,0,24069,24164,24163,1,77,3,3,9,2082,2082,2079,2079
Amador,48,2022-11-14,20,20,20,0,656,659,658,1,2,0,0,0,95,95,95,95
Butte,48,2022-11-14,119,119,119,0,1378,1384,1383,1,20,0,0,1,467,467,467,467
Calaveras,48,2022-11-14,30,30,30,0,341,342,341,1,0,0,0,0,135,135,135,135
Colusa,48,2022-11-14,11,11,11,0,100,101,100,1,1,0,0,0,22,22,22,22
Contra Costa,48,2022-11-14,968,973,973,0,15937,16000,15999,1,56,1,1,5,1484,1484,1483,1483
Del Norte,48,2022-11-14,20,20,20,0,429,430,429,1,1,0,0,0,55,55,55,55
El Dorado,48,2022-11-14,143,143,143,0,1590,1597,1596,1,7,0,0,1,235,235,235,235
Fresno,48,2022-11-14,771,772,772,0,11264,11309,11308,1,72,8,8,13,2900,2900,2892,2892
Glenn,48,2022-11-14,20,20,20,0,160,161,160,1,0,0,0,0,53,53,53,53
Humboldt,48,2022-11-14,84,84,84,0,1103,1110,1109,1,6,0,0,0,162,162,162,162
Imperial,48,2022-11-14,251,251,251,0,3221,3235,3234,1,4,0,0,1,963,963,963,963
Inyo,48,2022-11-14,11,11,11,0,542,546,545,1,0,0,0,0,60,60,60,60
Kern,48,2022-11-14,445,445,445,0,10601,10645,10644,1,26,1,1,6,2438,2438,2437,2437
Kings,48,2022-11-14,200,200,200,0,2624,2636,2635,1,6,2,2,0,468,468,466,466
Lake,48,2022-11-14,54,54,54,0,803,806,805,1,2,0,0,1,150,150,150,150
Lassen,48,2022-11-14,35,35,35,0,544,546,545,1,0,1,1,0,64,64,63,63
Los Angeles,48,2022-11-14,9379,9417,9417,0,195291,196064,196062,2,477,49,49,75,33939,33939,33890,33890
Madera,48,2022-11-14,95,95,95,0,1712,1720,1719,1,4,0,0,3,375,375,375,375
Marin,48,2022-11-14,175,175,175,0,3569,3584,3583,1,8,0,0,2,317,317,317,317
Mariposa,48,2022-11-14,18,18,18,0,137,138,137,1,0,0,0,0,30,30,30,30
Mendocino,48,2022-11-14,39,39,39,0,908,912,911,1,3,0,0,1,137,137,137,137
Merced,48,2022-11-14,185,185,185,0,2638,2651,2650,1,6,0,0,0,879,879,879,879
Modoc,48,2022-11-14,3,3,3,0,11,12,11,1,0,0,0,0,9,9,9,9
Mono,48,2022-11-14,10,10,10,0,122,123,122,1,0,0,0,0,8,8,8,8
Monterey,48,2022-11-14,200,200,200,0,4156,4173,4172,1,20,1,1,1,776,776,775,775
Napa,48,2022-11-14,105,105,105,0,1918,1927,1926,1,5,0,0,0,159,159,159,159
Nevada,48,2022-11-14,65,65,65,0,797,799,798,1,3,0,0,2,132,132,132,132
Orange,48,2022-11-14,1561,1568,1568,0,26772,26878,26877,1,118,8,8,21,7626,7626,7618,7618
Placer,48,2022-11-14,310,310,310,0,3834,3850,3849,1,54,1,1,5,665,665,664,664
Plumas,48,2022-11-14,4,4,4,0,79,80,79,1,0,0,0,0,13,13,13,13
Riverside,48,2022-11-14,1642,1650,1650,0,22363,22452,22451,1,95,4,4,10,6664,6664,6660,6660
Sacramento,48,2022-11-14,1181,1186,1186,0,16853,16920,16919,1,82,6,6,18,3389,3389,3383,3383
San Benito,48,2022-11-14,42,42,42,0,979,983,982,1,1,0,0,0,102,102,102,102
San Bernardino,48,2022-11-14,1781,1789,1789,0,23976,24071,24070,1,83,0,0,14,8103,8103,8103,8103
San Diego,48,2022-11-14,2455,2464,2464,0,43498,43670,43669,1,124,7,7,21,5614,5614,5607,5607
San Francisco,48,2022-11-14,710,711,711,0,13676,13730,13729,1,52,7,7,5,1086,1086,1079,1079
San Joaquin,48,2022-11-14,610,611,611,0,9501,9540,9539,1,20,0,0,5,2354,2354,2354,2354
San Luis Obispo,48,2022-11-14,120,120,120,0,2200,2210,2209,1,6,0,0,1,530,530,530,530
San Mateo,48,2022-11-14,639,640,640,0,11297,11342,11341,1,27,0,0,2,738,738,738,738
Santa Barbara,48,2022-11-14,192,192,192,0,5891,5915,5914,1,15,1,1,2,737,737,736,736
Santa Clara,48,2022-11-14,1732,1740,1740,0,30462,30584,30583,1,117,3,3,14,2563,2563,2560,2560
Santa Cruz,48,2022-11-14,249,249,249,0,9602,9641,9640,1,11,1,1,0,276,276,275,275
Shasta,48,2022-11-14,101,101,101,0,1070,1076,1075,1,10,1,1,2,595,595,594,594
Siskiyou,48,2022-11-14,27,27,27,0,397,398,397,1,2,0,0,0,95,95,95,95
Solano,48,2022-11-14,439,439,439,0,5418,5439,5438,1,26,0,0,3,462,462,462,462
Sonoma,48,2022-11-14,268,268,268,0,6034,6060,6059,1,23,1,1,0,532,532,531,531
Stanislaus,48,2022-11-14,328,328,328,0,5222,5243,5242,1,48,0,0,10,1797,1797,1797,1797
Sutter,48,2022-11-14,95,95,95,0,1182,1188,1187,1,0,0,0,0,232,232,232,232
Tehama,48,2022-11-14,49,49,49,0,574,576,575,1,1,0,0,0,216,216,216,216
Trinity,48,2022-11-14,11,11,11,0,52,53,52,1,0,1,1,0,22,22,21,21
Tulare,48,2022-11-14,308,308,308,0,4283,4300,4299,1,16,0,0,1,1549,1549,1549,1549
Tuolumne,48,2022-11-14,77,77,77,0,695,698,697,1,2,0,0,0,201,201,201,201
Ventura,48,2022-11-14,572,572,572,0,10613,10657,10656,1,28,1,1,4,1609,1609,1608,1608
Yolo,48,2022-11-14,152,152,152,0,2158,2168,2167,1,2,6,6,0,415,415,409,409
Yuba,48,2022-11-14,60,60,60,0,987,992,991,1,6,0,0,1,122,122,122,122
Alameda,49,2022-11-21,1708,1716,1716,0,25225,25335,25334,1,82,9,9,16,2091,2091,2082,2082
Amador,49,2022-11-21,28,28,28,0,833,836,835,1,2,0,0,0,95,95,95,95
Butte,49,2022-11-21,143,143,143,0,1327,1334,1333,1,21,0,0,1,467,467,467,467
Calaveras,49,2022-11-21,40,40,40,0,421,422,421,1,2,0,0,0,135,135,135,135
Colusa,49,2022-11-21,9,9,9,0,110,111,110,1,0,0,0,0,22,22,22,22
Contra Costa,49,2022-11-21,1028,1034,1034,0,16508,16580,16579,1,52,3,3,8,1487,1487,1484,1484
Del Norte,49,2022-11-21,18,18,18,0,489,490,489,1,4,0,0,0,55,55,55,55
El Dorado,49,2022-11-21,186,186,186,0,1827,1836,1835,1,10,0,0,1,235,235,235,235
Fresno,49,2022-11-21,1067,1072,1072,0,12140,12194,12193,1,114,5,5,9,2905,2905,2900,2900
Glenn,49,2022-11-21,21,21,21,0,214,216,215,1,0,0,0,0,53,53,53,53
Humboldt,49,2022-11-21,123,123,123,0,1172,1179,1178,1,4,1,1,1,163,163,162,162
Imperial,49,2022-11-21,280,280,280,0,3123,3137,3136,1,3,1,1,1,964,964,963,963
Inyo,49,2022-11-21,29,29,29,0,402,403,402,1,0,1,1,0,61,61,60,60
Kern,49,2022-11-21,483,483,483,0,10095,10139,10138,1,54,3,3,10,2441,2441,2438,2438
Kings,49,2022-11-21,296,296,296,0,2779,2792,2791,1,4,2,2,1,470,470,468,468
Lake,49,2022-11-21,56,56,56,0,928,934,933,1,0,0,0,1,150,150,150,150
Lassen,49,2022-11-21,34,34,34,0,540,542,541,1,0,0,0,0,64,64,64,64
Los Angeles,49,2022-11-21,13152,13209,13209,0,197908,198773,198771,2,648,69,69,93,34008,34008,33939,33939
Madera,49,2022-11-21,168,168,168,0,1861,1869,1868,1,11,0,0,1,375,375,375,375
Marin,49,2022-11-21,179,179,179,0,3351,3366,3365,1,8,0,0,0,317,317,317,317
Mariposa,49,2022-11-21,19,19,19,0,170,171,170,1,0,0,0,0,30,30,30,30
Mendocino,49,2022-11-21,38,38,38,0,889,895,894,1,4,0,0,1,137,137,137,137
Merced,49,2022-11-21,269,269,269,0,2931,2945,2944,1,9,2,2,4,881,881,879,879
Modoc,49,2022-11-21,8,8,8,0,13,14,13,1,0,0,0,0,9,9,9,9
Mono,49,2022-11-21,3,3,3,0,107,108,107,1,0,0,0,0,8,8,8,8
Monterey,49,2022-11-21,227,227,227,0,4442,4462,4461,1,17,1,1,0,777,777,776,776
Napa,49,2022-11-21,145,145,145,0,2037,2048,2047,1,4,0,0,1,159,159,159,159
Nevada,49,2022-11-21,93,93,93,0,932,938,937,1,2,0,0,2,132,132,132,132
Orange,49,2022-11-21,2162,2170,2170,0,28140,28264,28263,1,170,14,14,32,7640,7640,7626,7626
Placer,49,2022-11-21,361,361,361,0,4059,4078,4077,1,53,0,0,6,665,665,665,665
Plumas,49,2022-11-21,7,7,7,0,104,105,104,1,1,0,0,0,13,13,13,13
Riverside,49,2022-11-21,2145,2153,2153,0,24362,24467,24466,1,110,7,7,9,6671,6671,6664,6664
Sacramento,49,2022-11-21,1521,1528,1528,0,18921,19005,19004,1,105,3,3,18,3392,3392,3389,3389
San Benito,49,2022-11-21,64,64,64,0,1154,1160,1159,1,2,0,0,0,102,102,102,102
San Bernardino,49,2022-11-21,2333,2343,2343,0,26598,26715,26714,1,89,1,1,19,8104,8104,8103,8103
San Diego,49,2022-11-21,3172,3185,3185,0,43786,43977,43976,1,198,3,3,26,5617,5617,5614,5614
San Francisco,49,2022-11-21,943,948,948,0,15065,15132,15131,1,54,5,5,7,1091,1091,1086,1086
San Joaquin,49,2022-11-21,763,766,766,0,11077,11126,11125,1,36,1,1,5,2355,2355,2354,2354
San Luis Obispo,49,2022-11-21,170,170,170,0,2350,2361,2360,1,4,1,1,0,531,531,530,530
San Mateo,49,2022-11-21,739,741,741,0,12300,12355,12354,1,36,0,0,1,738,738,738,738
Santa Barbara,49,2022-11-21,321,321,321,0,6106,6133,6132,1,15,3,3,3,740,740,737,737
Santa Clara,49,2022-11-21,2153,2161,2161,0,34256,34406,34405,1,119,10,10,23,2573,2573,2563,2563
Santa Cruz,49,2022-11-21,286,286,286,0,9522,9565,9564,1,12,0,0,2,276,276,276,276
Shasta,49,2022-11-21,91,91,91,0,1051,1057,1056,1,14,0,0,1,595,595,595,595
Siskiyou,49,2022-11-21,24,24,24,0,342,343,342,1,1,0,0,0,95,95,95,95
Solano,49,2022-11-21,491,492,492,0,5667,5694,5693,1,32,1,1,5,463,463,462,462
Sonoma,49,2022-11-21,326,326,326,0,5780,5807,5806,1,22,0,0,4,532,532,532,532
Stanislaus,49,2022-11-21,445,445,445,0,5969,5996,5995,1,51,0,0,10,1797,1797,1797,1797
Sutter,49,2022-11-21,91,91,91,0,1139,1145,1144,1,0,0,0,0,232,232,232,232
Tehama,49,2022-11-21,72,72,72,0,673,677,676,1,3,0,0,2,216,216,216,216
Trinity,49,2022-11-21,5,5,5,0,51,52,51,1,0,0,0,0,22,22,22,22
Tulare,49,2022-11-21,431,431,431,0,5503,5527,5526,1,23,0,0,1,1549,1549,1549,1549
Tuolumne,49,2022-11-21,97,97,97,0,765,769,768,1,3,0,0,0,201,201,201,201
Ventura,49,2022-11-21,728,729,729,0,10699,10746,10745,1,43,1,1,2,1610,1610,1609,1609
Yolo,49,2022-11-21,132,132,132,0,2238,2249,2248,1,7,4,4,2,419,419,415,415
Yuba,49,2022-11-21,70,70,70,0,1027,1034,1033,1,10,0,0,1,122,122,122,122
Alameda,50,2022-11-28,2232,2243,2243,0,22049,22157,22156,1,103,6,6,13,2097,2097,2091,2091
Amador,50,2022-11-28,32,32,32,0,757,761,760,1,5,1,1,1,96,96,95,95
Butte,50,2022-11-28,204,204,204,0,1477,1485,1484,1,41,0,0,1,467,467,467,467
Calaveras,50,2022-11-28,32,32,32,0,402,404,403,1,3,0,0,0,135,135,135,135
Colusa,50,2022-11-28,14,14,14,0,184,185,184,1,0,0,0,0,22,22,22,22
Contra Costa,50,2022-11-28,1472,1480,1480,0,15530,15607,15606,1,67,4,4,8,1491,1491,1487,1487
Del Norte,50,2022-11-28,33,33,33,0,458,460,459,1,1,1,1,0,56,56,55,55
El Dorado,50,2022-11-28,185,185,185,0,1548,1557,1556,1,13,1,1,1,236,236,235,235
Fresno,50,2022-11-28,1317,1324,1324,0,11704,11762,11761,1,136,5,5,19,2910,2910,2905,2905
Glenn,50,2022-11-28,17,17,17,0,194,195,194,1,3,0,0,0,53,53,53,53
Humboldt,50,2022-11-28,114,114,114,0,1042,1048,1047,1,10,0,0,0,163,163,163,163
Imperial,50,2022-11-28,379,379,379,0,2791,2806,2805,1,6,1,1,1,965,965,964,964
Inyo,50,2022-11-28,34,34,34,0,376,378,377,1,2,0,0,0,61,61,61,61
Kern,50,2022-11-28,586,587,587,0,9373,9420,9419,1,60,4,4,6,2445,2445,2441,2441
Kings,50,2022-11-28,244,244,244,0,2544,2557,2556,1,10,0,0,0,470,470,470,470
Lake,50,2022-11-28,49,49,49,0,848,852,851,1,1,0,0,0,150,150,150,150
Lassen,50,2022-11-28,27,27,27,0,493,495,494,1,0,0,0,0,64,64,64,64
Los Angeles,50,2022-11-28,18853,18945,18945,0,183040,183940,183938,2,918,88,88,122,34096,34096,34008,34008
Madera,50,2022-11-28,162,162,162,0,1627,1635,1634,1,13,0,0,2,375,375,375,375
Marin,50,2022-11-28,299,299,299,0,3071,3087,3086,1,19,0,0,1,317,317,317,317
Mariposa,50,2022-11-28,23,23,23,0,136,137,136,1,0,0,0,0,30,30,30,30
Mendocino,50,2022-11-28,49,49,49,0,726,730,729,1,5,0,0,2,137,137,137,137
Merced,50,2022-11-28,349,350,350,0,2550,2564,2563,1,18,5,5,2,886,886,881,881
Modoc,50,2022-11-28,5,5,5,0,10,11,10,1,0,0,0,0,9,9,9,9
Mono,50,2022-11-28,4,4,4,0,94,95,94,1,0,0,0,0,8,8,8,8
Monterey,50,2022-11-28,284,284,284,0,3890,3909,3908,1,26,1,1,0,778,778,777,777
Napa,50,2022-11-28,141,141,141,0,1884,1893,1892,1,6,0,0,3,159,159,159,159
Nevada,50,2022-11-28,118,118,118,0,1008,1013,1012,1,9,0,0,0,132,132,132,132
Orange,50,2022-11-28,3106,3121,3121,0,26228,26355,26354,1,221,17,17,34,7657,7657,7640,7640
Placer,50,2022-11-28,387,387,387,0,3778,3798,3797,1,69,3,3,5,668,668,665,665
Plumas,50,2022-11-28,6,6,6,0,143,144,143,1,0,0,0,0,13,13,13,13
Riverside,50,2022-11-28,3191,3206,3206,0,23282,23396,23395,1,188,12,12,22,6683,6683,6671,6671
Sacramento,50,2022-11-28,1786,1794,1794,0,17966,18054,18053,1,126,8,8,14,3400,3400,3392,3392
San Benito,50,2022-11-28,131,131,131,0,1221,1228,1227,1,1,0,0,0,102,102,102,102
San Bernardino,50,2022-11-28,3301,3317,3317,0,25793,25919,25918,1,146,1,1,20,8105,8105,8104,8104
San Diego,50,2022-11-28,4090,4109,4109,0,31679,31836,31835,1,259,7,7,27,5624,5624,5617,5617
San Francisco,50,2022-11-28,1161,1168,1168,0,12719,12781,12780,1,67,6,6,8,1097,1097,1091,1091
San Joaquin,50,2022-11-28,992,998,998,0,10941,10996,10995,1,50,3,3,11,2358,2358,2355,2355
San Luis Obispo,50,2022-11-28,179,179,179,0,2248,2260,2259,1,9,3,3,1,534,534,531,531
San Mateo,50,2022-11-28,1087,1094,1094,0,10982,11037,11036,1,42,1,1,3,739,739,738,738
Santa Barbara,50,2022-11-28,466,467,467,0,5210,5237,5236,1,27,2,2,5,742,742,740,740
Santa Clara,50,2022-11-28,2892,2906,2906,0,28045,28184,28183,1,159,9,9,22,2582,2582,2573,2573
Santa Cruz,50,2022-11-28,371,372,372,0,6665,6699,6698,1,20,0,0,2,276,276,276,276
Shasta,50,2022-11-28,97,97,97,0,1010,1015,1014,1,16,1,1,3,596,596,595,595
Siskiyou,50,2022-11-28,27,27,27,0,277,278,277,1,2,0,0,0,95,95,95,95
Solano,50,2022-11-28,590,592,592,0,5183,5209,5208,1,34,2,2,7,465,465,463,463
Sonoma,50,2022-11-28,456,457,457,0,5011,5037,5036,1,48,2,2,3,534,534,532,532
Stanislaus,50,2022-11-28,524,525,525,0,5363,5390,5389,1,77,3,3,4,1800,1800,1797,1797
Sutter,50,2022-11-28,82,82,82,0,1119,1126,1125,1,0,0,0,0,232,232,232,232
Tehama,50,2022-11-28,70,70,70,0,632,635,634,1,6,0,0,3,216,216,216,216
Trinity,50,2022-11-28,3,3,3,0,60,61,60,1,0,0,0,0,22,22,22,22
Tulare,50,2022-11-28,510,511,511,0,4930,4956,4955,1,34,0,0,0,1549,1549,1549,1549
Tuolumne,50,2022-11-28,72,72,72,0,676,680,679,1,4,0,0,0,201,201,201,201
Ventura,50,2022-11-28,963,969,969,0,10588,10641,10640,1,58,2,2,2,1612,1612,1610,1610
Yolo,50,2022-11-28,170,170,170,0,2027,2038,2037,1,3,4,4,1,423,423,419,419
Yuba,50,2022-11-28,92,92,92,0,926,931,930,1,12,0,0,0,122,122,122,122
Alameda,51,2022-12-05,2773,2786,2786,0,29017,29169,29168,1,126,7,7,13,2104,2104,2097,2097
Amador,51,2022-12-05,41,41,41,0,812,815,814,1,3,0,0,2,96,96,96,96
Butte,51,2022-12-05,238,238,238,0,1886,1897,1896,1,38,7,7,5,474,474,467,467
Calaveras,51,2022-12-05,47,47,47,0,486,488,487,1,0,1,1,0,136,136,135,135
Colusa,51,2022-12-05,12,12,12,0,206,207,206,1,4,0,0,0,22,22,22,22
Contra Costa,51,2022-12-05,1778,1787,1787,0,19282,19382,19381,1,78,0,0,11,1491,1491,1491,1491
Del Norte,51,2022-12-05,39,39,39,0,566,570,569,1,2,0,0,0,56,56,56,56
El Dorado,51,2022-12-05,182,182,182,0,1576,1585,1584,1,14,1,1,0,237,237,236,236
Fresno,51,2022-12-05,1532,1540,1540,0,14287,14362,14361,1,177,6,6,17,2916,2916,2910,2910
Glenn,51,2022-12-05,24,24,24,0,232,234,233,1,2,0,0,0,53,53,53,53
Humboldt,51,2022-12-05,134,134,134,0,1083,1090,1089,1,17,1,1,2,164,164,163,163
Imperial,51,2022-12-05,587,589,589,0,3396,3414,3413,1,18,2,2,5,967,967,965,965
Inyo,51,2022-12-05,26,26,26,0,332,333,332,1,1,1,1,0,62,62,61,61
Kern,51,2022-12-05,797,802,802,0,10541,10597,10596,1,55,1,1,10,2446,2446,2445,2445
Kings,51,2022-12-05,295,295,295,0,3047,3064,3063,1,8,0,0,0,470,470,470,470
Lake,51,2022-12-05,64,64,64,0,830,836,835,1,2,0,0,0,150,150,150,150
Lassen,51,2022-12-05,14,14,14,0,444,446,445,1,0,0,0,0,64,64,64,64
Los Angeles,51,2022-12-05,22371,22488,22488,0,241662,242935,242932,3,1119,110,111,151,34206,34207,34096,34096
Madera,51,2022-12-05,205,205,205,0,1982,1995,1994,1,12,0,0,3,375,375,375,375
Marin,51,2022-12-05,312,312,312,0,3507,3526,3525,1,14,0,0,2,317,317,317,317
Mariposa,51,2022-12-05,19,19,19,0,174,175,174,1,0,0,0,0,30,30,30,30
Mendocino,51,2022-12-05,47,47,47,0,797,803,802,1,6,1,1,2,138,138,137,137
Merced,51,2022-12-05,351,351,351,0,3210,3228,3227,1,23,2,2,2,888,888,886,886
Modoc,51,2022-12-05,12,12,12,0,13,14,13,1,0,0,0,0,9,9,9,9
Mono,51,2022-12-05,9,9,9,0,91,92,91,1,0,0,0,0,8,8,8,8
Monterey,51,2022-12-05,271,271,271,0,4384,4408,4407,1,34,1,1,0,779,779,778,778
Napa,51,2022-12-05,160,160,160,0,2341,2355,2354,1,7,0,0,0,159,159,159,159
Nevada,51,2022-12-05,115,115,115,0,1123,1129,1128,1,8,0,0,2,132,132,132,132
Orange,51,2022-12-05,4182,4204,4204,0,34027,34207,34206,1,301,21,21,48,7678,7678,7657,7657
Placer,51,2022-12-05,392,392,392,0,4041,4063,4062,1,72,1,1,4,669,669,668,668
Plumas,51,2022-12-05,22,22,22,0,184,185,184,1,1,0,0,0,13,13,13,13
Riverside,51,2022-12-05,3959,3979,3979,0,27241,27385,27384,1,186,13,13,25,6696,6696,6683,6683
Sacramento,51,2022-12-05,2120,2131,2131,0,21126,21237,21236,1,128,8,8,28,3408,3408,3400,3400
San Benito,51,2022-12-05,219,219,219,0,1483,1493,1492,1,6,1,1,3,103,103,102,102
San Bernardino,51,2022-12-05,4016,4037,4037,0,28258,28406,28405,1,167,0,0,34,8105,8105,8105,8105
San Diego,51,2022-12-05,5673,5703,5703,0,44334,44568,44567,1,302,12,12,30,5636,5636,5624,5624
San Francisco,51,2022-12-05,1486,1494,1494,0,15939,16022,16021,1,77,7,7,7,1104,1104,1097,1097
San Joaquin,51,2022-12-05,1120,1127,1127,0,12629,12695,12694,1,70,8,8,16,2366,2366,2358,2358
San Luis Obispo,51,2022-12-05,206,206,206,0,2660,2674,2673,1,15,3,3,1,537,537,534,534
San Mateo,51,2022-12-05,1225,1232,1232,0,13442,13513,13512,1,56,1,1,1,740,740,739,739
Santa Barbara,51,2022-12-05,521,522,522,0,6764,6801,6800,1,38,1,1,9,743,743,742,742
Santa Clara,51,2022-12-05,3445,3465,3465,0,35389,35578,35577,1,207,11,11,26,2593,2593,2582,2582
Santa Cruz,51,2022-12-05,471,471,471,0,12731,12800,12799,1,22,0,0,3,276,276,276,276
Shasta,51,2022-12-05,132,132,132,0,1107,1115,1114,1,23,0,0,5,596,596,596,596
Siskiyou,51,2022-12-05,22,22,22,0,309,310,309,1,2,0,0,0,95,95,95,95
Solano,51,2022-12-05,643,646,646,0,6611,6647,6646,1,33,1,1,7,466,466,465,465
Sonoma,51,2022-12-05,505,506,506,0,5880,5912,5911,1,35,5,5,1,539,539,534,534
Stanislaus,51,2022-12-05,640,643,643,0,6729,6765,6764,1,76,1,1,7,1801,1801,1800,1800
Sutter,51,2022-12-05,96,96,96,0,1171,1180,1179,1,0,1,1,0,233,233,232,232
Tehama,51,2022-12-05,93,93,93,0,817,823,822,1,9,2,2,0,218,218,216,216
Trinity,51,2022-12-05,3,3,3,0,39,40,39,1,0,0,0,0,22,22,22,22
Tulare,51,2022-12-05,523,524,524,0,5950,5981,5980,1,35,0,0,1,1549,1549,1549,1549
Tuolumne,51,2022-12-05,107,107,107,0,852,858,857,1,2,0,0,0,201,201,201,201
Ventura,51,2022-12-05,1102,1109,1109,0,12163,12227,12226,1,71,2,2,6,1614,1614,1612,1612
Yolo,51,2022-12-05,214,214,214,0,2645,2660,2659,1,2,1,1,3,424,424,423,423
Yuba,51,2022-12-05,82,82,82,0,1038,1046,1045,1,11,0,0,1,122,122,122,122
Alameda,52,2022-12-12,2638,2656,2656,0,29270,29448,29447,1,147,11,11,20,2115,2115,2104,2104
Amador,52,2022-12-12,32,32,32,0,789,796,795,1,3,0,0,0,96,96,96,96
Butte,52,2022-12-12,183,183,183,0,1834,1846,1845,1,39,2,2,2,476,476,474,474
Calaveras,52,2022-12-12,41,41,41,0,454,456,455,1,1,0,0,0,136,136,136,136
Colusa,52,2022-12-12,12,12,12,0,272,273,272,1,1,0,0,0,22,22,22,22
Contra Costa,52,2022-12-12,1743,1753,1753,0,18414,18525,18524,1,78,10,10,4,1501,1501,1491,1491
Del Norte,52,2022-12-12,34,34,34,0,534,538,537,1,3,0,0,0,56,56,56,56
El Dorado,52,2022-12-12,146,146,146,0,1408,1418,1417,1,8,1,1,3,238,238,237,237
Fresno,52,2022-12-12,1477,1487,1487,0,13844,13929,13928,1,186,12,12,18,2928,2928,2916,2916
Glenn,52,2022-12-12,17,17,17,0,230,232,231,1,6,0,0,0,53,53,53,53
Humboldt,52,2022-12-12,106,106,106,0,1011,1018,1017,1,13,1,1,2,165,165,164,164
Imperial,52,2022-12-12,455,456,456,0,2943,2962,2961,1,27,3,3,3,970,970,967,967
Inyo,52,2022-12-12,22,22,22,0,303,305,304,1,1,0,0,0,62,62,62,62
Kern,52,2022-12-12,940,947,947,0,10844,10909,10908,1,55,2,2,4,2448,2448,2446,2446
Kings,52,2022-12-12,256,256,256,0,2855,2872,2871,1,8,2,2,0,472,472,470,470
Lake,52,2022-12-12,56,56,56,0,761,767,766,1,3,0,0,1,150,150,150,150
Lassen,52,2022-12-12,15,15,15,0,423,425,424,1,0,0,0,0,64,64,64,64
Los Angeles,52,2022-12-12,17458,17563,17563,0,225457,226826,226823,3,1113,158,165,154,34364,34372,34206,34207
Madera,52,2022-12-12,212,212,212,0,2174,2189,2188,1,15,0,0,2,375,375,375,375
Marin,52,2022-12-12,316,316,316,0,3616,3639,3638,1,24,0,0,2,317,317,317,317
Mariposa,52,2022-12-12,18,18,18,0,122,123,122,1,0,0,0,0,30,30,30,30
Mendocino,52,2022-12-12,53,53,53,0,657,662,661,1,7,1,1,0,139,139,138,138
Merced,52,2022-12-12,312,312,312,0,3323,3343,3342,1,14,0,0,2,888,888,888,888
Modoc,52,2022-12-12,5,5,5,0,10,11,10,1,0,0,0,0,9,9,9,9
Mono,52,2022-12-12,9,9,9,0,122,123,122,1,0,0,0,0,8,8,8,8
Monterey,52,2022-12-12,265,265,265,0,4255,4281,4280,1,25,3,3,2,782,782,779,779
Napa,52,2022-12-12,161,161,161,0,2172,2186,2185,1,9,1,1,0,160,160,159,159
Nevada,52,2022-12-12,90,90,90,0,969,975,974,1,5,0,0,2,132,132,132,132
Orange,52,2022-12-12,3424,3445,3445,0,31013,31201,31200,1,300,35,35,48,7713,7713,7678,7678
Placer,52,2022-12-12,330,330,330,0,3883,3909,3908,1,73,5,5,6,674,674,669,669
Plumas,52,2022-12-12,7,7,7,0,186,187,186,1,2,0,0,0,13,13,13,13
Riverside,52,2022-12-12,3301,3321,3321,0,24451,24600,24599,1,204,19,19,25,6715,6715,6696,6696
Sacramento,52,2022-12-12,1804,1815,1815,0,20062,20185,20184,1,173,7,7,31,3415,3415,3408,3408
San Benito,52,2022-12-12,125,125,125,0,1329,1339,1338,1,2,2,2,2,105,105,103,103
San Bernardino,52,2022-12-12,3543,3564,3564,0,26662,26824,26823,1,226,3,3,36,8108,8108,8105,8105
San Diego,52,2022-12-12,4839,4869,4869,0,40207,40451,40450,1,331,15,15,45,5651,5651,5636,5636
San Francisco,52,2022-12-12,1417,1425,1425,0,16728,16829,16828,1,103,7,7,12,1111,1111,1104,1104
San Joaquin,52,2022-12-12,1002,1009,1009,0,12707,12784,12783,1,68,6,6,19,2372,2372,2366,2366
San Luis Obispo,52,2022-12-12,231,231,231,0,2650,2666,2665,1,10,1,1,0,538,538,537,537
San Mateo,52,2022-12-12,1147,1154,1154,0,12351,12427,12426,1,59,0,0,3,740,740,740,740
Santa Barbara,52,2022-12-12,512,513,513,0,5761,5796,5795,1,36,2,2,6,745,745,743,743
Santa Clara,52,2022-12-12,3208,3228,3228,0,34806,35018,35017,1,198,17,17,30,2610,2610,2593,2593
Santa Cruz,52,2022-12-12,578,582,582,0,12931,13011,13010,1,29,0,0,1,276,276,276,276
Shasta,52,2022-12-12,104,104,104,0,1154,1163,1162,1,22,0,0,5,596,596,596,596
Siskiyou,52,2022-12-12,15,15,15,0,244,245,244,1,2,0,0,0,95,95,95,95
Solano,52,2022-12-12,637,642,642,0,6176,6215,6214,1,42,2,2,7,468,468,466,466
Sonoma,52,2022-12-12,559,562,562,0,5592,5626,5625,1,41,2,2,7,541,541,539,539
Stanislaus,52,2022-12-12,594,598,598,0,6380,6421,6420,1,104,8,8,12,1809,1809,1801,1801
Sutter,52,2022-12-12,114,114,114,0,1154,1163,1162,1,0,0,0,0,233,233,233,233
Tehama,52,2022-12-12,80,80,80,0,774,780,779,1,6,1,1,0,219,219,218,218
Trinity,52,2022-12-12,3,3,3,0,45,46,45,1,0,0,0,0,22,22,22,22
Tulare,52,2022-12-12,437,439,439,0,5890,5928,5927,1,27,2,2,2,1551,1551,1549,1549
Tuolumne,52,2022-12-12,133,133,133,0,934,942,941,1,5,0,0,0,201,201,201,201
Ventura,52,2022-12-12,914,921,921,0,10629,10695,10694,1,72,4,4,7,1618,1618,1614,1614
Yolo,52,2022-12-12,210,210,210,0,2296,2310,2309,1,5,2,2,2,426,426,424,424
Yuba,52,2022-12-12,75,75,75,0,948,954,953,1,13,0,0,0,122,122,122,122
Alameda,53,2022-12-19,2296,2313,2313,0,26701,26891,26890,1,144,11,11,19,2126,2126,2115,2115
Amador,53,2022-12-19,42,42,42,0,806,814,813,1,6,0,0,0,96,96,96,96
Butte,53,2022-12-19,128,128,128,0,1638,1651,1650,1,34,3,3,2,479,479,476,476
Calaveras,53,2022-12-19,29,29,29,0,441,445,444,1,1,1,1,0,137,137,136,136
Colusa,53,2022-12-19,12,12,12,0,214,216,215,1,1,0,0,0,22,22,22,22
Contra Costa,53,2022-12-19,1720,1731,1731,0,17324,17447,17446,1,95,6,6,7,1507,1507,1501,1501
Del Norte,53,2022-12-19,39,39,39,0,553,558,557,1,3,0,0,0,56,56,56,56
El Dorado,53,2022-12-19,160,160,160,0,1632,1645,1644,1,9,1,1,2,239,239,238,238
Fresno,53,2022-12-19,1168,1176,1176,0,12880,12972,12971,1,212,7,7,22,2935,2935,2928,2928
Glenn,53,2022-12-19,21,21,21,0,205,207,206,1,6,0,0,0,53,53,53,53
Humboldt,53,2022-12-19,113,113,113,0,942,950,949,1,9,0,0,1,165,165,165,165
Imperial,53,2022-12-19,262,262,262,0,2545,2564,2563,1,16,1,1,0,971,971,970,970
Inyo,53,2022-12-19,12,12,12,0,324,327,326,1,1,0,0,0,62,62,62,62
Kern,53,2022-12-19,920,926,926,0,10638,10715,10714,1,60,3,3,5,2451,2451,2448,2448
Kings,53,2022-12-19,229,229,229,0,2770,2790,2789,1,6,3,3,1,475,475,472,472
Lake,53,2022-12-19,70,70,70,0,794,801,800,1,4,1,1,0,151,151,150,150
Lassen,53,2022-12-19,8,8,8,0,466,470,469,1,0,0,0,0,64,64,64,64
Los Angeles,53,2022-12-19,15210,15319,15319,0,201913,203349,203347,2,1096,130,136,155,34494,34508,34364,34372
Madera,53,2022-12-19,186,186,186,0,1889,1904,1903,1,10,0,0,1,375,375,375,375
Marin,53,2022-12-19,268,268,268,0,3233,3255,3254,1,17,0,0,0,317,317,317,317
Mariposa,53,2022-12-19,25,25,25,0,133,134,133,1,0,0,0,0,30,30,30,30
Mendocino,53,2022-12-19,66,66,66,0,754,761,760,1,4,0,0,0,139,139,139,139
Merced,53,2022-12-19,262,262,262,0,2773,2794,2793,1,15,2,2,2,890,890,888,888
Modoc,53,2022-12-19,8,8,8,0,21,22,21,1,0,0,0,0,9,9,9,9
Mono,53,2022-12-19,11,11,11,0,121,122,121,1,1,0,0,0,8,8,8,8
Monterey,53,2022-12-19,231,231,231,0,3875,3904,3903,1,13,1,1,1,783,783,782,782
Napa,53,2022-12-19,181,181,181,0,2091,2107,2106,1,8,0,0,0,160,160,160,160
Nevada,53,2022-12-19,72,72,72,0,883,890,889,1,5,0,0,2,132,132,132,132
Orange,53,2022-12-19,3227,3250,3250,0,29778,29990,29989,1,296,32,32,51,7745,7745,7713,7713
Placer,53,2022-12-19,362,364,364,0,3829,3857,3856,1,90,1,1,10,675,675,674,674
Plumas,53,2022-12-19,7,7,7,0,188,189,188,1,0,0,0,0,13,13,13,13
Riverside,53,2022-12-19,3098,3120,3120,0,22554,22714,22713,1,177,21,21,22,6736,6736,6715,6715
Sacramento,53,2022-12-19,1722,1734,1734,0,19653,19793,19792,1,210,13,13,22,3428,3428,3415,3415
San Benito,53,2022-12-19,105,105,105,0,1136,1146,1145,1,0,4,4,1,109,109,105,105
San Bernardino,53,2022-12-19,3154,3177,3177,0,24738,24913,24912,1,200,4,4,38,8112,8112,8108,8108
San Diego,53,2022-12-19,4843,4877,4877,0,39017,39297,39296,1,381,16,16,45,5667,5667,5651,5651
San Francisco,53,2022-12-19,1216,1224,1224,0,15628,15740,15739,1,106,10,10,17,1121,1121,1111,1111
San Joaquin,53,2022-12-19,854,861,861,0,12988,13082,13081,1,58,11,11,19,2383,2383,2372,2372
San Luis Obispo,53,2022-12-19,242,242,242,0,2423,2442,2441,1,17,1,1,0,539,539,538,538
San Mateo,53,2022-12-19,917,924,924,0,11730,11813,11812,1,62,0,0,5,740,740,740,740
Santa Barbara,53,2022-12-19,468,471,471,0,5246,5284,5283,1,35,4,4,5,749,749,745,745
Santa Clara,53,2022-12-19,2784,2805,2805,0,32123,32352,32351,1,205,14,14,30,2624,2624,2610,2610
Santa Cruz,53,2022-12-19,259,260,260,0,11197,11278,11277,1,31,0,0,1,276,276,276,276
Shasta,53,2022-12-19,109,109,109,0,1126,1135,1134,1,24,1,1,4,597,597,596,596
Siskiyou,53,2022-12-19,15,15,15,0,258,259,258,1,2,0,0,0,95,95,95,95
Solano,53,2022-12-19,636,641,641,0,6177,6222,6221,1,41,0,0,6,468,468,468,468
Sonoma,53,2022-12-19,480,482,482,0,5421,5461,5460,1,38,1,1,4,542,542,541,541
Stanislaus,53,2022-12-19,474,477,477,0,5994,6038,6037,1,94,1,1,12,1810,1810,1809,1809
Sutter,53,2022-12-19,81,81,81,0,1074,1083,1082,1,0,1,1,0,234,234,233,233
Tehama,53,2022-12-19,67,67,67,0,676,682,681,1,6,1,1,0,220,220,219,219
Trinity,53,2022-12-19,2,2,2,0,31,32,31,1,0,0,0,0,22,22,22,22
Tulare,53,2022-12-19,467,469,469,0,5380,5420,5419,1,53,5,5,1,1556,1556,1551,1551
Tuolumne,53,2022-12-19,88,88,88,0,841,849,848,1,2,1,1,1,202,202,201,201
Ventura,53,2022-12-19,936,943,943,0,9940,10011,10010,1,81,4,4,9,1622,1622,1618,1618
Yolo,53,2022-12-19,172,172,172,0,1959,1974,1973,1,5,4,4,0,430,430,426,426
Yuba,53,2022-12-19,81,81,81,0,900,908,907,1,7,0,0,0,122,122,122,122
Alameda,54,2022-12-26,1942,1959,1959,0,20331,20499,20498,1,150,9,9,17,2135,2135,2126,2126
Amador,54,2022-12-26,43,43,43,0,758,766,765,1,5,1,1,0,97,97,96,96
Butte,54,2022-12-26,96,96,96,0,1294,1306,1305,1,33,0,0,1,479,479,479,479
Calaveras,54,2022-12-26,24,24,24,0,366,371,370,1,0,1,1,0,138,138,137,137
Colusa,54,2022-12-26,14,14,14,0,150,151,150,1,0,0,0,0,22,22,22,22
Contra Costa,54,2022-12-26,1461,1473,1473,0,13722,13835,13834,1,89,10,10,11,1517,1517,1507,1507
Del Norte,54,2022-12-26,33,33,33,0,420,424,423,1,3,0,0,0,56,56,56,56
El Dorado,54,2022-12-26,152,152,152,0,1316,1329,1328,1,7,1,1,0,240,240,239,239
Fresno,54,2022-12-26,1073,1082,1082,0,10643,10732,10731,1,186,10,10,33,2945,2945,2935,2935
Glenn,54,2022-12-26,12,12,12,0,196,198,197,1,0,0,0,0,53,53,53,53
Humboldt,54,2022-12-26,82,82,82,0,629,635,634,1,5,2,2,2,167,167,165,165
Imperial,54,2022-12-26,235,235,235,0,2162,2182,2181,1,67,2,2,0,973,973,971,971
Inyo,54,2022-12-26,13,13,13,0,158,159,158,1,1,0,0,0,62,62,62,62
Kern,54,2022-12-26,690,695,695,0,8722,8795,8794,1,51,9,9,8,2460,2460,2451,2451
Kings,54,2022-12-26,201,201,201,0,2296,2315,2314,1,5,0,0,2,475,475,475,475
Lake,54,2022-12-26,58,58,58,0,600,606,605,1,3,0,0,1,151,151,151,151
Lassen,54,2022-12-26,27,27,27,0,485,488,487,1,0,0,0,0,64,64,64,64
Los Angeles,54,2022-12-26,13420,13531,13531,0,132079,133165,133163,2,1032,168,175,164,34662,34683,34494,34508
Madera,54,2022-12-26,166,166,166,0,1563,1577,1576,1,6,0,0,1,375,375,375,375
Marin,54,2022-12-26,216,216,216,0,2555,2577,2576,1,29,0,0,2,317,317,317,317
Mariposa,54,2022-12-26,22,22,22,0,105,106,105,1,0,0,0,0,30,30,30,30
Mendocino,54,2022-12-26,75,75,75,0,646,652,651,1,10,0,0,0,139,139,139,139
Merced,54,2022-12-26,210,210,210,0,1963,1981,1980,1,17,5,5,3,895,895,890,890
Modoc,54,2022-12-26,4,4,4,0,11,12,11,1,0,0,0,0,9,9,9,9
Mono,54,2022-12-26,10,10,10,0,82,83,82,1,0,0,0,0,8,8,8,8
Monterey,54,2022-12-26,191,191,191,0,2956,2981,2980,1,21,4,4,0,787,787,783,783
Napa,54,2022-12-26,142,142,142,0,1718,1734,1733,1,12,0,0,0,160,160,160,160
Nevada,54,2022-12-26,66,66,66,0,749,756,755,1,9,0,0,1,132,132,132,132
Orange,54,2022-12-26,3153,3179,3179,0,24461,24661,24660,1,274,38,38,31,7783,7783,7745,7745
Placer,54,2022-12-26,293,293,293,0,3038,3064,3063,1,87,2,2,12,677,677,675,675
Plumas,54,2022-12-26,10,10,10,0,123,124,123,1,0,0,0,0,13,13,13,13
Riverside,54,2022-12-26,2861,2884,2884,0,18262,18413,18412,1,194,12,12,18,6748,6748,6736,6736
Sacramento,54,2022-12-26,1365,1377,1377,0,14466,14585,14584,1,179,12,12,25,3440,3440,3428,3428
San Benito,54,2022-12-26,106,106,106,0,810,817,816,1,1,0,0,1,109,109,109,109
San Bernardino,54,2022-12-26,2862,2885,2885,0,19893,20057,20056,1,210,7,7,26,8119,8119,8112,8112
San Diego,54,2022-12-26,4590,4628,4628,0,28541,28777,28776,1,395,25,25,45,5692,5692,5667,5667
San Francisco,54,2022-12-26,1010,1018,1018,0,11736,11833,11832,1,90,21,21,15,1142,1142,1121,1121
San Joaquin,54,2022-12-26,749,754,754,0,10079,10164,10163,1,60,7,7,10,2390,2390,2383,2383
San Luis Obispo,54,2022-12-26,212,212,212,0,1971,1987,1986,1,20,3,3,0,542,542,539,539
San Mateo,54,2022-12-26,818,825,825,0,8788,8861,8860,1,55,0,0,6,740,740,740,740
Santa Barbara,54,2022-12-26,486,491,491,0,4095,4130,4129,1,40,0,0,4,749,749,749,749
Santa Clara,54,2022-12-26,2275,2292,2292,0,23755,23952,23951,1,179,9,9,35,2633,2633,2624,2624
Santa Cruz,54,2022-12-26,221,222,222,0,4637,4676,4675,1,25,0,0,2,276,276,276,276
Shasta,54,2022-12-26,100,100,100,0,923,931,930,1,18,0,0,1,597,597,597,597
Siskiyou,54,2022-12-26,17,17,17,0,266,267,266,1,1,0,0,0,95,95,95,95
Solano,54,2022-12-26,648,653,653,0,5238,5282,5281,1,59,2,2,7,470,470,468,468
Sonoma,54,2022-12-26,453,458,458,0,4246,4282,4281,1,39,0,0,4,542,542,542,542
Stanislaus,54,2022-12-26,455,460,460,0,4897,4937,4936,1,96,10,10,5,1820,1820,1810,1810
Sutter,54,2022-12-26,128,128,128,0,928,937,936,1,0,0,0,0,234,234,234,234
Tehama,54,2022-12-26,48,48,48,0,607,613,612,1,2,3,3,0,223,223,220,220
Trinity,54,2022-12-26,3,3,3,0,39,40,39,1,0,0,0,0,22,22,22,22
Tulare,54,2022-12-26,442,447,447,0,3938,3972,3971,1,41,7,7,3,1563,1563,1556,1556
Tuolumne,54,2022-12-26,93,93,93,0,758,766,765,1,6,0,0,2,202,202,202,202
Ventura,54,2022-12-26,888,895,895,0,7838,7904,7903,1,71,16,16,11,1638,1638,1622,1622
Yolo,54,2022-12-26,140,140,140,0,1602,1617,1616,1,9,2,2,1,432,432,430,430
Yuba,54,2022-12-26,99,99,99,0,754,761,760,1,14,0,0,0,122,122,122,122
Alameda,55,2023-01-02,1819,1836,1836,0,19727,19918,19917,1,175,14,14,19,2149,2149,2135,2135
Amador,55,2023-01-02,34,34,34,0,675,683,682,1,3,1,1,0,98,98,97,97
Butte,55,2023-01-02,98,98,98,0,1327,1341,1340,1,35,3,3,2,482,482,479,479
Calaveras,55,2023-01-02,33,33,33,0,361,366,365,1,0,2,2,0,140,140,138,138
Colusa,55,2023-01-02,5,5,5,0,94,95,94,1,0,0,0,0,22,22,22,22
Contra Costa,55,2023-01-02,1383,1397,1397,0,14026,14161,14160,1,89,5,5,13,1522,1522,1517,1517
Del Norte,55,2023-01-02,32,32,32,0,408,413,412,1,3,0,0,2,56,56,56,56
El Dorado,55,2023-01-02,147,147,147,0,1405,1419,1418,1,7,1,1,2,241,241,240,240
Fresno,55,2023-01-02,1063,1073,1073,0,11335,11445,11444,1,195,16,16,28,2961,2961,2945,2945
Glenn,55,2023-01-02,12,12,12,0,190,192,191,1,0,0,0,0,53,53,53,53
Humboldt,55,2023-01-02,47,47,47,0,614,621,620,1,2,0,0,2,167,167,167,167
Imperial,55,2023-01-02,205,206,206,0,2034,2055,2054,1,11,0,0,1,973,973,973,973
Inyo,55,2023-01-02,16,16,16,0,226,228,227,1,1,0,0,0,62,62,62,62
Kern,55,2023-01-02,888,899,899,0,9582,9676,9675,1,66,2,2,8,2462,2462,2460,2460
Kings,55,2023-01-02,186,186,186,0,2165,2187,2186,1,4,2,2,1,477,477,475,475
Lake,55,2023-01-02,46,46,46,0,603,610,609,1,3,0,0,0,151,151,151,151
Lassen,55,2023-01-02,14,14,14,0,490,495,494,1,0,0,0,0,64,64,64,64
Los Angeles,55,2023-01-02,13322,13451,13451,0,135823,137138,137136,2,1091,143,152,154,34805,34835,34662,34683
Madera,55,2023-01-02,153,153,153,0,1650,1666,1665,1,7,0,0,0,375,375,375,375
Marin,55,2023-01-02,227,227,227,0,2408,2432,2431,1,24,0,0,2,317,317,317,317
Mariposa,55,2023-01-02,15,15,15,0,94,95,94,1,0,0,0,0,30,30,30,30
Mendocino,55,2023-01-02,59,59,59,0,687,695,694,1,6,1,1,3,140,140,139,139
Merced,55,2023-01-02,194,194,194,0,2011,2031,2030,1,8,2,2,4,897,897,895,895
Modoc,55,2023-01-02,9,9,9,0,13,14,13,1,0,0,0,0,9,9,9,9
Mono,55,2023-01-02,10,10,10,0,66,67,66,1,0,0,0,0,8,8,8,8
Monterey,55,2023-01-02,214,214,214,0,3040,3071,3070,1,27,0,0,0,787,787,787,787
Napa,55,2023-01-02,124,124,124,0,1676,1693,1692,1,8,1,1,1,161,161,160,160
Nevada,55,2023-01-02,54,54,54,0,721,728,727,1,8,0,0,2,132,132,132,132
Orange,55,2023-01-02,3183,3214,3214,0,24744,24983,24982,1,312,37,38,28,7820,7821,7783,7783
Placer,55,2023-01-02,306,308,308,0,3231,3263,3262,1,108,1,1,8,678,678,677,677
Plumas,55,2023-01-02,12,12,12,0,145,146,145,1,1,1,1,0,14,14,13,13
Riverside,55,2023-01-02,3038,3067,3067,0,19661,19851,19850,1,223,8,8,31,6756,6756,6748,6748
Sacramento,55,2023-01-02,1508,1523,1523,0,15211,15358,15357,1,201,18,18,26,3458,3458,3440,3440
San Benito,55,2023-01-02,58,58,58,0,790,798,797,1,1,0,0,1,109,109,109,109
San Bernardino,55,2023-01-02,2824,2852,2852,0,20605,20806,20805,1,183,3,3,31,8122,8122,8119,8119
San Diego,55,2023-01-02,4633,4678,4678,0,29184,29465,29464,1,401,24,24,43,5716,5716,5692,5692
San Francisco,55,2023-01-02,880,888,888,0,10123,10221,10220,1,77,11,11,15,1153,1153,1142,1142
San Joaquin,55,2023-01-02,753,760,760,0,10407,10508,10507,1,62,6,6,12,2396,2396,2390,2390
San Luis Obispo,55,2023-01-02,210,210,210,0,1994,2013,2012,1,17,6,6,0,548,548,542,542
San Mateo,55,2023-01-02,719,725,725,0,7887,7965,7964,1,50,0,0,9,740,740,740,740
Santa Barbara,55,2023-01-02,433,438,438,0,4040,4081,4080,1,47,1,1,5,750,750,749,749
Santa Clara,55,2023-01-02,2400,2424,2424,0,23020,23243,23242,1,200,15,15,32,2648,2648,2633,2633
Santa Cruz,55,2023-01-02,171,171,171,0,2999,3029,3028,1,27,0,0,0,276,276,276,276
Shasta,55,2023-01-02,98,98,98,0,945,955,954,1,20,0,0,1,597,597,597,597
Siskiyou,55,2023-01-02,15,15,15,0,268,269,268,1,1,0,0,0,95,95,95,95
Solano,55,2023-01-02,639,644,644,0,5294,5347,5346,1,60,3,3,11,473,473,470,470
Sonoma,55,2023-01-02,422,426,426,0,4255,4298,4297,1,56,0,0,2,542,542,542,542
Stanislaus,55,2023-01-02,474,479,479,0,5016,5066,5065,1,88,6,6,8,1826,1826,1820,1820
Sutter,55,2023-01-02,97,97,97,0,887,897,896,1,0,0,0,0,234,234,234,234
Tehama,55,2023-01-02,54,54,54,0,621,627,626,1,2,5,5,0,228,228,223,223
Trinity,55,2023-01-02,4,4,4,0,41,42,41,1,0,0,0,0,22,22,22,22
Tulare,55,2023-01-02,472,477,477,0,4713,4758,4757,1,52,1,1,6,1564,1564,1563,1563
Tuolumne,55,2023-01-02,66,66,66,0,662,670,669,1,5,0,0,0,202,202,202,202
Ventura,55,2023-01-02,902,910,910,0,7461,7535,7534,1,87,10,10,13,1648,1648,1638,1638
Yolo,55,2023-01-02,135,135,135,0,1519,1536,1535,1,4,2,2,1,434,434,432,432
Yuba,55,2023-01-02,79,79,79,0,730,739,738,1,19,0,0,1,122,122,122,122
Alameda,56,2023-01-09,1468,1484,1484,0,23069,23326,23325,1,149,12,12,11,2161,2161,2149,2149
Amador,56,2023-01-09,28,28,28,0,706,714,713,1,2,0,0,0,98,98,98,98
Butte,56,2023-01-09,86,86,86,0,1199,1213,1212,1,39,2,2,3,484,484,482,482
Calaveras,56,2023-01-09,19,19,19,0,341,346,345,1,0,0,0,1,140,140,140,140
Colusa,56,2023-01-09,8,8,8,0,92,93,92,1,0,0,0,0,22,22,22,22
Contra Costa,56,2023-01-09,1058,1071,1071,0,15347,15519,15518,1,85,5,5,11,1527,1527,1522,1522
Del Norte,56,2023-01-09,17,17,17,0,367,372,371,1,5,0,0,2,56,56,56,56
El Dorado,56,2023-01-09,87,87,87,0,1453,1469,1468,1,4,0,0,0,241,241,241,241
Fresno,56,2023-01-09,803,812,812,0,11446,11575,11574,1,171,7,7,23,2968,2968,2961,2961
Glenn,56,2023-01-09,8,8,8,0,185,187,186,1,0,0,0,0,53,53,53,53
Humboldt,56,2023-01-09,58,58,58,0,705,714,713,1,7,0,0,4,167,167,167,167
Imperial,56,2023-01-09,162,162,162,0,2437,2465,2464,1,12,2,2,2,975,975,973,973
Inyo,56,2023-01-09,10,10,10,0,205,208,207,1,0,0,0,0,62,62,62,62
Kern,56,2023-01-09,612,618,618,0,10476,10594,10593,1,73,1,1,8,2463,2463,2462,2462
Kings,56,2023-01-09,184,184,184,0,2314,2340,2339,1,9,0,0,0,477,477,477,477
Lake,56,2023-01-09,44,44,44,0,622,629,628,1,3,0,0,0,151,151,151,151
Lassen,56,2023-01-09,19,19,19,0,506,514,513,1,2,0,0,0,64,64,64,64
Los Angeles,56,2023-01-09,10116,10228,10228,0,187792,189888,189886,2,965,140,151,136,34945,34986,34805,34835
Madera,56,2023-01-09,100,100,100,0,1645,1664,1663,1,8,0,0,1,375,375,375,375
Marin,56,2023-01-09,146,146,146,0,2558,2588,2587,1,18,0,0,3,317,317,317,317
Mariposa,56,2023-01-09,9,9,9,0,105,106,105,1,0,1,1,0,31,31,30,30
Mendocino,56,2023-01-09,40,40,40,0,643,651,650,1,10,2,2,3,142,142,140,140
Merced,56,2023-01-09,185,185,185,0,2149,2175,2174,1,11,1,1,1,898,898,897,897
Modoc,56,2023-01-09,8,8,8,0,14,15,14,1,0,0,0,0,9,9,9,9
Mono,56,2023-01-09,12,12,12,0,78,79,78,1,0,0,0,0,8,8,8,8
Monterey,56,2023-01-09,170,170,170,0,3119,3155,3154,1,20,4,4,3,791,791,787,787
Napa,56,2023-01-09,132,132,132,0,1877,1898,1897,1,9,0,0,3,161,161,161,161
Nevada,56,2023-01-09,42,42,42,0,759,769,768,1,6,0,0,0,132,132,132,132
Orange,56,2023-01-09,2395,2423,2423,0,27560,27868,27867,1,267,36,40,34,7856,7861,7820,7821
Placer,56,2023-01-09,260,261,261,0,3386,3426,3425,1,89,0,0,6,678,678,678,678
Plumas,56,2023-01-09,5,5,5,0,88,89,88,1,1,0,0,0,14,14,14,14
Riverside,56,2023-01-09,1977,1999,1999,0,20860,21092,21091,1,186,11,11,26,6767,6767,6756,6756
Sacramento,56,2023-01-09,1013,1024,1024,0,15551,15724,15723,1,178,17,18,28,3475,3476,3458,3458
San Benito,56,2023-01-09,51,51,51,0,817,828,827,1,1,0,0,2,109,109,109,109
San Bernardino,56,2023-01-09,1718,1737,1737,0,20413,20640,20639,1,179,6,6,36,8128,8128,8122,8122
San Diego,56,2023-01-09,3582,3621,3621,0,34790,35180,35179,1,397,24,24,40,5740,5740,5716,5716
San Francisco,56,2023-01-09,785,794,794,0,12708,12850,12849,1,75,6,6,17,1159,1159,1153,1153
San Joaquin,56,2023-01-09,584,591,591,0,10951,11075,11074,1,51,10,10,12,2406,2406,2396,2396
San Luis Obispo,56,2023-01-09,185,186,186,0,2144,2170,2169,1,12,3,3,0,551,551,548,548
San Mateo,56,2023-01-09,597,604,604,0,9544,9651,9650,1,47,0,0,5,740,740,740,740
Santa Barbara,56,2023-01-09,367,372,372,0,4502,4553,4552,1,39,3,3,1,753,753,750,750
Santa Clara,56,2023-01-09,1938,1960,1960,0,28140,28456,28455,1,182,11,11,28,2659,2659,2648,2648
Santa Cruz,56,2023-01-09,152,152,152,0,4060,4106,4105,1,27,0,0,1,276,276,276,276
Shasta,56,2023-01-09,59,59,59,0,889,900,899,1,17,0,0,2,597,597,597,597
Siskiyou,56,2023-01-09,20,20,20,0,233,236,235,1,0,0,0,0,95,95,95,95
Solano,56,2023-01-09,403,408,408,0,5181,5241,5240,1,54,1,1,6,474,474,473,473
Sonoma,56,2023-01-09,286,290,290,0,4753,4806,4805,1,31,2,2,4,544,544,542,542
Stanislaus,56,2023-01-09,304,307,307,0,5176,5235,5234,1,87,6,6,8,1832,1832,1826,1826
Sutter,56,2023-01-09,62,62,62,0,869,879,878,1,0,0,0,0,234,234,234,234
Tehama,56,2023-01-09,28,28,28,0,491,497,496,1,1,2,2,0,230,230,228,228
Trinity,56,2023-01-09,3,3,3,0,30,31,30,1,0,0,0,0,22,22,22,22
Tulare,56,2023-01-09,334,338,338,0,5102,5160,5159,1,53,4,4,2,1568,1568,1564,1564
Tuolumne,56,2023-01-09,74,74,74,0,654,662,661,1,2,0,0,0,202,202,202,202
Ventura,56,2023-01-09,662,670,670,0,9357,9461,9460,1,65,5,5,12,1653,1653,1648,1648
Yolo,56,2023-01-09,108,108,108,0,1655,1673,1672,1,2,2,2,1,436,436,434,434
Yuba,56,2023-01-09,48,48,48,0,735,744,743,1,21,0,0,1,122,122,122,122
Alameda,57,2023-01-16,864,875,875,0,18926,19163,19162,1,105,5,5,11,2166,2166,2161,2161
Amador,57,2023-01-16,20,20,20,0,585,594,593,1,4,0,0,0,98,98,98,98
Butte,57,2023-01-16,58,58,58,0,1157,1172,1171,1,21,1,1,0,485,485,484,484
Calaveras,57,2023-01-16,10,10,10,0,308,314,313,1,2,0,0,1,140,140,140,140
Colusa,57,2023-01-16,7,7,7,0,86,87,86,1,1,0,0,0,22,22,22,22
Contra Costa,57,2023-01-16,615,622,622,0,12081,12232,12231,1,61,5,5,11,1532,1532,1527,1527
Del Norte,57,2023-01-16,10,10,10,0,303,307,306,1,3,2,2,1,58,58,56,56
El Dorado,57,2023-01-16,60,60,60,0,976,989,988,1,2,1,1,1,242,242,241,241
Fresno,57,2023-01-16,460,467,467,0,9712,9836,9835,1,162,7,7,13,2975,2975,2968,2968
Glenn,57,2023-01-16,3,3,3,0,163,165,164,1,0,0,0,0,53,53,53,53
Humboldt,57,2023-01-16,35,35,35,0,494,502,501,1,9,1,1,2,168,168,167,167
Imperial,57,2023-01-16,127,127,127,0,2068,2095,2094,1,10,2,2,2,977,977,975,975
Inyo,57,2023-01-16,11,11,11,0,199,202,201,1,0,0,0,0,62,62,62,62
Kern,57,2023-01-16,383,387,387,0,8222,8327,8326,1,55,4,4,13,2467,2467,2463,2463
Kings,57,2023-01-16,124,124,124,0,1982,2008,2007,1,5,2,2,0,479,479,477,477
Lake,57,2023-01-16,23,23,23,0,575,582,581,1,2,1,1,1,152,152,151,151
Lassen,57,2023-01-16,6,6,6,0,440,447,446,1,0,0,0,0,64,64,64,64
Los Angeles,57,2023-01-16,6095,6170,6170,0,147442,149288,149286,2,855,139,154,113,35084,35140,34945,34986
Madera,57,2023-01-16,67,67,67,0,1349,1366,1365,1,4,0,0,2,375,375,375,375
Marin,57,2023-01-16,124,124,124,0,2137,2165,2164,1,20,0,0,1,317,317,317,317
Mariposa,57,2023-01-16,11,11,11,0,95,96,95,1,0,0,0,0,31,31,31,31
Mendocino,57,2023-01-16,25,25,25,0,499,506,505,1,6,0,0,0,142,142,142,142
Merced,57,2023-01-16,120,120,120,0,1681,1704,1703,1,12,3,3,5,901,901,898,898
Modoc,57,2023-01-16,2,2,2,0,9,10,9,1,0,0,0,0,9,9,9,9
Mono,57,2023-01-16,6,6,6,0,68,69,68,1,0,0,0,0,8,8,8,8
Monterey,57,2023-01-16,113,113,113,0,2601,2636,2635,1,20,3,3,2,794,794,791,791
Napa,57,2023-01-16,63,63,63,0,1508,1527,1526,1,5,0,0,0,161,161,161,161
Nevada,57,2023-01-16,24,24,24,0,564,573,572,1,4,0,0,0,132,132,132,132
Orange,57,2023-01-16,1443,1462,1462,0,23898,24197,24196,1,245,35,38,32,7891,7899,7856,7861
Placer,57,2023-01-16,164,164,164,0,2631,2665,2664,1,68,0,0,6,678,678,678,678
Plumas,57,2023-01-16,2,2,2,0,71,72,71,1,1,0,0,0,14,14,14,14
Riverside,57,2023-01-16,1215,1229,1229,0,16949,17161,17160,1,169,15,15,36,6782,6782,6767,6767
Sacramento,57,2023-01-16,567,574,574,0,12386,12542,12541,1,149,18,19,23,3493,3495,3475,3476
San Benito,57,2023-01-16,27,27,27,0,467,475,474,1,0,1,1,0,110,110,109,109
San Bernardino,57,2023-01-16,981,993,993,0,16601,16811,16810,1,148,2,2,35,8130,8130,8128,8128
San Diego,57,2023-01-16,2063,2089,2089,0,28429,28786,28785,1,327,14,14,39,5754,5754,5740,5740
San Francisco,57,2023-01-16,438,445,445,0,10122,10248,10247,1,75,1,1,12,1160,1160,1159,1159
San Joaquin,57,2023-01-16,355,360,360,0,8772,8884,8883,1,42,8,8,11,2414,2414,2406,2406
San Luis Obispo,57,2023-01-16,108,108,108,0,1776,1800,1799,1,12,2,2,3,553,553,551,551
San Mateo,57,2023-01-16,388,394,394,0,7654,7751,7750,1,37,0,0,3,740,740,740,740
Santa Barbara,57,2023-01-16,242,244,244,0,3918,3967,3966,1,34,2,2,0,755,755,753,753
Santa Clara,57,2023-01-16,1095,1107,1107,0,23740,24037,24036,1,106,15,15,16,2674,2674,2659,2659
Santa Cruz,57,2023-01-16,171,171,171,0,6491,6573,6572,1,23,0,0,1,276,276,276,276
Shasta,57,2023-01-16,40,40,40,0,678,689,688,1,13,2,2,2,599,599,597,597
Siskiyou,57,2023-01-16,6,6,6,0,208,209,208,1,0,0,0,0,95,95,95,95
Solano,57,2023-01-16,222,224,224,0,3709,3757,3756,1,49,0,0,6,474,474,474,474
Sonoma,57,2023-01-16,187,187,187,0,3767,3815,3814,1,26,4,4,2,548,548,544,544
Stanislaus,57,2023-01-16,206,208,208,0,4242,4296,4295,1,72,3,3,3,1835,1835,1832,1832
Sutter,57,2023-01-16,47,47,47,0,713,723,722,1,0,0,0,0,234,234,234,234
Tehama,57,2023-01-16,16,16,16,0,326,332,331,1,1,0,0,0,230,230,230,230
Trinity,57,2023-01-16,3,3,3,0,23,24,23,1,0,0,0,0,22,22,22,22
Tulare,57,2023-01-16,265,268,268,0,4119,4171,4170,1,45,2,2,2,1570,1570,1568,1568
Tuolumne,57,2023-01-16,44,44,44,0,548,556,555,1,1,0,0,0,202,202,202,202
Ventura,57,2023-01-16,413,420,420,0,7819,7918,7917,1,53,4,4,12,1657,1657,1653,1653
Yolo,57,2023-01-16,74,74,74,0,1248,1264,1263,1,2,1,1,0,437,437,436,436
Yuba,57,2023-01-16,38,38,38,0,595,604,603,1,9,0,0,2,122,122,122,122
Alameda,58,2023-01-23,733,744,744,0,21015,21315,21314,1,100,10,10,9,2176,2176,2166,2166
Amador,58,2023-01-23,34,34,34,0,590,599,598,1,1,1,1,0,99,99,98,98
Butte,58,2023-01-23,42,42,42,0,1080,1097,1096,1,13,1,1,0,486,486,485,485
Calaveras,58,2023-01-23,15,15,15,0,279,285,284,1,0,0,0,0,140,140,140,140
Colusa,58,2023-01-23,10,10,10,0,142,144,143,1,0,0,0,0,22,22,22,22
Contra Costa,58,2023-01-23,515,522,522,0,13282,13471,13470,1,61,6,6,6,1538,1538,1532,1532
Del Norte,58,2023-01-23,22,22,22,0,359,365,364,1,1,0,0,0,58,58,58,58
El Dorado,58,2023-01-23,40,40,40,0,1080,1097,1096,1,2,0,0,0,242,242,242,242
Fresno,58,2023-01-23,442,449,449,0,10082,10227,10226,1,117,5,5,19,2980,2980,2975,2975
Glenn,58,2023-01-23,3,3,3,0,153,155,154,1,0,0,0,0,53,53,53,53
Humboldt,58,2023-01-23,34,34,34,0,549,558,557,1,9,1,1,4,169,169,168,168
Imperial,58,2023-01-23,83,83,83,0,2257,2291,2290,1,10,0,0,1,977,977,977,977
Inyo,58,2023-01-23,6,6,6,0,164,166,165,1,0,1,1,0,63,63,62,62
Kern,58,2023-01-23,302,308,308,0,9211,9343,9342,1,34,3,3,8,2470,2470,2467,2467
Kings,58,2023-01-23,108,108,108,0,1984,2014,2013,1,6,0,0,0,479,479,479,479
Lake,58,2023-01-23,28,28,28,0,579,588,587,1,2,2,2,2,154,154,152,152
Lassen,58,2023-01-23,5,5,5,0,465,472,471,1,0,0,0,0,64,64,64,64
Los Angeles,58,2023-01-23,5587,5667,5667,0,168877,171289,171287,2,665,106,120,96,35190,35260,35084,35140
Madera,58,2023-01-23,51,51,51,0,1433,1455,1454,1,6,0,0,2,375,375,375,375
Marin,58,2023-01-23,108,108,108,0,2350,2384,2383,1,18,0,0,3,317,317,317,317
Mariposa,58,2023-01-23,7,7,7,0,103,104,103,1,0,0,0,0,31,31,31,31
Mendocino,58,2023-01-23,21,21,21,0,546,555,554,1,4,0,0,0,142,142,142,142
Merced,58,2023-01-23,126,126,126,0,1922,1952,1951,1,9,2,2,3,903,903,901,901
Modoc,58,2023-01-23,1,1,1,0,11,12,11,1,1,0,0,0,9,9,9,9
Mono,58,2023-01-23,5,5,5,0,73,74,73,1,0,0,0,0,8,8,8,8
Monterey,58,2023-01-23,106,106,106,0,2753,2794,2793,1,15,1,1,2,795,795,794,794
Napa,58,2023-01-23,78,78,78,0,1505,1529,1528,1,4,0,0,1,161,161,161,161
Nevada,58,2023-01-23,20,20,20,0,600,610,609,1,3,0,0,2,132,132,132,132
Orange,58,2023-01-23,1153,1170,1170,0,23848,24190,24189,1,177,23,25,27,7914,7924,7891,7899
Placer,58,2023-01-23,138,138,138,0,2717,2758,2757,1,42,1,1,7,679,679,678,678
Plumas,58,2023-01-23,5,5,5,0,90,91,90,1,1,0,0,0,14,14,14,14
Riverside,58,2023-01-23,1009,1024,1024,0,16073,16303,16302,1,111,12,12,22,6794,6794,6782,6782
Sacramento,58,2023-01-23,592,601,601,0,13675,13871,13870,1,134,10,10,21,3503,3505,3493,3495
San Benito,58,2023-01-23,27,27,27,0,563,573,572,1,0,0,0,0,110,110,110,110
San Bernardino,58,2023-01-23,1023,1039,1039,0,18963,19235,19234,1,127,1,1,33,8131,8131,8130,8130
San Diego,58,2023-01-23,2024,2053,2053,0,33037,33511,33510,1,236,9,9,37,5763,5763,5754,5754
San Francisco,58,2023-01-23,450,457,457,0,11230,11391,11390,1,58,6,6,5,1166,1166,1160,1160
San Joaquin,58,2023-01-23,241,246,246,0,8399,8521,8520,1,29,3,3,8,2417,2417,2414,2414
San Luis Obispo,58,2023-01-23,109,109,109,0,1949,1978,1977,1,8,3,3,2,556,556,553,553
San Mateo,58,2023-01-23,346,351,351,0,8645,8770,8769,1,21,0,0,0,740,740,740,740
Santa Barbara,58,2023-01-23,209,211,211,0,4241,4303,4302,1,28,2,2,4,757,757,755,755
Santa Clara,58,2023-01-23,1017,1032,1032,0,24369,24718,24717,1,119,5,5,23,2679,2679,2674,2674
Santa Cruz,58,2023-01-23,122,122,122,0,9479,9617,9616,1,16,0,0,0,276,276,276,276
Shasta,58,2023-01-23,23,23,23,0,747,759,758,1,6,1,1,1,600,600,599,599
Siskiyou,58,2023-01-23,6,6,6,0,178,179,178,1,0,0,0,0,95,95,95,95
Solano,58,2023-01-23,228,231,231,0,4212,4272,4271,1,33,0,0,2,474,474,474,474
Sonoma,58,2023-01-23,201,203,203,0,4276,4339,4338,1,26,0,0,4,548,548,548,548
Stanislaus,58,2023-01-23,179,179,179,0,4287,4349,4348,1,57,2,2,6,1837,1837,1835,1835
Sutter,58,2023-01-23,41,41,41,0,778,791,790,1,0,1,1,0,235,235,234,234
Tehama,58,2023-01-23,15,15,15,0,294,299,298,1,1,0,0,0,230,230,230,230
Trinity,58,2023-01-23,4,4,4,0,31,32,31,1,0,0,0,0,22,22,22,22
Tulare,58,2023-01-23,220,222,222,0,4168,4228,4227,1,27,1,1,5,1571,1571,1570,1570
Tuolumne,58,2023-01-23,36,36,36,0,484,492,491,1,0,0,0,1,202,202,202,202
Ventura,58,2023-01-23,367,374,374,0,8578,8702,8701,1,57,5,5,3,1662,1662,1657,1657
Yolo,58,2023-01-23,84,84,84,0,1364,1386,1385,1,2,3,3,0,440,440,437,437
Yuba,58,2023-01-23,29,29,29,0,725,737,736,1,3,0,0,0,122,122,122,122
Alameda,59,2023-01-30,833,847,847,0,18314,18616,18615,1,85,3,3,4,2179,2179,2176,2176
Amador,59,2023-01-30,24,24,24,0,620,631,630,1,3,0,0,0,99,99,99,99
Butte,59,2023-01-30,55,55,55,0,1124,1144,1143,1,13,1,1,2,487,487,486,486
Calaveras,59,2023-01-30,15,15,15,0,318,325,324,1,0,0,0,0,140,140,140,140
Colusa,59,2023-01-30,7,7,7,0,169,172,171,1,0,0,0,0,22,22,22,22
Contra Costa,59,2023-01-30,646,657,657,0,12401,12606,12605,1,38,9,9,6,1547,1547,1538,1538
Del Norte,59,2023-01-30,31,31,31,0,382,390,389,1,1,1,1,0,59,59,58,58
El Dorado,59,2023-01-30,60,60,60,0,1190,1211,1210,1,4,2,2,0,244,244,242,242
Fresno,59,2023-01-30,445,452,452,0,9854,10017,10016,1,117,8,9,10,2988,2989,2980,2980
Glenn,59,2023-01-30,2,2,2,0,155,157,156,1,0,0,0,0,53,53,53,53
Humboldt,59,2023-01-30,29,29,29,0,563,572,571,1,6,0,0,1,169,169,169,169
Imperial,59,2023-01-30,103,103,103,0,2068,2103,2102,1,7,0,0,0,977,977,977,977
Inyo,59,2023-01-30,10,10,10,0,202,207,206,1,1,0,0,0,63,63,63,63
Kern,59,2023-01-30,301,306,306,0,8706,8852,8851,1,36,1,1,8,2471,2471,2470,2470
Kings,59,2023-01-30,136,136,136,0,2211,2247,2246,1,7,0,0,1,479,479,479,479
Lake,59,2023-01-30,26,26,26,0,555,566,565,1,5,2,2,1,156,156,154,154
Lassen,59,2023-01-30,4,4,4,0,490,500,499,1,0,0,0,0,64,64,64,64
Los Angeles,59,2023-01-30,5766,5863,5863,0,150922,153416,153414,2,633,103,122,72,35293,35382,35190,35260
Madera,59,2023-01-30,48,48,48,0,1478,1504,1503,1,7,0,0,0,375,375,375,375
Marin,59,2023-01-30,97,97,97,0,2152,2190,2189,1,19,0,0,1,317,317,317,317
Mariposa,59,2023-01-30,5,5,5,0,105,106,105,1,0,0,0,0,31,31,31,31
Mendocino,59,2023-01-30,24,24,24,0,517,526,525,1,2,0,0,1,142,142,142,142
Merced,59,2023-01-30,135,135,135,0,1797,1828,1827,1,11,0,0,3,903,903,903,903
Modoc,59,2023-01-30,0,0,0,0,8,9,8,1,1,0,0,0,9,9,9,9
Mono,59,2023-01-30,2,2,2,0,67,68,67,1,0,0,0,0,8,8,8,8
Monterey,59,2023-01-30,155,155,155,0,2846,2894,2893,1,8,1,1,1,796,796,795,795
Napa,59,2023-01-30,72,72,72,0,1370,1393,1392,1,4,0,0,0,161,161,161,161
Nevada,59,2023-01-30,29,29,29,0,589,600,599,1,2,0,0,1,132,132,132,132
Orange,59,2023-01-30,1181,1201,1201,0,22513,22885,22884,1,136,11,13,25,7925,7937,7914,7924
Placer,59,2023-01-30,169,171,171,0,2705,2751,2750,1,49,2,2,3,681,681,679,679
Plumas,59,2023-01-30,3,3,3,0,75,76,75,1,0,0,0,0,14,14,14,14
Riverside,59,2023-01-30,1071,1090,1090,0,15878,16141,16140,1,84,4,4,17,6798,6798,6794,6794
Sacramento,59,2023-01-30,661,672,672,0,13344,13565,13564,1,117,8,8,13,3511,3513,3503,3505
San Benito,59,2023-01-30,30,30,30,0,561,570,569,1,0,0,0,0,110,110,110,110
San Bernardino,59,2023-01-30,919,934,934,0,17116,17401,17400,1,140,0,0,19,8131,8131,8131,8131
San Diego,59,2023-01-30,1857,1887,1887,0,30025,30523,30522,1,202,10,10,32,5773,5773,5763,5763
San Francisco,59,2023-01-30,472,480,480,0,10852,11032,11031,1,51,2,2,4,1168,1168,1166,1166
San Joaquin,59,2023-01-30,299,305,305,0,7656,7784,7783,1,22,2,2,5,2419,2419,2417,2417
San Luis Obispo,59,2023-01-30,141,142,142,0,1912,1944,1943,1,13,4,4,0,560,560,556,556
San Mateo,59,2023-01-30,427,434,434,0,8558,8700,8699,1,25,0,0,3,740,740,740,740
Santa Barbara,59,2023-01-30,226,230,230,0,4263,4335,4334,1,25,1,1,2,758,758,757,757
Santa Clara,59,2023-01-30,1178,1198,1198,0,23403,23790,23789,1,132,5,5,14,2684,2684,2679,2679
Santa Cruz,59,2023-01-30,132,134,134,0,9328,9483,9482,1,12,0,0,0,276,276,276,276
Shasta,59,2023-01-30,18,18,18,0,656,668,667,1,7,0,0,0,600,600,600,600
Siskiyou,59,2023-01-30,6,6,6,0,195,199,198,1,0,0,0,0,95,95,95,95
Solano,59,2023-01-30,234,239,239,0,4167,4237,4236,1,40,0,0,1,474,474,474,474
Sonoma,59,2023-01-30,157,158,158,0,3593,3654,3653,1,23,1,1,1,549,549,548,548
Stanislaus,59,2023-01-30,229,234,234,0,4127,4196,4195,1,43,2,2,3,1839,1839,1837,1837
Sutter,59,2023-01-30,36,36,36,0,608,619,618,1,0,1,1,0,236,236,235,235
Tehama,59,2023-01-30,8,8,8,0,255,261,260,1,1,1,1,0,231,231,230,230
Trinity,59,2023-01-30,7,7,7,0,26,27,26,1,0,0,0,0,22,22,22,22
Tulare,59,2023-01-30,263,268,268,0,4020,4089,4088,1,28,3,3,3,1574,1574,1571,1571
Tuolumne,59,2023-01-30,45,45,45,0,600,611,610,1,3,0,0,0,202,202,202,202
Ventura,59,2023-01-30,363,370,370,0,8119,8253,8252,1,46,7,7,8,1669,1669,1662,1662
Yolo,59,2023-01-30,85,85,85,0,1295,1317,1316,1,2,1,1,0,441,441,440,440
Yuba,59,2023-01-30,31,31,31,0,656,669,668,1,3,0,0,1,122,122,122,122
Alameda,60,2023-02-06,1091,1112,1112,0,18114,18473,18472,1,86,5,6,9,2184,2185,2179,2179
Amador,60,2023-02-06,29,29,29,0,637,649,648,1,1,0,0,0,99,99,99,99
Butte,60,2023-02-06,81,81,81,0,1205,1230,1229,1,20,0,0,1,487,487,487,487
Calaveras,60,2023-02-06,14,14,14,0,323,332,331,1,0,0,0,0,140,140,140,140
Colusa,60,2023-02-06,6,6,6,0,184,188,187,1,0,0,0,0,22,22,22,22
Contra Costa,60,2023-02-06,710,724,724,0,11843,12076,12075,1,50,2,2,9,1549,1549,1547,1547
Del Norte,60,2023-02-06,58,58,58,0,394,403,402,1,0,0,0,0,59,59,59,59
El Dorado,60,2023-02-06,59,59,59,0,1132,1156,1155,1,3,0,0,0,244,244,244,244
Fresno,60,2023-02-06,493,501,501,0,9021,9202,9201,1,89,4,4,15,2992,2993,2988,2989
Glenn,60,2023-02-06,11,11,11,0,170,173,172,1,0,0,0,0,53,53,53,53
Humboldt,60,2023-02-06,54,54,54,0,565,578,577,1,6,1,1,0,170,170,169,169
Imperial,60,2023-02-06,120,120,120,0,2097,2140,2139,1,7,1,1,0,978,978,977,977
Inyo,60,2023-02-06,9,9,9,0,209,213,212,1,0,0,0,0,63,63,63,63
Kern,60,2023-02-06,326,333,333,0,8521,8690,8689,1,34,2,2,4,2473,2473,2471,2471
Kings,60,2023-02-06,126,127,127,0,2055,2097,2096,1,3,0,0,1,479,479,479,479
Lake,60,2023-02-06,25,25,25,0,561,572,571,1,5,0,0,0,156,156,156,156
Lassen,60,2023-02-06,6,6,6,0,445,456,455,1,0,0,0,0,64,64,64,64
Los Angeles,60,2023-02-06,5861,5978,5978,0,141056,143840,143838,2,609,85,107,83,35378,35489,35293,35382
Madera,60,2023-02-06,55,55,55,0,1308,1334,1333,1,4,1,1,0,376,376,375,375
Marin,60,2023-02-06,143,144,144,0,2129,2172,2171,1,13,0,0,3,317,317,317,317
Mariposa,60,2023-02-06,2,2,2,0,105,106,105,1,0,0,0,0,31,31,31,31
Mendocino,60,2023-02-06,30,30,30,0,513,524,523,1,4,0,0,2,142,142,142,142
Merced,60,2023-02-06,165,167,167,0,1884,1923,1922,1,12,0,0,0,903,903,903,903
Modoc,60,2023-02-06,2,2,2,0,6,7,6,1,0,0,0,0,9,9,9,9
Mono,60,2023-02-06,4,4,4,0,92,94,93,1,0,0,0,0,8,8,8,8
Monterey,60,2023-02-06,224,230,230,0,2934,2994,2993,1,22,3,3,1,799,799,796,796
Napa,60,2023-02-06,109,110,110,0,1404,1432,1431,1,4,0,0,3,161,161,161,161
Nevada,60,2023-02-06,32,32,32,0,572,585,584,1,4,0,0,0,132,132,132,132
Orange,60,2023-02-06,1273,1299,1299,0,22043,22478,22477,1,154,15,18,20,7940,7955,7925,7937
Placer,60,2023-02-06,164,166,166,0,2650,2703,2702,1,41,0,0,4,681,681,681,681
Plumas,60,2023-02-06,1,1,1,0,70,71,70,1,0,1,1,0,15,15,14,14
Riverside,60,2023-02-06,1121,1145,1145,0,15373,15677,15676,1,89,2,2,14,6800,6800,6798,6798
Sacramento,60,2023-02-06,729,744,744,0,13141,13401,13400,1,96,5,6,19,3516,3519,3511,3513
San Benito,60,2023-02-06,50,50,50,0,538,550,549,1,1,0,0,0,110,110,110,110
San Bernardino,60,2023-02-06,1061,1082,1082,0,17303,17645,17644,1,152,0,0,17,8131,8131,8131,8131
San Diego,60,2023-02-06,1868,1905,1905,0,29906,30501,30500,1,230,8,10,23,5781,5783,5773,5773
San Francisco,60,2023-02-06,573,585,585,0,10493,10702,10701,1,58,3,3,2,1171,1171,1168,1168
San Joaquin,60,2023-02-06,434,442,442,0,6925,7062,7061,1,32,1,1,3,2420,2420,2419,2419
San Luis Obispo,60,2023-02-06,147,150,150,0,1901,1939,1938,1,7,1,1,0,561,561,560,560
San Mateo,60,2023-02-06,523,532,532,0,8136,8299,8298,1,42,0,0,1,740,740,740,740
Santa Barbara,60,2023-02-06,239,245,245,0,4364,4452,4451,1,21,1,1,0,759,759,758,758
Santa Clara,60,2023-02-06,1309,1337,1337,0,23216,23676,23675,1,123,9,11,23,2693,2695,2684,2684
Santa Cruz,60,2023-02-06,230,235,235,0,10391,10599,10598,1,11,0,0,0,276,276,276,276
Shasta,60,2023-02-06,24,24,24,0,638,651,650,1,9,0,0,0,600,600,600,600
Siskiyou,60,2023-02-06,11,11,11,0,221,227,226,1,0,0,0,0,95,95,95,95
Solano,60,2023-02-06,285,291,291,0,3852,3929,3928,1,41,0,0,5,474,474,474,474
Sonoma,60,2023-02-06,265,272,272,0,3564,3635,3634,1,17,2,2,1,551,551,549,549
Stanislaus,60,2023-02-06,276,283,283,0,3926,4005,4004,1,54,1,1,6,1840,1840,1839,1839
Sutter,60,2023-02-06,52,52,52,0,704,718,717,1,0,0,0,0,236,236,236,236
Tehama,60,2023-02-06,17,17,17,0,283,291,290,1,2,0,0,0,231,231,231,231
Trinity,60,2023-02-06,1,1,1,0,19,20,19,1,0,0,0,0,22,22,22,22
Tulare,60,2023-02-06,270,276,276,0,4389,4478,4477,1,28,1,1,3,1575,1575,1574,1574
Tuolumne,60,2023-02-06,48,48,48,0,555,566,565,1,1,0,0,0,202,202,202,202
Ventura,60,2023-02-06,324,331,331,0,6920,7057,7056,1,39,1,1,5,1670,1670,1669,1669
Yolo,60,2023-02-06,80,80,80,0,1247,1273,1272,1,4,1,1,2,442,442,441,441
Yuba,60,2023-02-06,22,22,22,0,623,637,636,1,3,0,0,1,122,122,122,122
Alameda,61,2023-02-13,1091,1118,1118,0,17494,17933,17932,1,90,1,2,8,2185,2187,2184,2185
Amador,61,2023-02-13,19,19,19,0,497,512,511,1,0,0,0,0,99,99,99,99
Butte,61,2023-02-13,85,86,86,0,1250,1282,1281,1,25,0,0,2,487,487,487,487
Calaveras,61,2023-02-13,14,14,14,0,295,304,303,1,0,0,0,0,140,140,140,140
Colusa,61,2023-02-13,8,8,8,0,137,140,139,1,0,0,0,0,22,22,22,22
Contra Costa,61,2023-02-13,677,694,694,0,11528,11818,11817,1,44,2,2,10,1551,1551,1549,1549
Del Norte,61,2023-02-13,19,19,19,0,299,307,306,1,2,0,0,0,59,59,59,59
El Dorado,61,2023-02-13,65,65,65,0,1099,1127,1126,1,2,0,0,0,244,244,244,244
Fresno,61,2023-02-13,465,477,477,0,8719,8940,8939,1,106,4,4,7,2996,2997,2992,2993
Glenn,61,2023-02-13,11,11,11,0,175,180,179,1,5,0,0,0,53,53,53,53
Humboldt,61,2023-02-13,35,35,35,0,577,592,591,1,7,0,0,1,170,170,170,170
Imperial,61,2023-02-13,140,143,143,0,1852,1899,1898,1,3,0,0,5,978,978,978,978
Inyo,61,2023-02-13,6,6,6,0,199,205,204,1,0,0,0,0,63,63,63,63
Kern,61,2023-02-13,324,332,332,0,7970,8171,8170,1,37,2,3,6,2475,2476,2473,2473
Kings,61,2023-02-13,88,89,89,0,1889,1939,1938,1,6,1,2,0,480,481,479,479
Lake,61,2023-02-13,20,20,20,0,567,583,582,1,2,0,0,0,156,156,156,156
Lassen,61,2023-02-13,5,5,5,0,361,371,370,1,0,0,0,0,64,64,64,64
Los Angeles,61,2023-02-13,5850,5997,5997,0,129258,132509,132507,2,613,62,88,67,35440,35577,35378,35489
Madera,61,2023-02-13,58,58,58,0,1238,1271,1270,1,7,0,0,2,376,376,376,376
Marin,61,2023-02-13,139,142,142,0,1928,1978,1977,1,19,0,0,3,317,317,317,317
Mariposa,61,2023-02-13,3,3,3,0,102,103,102,1,0,0,0,0,31,31,31,31
Mendocino,61,2023-02-13,28,28,28,0,538,553,552,1,3,1,1,1,143,143,142,142
Merced,61,2023-02-13,167,172,172,0,1855,1902,1901,1,8,0,0,0,903,903,903,903
Modoc,61,2023-02-13,0,0,0,0,2,3,2,1,0,0,0,0,9,9,9,9
Mono,61,2023-02-13,1,1,1,0,66,67,66,1,0,0,0,0,8,8,8,8
Monterey,61,2023-02-13,217,224,224,0,2486,2550,2549,1,25,3,3,1,802,802,799,799
Napa,61,2023-02-13,92,92,92,0,1362,1397,1396,1,4,0,0,0,161,161,161,161
Nevada,61,2023-02-13,34,34,34,0,596,611,610,1,4,0,0,1,132,132,132,132
Orange,61,2023-02-13,1350,1385,1385,0,20343,20855,20854,1,161,7,11,21,7947,7966,7940,7955
Placer,61,2023-02-13,161,165,165,0,2612,2678,2677,1,35,0,0,6,681,681,681,681
Plumas,61,2023-02-13,3,3,3,0,79,80,79,1,1,0,0,0,15,15,15,15
Riverside,61,2023-02-13,1093,1121,1121,0,15919,16319,16318,1,93,6,8,16,6806,6808,6800,6800
Sacramento,61,2023-02-13,815,836,836,0,13016,13346,13345,1,113,5,6,19,3521,3525,3516,3519
San Benito,61,2023-02-13,42,42,42,0,565,580,579,1,1,0,0,0,110,110,110,110
San Bernardino,61,2023-02-13,1009,1034,1034,0,16801,17225,17224,1,134,0,0,18,8131,8131,8131,8131
San Diego,61,2023-02-13,2016,2066,2066,0,28745,29467,29466,1,218,3,5,25,5784,5788,5781,5783
San Francisco,61,2023-02-13,591,606,606,0,10642,10910,10909,1,59,3,3,5,1174,1174,1171,1171
San Joaquin,61,2023-02-13,449,460,460,0,6957,7134,7133,1,28,0,0,3,2420,2420,2420,2420
San Luis Obispo,61,2023-02-13,128,130,130,0,1676,1719,1718,1,4,0,0,4,561,561,561,561
San Mateo,61,2023-02-13,515,528,528,0,8107,8312,8311,1,29,0,0,5,740,740,740,740
Santa Barbara,61,2023-02-13,189,196,196,0,3935,4035,4034,1,16,1,1,5,760,760,759,759
Santa Clara,61,2023-02-13,1360,1395,1395,0,22915,23494,23493,1,114,7,10,25,2700,2705,2693,2695
Santa Cruz,61,2023-02-13,205,211,211,0,9620,9863,9862,1,19,0,0,0,276,276,276,276
Shasta,61,2023-02-13,33,33,33,0,667,684,683,1,7,0,0,0,600,600,600,600
Siskiyou,61,2023-02-13,11,11,11,0,199,207,206,1,0,0,0,0,95,95,95,95
Solano,61,2023-02-13,259,265,265,0,3772,3869,3868,1,28,0,0,3,474,474,474,474
Sonoma,61,2023-02-13,234,241,241,0,3421,3509,3508,1,32,1,1,1,552,552,551,551
Stanislaus,61,2023-02-13,266,272,272,0,3808,3904,3903,1,47,1,1,9,1841,1841,1840,1840
Sutter,61,2023-02-13,46,46,46,0,658,676,675,1,0,1,1,0,237,237,236,236
Tehama,61,2023-02-13,16,16,16,0,283,291,290,1,1,2,3,0,233,234,231,231
Trinity,61,2023-02-13,1,1,1,0,26,27,26,1,0,0,0,0,22,22,22,22
Tulare,61,2023-02-13,243,250,250,0,4115,4221,4220,1,29,1,1,1,1576,1576,1575,1575
Tuolumne,61,2023-02-13,34,34,34,0,507,521,520,1,2,0,0,0,202,202,202,202
Ventura,61,2023-02-13,309,317,317,0,6653,6823,6822,1,29,3,4,6,1673,1674,1670,1670
Yolo,61,2023-02-13,73,73,73,0,1240,1271,1270,1,3,0,0,1,442,442,442,442
Yuba,61,2023-02-13,30,30,30,0,642,659,658,1,8,0,0,0,122,122,122,122
Alameda,62,2023-02-20,998,1033,1033,0,15310,15836,15835,1,79,3,6,5,2188,2193,2185,2187
Amador,62,2023-02-20,25,25,25,0,496,515,514,1,1,0,0,1,99,99,99,99
Butte,62,2023-02-20,42,42,42,0,1051,1089,1088,1,7,0,0,1,487,487,487,487
Calaveras,62,2023-02-20,16,16,16,0,289,302,301,1,0,0,0,1,140,140,140,140
Colusa,62,2023-02-20,12,12,12,0,92,96,95,1,0,0,0,0,22,22,22,22
Contra Costa,62,2023-02-20,653,675,675,0,9918,10260,10259,1,57,1,2,6,1552,1553,1551,1551
Del Norte,62,2023-02-20,11,11,11,0,258,268,267,1,2,0,0,0,59,59,59,59
El Dorado,62,2023-02-20,51,51,51,0,975,1010,1009,1,2,0,0,1,244,244,244,244
Fresno,62,2023-02-20,450,466,466,0,8220,8509,8508,1,84,2,4,17,2998,3001,2996,2997
Glenn,62,2023-02-20,5,5,5,0,146,150,149,1,5,0,0,0,53,53,53,53
Humboldt,62,2023-02-20,30,30,30,0,575,596,595,1,7,0,0,1,170,170,170,170
Imperial,62,2023-02-20,107,112,112,0,1776,1839,1838,1,8,0,0,0,978,978,978,978
Inyo,62,2023-02-20,6,6,6,0,162,168,167,1,0,0,0,0,63,63,63,63
Kern,62,2023-02-20,396,411,411,0,7386,7645,7644,1,29,0,0,5,2475,2476,2475,2476
Kings,62,2023-02-20,78,80,80,0,1638,1696,1695,1,5,1,2,0,481,483,480,481
Lake,62,2023-02-20,18,18,18,0,482,500,499,1,2,0,0,1,156,156,156,156
Lassen,62,2023-02-20,2,2,2,0,327,340,339,1,0,0,0,0,64,64,64,64
Los Angeles,62,2023-02-20,5474,5666,5666,0,116605,120651,120650,1,601,52,98,76,35492,35675,35440,35577
Madera,62,2023-02-20,56,56,56,0,1088,1127,1126,1,3,0,0,2,376,376,376,376
Marin,62,2023-02-20,150,156,156,0,1849,1914,1913,1,13,0,0,2,317,317,317,317
Mariposa,62,2023-02-20,6,6,6,0,121,126,125,1,0,0,0,0,31,31,31,31
Mendocino,62,2023-02-20,24,24,24,0,489,507,506,1,3,0,0,0,143,143,143,143
Merced,62,2023-02-20,122,128,128,0,1753,1817,1816,1,19,0,0,1,903,903,903,903
Modoc,62,2023-02-20,1,1,1,0,15,16,15,1,0,0,0,0,9,9,9,9
Mono,62,2023-02-20,2,2,2,0,66,69,68,1,0,0,0,0,8,8,8,8
Monterey,62,2023-02-20,148,154,154,0,2314,2396,2395,1,22,0,0,0,802,802,802,802
Napa,62,2023-02-20,72,74,74,0,1085,1123,1122,1,3,0,0,1,161,161,161,161
Nevada,62,2023-02-20,26,26,26,0,611,633,632,1,7,1,2,1,133,134,132,132
Orange,62,2023-02-20,1321,1367,1367,0,19169,19835,19834,1,158,9,18,21,7956,7984,7947,7966
Placer,62,2023-02-20,160,166,166,0,2413,2498,2497,1,48,0,0,3,681,681,681,681
Plumas,62,2023-02-20,7,7,7,0,74,77,76,1,0,0,0,0,15,15,15,15
Riverside,62,2023-02-20,957,990,990,0,14992,15516,15515,1,92,5,10,9,6811,6818,6806,6808
Sacramento,62,2023-02-20,727,753,753,0,11505,11907,11906,1,103,5,11,16,3526,3536,3521,3525
San Benito,62,2023-02-20,24,24,24,0,476,494,493,1,1,1,2,0,111,112,110,110
San Bernardino,62,2023-02-20,877,908,908,0,15049,15574,15573,1,117,0,0,27,8131,8131,8131,8131
San Diego,62,2023-02-20,1747,1809,1809,0,24875,25739,25738,1,201,7,16,25,5791,5804,5784,5788
San Francisco,62,2023-02-20,586,608,608,0,9844,10186,10185,1,79,0,0,7,1174,1174,1174,1174
San Joaquin,62,2023-02-20,410,424,424,0,7361,7620,7619,1,30,0,0,7,2420,2420,2420,2420
San Luis Obispo,62,2023-02-20,94,97,97,0,1433,1485,1484,1,11,0,0,0,561,561,561,561
San Mateo,62,2023-02-20,459,475,475,0,7299,7551,7550,1,44,0,0,3,740,740,740,740
Santa Barbara,62,2023-02-20,204,211,211,0,3624,3751,3750,1,18,0,0,5,760,760,760,760
Santa Clara,62,2023-02-20,1208,1249,1249,0,19295,19958,19957,1,111,8,15,26,2708,2720,2700,2705
Santa Cruz,62,2023-02-20,136,142,142,0,6262,6469,6468,1,20,0,0,2,276,276,276,276
Shasta,62,2023-02-20,18,18,18,0,728,755,754,1,2,0,0,0,600,600,600,600
Siskiyou,62,2023-02-20,14,14,14,0,198,206,205,1,0,0,0,0,95,95,95,95
Solano,62,2023-02-20,229,236,236,0,3257,3372,3371,1,26,0,0,3,474,474,474,474
Sonoma,62,2023-02-20,260,268,268,0,3198,3310,3309,1,24,0,0,4,552,552,552,552
Stanislaus,62,2023-02-20,265,273,273,0,3643,3771,3770,1,55,0,0,4,1841,1841,1841,1841
Sutter,62,2023-02-20,38,38,38,0,539,559,558,1,0,1,2,0,238,239,237,237
Tehama,62,2023-02-20,13,13,13,0,279,290,289,1,0,0,0,0,233,234,233,234
Trinity,62,2023-02-20,0,0,0,0,30,31,30,1,0,0,0,0,22,22,22,22
Tulare,62,2023-02-20,210,218,218,0,3794,3927,3926,1,23,0,0,0,1576,1576,1576,1576
Tuolumne,62,2023-02-20,28,28,28,0,445,461,460,1,0,0,0,0,202,202,202,202
Ventura,62,2023-02-20,277,287,287,0,5592,5787,5786,1,30,3,6,7,1676,1680,1673,1674
Yolo,62,2023-02-20,87,88,88,0,1275,1321,1320,1,1,0,0,1,442,442,442,442
Yuba,62,2023-02-20,25,25,25,0,506,525,524,1,6,0,0,0,122,122,122,122
Alameda,63,2023-02-27,1085,1156,1156,0,18419,19617,19616,1,96,3,13,9,2191,2206,2188,2193
Amador,63,2023-02-27,19,19,19,0,520,555,554,1,1,0,0,1,99,99,99,99
Butte,63,2023-02-27,53,56,56,0,944,1002,1001,1,8,0,0,1,487,487,487,487
Calaveras,63,2023-02-27,14,14,14,0,306,326,325,1,1,0,0,0,140,140,140,140
Colusa,63,2023-02-27,12,12,12,0,85,92,91,1,0,0,0,0,22,22,22,22
Contra Costa,63,2023-02-27,697,742,742,0,11298,12027,12026,1,63,0,0,11,1552,1553,1552,1553
Del Norte,63,2023-02-27,7,7,7,0,288,308,307,1,0,0,0,0,59,59,59,59
El Dorado,63,2023-02-27,61,63,63,0,1037,1106,1105,1,2,0,0,0,244,244,244,244
Fresno,63,2023-02-27,457,486,486,0,8911,9501,9500,1,93,0,0,7,2998,3001,2998,3001
Glenn,63,2023-02-27,4,4,4,0,143,156,155,1,1,0,0,0,53,53,53,53
Humboldt,63,2023-02-27,22,22,22,0,488,521,520,1,4,0,0,1,170,170,170,170
Imperial,63,2023-02-27,165,177,177,0,1823,1942,1941,1,13,0,0,0,978,978,978,978
Inyo,63,2023-02-27,4,4,4,0,154,166,165,1,0,0,0,0,63,63,63,63
Kern,63,2023-02-27,386,411,411,0,8151,8681,8680,1,42,1,3,7,2476,2479,2475,2476
Kings,63,2023-02-27,61,64,64,0,1659,1767,1766,1,4,0,0,0,481,483,481,483
Lake,63,2023-02-27,21,21,21,0,465,496,495,1,2,0,0,1,156,156,156,156
Lassen,63,2023-02-27,3,3,3,0,352,376,375,1,0,0,0,0,64,64,64,64
Los Angeles,63,2023-02-27,4967,5287,5287,0,131879,140348,140346,2,573,35,177,75,35527,35852,35492,35675
Madera,63,2023-02-27,55,58,58,0,1179,1257,1256,1,7,0,0,1,376,376,376,376
Marin,63,2023-02-27,139,147,147,0,1961,2092,2091,1,16,0,0,3,317,317,317,317
Mariposa,63,2023-02-27,7,7,7,0,97,103,102,1,0,0,0,0,31,31,31,31
Mendocino,63,2023-02-27,21,21,21,0,492,525,524,1,5,0,0,1,143,143,143,143
Merced,63,2023-02-27,121,129,129,0,1883,2007,2006,1,19,0,0,1,903,903,903,903
Modoc,63,2023-02-27,1,1,1,0,8,9,8,1,0,0,0,0,9,9,9,9
Mono,63,2023-02-27,5,5,5,0,52,56,55,1,0,0,0,0,8,8,8,8
Monterey,63,2023-02-27,167,179,179,0,2576,2744,2743,1,30,1,4,1,803,806,802,802
Napa,63,2023-02-27,75,80,80,0,1289,1373,1372,1,7,0,0,4,161,161,161,161
Nevada,63,2023-02-27,21,21,21,0,563,600,599,1,2,0,0,0,133,134,133,134
Orange,63,2023-02-27,1165,1239,1239,0,19247,20495,20494,1,161,10,49,21,7966,8033,7956,7984
Placer,63,2023-02-27,179,191,191,0,2562,2733,2732,1,44,0,0,7,681,681,681,681
Plumas,63,2023-02-27,2,2,2,0,87,94,93,1,0,0,0,0,15,15,15,15
Riverside,63,2023-02-27,871,927,927,0,15227,16215,16214,1,76,5,16,15,6816,6834,6811,6818
Sacramento,63,2023-02-27,918,979,979,0,12708,13543,13542,1,121,2,6,19,3528,3542,3526,3536
San Benito,63,2023-02-27,28,28,28,0,473,506,505,1,2,0,0,0,111,112,111,112
San Bernardino,63,2023-02-27,846,900,900,0,16153,17216,17215,1,111,0,0,24,8131,8131,8131,8131
San Diego,63,2023-02-27,1787,1903,1903,0,26806,28537,28536,1,210,5,25,21,5796,5829,5791,5804
San Francisco,63,2023-02-27,654,697,697,0,11492,12245,12244,1,76,3,13,8,1177,1187,1174,1174
San Joaquin,63,2023-02-27,408,435,435,0,7502,8001,8000,1,33,0,0,3,2420,2420,2420,2420
San Luis Obispo,63,2023-02-27,79,84,84,0,1661,1772,1771,1,11,0,0,0,561,561,561,561
San Mateo,63,2023-02-27,465,496,496,0,7321,7810,7809,1,43,0,0,4,740,740,740,740
Santa Barbara,63,2023-02-27,174,184,184,0,3548,3786,3785,1,18,1,6,8,761,766,760,760
Santa Clara,63,2023-02-27,1306,1392,1392,0,21309,22703,22702,1,126,2,7,26,2710,2727,2708,2720
Santa Cruz,63,2023-02-27,158,168,168,0,8751,9329,9328,1,7,0,0,1,276,276,276,276
Shasta,63,2023-02-27,35,36,36,0,651,696,695,1,9,0,0,1,600,600,600,600
Siskiyou,63,2023-02-27,11,11,11,0,235,251,250,1,0,0,0,0,95,95,95,95
Solano,63,2023-02-27,292,310,310,0,3654,3895,3894,1,30,0,0,8,474,474,474,474
Sonoma,63,2023-02-27,219,234,234,0,3406,3628,3627,1,33,0,0,5,552,552,552,552
Stanislaus,63,2023-02-27,243,259,259,0,3835,4088,4087,1,58,0,0,3,1841,1841,1841,1841
Sutter,63,2023-02-27,46,48,48,0,503,537,536,1,0,0,0,0,238,239,238,239
Tehama,63,2023-02-27,14,14,14,0,266,285,284,1,2,0,0,1,233,234,233,234
Trinity,63,2023-02-27,0,0,0,0,20,21,20,1,0,0,0,0,22,22,22,22
Tulare,63,2023-02-27,209,223,223,0,4005,4272,4271,1,22,1,3,2,1577,1579,1576,1576
Tuolumne,63,2023-02-27,38,40,40,0,471,501,500,1,0,0,0,1,202,202,202,202
Ventura,63,2023-02-27,263,279,279,0,5905,6287,6286,1,35,0,0,7,1676,1680,1676,1680
Yolo,63,2023-02-27,91,98,98,0,1358,1452,1451,1,3,0,0,1,442,442,442,442
Yuba,63,2023-02-27,35,37,37,0,507,540,539,1,0,0,0,0,122,122,122,122
Alameda,64,2023-03-06,775,2597,2597,0,14255,34893,34892,1,96,0,0,12,2191,2206,2191,2206
Amador,64,2023-03-06,7,38,38,0,352,780,779,1,0,0,0,0,99,99,99,99
Butte,64,2023-03-06,25,66,66,0,474,1135,1134,1,5,0,0,0,487,487,487,487
Calaveras,64,2023-03-06,14,34,34,0,235,548,547,1,0,0,0,0,140,140,140,140
Colusa,64,2023-03-06,8,20,20,0,104,199,198,1,0,0,0,0,22,22,22,22
Contra Costa,64,2023-03-06,525,1452,1452,0,8549,22024,22023,1,64,0,0,8,1552,1553,1552,1553
Del Norte,64,2023-03-06,5,5,5,0,200,488,487,1,1,0,0,1,59,59,59,59
El Dorado,64,2023-03-06,47,201,201,0,794,2040,2039,1,2,0,0,0,244,244,244,244
Fresno,64,2023-03-06,316,878,878,0,6585,15144,15143,1,77,0,0,16,2998,3001,2998,3001
Glenn,64,2023-03-06,3,17,17,0,78,176,175,1,0,0,0,0,53,53,53,53
Humboldt,64,2023-03-06,15,59,59,0,425,1249,1248,1,1,0,0,1,170,170,170,170
Imperial,64,2023-03-06,100,324,324,0,1256,3842,3841,1,9,0,0,0,978,978,978,978
Inyo,64,2023-03-06,3,17,17,0,122,330,329,1,1,0,0,0,63,63,63,63
Kern,64,2023-03-06,262,455,455,0,5854,10296,10295,1,35,0,0,4,2476,2479,2476,2479
Kings,64,2023-03-06,45,164,164,0,1234,3636,3635,1,1,0,0,0,481,483,481,483
Lake,64,2023-03-06,17,35,35,0,459,1349,1348,1,1,0,0,0,156,156,156,156
Lassen,64,2023-03-06,4,19,19,0,213,422,421,1,1,0,0,0,64,64,64,64
Los Angeles,64,2023-03-06,3176,4954,4954,0,77462,102562,102561,1,509,14,186,60,35541,36038,35527,35852
Madera,64,2023-03-06,69,136,136,0,944,1919,1918,1,5,0,0,0,376,376,376,376
Marin,64,2023-03-06,108,300,300,0,1486,3656,3655,1,21,0,0,2,317,317,317,317
Mariposa,64,2023-03-06,0,0,0,0,61,149,148,1,0,0,0,0,31,31,31,31
Mendocino,64,2023-03-06,25,68,68,0,413,1339,1338,1,7,0,0,1,143,143,143,143
Merced,64,2023-03-06,112,259,259,0,1408,3045,3044,1,14,0,0,2,903,903,903,903
Modoc,64,2023-03-06,1,4,4,0,9,17,16,1,0,0,0,0,9,9,9,9
Mono,64,2023-03-06,5,20,20,0,53,121,120,1,0,0,0,0,8,8,8,8
Monterey,64,2023-03-06,112,336,336,0,1806,4495,4494,1,29,1,9,3,804,815,803,806
Napa,64,2023-03-06,44,170,170,0,919,2984,2983,1,9,0,0,2,161,161,161,161
Nevada,64,2023-03-06,12,19,19,0,366,759,758,1,2,0,0,0,133,134,133,134
Orange,64,2023-03-06,805,1881,1881,0,14770,35335,35334,1,111,0,0,18,7966,8033,7966,8033
Placer,64,2023-03-06,129,391,391,0,2117,5651,5650,1,62,0,0,5,681,681,681,681
Plumas,64,2023-03-06,0,0,0,0,61,182,181,1,0,0,0,0,15,15,15,15
Riverside,64,2023-03-06,608,1351,1351,0,10202,19978,19977,1,78,2,51,8,6818,6885,6816,6834
Sacramento,64,2023-03-06,673,1784,1784,0,9723,23632,23631,1,113,1,18,6,3529,3560,3528,3542
San Benito,64,2023-03-06,15,19,19,0,410,1200,1199,1,1,0,0,0,111,112,111,112
San Bernardino,64,2023-03-06,510,1034,1034,0,11179,21622,21621,1,99,0,0,18,8131,8131,8131,8131
San Diego,64,2023-03-06,1116,2536,2536,0,20236,45185,45184,1,179,3,34,13,5799,5863,5796,5829
San Francisco,64,2023-03-06,487,1288,1288,0,8524,21502,21500,2,73,0,0,11,1177,1187,1177,1187
San Joaquin,64,2023-03-06,298,882,882,0,5472,12736,12735,1,42,0,0,8,2420,2420,2420,2420
San Luis Obispo,64,2023-03-06,61,120,120,0,977,2329,2328,1,9,0,0,0,561,561,561,561
San Mateo,64,2023-03-06,330,899,899,0,5828,14315,14314,1,28,0,0,3,740,740,740,740
Santa Barbara,64,2023-03-06,104,229,229,0,3192,8661,8660,1,18,0,0,1,761,766,761,766
Santa Clara,64,2023-03-06,851,2409,2409,0,16603,34783,34782,1,133,0,0,32,2710,2727,2710,2727
Santa Cruz,64,2023-03-06,68,151,151,0,4103,5899,5898,1,20,0,0,0,276,276,276,276
Shasta,64,2023-03-06,16,22,22,0,466,847,846,1,5,0,0,2,600,600,600,600
Siskiyou,64,2023-03-06,5,6,6,0,208,647,646,1,1,0,0,0,95,95,95,95
Solano,64,2023-03-06,236,928,928,0,2938,9339,9338,1,34,0,0,5,474,474,474,474
Sonoma,64,2023-03-06,167,421,421,0,2870,7684,7683,1,23,0,0,2,552,552,552,552
Stanislaus,64,2023-03-06,207,554,554,0,3047,8720,8719,1,67,0,0,9,1841,1841,1841,1841
Sutter,64,2023-03-06,32,63,63,0,557,1514,1513,1,0,0,0,0,238,239,238,239
Tehama,64,2023-03-06,10,13,13,0,192,278,277,1,5,0,0,1,233,234,233,234
Trinity,64,2023-03-06,2,2,2,0,16,25,24,1,0,0,0,0,22,22,22,22
Tulare,64,2023-03-06,159,451,451,0,2605,5529,5528,1,29,0,0,3,1577,1579,1577,1579
Tuolumne,64,2023-03-06,26,35,35,0,353,843,842,1,1,0,0,0,202,202,202,202
Ventura,64,2023-03-06,197,489,489,0,4269,10644,10643,1,42,0,0,5,1676,1680,1676,1680
Yolo,64,2023-03-06,50,139,139,0,1012,2463,2462,1,4,0,0,0,442,442,442,442
Yuba,64,2023-03-06,34,62,62,0,451,1310,1309,1,7,0,0,0,122,122,122,122
California,1,2021-12-20,84308,84308,47190,37118,2163409,2163485,1234412,929073,2585,503,503,932,77358,77358,76855,76855
California,2,2021-12-27,241904,241910,151896,90014,1954239,1954316,1192589,761727,3348,496,496,1030,77854,77854,77358,77358
California,3,2022-01-03,549616,549633,369310,180323,2956408,2956550,1966543,990007,6125,591,591,1280,78445,78445,77854,77854
California,4,2022-01-10,867218,867262,619849,247413,4666306,4666609,3353886,1312723,10002,946,946,1813,79391,79391,78445,78445
California,5,2022-01-17,661800,661833,493127,168706,3984104,3984389,3022425,961964,12343,1432,1432,2311,80823,80823,79391,79391
California,6,2022-01-24,527382,527403,412575,114828,3989123,3989439,3193666,795773,12648,1778,1778,2600,82601,82601,80823,80823
California,7,2022-01-31,270341,270349,219720,50629,3155017,3155309,2636322,518987,10873,1907,1907,2494,84508,84508,82601,82601
California,8,2022-02-07,149319,149324,125789,23535,2670440,2670739,2318497,352242,8405,1778,1778,2007,86286,86286,84508,84508
California,9,2022-02-14,85821,85823,74812,11011,2323012,2323293,2080048,243245,6407,1431,1431,1564,87717,87717,86286,86286
California,10,2022-02-21,48084,48084,43056,5028,1850897,1851158,1692365,158793,4557,1004,1004,1098,88721,88721,87717,87717
California,11,2022-02-28,32658,32658,29949,2709,2098795,2099187,1962227,136960,3357,695,695,772,89416,89416,88721,88721
California,12,2022-03-07,22992,22992,21485,1507,1819442,1819865,1725268,94597,2435,500,500,581,89916,89916,89416,89416
California,13,2022-03-14,16965,16965,16088,877,1725519,1726038,1655672,70366,1844,358,358,419,90274,90274,89916,89916
California,14,2022-03-21,14645,14645,14062,583,1646476,1647153,1594422,52731,1537,253,253,313,90527,90527,90274,90274
California,15,2022-03-28,15470,15470,14990,480,1463358,1464101,1426476,37625,1150,179,179,264,90706,90706,90527,90527
California,16,2022-04-04,17685,17686,17269,417,1525137,1526034,1496485,29549,943,141,141,211,90847,90847,90706,90706
California,17,2022-04-11,21513,21518,21125,393,1343380,1344288,1323430,20858,905,125,125,148,90972,90972,90847,90847
California,18,2022-04-18,26866,26874,26485,389,1131771,1132611,1117707,14904,823,110,110,141,91082,91082,90972,90972
California,19,2022-04-25,37235,37246,36818,428,1622713,1624062,1609194,14868,838,91,91,112,91173,91173,91082,91082
California,20,2022-05-02,48936,48963,48528,435,1701883,1703486,1691245,12241,950,85,85,143,91258,91258,91173,91173
California,21,2022-05-09,63341,63390,62945,445,1770571,1772399,1762353,10046,1050,86,86,153,91344,91344,91258,91258
California,22,2022-05-16,80320,80389,79937,452,1840130,1842152,1833895,8257,1345,120,120,182,91464,91464,91344,91344
California,23,2022-05-23,97851,97950,97529,421,1870247,1872424,1865823,6601,1714,117,117,217,91581,91581,91464,91464
California,24,2022-05-30,90503,90594,90284,310,1498952,1500768,1496514,4254,1918,152,152,272,91733,91733,91581,91581
California,25,2022-06-06,120560,120685,120367,318,1939120,1941540,1937441,4099,2305,138,138,276,91871,91871,91733,91733
California,26,2022-06-13,105258,105371,105154,217,1406718,1408531,1406048,2483,2471,179,179,291,92050,92050,91871,91871
California,27,2022-06-20,101397,101508,101347,161,1026845,1028194,1026603,1591,2552,209,209,310,92259,92259,92050,92050
California,28,2022-06-27,115538,115671,115533,138,1043913,1045342,1044090,1252,3006,220,220,339,92479,92479,92259,92259
California,29,2022-07-04,108301,108438,108336,102,836788,837991,837185,806,3167,272,272,393,92751,92751,92479,92479
California,30,2022-07-11,141371,141557,141458,99,1082456,1084087,1083297,790,3824,298,298,453,93049,93049,92751,92751
California,31,2022-07-18,129764,129944,129871,73,992939,994484,993920,564,4148,296,296,528,93345,93345,93049,93049
California,32,2022-07-25,117653,117817,117769,48,948426,949953,949528,425,4310,360,360,516,93705,93705,93345,93345
California,33,2022-08-01,99239,99377,99344,33,875493,876931,876618,313,4119,362,362,535,94067,94067,93705,93705
California,34,2022-08-08,83105,83216,83197,19,820078,821472,821241,231,3754,335,335,474,94402,94402,94067,94067
California,35,2022-08-15,68763,68853,68841,12,789928,791313,791131,182,3363,297,297,448,94699,94699,94402,94402
California,36,2022-08-22,61139,61223,61217,6,774004,775404,775258,146,3087,286,286,418,94985,94985,94699,94699
California,37,2022-08-29,51534,51605,51602,3,763785,765232,765111,121,2752,218,218,351,95203,95203,94985,94985
California,38,2022-09-05,36454,36498,36498,0,626272,627516,627428,88,2525,247,247,350,95450,95450,95203,95203
California,39,2022-09-12,36214,36268,36268,0,750908,752476,752392,84,2422,223,223,346,95673,95673,95450,95450
California,40,2022-09-19,27597,27635,27635,0,685577,687079,687008,71,2041,180,180,272,95853,95853,95673,95673
California,41,2022-09-26,25293,25328,25328,0,637520,638984,638921,63,1818,167,167,230,96020,96020,95853,95853
California,42,2022-10-03,23282,23317,23317,0,584211,585637,585577,60,1647,148,148,247,96168,96168,96020,96020
California,43,2022-10-10,23324,23357,23357,0,624552,626161,626103,58,1537,154,154,228,96304,96304,96150,96150
California,44,2022-10-17,18590,18613,18613,0,520638,522067,522010,57,1397,117,117,218,96421,96421,96304,96304
California,45,2022-10-24,18469,18497,18497,0,511112,512636,512579,57,1324,119,119,190,96540,96540,96421,96421
California,46,2022-10-31,20596,20641,20641,0,520430,522090,522033,57,1401,113,113,191,96653,96653,96540,96540
California,47,2022-11-07,26734,26810,26810,0,544855,546784,546727,57,1525,134,134,231,96787,96787,96653,96653
California,48,2022-11-14,30640,30739,30739,0,546289,548488,548431,57,1775,114,114,260,96901,96901,96787,96787
California,49,2022-11-21,39993,40135,40135,0,571478,574014,573957,57,2268,151,151,330,97052,97052,96901,96901
California,50,2022-11-28,54060,54300,54300,0,514508,517064,517007,57,3153,203,203,379,97255,97255,97052,97052
California,51,2022-12-05,65674,65990,65990,0,652866,656340,656282,58,3715,241,242,493,97496,97497,97255,97255
California,52,2022-12-12,56415,56737,56737,0,617009,620792,620734,58,3944,347,354,527,97843,97851,97496,97497
California,53,2022-12-19,50615,50948,50948,0,570564,574669,574612,57,3997,320,326,523,98163,98177,97843,97851
California,54,2022-12-26,45203,45549,45549,0,415364,418825,418768,57,3906,398,405,510,98561,98582,98163,98177
California,55,2023-01-02,44994,45403,45403,0,419904,424004,423947,57,4077,351,361,528,98912,98943,98561,98582
California,56,2023-01-09,33631,33982,33982,0,502848,508499,508442,57,3672,326,342,487,99238,99285,98912,98943
California,57,2023-01-16,20286,20514,20514,0,408130,413289,413232,57,3075,305,324,425,99543,99609,99238,99285
California,58,2023-01-23,18430,18675,18675,0,450844,457340,457283,57,2400,227,243,369,99770,99852,99543,99609
California,59,2023-01-30,19308,19610,19610,0,417679,424630,424573,57,2214,196,218,266,99966,100070,99770,99852
California,60,2023-02-06,21242,21649,21649,0,402870,410881,410824,57,2231,156,187,280,100122,100257,99966,100070
California,61,2023-02-13,21142,21659,21659,0,382262,391926,391869,57,2223,117,160,287,100239,100417,100122,100257
California,62,2023-02-20,19362,20024,20024,0,342252,354173,354117,56,2159,99,194,292,100338,100611,100239,100417
California,63,2023-02-27,19186,20410,20410,0,376685,401191,401134,57,2220,69,322,310,100407,100933,100338,100611
California,64,2023-03-06,13031,30806,30806,0,258497,522450,522393,57,2074,21,298,262,100428,101231,100407,100933
