county,time,date,cases,est_cases,est_omicron_cases,est_other_cases,tests,est_tests,est_omicron_tests,est_other_tests,hospitalizations,deaths,est_deaths,icu,cum_deaths,cum_est_deaths,prev_cum_deaths,prev_cum_est_deaths
Alameda,1,2021-12-20,2981,2981,1418,1563,89768,89768,41917,47851,47,9,9,14,1548,1548,1539,1539
Amador,1,2021-12-20,49,49,18,31,1716,1716,602,1114,2,0,0,3,70,70,70,70
Butte,1,2021-12-20,193,193,101,92,4385,4385,2285,2100,24,5,5,1,359,359,354,354
Calaveras,1,2021-12-20,59,59,23,36,1520,1520,582,938,1,2,2,0,92,92,90,90
Colusa,1,2021-12-20,11,11,5,6,397,397,170,227,1,0,0,0,21,21,21,21
Contra Costa,1,2021-12-20,1687,1687,591,1096,43224,43224,14846,28378,27,4,4,7,1080,1080,1076,1076
Del Norte,1,2021-12-20,19,19,8,11,1378,1378,570,808,0,0,0,0,42,42,42,42
El Dorado,1,2021-12-20,238,238,93,145,4466,4466,1729,2737,4,4,4,3,179,179,175,175
Fresno,1,2021-12-20,1057,1057,380,677,24956,24956,8882,16074,131,19,19,45,2419,2419,2400,2400
Glenn,1,2021-12-20,20,20,8,12,462,462,185,277,0,0,0,0,41,41,41,41
Humboldt,1,2021-12-20,164,164,67,97,3772,3772,1529,2243,11,1,1,2,121,121,120,120
Imperial,1,2021-12-20,584,584,225,359,5521,5521,2103,3418,40,9,9,27,817,817,808,808
Inyo,1,2021-12-20,31,31,14,17,358,358,154,204,1,1,1,0,49,49,48,48
Kern,1,2021-12-20,927,927,401,526,26093,26093,11160,14933,84,24,24,27,2023,2023,1999,1999
Kings,1,2021-12-20,244,244,94,150,6912,6912,2638,4274,15,6,6,3,389,389,383,383
Lake,1,2021-12-20,37,37,13,24,1317,1317,464,853,0,0,0,0,116,116,116,116
Lassen,1,2021-12-20,11,11,5,6,2387,2387,1093,1294,0,0,0,0,54,54,54,54
Los Angeles,1,2021-12-20,31636,31636,22014,9622,985585,985602,676245,309357,574,107,107,174,27372,27372,27265,27265
Madera,1,2021-12-20,159,159,56,103,6014,6014,2122,3892,9,3,3,5,334,334,331,331
Marin,1,2021-12-20,566,566,210,356,11811,11811,4295,7516,5,1,1,1,256,256,255,255
Mariposa,1,2021-12-20,21,21,7,14,448,448,154,294,0,0,0,0,21,21,21,21
Mendocino,1,2021-12-20,91,91,27,64,2687,2687,789,1898,3,2,2,4,103,103,101,101
Merced,1,2021-12-20,323,323,138,185,5616,5616,2366,3250,11,6,6,12,693,693,687,687
Modoc,1,2021-12-20,5,5,2,3,67,67,30,37,2,0,0,0,6,6,6,6
Mono,1,2021-12-20,37,37,10,27,313,313,81,232,1,0,0,0,4,4,4,4
Monterey,1,2021-12-20,481,481,126,355,13259,13259,3421,9838,23,3,3,8,642,642,639,639
Napa,1,2021-12-20,229,229,106,123,5390,5390,2432,2958,2,1,1,2,108,108,107,107
Nevada,1,2021-12-20,161,161,58,103,2764,2764,999,1765,4,1,1,2,110,110,109,109
Orange,1,2021-12-20,4872,4872,2408,2464,99394,99394,48413,50981,132,34,34,56,6023,6023,5989,5989
Placer,1,2021-12-20,555,555,190,365,11155,11155,3769,7386,53,6,6,24,501,501,495,495
Plumas,1,2021-12-20,16,16,6,10,513,513,195,318,0,0,0,0,12,12,12,12
Riverside,1,2021-12-20,5608,5608,2351,3257,78332,78332,32448,45884,238,40,40,82,5580,5580,5540,5540
Sacramento,1,2021-12-20,2148,2148,857,1291,53572,53572,21166,32406,101,21,21,41,2490,2490,2469,2469
San Benito,1,2021-12-20,91,91,41,50,1928,1928,860,1068,2,3,3,2,81,81,78,78
San Bernardino,1,2021-12-20,5012,5012,2369,2643,79709,79709,37186,42523,299,66,66,112,6511,6511,6445,6445
San Diego,1,2021-12-20,8681,8681,5933,2748,149629,149630,101537,48093,249,29,29,94,4479,4479,4450,4450
San Francisco,1,2021-12-20,2989,2989,741,2248,57004,57004,13806,43198,28,3,3,10,693,693,690,690
San Joaquin,1,2021-12-20,952,952,359,593,25321,25321,9391,15930,48,13,13,27,1973,1973,1960,1960
San Luis Obispo,1,2021-12-20,426,426,187,239,9993,9993,4349,5644,11,3,3,6,371,371,368,368
San Mateo,1,2021-12-20,1560,1560,771,789,50632,50632,24530,26102,9,0,0,5,601,601,601,601
Santa Barbara,1,2021-12-20,789,789,326,463,15818,15818,6434,9384,18,8,8,12,570,570,562,562
Santa Clara,1,2021-12-20,2949,2949,1982,967,118952,118952,78834,40118,85,8,8,38,1978,1978,1970,1970
Santa Cruz,1,2021-12-20,404,404,182,222,19816,19816,8760,11056,11,2,2,5,230,230,228,228
Shasta,1,2021-12-20,163,163,65,98,6035,6035,2392,3643,28,8,8,8,448,448,440,440
Siskiyou,1,2021-12-20,20,20,9,11,449,449,207,242,2,2,2,2,63,63,61,61
Solano,1,2021-12-20,495,495,206,289,14746,14746,6067,8679,21,4,4,5,389,389,385,385
Sonoma,1,2021-12-20,754,754,320,434,20780,20780,8668,12112,22,1,1,6,420,420,419,419
Stanislaus,1,2021-12-20,670,670,210,460,13019,13019,4035,8984,90,13,13,22,1432,1432,1419,1419
Sutter,1,2021-12-20,123,123,51,72,2315,2315,947,1368,0,2,2,0,193,193,191,191
Tehama,1,2021-12-20,52,52,17,35,1324,1324,425,899,4,0,0,3,165,165,165,165
Trinity,1,2021-12-20,1,1,0,1,98,98,31,67,0,1,1,0,19,19,18,18
Tulare,1,2021-12-20,404,404,125,279,12353,12353,3799,8554,36,19,19,13,1308,1308,1289,1289
Tuolumne,1,2021-12-20,97,97,35,62,1940,1940,693,1247,7,0,0,0,150,150,150,150
Ventura,1,2021-12-20,2046,2046,1052,994,39239,39239,19902,19337,62,9,9,14,1216,1216,1207,1207
Yolo,1,2021-12-20,329,329,146,183,24698,24698,10820,13878,4,0,0,1,294,294,294,294
Yuba,1,2021-12-20,100,100,43,57,1874,1874,799,1075,3,0,0,4,102,102,102,102
Alameda,2,2021-12-27,7511,7511,4025,3486,87415,87415,46205,41210,89,12,12,19,1560,1560,1548,1548
Amador,2,2021-12-27,92,92,38,54,1445,1445,590,855,2,0,0,3,70,70,70,70
Butte,2,2021-12-27,540,540,318,222,4551,4551,2662,1889,37,3,3,3,362,362,359,359
Calaveras,2,2021-12-27,100,100,45,55,989,989,442,547,1,1,1,1,93,93,92,92
Colusa,2,2021-12-27,27,27,14,13,243,243,119,124,4,0,0,0,21,21,21,21
Contra Costa,2,2021-12-27,5145,5145,2107,3038,46333,46333,18594,27739,44,3,3,16,1083,1083,1080,1080
Del Norte,2,2021-12-27,25,25,12,13,1423,1423,679,744,0,0,0,1,42,42,42,42
El Dorado,2,2021-12-27,511,511,231,280,4083,4083,1815,2268,7,0,0,4,179,179,179,179
Fresno,2,2021-12-27,2210,2210,935,1275,23816,23816,9913,13903,122,16,16,41,2435,2435,2419,2419
Glenn,2,2021-12-27,53,53,24,29,451,451,207,244,0,1,1,0,42,42,41,41
Humboldt,2,2021-12-27,501,501,238,263,3456,3456,1617,1839,10,1,1,0,122,122,121,121
Imperial,2,2021-12-27,884,884,397,487,5893,5893,2609,3284,35,10,10,26,827,827,817,817
Inyo,2,2021-12-27,109,109,54,55,447,447,219,228,0,1,1,0,50,50,49,49
Kern,2,2021-12-27,1987,1987,996,991,22591,22591,11165,11426,79,18,18,36,2041,2041,2023,2023
Kings,2,2021-12-27,507,507,230,277,5482,5482,2433,3049,17,1,1,3,390,390,389,389
Lake,2,2021-12-27,67,67,28,39,1203,1203,495,708,0,1,1,0,117,117,116,116
Lassen,2,2021-12-27,21,21,11,10,2242,2242,1160,1082,0,0,0,0,54,54,54,54
Los Angeles,2,2021-12-27,96149,96150,71610,24540,717726,717739,530966,186773,862,115,115,207,27487,27487,27372,27372
Madera,2,2021-12-27,342,342,145,197,4209,4209,1747,2462,9,2,2,4,336,336,334,334
Marin,2,2021-12-27,1606,1606,687,919,16773,16773,7083,9690,3,0,0,1,256,256,256,256
Mariposa,2,2021-12-27,36,36,15,21,493,493,195,298,0,0,0,0,21,21,21,21
Mendocino,2,2021-12-27,152,152,55,97,2496,2496,862,1634,5,0,0,2,103,103,103,103
Merced,2,2021-12-27,653,653,322,331,5100,5100,2471,2629,11,7,7,10,700,700,693,693
Modoc,2,2021-12-27,3,3,1,2,38,38,19,19,1,0,0,0,6,6,6,6
Mono,2,2021-12-27,123,123,38,85,366,366,110,256,1,0,0,0,4,4,4,4
Monterey,2,2021-12-27,1008,1008,318,690,12882,12882,3971,8911,21,3,3,11,645,645,642,642
Napa,2,2021-12-27,814,814,424,390,6692,6692,3460,3232,6,0,0,1,108,108,108,108
Nevada,2,2021-12-27,236,236,100,136,1984,1984,815,1169,6,1,1,1,111,111,110,110
Orange,2,2021-12-27,18076,18076,10083,7993,130356,130357,71888,58469,256,31,31,66,6054,6054,6023,6023
Placer,2,2021-12-27,1255,1255,504,751,10769,10769,4261,6508,63,2,2,27,503,503,501,501
Plumas,2,2021-12-27,18,18,8,10,299,299,129,170,0,0,0,0,12,12,12,12
Riverside,2,2021-12-27,13692,13692,6605,7087,87501,87501,41714,45787,306,53,53,81,5633,5633,5580,5580
Sacramento,2,2021-12-27,5199,5199,2414,2785,52473,52473,24000,28473,135,22,22,44,2512,2512,2490,2490
San Benito,2,2021-12-27,317,317,163,154,2307,2307,1173,1134,1,3,3,3,84,84,81,81
San Bernardino,2,2021-12-27,14405,14405,7740,6665,87904,87904,46461,41443,341,69,69,141,6580,6580,6511,6511
San Diego,2,2021-12-27,27116,27116,19929,7187,177596,177600,129643,47957,315,34,34,96,4513,4513,4479,4479
San Francisco,2,2021-12-27,6858,6858,2010,4848,65930,65930,19043,46887,31,1,1,14,694,694,693,693
San Joaquin,2,2021-12-27,2353,2353,1038,1315,22767,22767,9880,12887,61,15,15,25,1988,1988,1973,1973
San Luis Obispo,2,2021-12-27,1153,1153,583,570,11182,11182,5563,5619,11,1,1,8,372,372,371,371
San Mateo,2,2021-12-27,5283,5283,2933,2350,55544,55544,30397,25147,19,2,2,5,603,603,601,601
Santa Barbara,2,2021-12-27,2143,2143,1022,1121,15279,15279,7173,8106,33,5,5,10,575,575,570,570
Santa Clara,2,2021-12-27,9051,9051,6550,2501,107055,107055,76804,30251,95,10,10,38,1988,1988,1978,1978
Santa Cruz,2,2021-12-27,947,947,490,457,12423,12423,6305,6118,11,0,0,2,230,230,230,230
Shasta,2,2021-12-27,263,263,123,140,4624,4624,2123,2501,32,5,5,12,453,453,448,448
Siskiyou,2,2021-12-27,21,21,11,10,361,361,190,171,0,0,0,0,63,63,63,63
Solano,2,2021-12-27,1301,1301,627,674,17044,17044,8086,8958,25,5,5,5,394,394,389,389
Sonoma,2,2021-12-27,1914,1914,934,980,21663,21663,10424,11239,19,1,1,5,421,421,420,420
Stanislaus,2,2021-12-27,1249,1249,468,781,11151,11151,4114,7037,94,17,17,18,1449,1449,1432,1432
Sutter,2,2021-12-27,226,226,108,118,2131,2131,1006,1125,0,2,2,0,195,195,193,193
Tehama,2,2021-12-27,103,103,40,63,1106,1106,419,687,6,2,2,3,167,167,165,165
Trinity,2,2021-12-27,4,4,2,2,101,101,37,64,0,0,0,0,19,19,19,19
Tulare,2,2021-12-27,815,815,301,514,11118,11118,4057,7061,36,10,10,9,1318,1318,1308,1308
Tuolumne,2,2021-12-27,171,171,72,99,1672,1672,692,980,5,0,0,1,150,150,150,150
Ventura,2,2021-12-27,5721,5721,3307,2414,39329,39329,22501,16828,66,8,8,19,1224,1224,1216,1216
Yolo,2,2021-12-27,818,818,417,401,22119,22119,11081,11038,7,1,1,4,295,295,294,294
Yuba,2,2021-12-27,164,164,81,83,1534,1534,749,785,8,1,1,4,103,103,102,102
Alameda,3,2022-01-03,17669,17669,10487,7182,117280,117281,69466,47815,156,5,5,31,1565,1565,1560,1560
Amador,3,2022-01-03,220,220,105,115,2179,2179,1029,1150,5,1,1,2,71,71,70,70
Butte,3,2022-01-03,1204,1204,780,424,6871,6871,4430,2441,32,0,0,4,362,362,362,362
Calaveras,3,2022-01-03,232,232,120,112,1305,1305,666,639,0,1,1,1,94,94,93,93
Colusa,3,2022-01-03,48,48,26,22,393,393,217,176,5,0,0,0,21,21,21,21
Contra Costa,3,2022-01-03,13525,13525,6291,7234,69128,69128,32071,37057,76,10,10,21,1093,1093,1083,1083
Del Norte,3,2022-01-03,86,86,47,39,2132,2132,1143,989,0,0,0,0,42,42,42,42
El Dorado,3,2022-01-03,1292,1292,661,631,6062,6062,3079,2983,7,4,4,6,183,183,179,179
Fresno,3,2022-01-03,6610,6610,3177,3433,38534,38534,18395,20139,175,14,14,44,2449,2449,2435,2435
Glenn,3,2022-01-03,78,78,40,38,610,610,318,292,0,1,1,0,43,43,42,42
Humboldt,3,2022-01-03,881,881,471,410,5295,5295,2810,2485,9,1,1,3,123,123,122,122
Imperial,3,2022-01-03,1880,1880,957,923,9131,9131,4610,4521,35,14,14,29,841,841,827,827
Inyo,3,2022-01-03,265,265,147,118,713,713,394,319,3,0,0,0,50,50,50,50
Kern,3,2022-01-03,5835,5835,3271,2564,35875,35875,19997,15878,100,16,16,32,2057,2057,2041,2041
Kings,3,2022-01-03,1100,1100,563,537,8514,8514,4311,4203,13,3,3,5,393,393,390,390
Lake,3,2022-01-03,222,222,107,115,1777,1777,847,930,1,0,0,1,117,117,117,117
Lassen,3,2022-01-03,61,61,35,26,3119,3119,1806,1313,2,0,0,0,54,54,54,54
Los Angeles,3,2022-01-03,204179,204183,160582,43601,1088033,1088054,856017,232037,1937,149,149,303,27636,27636,27487,27487
Madera,3,2022-01-03,831,831,398,433,6362,6362,3024,3338,17,3,3,6,339,339,336,336
Marin,3,2022-01-03,2366,2366,1149,1217,17674,17674,8532,9142,15,1,1,3,257,257,256,256
Mariposa,3,2022-01-03,103,103,48,55,657,657,304,353,0,0,0,0,21,21,21,21
Mendocino,3,2022-01-03,453,453,187,266,3572,3572,1454,2118,7,1,1,2,104,104,103,103
Merced,3,2022-01-03,1606,1606,883,723,8548,8548,4667,3881,3,9,9,4,709,709,700,700
Modoc,3,2022-01-03,15,15,8,7,59,59,33,26,0,0,0,0,6,6,6,6
Mono,3,2022-01-03,180,180,65,115,435,435,156,279,2,0,0,0,4,4,4,4
Monterey,3,2022-01-03,2468,2468,909,1559,20639,20639,7547,13092,30,4,4,10,649,649,645,645
Napa,3,2022-01-03,1859,1859,1077,782,11772,11772,6799,4973,9,1,1,3,109,109,108,108
Nevada,3,2022-01-03,648,648,314,334,3071,3071,1485,1586,7,1,1,3,112,112,111,111
Orange,3,2022-01-03,45622,45622,27878,17744,220355,220359,134444,85915,504,34,34,110,6088,6088,6054,6054
Placer,3,2022-01-03,2913,2913,1336,1577,15071,15071,6863,8208,113,15,15,24,518,518,503,503
Plumas,3,2022-01-03,55,55,28,27,496,496,248,248,1,0,0,0,12,12,12,12
Riverside,3,2022-01-03,32070,32070,17322,14748,138454,138455,74450,64005,564,54,54,94,5687,5687,5633,5633
Sacramento,3,2022-01-03,14148,14148,7388,6760,80500,80500,41835,38665,219,25,25,57,2537,2537,2512,2512
San Benito,3,2022-01-03,739,739,422,317,3464,3464,1976,1488,3,1,1,2,85,85,84,84
San Bernardino,3,2022-01-03,33874,33874,20036,13838,135065,135068,79611,55457,571,94,94,136,6674,6674,6580,6580
San Diego,3,2022-01-03,61092,61092,47459,13633,253655,253659,196956,56703,561,35,35,121,4548,4548,4513,4513
San Francisco,3,2022-01-03,11442,11442,3975,7467,85526,85526,29511,56015,78,5,5,22,699,699,694,694
San Joaquin,3,2022-01-03,6981,6981,3481,3500,36105,36105,17888,18217,80,13,13,27,2001,2001,1988,1988
San Luis Obispo,3,2022-01-03,2473,2473,1386,1087,15963,15963,8917,7046,24,5,5,7,377,377,372,372
San Mateo,3,2022-01-03,10627,10627,6506,4121,81978,81978,50095,31883,37,4,4,7,607,607,603,603
Santa Barbara,3,2022-01-03,5328,5328,2852,2476,28194,28194,15053,13141,53,5,5,7,580,580,575,575
Santa Clara,3,2022-01-03,23034,23034,17708,5326,170174,170176,130640,39536,186,10,10,58,1998,1998,1988,1988
Santa Cruz,3,2022-01-03,2411,2411,1389,1022,21662,21662,12485,9177,15,5,5,3,235,235,230,230
Shasta,3,2022-01-03,601,601,318,283,6173,6173,3228,2945,33,2,2,13,455,455,453,453
Siskiyou,3,2022-01-03,74,74,43,31,590,590,348,242,0,0,0,0,63,63,63,63
Solano,3,2022-01-03,4069,4069,2179,1890,26133,26133,13981,12152,54,3,3,9,397,397,394,394
Sonoma,3,2022-01-03,4541,4541,2480,2061,32187,32187,17529,14658,25,7,7,4,428,428,421,421
Stanislaus,3,2022-01-03,3333,3333,1436,1897,17985,17985,7689,10296,129,9,9,20,1458,1458,1449,1449
Sutter,3,2022-01-03,547,547,296,251,2980,2980,1594,1386,0,2,2,0,197,197,195,195
Tehama,3,2022-01-03,216,216,97,119,1474,1474,652,822,4,1,1,2,168,168,167,167
Trinity,3,2022-01-03,14,14,6,8,107,107,46,61,0,0,0,0,19,19,19,19
Tulare,3,2022-01-03,2141,2141,917,1224,16003,16003,6774,9229,57,5,5,7,1323,1323,1318,1318
Tuolumne,3,2022-01-03,383,383,186,197,2544,2544,1227,1317,7,3,3,0,153,153,150,150
Ventura,3,2022-01-03,12672,12672,7987,4685,59673,59673,37562,22111,136,11,11,28,1235,1235,1224,1224
Yolo,3,2022-01-03,2327,2327,1327,1000,31706,31706,17935,13771,8,4,4,3,299,299,295,295
Yuba,3,2022-01-03,475,475,264,211,2331,2331,1284,1047,17,1,1,6,104,104,103,103
Alameda,4,2022-01-10,31206,31206,20217,10989,193860,193865,125726,68139,277,14,14,46,1579,1579,1565,1565
Amador,4,2022-01-10,390,390,208,182,2726,2726,1447,1279,4,0,0,4,71,71,71,71
Butte,4,2022-01-10,2000,2000,1395,605,10455,10455,7284,3171,55,2,2,4,364,364,362,362
Calaveras,4,2022-01-10,522,522,299,223,2606,2606,1478,1128,0,1,1,2,95,95,94,94
Colusa,4,2022-01-10,105,105,65,40,756,756,462,294,5,0,0,0,21,21,21,21
Contra Costa,4,2022-01-10,19739,19739,10338,9401,102253,102253,53543,48710,152,12,12,24,1105,1105,1093,1093
Del Norte,4,2022-01-10,177,177,106,71,3958,3958,2363,1595,2,0,0,0,42,42,42,42
El Dorado,4,2022-01-10,2214,2214,1260,954,9363,9363,5325,4038,14,6,6,2,189,189,183,183
Fresno,4,2022-01-10,14420,14420,7792,6628,59849,59849,32272,27577,301,14,14,47,2463,2463,2449,2449
Glenn,4,2022-01-10,219,219,127,92,938,938,544,394,2,0,0,0,43,43,43,43
Humboldt,4,2022-01-10,1401,1401,827,574,8355,8355,4924,3431,18,5,5,2,128,128,123,123
Imperial,4,2022-01-10,3624,3624,2048,1576,13821,13821,7793,6028,58,11,11,25,852,852,841,841
Inyo,4,2022-01-10,408,408,248,160,1356,1356,826,530,4,2,2,0,52,52,50,50
Kern,4,2022-01-10,11945,11945,7345,4600,57112,57112,35080,22032,181,26,26,35,2083,2083,2057,2057
Kings,4,2022-01-10,2406,2406,1377,1029,13013,13013,7401,5612,33,1,1,4,394,394,393,393
Lake,4,2022-01-10,497,497,267,230,2761,2761,1477,1284,0,3,3,1,120,120,117,117
Lassen,4,2022-01-10,196,196,126,70,3438,3438,2185,1253,1,0,0,0,54,54,54,54
Los Angeles,4,2022-01-10,329118,329124,270892,58232,1915132,1915168,1576848,338320,3253,270,270,513,27906,27906,27636,27636
Madera,4,2022-01-10,1913,1913,1029,884,10380,10380,5547,4833,19,1,1,6,340,340,339,339
Marin,4,2022-01-10,2941,2941,1602,1339,21012,21012,11438,9574,18,3,3,5,260,260,257,257
Mariposa,4,2022-01-10,199,199,105,94,1158,1158,607,551,0,1,1,0,22,22,21,21
Mendocino,4,2022-01-10,874,874,410,464,5538,5538,2581,2957,8,2,2,2,106,106,104,104
Merced,4,2022-01-10,3923,3923,2375,1548,14514,14514,8774,5740,33,10,10,11,719,719,709,709
Modoc,4,2022-01-10,13,13,8,5,109,109,67,42,0,0,0,0,6,6,6,6
Mono,4,2022-01-10,253,253,106,147,863,863,360,503,1,1,1,0,5,5,4,4
Monterey,4,2022-01-10,4981,4981,2117,2864,33232,33232,14051,19181,44,5,5,12,654,654,649,649
Napa,4,2022-01-10,2658,2658,1687,971,14407,14407,9137,5270,14,1,1,4,110,110,109,109
Nevada,4,2022-01-10,1193,1193,648,545,5233,5233,2839,2394,10,2,2,3,114,114,112,112
Orange,4,2022-01-10,60259,60259,40109,20150,317866,317871,211645,106226,854,100,100,159,6188,6188,6088,6088
Placer,4,2022-01-10,5198,5198,2693,2505,22555,22555,11665,10890,179,6,6,29,524,524,518,518
Plumas,4,2022-01-10,141,141,79,62,803,803,446,357,5,0,0,0,12,12,12,12
Riverside,4,2022-01-10,48249,48249,28845,19404,187769,187774,112225,75549,762,83,83,139,5770,5770,5687,5687
Sacramento,4,2022-01-10,27532,27532,15931,11601,121783,121783,70478,51305,375,37,37,89,2574,2574,2537,2537
San Benito,4,2022-01-10,1039,1039,655,384,4617,4617,2910,1707,3,1,1,2,86,86,85,85
San Bernardino,4,2022-01-10,50628,50628,32797,17831,192769,192774,124822,67952,784,113,113,187,6787,6787,6674,6674
San Diego,4,2022-01-10,82736,82736,67414,15322,330086,330092,269004,61088,895,66,66,166,4614,4614,4548,4548
San Francisco,4,2022-01-10,15104,15104,6038,9066,117288,117288,46956,70332,158,12,12,35,711,711,699,699
San Joaquin,4,2022-01-10,14510,14510,8085,6425,66806,66806,37164,29642,151,15,15,45,2016,2016,2001,2001
San Luis Obispo,4,2022-01-10,4337,4337,2676,1661,21621,21621,13356,8265,30,2,2,7,379,379,377,377
San Mateo,4,2022-01-10,15024,15024,10007,5017,113103,113103,75327,37776,95,5,5,16,612,612,607,607
Santa Barbara,4,2022-01-10,8537,8537,5053,3484,47382,47382,28051,19331,84,9,9,10,589,589,580,580
Santa Clara,4,2022-01-10,36505,36505,29459,7046,271164,271169,218784,52385,350,26,26,68,2024,2024,1998,1998
Santa Cruz,4,2022-01-10,4543,4543,2861,1682,42815,42815,26980,15835,25,2,2,2,237,237,235,235
Shasta,4,2022-01-10,1060,1060,619,441,8406,8406,4894,3512,37,7,7,12,462,462,455,455
Siskiyou,4,2022-01-10,120,120,77,43,919,919,591,328,3,1,1,1,64,64,63,63
Solano,4,2022-01-10,6926,6926,4127,2799,37132,37132,22136,14996,94,6,6,15,403,403,397,397
Sonoma,4,2022-01-10,8871,8871,5344,3527,47197,47197,28452,18745,72,9,9,8,437,437,428,428
Stanislaus,4,2022-01-10,6758,6758,3310,3448,29319,29319,14324,14995,173,13,13,19,1471,1471,1458,1458
Sutter,4,2022-01-10,1246,1246,743,503,5062,5062,3006,2056,0,2,2,0,199,199,197,197
Tehama,4,2022-01-10,513,513,257,256,2482,2482,1241,1241,13,1,1,1,169,169,168,168
Trinity,4,2022-01-10,38,38,19,19,275,275,135,140,0,0,0,0,19,19,19,19
Tulare,4,2022-01-10,5214,5214,2541,2673,24081,24081,11674,12407,66,9,9,8,1332,1332,1323,1323
Tuolumne,4,2022-01-10,806,806,436,370,4178,4178,2257,1921,13,1,1,1,154,154,153,153
Ventura,4,2022-01-10,17512,17512,11976,5536,88216,88216,60304,27912,227,23,23,34,1258,1258,1235,1235
Yolo,4,2022-01-10,3757,3757,2339,1418,48233,48233,29997,18236,6,4,4,1,303,303,299,299
Yuba,4,2022-01-10,1021,1021,624,397,4108,4108,2504,1604,41,0,0,7,104,104,104,104
Alameda,5,2022-01-17,24705,24705,17330,7375,170497,170501,119536,50965,366,33,33,62,1612,1612,1579,1579
Amador,5,2022-01-17,476,476,282,194,3557,3557,2081,1476,10,2,2,3,73,73,71,71
Butte,5,2022-01-17,2063,2063,1538,525,9327,9327,6949,2378,58,6,6,6,370,370,364,364
Calaveras,5,2022-01-17,564,564,353,211,2472,2472,1542,930,3,2,2,3,97,97,95,95
Colusa,5,2022-01-17,161,161,107,54,719,719,476,243,3,0,0,0,21,21,21,21
Contra Costa,5,2022-01-17,16222,16222,9472,6750,88039,88039,51320,36719,198,22,22,41,1127,1127,1105,1105
Del Norte,5,2022-01-17,200,200,131,69,3758,3758,2429,1329,2,0,0,1,42,42,42,42
El Dorado,5,2022-01-17,1964,1964,1228,736,8062,8062,5041,3021,9,4,4,2,193,193,189,189
Fresno,5,2022-01-17,18274,18274,10945,7329,65971,65971,39476,26495,386,27,27,61,2490,2490,2463,2463
Glenn,5,2022-01-17,306,306,194,112,1076,1076,683,393,3,2,2,0,45,45,43,43
Humboldt,5,2022-01-17,1144,1144,739,405,8323,8323,5365,2958,10,1,1,4,129,129,128,128
Imperial,5,2022-01-17,3415,3415,2124,1291,13217,13217,8216,5001,69,12,12,29,864,864,852,852
Inyo,5,2022-01-17,327,327,216,111,1040,1040,688,352,4,0,0,0,52,52,52,52
Kern,5,2022-01-17,11693,11693,7803,3890,51810,51810,34532,17278,242,29,29,44,2112,2112,2083,2083
Kings,5,2022-01-17,3201,3201,1999,1202,14866,14866,9258,5608,40,4,4,1,398,398,394,394
Lake,5,2022-01-17,584,584,348,236,3245,3245,1935,1310,2,1,1,2,121,121,120,120
Lassen,5,2022-01-17,284,284,196,88,3322,3322,2278,1044,0,0,0,0,54,54,54,54
Los Angeles,5,2022-01-17,218493,218498,186919,31579,1610431,1610462,1376771,233691,4034,504,504,680,28410,28410,27906,27906
Madera,5,2022-01-17,2401,2401,1432,969,10611,10611,6301,4310,32,5,5,10,345,345,340,340
Marin,5,2022-01-17,2420,2420,1461,959,17704,17704,10679,7025,38,4,4,6,264,264,260,260
Mariposa,5,2022-01-17,163,163,95,68,1115,1115,648,467,0,0,0,0,22,22,22,22
Mendocino,5,2022-01-17,922,922,487,435,5015,5015,2630,2385,18,3,3,2,109,109,106,106
Merced,5,2022-01-17,4183,4183,2758,1425,13639,13639,8989,4650,41,18,18,11,737,737,719,719
Modoc,5,2022-01-17,13,13,9,4,102,102,68,34,0,1,1,0,7,7,6,6
Mono,5,2022-01-17,198,198,94,104,809,809,386,423,2,0,0,0,5,5,5,5
Monterey,5,2022-01-17,5903,5903,2860,3043,28328,28328,13710,14618,69,6,6,14,660,660,654,654
Napa,5,2022-01-17,1940,1940,1335,605,11943,11943,8197,3746,21,2,2,5,112,112,110,110
Nevada,5,2022-01-17,1248,1248,750,498,5429,5429,3261,2168,19,1,1,1,115,115,114,114
Orange,5,2022-01-17,41423,41423,29713,11710,251608,251613,180315,71298,998,111,111,199,6299,6299,6188,6188
Placer,5,2022-01-17,4316,4316,2492,1824,19460,19460,11216,8244,178,14,14,36,538,538,524,524
Plumas,5,2022-01-17,194,194,119,75,852,852,524,328,3,0,0,0,12,12,12,12
Riverside,5,2022-01-17,41259,41259,26972,14287,168063,168068,109886,58182,920,97,97,158,5867,5867,5770,5770
Sacramento,5,2022-01-17,21467,21467,13661,7806,101465,101465,64494,36971,473,64,64,97,2638,2638,2574,2574
San Benito,5,2022-01-17,903,903,618,285,4273,4273,2922,1351,4,1,1,4,87,87,86,86
San Bernardino,5,2022-01-17,38427,38427,26881,11546,164356,164360,114971,49389,936,146,146,227,6933,6933,6787,6787
San Diego,5,2022-01-17,60665,60665,51496,9169,265928,265934,225760,40174,1067,103,103,193,4717,4717,4614,4614
San Francisco,5,2022-01-17,11258,11258,5199,6059,94013,94013,43305,50708,212,14,14,44,725,725,711,711
San Joaquin,5,2022-01-17,12719,12719,7803,4916,58085,58085,35642,22443,201,20,20,57,2036,2036,2016,2016
San Luis Obispo,5,2022-01-17,3934,3934,2647,1287,21024,21024,14127,6897,46,12,12,10,391,391,379,379
San Mateo,5,2022-01-17,12488,12488,8949,3539,95951,95951,68671,27280,92,10,10,30,622,622,612,612
Santa Barbara,5,2022-01-17,6855,6855,4447,2408,40487,40487,26231,14256,123,12,12,12,601,601,589,589
Santa Clara,5,2022-01-17,29562,29562,24873,4689,235961,235966,198416,37550,451,24,24,84,2048,2048,2024,2024
Santa Cruz,5,2022-01-17,4186,4186,2869,1317,42205,42205,28863,13342,23,3,3,3,240,240,237,237
Shasta,5,2022-01-17,1347,1347,863,484,9163,9163,5844,3319,55,7,7,14,469,469,462,462
Siskiyou,5,2022-01-17,158,158,110,48,927,927,640,287,3,1,1,2,65,65,64,64
Solano,5,2022-01-17,6432,6432,4198,2234,35204,35204,22974,12230,121,6,6,22,409,409,403,403
Sonoma,5,2022-01-17,7626,7626,5025,2601,42778,42778,28132,14646,73,7,7,15,444,444,437,437
Stanislaus,5,2022-01-17,7328,7328,4019,3309,29058,29058,15916,13142,206,10,10,31,1481,1481,1471,1471
Sutter,5,2022-01-17,1248,1248,812,436,4863,4863,3161,1702,0,4,4,0,203,203,199,199
Tehama,5,2022-01-17,616,616,344,272,2420,2420,1349,1071,15,5,5,2,174,174,169,169
Trinity,5,2022-01-17,41,41,23,18,255,255,140,115,0,1,1,0,20,20,19,19
Tulare,5,2022-01-17,7477,7477,4070,3407,27091,27091,14726,12365,97,16,16,16,1348,1348,1332,1332
Tuolumne,5,2022-01-17,887,887,532,355,3836,3836,2287,1549,10,8,8,1,162,162,154,154
Ventura,5,2022-01-17,11976,11976,8781,3195,66930,66930,49015,17915,300,41,41,56,1299,1299,1258,1258
Yolo,5,2022-01-17,2805,2805,1899,906,39488,39488,26699,12789,15,4,4,4,307,307,303,303
Yuba,5,2022-01-17,1064,1064,707,357,3747,3747,2489,1258,42,2,2,6,106,106,104,104
Alameda,6,2022-01-24,19741,19741,14820,4921,171782,171787,129141,42646,373,41,41,68,1653,1653,1612,1612
Amador,6,2022-01-24,544,544,352,192,4667,4667,3019,1648,8,0,0,5,73,73,73,73
Butte,6,2022-01-24,1906,1906,1503,403,9606,9606,7589,2017,82,10,10,9,380,380,370,370
Calaveras,6,2022-01-24,556,556,378,178,2506,2506,1705,801,6,2,2,2,99,99,97,97
Colusa,6,2022-01-24,177,177,127,50,951,951,680,271,6,0,0,0,21,21,21,21
Contra Costa,6,2022-01-24,13596,13596,8738,4858,85314,85314,54886,30428,217,25,25,64,1152,1152,1127,1127
Del Norte,6,2022-01-24,348,348,246,102,4326,4326,3042,1284,3,0,0,3,42,42,42,42
El Dorado,6,2022-01-24,1400,1400,954,446,7329,7329,5001,2328,17,2,2,6,195,195,193,193
Fresno,6,2022-01-24,17735,17735,11620,6115,68663,68663,45071,23592,491,43,43,83,2533,2533,2490,2490
Glenn,6,2022-01-24,250,250,172,78,971,971,670,301,0,0,0,0,45,45,45,45
Humboldt,6,2022-01-24,916,916,641,275,7714,7714,5409,2305,25,3,3,3,132,132,129,129
Imperial,6,2022-01-24,3620,3620,2457,1163,13165,13165,8953,4212,70,14,14,27,878,878,864,864
Inyo,6,2022-01-24,142,142,102,40,625,625,449,176,1,1,1,0,53,53,52,52
Kern,6,2022-01-24,10554,10554,7599,2955,53946,53946,38889,15057,267,47,47,51,2159,2159,2112,2112
Kings,6,2022-01-24,4306,4306,2925,1381,19064,19064,12977,6087,40,4,4,4,402,402,398,398
Lake,6,2022-01-24,745,745,487,258,3417,3417,2234,1183,6,2,2,3,123,123,121,121
Lassen,6,2022-01-24,418,418,307,111,3982,3982,2932,1050,6,0,0,0,54,54,54,54
Los Angeles,6,2022-01-24,164914,164919,145681,19238,1659207,1659252,1466727,192525,3769,611,611,785,29021,29021,28410,28410
Madera,6,2022-01-24,2717,2717,1772,945,12170,12170,7938,4232,49,7,7,10,352,352,345,345
Marin,6,2022-01-24,1856,1856,1227,629,17548,17548,11608,5940,38,4,4,10,268,268,264,264
Mariposa,6,2022-01-24,133,133,85,48,945,945,605,340,0,0,0,0,22,22,22,22
Mendocino,6,2022-01-24,917,917,538,379,4873,4873,2854,2019,23,2,2,3,111,111,109,109
Merced,6,2022-01-24,3351,3351,2390,961,12907,12907,9214,3693,55,9,9,12,746,746,737,737
Modoc,6,2022-01-24,14,14,10,4,114,114,82,32,2,0,0,0,7,7,7,7
Mono,6,2022-01-24,97,97,52,45,422,422,227,195,1,0,0,0,5,5,5,5
Monterey,6,2022-01-24,5090,5090,2776,2314,31797,31797,17335,14462,80,9,9,17,669,669,660,660
Napa,6,2022-01-24,1679,1679,1241,438,12490,12490,9224,3266,23,5,5,4,117,117,112,112
Nevada,6,2022-01-24,1001,1001,659,342,4806,4806,3170,1636,29,1,1,6,116,116,115,115
Orange,6,2022-01-24,26764,26764,20453,6311,230978,230983,176764,54219,923,177,177,191,6476,6476,6299,6299
Placer,6,2022-01-24,3660,3660,2330,1330,18644,18644,11867,6777,215,8,8,43,546,546,538,538
Plumas,6,2022-01-24,215,215,144,71,836,836,559,277,5,0,0,0,12,12,12,12
Riverside,6,2022-01-24,31909,31909,22577,9332,158781,158786,112468,46318,901,122,122,168,5989,5989,5867,5867
Sacramento,6,2022-01-24,17480,17480,12095,5385,98838,98840,68427,30413,542,64,64,105,2702,2702,2638,2638
San Benito,6,2022-01-24,776,776,570,206,3929,3929,2889,1040,7,1,1,3,88,88,87,87
San Bernardino,6,2022-01-24,28080,28080,21044,7036,153573,153578,115206,38372,975,170,170,223,7103,7103,6933,6933
San Diego,6,2022-01-24,51446,51446,45153,6293,252114,252120,221529,30591,1056,131,131,232,4848,4848,4717,4717
San Francisco,6,2022-01-24,8095,8095,4232,3863,88914,88914,46537,42377,232,19,19,37,744,744,725,725
San Joaquin,6,2022-01-24,11055,11055,7404,3651,59067,59067,39640,19427,241,34,34,71,2070,2070,2036,2036
San Luis Obispo,6,2022-01-24,3561,3561,2582,979,21516,21516,15603,5913,42,10,10,12,401,401,391,391
San Mateo,6,2022-01-24,8511,8511,6502,2009,95138,95139,72741,22398,139,19,19,28,641,641,622,622
Santa Barbara,6,2022-01-24,6485,6485,4559,1926,43826,43826,30822,13004,127,12,12,19,613,613,601,601
Santa Clara,6,2022-01-24,22786,22786,19872,2914,233308,233313,203461,29852,412,48,48,88,2096,2096,2048,2048
Santa Cruz,6,2022-01-24,5046,5046,3711,1335,45621,45621,33575,12046,31,1,1,2,241,241,240,240
Shasta,6,2022-01-24,1486,1486,1032,454,10135,10135,7033,3102,78,7,7,9,476,476,469,469
Siskiyou,6,2022-01-24,159,159,118,41,857,857,635,222,6,3,3,1,68,68,65,65
Solano,6,2022-01-24,5130,5130,3629,1501,32624,32624,23091,9533,143,14,14,26,423,423,409,409
Sonoma,6,2022-01-24,6926,6926,4931,1995,42474,42474,30246,12228,94,7,7,18,451,451,444,444
Stanislaus,6,2022-01-24,6377,6377,3877,2500,28268,28268,17211,11057,277,27,27,44,1508,1508,1481,1481
Sutter,6,2022-01-24,1047,1047,737,310,5002,5002,3521,1481,0,2,2,0,205,205,203,203
Tehama,6,2022-01-24,577,577,357,220,2702,2702,1674,1028,19,4,4,5,178,178,174,174
Trinity,6,2022-01-24,63,63,38,25,322,322,196,126,0,0,0,0,20,20,20,20
Tulare,6,2022-01-24,7679,7679,4633,3046,29521,29521,17850,11671,138,11,11,14,1359,1359,1348,1348
Tuolumne,6,2022-01-24,954,954,628,326,3827,3827,2510,1317,17,2,2,3,164,164,162,162
Ventura,6,2022-01-24,9413,9413,7332,2081,68520,68520,53428,15092,269,28,28,68,1327,1327,1299,1299
Yolo,6,2022-01-24,2300,2300,1677,623,40461,40461,29500,10961,18,12,12,5,319,319,307,307
Yuba,6,2022-01-24,910,910,653,257,3777,3777,2709,1068,54,3,3,10,109,109,106,106
Alameda,7,2022-01-31,10998,10998,8741,2257,137318,137323,109272,28051,336,50,50,75,1703,1703,1653,1653
Amador,7,2022-01-31,350,350,246,104,3226,3226,2273,953,15,1,1,4,74,74,73,73
Butte,7,2022-01-31,1163,1163,963,200,7608,7608,6305,1303,80,6,6,7,386,386,380,380
Calaveras,7,2022-01-31,264,264,194,70,1940,1940,1424,516,3,5,5,2,104,104,99,99
Colusa,7,2022-01-31,106,106,81,25,704,704,540,164,9,0,0,0,21,21,21,21
Contra Costa,7,2022-01-31,7310,7310,5096,2214,68624,68624,47919,20705,207,39,39,54,1191,1191,1152,1152
Del Norte,7,2022-01-31,315,315,237,78,3957,3957,2977,980,6,2,2,2,44,44,42,42
El Dorado,7,2022-01-31,741,741,544,197,6019,6019,4420,1599,13,4,4,5,199,199,195,195
Fresno,7,2022-01-31,10990,10990,7794,3196,54815,54815,38926,15889,503,39,39,98,2572,2572,2533,2533
Glenn,7,2022-01-31,190,190,140,50,759,759,563,196,2,2,2,0,47,47,45,45
Humboldt,7,2022-01-31,583,583,438,145,5790,5790,4348,1442,18,3,3,3,135,135,132,132
Imperial,7,2022-01-31,2197,2197,1602,595,11274,11274,8242,3032,71,17,17,28,895,895,878,878
Inyo,7,2022-01-31,55,55,42,13,467,467,357,110,5,3,3,0,56,56,53,53
Kern,7,2022-01-31,5650,5650,4340,1310,42263,42263,32503,9760,264,47,47,54,2206,2206,2159,2159
Kings,7,2022-01-31,2391,2391,1749,642,13681,13681,10017,3664,55,5,5,4,407,407,402,402
Lake,7,2022-01-31,478,478,338,140,3193,3193,2258,935,4,4,4,4,127,127,123,123
Lassen,7,2022-01-31,311,311,243,68,3624,3624,2838,786,7,1,1,0,55,55,54,54
Los Angeles,7,2022-01-31,74573,74574,67642,6932,1302840,1302883,1182575,120308,2991,640,640,719,29661,29661,29021,29021
Madera,7,2022-01-31,1744,1744,1233,511,9631,9631,6816,2815,50,6,6,7,358,358,352,352
Marin,7,2022-01-31,1063,1063,759,304,13817,13817,9888,3929,26,5,5,9,273,273,268,268
Mariposa,7,2022-01-31,101,101,70,31,840,840,584,256,0,2,2,0,24,24,22,22
Mendocino,7,2022-01-31,464,464,299,165,3486,3486,2252,1234,12,3,3,4,114,114,111,111
Merced,7,2022-01-31,2126,2126,1618,508,10466,10466,7976,2490,54,12,12,14,758,758,746,746
Modoc,7,2022-01-31,12,12,9,3,89,89,68,21,1,0,0,0,7,7,7,7
Mono,7,2022-01-31,41,41,25,16,339,339,203,136,0,0,0,0,5,5,5,5
Monterey,7,2022-01-31,3556,3556,2152,1404,26742,26742,16229,10513,82,9,9,13,678,678,669,669
Napa,7,2022-01-31,998,998,783,215,9405,9405,7377,2028,17,7,7,10,124,124,117,117
Nevada,7,2022-01-31,568,568,404,164,3912,3912,2788,1124,26,3,3,5,119,119,116,116
Orange,7,2022-01-31,12014,12014,9692,2322,177060,177065,142958,34107,708,170,170,164,6646,6646,6476,6476
Placer,7,2022-01-31,2256,2256,1560,696,15375,15375,10647,4728,152,19,19,42,565,565,546,546
Plumas,7,2022-01-31,137,137,98,39,753,753,542,211,1,0,0,0,12,12,12,12
Riverside,7,2022-01-31,15946,15946,12052,3894,121045,121050,91697,29353,740,111,111,171,6100,6100,5989,5989
Sacramento,7,2022-01-31,10145,10145,7527,2618,77586,77588,57654,19934,501,93,93,106,2795,2795,2702,2702
San Benito,7,2022-01-31,474,474,370,104,3323,3323,2596,727,5,2,2,3,90,90,88,88
San Bernardino,7,2022-01-31,13253,13253,10517,2736,116542,116547,92601,23946,744,185,185,207,7288,7288,7103,7103
San Diego,7,2022-01-31,24831,24831,22403,2428,181384,181389,163798,17591,944,105,105,214,4953,4953,4848,4848
San Francisco,7,2022-01-31,4046,4046,2359,1687,69166,69166,40401,28765,208,24,24,45,768,768,744,744
San Joaquin,7,2022-01-31,5701,5701,4124,1577,43647,43647,31642,12005,210,36,36,75,2106,2106,2070,2070
San Luis Obispo,7,2022-01-31,1981,1981,1530,451,16234,16234,12540,3694,40,12,12,10,413,413,401,401
San Mateo,7,2022-01-31,4328,4328,3489,839,75105,75107,60571,14536,131,10,10,19,651,651,641,641
Santa Barbara,7,2022-01-31,3634,3634,2733,901,35026,35026,26385,8641,103,23,23,13,636,636,613,613
Santa Clara,7,2022-01-31,13837,13837,12416,1421,207115,207120,185903,21217,427,54,54,93,2150,2150,2096,2096
Santa Cruz,7,2022-01-31,3440,3440,2681,759,51420,51420,40150,11270,35,5,5,6,246,246,241,241
Shasta,7,2022-01-31,900,900,670,230,8419,8419,6269,2150,59,13,13,11,489,489,476,476
Siskiyou,7,2022-01-31,119,119,94,25,691,691,545,146,8,2,2,2,70,70,68,68
Solano,7,2022-01-31,3812,3812,2885,927,28702,28702,21720,6982,126,6,6,30,429,429,423,423
Sonoma,7,2022-01-31,3569,3569,2711,858,32148,32148,24453,7695,84,12,12,15,463,463,451,451
Stanislaus,7,2022-01-31,3688,3688,2459,1229,22306,22306,14897,7409,261,33,33,53,1541,1541,1508,1508
Sutter,7,2022-01-31,619,619,466,153,3764,3764,2837,927,0,4,4,0,209,209,205,205
Tehama,7,2022-01-31,377,377,256,121,2022,2022,1368,654,17,3,3,5,181,181,178,178
Trinity,7,2022-01-31,43,43,29,14,227,227,151,76,0,0,0,0,20,20,20,20
Tulare,7,2022-01-31,4688,4688,3099,1589,22901,22901,15174,7727,150,22,22,21,1381,1381,1359,1359
Tuolumne,7,2022-01-31,710,710,502,208,3265,3265,2315,950,12,2,2,4,166,166,164,164
Ventura,7,2022-01-31,4599,4599,3766,833,52327,52327,42903,9424,253,39,39,48,1366,1366,1327,1327
Yolo,7,2022-01-31,1353,1353,1049,304,37499,37499,29098,8401,19,5,5,5,324,324,319,319
Yuba,7,2022-01-31,524,524,401,123,2931,2931,2243,688,78,2,2,11,111,111,109,109
Alameda,8,2022-02-07,5968,5968,4969,999,115667,115672,96373,19299,254,44,44,62,1747,1747,1703,1703
Amador,8,2022-02-07,204,204,153,51,2909,2909,2187,722,14,4,4,5,78,78,74,74
Butte,8,2022-02-07,784,784,674,110,6392,6392,5504,888,74,8,8,12,394,394,386,386
Calaveras,8,2022-02-07,183,183,142,41,1427,1427,1112,315,2,2,2,1,106,106,104,104
Colusa,8,2022-02-07,71,71,57,14,555,555,449,106,0,0,0,0,21,21,21,21
Contra Costa,8,2022-02-07,4136,4136,3093,1043,54148,54148,40502,13646,149,32,32,52,1223,1223,1191,1191
Del Norte,8,2022-02-07,286,286,228,58,4003,4003,3184,819,5,0,0,0,44,44,44,44
El Dorado,8,2022-02-07,427,427,333,94,5034,5034,3927,1107,20,1,1,5,200,200,199,199
Fresno,8,2022-02-07,6395,6395,4844,1551,42464,42464,32207,10257,450,49,49,87,2621,2621,2572,2572
Glenn,8,2022-02-07,113,113,88,25,620,620,488,132,4,3,3,0,50,50,47,47
Humboldt,8,2022-02-07,467,467,371,96,4875,4875,3874,1001,15,1,1,2,136,136,135,135
Imperial,8,2022-02-07,1097,1097,852,245,7925,7925,6162,1763,46,12,12,26,907,907,895,895
Inyo,8,2022-02-07,38,38,30,8,447,447,361,86,5,0,0,0,56,56,56,56
Kern,8,2022-02-07,3473,3473,2812,661,34656,34656,28087,6569,190,32,32,43,2238,2238,2206,2206
Kings,8,2022-02-07,1353,1353,1052,301,10247,10247,7976,2271,52,14,14,5,421,421,407,407
Lake,8,2022-02-07,351,351,265,86,2624,2624,1985,639,11,1,1,5,128,128,127,127
Lassen,8,2022-02-07,140,140,115,25,3023,3023,2487,536,5,2,2,0,57,57,55,55
Los Angeles,8,2022-02-07,37353,37353,34596,2757,1151452,1151496,1066943,84553,2155,638,638,547,30299,30299,29661,29661
Madera,8,2022-02-07,1060,1060,802,258,8081,8081,6118,1963,38,4,4,9,362,362,358,358
Marin,8,2022-02-07,655,655,500,155,11291,11291,8617,2674,29,8,8,6,281,281,273,273
Mariposa,8,2022-02-07,51,51,38,13,579,579,431,148,0,0,0,0,24,24,24,24
Mendocino,8,2022-02-07,327,327,229,98,2817,2817,1974,843,12,2,2,5,116,116,114,114
Merced,8,2022-02-07,1210,1210,974,236,8063,8063,6492,1571,53,13,13,12,771,771,758,758
Modoc,8,2022-02-07,25,25,20,5,219,219,179,40,3,0,0,0,7,7,7,7
Mono,8,2022-02-07,44,44,29,15,271,271,178,93,0,0,0,0,5,5,5,5
Monterey,8,2022-02-07,2221,2221,1474,747,22461,22461,14939,7522,68,11,11,14,689,689,678,678
Napa,8,2022-02-07,746,746,615,131,7782,7782,6409,1373,16,6,6,2,130,130,124,124
Nevada,8,2022-02-07,357,357,271,86,3187,3187,2429,758,24,3,3,1,122,122,119,119
Orange,8,2022-02-07,6410,6410,5404,1006,152314,152319,128467,23852,494,118,118,125,6764,6764,6646,6646
Placer,8,2022-02-07,1294,1294,960,334,11887,11887,8831,3056,148,22,22,34,587,587,565,565
Plumas,8,2022-02-07,79,79,60,19,521,521,399,122,1,1,1,0,13,13,12,12
Riverside,8,2022-02-07,8143,8143,6511,1632,93429,93434,74778,18656,548,107,107,116,6207,6207,6100,6100
Sacramento,8,2022-02-07,6077,6077,4785,1292,63990,63991,50430,13561,390,72,72,95,2867,2867,2795,2795
San Benito,8,2022-02-07,311,311,255,56,2660,2660,2184,476,3,0,0,4,90,90,90,90
San Bernardino,8,2022-02-07,7051,7051,5864,1187,90090,90095,74996,15099,528,140,140,156,7428,7428,7288,7288
San Diego,8,2022-02-07,13632,13632,12575,1057,151886,151891,140176,11715,773,116,116,169,5069,5069,4953,4953
San Francisco,8,2022-02-07,2409,2409,1553,856,55775,55775,35911,19864,171,25,25,40,793,793,768,768
San Joaquin,8,2022-02-07,3348,3348,2581,767,36517,36517,28200,8317,186,42,42,62,2148,2148,2106,2106
San Luis Obispo,8,2022-02-07,1204,1204,979,225,12341,12341,10042,2299,23,16,16,7,429,429,413,413
San Mateo,8,2022-02-07,2463,2463,2075,388,62131,62131,52352,9779,83,16,16,18,667,667,651,651
Santa Barbara,8,2022-02-07,2282,2282,1814,468,30723,30723,24432,6291,75,15,15,17,651,651,636,636
Santa Clara,8,2022-02-07,8032,8032,7375,657,175343,175348,161029,14319,377,31,31,74,2181,2181,2150,2150
Santa Cruz,8,2022-02-07,1900,1900,1560,340,38681,38681,31764,6917,28,4,4,5,250,250,246,246
Shasta,8,2022-02-07,677,677,534,143,6857,6857,5413,1444,64,15,15,10,504,504,489,489
Siskiyou,8,2022-02-07,91,91,75,16,720,720,595,125,10,2,2,0,72,72,70,70
Solano,8,2022-02-07,2238,2238,1784,454,24204,24204,19342,4862,91,5,5,28,434,434,429,429
Sonoma,8,2022-02-07,2087,2087,1677,410,27054,27054,21735,5319,57,7,7,11,470,470,463,463
Stanislaus,8,2022-02-07,2491,2491,1792,699,18738,18738,13501,5237,243,43,43,43,1584,1584,1541,1541
Sutter,8,2022-02-07,360,360,286,74,3305,3305,2631,674,0,5,5,0,214,214,209,209
Tehama,8,2022-02-07,282,282,205,77,1644,1644,1197,447,17,3,3,6,184,184,181,181
Trinity,8,2022-02-07,18,18,13,5,136,136,98,38,0,0,0,0,20,20,20,20
Tulare,8,2022-02-07,2705,2705,1933,772,17907,17907,12831,5076,130,27,27,21,1408,1408,1381,1381
Tuolumne,8,2022-02-07,348,348,263,85,2576,2576,1953,623,10,2,2,1,168,168,166,166
Ventura,8,2022-02-07,2696,2696,2301,395,42327,42327,36165,6162,207,40,40,45,1406,1406,1366,1366
Yolo,8,2022-02-07,863,863,705,158,30850,30850,25174,5676,12,11,11,6,335,335,324,324
Yuba,8,2022-02-07,333,333,269,64,2406,2406,1942,464,42,4,4,13,115,115,111,111
Alameda,9,2022-02-14,3404,3404,2943,461,98991,98996,85611,13385,190,39,39,48,1786,1786,1747,1747
Amador,9,2022-02-14,109,109,87,22,2345,2345,1866,479,8,3,3,3,81,81,78,78
Butte,9,2022-02-14,464,464,412,52,5317,5317,4721,596,64,10,10,9,404,404,394,394
Calaveras,9,2022-02-14,79,79,64,15,1162,1162,950,212,4,2,2,2,108,108,106,106
Colusa,9,2022-02-14,35,35,29,6,406,406,341,65,5,0,0,0,21,21,21,21
Contra Costa,9,2022-02-14,2404,2404,1904,500,44860,44860,35540,9320,123,23,23,31,1246,1246,1223,1223
Del Norte,9,2022-02-14,210,210,175,35,3338,3338,2775,563,6,0,0,3,44,44,44,44
El Dorado,9,2022-02-14,260,260,213,47,4433,4433,3631,802,21,4,4,3,204,204,200,200
Fresno,9,2022-02-14,3868,3868,3096,772,34830,34830,27893,6937,375,34,34,75,2655,2655,2621,2621
Glenn,9,2022-02-14,58,58,48,10,482,482,398,84,3,1,1,0,51,51,50,50
Humboldt,9,2022-02-14,331,331,275,56,4202,4202,3495,707,23,0,0,2,136,136,136,136
Imperial,9,2022-02-14,588,588,480,108,5945,5945,4857,1088,44,14,14,18,921,921,907,907
Inyo,9,2022-02-14,29,29,24,5,413,413,348,65,3,0,0,0,56,56,56,56
Kern,9,2022-02-14,2014,2014,1701,313,27232,27232,23011,4221,156,28,28,40,2266,2266,2238,2238
Kings,9,2022-02-14,774,774,633,141,8001,8001,6548,1453,43,8,8,5,429,429,421,421
Lake,9,2022-02-14,256,256,205,51,2307,2307,1842,465,6,2,2,5,130,130,128,128
Lassen,9,2022-02-14,155,155,133,22,2789,2789,2383,406,3,2,2,0,59,59,57,57
Los Angeles,9,2022-02-14,21443,21443,20190,1253,1052392,1052438,991093,61345,1572,490,490,423,30789,30789,30299,30299
Madera,9,2022-02-14,621,621,497,124,6463,6463,5165,1298,29,2,2,7,364,364,362,362
Marin,9,2022-02-14,383,383,309,74,10150,10150,8173,1977,23,5,5,4,286,286,281,281
Mariposa,9,2022-02-14,24,24,19,5,433,433,342,91,0,0,0,0,24,24,24,24
Mendocino,9,2022-02-14,207,207,155,52,2445,2445,1834,611,13,1,1,7,117,117,116,116
Merced,9,2022-02-14,745,745,627,118,6832,6832,5744,1088,37,13,13,8,784,784,771,771
Modoc,9,2022-02-14,17,17,14,3,124,124,104,20,0,0,0,0,7,7,7,7
Mono,9,2022-02-14,10,10,7,3,179,179,127,52,0,0,0,0,5,5,5,5
Monterey,9,2022-02-14,1229,1229,881,348,16948,16948,12153,4795,48,12,12,12,701,701,689,689
Napa,9,2022-02-14,400,400,343,57,6607,6607,5661,946,10,1,1,1,131,131,130,130
Nevada,9,2022-02-14,169,169,136,33,2568,2568,2066,502,19,3,3,5,125,125,122,122
Orange,9,2022-02-14,4007,4007,3501,506,132330,132335,115562,16773,354,115,115,77,6879,6879,6764,6764
Placer,9,2022-02-14,595,595,468,127,9967,9967,7844,2123,105,12,12,23,599,599,587,587
Plumas,9,2022-02-14,43,43,35,8,431,431,348,83,1,0,0,0,13,13,13,13
Riverside,9,2022-02-14,4611,4611,3858,753,74754,74758,62570,12188,400,85,85,86,6292,6292,6207,6207
Sacramento,9,2022-02-14,3417,3417,2823,594,53021,53021,43828,9193,349,60,60,66,2927,2927,2867,2867
San Benito,9,2022-02-14,158,158,135,23,2159,2159,1845,314,0,1,1,3,91,91,90,90
San Bernardino,9,2022-02-14,3708,3708,3203,505,72760,72764,62878,9886,338,117,117,128,7545,7545,7428,7428
San Diego,9,2022-02-14,8073,8073,7576,497,126080,126085,118373,7712,589,89,89,135,5158,5158,5069,5069
San Francisco,9,2022-02-14,1610,1610,1124,486,47603,47603,33264,14339,130,25,25,39,818,818,793,793
San Joaquin,9,2022-02-14,1987,1987,1614,373,30637,30637,24895,5742,123,37,37,53,2185,2185,2148,2148
San Luis Obispo,9,2022-02-14,798,798,677,121,10051,10051,8530,1521,24,9,9,7,438,438,429,429
San Mateo,9,2022-02-14,1345,1345,1174,171,55007,55007,48007,7000,63,16,16,11,683,683,667,667
Santa Barbara,9,2022-02-14,1056,1056,880,176,22481,22481,18752,3729,68,8,8,14,659,659,651,651
Santa Clara,9,2022-02-14,4636,4636,4335,301,155254,155259,145179,10080,296,27,27,59,2208,2208,2181,2181
Santa Cruz,9,2022-02-14,981,981,838,143,30369,30369,25920,4449,23,3,3,4,253,253,250,250
Shasta,9,2022-02-14,442,442,366,76,5851,5851,4841,1010,62,13,13,13,517,517,504,504
Siskiyou,9,2022-02-14,66,66,57,9,520,520,447,73,7,1,1,2,73,73,72,72
Solano,9,2022-02-14,1201,1201,1003,198,18980,18980,15869,3111,73,2,2,20,436,436,434,434
Sonoma,9,2022-02-14,1135,1135,953,182,21176,21176,17763,3413,55,8,8,7,478,478,470,470
Stanislaus,9,2022-02-14,1364,1364,1046,318,15080,15080,11571,3509,206,28,28,41,1612,1612,1584,1584
Sutter,9,2022-02-14,230,230,192,38,2862,2862,2386,476,0,3,3,0,217,217,214,214
Tehama,9,2022-02-14,180,180,139,41,1404,1404,1088,316,15,5,5,5,189,189,184,184
Trinity,9,2022-02-14,22,22,17,5,171,171,131,40,0,0,0,0,20,20,20,20
Tulare,9,2022-02-14,1479,1479,1127,352,15050,15050,11499,3551,116,27,27,19,1435,1435,1408,1408
Tuolumne,9,2022-02-14,192,192,154,38,2221,2221,1778,443,12,4,4,1,172,172,168,168
Ventura,9,2022-02-14,1510,1510,1332,178,35526,35526,31346,4180,141,36,36,26,1442,1442,1406,1406
Yolo,9,2022-02-14,479,479,407,72,26816,26816,22785,4031,10,7,7,3,342,342,335,335
Yuba,9,2022-02-14,220,220,185,35,2109,2109,1777,332,19,0,0,11,115,115,115,115
Alameda,10,2022-02-21,1927,1927,1717,210,77637,77641,69066,8575,138,28,28,26,1814,1814,1786,1786
Amador,10,2022-02-21,70,70,58,12,1921,1921,1598,323,7,3,3,3,84,84,81,81
Butte,10,2022-02-21,256,256,233,23,4424,4424,4025,399,63,12,12,4,416,416,404,404
Calaveras,10,2022-02-21,44,44,37,7,838,838,712,126,3,6,6,0,114,114,108,108
Colusa,10,2022-02-21,26,26,23,3,362,362,315,47,4,0,0,0,21,21,21,21
Contra Costa,10,2022-02-21,1304,1304,1081,223,34147,34147,28269,5878,66,18,18,30,1264,1264,1246,1246
Del Norte,10,2022-02-21,129,129,111,18,2704,2704,2329,375,8,0,0,1,44,44,44,44
El Dorado,10,2022-02-21,155,155,132,23,3612,3612,3078,534,8,1,1,5,205,205,204,204
Fresno,10,2022-02-21,2012,2012,1683,329,26828,26828,22443,4385,272,26,26,54,2681,2681,2655,2655
Glenn,10,2022-02-21,28,28,24,4,405,405,348,57,2,1,1,0,52,52,51,51
Humboldt,10,2022-02-21,193,193,166,27,3331,3331,2873,458,22,3,3,1,139,139,136,136
Imperial,10,2022-02-21,394,394,335,59,4741,4741,4034,707,31,6,6,10,927,927,921,921
Inyo,10,2022-02-21,10,10,9,1,326,326,284,42,1,0,0,0,56,56,56,56
Kern,10,2022-02-21,1285,1285,1123,162,24322,24322,21263,3059,95,23,23,25,2289,2289,2266,2266
Kings,10,2022-02-21,454,454,387,67,6543,6543,5576,967,32,4,4,5,433,433,429,429
Lake,10,2022-02-21,185,185,155,30,1935,1935,1614,321,7,2,2,1,132,132,130,130
Lassen,10,2022-02-21,111,111,98,13,2135,2135,1883,252,1,0,0,0,59,59,59,59
Los Angeles,10,2022-02-21,11810,11810,11263,547,832205,832241,793213,39028,997,322,322,279,31111,31111,30789,30789
Madera,10,2022-02-21,317,317,265,52,5176,5176,4315,861,27,2,2,7,366,366,364,364
Marin,10,2022-02-21,199,199,167,32,8846,8846,7426,1420,13,3,3,4,289,289,286,286
Mariposa,10,2022-02-21,23,23,19,4,372,372,307,65,0,1,1,0,25,25,24,24
Mendocino,10,2022-02-21,113,113,90,23,1942,1942,1539,403,9,2,2,3,119,119,117,117
Merced,10,2022-02-21,426,426,371,55,5160,5160,4489,671,26,10,10,7,794,794,784,784
Modoc,10,2022-02-21,9,9,8,1,65,65,57,8,2,0,0,0,7,7,7,7
Mono,10,2022-02-21,7,7,5,2,162,162,123,39,0,1,1,0,6,6,5,5
Monterey,10,2022-02-21,780,780,596,184,12977,12977,9894,3083,47,5,5,7,706,706,701,701
Napa,10,2022-02-21,229,229,202,27,4991,4991,4410,581,6,4,4,3,135,135,131,131
Nevada,10,2022-02-21,102,102,85,17,1985,1985,1665,320,16,2,2,5,127,127,125,125
Orange,10,2022-02-21,2468,2468,2217,251,110421,110426,99032,11394,256,79,79,69,6958,6958,6879,6879
Placer,10,2022-02-21,328,328,271,57,8679,8679,7157,1522,92,9,9,13,608,608,599,599
Plumas,10,2022-02-21,21,21,18,3,328,328,276,52,0,0,0,0,13,13,13,13
Riverside,10,2022-02-21,2438,2438,2114,324,61417,61420,53280,8140,262,53,53,61,6345,6345,6292,6292
Sacramento,10,2022-02-21,1964,1964,1686,278,42793,42793,36703,6090,249,33,33,47,2960,2960,2927,2927
San Benito,10,2022-02-21,104,104,92,12,1696,1696,1494,202,0,0,0,1,91,91,91,91
San Bernardino,10,2022-02-21,1901,1901,1693,208,60252,60254,53632,6622,251,82,82,78,7627,7627,7545,7545
San Diego,10,2022-02-21,4622,4622,4397,225,100589,100594,95693,4901,468,63,63,106,5221,5221,5158,5158
San Francisco,10,2022-02-21,975,975,730,245,40355,40355,30107,10248,98,11,11,24,829,829,818,818
San Joaquin,10,2022-02-21,1049,1049,888,161,23840,23840,20163,3677,91,25,25,31,2210,2210,2185,2185
San Luis Obispo,10,2022-02-21,441,441,386,55,7650,7650,6704,946,16,16,16,3,454,454,438,438
San Mateo,10,2022-02-21,695,695,624,71,42576,42576,38161,4415,47,8,8,8,691,691,683,683
Santa Barbara,10,2022-02-21,611,611,528,83,19195,19195,16577,2618,40,6,6,10,665,665,659,659
Santa Clara,10,2022-02-21,2515,2515,2385,130,120312,120316,114027,6289,224,25,25,53,2233,2233,2208,2208
Santa Cruz,10,2022-02-21,578,578,509,69,25013,25013,22014,2999,21,1,1,4,254,254,253,253
Shasta,10,2022-02-21,263,263,225,38,4976,4976,4276,700,46,9,9,10,526,526,517,517
Siskiyou,10,2022-02-21,47,47,42,5,450,450,398,52,6,4,4,1,77,77,73,73
Solano,10,2022-02-21,696,696,603,93,15110,15110,13093,2017,51,5,5,15,441,441,436,436
Sonoma,10,2022-02-21,628,628,546,82,16821,16821,14601,2220,36,2,2,8,480,480,478,478
Stanislaus,10,2022-02-21,732,732,590,142,11759,11759,9489,2270,168,29,29,30,1641,1641,1612,1612
Sutter,10,2022-02-21,121,121,105,16,2108,2108,1821,287,0,2,2,0,219,219,217,217
Tehama,10,2022-02-21,96,96,78,18,1219,1219,993,226,8,10,10,2,199,199,189,189
Trinity,10,2022-02-21,15,15,12,3,199,199,160,39,0,0,0,0,20,20,20,20
Tulare,10,2022-02-21,774,774,622,152,10925,10925,8784,2141,86,15,15,9,1450,1450,1435,1435
Tuolumne,10,2022-02-21,107,107,90,17,1784,1784,1491,293,2,6,6,2,178,178,172,172
Ventura,10,2022-02-21,886,886,802,84,27543,27543,24926,2617,107,22,22,22,1464,1464,1442,1442
Yolo,10,2022-02-21,282,282,248,34,20975,20975,18396,2579,7,6,6,3,348,348,342,342
Yuba,10,2022-02-21,134,134,117,17,1679,1679,1466,213,22,1,1,8,116,116,115,115
Alameda,11,2022-02-28,1475,1475,1348,127,78766,78771,71944,6827,113,16,16,23,1830,1830,1814,1814
Amador,11,2022-02-28,56,56,48,8,2077,2077,1796,281,7,0,0,2,84,84,84,84
Butte,11,2022-02-28,187,187,174,13,4475,4475,4156,319,45,6,6,4,422,422,416,416
Calaveras,11,2022-02-28,40,40,35,5,1254,1254,1105,149,0,3,3,0,117,117,114,114
Colusa,11,2022-02-28,10,10,9,1,406,406,364,42,5,0,0,0,21,21,21,21
Contra Costa,11,2022-02-28,935,935,806,129,35020,35020,30195,4825,56,15,15,19,1279,1279,1264,1264
Del Norte,11,2022-02-28,84,84,75,9,2876,2876,2557,319,5,3,3,2,47,47,44,44
El Dorado,11,2022-02-28,105,105,93,12,3686,3686,3252,434,5,2,2,3,207,207,205,205
Fresno,11,2022-02-28,1308,1308,1136,172,26283,26283,22834,3449,196,28,28,44,2709,2709,2681,2681
Glenn,11,2022-02-28,18,18,16,2,435,435,386,49,1,0,0,0,52,52,52,52
Humboldt,11,2022-02-28,157,157,140,17,2957,2957,2633,324,6,1,1,1,140,140,139,139
Imperial,11,2022-02-28,264,264,233,31,4766,4766,4195,571,13,6,6,10,933,933,927,927
Inyo,11,2022-02-28,10,10,9,1,379,379,341,38,0,0,0,0,56,56,56,56
Kern,11,2022-02-28,792,792,713,79,24603,24603,22150,2453,77,16,16,16,2305,2305,2289,2289
Kings,11,2022-02-28,246,246,216,30,6079,6079,5356,723,19,7,7,3,440,440,433,433
Lake,11,2022-02-28,110,110,95,15,1956,1956,1695,261,0,4,4,1,136,136,132,132
Lassen,11,2022-02-28,44,44,40,4,2097,2097,1899,198,1,2,2,0,61,61,59,59
Los Angeles,11,2022-02-28,8219,8219,7921,298,1057294,1057343,1018804,38539,753,222,222,174,31333,31333,31111,31111
Madera,11,2022-02-28,189,189,164,25,4623,4623,4012,611,20,2,2,6,368,368,366,366
Marin,11,2022-02-28,160,160,140,20,7664,7664,6681,983,13,3,3,3,292,292,289,289
Mariposa,11,2022-02-28,29,29,25,4,347,347,298,49,0,1,1,0,26,26,25,25
Mendocino,11,2022-02-28,84,84,70,14,1889,1889,1571,318,11,2,2,2,121,121,119,119
Merced,11,2022-02-28,283,283,254,29,5030,5030,4509,521,25,7,7,5,801,801,794,794
Modoc,11,2022-02-28,6,6,5,1,57,57,51,6,1,0,0,0,7,7,7,7
Mono,11,2022-02-28,5,5,4,1,169,169,136,33,0,0,0,0,6,6,6,6
Monterey,11,2022-02-28,356,356,287,69,14337,14337,11561,2776,28,9,9,5,715,715,706,706
Napa,11,2022-02-28,194,194,176,18,5599,5599,5084,515,8,3,3,2,138,138,135,135
Nevada,11,2022-02-28,71,71,62,9,2016,2016,1753,263,9,0,0,1,127,127,127,127
Orange,11,2022-02-28,1693,1693,1556,137,126372,126377,116113,10264,198,43,43,35,7001,7001,6958,6958
Placer,11,2022-02-28,248,248,213,35,8421,8421,7233,1188,65,4,4,13,612,612,608,608
Plumas,11,2022-02-28,23,23,20,3,370,370,323,47,0,0,0,0,13,13,13,13
Riverside,11,2022-02-28,1686,1686,1507,179,63266,63269,56572,6697,185,37,37,35,6382,6382,6345,6345
Sacramento,11,2022-02-28,1164,1164,1033,131,45700,45701,40519,5182,163,24,24,35,2984,2984,2960,2960
San Benito,11,2022-02-28,55,55,50,5,1809,1809,1638,171,0,0,0,1,91,91,91,91
San Bernardino,11,2022-02-28,1174,1174,1072,102,61095,61097,55777,5320,157,60,60,45,7687,7687,7627,7627
San Diego,11,2022-02-28,3034,3034,2918,116,100026,100031,96227,3804,341,38,38,83,5259,5259,5221,5221
San Francisco,11,2022-02-28,835,835,662,173,40065,40065,31742,8323,74,16,16,19,845,845,829,829
San Joaquin,11,2022-02-28,657,657,576,81,26083,26083,22861,3222,58,11,11,24,2221,2221,2210,2210
San Luis Obispo,11,2022-02-28,378,378,341,37,8504,8504,7672,832,9,5,5,2,459,459,454,454
San Mateo,11,2022-02-28,597,597,549,48,41439,41440,38086,3354,33,4,4,7,695,695,691,691
Santa Barbara,11,2022-02-28,369,369,329,40,21385,21385,19063,2322,36,5,5,10,670,670,665,665
Santa Clara,11,2022-02-28,1730,1730,1660,70,103091,103096,98976,4120,191,22,22,46,2255,2255,2233,2233
Santa Cruz,11,2022-02-28,460,460,416,44,27974,27974,25344,2630,20,2,2,4,256,256,254,254
Shasta,11,2022-02-28,167,167,148,19,4926,4926,4373,553,36,11,11,8,537,537,526,526
Siskiyou,11,2022-02-28,25,25,23,2,475,475,432,43,4,2,2,1,79,79,77,77
Solano,11,2022-02-28,475,475,425,50,15304,15304,13678,1626,47,3,3,17,444,444,441,441
Sonoma,11,2022-02-28,454,454,407,47,16949,16949,15184,1765,28,3,3,5,483,483,480,480
Stanislaus,11,2022-02-28,470,470,396,74,13361,13361,11275,2086,124,11,11,21,1652,1652,1641,1641
Sutter,11,2022-02-28,106,106,95,11,2333,2333,2079,254,0,2,2,0,221,221,219,219
Tehama,11,2022-02-28,60,60,51,9,1221,1221,1039,182,7,1,1,2,200,200,199,199
Trinity,11,2022-02-28,5,5,4,1,118,118,99,19,0,0,0,0,20,20,20,20
Tulare,11,2022-02-28,462,462,389,73,11875,11875,9989,1886,67,15,15,9,1465,1465,1450,1450
Tuolumne,11,2022-02-28,69,69,60,9,1486,1486,1291,195,6,3,3,1,181,181,178,178
Ventura,11,2022-02-28,548,548,507,41,29889,29889,27649,2240,75,10,10,11,1474,1474,1464,1464
Yolo,11,2022-02-28,207,207,187,20,26245,26245,23700,2545,4,5,5,6,353,353,348,348
Yuba,11,2022-02-28,75,75,67,8,1711,1711,1537,174,12,1,1,6,117,117,116,116
Alameda,12,2022-03-07,1093,1093,1018,75,72599,72604,67606,4998,77,11,11,16,1841,1841,1830,1830
Amador,12,2022-03-07,75,75,67,8,1428,1428,1274,154,6,2,2,1,86,86,84,84
Butte,12,2022-03-07,98,98,92,6,3638,3638,3434,204,33,4,4,3,426,426,422,422
Calaveras,12,2022-03-07,25,25,23,2,1048,1048,948,100,1,1,1,0,118,118,117,117
Colusa,12,2022-03-07,9,9,8,1,355,355,326,29,6,0,0,0,21,21,21,21
Contra Costa,12,2022-03-07,627,627,558,69,30970,30970,27545,3425,47,8,8,13,1287,1287,1279,1279
Del Norte,12,2022-03-07,50,50,46,4,1779,1779,1624,155,7,0,0,1,47,47,47,47
El Dorado,12,2022-03-07,77,77,70,7,3200,3200,2899,301,5,3,3,2,210,210,207,207
Fresno,12,2022-03-07,859,859,769,90,22193,22193,19869,2324,145,18,18,27,2727,2727,2709,2709
Glenn,12,2022-03-07,19,19,17,2,395,395,359,36,2,1,1,0,53,53,52,52
Humboldt,12,2022-03-07,81,81,74,7,3045,3045,2779,266,10,3,3,4,143,143,140,140
Imperial,12,2022-03-07,122,122,110,12,4464,4464,4038,426,16,5,5,10,938,938,933,933
Inyo,12,2022-03-07,10,10,9,1,269,269,247,22,0,0,0,0,56,56,56,56
Kern,12,2022-03-07,433,433,398,35,20833,20833,19184,1649,67,12,12,16,2317,2317,2305,2305
Kings,12,2022-03-07,201,201,182,19,4986,4986,4514,472,13,4,4,2,444,444,440,440
Lake,12,2022-03-07,64,64,57,7,1760,1760,1572,188,2,2,2,1,138,138,136,136
Lassen,12,2022-03-07,96,96,89,7,1889,1889,1748,141,0,1,1,0,62,62,61,61
Los Angeles,12,2022-03-07,5536,5536,5379,157,876052,876100,851176,24924,573,171,171,133,31504,31504,31333,31333
Madera,12,2022-03-07,133,133,119,14,3916,3916,3502,414,15,1,1,2,369,369,368,368
Marin,12,2022-03-07,154,154,138,16,7559,7559,6778,781,10,1,1,2,293,293,292,292
Mariposa,12,2022-03-07,11,11,10,1,296,296,263,33,0,1,1,0,27,27,26,26
Mendocino,12,2022-03-07,65,65,56,9,1643,1643,1418,225,6,0,0,2,121,121,121,121
Merced,12,2022-03-07,173,173,159,14,4536,4536,4161,375,17,7,7,5,808,808,801,801
Modoc,12,2022-03-07,0,0,0,0,54,54,50,4,0,0,0,0,7,7,7,7
Mono,12,2022-03-07,2,2,2,0,128,128,108,20,0,0,0,1,6,6,6,6
Monterey,12,2022-03-07,243,243,205,38,11053,11053,9324,1729,19,5,5,2,720,720,715,715
Napa,12,2022-03-07,200,200,185,15,4896,4896,4539,357,2,1,1,2,139,139,138,138
Nevada,12,2022-03-07,50,50,45,5,1751,1751,1569,182,0,2,2,0,129,129,127,127
Orange,12,2022-03-07,1257,1257,1176,81,107466,107471,100565,6906,138,29,29,28,7030,7030,7001,7001
Placer,12,2022-03-07,164,164,145,19,7797,7797,6916,881,54,3,3,11,615,615,612,612
Plumas,12,2022-03-07,7,7,6,1,266,266,239,27,0,0,0,0,13,13,13,13
Riverside,12,2022-03-07,981,981,899,82,53632,53635,49121,4514,125,26,26,30,6408,6408,6382,6382
Sacramento,12,2022-03-07,773,773,704,69,40204,40205,36585,3620,124,18,18,28,3002,3002,2984,2984
San Benito,12,2022-03-07,41,41,38,3,1525,1525,1411,114,0,2,2,1,93,93,91,91
San Bernardino,12,2022-03-07,791,791,736,55,54193,54196,50459,3737,95,43,43,38,7730,7730,7687,7687
San Diego,12,2022-03-07,2336,2336,2266,70,96666,96671,93787,2884,237,31,31,57,5290,5290,5259,5259
San Francisco,12,2022-03-07,700,700,582,118,37419,37419,31062,6357,62,5,5,11,850,850,845,845
San Joaquin,12,2022-03-07,439,439,396,43,21194,21194,19116,2078,33,9,9,19,2230,2230,2221,2221
San Luis Obispo,12,2022-03-07,245,245,226,19,7300,7300,6735,565,7,5,5,1,464,464,459,459
San Mateo,12,2022-03-07,529,529,495,34,40059,40059,37471,2588,30,2,2,3,697,697,695,695
Santa Barbara,12,2022-03-07,203,203,186,17,17714,17714,16186,1528,15,4,4,8,674,674,670,670
Santa Clara,12,2022-03-07,1467,1467,1421,46,112126,112131,108561,3570,128,13,13,38,2268,2268,2255,2255
Santa Cruz,12,2022-03-07,335,335,310,25,24974,24974,23115,1859,11,0,0,7,256,256,256,256
Shasta,12,2022-03-07,140,140,127,13,4940,4940,4498,442,24,8,8,3,545,545,537,537
Siskiyou,12,2022-03-07,12,12,11,1,399,399,370,29,2,1,1,0,80,80,79,79
Solano,12,2022-03-07,351,351,321,30,14064,14064,12873,1191,46,2,2,10,446,446,444,444
Sonoma,12,2022-03-07,321,321,294,27,14923,14923,13686,1237,26,3,3,6,486,486,483,483
Stanislaus,12,2022-03-07,276,276,241,35,10858,10858,9500,1358,94,10,10,13,1662,1662,1652,1652
Sutter,12,2022-03-07,81,81,74,7,1908,1908,1742,166,0,1,1,0,222,222,221,221
Tehama,12,2022-03-07,40,40,35,5,1115,1115,980,135,5,2,2,1,202,202,200,200
Trinity,12,2022-03-07,4,4,3,1,114,114,100,14,0,0,0,0,20,20,20,20
Tulare,12,2022-03-07,302,302,263,39,10282,10282,8974,1308,37,13,13,3,1478,1478,1465,1465
Tuolumne,12,2022-03-07,48,48,43,5,1253,1253,1122,131,2,0,0,1,181,181,181,181
Ventura,12,2022-03-07,417,417,392,25,26717,26717,25137,1580,45,4,4,11,1478,1478,1474,1474
Yolo,12,2022-03-07,160,160,148,12,22153,22153,20449,1704,3,2,2,2,355,355,353,353
Yuba,12,2022-03-07,59,59,54,5,1552,1552,1425,127,13,0,0,6,117,117,117,117
Alameda,13,2022-03-14,879,879,831,48,68953,68958,65207,3751,64,9,9,6,1850,1850,1841,1841
Amador,13,2022-03-14,32,32,29,3,1439,1439,1315,124,4,0,0,0,86,86,86,86
Butte,13,2022-03-14,82,82,78,4,3592,3592,3432,160,24,1,1,0,427,427,426,426
Calaveras,13,2022-03-14,17,17,16,1,990,990,914,76,1,1,1,1,119,119,118,118
Colusa,13,2022-03-14,4,4,4,0,257,257,240,17,4,0,0,0,21,21,21,21
Contra Costa,13,2022-03-14,567,567,517,50,29141,29141,26572,2569,19,5,5,9,1292,1292,1287,1287
Del Norte,13,2022-03-14,31,31,29,2,1415,1415,1317,98,1,2,2,1,49,49,47,47
El Dorado,13,2022-03-14,44,44,41,3,2980,2980,2757,223,4,1,1,0,211,211,210,210
Fresno,13,2022-03-14,526,526,482,44,21100,21100,19337,1763,120,10,10,20,2737,2737,2727,2727
Glenn,13,2022-03-14,11,11,10,1,342,342,318,24,1,0,0,0,53,53,53,53
Humboldt,13,2022-03-14,56,56,52,4,2651,2651,2466,185,3,1,1,2,144,144,143,143
Imperial,13,2022-03-14,74,74,68,6,4537,4537,4190,347,5,2,2,7,940,940,938,938
Inyo,13,2022-03-14,6,6,6,0,165,165,154,11,0,0,0,0,56,56,56,56
Kern,13,2022-03-14,301,301,282,19,20273,20273,19003,1270,42,14,14,12,2331,2331,2317,2317
Kings,13,2022-03-14,156,156,144,12,4695,4695,4341,354,17,1,1,2,445,445,444,444
Lake,13,2022-03-14,48,48,44,4,1570,1570,1436,134,1,1,1,0,139,139,138,138
Lassen,13,2022-03-14,5,5,5,0,1515,1515,1426,89,0,0,0,0,62,62,62,62
Los Angeles,13,2022-03-14,4061,4061,3971,90,845640,845699,826843,18856,412,115,115,91,31619,31619,31504,31504
Madera,13,2022-03-14,52,52,48,4,3575,3575,3272,303,12,0,0,2,369,369,369,369
Marin,13,2022-03-14,170,170,156,14,6532,6532,5997,535,7,1,1,0,294,294,293,293
Mariposa,13,2022-03-14,9,9,8,1,222,222,202,20,0,0,0,0,27,27,27,27
Mendocino,13,2022-03-14,35,35,31,4,1434,1434,1276,158,4,2,2,1,123,123,121,121
Merced,13,2022-03-14,134,134,125,9,4167,4167,3895,272,17,2,2,4,810,810,808,808
Modoc,13,2022-03-14,3,3,3,0,52,52,49,3,1,0,0,0,7,7,7,7
Mono,13,2022-03-14,2,2,2,0,118,118,103,15,0,0,0,0,6,6,6,6
Monterey,13,2022-03-14,156,156,136,20,10115,10115,8836,1279,14,4,4,2,724,724,720,720
Napa,13,2022-03-14,123,123,116,7,4113,4113,3875,238,6,1,1,3,140,140,139,139
Nevada,13,2022-03-14,50,50,46,4,1571,1571,1441,130,2,0,0,0,129,129,129,129
Orange,13,2022-03-14,827,827,785,42,101566,101571,96416,5155,109,32,32,31,7062,7062,7030,7030
Placer,13,2022-03-14,148,148,135,13,7319,7319,6658,661,45,3,3,5,618,618,615,615
Plumas,13,2022-03-14,4,4,4,0,317,317,291,26,0,0,0,0,13,13,13,13
Riverside,13,2022-03-14,741,741,692,49,52737,52742,49225,3517,87,15,15,16,6423,6423,6408,6408
Sacramento,13,2022-03-14,588,588,546,42,35139,35139,32616,2523,122,16,16,22,3018,3018,3002,3002
San Benito,13,2022-03-14,36,36,34,2,1462,1462,1375,87,0,0,0,1,93,93,93,93
San Bernardino,13,2022-03-14,570,570,539,31,51689,51694,48874,2820,68,26,26,32,7756,7756,7730,7730
San Diego,13,2022-03-14,1843,1843,1800,43,96065,96070,93815,2255,174,17,17,47,5307,5307,5290,5290
San Francisco,13,2022-03-14,608,608,525,83,34320,34320,29599,4721,28,7,7,7,857,857,850,850
San Joaquin,13,2022-03-14,268,268,247,21,18873,18873,17388,1485,28,7,7,11,2237,2237,2230,2230
San Luis Obispo,13,2022-03-14,162,162,152,10,6664,6664,6254,410,7,7,7,1,471,471,464,464
San Mateo,13,2022-03-14,441,441,419,22,35834,35835,34001,1834,27,0,0,3,697,697,697,697
Santa Barbara,13,2022-03-14,195,195,182,13,16859,16859,15700,1159,16,7,7,2,681,681,674,674
Santa Clara,13,2022-03-14,1177,1177,1148,29,99875,99881,97383,2498,108,13,13,28,2281,2281,2268,2268
Santa Cruz,13,2022-03-14,239,239,225,14,22176,22176,20869,1307,10,3,3,3,259,259,256,256
Shasta,13,2022-03-14,97,97,90,7,4838,4838,4492,346,16,5,5,2,550,550,545,545
Siskiyou,13,2022-03-14,9,9,8,1,370,370,349,21,0,3,3,0,83,83,80,80
Solano,13,2022-03-14,221,221,206,15,12299,12299,11471,828,34,1,1,6,447,447,446,446
Sonoma,13,2022-03-14,229,229,214,15,13398,13398,12513,885,14,1,1,4,487,487,486,486
Stanislaus,13,2022-03-14,216,216,194,22,9401,9401,8454,947,82,11,11,17,1673,1673,1662,1662
Sutter,13,2022-03-14,41,41,38,3,1815,1815,1689,126,0,0,0,0,222,222,222,222
Tehama,13,2022-03-14,17,17,15,2,981,981,886,95,2,3,3,0,205,205,202,202
Trinity,13,2022-03-14,3,3,3,0,96,96,86,10,0,0,0,0,20,20,20,20
Tulare,13,2022-03-14,174,174,156,18,9301,9301,8348,953,33,0,0,6,1478,1478,1478,1478
Tuolumne,13,2022-03-14,22,22,20,2,1246,1246,1142,104,1,0,0,0,181,181,181,181
Ventura,13,2022-03-14,326,326,311,15,24591,24591,23440,1151,37,6,6,7,1484,1484,1478,1478
Yolo,13,2022-03-14,118,118,111,7,21619,21619,20301,1318,1,3,3,2,358,358,355,355
Yuba,13,2022-03-14,35,35,33,2,1417,1417,1325,92,10,0,0,3,117,117,117,117
Alameda,14,2022-03-21,721,721,690,31,65828,65833,63001,2832,58,6,6,3,1856,1856,1850,1850
Amador,14,2022-03-21,29,29,27,2,1356,1356,1263,93,2,0,0,0,86,86,86,86
Butte,14,2022-03-21,81,81,78,3,3158,3158,3048,110,17,0,0,2,427,427,427,427
Calaveras,14,2022-03-21,8,8,8,0,657,657,618,39,0,0,0,0,119,119,119,119
Colusa,14,2022-03-21,3,3,3,0,231,231,219,12,2,0,0,0,21,21,21,21
Contra Costa,14,2022-03-21,466,466,434,32,26931,26931,25039,1892,27,7,7,9,1299,1299,1292,1292
Del Norte,14,2022-03-21,19,19,18,1,1192,1192,1127,65,0,0,0,0,49,49,49,49
El Dorado,14,2022-03-21,46,46,43,3,2813,2813,2647,166,1,2,2,0,213,213,211,211
Fresno,14,2022-03-21,346,346,323,23,19318,19318,18037,1281,97,11,11,12,2748,2748,2737,2737
Glenn,14,2022-03-21,7,7,7,0,366,366,345,21,1,0,0,0,53,53,53,53
Humboldt,14,2022-03-21,31,31,29,2,2456,2456,2322,134,5,1,1,2,145,145,144,144
Imperial,14,2022-03-21,58,58,54,4,3952,3952,3714,238,4,3,3,4,943,943,940,940
Inyo,14,2022-03-21,1,1,1,0,148,148,140,8,0,0,0,0,56,56,56,56
Kern,14,2022-03-21,206,206,196,10,19490,19490,18525,965,34,4,4,9,2335,2335,2331,2331
Kings,14,2022-03-21,79,79,74,5,4411,4411,4147,264,7,1,1,1,446,446,445,445
Lake,14,2022-03-21,18,18,17,1,1365,1365,1272,93,0,0,0,0,139,139,139,139
Lassen,14,2022-03-21,10,10,10,0,1388,1388,1323,65,0,0,0,0,62,62,62,62
Los Angeles,14,2022-03-21,4131,4131,4060,71,822848,822913,808540,14373,338,76,76,66,31695,31695,31619,31619
Madera,14,2022-03-21,40,40,37,3,3392,3392,3164,228,9,1,1,1,370,370,369,369
Marin,14,2022-03-21,133,133,124,9,6231,6231,5825,406,6,1,1,0,295,295,294,294
Mariposa,14,2022-03-21,7,7,6,1,236,236,219,17,0,0,0,0,27,27,27,27
Mendocino,14,2022-03-21,28,28,26,2,1508,1508,1376,132,4,0,0,1,123,123,123,123
Merced,14,2022-03-21,87,87,82,5,3771,3771,3576,195,13,5,5,1,815,815,810,810
Modoc,14,2022-03-21,2,2,2,0,60,60,57,3,0,0,0,0,7,7,7,7
Mono,14,2022-03-21,4,4,4,0,134,134,120,14,1,0,0,0,6,6,6,6
Monterey,14,2022-03-21,152,152,137,15,10087,10087,9063,1024,22,0,0,1,724,724,724,724
Napa,14,2022-03-21,55,55,52,3,3454,3454,3297,157,6,1,1,2,141,141,140,140
Nevada,14,2022-03-21,18,18,17,1,1528,1528,1428,100,2,0,0,0,129,129,129,129
Orange,14,2022-03-21,761,761,731,30,96140,96145,92292,3853,100,12,12,25,7074,7074,7062,7062
Placer,14,2022-03-21,112,112,104,8,6475,6475,6010,465,40,2,2,6,620,620,618,618
Plumas,14,2022-03-21,2,2,2,0,228,228,213,15,0,0,0,0,13,13,13,13
Riverside,14,2022-03-21,614,614,581,33,51895,51900,49143,2757,69,13,13,18,6436,6436,6423,6423
Sacramento,14,2022-03-21,464,464,438,26,32986,32987,31116,1871,89,13,13,13,3031,3031,3018,3018
San Benito,14,2022-03-21,19,19,18,1,1385,1385,1320,65,0,1,1,0,94,94,93,93
San Bernardino,14,2022-03-21,474,474,454,20,49320,49325,47193,2132,49,20,20,31,7776,7776,7756,7756
San Diego,14,2022-03-21,1371,1371,1346,25,84591,84596,83040,1556,146,15,15,39,5322,5322,5307,5307
San Francisco,14,2022-03-21,687,687,612,75,33568,33568,29856,3712,34,3,3,3,860,860,857,857
San Joaquin,14,2022-03-21,220,220,206,14,15669,15669,14698,971,23,6,6,6,2243,2243,2237,2237
San Luis Obispo,14,2022-03-21,107,107,102,5,6416,6416,6103,313,3,5,5,0,476,476,471,471
San Mateo,14,2022-03-21,368,368,353,15,34927,34931,33527,1404,30,1,1,1,698,698,697,697
Santa Barbara,14,2022-03-21,161,161,152,9,14296,14296,13507,789,17,5,5,4,686,686,681,681
Santa Clara,14,2022-03-21,1099,1099,1078,21,95231,95236,93370,1866,101,5,5,20,2286,2286,2281,2281
Santa Cruz,14,2022-03-21,184,184,175,9,20037,20037,19102,935,8,0,0,3,259,259,259,259
Shasta,14,2022-03-21,41,41,39,2,4136,4136,3902,234,10,6,6,2,556,556,550,550
Siskiyou,14,2022-03-21,9,9,9,0,370,370,353,17,1,0,0,0,83,83,83,83
Solano,14,2022-03-21,187,187,177,10,11748,11748,11123,625,17,1,1,5,448,448,447,447
Sonoma,14,2022-03-21,230,230,218,12,12379,12379,11727,652,15,2,2,2,489,489,487,487
Stanislaus,14,2022-03-21,142,142,131,11,8428,8428,7752,676,59,12,12,8,1685,1685,1673,1673
Sutter,14,2022-03-21,34,34,32,2,1478,1478,1398,80,0,1,1,0,223,223,222,222
Tehama,14,2022-03-21,10,10,9,1,926,926,854,72,2,0,0,0,205,205,205,205
Trinity,14,2022-03-21,0,0,0,0,111,111,102,9,0,0,0,0,20,20,20,20
Tulare,14,2022-03-21,108,108,99,9,8165,8165,7499,666,27,5,5,4,1483,1483,1478,1478
Tuolumne,14,2022-03-21,19,19,18,1,1131,1131,1055,76,2,0,0,0,181,181,181,181
Ventura,14,2022-03-21,289,289,278,11,23283,23283,22423,860,30,5,5,6,1489,1489,1484,1484
Yolo,14,2022-03-21,106,106,101,5,21431,21431,20393,1038,1,0,0,1,358,358,358,358
Yuba,14,2022-03-21,42,42,40,2,1318,1318,1251,67,8,0,0,2,117,117,117,117
Alameda,15,2022-03-28,929,929,898,31,59265,59270,57271,1999,35,4,4,5,1860,1860,1856,1856
Amador,15,2022-03-28,8,8,8,0,1376,1376,1301,75,3,0,0,0,86,86,86,86
Butte,15,2022-03-28,64,64,62,2,2853,2853,2775,78,11,0,0,1,427,427,427,427
Calaveras,15,2022-03-28,15,15,14,1,580,580,553,27,0,0,0,0,119,119,119,119
Colusa,15,2022-03-28,4,4,4,0,207,207,199,8,0,0,0,0,21,21,21,21
Contra Costa,15,2022-03-28,533,533,504,29,24909,24909,23528,1381,29,1,1,6,1300,1300,1299,1299
Del Norte,15,2022-03-28,16,16,15,1,1038,1038,993,45,1,0,0,0,49,49,49,49
El Dorado,15,2022-03-28,60,60,57,3,2810,2810,2679,131,0,0,0,0,213,213,213,213
Fresno,15,2022-03-28,275,275,261,14,17887,17887,16948,939,71,5,5,18,2753,2753,2748,2748
Glenn,15,2022-03-28,8,8,8,0,333,333,318,15,0,0,0,0,53,53,53,53
Humboldt,15,2022-03-28,27,27,26,1,2608,2608,2495,113,4,0,0,3,145,145,145,145
Imperial,15,2022-03-28,63,63,60,3,3529,3529,3361,168,4,1,1,3,944,944,943,943
Inyo,15,2022-03-28,4,4,4,0,186,186,178,8,1,0,0,0,56,56,56,56
Kern,15,2022-03-28,144,144,138,6,18179,18179,17469,710,17,4,4,8,2339,2339,2335,2335
Kings,15,2022-03-28,57,57,54,3,4275,4275,4073,202,6,2,2,0,448,448,446,446
Lake,15,2022-03-28,10,10,9,1,1068,1068,1010,58,0,0,0,0,139,139,139,139
Lassen,15,2022-03-28,4,4,4,0,1284,1284,1236,48,0,0,0,0,62,62,62,62
Los Angeles,15,2022-03-28,4475,4475,4414,61,703833,703893,694165,9728,264,53,53,57,31748,31748,31695,31695
Madera,15,2022-03-28,24,24,23,1,3451,3451,3268,183,4,0,0,2,370,370,370,370
Marin,15,2022-03-28,180,180,171,9,6000,6000,5692,308,3,0,0,0,295,295,295,295
Mariposa,15,2022-03-28,5,5,5,0,179,179,169,10,0,1,1,0,28,28,27,27
Mendocino,15,2022-03-28,31,31,29,2,1314,1314,1223,91,0,1,1,0,124,124,123,123
Merced,15,2022-03-28,64,64,61,3,3359,3359,3223,136,5,1,1,3,816,816,815,815
Modoc,15,2022-03-28,3,3,3,0,45,45,43,2,0,0,0,0,7,7,7,7
Mono,15,2022-03-28,1,1,1,0,134,134,123,11,0,0,0,0,6,6,6,6
Monterey,15,2022-03-28,149,149,137,12,8782,8782,8069,713,14,1,1,0,725,725,724,724
Napa,15,2022-03-28,70,70,68,2,3335,3335,3216,119,1,2,2,1,143,143,141,141
Nevada,15,2022-03-28,27,27,26,1,1431,1431,1357,74,1,1,1,0,130,130,129,129
Orange,15,2022-03-28,815,815,790,25,90218,90224,87387,2837,81,12,12,17,7086,7086,7074,7074
Placer,15,2022-03-28,108,108,102,6,6223,6223,5871,352,26,4,4,6,624,624,620,620
Plumas,15,2022-03-28,3,3,3,0,267,267,253,14,0,0,0,0,13,13,13,13
Riverside,15,2022-03-28,522,522,500,22,43927,43932,42101,1831,47,7,7,10,6443,6443,6436,6436
Sacramento,15,2022-03-28,454,454,434,20,32472,32474,31024,1450,68,6,6,19,3037,3037,3031,3031
San Benito,15,2022-03-28,14,14,13,1,1365,1365,1315,50,0,0,0,0,94,94,94,94
San Bernardino,15,2022-03-28,545,545,527,18,41309,41314,39917,1397,40,18,18,24,7794,7794,7776,7776
San Diego,15,2022-03-28,1327,1327,1308,19,72132,72137,71102,1035,114,9,9,26,5331,5331,5322,5322
San Francisco,15,2022-03-28,844,844,770,74,32805,32807,29912,2895,23,5,5,5,865,865,860,860
San Joaquin,15,2022-03-28,189,189,180,9,17487,17487,16633,854,20,4,4,4,2247,2247,2243,2243
San Luis Obispo,15,2022-03-28,96,96,92,4,5701,5701,5484,217,5,1,1,1,477,477,476,476
San Mateo,15,2022-03-28,582,582,564,18,33959,33962,32887,1075,26,3,3,3,701,701,698,698
Santa Barbara,15,2022-03-28,135,135,129,6,10222,10222,9791,431,15,1,1,4,687,687,686,686
Santa Clara,15,2022-03-28,1276,1276,1257,19,95192,95199,93747,1452,88,10,10,18,2296,2296,2286,2286
Santa Cruz,15,2022-03-28,145,145,140,5,19692,19692,18975,717,3,0,0,2,259,259,259,259
Shasta,15,2022-03-28,34,34,32,2,3879,3879,3706,173,7,2,2,3,558,558,556,556
Siskiyou,15,2022-03-28,5,5,5,0,292,292,282,10,0,0,0,0,83,83,83,83
Solano,15,2022-03-28,169,169,162,7,10930,10930,10474,456,18,0,0,6,448,448,448,448
Sonoma,15,2022-03-28,260,260,250,10,8553,8553,8206,347,13,0,0,1,489,489,489,489
Stanislaus,15,2022-03-28,119,119,111,8,8184,8184,7665,519,28,2,2,3,1687,1687,1685,1685
Sutter,15,2022-03-28,25,25,24,1,1490,1490,1426,64,0,1,1,0,224,224,223,223
Tehama,15,2022-03-28,13,13,12,1,798,798,749,49,3,1,1,0,206,206,205,205
Trinity,15,2022-03-28,0,0,0,0,79,79,74,5,0,0,0,0,20,20,20,20
Tulare,15,2022-03-28,81,81,76,5,7838,7838,7331,507,20,6,6,1,1489,1489,1483,1483
Tuolumne,15,2022-03-28,7,7,7,0,1083,1083,1026,57,3,1,1,0,182,182,181,181
Ventura,15,2022-03-28,335,335,325,10,21204,21204,20590,614,23,6,6,3,1495,1495,1489,1489
Yolo,15,2022-03-28,103,103,99,4,20513,20513,19750,763,3,2,2,0,360,360,358,358
Yuba,15,2022-03-28,26,26,25,1,1214,1214,1165,49,2,2,2,1,119,119,117,117
Alameda,16,2022-04-04,1056,1056,1029,27,56225,56230,54736,1494,40,3,3,3,1863,1863,1860,1860
Amador,16,2022-04-04,2,2,2,0,1107,1107,1060,47,1,0,0,0,86,86,86,86
Butte,16,2022-04-04,44,44,43,1,2582,2582,2526,56,8,2,2,1,429,429,427,427
Calaveras,16,2022-04-04,8,8,8,0,589,589,567,22,0,0,0,0,119,119,119,119
Colusa,16,2022-04-04,2,2,2,0,202,202,196,6,0,0,0,0,21,21,21,21
Contra Costa,16,2022-04-04,544,544,520,24,23560,23560,22525,1035,13,1,1,4,1301,1301,1300,1300
Del Norte,16,2022-04-04,8,8,8,0,1118,1118,1080,38,0,0,0,1,49,49,49,49
El Dorado,16,2022-04-04,50,50,48,2,2717,2717,2617,100,0,1,1,1,214,214,213,213
Fresno,16,2022-04-04,188,188,180,8,16783,16783,16090,693,62,4,4,12,2757,2757,2753,2753
Glenn,16,2022-04-04,3,3,3,0,287,287,277,10,0,0,0,0,53,53,53,53
Humboldt,16,2022-04-04,23,23,22,1,2385,2385,2303,82,5,0,0,2,145,145,145,145
Imperial,16,2022-04-04,39,39,37,2,3437,3437,3308,129,3,0,0,2,944,944,944,944
Inyo,16,2022-04-04,9,9,9,0,182,182,176,6,0,0,0,0,56,56,56,56
Kern,16,2022-04-04,152,152,147,5,16751,16751,16236,515,16,2,2,7,2341,2341,2339,2339
Kings,16,2022-04-04,47,47,45,2,4178,4178,4022,156,2,0,0,1,448,448,448,448
Lake,16,2022-04-04,14,14,13,1,973,973,931,42,0,0,0,0,139,139,139,139
Lassen,16,2022-04-04,5,5,5,0,1284,1284,1247,37,0,0,0,0,62,62,62,62
Los Angeles,16,2022-04-04,5460,5460,5403,57,803353,803434,794825,8609,255,47,47,42,31795,31795,31748,31748
Madera,16,2022-04-04,27,27,26,1,3190,3190,3057,133,3,0,0,1,370,370,370,370
Marin,16,2022-04-04,167,167,160,7,6347,6347,6089,258,3,0,0,1,295,295,295,295
Mariposa,16,2022-04-04,7,7,7,0,235,235,225,10,0,0,0,0,28,28,28,28
Mendocino,16,2022-04-04,25,25,24,1,1196,1196,1130,66,2,0,0,0,124,124,124,124
Merced,16,2022-04-04,58,58,56,2,3350,3350,3243,107,2,2,2,0,818,818,816,816
Modoc,16,2022-04-04,4,4,4,0,43,43,42,1,0,0,0,0,7,7,7,7
Mono,16,2022-04-04,1,1,1,0,142,142,133,9,0,0,0,0,6,6,6,6
Monterey,16,2022-04-04,128,128,120,8,7491,7491,7011,480,8,3,3,0,728,728,725,725
Napa,16,2022-04-04,75,75,73,2,3148,3148,3060,88,1,0,0,1,143,143,143,143
Nevada,16,2022-04-04,30,30,29,1,1447,1447,1388,59,1,1,1,0,131,131,130,130
Orange,16,2022-04-04,995,995,971,24,81536,81543,79511,2032,56,17,17,14,7103,7103,7086,7086
Placer,16,2022-04-04,128,128,122,6,6692,6692,6393,299,19,1,1,5,625,625,624,624
Plumas,16,2022-04-04,4,4,4,0,235,235,225,10,0,0,0,0,13,13,13,13
Riverside,16,2022-04-04,692,692,670,22,38907,38912,37639,1273,36,5,5,8,6448,6448,6443,6443
Sacramento,16,2022-04-04,432,432,417,15,32905,32908,31752,1156,50,8,8,11,3045,3045,3037,3037
San Benito,16,2022-04-04,13,13,13,0,1187,1187,1153,34,0,0,0,0,94,94,94,94
San Bernardino,16,2022-04-04,613,613,597,16,42056,42061,40943,1118,32,11,11,13,7805,7805,7794,7794
San Diego,16,2022-04-04,1543,1543,1526,17,66686,66693,65949,744,88,7,7,29,5338,5338,5331,5331
San Francisco,16,2022-04-04,1002,1002,933,69,28769,28771,26761,2010,20,1,1,3,866,866,865,865
San Joaquin,16,2022-04-04,227,227,218,9,15696,15696,15092,604,9,2,2,8,2249,2249,2247,2247
San Luis Obispo,16,2022-04-04,99,99,96,3,5382,5382,5220,162,2,1,1,1,478,478,477,477
San Mateo,16,2022-04-04,724,724,706,18,29370,29373,28647,726,14,2,2,1,703,703,701,701
Santa Barbara,16,2022-04-04,187,187,181,6,15277,15277,14760,517,7,2,2,1,689,689,687,687
Santa Clara,16,2022-04-04,1493,1493,1475,18,88302,88310,87251,1059,89,2,2,18,2298,2298,2296,2296
Santa Cruz,16,2022-04-04,210,210,204,6,16701,16701,16211,490,4,0,0,2,259,259,259,259
Shasta,16,2022-04-04,29,29,28,1,3320,3320,3203,117,4,1,1,2,559,559,558,558
Siskiyou,16,2022-04-04,2,2,2,0,294,294,286,8,0,0,0,0,83,83,83,83
Solano,16,2022-04-04,173,173,167,6,10220,10220,9884,336,21,1,1,4,449,449,448,448
Sonoma,16,2022-04-04,330,330,320,10,10653,10653,10309,344,9,1,1,1,490,490,489,489
Stanislaus,16,2022-04-04,113,113,107,6,7962,7962,7564,398,21,3,3,5,1690,1690,1687,1687
Sutter,16,2022-04-04,24,24,23,1,1324,1324,1280,44,0,0,0,0,224,224,224,224
Tehama,16,2022-04-04,6,6,6,0,765,765,728,37,0,1,1,0,207,207,206,206
Trinity,16,2022-04-04,1,1,1,0,87,87,83,4,0,0,0,0,20,20,20,20
Tulare,16,2022-04-04,48,48,46,2,7740,7740,7344,396,13,3,3,0,1492,1492,1489,1489
Tuolumne,16,2022-04-04,10,10,10,0,1034,1034,991,43,1,1,1,0,183,183,182,182
Ventura,16,2022-04-04,298,298,291,7,20329,20329,19865,464,19,5,5,5,1500,1500,1495,1495
Yolo,16,2022-04-04,104,104,101,3,26251,26251,25465,786,0,0,0,0,360,360,360,360
Yuba,16,2022-04-04,11,11,11,0,1071,1071,1037,34,4,0,0,1,119,119,119,119
Alameda,17,2022-04-11,1495,1495,1464,31,49842,49847,48818,1029,51,5,5,2,1868,1868,1863,1863
Amador,17,2022-04-11,9,9,9,0,1068,1068,1032,36,1,0,0,0,86,86,86,86
Butte,17,2022-04-11,33,33,32,1,2262,2262,2224,38,3,0,0,1,429,429,429,429
Calaveras,17,2022-04-11,14,14,14,0,649,649,630,19,0,0,0,0,119,119,119,119
Colusa,17,2022-04-11,6,6,6,0,203,203,198,5,0,0,0,0,21,21,21,21
Contra Costa,17,2022-04-11,714,714,690,24,20841,20842,20132,710,15,1,1,5,1302,1302,1301,1301
Del Norte,17,2022-04-11,9,9,9,0,1012,1012,985,27,0,0,0,0,49,49,49,49
El Dorado,17,2022-04-11,48,48,47,1,2508,2508,2436,72,1,0,0,0,214,214,214,214
Fresno,17,2022-04-11,196,196,190,6,15714,15714,15202,512,54,3,3,6,2760,2760,2757,2757
Glenn,17,2022-04-11,2,2,2,0,258,258,251,7,0,0,0,0,53,53,53,53
Humboldt,17,2022-04-11,46,46,45,1,2347,2347,2284,63,5,1,1,2,146,146,145,145
Imperial,17,2022-04-11,28,28,27,1,3439,3439,3338,101,2,1,1,1,945,945,944,944
Inyo,17,2022-04-11,4,4,4,0,188,188,183,5,0,0,0,0,56,56,56,56
Kern,17,2022-04-11,135,135,132,3,16366,16366,15968,398,20,2,2,6,2343,2343,2341,2341
Kings,17,2022-04-11,31,31,30,1,4161,4161,4039,122,3,0,0,0,448,448,448,448
Lake,17,2022-04-11,22,22,21,1,870,870,841,29,0,0,0,0,139,139,139,139
Lassen,17,2022-04-11,1,1,1,0,1292,1292,1263,29,1,0,0,0,62,62,62,62
Los Angeles,17,2022-04-11,6737,6737,6682,55,675660,675739,670033,5706,234,46,46,36,31841,31841,31795,31795
Madera,17,2022-04-11,29,29,28,1,3076,3076,2975,101,4,0,0,2,370,370,370,370
Marin,17,2022-04-11,214,214,207,7,5555,5555,5379,176,6,0,0,1,295,295,295,295
Mariposa,17,2022-04-11,7,7,7,0,246,246,237,9,0,0,0,0,28,28,28,28
Mendocino,17,2022-04-11,32,32,31,1,1158,1158,1108,50,0,0,0,0,124,124,124,124
Merced,17,2022-04-11,68,68,66,2,3222,3222,3141,81,6,2,2,0,820,820,818,818
Modoc,17,2022-04-11,0,0,0,0,40,40,39,1,0,0,0,0,7,7,7,7
Mono,17,2022-04-11,9,9,9,0,170,170,161,9,0,0,0,0,6,6,6,6
Monterey,17,2022-04-11,108,108,103,5,6890,6890,6540,350,9,2,2,0,730,730,728,728
Napa,17,2022-04-11,120,120,117,3,2805,2805,2743,62,1,0,0,0,143,143,143,143
Nevada,17,2022-04-11,45,45,44,1,1431,1431,1385,46,2,0,0,0,131,131,131,131
Orange,17,2022-04-11,1169,1169,1147,22,62014,62020,60841,1179,70,9,9,16,7112,7112,7103,7103
Placer,17,2022-04-11,126,126,122,4,5632,5632,5433,199,18,2,2,2,627,627,625,625
Plumas,17,2022-04-11,7,7,7,0,247,247,239,8,0,0,0,0,13,13,13,13
Riverside,17,2022-04-11,728,728,710,18,37778,37783,36813,970,35,5,5,9,6453,6453,6448,6448
Sacramento,17,2022-04-11,509,509,495,14,30140,30145,29312,833,47,11,11,5,3056,3056,3045,3045
San Benito,17,2022-04-11,16,16,16,0,1182,1182,1155,27,0,0,0,0,94,94,94,94
San Bernardino,17,2022-04-11,916,916,897,19,42013,42018,41142,876,33,5,5,7,7810,7810,7805,7805
San Diego,17,2022-04-11,1833,1833,1817,16,74105,74113,73465,648,91,4,4,22,5342,5342,5338,5338
San Francisco,17,2022-04-11,1180,1180,1115,65,29897,29902,28246,1656,19,6,6,4,872,872,866,866
San Joaquin,17,2022-04-11,221,221,214,7,15222,15222,14761,461,10,0,0,1,2249,2249,2249,2249
San Luis Obispo,17,2022-04-11,120,120,117,3,4908,4908,4792,116,2,1,1,0,479,479,478,478
San Mateo,17,2022-04-11,859,859,843,16,30382,30387,29796,591,8,2,2,1,705,705,703,703
Santa Barbara,17,2022-04-11,302,302,294,8,15120,15120,14718,402,6,2,2,1,691,691,689,689
Santa Clara,17,2022-04-11,1661,1661,1646,15,81519,81529,80769,760,61,4,4,13,2302,2302,2298,2298
Santa Cruz,17,2022-04-11,328,328,321,7,10999,11000,10759,241,7,1,1,0,260,260,259,259
Shasta,17,2022-04-11,18,18,18,0,3123,3123,3036,87,2,1,1,1,560,560,559,559
Siskiyou,17,2022-04-11,1,1,1,0,340,340,332,8,0,0,0,0,83,83,83,83
Solano,17,2022-04-11,249,249,243,6,9418,9418,9175,243,16,0,0,1,449,449,449,449
Sonoma,17,2022-04-11,416,416,406,10,10686,10686,10416,270,8,1,1,0,491,491,490,490
Stanislaus,17,2022-04-11,124,124,119,5,7639,7639,7338,301,22,1,1,1,1691,1691,1690,1690
Sutter,17,2022-04-11,20,20,19,1,1237,1237,1204,33,0,1,1,0,225,225,224,224
Tehama,17,2022-04-11,9,9,9,0,753,753,724,29,1,0,0,0,207,207,207,207
Trinity,17,2022-04-11,0,0,0,0,77,77,74,3,0,0,0,0,20,20,20,20
Tulare,17,2022-04-11,58,58,56,2,7843,7843,7526,317,11,3,3,0,1495,1495,1492,1492
Tuolumne,17,2022-04-11,22,22,21,1,1062,1062,1027,35,1,0,0,0,183,183,183,183
Ventura,17,2022-04-11,323,323,317,6,17587,17587,17274,313,16,2,2,2,1502,1502,1500,1500
Yolo,17,2022-04-11,130,130,127,3,18073,18073,17653,420,1,0,0,0,360,360,360,360
Yuba,17,2022-04-11,15,15,15,0,1019,1019,994,25,2,0,0,0,119,119,119,119
Alameda,18,2022-04-18,1781,1781,1752,29,54178,54184,53302,882,42,4,4,4,1872,1872,1868,1868
Amador,18,2022-04-18,12,12,12,0,1194,1194,1162,32,2,0,0,0,86,86,86,86
Butte,18,2022-04-18,47,47,46,1,2267,2267,2237,30,5,2,2,0,431,431,429,429
Calaveras,18,2022-04-18,16,16,16,0,579,579,566,13,0,1,1,0,120,120,119,119
Colusa,18,2022-04-18,3,3,3,0,157,157,154,3,0,0,0,0,21,21,21,21
Contra Costa,18,2022-04-18,1050,1050,1022,28,24755,24759,24090,669,26,1,1,5,1303,1303,1302,1302
Del Norte,18,2022-04-18,13,13,13,0,1010,1010,989,21,0,0,0,0,49,49,49,49
El Dorado,18,2022-04-18,66,66,65,1,2455,2455,2400,55,0,0,0,0,214,214,214,214
Fresno,18,2022-04-18,247,247,241,6,13859,13859,13508,351,42,4,4,5,2764,2764,2760,2760
Glenn,18,2022-04-18,4,4,4,0,278,278,272,6,0,0,0,0,53,53,53,53
Humboldt,18,2022-04-18,107,107,105,2,2052,2052,2009,43,4,1,1,2,147,147,146,146
Imperial,18,2022-04-18,49,49,48,1,3207,3207,3133,74,2,0,0,1,945,945,945,945
Inyo,18,2022-04-18,2,2,2,0,164,164,161,3,0,0,0,0,56,56,56,56
Kern,18,2022-04-18,150,150,147,3,13634,13634,13377,257,9,1,1,5,2344,2344,2343,2343
Kings,18,2022-04-18,44,44,43,1,3581,3581,3499,82,3,1,1,1,449,449,448,448
Lake,18,2022-04-18,16,16,16,0,782,782,762,20,2,1,1,1,140,140,139,139
Lassen,18,2022-04-18,1,1,1,0,1340,1340,1316,24,0,0,0,0,62,62,62,62
Los Angeles,18,2022-04-18,8319,8319,8266,53,469201,469263,466291,2972,200,37,37,26,31878,31878,31841,31841
Madera,18,2022-04-18,23,23,22,1,2521,2521,2456,65,2,0,0,2,370,370,370,370
Marin,18,2022-04-18,322,322,314,8,5992,5992,5842,150,6,0,0,0,295,295,295,295
Mariposa,18,2022-04-18,18,18,18,0,248,248,241,7,0,0,0,0,28,28,28,28
Mendocino,18,2022-04-18,53,53,51,2,1285,1285,1241,44,0,1,1,0,125,125,124,124
Merced,18,2022-04-18,65,65,64,1,3047,3047,2987,60,3,2,2,0,822,822,820,820
Modoc,18,2022-04-18,1,1,1,0,40,40,39,1,0,0,0,0,7,7,7,7
Mono,18,2022-04-18,9,9,9,0,122,122,117,5,0,0,0,0,6,6,6,6
Monterey,18,2022-04-18,157,157,151,6,6522,6522,6263,259,2,1,1,0,731,731,730,730
Napa,18,2022-04-18,164,164,161,3,2869,2869,2820,49,1,0,0,0,143,143,143,143
Nevada,18,2022-04-18,41,41,40,1,1260,1260,1228,32,1,0,0,0,131,131,131,131
Orange,18,2022-04-18,1449,1449,1427,22,79776,79786,78578,1208,50,6,6,10,7118,7118,7112,7112
Placer,18,2022-04-18,161,161,157,4,4800,4800,4668,132,30,0,0,3,627,627,627,627
Plumas,18,2022-04-18,6,6,6,0,225,225,219,6,0,0,0,0,13,13,13,13
Riverside,18,2022-04-18,937,937,918,19,36722,36727,35987,740,36,7,7,7,6460,6460,6453,6453
Sacramento,18,2022-04-18,716,716,701,15,27855,27860,27259,601,47,9,9,8,3065,3065,3056,3056
San Benito,18,2022-04-18,24,24,24,0,1170,1170,1149,21,0,0,0,0,94,94,94,94
San Bernardino,18,2022-04-18,1058,1058,1041,17,40086,40091,39437,654,35,7,7,8,7817,7817,7810,7810
San Diego,18,2022-04-18,2047,2047,2033,14,67090,67099,66641,458,78,9,9,17,5351,5351,5342,5342
San Francisco,18,2022-04-18,1440,1440,1378,62,30566,30571,29234,1337,27,2,2,2,874,874,872,872
San Joaquin,18,2022-04-18,248,248,242,6,14729,14729,14379,350,8,1,1,4,2250,2250,2249,2249
San Luis Obispo,18,2022-04-18,180,180,177,3,4959,4959,4868,91,2,2,2,0,481,481,479,479
San Mateo,18,2022-04-18,1155,1155,1138,17,30636,30641,30177,464,15,2,2,2,707,707,705,705
Santa Barbara,18,2022-04-18,300,300,294,6,14686,14686,14380,306,8,0,0,0,691,691,691,691
Santa Clara,18,2022-04-18,2238,2238,2222,16,71272,71281,70760,521,67,4,4,16,2306,2306,2302,2302
Santa Cruz,18,2022-04-18,438,438,430,8,12234,12235,12020,215,3,0,0,1,260,260,260,260
Shasta,18,2022-04-18,32,32,31,1,2849,2849,2787,62,2,1,1,2,561,561,560,560
Siskiyou,18,2022-04-18,8,8,8,0,318,318,312,6,0,0,0,0,83,83,83,83
Solano,18,2022-04-18,254,254,249,5,9328,9328,9139,189,6,1,1,1,450,450,449,449
Sonoma,18,2022-04-18,502,502,492,10,11184,11184,10961,223,16,1,1,4,492,492,491,491
Stanislaus,18,2022-04-18,162,162,157,5,7666,7666,7428,238,15,0,0,3,1691,1691,1691,1691
Sutter,18,2022-04-18,24,24,24,0,1173,1173,1149,24,0,0,0,0,225,225,225,225
Tehama,18,2022-04-18,7,7,7,0,685,685,664,21,1,0,0,0,207,207,207,207
Trinity,18,2022-04-18,1,1,1,0,72,72,70,2,0,0,0,0,20,20,20,20
Tulare,18,2022-04-18,79,79,77,2,6661,6661,6451,210,13,0,0,0,1495,1495,1495,1495
Tuolumne,18,2022-04-18,26,26,25,1,1025,1025,999,26,1,0,0,0,183,183,183,183
Ventura,18,2022-04-18,367,367,362,5,16412,16413,16186,227,8,3,3,0,1505,1505,1502,1502
Yolo,18,2022-04-18,217,217,213,4,17914,17914,17585,329,2,1,1,0,361,361,360,360
Yuba,18,2022-04-18,28,28,27,1,996,996,977,19,1,0,0,1,119,119,119,119
Alameda,19,2022-04-25,2539,2539,2507,32,60892,60901,60134,767,44,6,6,4,1878,1878,1872,1872
Amador,19,2022-04-25,26,26,25,1,1316,1316,1289,27,0,0,0,0,86,86,86,86
Butte,19,2022-04-25,66,66,65,1,2596,2596,2569,27,5,1,1,1,432,432,431,431
Calaveras,19,2022-04-25,34,34,33,1,688,688,676,12,0,0,0,0,120,120,120,120
Colusa,19,2022-04-25,3,3,3,0,199,199,196,3,0,0,0,0,21,21,21,21
Contra Costa,19,2022-04-25,1509,1509,1477,32,27266,27271,26697,574,25,3,3,3,1306,1306,1303,1303
Del Norte,19,2022-04-25,25,25,25,0,1104,1104,1086,18,0,0,0,0,49,49,49,49
El Dorado,19,2022-04-25,103,103,101,2,2648,2648,2601,47,1,0,0,0,214,214,214,214
Fresno,19,2022-04-25,336,336,329,7,15801,15802,15487,315,34,3,3,2,2767,2767,2764,2764
Glenn,19,2022-04-25,4,4,4,0,287,287,282,5,0,0,0,0,53,53,53,53
Humboldt,19,2022-04-25,168,168,165,3,2853,2853,2806,47,2,0,0,2,147,147,147,147
Imperial,19,2022-04-25,65,65,64,1,3505,3505,3442,63,4,0,0,1,945,945,945,945
Inyo,19,2022-04-25,7,7,7,0,194,194,191,3,0,0,0,0,56,56,56,56
Kern,19,2022-04-25,251,251,247,4,18299,18301,18030,271,14,2,2,4,2346,2346,2344,2344
Kings,19,2022-04-25,54,54,53,1,4517,4517,4436,81,3,0,0,1,449,449,449,449
Lake,19,2022-04-25,21,21,21,0,888,888,870,18,0,0,0,0,140,140,140,140
Lassen,19,2022-04-25,1,1,1,0,1556,1556,1534,22,0,0,0,0,62,62,62,62
Los Angeles,19,2022-04-25,11371,11371,11314,57,884900,885032,880546,4486,207,30,30,25,31908,31908,31878,31878
Madera,19,2022-04-25,44,44,43,1,2916,2916,2857,59,2,0,0,0,370,370,370,370
Marin,19,2022-04-25,329,329,323,6,6440,6440,6314,126,7,0,0,0,295,295,295,295
Mariposa,19,2022-04-25,9,9,9,0,205,205,201,4,0,0,0,0,28,28,28,28
Mendocino,19,2022-04-25,55,55,54,1,1254,1254,1220,34,0,1,1,0,126,126,125,125
Merced,19,2022-04-25,99,99,98,1,3030,3030,2984,46,5,0,0,0,822,822,822,822
Modoc,19,2022-04-25,1,1,1,0,41,41,40,1,0,0,0,0,7,7,7,7
Mono,19,2022-04-25,4,4,4,0,94,94,91,3,0,0,0,0,6,6,6,6
Monterey,19,2022-04-25,324,324,314,10,8008,8008,7758,250,5,1,1,0,732,732,731,731
Napa,19,2022-04-25,208,208,205,3,3391,3391,3345,46,2,0,0,0,143,143,143,143
Nevada,19,2022-04-25,52,52,51,1,1399,1399,1371,28,1,0,0,1,131,131,131,131
Orange,19,2022-04-25,1983,1983,1960,23,86635,86648,85625,1023,53,7,7,13,7125,7125,7118,7118
Placer,19,2022-04-25,239,239,234,5,6091,6091,5959,132,18,0,0,4,627,627,627,627
Plumas,19,2022-04-25,2,2,2,0,228,228,223,5,0,0,0,0,13,13,13,13
Riverside,19,2022-04-25,1304,1304,1284,20,40561,40566,39926,640,33,4,4,5,6464,6464,6460,6460
Sacramento,19,2022-04-25,1026,1026,1009,17,31870,31875,31336,539,44,4,4,4,3069,3069,3065,3065
San Benito,19,2022-04-25,34,34,34,0,1118,1118,1102,16,0,0,0,0,94,94,94,94
San Bernardino,19,2022-04-25,1294,1294,1278,16,42981,42987,42439,548,21,10,10,7,7827,7827,7817,7817
San Diego,19,2022-04-25,3013,3013,2997,16,74327,74340,73944,396,86,5,5,10,5356,5356,5351,5351
San Francisco,19,2022-04-25,2001,2001,1933,68,32544,32549,31432,1117,23,1,1,3,875,875,874,874
San Joaquin,19,2022-04-25,388,388,381,7,15463,15465,15176,289,12,0,0,1,2250,2250,2250,2250
San Luis Obispo,19,2022-04-25,209,209,206,3,5036,5036,4963,73,6,0,0,0,481,481,481,481
San Mateo,19,2022-04-25,1541,1541,1523,18,32933,32938,32549,389,14,1,1,3,708,708,707,707
Santa Barbara,19,2022-04-25,370,370,364,6,15227,15228,14981,247,7,2,2,1,693,693,691,691
Santa Clara,19,2022-04-25,3142,3142,3124,18,77136,77149,76715,434,73,4,4,9,2310,2310,2306,2306
Santa Cruz,19,2022-04-25,474,474,468,6,20467,20471,20189,282,4,1,1,0,261,261,260,260
Shasta,19,2022-04-25,49,49,48,1,3318,3318,3262,56,3,0,0,1,561,561,561,561
Siskiyou,19,2022-04-25,7,7,7,0,322,322,318,4,0,0,0,0,83,83,83,83
Solano,19,2022-04-25,479,479,471,8,10651,10651,10483,168,11,0,0,2,450,450,450,450
Sonoma,19,2022-04-25,674,674,664,10,12066,12066,11878,188,19,0,0,2,492,492,492,492
Stanislaus,19,2022-04-25,241,241,235,6,7899,7899,7707,192,25,4,4,0,1695,1695,1691,1691
Sutter,19,2022-04-25,39,39,38,1,1399,1399,1376,23,0,1,1,0,226,226,225,225
Tehama,19,2022-04-25,17,17,17,0,711,711,694,17,1,0,0,0,207,207,207,207
Trinity,19,2022-04-25,1,1,1,0,72,72,70,2,0,0,0,0,20,20,20,20
Tulare,19,2022-04-25,100,100,98,2,6924,6924,6752,172,11,1,1,0,1496,1496,1495,1495
Tuolumne,19,2022-04-25,43,43,42,1,1124,1124,1101,23,2,0,0,0,183,183,183,183
Ventura,19,2022-04-25,604,604,597,7,18901,18902,18697,205,10,1,1,3,1506,1506,1505,1505
Yolo,19,2022-04-25,272,272,268,4,19381,19384,19106,278,1,0,0,0,361,361,361,361
Yuba,19,2022-04-25,31,31,31,0,1106,1106,1089,17,0,0,0,0,119,119,119,119
Alameda,20,2022-05-02,3378,3378,3345,33,68020,68033,67356,677,42,1,1,5,1879,1879,1878,1878
Amador,20,2022-05-02,19,19,19,0,1335,1335,1313,22,0,0,0,0,86,86,86,86
Butte,20,2022-05-02,91,91,90,1,2385,2385,2366,19,4,2,2,0,434,434,432,432
Calaveras,20,2022-05-02,23,23,23,0,727,727,717,10,0,0,0,0,120,120,120,120
Colusa,20,2022-05-02,2,2,2,0,203,203,201,2,0,0,0,0,21,21,21,21
Contra Costa,20,2022-05-02,1878,1878,1847,31,29266,29271,28788,483,40,2,2,5,1308,1308,1306,1306
Del Norte,20,2022-05-02,42,42,41,1,1202,1202,1187,15,1,0,0,0,49,49,49,49
El Dorado,20,2022-05-02,140,140,138,2,2756,2756,2718,38,1,1,1,0,215,215,214,214
Fresno,20,2022-05-02,503,503,495,8,16612,16616,16357,259,42,3,3,4,2770,2770,2767,2767
Glenn,20,2022-05-02,4,4,4,0,252,252,249,3,0,0,0,0,53,53,53,53
Humboldt,20,2022-05-02,269,269,266,3,2941,2941,2903,38,6,0,0,2,147,147,147,147
Imperial,20,2022-05-02,123,123,121,2,3631,3631,3580,51,1,0,0,1,945,945,945,945
Inyo,20,2022-05-02,2,2,2,0,179,179,177,2,0,0,0,0,56,56,56,56
Kern,20,2022-05-02,294,294,291,3,17931,17935,17728,207,10,0,0,5,2346,2346,2346,2346
Kings,20,2022-05-02,59,59,58,1,4847,4847,4779,68,3,0,0,1,449,449,449,449
Lake,20,2022-05-02,29,29,29,0,1003,1003,987,16,1,0,0,0,140,140,140,140
Lassen,20,2022-05-02,8,8,8,0,1608,1608,1590,18,0,0,0,0,62,62,62,62
Los Angeles,20,2022-05-02,14813,14814,14756,58,917597,917779,914136,3643,214,24,24,22,31932,31932,31908,31908
Madera,20,2022-05-02,76,76,75,1,3307,3307,3255,52,5,0,0,0,370,370,370,370
Marin,20,2022-05-02,427,427,421,6,6544,6544,6444,100,10,0,0,0,295,295,295,295
Mariposa,20,2022-05-02,7,7,7,0,244,244,240,4,0,0,0,0,28,28,28,28
Mendocino,20,2022-05-02,60,60,59,1,1222,1222,1196,26,0,0,0,0,126,126,126,126
Merced,20,2022-05-02,131,131,129,2,3284,3284,3245,39,8,4,4,0,826,826,822,822
Modoc,20,2022-05-02,0,0,0,0,36,37,36,1,0,0,0,0,7,7,7,7
Mono,20,2022-05-02,6,6,6,0,106,106,103,3,0,0,0,0,6,6,6,6
Monterey,20,2022-05-02,355,355,346,9,8388,8388,8182,206,8,1,1,0,733,733,732,732
Napa,20,2022-05-02,229,229,227,2,3553,3553,3515,38,4,0,0,0,143,143,143,143
Nevada,20,2022-05-02,80,80,79,1,1535,1535,1511,24,2,0,0,0,131,131,131,131
Orange,20,2022-05-02,2656,2656,2632,24,87514,87532,86723,809,61,5,5,13,7130,7130,7125,7125
Placer,20,2022-05-02,306,306,301,5,6373,6373,6265,108,20,0,0,4,627,627,627,627
Plumas,20,2022-05-02,9,9,9,0,256,256,252,4,0,0,0,0,13,13,13,13
Riverside,20,2022-05-02,2051,2051,2026,25,42958,42967,42438,529,37,3,3,5,6467,6467,6464,6464
Sacramento,20,2022-05-02,1396,1396,1378,18,33656,33662,33218,444,43,5,5,9,3074,3074,3069,3069
San Benito,20,2022-05-02,50,50,49,1,1285,1285,1271,14,0,0,0,0,94,94,94,94
San Bernardino,20,2022-05-02,1490,1490,1475,15,43536,43544,43111,433,30,7,7,6,7834,7834,7827,7827
San Diego,20,2022-05-02,4122,4122,4105,17,72931,72945,72643,302,79,3,3,13,5359,5359,5356,5356
San Francisco,20,2022-05-02,2424,2424,2359,65,35539,35545,34586,959,39,3,3,13,878,878,875,875
San Joaquin,20,2022-05-02,545,545,537,8,15207,15209,14987,222,14,1,1,1,2251,2251,2250,2250
San Luis Obispo,20,2022-05-02,249,249,246,3,5109,5109,5051,58,5,2,2,0,483,483,481,481
San Mateo,20,2022-05-02,1821,1821,1804,17,35991,35997,35663,334,22,2,2,5,710,710,708,708
Santa Barbara,20,2022-05-02,440,440,435,5,15309,15312,15117,195,10,0,0,2,693,693,693,693
Santa Clara,20,2022-05-02,4358,4358,4339,19,96570,96589,96160,429,88,5,5,15,2315,2315,2310,2310
Santa Cruz,20,2022-05-02,678,678,671,7,22027,22031,21793,238,2,1,1,0,262,262,261,261
Shasta,20,2022-05-02,68,68,67,1,3451,3451,3405,46,7,0,0,1,561,561,561,561
Siskiyou,20,2022-05-02,9,9,9,0,329,329,326,3,0,0,0,0,83,83,83,83
Solano,20,2022-05-02,624,624,616,8,11785,11786,11640,146,20,0,0,2,450,450,450,450
Sonoma,20,2022-05-02,898,898,887,11,12794,12796,12641,155,16,1,1,4,493,493,492,492
Stanislaus,20,2022-05-02,269,269,264,5,8083,8083,7929,154,22,0,0,3,1695,1695,1695,1695
Sutter,20,2022-05-02,47,47,46,1,1263,1263,1247,16,0,1,1,0,227,227,226,226
Tehama,20,2022-05-02,17,17,17,0,700,700,687,13,0,0,0,0,207,207,207,207
Trinity,20,2022-05-02,1,1,1,0,84,84,82,2,0,0,0,0,20,20,20,20
Tulare,20,2022-05-02,163,163,160,3,7290,7290,7148,142,10,3,3,0,1499,1499,1496,1496
Tuolumne,20,2022-05-02,94,94,93,1,1298,1298,1278,20,5,0,0,0,183,183,183,183
Ventura,20,2022-05-02,744,744,738,6,19920,19925,19756,169,15,4,4,1,1510,1510,1506,1506
Yolo,20,2022-05-02,352,352,348,4,18790,18795,18584,211,1,1,1,0,362,362,361,361
Yuba,20,2022-05-02,46,46,45,1,1052,1052,1040,12,2,0,0,1,119,119,119,119
Alameda,21,2022-05-09,4151,4151,4119,32,71486,71504,70950,554,44,5,5,6,1884,1884,1879,1879
Amador,21,2022-05-09,25,25,25,0,1518,1518,1499,19,0,0,0,0,86,86,86,86
Butte,21,2022-05-09,115,115,114,1,2412,2412,2397,15,5,0,0,0,434,434,434,434
Calaveras,21,2022-05-09,33,33,33,0,689,689,681,8,1,0,0,0,120,120,120,120
Colusa,21,2022-05-09,3,3,3,0,215,215,213,2,0,0,0,0,21,21,21,21
Contra Costa,21,2022-05-09,2516,2516,2484,32,30524,30530,30135,395,48,4,4,12,1312,1312,1308,1308
Del Norte,21,2022-05-09,49,49,49,0,1358,1358,1344,14,0,0,0,0,49,49,49,49
El Dorado,21,2022-05-09,179,179,177,2,2889,2889,2858,31,3,0,0,1,215,215,215,215
Fresno,21,2022-05-09,746,746,737,9,17758,17763,17546,217,29,1,1,1,2771,2771,2770,2770
Glenn,21,2022-05-09,8,8,8,0,228,228,226,2,0,0,0,0,53,53,53,53
Humboldt,21,2022-05-09,273,273,270,3,3149,3149,3117,32,5,0,0,2,147,147,147,147
Imperial,21,2022-05-09,131,131,130,1,3816,3816,3774,42,0,0,0,1,945,945,945,945
Inyo,21,2022-05-09,26,26,26,0,236,236,234,2,0,0,0,0,56,56,56,56
Kern,21,2022-05-09,467,467,463,4,18698,18703,18534,169,18,2,2,2,2348,2348,2346,2346
Kings,21,2022-05-09,91,91,90,1,4936,4936,4882,54,1,0,0,1,449,449,449,449
Lake,21,2022-05-09,30,30,30,0,1029,1029,1016,13,1,0,0,0,140,140,140,140
Lassen,21,2022-05-09,7,7,7,0,1689,1689,1675,14,0,0,0,0,62,62,62,62
Los Angeles,21,2022-05-09,18429,18434,18378,56,926877,927106,924241,2865,225,29,29,27,31961,31961,31932,31932
Madera,21,2022-05-09,132,132,130,2,3725,3725,3679,46,3,0,0,0,370,370,370,370
Marin,21,2022-05-09,711,711,703,8,7781,7781,7688,93,12,0,0,0,295,295,295,295
Mariposa,21,2022-05-09,32,32,32,0,287,287,283,4,0,0,0,0,28,28,28,28
Mendocino,21,2022-05-09,92,92,91,1,1264,1264,1243,21,0,1,1,0,127,127,126,126
Merced,21,2022-05-09,198,198,196,2,3432,3432,3400,32,4,1,1,0,827,827,826,826
Modoc,21,2022-05-09,2,2,2,0,41,42,41,1,0,0,0,0,7,7,7,7
Mono,21,2022-05-09,9,9,9,0,113,113,111,2,0,0,0,0,6,6,6,6
Monterey,21,2022-05-09,440,440,432,8,9377,9378,9197,181,11,0,0,0,733,733,733,733
Napa,21,2022-05-09,234,234,232,2,3126,3126,3100,26,2,0,0,0,143,143,143,143
Nevada,21,2022-05-09,102,102,101,1,1655,1655,1635,20,5,0,0,0,131,131,131,131
Orange,21,2022-05-09,3536,3536,3511,25,91809,91832,91169,663,84,8,8,17,7138,7138,7130,7130
Placer,21,2022-05-09,537,537,530,7,6753,6753,6663,90,25,0,0,2,627,627,627,627
Plumas,21,2022-05-09,13,13,13,0,274,274,271,3,0,0,0,0,13,13,13,13
Riverside,21,2022-05-09,2403,2403,2380,23,45141,45154,44718,436,42,4,4,8,6471,6471,6467,6467
Sacramento,21,2022-05-09,2258,2258,2235,23,36131,36140,35766,374,62,4,4,10,3078,3078,3074,3074
San Benito,21,2022-05-09,74,74,73,1,1433,1433,1421,12,0,0,0,0,94,94,94,94
San Bernardino,21,2022-05-09,1938,1938,1923,15,46593,46606,46244,362,31,5,5,4,7839,7839,7834,7834
San Diego,21,2022-05-09,5222,5222,5205,17,87128,87149,86866,283,98,2,2,11,5361,5361,5359,5359
San Francisco,21,2022-05-09,3050,3050,2986,64,38188,38199,37391,808,52,6,6,9,884,884,878,878
San Joaquin,21,2022-05-09,772,772,763,9,16049,16054,15871,183,11,1,1,3,2252,2252,2251,2251
San Luis Obispo,21,2022-05-09,290,290,287,3,5221,5221,5175,46,0,0,0,0,483,483,483,483
San Mateo,21,2022-05-09,2315,2315,2299,16,37695,37704,37431,273,26,3,3,1,713,713,710,710
Santa Barbara,21,2022-05-09,638,638,632,6,15589,15594,15439,155,10,0,0,3,693,693,693,693
Santa Clara,21,2022-05-09,5623,5623,5604,19,106180,106206,105838,368,87,3,3,23,2318,2318,2315,2315
Santa Cruz,21,2022-05-09,729,729,723,6,23980,23986,23784,202,2,0,0,0,262,262,262,262
Shasta,21,2022-05-09,107,107,106,1,3301,3301,3267,34,7,0,0,0,561,561,561,561
Siskiyou,21,2022-05-09,16,16,16,0,285,285,283,2,0,0,0,0,83,83,83,83
Solano,21,2022-05-09,920,920,911,9,12318,12321,12201,120,20,0,0,1,450,450,450,450
Sonoma,21,2022-05-09,1179,1179,1168,11,13978,13981,13848,133,18,1,1,2,494,494,493,493
Stanislaus,21,2022-05-09,460,460,453,7,8942,8943,8810,133,27,0,0,2,1695,1695,1695,1695
Sutter,21,2022-05-09,61,61,60,1,1565,1565,1549,16,0,0,0,0,227,227,227,227
Tehama,21,2022-05-09,28,28,28,0,692,692,682,10,1,0,0,0,207,207,207,207
Trinity,21,2022-05-09,4,4,4,0,69,69,68,1,0,0,0,0,20,20,20,20
Tulare,21,2022-05-09,187,187,184,3,7639,7640,7524,116,11,1,1,1,1500,1500,1499,1499
Tuolumne,21,2022-05-09,71,71,70,1,1429,1429,1412,17,1,2,2,0,185,185,183,183
Ventura,21,2022-05-09,1151,1151,1143,8,20949,20954,20815,139,15,1,1,2,1511,1511,1510,1510
Yolo,21,2022-05-09,493,493,489,4,19655,19660,19488,172,1,0,0,1,362,362,362,362
Yuba,21,2022-05-09,77,77,76,1,1241,1241,1229,12,2,0,0,0,119,119,119,119
Alameda,22,2022-05-16,4994,4994,4964,30,75029,75053,74599,454,73,7,7,6,1891,1891,1884,1884
Amador,22,2022-05-16,54,54,53,1,1672,1672,1655,17,0,0,0,0,86,86,86,86
Butte,22,2022-05-16,207,207,206,1,2664,2664,2651,13,7,2,2,0,436,436,434,434
Calaveras,22,2022-05-16,43,43,43,0,765,765,758,7,0,1,1,1,121,121,120,120
Colusa,22,2022-05-16,7,7,7,0,217,217,215,2,0,0,0,0,21,21,21,21
Contra Costa,22,2022-05-16,3491,3491,3456,35,33515,33527,33188,339,50,5,5,7,1317,1317,1312,1312
Del Norte,22,2022-05-16,175,175,174,1,1859,1859,1844,15,0,0,0,0,49,49,49,49
El Dorado,22,2022-05-16,266,266,264,2,3040,3040,3014,26,5,0,0,1,215,215,215,215
Fresno,22,2022-05-16,1139,1139,1128,11,18941,18946,18766,180,46,2,2,6,2773,2773,2771,2771
Glenn,22,2022-05-16,15,15,15,0,259,259,257,2,0,0,0,0,53,53,53,53
Humboldt,22,2022-05-16,274,274,272,2,3253,3253,3227,26,9,1,1,2,148,148,147,147
Imperial,22,2022-05-16,207,207,205,2,4261,4261,4224,37,1,0,0,1,945,945,945,945
Inyo,22,2022-05-16,19,19,19,0,228,228,226,2,1,0,0,0,56,56,56,56
Kern,22,2022-05-16,687,687,682,5,19978,19984,19843,141,22,3,3,3,2351,2351,2348,2348
Kings,22,2022-05-16,220,220,218,2,5418,5418,5372,46,0,1,1,0,450,450,449,449
Lake,22,2022-05-16,75,75,74,1,1118,1118,1107,11,2,0,0,0,140,140,140,140
Lassen,22,2022-05-16,21,21,21,0,1704,1704,1693,11,1,0,0,0,62,62,62,62
Los Angeles,22,2022-05-16,21421,21429,21378,51,938075,938372,936110,2262,283,38,38,44,31999,31999,31961,31961
Madera,22,2022-05-16,199,199,197,2,3632,3632,3597,35,2,0,0,0,370,370,370,370
Marin,22,2022-05-16,816,816,808,8,8391,8392,8314,78,12,0,0,0,295,295,295,295
Mariposa,22,2022-05-16,23,23,23,0,340,340,336,4,0,0,0,0,28,28,28,28
Mendocino,22,2022-05-16,99,99,98,1,1326,1326,1309,17,0,1,1,1,128,128,127,127
Merced,22,2022-05-16,314,314,312,2,4010,4010,3981,29,8,1,1,1,828,828,827,827
Modoc,22,2022-05-16,4,4,4,0,43,44,43,1,0,0,0,0,7,7,7,7
Mono,22,2022-05-16,11,11,11,0,112,112,110,2,0,0,0,0,6,6,6,6
Monterey,22,2022-05-16,509,509,501,8,9600,9602,9458,144,6,1,1,0,734,734,733,733
Napa,22,2022-05-16,299,299,297,2,3741,3741,3717,24,3,0,0,0,143,143,143,143
Nevada,22,2022-05-16,146,146,145,1,1834,1834,1817,17,2,0,0,0,131,131,131,131
Orange,22,2022-05-16,4574,4574,4549,25,94713,94742,94209,533,74,7,7,15,7145,7145,7138,7138
Placer,22,2022-05-16,742,742,734,8,7777,7778,7697,81,43,2,2,3,629,629,627,627
Plumas,22,2022-05-16,48,48,48,0,242,242,240,2,1,0,0,0,13,13,13,13
Riverside,22,2022-05-16,3345,3345,3320,25,47986,48001,47640,361,65,1,1,6,6472,6472,6471,6471
Sacramento,22,2022-05-16,3141,3141,3116,25,39842,39855,39533,322,89,8,8,12,3086,3086,3078,3078
San Benito,22,2022-05-16,110,110,109,1,1529,1529,1519,10,1,0,0,0,94,94,94,94
San Bernardino,22,2022-05-16,2473,2473,2458,15,49171,49188,48890,298,44,8,8,5,7847,7847,7839,7839
San Diego,22,2022-05-16,6666,6667,6650,17,94785,94816,94576,240,91,6,6,25,5367,5367,5361,5361
San Francisco,22,2022-05-16,3413,3413,3357,56,39358,39371,38718,653,68,5,5,8,889,889,884,884
San Joaquin,22,2022-05-16,1201,1201,1190,11,19000,19006,18837,169,16,1,1,1,2253,2253,2252,2252
San Luis Obispo,22,2022-05-16,426,426,423,3,6058,6059,6017,42,3,0,0,0,483,483,483,483
San Mateo,22,2022-05-16,2776,2776,2761,15,39916,39929,39704,225,39,1,1,1,714,714,713,713
Santa Barbara,22,2022-05-16,913,913,906,7,17042,17047,16915,132,13,0,0,2,693,693,693,693
Santa Clara,22,2022-05-16,7205,7206,7187,19,113214,113251,112946,305,111,9,9,15,2327,2327,2318,2318
Santa Cruz,22,2022-05-16,808,808,803,5,20748,20754,20614,140,5,0,0,0,262,262,262,262
Shasta,22,2022-05-16,126,126,125,1,3812,3812,3781,31,6,0,0,1,561,561,561,561
Siskiyou,22,2022-05-16,19,19,19,0,372,372,370,2,0,0,0,0,83,83,83,83
Solano,22,2022-05-16,1279,1279,1269,10,14199,14204,14097,107,29,0,0,2,450,450,450,450
Sonoma,22,2022-05-16,1573,1573,1562,11,15544,15549,15434,115,28,0,0,4,494,494,494,494
Stanislaus,22,2022-05-16,749,749,740,9,9951,9953,9837,116,33,2,2,5,1697,1697,1695,1695
Sutter,22,2022-05-16,109,109,108,1,1828,1828,1814,14,0,0,0,0,227,227,227,227
Tehama,22,2022-05-16,38,38,38,0,840,840,831,9,0,1,1,1,208,208,207,207
Trinity,22,2022-05-16,5,5,5,0,69,69,68,1,0,0,0,0,20,20,20,20
Tulare,22,2022-05-16,398,398,393,5,8323,8324,8225,99,14,1,1,0,1501,1501,1500,1500
Tuolumne,22,2022-05-16,139,139,138,1,1448,1448,1434,14,1,1,1,0,186,186,185,185
Ventura,22,2022-05-16,1552,1552,1544,8,23859,23865,23742,123,34,2,2,2,1513,1513,1511,1511
Yolo,22,2022-05-16,688,688,683,5,22151,22156,22004,152,0,0,0,1,362,362,362,362
Yuba,22,2022-05-16,119,119,118,1,1335,1335,1325,10,4,0,0,0,119,119,119,119
Alameda,23,2022-05-23,5602,5603,5577,26,77860,77894,77526,368,76,4,4,4,1895,1895,1891,1891
Amador,23,2022-05-23,80,80,79,1,1441,1441,1430,11,0,0,0,0,86,86,86,86
Butte,23,2022-05-23,284,284,283,1,2766,2766,2755,11,5,1,1,1,437,437,436,436
Calaveras,23,2022-05-23,52,52,52,0,744,744,739,5,0,1,1,0,122,122,121,121
Colusa,23,2022-05-23,7,7,7,0,232,232,231,1,0,0,0,0,21,21,21,21
Contra Costa,23,2022-05-23,3830,3830,3800,30,35374,35389,35110,279,71,10,10,7,1327,1327,1317,1317
Del Norte,23,2022-05-23,67,67,67,0,1346,1346,1338,8,0,1,1,0,50,50,49,49
El Dorado,23,2022-05-23,359,359,357,2,3421,3421,3398,23,6,2,2,0,217,217,215,215
Fresno,23,2022-05-23,1651,1651,1639,12,21268,21276,21118,158,63,2,2,8,2775,2775,2773,2773
Glenn,23,2022-05-23,26,26,26,0,273,273,271,2,0,0,0,0,53,53,53,53
Humboldt,23,2022-05-23,245,245,244,1,2911,2911,2893,18,14,1,1,3,149,149,148,148
Imperial,23,2022-05-23,343,343,341,2,4735,4736,4704,32,2,0,0,1,945,945,945,945
Inyo,23,2022-05-23,27,27,27,0,221,221,220,1,0,0,0,0,56,56,56,56
Kern,23,2022-05-23,1006,1006,1001,5,21275,21284,21167,117,34,0,0,7,2351,2351,2351,2351
Kings,23,2022-05-23,250,250,248,2,5644,5645,5607,38,1,0,0,0,450,450,450,450
Lake,23,2022-05-23,96,96,95,1,1238,1238,1228,10,1,0,0,1,140,140,140,140
Lassen,23,2022-05-23,41,41,41,0,1763,1763,1754,9,0,0,0,0,62,62,62,62
Los Angeles,23,2022-05-23,27748,27761,27709,52,946453,946855,945077,1778,366,31,31,53,32030,32030,31999,31999
Madera,23,2022-05-23,216,216,214,2,3765,3765,3737,28,1,0,0,2,370,370,370,370
Marin,23,2022-05-23,798,798,792,6,8785,8790,8726,64,15,0,0,1,295,295,295,295
Mariposa,23,2022-05-23,32,32,32,0,340,340,337,3,0,0,0,0,28,28,28,28
Mendocino,23,2022-05-23,150,150,149,1,1659,1659,1642,17,3,1,1,1,129,129,128,128
Merced,23,2022-05-23,409,409,407,2,4201,4201,4177,24,4,0,0,0,828,828,828,828
Modoc,23,2022-05-23,2,2,2,0,40,41,40,1,0,0,0,0,7,7,7,7
Mono,23,2022-05-23,14,14,14,0,163,163,161,2,0,0,0,0,6,6,6,6
Monterey,23,2022-05-23,701,701,693,8,9613,9618,9505,113,17,1,1,1,735,735,734,734
Napa,23,2022-05-23,339,339,337,2,3951,3951,3931,20,5,0,0,0,143,143,143,143
Nevada,23,2022-05-23,150,150,149,1,1904,1904,1890,14,2,0,0,0,131,131,131,131
Orange,23,2022-05-23,5644,5645,5621,24,94958,94998,94580,418,111,11,11,20,7156,7156,7145,7145
Placer,23,2022-05-23,888,888,881,7,7838,7842,7778,64,49,2,2,4,631,631,629,629
Plumas,23,2022-05-23,46,46,46,0,279,279,277,2,0,0,0,0,13,13,13,13
Riverside,23,2022-05-23,4455,4455,4429,26,52425,52448,52141,307,73,6,6,10,6478,6478,6472,6472
Sacramento,23,2022-05-23,3899,3899,3875,24,41057,41075,40815,260,122,7,7,10,3093,3093,3086,3086
San Benito,23,2022-05-23,168,168,167,1,1668,1668,1659,9,0,0,0,0,94,94,94,94
San Bernardino,23,2022-05-23,3325,3325,3309,16,50646,50667,50427,240,53,3,3,10,7850,7850,7847,7847
San Diego,23,2022-05-23,8839,8844,8827,17,103289,103332,103128,204,138,4,4,20,5371,5371,5367,5367
San Francisco,23,2022-05-23,3605,3605,3558,47,41637,41655,41115,540,85,6,6,9,895,895,889,889
San Joaquin,23,2022-05-23,1548,1548,1537,11,20953,20962,20816,146,20,3,3,7,2256,2256,2253,2253
San Luis Obispo,23,2022-05-23,669,669,665,4,7272,7275,7236,39,10,3,3,0,486,486,483,483
San Mateo,23,2022-05-23,3156,3156,3142,14,40830,40848,40668,180,35,0,0,0,714,714,714,714
Santa Barbara,23,2022-05-23,1064,1064,1058,6,17776,17782,17674,108,20,0,0,3,693,693,693,693
Santa Clara,23,2022-05-23,7829,7831,7815,16,111312,111359,111125,234,126,7,7,18,2334,2334,2327,2327
Santa Cruz,23,2022-05-23,505,505,502,3,7816,7820,7780,40,16,0,0,0,262,262,262,262
Shasta,23,2022-05-23,195,195,194,1,3606,3606,3583,23,4,1,1,3,562,562,561,561
Siskiyou,23,2022-05-23,29,29,29,0,364,364,362,2,1,0,0,0,83,83,83,83
Solano,23,2022-05-23,1513,1513,1504,9,14915,14921,14833,88,24,1,1,3,451,451,450,450
Sonoma,23,2022-05-23,1487,1487,1478,9,16336,16341,16246,95,34,2,2,3,496,496,494,494
Stanislaus,23,2022-05-23,873,873,865,8,10701,10706,10608,98,37,2,2,3,1699,1699,1697,1697
Sutter,23,2022-05-23,141,141,140,1,1912,1912,1901,11,0,1,1,0,228,228,227,227
Tehama,23,2022-05-23,50,50,50,0,812,812,805,7,1,0,0,1,208,208,208,208
Trinity,23,2022-05-23,3,3,3,0,90,90,89,1,0,0,0,0,20,20,20,20
Tulare,23,2022-05-23,561,561,556,5,9075,9080,8996,84,26,0,0,0,1501,1501,1501,1501
Tuolumne,23,2022-05-23,136,136,135,1,1576,1576,1564,12,0,1,1,0,187,187,186,186
Ventura,23,2022-05-23,1918,1918,1910,8,24021,24033,23936,97,36,1,1,1,1514,1514,1513,1513
Yolo,23,2022-05-23,731,731,727,4,22657,22668,22547,121,1,1,1,1,363,363,362,362
Yuba,23,2022-05-23,151,151,150,1,1453,1453,1445,8,6,0,0,1,119,119,119,119
Alameda,24,2022-05-30,4912,4912,4894,18,60794,60826,60597,229,95,4,4,7,1899,1899,1895,1895
Amador,24,2022-05-30,89,89,88,1,1191,1191,1184,7,0,1,1,0,87,87,86,86
Butte,24,2022-05-30,276,276,275,1,2708,2708,2700,8,20,0,0,1,437,437,437,437
Calaveras,24,2022-05-30,54,54,54,0,617,617,614,3,0,0,0,0,122,122,122,122
Colusa,24,2022-05-30,13,13,13,0,170,170,169,1,0,0,0,0,21,21,21,21
Contra Costa,24,2022-05-30,3322,3322,3301,21,28984,28999,28817,182,65,7,7,9,1334,1334,1327,1327
Del Norte,24,2022-05-30,36,36,36,0,975,975,970,5,2,1,1,0,51,51,50,50
El Dorado,24,2022-05-30,332,332,330,2,2940,2940,2924,16,6,2,2,2,219,219,217,217
Fresno,24,2022-05-30,1669,1669,1659,10,19451,19462,19347,115,71,6,6,7,2781,2781,2775,2775
Glenn,24,2022-05-30,27,27,27,0,290,290,289,1,2,0,0,0,53,53,53,53
Humboldt,24,2022-05-30,181,181,180,1,2296,2296,2285,11,10,0,0,5,149,149,149,149
Imperial,24,2022-05-30,332,332,330,2,4134,4134,4112,22,2,1,1,2,946,946,945,945
Inyo,24,2022-05-30,18,18,18,0,151,151,150,1,0,0,0,0,56,56,56,56
Kern,24,2022-05-30,1078,1078,1073,5,17986,17996,17917,79,36,0,0,6,2351,2351,2351,2351
Kings,24,2022-05-30,292,292,290,2,4664,4665,4640,25,2,0,0,1,450,450,450,450
Lake,24,2022-05-30,89,89,88,1,994,994,988,6,1,0,0,0,140,140,140,140
Lassen,24,2022-05-30,50,50,50,0,1615,1615,1608,7,1,0,0,0,62,62,62,62
Los Angeles,24,2022-05-30,26044,26057,26018,39,746788,747172,746046,1126,425,47,47,54,32077,32077,32030,32030
Madera,24,2022-05-30,235,235,234,1,3314,3314,3294,20,4,0,0,1,370,370,370,370
Marin,24,2022-05-30,651,651,647,4,7154,7158,7116,42,16,3,3,1,298,298,295,295
Mariposa,24,2022-05-30,39,39,39,0,303,303,301,2,0,0,0,0,28,28,28,28
Mendocino,24,2022-05-30,137,137,136,1,1264,1264,1254,10,4,0,0,1,129,129,129,129
Merced,24,2022-05-30,365,365,363,2,3406,3406,3391,15,6,0,0,2,828,828,828,828
Modoc,24,2022-05-30,4,4,4,0,38,39,38,1,0,0,0,0,7,7,7,7
Mono,24,2022-05-30,6,6,6,0,81,81,80,1,0,0,0,0,6,6,6,6
Monterey,24,2022-05-30,526,526,521,5,7149,7153,7086,67,19,1,1,1,736,736,735,735
Napa,24,2022-05-30,328,328,327,1,3207,3207,3194,13,4,0,0,0,143,143,143,143
Nevada,24,2022-05-30,181,181,180,1,1595,1595,1586,9,3,2,2,1,133,133,131,131
Orange,24,2022-05-30,5667,5670,5651,19,82310,82351,82063,288,122,12,12,18,7168,7168,7156,7156
Placer,24,2022-05-30,738,738,733,5,6135,6139,6099,40,52,0,0,8,631,631,631,631
Plumas,24,2022-05-30,35,35,35,0,200,200,199,1,1,0,0,0,13,13,13,13
Riverside,24,2022-05-30,3863,3863,3845,18,43870,43895,43690,205,82,3,3,10,6481,6481,6478,6478
Sacramento,24,2022-05-30,3844,3844,3825,19,33086,33103,32937,166,130,9,9,20,3102,3102,3093,3093
San Benito,24,2022-05-30,154,154,153,1,1276,1276,1271,5,0,0,0,0,94,94,94,94
San Bernardino,24,2022-05-30,3337,3337,3325,12,42872,42894,42733,161,49,5,5,10,7855,7855,7850,7850
San Diego,24,2022-05-30,8414,8418,8405,13,85859,85903,85768,135,153,10,10,26,5381,5381,5371,5371
San Francisco,24,2022-05-30,3132,3132,3100,32,33425,33442,33098,344,88,11,11,14,906,906,895,895
San Joaquin,24,2022-05-30,1399,1399,1391,8,17011,17021,16927,94,25,2,2,9,2258,2258,2256,2256
San Luis Obispo,24,2022-05-30,653,653,650,3,5437,5439,5416,23,12,1,1,0,487,487,486,486
San Mateo,24,2022-05-30,2753,2753,2743,10,31176,31193,31083,110,33,3,3,2,717,717,714,714
Santa Barbara,24,2022-05-30,1032,1032,1027,5,14451,14458,14388,70,23,2,2,5,695,695,693,693
Santa Clara,24,2022-05-30,7030,7034,7022,12,85314,85359,85216,143,154,10,10,22,2344,2344,2334,2334
Santa Cruz,24,2022-05-30,526,526,524,2,6255,6258,6232,26,7,1,1,1,263,263,262,262
Shasta,24,2022-05-30,133,133,132,1,2838,2838,2824,14,4,3,3,4,565,565,562,562
Siskiyou,24,2022-05-30,53,53,53,0,340,340,339,1,3,0,0,0,83,83,83,83
Solano,24,2022-05-30,1186,1186,1180,6,11558,11563,11508,55,28,0,0,7,451,451,451,451
Sonoma,24,2022-05-30,1200,1200,1195,5,13239,13245,13184,61,38,2,2,5,498,498,496,496
Stanislaus,24,2022-05-30,801,801,795,6,8585,8589,8527,62,55,2,2,3,1701,1701,1699,1699
Sutter,24,2022-05-30,158,158,157,1,1701,1701,1693,8,0,0,0,0,228,228,228,228
Tehama,24,2022-05-30,62,62,62,0,757,757,752,5,2,0,0,0,208,208,208,208
Trinity,24,2022-05-30,8,8,8,0,96,96,95,1,0,0,0,0,20,20,20,20
Tulare,24,2022-05-30,601,601,597,4,7500,7504,7448,56,19,0,0,0,1501,1501,1501,1501
Tuolumne,24,2022-05-30,122,122,121,1,1306,1306,1298,8,3,0,0,0,187,187,187,187
Ventura,24,2022-05-30,1681,1681,1676,5,19545,19556,19493,63,30,1,1,4,1515,1515,1514,1514
Yolo,24,2022-05-30,611,611,608,3,17632,17641,17566,75,4,0,0,1,363,363,363,363
Yuba,24,2022-05-30,144,144,143,1,1276,1276,1270,6,7,0,0,2,119,119,119,119
Alameda,25,2022-06-06,6488,6493,6474,19,73234,73278,73066,212,112,6,6,12,1905,1905,1899,1899
Amador,25,2022-06-06,114,114,113,1,1723,1723,1715,8,1,0,0,1,87,87,87,87
Butte,25,2022-06-06,453,453,452,1,3617,3617,3609,8,24,1,1,1,438,438,437,437
Calaveras,25,2022-06-06,73,73,73,0,737,737,734,3,0,2,2,0,124,124,122,122
Colusa,25,2022-06-06,22,22,22,0,275,275,274,1,3,0,0,0,21,21,21,21
Contra Costa,25,2022-06-06,4236,4236,4216,20,35705,35726,35553,173,107,9,9,7,1343,1343,1334,1334
Del Norte,25,2022-06-06,64,64,64,0,1134,1134,1130,4,2,0,0,0,51,51,51,51
El Dorado,25,2022-06-06,413,413,411,2,3637,3637,3622,15,5,0,0,5,219,219,219,219
Fresno,25,2022-06-06,2451,2451,2440,11,22603,22617,22514,103,94,2,2,6,2783,2783,2781,2781
Glenn,25,2022-06-06,41,41,41,0,325,325,324,1,3,0,0,0,53,53,53,53
Humboldt,25,2022-06-06,261,261,260,1,3054,3054,3043,11,14,1,1,3,150,150,149,149
Imperial,25,2022-06-06,465,465,463,2,4855,4857,4837,20,2,0,0,0,946,946,946,946
Inyo,25,2022-06-06,20,20,20,0,213,213,212,1,1,0,0,0,56,56,56,56
Kern,25,2022-06-06,1611,1611,1606,5,22975,22989,22912,77,35,1,1,6,2352,2352,2351,2351
Kings,25,2022-06-06,397,397,395,2,5504,5507,5484,23,10,0,0,1,450,450,450,450
Lake,25,2022-06-06,136,136,135,1,1180,1180,1174,6,5,0,0,2,140,140,140,140
Lassen,25,2022-06-06,71,71,71,0,2398,2398,2390,8,2,0,0,0,62,62,62,62
Los Angeles,25,2022-06-06,35103,35124,35084,40,1041702,1042325,1041122,1203,496,39,39,61,32116,32116,32077,32077
Madera,25,2022-06-06,354,354,352,2,4126,4127,4108,19,7,0,0,1,370,370,370,370
Marin,25,2022-06-06,739,739,736,3,7650,7655,7621,34,10,2,2,5,300,300,298,298
Mariposa,25,2022-06-06,57,57,57,0,403,403,401,2,0,0,0,0,28,28,28,28
Mendocino,25,2022-06-06,209,209,208,1,1711,1711,1700,11,9,1,1,2,130,130,129,129
Merced,25,2022-06-06,532,532,530,2,4530,4532,4516,16,16,0,0,0,828,828,828,828
Modoc,25,2022-06-06,11,11,11,0,37,38,37,1,0,0,0,0,7,7,7,7
Mono,25,2022-06-06,15,15,15,0,120,120,119,1,0,0,0,0,6,6,6,6
Monterey,25,2022-06-06,1002,1002,995,7,10243,10249,10174,75,17,2,2,1,738,738,736,736
Napa,25,2022-06-06,556,556,554,2,4267,4269,4256,13,8,1,1,0,144,144,143,143
Nevada,25,2022-06-06,246,246,245,1,2149,2149,2139,10,5,0,0,0,133,133,133,133
Orange,25,2022-06-06,7627,7632,7612,20,73827,73872,73674,198,140,12,12,18,7180,7180,7168,7168
Placer,25,2022-06-06,868,868,864,4,7605,7610,7572,38,65,0,0,11,631,631,631,631
Plumas,25,2022-06-06,40,40,40,0,321,321,320,1,0,0,0,0,13,13,13,13
Riverside,25,2022-06-06,5355,5358,5339,19,55976,56010,55809,201,88,6,6,10,6487,6487,6481,6481
Sacramento,25,2022-06-06,4951,4953,4934,19,42466,42492,42327,165,149,14,14,20,3116,3116,3102,3102
San Benito,25,2022-06-06,273,273,272,1,2016,2016,2010,6,0,0,0,1,94,94,94,94
San Bernardino,25,2022-06-06,5134,5137,5122,15,55846,55879,55717,162,77,7,7,14,7862,7862,7855,7855
San Diego,25,2022-06-06,10776,10782,10769,13,100464,100524,100402,122,185,8,8,22,5389,5389,5381,5381
San Francisco,25,2022-06-06,3521,3521,3493,28,38262,38285,37980,305,77,0,0,11,906,906,906,906
San Joaquin,25,2022-06-06,2134,2134,2125,9,22156,22170,22076,94,40,4,4,9,2262,2262,2258,2258
San Luis Obispo,25,2022-06-06,901,901,898,3,7531,7536,7511,25,16,1,1,1,488,488,487,487
San Mateo,25,2022-06-06,3214,3214,3205,9,37066,37087,36987,100,36,2,2,4,719,719,717,717
Santa Barbara,25,2022-06-06,1246,1246,1241,5,15072,15079,15023,56,22,1,1,5,696,696,695,695
Santa Clara,25,2022-06-06,8504,8511,8500,11,102648,102710,102578,132,176,6,6,22,2350,2350,2344,2344
Santa Cruz,25,2022-06-06,896,896,893,3,9720,9726,9696,30,24,1,1,3,264,264,263,263
Shasta,25,2022-06-06,210,210,209,1,4425,4427,4410,17,10,2,2,2,567,567,565,565
Siskiyou,25,2022-06-06,41,41,41,0,431,431,430,1,1,0,0,0,83,83,83,83
Solano,25,2022-06-06,1748,1748,1742,6,15182,15190,15135,55,29,2,2,1,453,453,451,451
Sonoma,25,2022-06-06,1635,1635,1629,6,13997,14005,13956,49,38,1,1,1,499,499,498,498
Stanislaus,25,2022-06-06,1183,1183,1176,7,10914,10920,10859,61,60,1,1,2,1702,1702,1701,1701
Sutter,25,2022-06-06,206,206,205,1,1941,1941,1934,7,0,0,0,0,228,228,228,228
Tehama,25,2022-06-06,83,83,83,0,1051,1051,1045,6,2,0,0,0,208,208,208,208
Trinity,25,2022-06-06,7,7,7,0,110,110,109,1,0,0,0,0,20,20,20,20
Tulare,25,2022-06-06,864,864,859,5,10805,10812,10750,62,24,0,0,0,1501,1501,1501,1501
Tuolumne,25,2022-06-06,124,124,123,1,1723,1723,1715,8,4,0,0,1,187,187,187,187
Ventura,25,2022-06-06,1973,1973,1968,5,24767,24781,24720,61,43,3,3,3,1518,1518,1515,1515
Yolo,25,2022-06-06,828,828,825,3,21437,21450,21380,70,2,1,1,0,364,364,363,363
Yuba,25,2022-06-06,187,187,186,1,1556,1556,1551,5,9,0,0,1,119,119,119,119
Alameda,26,2022-06-13,5077,5082,5071,11,55923,55963,55837,126,106,6,6,18,1911,1911,1905,1905
Amador,26,2022-06-13,129,129,129,0,1413,1413,1408,5,1,0,0,0,87,87,87,87
Butte,26,2022-06-13,394,394,393,1,3459,3461,3455,6,31,4,4,0,442,442,438,438
Calaveras,26,2022-06-13,69,69,69,0,658,658,656,2,0,0,0,0,124,124,124,124
Colusa,26,2022-06-13,12,12,12,0,328,328,327,1,17,0,0,0,21,21,21,21
Contra Costa,26,2022-06-13,3414,3414,3401,13,27990,28010,27904,106,89,8,8,12,1351,1351,1343,1343
Del Norte,26,2022-06-13,79,79,79,0,658,658,656,2,4,0,0,0,51,51,51,51
El Dorado,26,2022-06-13,324,324,323,1,3197,3197,3187,10,7,3,3,1,222,222,219,219
Fresno,26,2022-06-13,2399,2399,2391,8,20609,20623,20550,73,103,4,4,13,2787,2787,2783,2783
Glenn,26,2022-06-13,32,32,32,0,329,329,328,1,2,0,0,0,53,53,53,53
Humboldt,26,2022-06-13,262,262,261,1,2325,2325,2318,7,11,0,0,3,150,150,150,150
Imperial,26,2022-06-13,447,447,446,1,4519,4522,4508,14,6,1,1,0,947,947,946,946
Inyo,26,2022-06-13,13,13,13,0,189,189,188,1,0,0,0,0,56,56,56,56
Kern,26,2022-06-13,1565,1565,1561,4,21421,21436,21380,56,38,1,1,5,2353,2353,2352,2352
Kings,26,2022-06-13,357,357,356,1,5156,5161,5145,16,4,1,1,0,451,451,450,450
Lake,26,2022-06-13,138,138,137,1,1228,1228,1224,4,1,0,0,0,140,140,140,140
Lassen,26,2022-06-13,77,77,77,0,1994,1994,1989,5,2,0,0,0,62,62,62,62
Los Angeles,26,2022-06-13,29992,30014,29987,27,660492,660947,660348,599,519,54,54,60,32170,32170,32116,32116
Madera,26,2022-06-13,381,381,380,1,4231,4233,4218,15,7,0,0,2,370,370,370,370
Marin,26,2022-06-13,686,686,684,2,7039,7044,7019,25,16,2,2,2,302,302,300,300
Mariposa,26,2022-06-13,45,45,45,0,372,372,371,1,0,0,0,0,28,28,28,28
Mendocino,26,2022-06-13,162,162,161,1,1567,1567,1559,8,9,0,0,1,130,130,130,130
Merced,26,2022-06-13,561,561,559,2,4169,4170,4159,11,13,0,0,2,828,828,828,828
Modoc,26,2022-06-13,7,7,7,0,34,35,34,1,1,1,1,0,8,8,7,7
Mono,26,2022-06-13,19,19,19,0,92,92,91,1,0,0,0,0,6,6,6,6
Monterey,26,2022-06-13,841,841,836,5,8659,8664,8615,49,25,3,3,1,741,741,738,738
Napa,26,2022-06-13,445,445,444,1,3967,3969,3959,10,2,1,1,1,145,145,144,144
Nevada,26,2022-06-13,186,186,185,1,1874,1874,1867,7,8,0,0,0,133,133,133,133
Orange,26,2022-06-13,7049,7054,7039,15,65292,65337,65201,136,175,15,15,19,7195,7195,7180,7180
Placer,26,2022-06-13,790,790,787,3,6801,6806,6780,26,79,2,2,7,633,633,631,631
Plumas,26,2022-06-13,34,34,34,0,271,271,270,1,0,0,0,0,13,13,13,13
Riverside,26,2022-06-13,5046,5049,5035,14,47851,47883,47749,134,105,3,3,11,6490,6490,6487,6487
Sacramento,26,2022-06-13,4179,4181,4168,13,37540,37565,37452,113,190,13,13,20,3129,3129,3116,3116
San Benito,26,2022-06-13,200,200,200,0,1780,1780,1776,4,1,0,0,1,94,94,94,94
San Bernardino,26,2022-06-13,4674,4677,4667,10,48701,48735,48625,110,96,6,6,15,7868,7868,7862,7862
San Diego,26,2022-06-13,9614,9620,9611,9,84903,84961,84881,80,192,9,9,27,5398,5398,5389,5389
San Francisco,26,2022-06-13,3029,3029,3010,19,31123,31144,30951,193,72,11,11,13,917,917,906,906
San Joaquin,26,2022-06-13,1919,1919,1913,6,19008,19021,18958,63,32,5,5,3,2267,2267,2262,2262
San Luis Obispo,26,2022-06-13,661,661,659,2,6051,6056,6041,15,21,0,0,0,488,488,488,488
San Mateo,26,2022-06-13,2635,2635,2630,5,29175,29195,29134,61,44,3,3,3,722,722,719,719
Santa Barbara,26,2022-06-13,931,931,928,3,9476,9481,9454,27,15,1,1,5,697,697,696,696
Santa Clara,26,2022-06-13,7044,7051,7044,7,76835,76889,76812,77,182,13,13,23,2363,2363,2350,2350
Santa Cruz,26,2022-06-13,842,842,840,2,9962,9968,9944,24,23,0,0,1,264,264,264,264
Shasta,26,2022-06-13,220,220,219,1,3390,3392,3382,10,8,1,1,0,568,568,567,567
Siskiyou,26,2022-06-13,50,50,50,0,372,372,371,1,1,0,0,0,83,83,83,83
Solano,26,2022-06-13,1689,1689,1684,5,12902,12912,12876,36,33,0,0,2,453,453,453,453
Sonoma,26,2022-06-13,1336,1336,1332,4,11653,11661,11629,32,36,3,3,6,502,502,499,499
Stanislaus,26,2022-06-13,1133,1133,1128,5,9453,9459,9418,41,63,1,1,7,1703,1703,1702,1702
Sutter,26,2022-06-13,193,193,192,1,1721,1721,1716,5,0,0,0,0,228,228,228,228
Tehama,26,2022-06-13,88,88,88,0,967,967,963,4,3,0,0,0,208,208,208,208
Trinity,26,2022-06-13,11,11,11,0,84,85,84,1,0,0,0,0,20,20,20,20
Tulare,26,2022-06-13,833,833,829,4,9476,9482,9440,42,26,2,2,1,1503,1503,1501,1501
Tuolumne,26,2022-06-13,148,148,147,1,1445,1445,1440,5,2,0,0,0,187,187,187,187
Ventura,26,2022-06-13,1936,1936,1932,4,20982,20997,20957,40,38,3,3,5,1521,1521,1518,1518
Yolo,26,2022-06-13,767,767,765,2,14393,14402,14365,37,4,1,1,0,365,365,364,364
Yuba,26,2022-06-13,188,188,187,1,1419,1419,1415,4,8,0,0,1,119,119,119,119
Alameda,27,2022-06-20,4952,4957,4948,9,48646,48682,48597,85,105,12,12,14,1923,1923,1911,1911
Amador,27,2022-06-20,104,104,104,0,1247,1247,1243,4,2,0,0,0,87,87,87,87
Butte,27,2022-06-20,414,414,413,1,3562,3565,3560,5,28,4,4,1,446,446,442,442
Calaveras,27,2022-06-20,82,82,82,0,624,624,622,2,0,0,0,0,124,124,124,124
Colusa,27,2022-06-20,16,16,16,0,176,177,176,1,15,1,1,0,22,22,21,21
Contra Costa,27,2022-06-20,3348,3349,3339,10,26023,26043,25966,77,81,7,7,8,1358,1358,1351,1351
Del Norte,27,2022-06-20,82,82,82,0,611,611,610,1,3,1,1,1,52,52,51,51
El Dorado,27,2022-06-20,351,351,350,1,3074,3075,3067,8,5,2,2,1,224,224,222,222
Fresno,27,2022-06-20,2471,2471,2464,7,19407,19421,19367,54,100,2,2,16,2789,2789,2787,2787
Glenn,27,2022-06-20,41,41,41,0,314,314,313,1,3,0,0,0,53,53,53,53
Humboldt,27,2022-06-20,274,274,273,1,2274,2274,2269,5,11,0,0,3,150,150,150,150
Imperial,27,2022-06-20,602,602,601,1,3690,3691,3682,9,5,0,0,0,947,947,947,947
Inyo,27,2022-06-20,19,19,19,0,187,188,187,1,0,0,0,0,56,56,56,56
Kern,27,2022-06-20,1652,1652,1649,3,20136,20151,20110,41,39,5,5,9,2358,2358,2353,2353
Kings,27,2022-06-20,413,413,412,1,4866,4871,4859,12,6,1,1,0,452,452,451,451
Lake,27,2022-06-20,120,120,120,0,1237,1237,1233,4,1,0,0,2,140,140,140,140
Lassen,27,2022-06-20,43,43,43,0,1223,1223,1221,2,1,0,0,0,62,62,62,62
Los Angeles,27,2022-06-20,27530,27550,27531,19,351481,351747,351503,244,596,57,57,68,32227,32227,32170,32170
Madera,27,2022-06-20,340,340,339,1,4163,4166,4154,12,4,0,0,1,370,370,370,370
Marin,27,2022-06-20,693,693,691,2,6328,6333,6316,17,21,0,0,1,302,302,302,302
Mariposa,27,2022-06-20,53,53,53,0,335,335,334,1,0,0,0,0,28,28,28,28
Mendocino,27,2022-06-20,180,180,179,1,1580,1580,1574,6,3,0,0,0,130,130,130,130
Merced,27,2022-06-20,541,541,540,1,3955,3957,3949,8,7,3,3,1,831,831,828,828
Modoc,27,2022-06-20,5,5,5,0,37,38,37,1,0,0,0,0,8,8,8,8
Mono,27,2022-06-20,6,6,6,0,82,83,82,1,1,1,1,0,7,7,6,6
Monterey,27,2022-06-20,894,894,890,4,8905,8911,8872,39,38,1,1,2,742,742,741,741
Napa,27,2022-06-20,371,371,370,1,3150,3150,3144,6,3,1,1,0,146,146,145,145
Nevada,27,2022-06-20,170,170,170,0,1619,1619,1615,4,6,1,1,0,134,134,133,133
Orange,27,2022-06-20,7061,7068,7057,11,60496,60543,60444,99,152,10,10,23,7205,7205,7195,7195
Placer,27,2022-06-20,674,674,672,2,6053,6058,6040,18,69,1,1,7,634,634,633,633
Plumas,27,2022-06-20,38,38,38,0,239,239,238,1,0,0,0,0,13,13,13,13
Riverside,27,2022-06-20,4960,4965,4954,11,43309,43341,43246,95,112,5,5,14,6495,6495,6490,6490
Sacramento,27,2022-06-20,3931,3932,3923,9,34813,34838,34756,82,171,12,12,21,3141,3141,3129,3129
San Benito,27,2022-06-20,173,173,173,0,1598,1598,1595,3,0,1,1,2,95,95,94,94
San Bernardino,27,2022-06-20,4533,4537,4529,8,46256,46291,46210,81,105,12,12,17,7880,7880,7868,7868
San Diego,27,2022-06-20,9697,9704,9697,7,77523,77582,77525,57,203,9,9,17,5407,5407,5398,5398
San Francisco,27,2022-06-20,3059,3059,3044,15,28298,28319,28182,137,72,12,12,14,929,929,917,917
San Joaquin,27,2022-06-20,1671,1671,1667,4,17897,17911,17865,46,38,6,6,6,2273,2273,2267,2267
San Luis Obispo,27,2022-06-20,601,601,600,1,5814,5819,5807,12,27,10,10,0,498,498,488,488
San Mateo,27,2022-06-20,2623,2623,2619,4,25948,25967,25924,43,42,2,2,1,724,724,722,722
Santa Barbara,27,2022-06-20,934,934,932,2,8260,8267,8249,18,33,2,2,6,699,699,697,697
Santa Clara,27,2022-06-20,6809,6816,6811,5,63486,63534,63485,49,170,8,8,21,2371,2371,2363,2363
Santa Cruz,27,2022-06-20,818,818,816,2,9130,9136,9119,17,19,1,1,2,265,265,264,264
Shasta,27,2022-06-20,241,241,240,1,3374,3376,3368,8,9,1,1,1,569,569,568,568
Siskiyou,27,2022-06-20,61,61,61,0,394,394,393,1,5,1,1,0,84,84,83,83
Solano,27,2022-06-20,1420,1420,1417,3,11467,11477,11452,25,41,0,0,5,453,453,453,453
Sonoma,27,2022-06-20,1400,1400,1397,3,10797,10805,10782,23,28,1,1,3,503,503,502,502
Stanislaus,27,2022-06-20,1037,1037,1033,4,8832,8838,8808,30,70,5,5,7,1708,1708,1703,1703
Sutter,27,2022-06-20,197,197,197,0,1858,1858,1854,4,0,0,0,0,228,228,228,228
Tehama,27,2022-06-20,97,97,97,0,889,889,886,3,3,0,0,0,208,208,208,208
Trinity,27,2022-06-20,10,10,10,0,106,107,106,1,0,0,0,0,20,20,20,20
Tulare,27,2022-06-20,898,898,895,3,8750,8755,8725,30,32,8,8,0,1511,1511,1503,1503
Tuolumne,27,2022-06-20,141,141,141,0,1554,1554,1550,4,3,0,0,1,187,187,187,187
Ventura,27,2022-06-20,1835,1835,1832,3,18671,18684,18656,28,50,1,1,7,1522,1522,1521,1521
Yolo,27,2022-06-20,680,680,679,1,10848,10856,10834,22,1,2,2,2,367,367,365,365
Yuba,27,2022-06-20,149,149,149,0,1339,1339,1336,3,13,0,0,5,119,119,119,119
Alameda,28,2022-06-27,5473,5478,5471,7,48325,48365,48299,66,124,8,8,16,1931,1931,1923,1923
Amador,28,2022-06-27,88,88,88,0,1149,1149,1146,3,3,0,0,1,87,87,87,87
Butte,28,2022-06-27,410,410,410,0,3468,3471,3467,4,30,2,2,0,448,448,446,446
Calaveras,28,2022-06-27,69,69,69,0,571,571,570,1,1,2,2,0,126,126,124,124
Colusa,28,2022-06-27,28,28,28,0,282,283,282,1,6,0,0,0,22,22,22,22
Contra Costa,28,2022-06-27,3529,3530,3522,8,25917,25940,25881,59,82,12,12,7,1370,1370,1358,1358
Del Norte,28,2022-06-27,140,140,140,0,669,669,668,1,5,1,1,2,53,53,52,52
El Dorado,28,2022-06-27,427,427,426,1,3357,3359,3353,6,5,0,0,1,224,224,224,224
Fresno,28,2022-06-27,2828,2828,2822,6,19884,19901,19858,43,136,2,2,17,2791,2791,2789,2789
Glenn,28,2022-06-27,28,28,28,0,296,296,295,1,1,0,0,0,53,53,53,53
Humboldt,28,2022-06-27,261,261,261,0,2189,2189,2185,4,10,1,1,2,151,151,150,150
Imperial,28,2022-06-27,705,705,704,1,4017,4021,4013,8,7,0,0,4,947,947,947,947
Inyo,28,2022-06-27,32,32,32,0,311,311,310,1,1,0,0,0,56,56,56,56
Kern,28,2022-06-27,1819,1819,1816,3,17406,17421,17393,28,52,7,7,8,2365,2365,2358,2358
Kings,28,2022-06-27,470,470,469,1,3931,3934,3926,8,9,0,0,0,452,452,452,452
Lake,28,2022-06-27,122,122,122,0,1139,1139,1136,3,2,0,0,0,140,140,140,140
Lassen,28,2022-06-27,51,51,51,0,848,848,847,1,1,0,0,0,62,62,62,62
Los Angeles,28,2022-06-27,32764,32792,32774,18,364336,364642,364445,197,679,73,73,68,32300,32300,32227,32227
Madera,28,2022-06-27,414,414,413,1,4286,4289,4280,9,8,0,0,0,370,370,370,370
Marin,28,2022-06-27,659,659,658,1,6242,6247,6234,13,20,1,1,2,303,303,302,302
Mariposa,28,2022-06-27,55,55,55,0,310,310,309,1,0,0,0,0,28,28,28,28
Mendocino,28,2022-06-27,153,153,153,0,1447,1447,1443,4,5,1,1,1,131,131,130,130
Merced,28,2022-06-27,614,614,613,1,4036,4041,4034,7,14,2,2,0,833,833,831,831
Modoc,28,2022-06-27,7,7,7,0,32,33,32,1,0,0,0,0,8,8,8,8
Mono,28,2022-06-27,25,25,25,0,110,111,110,1,1,0,0,0,7,7,7,7
Monterey,28,2022-06-27,935,935,932,3,8274,8280,8252,28,44,2,2,3,744,744,742,742
Napa,28,2022-06-27,394,394,393,1,3322,3325,3320,5,3,2,2,1,148,148,146,146
Nevada,28,2022-06-27,189,189,189,0,1619,1619,1616,3,4,0,0,3,134,134,134,134
Orange,28,2022-06-27,7595,7602,7592,10,59405,59455,59380,75,183,16,16,26,7221,7221,7205,7205
Placer,28,2022-06-27,808,808,806,2,6185,6190,6175,15,79,6,6,6,640,640,634,634
Plumas,28,2022-06-27,50,50,50,0,257,257,256,1,1,0,0,0,13,13,13,13
Riverside,28,2022-06-27,6195,6202,6192,10,44971,45010,44934,76,141,11,11,17,6506,6506,6495,6495
Sacramento,28,2022-06-27,4165,4170,4162,8,35282,35312,35247,65,173,10,10,25,3151,3151,3141,3141
San Benito,28,2022-06-27,221,221,221,0,1655,1655,1653,2,0,0,0,1,95,95,95,95
San Bernardino,28,2022-06-27,5724,5731,5723,8,48826,48867,48800,67,130,12,12,24,7892,7892,7880,7880
San Diego,28,2022-06-27,10871,10880,10874,6,80655,80723,80677,46,264,9,9,28,5416,5416,5407,5407
San Francisco,28,2022-06-27,3269,3270,3258,12,29257,29282,29172,110,92,5,5,23,934,934,929,929
San Joaquin,28,2022-06-27,1893,1893,1889,4,17962,17976,17940,36,46,2,2,5,2275,2275,2273,2273
San Luis Obispo,28,2022-06-27,645,645,644,1,5644,5649,5640,9,25,3,3,0,501,501,498,498
San Mateo,28,2022-06-27,2890,2890,2886,4,26919,26941,26907,34,36,2,2,2,726,726,724,724
Santa Barbara,28,2022-06-27,1148,1148,1146,2,9812,9821,9804,17,26,2,2,2,701,701,699,699
Santa Clara,28,2022-06-27,7542,7549,7544,5,61418,61469,61432,37,213,11,11,19,2382,2382,2371,2371
Santa Cruz,28,2022-06-27,861,861,860,1,9188,9194,9180,14,26,2,2,1,267,267,265,265
Shasta,28,2022-06-27,339,339,338,1,3308,3311,3305,6,21,0,0,4,569,569,569,569
Siskiyou,28,2022-06-27,63,63,63,0,355,355,354,1,2,1,1,0,85,85,84,84
Solano,28,2022-06-27,1614,1614,1611,3,13044,13055,13033,22,47,0,0,4,453,453,453,453
Sonoma,28,2022-06-27,1368,1368,1366,2,10098,10106,10089,17,33,2,2,3,505,505,503,503
Stanislaus,28,2022-06-27,1211,1211,1208,3,8583,8590,8567,23,96,2,2,6,1710,1710,1708,1708
Sutter,28,2022-06-27,197,197,197,0,1843,1843,1840,3,0,0,0,0,228,228,228,228
Tehama,28,2022-06-27,93,93,93,0,888,888,886,2,3,0,0,0,208,208,208,208
Trinity,28,2022-06-27,24,24,24,0,142,143,142,1,1,0,0,0,20,20,20,20
Tulare,28,2022-06-27,909,909,907,2,7901,7907,7886,21,35,0,0,2,1511,1511,1511,1511
Tuolumne,28,2022-06-27,172,172,172,0,1405,1405,1402,3,1,4,4,1,191,191,187,187
Ventura,28,2022-06-27,2090,2090,2088,2,18539,18554,18532,22,61,3,3,1,1525,1525,1522,1522
Yolo,28,2022-06-27,794,794,793,1,11408,11417,11399,18,8,0,0,1,367,367,367,367
Yuba,28,2022-06-27,173,173,173,0,1435,1435,1433,2,10,2,2,2,121,121,119,119
Alameda,29,2022-07-04,4831,4836,4831,5,38880,38916,38874,42,128,11,11,10,1942,1942,1931,1931
Amador,29,2022-07-04,66,66,66,0,1534,1535,1532,3,3,0,0,1,87,87,87,87
Butte,29,2022-07-04,284,284,284,0,2489,2491,2489,2,28,2,2,1,450,450,448,448
Calaveras,29,2022-07-04,81,81,81,0,486,486,485,1,0,2,2,0,128,128,126,126
Colusa,29,2022-07-04,21,21,21,0,150,151,150,1,4,0,0,0,22,22,22,22
Contra Costa,29,2022-07-04,3320,3323,3317,6,20933,20953,20915,38,76,10,10,12,1380,1380,1370,1370
Del Norte,29,2022-07-04,140,140,140,0,587,587,586,1,3,0,0,0,53,53,53,53
El Dorado,29,2022-07-04,307,307,307,0,2395,2396,2392,4,10,1,1,0,225,225,224,224
Fresno,29,2022-07-04,2469,2469,2465,4,15665,15680,15653,27,158,6,6,17,2797,2797,2791,2791
Glenn,29,2022-07-04,24,24,24,0,157,158,157,1,1,0,0,0,53,53,53,53
Humboldt,29,2022-07-04,188,188,188,0,1584,1584,1582,2,12,2,2,3,153,153,151,151
Imperial,29,2022-07-04,697,697,696,1,3233,3236,3231,5,8,1,1,3,948,948,947,947
Inyo,29,2022-07-04,42,42,42,0,292,293,292,1,1,0,0,0,56,56,56,56
Kern,29,2022-07-04,1794,1794,1792,2,14291,14304,14286,18,63,4,4,9,2369,2369,2365,2365
Kings,29,2022-07-04,436,436,435,1,3446,3449,3444,5,5,0,0,0,452,452,452,452
Lake,29,2022-07-04,107,107,107,0,790,790,789,1,3,2,2,0,142,142,140,140
Lassen,29,2022-07-04,31,31,31,0,640,640,639,1,2,0,0,0,62,62,62,62
Los Angeles,29,2022-07-04,32266,32296,32282,14,285973,286243,286120,123,801,88,88,85,32388,32388,32300,32300
Madera,29,2022-07-04,341,341,340,1,3179,3182,3176,6,9,0,0,1,370,370,370,370
Marin,29,2022-07-04,608,608,607,1,5170,5175,5166,9,25,1,1,2,304,304,303,303
Mariposa,29,2022-07-04,36,36,36,0,222,223,222,1,0,0,0,0,28,28,28,28
Mendocino,29,2022-07-04,164,164,164,0,1119,1119,1116,3,6,2,2,1,133,133,131,131
Merced,29,2022-07-04,595,595,594,1,2919,2923,2919,4,14,2,2,1,835,835,833,833
Modoc,29,2022-07-04,10,10,10,0,31,32,31,1,0,0,0,0,8,8,8,8
Mono,29,2022-07-04,22,22,22,0,81,82,81,1,1,0,0,0,7,7,7,7
Monterey,29,2022-07-04,843,843,841,2,6322,6327,6310,17,39,2,2,4,746,746,744,744
Napa,29,2022-07-04,345,345,345,0,2564,2567,2564,3,13,0,0,1,148,148,148,148
Nevada,29,2022-07-04,177,177,177,0,1268,1268,1266,2,5,0,0,1,134,134,134,134
Orange,29,2022-07-04,7021,7028,7021,7,50770,50818,50767,51,203,25,25,34,7246,7246,7221,7221
Placer,29,2022-07-04,808,808,807,1,5049,5053,5044,9,72,3,3,6,643,643,640,640
Plumas,29,2022-07-04,32,32,32,0,172,173,172,1,0,0,0,0,13,13,13,13
Riverside,29,2022-07-04,6396,6403,6394,9,38526,38561,38509,52,137,5,5,8,6511,6511,6506,6506
Sacramento,29,2022-07-04,3581,3585,3580,5,26535,26561,26522,39,163,19,19,22,3170,3170,3151,3151
San Benito,29,2022-07-04,211,211,211,0,1274,1274,1272,2,3,0,0,0,95,95,95,95
San Bernardino,29,2022-07-04,6066,6073,6066,7,41600,41639,41594,45,147,12,12,26,7904,7904,7892,7892
San Diego,29,2022-07-04,9597,9607,9603,4,65500,65563,65533,30,262,10,10,43,5426,5426,5416,5416
San Francisco,29,2022-07-04,2891,2891,2882,9,24202,24225,24153,72,100,11,11,18,945,945,934,934
San Joaquin,29,2022-07-04,1682,1682,1679,3,14678,14691,14668,23,41,5,5,4,2280,2280,2275,2275
San Luis Obispo,29,2022-07-04,616,616,615,1,4165,4169,4164,5,24,0,0,0,501,501,501,501
San Mateo,29,2022-07-04,2600,2600,2597,3,21595,21615,21593,22,39,1,1,3,727,727,726,726
Santa Barbara,29,2022-07-04,1057,1057,1056,1,7666,7673,7662,11,26,4,4,4,705,705,701,701
Santa Clara,29,2022-07-04,6804,6811,6808,3,50746,50794,50770,24,191,16,16,34,2398,2398,2382,2382
Santa Cruz,29,2022-07-04,733,733,732,1,7158,7163,7154,9,22,0,0,0,267,267,267,267
Shasta,29,2022-07-04,280,280,280,0,2396,2398,2394,4,15,5,5,3,574,574,569,569
Siskiyou,29,2022-07-04,34,34,34,0,326,327,326,1,1,0,0,1,85,85,85,85
Solano,29,2022-07-04,1345,1345,1343,2,9842,9852,9839,13,50,0,0,5,453,453,453,453
Sonoma,29,2022-07-04,1088,1088,1087,1,8092,8100,8089,11,35,2,2,1,507,507,505,505
Stanislaus,29,2022-07-04,1165,1165,1163,2,6990,6996,6981,15,84,7,7,16,1717,1717,1710,1710
Sutter,29,2022-07-04,230,230,230,0,1671,1672,1670,2,0,0,0,0,228,228,228,228
Tehama,29,2022-07-04,132,132,132,0,821,821,819,2,3,1,1,0,209,209,208,208
Trinity,29,2022-07-04,17,17,17,0,143,144,143,1,2,0,0,0,20,20,20,20
Tulare,29,2022-07-04,948,948,946,2,6121,6125,6112,13,40,4,4,1,1515,1515,1511,1511
Tuolumne,29,2022-07-04,165,165,165,0,938,938,936,2,8,0,0,1,191,191,191,191
Ventura,29,2022-07-04,1948,1948,1946,2,15410,15424,15410,14,66,2,2,8,1527,1527,1525,1525
Yolo,29,2022-07-04,535,535,534,1,7258,7265,7256,9,6,3,3,2,370,370,367,367
Yuba,29,2022-07-04,168,168,168,0,1078,1078,1077,1,9,0,0,1,121,121,121,121
Alameda,30,2022-07-11,5794,5801,5796,5,48341,48392,48352,40,119,8,8,16,1950,1950,1942,1942
Amador,30,2022-07-11,92,92,92,0,1504,1504,1502,2,2,0,0,0,87,87,87,87
Butte,30,2022-07-11,497,497,497,0,3298,3301,3299,2,27,1,1,4,451,451,450,450
Calaveras,30,2022-07-11,78,78,78,0,566,566,565,1,0,1,1,1,129,129,128,128
Colusa,30,2022-07-11,26,26,26,0,483,484,483,1,0,0,0,0,22,22,22,22
Contra Costa,30,2022-07-11,3685,3690,3685,5,26544,26572,26535,37,91,11,11,11,1391,1391,1380,1380
Del Norte,30,2022-07-11,174,174,174,0,677,677,676,1,5,0,0,1,53,53,53,53
El Dorado,30,2022-07-11,384,384,384,0,3153,3157,3153,4,12,1,1,3,226,226,225,225
Fresno,30,2022-07-11,3662,3667,3662,5,21551,21573,21545,28,161,7,7,14,2804,2804,2797,2797
Glenn,30,2022-07-11,45,45,45,0,382,383,382,1,0,0,0,0,53,53,53,53
Humboldt,30,2022-07-11,291,291,291,0,2189,2190,2188,2,11,1,1,2,154,154,153,153
Imperial,30,2022-07-11,1118,1118,1117,1,4746,4751,4745,6,14,1,1,1,949,949,948,948
Inyo,30,2022-07-11,40,40,40,0,391,392,391,1,0,1,1,0,57,57,56,56
Kern,30,2022-07-11,2481,2482,2480,2,17066,17084,17067,17,77,2,2,9,2371,2371,2369,2369
Kings,30,2022-07-11,732,732,731,1,4341,4346,4341,5,11,4,4,0,456,456,452,452
Lake,30,2022-07-11,126,126,126,0,1115,1115,1113,2,0,0,0,0,142,142,142,142
Lassen,30,2022-07-11,59,59,59,0,821,821,820,1,2,1,1,0,63,63,62,62
Los Angeles,30,2022-07-11,43330,43377,43363,14,381197,381593,381468,125,1038,90,90,115,32478,32478,32388,32388
Madera,30,2022-07-11,532,532,531,1,4126,4131,4126,5,15,0,0,3,370,370,370,370
Marin,30,2022-07-11,603,603,602,1,5929,5935,5927,8,17,1,1,1,305,305,304,304
Mariposa,30,2022-07-11,52,52,52,0,283,284,283,1,0,0,0,0,28,28,28,28
Mendocino,30,2022-07-11,190,190,190,0,1387,1387,1385,2,4,0,0,0,133,133,133,133
Merced,30,2022-07-11,764,764,763,1,4273,4278,4274,4,16,5,5,1,840,840,835,835
Modoc,30,2022-07-11,28,28,28,0,57,58,57,1,0,0,0,0,8,8,8,8
Mono,30,2022-07-11,11,11,11,0,105,106,105,1,0,0,0,0,7,7,7,7
Monterey,30,2022-07-11,1097,1097,1095,2,7952,7960,7943,17,47,5,5,3,751,751,746,746
Napa,30,2022-07-11,372,372,372,0,3692,3697,3694,3,13,1,1,1,149,149,148,148
Nevada,30,2022-07-11,221,221,221,0,1826,1826,1824,2,7,0,0,1,134,134,134,134
Orange,30,2022-07-11,9813,9824,9816,8,64228,64296,64246,50,257,20,20,30,7266,7266,7246,7246
Placer,30,2022-07-11,784,784,783,1,5963,5969,5960,9,76,2,2,8,645,645,643,643
Plumas,30,2022-07-11,71,71,71,0,282,283,282,1,0,0,0,0,13,13,13,13
Riverside,30,2022-07-11,9212,9222,9213,9,52072,52126,52072,54,225,17,17,12,6528,6528,6511,6511
Sacramento,30,2022-07-11,4210,4215,4210,5,35517,35553,35513,40,184,22,22,24,3192,3192,3170,3170
San Benito,30,2022-07-11,235,235,235,0,1666,1666,1664,2,1,0,0,0,95,95,95,95
San Bernardino,30,2022-07-11,8441,8450,8443,7,57677,57736,57688,48,188,14,14,20,7918,7918,7904,7904
San Diego,30,2022-07-11,13665,13679,13674,5,85553,85643,85613,30,332,11,11,41,5437,5437,5426,5426
San Francisco,30,2022-07-11,2999,3002,2995,7,27845,27874,27810,64,105,11,11,23,956,956,945,945
San Joaquin,30,2022-07-11,2141,2141,2138,3,19356,19375,19351,24,55,7,7,11,2287,2287,2280,2280
San Luis Obispo,30,2022-07-11,754,754,753,1,5272,5277,5272,5,22,3,3,1,504,504,501,501
San Mateo,30,2022-07-11,2778,2780,2778,2,25663,25689,25669,20,42,6,6,4,733,733,727,727
Santa Barbara,30,2022-07-11,1326,1326,1325,1,9704,9715,9705,10,46,5,5,9,710,710,705,705
Santa Clara,30,2022-07-11,7403,7411,7408,3,59984,60046,60024,22,211,12,12,38,2410,2410,2398,2398
Santa Cruz,30,2022-07-11,1031,1031,1030,1,9513,9524,9515,9,16,0,0,0,267,267,267,267
Shasta,30,2022-07-11,328,328,328,0,3565,3568,3564,4,21,2,2,6,576,576,574,574
Siskiyou,30,2022-07-11,29,29,29,0,361,362,361,1,1,1,1,1,86,86,85,85
Solano,30,2022-07-11,1632,1632,1630,2,11658,11670,11658,12,40,1,1,6,454,454,453,453
Sonoma,30,2022-07-11,1300,1300,1299,1,9944,9955,9945,10,50,0,0,7,507,507,507,507
Stanislaus,30,2022-07-11,1494,1494,1492,2,8691,8701,8687,14,103,7,7,11,1724,1724,1717,1717
Sutter,30,2022-07-11,287,287,287,0,1777,1777,1775,2,0,0,0,0,228,228,228,228
Tehama,30,2022-07-11,134,134,134,0,925,925,924,1,5,0,0,1,209,209,209,209
Trinity,30,2022-07-11,35,35,35,0,120,121,120,1,0,0,0,0,20,20,20,20
Tulare,30,2022-07-11,1388,1388,1386,2,9608,9617,9601,16,47,4,4,2,1519,1519,1515,1515
Tuolumne,30,2022-07-11,254,254,254,0,1303,1303,1301,2,6,0,0,0,191,191,191,191
Ventura,30,2022-07-11,2551,2552,2550,2,19717,19737,19723,14,89,9,9,6,1536,1536,1527,1527
Yolo,30,2022-07-11,502,502,502,0,5418,5423,5418,5,4,3,3,4,373,373,370,370
Yuba,30,2022-07-11,218,218,218,0,1402,1402,1401,1,9,0,0,1,121,121,121,121
Alameda,31,2022-07-18,4949,4955,4952,3,42946,42993,42965,28,149,10,10,25,1960,1960,1950,1950
Amador,31,2022-07-18,85,85,85,0,1348,1348,1347,1,6,0,0,1,87,87,87,87
Butte,31,2022-07-18,334,334,334,0,2794,2798,2797,1,25,1,1,3,452,452,451,451
Calaveras,31,2022-07-18,78,78,78,0,545,546,545,1,0,0,0,0,129,129,129,129
Colusa,31,2022-07-18,23,23,23,0,349,350,349,1,2,0,0,0,22,22,22,22
Contra Costa,31,2022-07-18,3060,3064,3061,3,22719,22744,22719,25,88,4,4,16,1395,1395,1391,1391
Del Norte,31,2022-07-18,168,168,168,0,705,705,704,1,7,0,0,0,53,53,53,53
El Dorado,31,2022-07-18,279,279,279,0,2638,2640,2638,2,11,1,1,1,227,227,226,226
Fresno,31,2022-07-18,3705,3710,3706,4,21098,21121,21099,22,199,9,9,15,2813,2813,2804,2804
Glenn,31,2022-07-18,34,34,34,0,263,264,263,1,0,0,0,0,53,53,53,53
Humboldt,31,2022-07-18,295,295,295,0,2026,2027,2025,2,10,0,0,4,154,154,154,154
Imperial,31,2022-07-18,1024,1024,1023,1,4434,4439,4435,4,18,2,2,3,951,951,949,949
Inyo,31,2022-07-18,30,30,30,0,332,333,332,1,0,0,0,0,57,57,57,57
Kern,31,2022-07-18,2318,2319,2317,2,16584,16602,16590,12,72,10,10,14,2381,2381,2371,2371
Kings,31,2022-07-18,708,708,707,1,4154,4159,4155,4,16,1,1,0,457,457,456,456
Lake,31,2022-07-18,132,132,132,0,994,994,993,1,3,0,0,0,142,142,142,142
Lassen,31,2022-07-18,78,78,78,0,1239,1239,1238,1,1,0,0,0,63,63,63,63
Los Angeles,31,2022-07-18,41851,41897,41886,11,352171,352560,352470,90,1162,112,112,137,32590,32590,32478,32478
Madera,31,2022-07-18,529,529,528,1,3632,3637,3633,4,5,0,0,3,370,370,370,370
Marin,31,2022-07-18,516,516,515,1,5504,5510,5504,6,12,1,1,5,306,306,305,305
Mariposa,31,2022-07-18,42,42,42,0,242,243,242,1,0,1,1,0,29,29,28,28
Mendocino,31,2022-07-18,185,185,185,0,1491,1491,1489,2,6,0,0,2,133,133,133,133
Merced,31,2022-07-18,753,753,752,1,3981,3986,3983,3,15,1,1,1,841,841,840,840
Modoc,31,2022-07-18,13,13,13,0,34,35,34,1,1,0,0,0,8,8,8,8
Mono,31,2022-07-18,10,10,10,0,85,86,85,1,1,0,0,0,7,7,7,7
Monterey,31,2022-07-18,985,985,983,2,7190,7198,7186,12,46,6,6,4,757,757,751,751
Napa,31,2022-07-18,327,327,327,0,2974,2978,2976,2,10,2,2,2,151,151,149,149
Nevada,31,2022-07-18,135,135,135,0,1331,1331,1330,1,8,0,0,3,134,134,134,134
Orange,31,2022-07-18,8859,8870,8865,5,59856,59922,59886,36,253,24,24,45,7290,7290,7266,7266
Placer,31,2022-07-18,684,684,683,1,5240,5245,5239,6,89,1,1,5,646,646,645,645
Plumas,31,2022-07-18,60,60,60,0,279,280,279,1,0,0,0,0,13,13,13,13
Riverside,31,2022-07-18,8243,8252,8245,7,48076,48130,48091,39,222,16,16,17,6544,6544,6528,6528
Sacramento,31,2022-07-18,3544,3549,3546,3,30410,30444,30418,26,180,12,12,26,3204,3204,3192,3192
San Benito,31,2022-07-18,199,199,199,0,1588,1588,1587,1,1,1,1,0,96,96,95,95
San Bernardino,31,2022-07-18,8003,8011,8006,5,53747,53807,53772,35,214,13,13,35,7931,7931,7918,7918
San Diego,31,2022-07-18,13080,13095,13091,4,79858,79946,79924,22,402,18,18,52,5455,5455,5437,5437
San Francisco,31,2022-07-18,2489,2490,2486,4,25515,25544,25499,45,111,10,10,24,966,966,956,956
San Joaquin,31,2022-07-18,2053,2053,2051,2,18029,18048,18031,17,66,2,2,11,2289,2289,2287,2287
San Luis Obispo,31,2022-07-18,559,559,559,0,4627,4632,4629,3,17,3,3,1,507,507,504,504
San Mateo,31,2022-07-18,2290,2290,2289,1,23097,23124,23110,14,33,0,0,4,733,733,733,733
Santa Barbara,31,2022-07-18,1298,1298,1297,1,9272,9284,9276,8,47,1,1,6,711,711,710,710
Santa Clara,31,2022-07-18,6194,6201,6199,2,54688,54749,54733,16,199,12,12,30,2422,2422,2410,2410
Santa Cruz,31,2022-07-18,874,874,873,1,7449,7457,7452,5,24,1,1,2,268,268,267,267
Shasta,31,2022-07-18,320,320,320,0,3209,3213,3210,3,40,3,3,3,579,579,576,576
Siskiyou,31,2022-07-18,34,34,34,0,345,346,345,1,3,0,0,0,86,86,86,86
Solano,31,2022-07-18,1246,1246,1245,1,9543,9553,9545,8,49,1,1,6,455,455,454,454
Sonoma,31,2022-07-18,1055,1055,1054,1,8749,8759,8752,7,44,0,0,5,507,507,507,507
Stanislaus,31,2022-07-18,1395,1395,1393,2,8397,8406,8395,11,109,5,5,9,1729,1729,1724,1724
Sutter,31,2022-07-18,253,253,253,0,1673,1674,1673,1,0,0,0,0,228,228,228,228
Tehama,31,2022-07-18,110,110,110,0,896,896,895,1,7,2,2,0,211,211,209,209
Trinity,31,2022-07-18,20,20,20,0,111,112,111,1,1,0,0,0,20,20,20,20
Tulare,31,2022-07-18,1188,1188,1186,2,8114,8122,8112,10,45,0,0,0,1519,1519,1519,1519
Tuolumne,31,2022-07-18,239,239,239,0,1142,1142,1141,1,7,4,4,0,195,195,191,191
Ventura,31,2022-07-18,2324,2325,2324,1,19561,19583,19572,11,92,4,4,7,1540,1540,1536,1536
Yolo,31,2022-07-18,430,430,430,0,4652,4657,4654,3,2,3,3,1,376,376,373,373
Yuba,31,2022-07-18,213,213,213,0,1292,1292,1291,1,18,0,0,0,121,121,121,121
Alameda,32,2022-07-25,4409,4414,4412,2,40433,40480,40460,20,143,12,12,19,1972,1972,1960,1960
Amador,32,2022-07-25,90,90,90,0,1206,1206,1205,1,3,0,0,1,87,87,87,87
Butte,32,2022-07-25,359,359,359,0,2945,2949,2948,1,30,1,1,2,453,453,452,452
Calaveras,32,2022-07-25,82,82,82,0,558,559,558,1,0,2,2,1,131,131,129,129
Colusa,32,2022-07-25,26,26,26,0,373,374,373,1,1,0,0,0,22,22,22,22
Contra Costa,32,2022-07-25,2827,2830,2828,2,21984,22010,21991,19,102,7,7,18,1402,1402,1395,1395
Del Norte,32,2022-07-25,67,67,67,0,534,535,534,1,6,0,0,0,53,53,53,53
El Dorado,32,2022-07-25,270,270,270,0,2485,2487,2485,2,9,1,1,0,228,228,227,227
Fresno,32,2022-07-25,3359,3364,3361,3,20377,20401,20385,16,195,6,6,29,2819,2819,2813,2813
Glenn,32,2022-07-25,31,31,31,0,271,272,271,1,0,0,0,0,53,53,53,53
Humboldt,32,2022-07-25,230,230,230,0,1923,1923,1922,1,13,2,2,4,156,156,154,154
Imperial,32,2022-07-25,872,872,871,1,4338,4343,4340,3,18,1,1,6,952,952,951,951
Inyo,32,2022-07-25,18,18,18,0,284,285,284,1,2,1,1,0,58,58,57,57
Kern,32,2022-07-25,1930,1930,1929,1,15241,15259,15250,9,82,3,3,12,2384,2384,2381,2381
Kings,32,2022-07-25,571,571,571,0,3888,3893,3890,3,15,1,1,0,458,458,457,457
Lake,32,2022-07-25,128,128,128,0,1041,1041,1040,1,5,1,1,2,143,143,142,142
Lassen,32,2022-07-25,53,53,53,0,1071,1071,1070,1,1,0,0,0,63,63,63,63
Los Angeles,32,2022-07-25,37131,37175,37168,7,334170,334562,334495,67,1152,121,121,134,32711,32711,32590,32590
Madera,32,2022-07-25,539,539,539,0,3829,3834,3831,3,11,1,1,5,371,371,370,370
Marin,32,2022-07-25,489,489,489,0,5418,5424,5420,4,26,2,2,2,308,308,306,306
Mariposa,32,2022-07-25,40,40,40,0,232,233,232,1,0,0,0,0,29,29,29,29
Mendocino,32,2022-07-25,196,196,196,0,1426,1426,1424,2,6,0,0,0,133,133,133,133
Merced,32,2022-07-25,731,731,731,0,3917,3922,3920,2,22,2,2,2,843,843,841,841
Modoc,32,2022-07-25,5,5,5,0,28,29,28,1,0,1,1,0,9,9,8,8
Mono,32,2022-07-25,15,15,15,0,85,86,85,1,0,0,0,0,7,7,7,7
Monterey,32,2022-07-25,933,933,932,1,7142,7151,7142,9,39,1,1,3,758,758,757,757
Napa,32,2022-07-25,298,298,298,0,2946,2950,2948,2,6,3,3,0,154,154,151,151
Nevada,32,2022-07-25,116,116,116,0,1316,1316,1315,1,3,1,1,0,135,135,134,134
Orange,32,2022-07-25,8063,8074,8070,4,58192,58262,58235,27,306,37,37,35,7327,7327,7290,7290
Placer,32,2022-07-25,606,606,605,1,5086,5091,5087,4,77,5,5,11,651,651,646,646
Plumas,32,2022-07-25,25,25,25,0,188,189,188,1,0,0,0,0,13,13,13,13
Riverside,32,2022-07-25,7518,7527,7522,5,45939,45993,45964,29,259,16,16,27,6560,6560,6544,6544
Sacramento,32,2022-07-25,3633,3638,3636,2,29836,29871,29851,20,207,18,18,32,3222,3222,3204,3204
San Benito,32,2022-07-25,201,201,201,0,1836,1837,1836,1,0,1,1,0,97,97,96,96
San Bernardino,32,2022-07-25,7100,7108,7104,4,52150,52212,52186,26,214,30,30,23,7961,7961,7931,7931
San Diego,32,2022-07-25,11893,11906,11903,3,76181,76272,76256,16,393,19,19,41,5474,5474,5455,5455
San Francisco,32,2022-07-25,2298,2299,2296,3,24270,24298,24264,34,126,9,9,24,975,975,966,966
San Joaquin,32,2022-07-25,1838,1838,1837,1,16572,16591,16579,12,73,5,5,9,2294,2294,2289,2289
San Luis Obispo,32,2022-07-25,539,539,539,0,4382,4387,4384,3,16,4,4,1,511,511,507,507
San Mateo,32,2022-07-25,2030,2030,2029,1,21689,21715,21705,10,57,1,1,7,734,734,733,733
Santa Barbara,32,2022-07-25,1178,1178,1177,1,8770,8781,8775,6,37,4,4,3,715,715,711,711
Santa Clara,32,2022-07-25,5772,5779,5778,1,50882,50942,50931,11,238,16,16,26,2438,2438,2422,2422
Santa Cruz,32,2022-07-25,832,832,832,0,7665,7674,7670,4,23,0,0,0,268,268,268,268
Shasta,32,2022-07-25,306,306,306,0,3079,3082,3080,2,38,2,2,6,581,581,579,579
Siskiyou,32,2022-07-25,36,36,36,0,333,334,333,1,1,0,0,0,86,86,86,86
Solano,32,2022-07-25,1203,1203,1202,1,9483,9494,9488,6,56,0,0,5,455,455,455,455
Sonoma,32,2022-07-25,1066,1066,1065,1,8654,8666,8661,5,48,2,2,4,509,509,507,507
Stanislaus,32,2022-07-25,1377,1377,1376,1,8160,8169,8161,8,104,8,8,11,1737,1737,1729,1729
Sutter,32,2022-07-25,222,222,222,0,1723,1724,1723,1,0,0,0,0,228,228,228,228
Tehama,32,2022-07-25,103,103,103,0,920,920,919,1,5,2,2,0,213,213,211,211
Trinity,32,2022-07-25,12,12,12,0,102,103,102,1,0,0,0,0,20,20,20,20
Tulare,32,2022-07-25,1145,1145,1144,1,8044,8052,8044,8,42,2,2,2,1521,1521,1519,1519
Tuolumne,32,2022-07-25,200,200,200,0,1150,1150,1149,1,5,1,1,0,196,196,195,195
Ventura,32,2022-07-25,2153,2153,2152,1,18389,18410,18402,8,76,5,5,8,1545,1545,1540,1540
Yolo,32,2022-07-25,414,414,414,0,4390,4395,4393,2,4,3,3,1,379,379,376,376
Yuba,32,2022-07-25,175,175,175,0,1282,1282,1281,1,15,0,0,0,121,121,121,121
Alameda,33,2022-08-01,3824,3829,3828,1,37193,37240,37225,15,176,8,8,21,1980,1980,1972,1972
Amador,33,2022-08-01,53,53,53,0,1133,1133,1132,1,3,1,1,0,88,88,87,87
Butte,33,2022-08-01,368,368,368,0,2841,2844,2843,1,33,2,2,3,455,455,453,453
Calaveras,33,2022-08-01,68,68,68,0,573,574,573,1,2,1,1,2,132,132,131,131
Colusa,33,2022-08-01,26,26,26,0,362,363,362,1,7,0,0,0,22,22,22,22
Contra Costa,33,2022-08-01,2627,2630,2628,2,21020,21047,21033,14,86,13,13,15,1415,1415,1402,1402
Del Norte,33,2022-08-01,53,53,53,0,476,477,476,1,4,0,0,2,53,53,53,53
El Dorado,33,2022-08-01,232,232,232,0,2456,2459,2458,1,4,3,3,2,231,231,228,228
Fresno,33,2022-08-01,2999,3004,3002,2,18294,18315,18304,11,231,10,10,16,2829,2829,2819,2819
Glenn,33,2022-08-01,28,28,28,0,251,252,251,1,0,0,0,0,53,53,53,53
Humboldt,33,2022-08-01,224,224,224,0,1880,1880,1879,1,12,0,0,3,156,156,156,156
Imperial,33,2022-08-01,636,636,636,0,3526,3531,3529,2,22,5,5,3,957,957,952,952
Inyo,33,2022-08-01,20,20,20,0,280,281,280,1,2,0,0,0,58,58,58,58
Kern,33,2022-08-01,1729,1729,1728,1,15102,15120,15113,7,81,6,6,17,2390,2390,2384,2384
Kings,33,2022-08-01,624,624,624,0,4044,4049,4047,2,6,0,0,1,458,458,458,458
Lake,33,2022-08-01,125,125,125,0,994,994,993,1,7,0,0,2,143,143,143,143
Lassen,33,2022-08-01,103,103,103,0,947,949,948,1,0,0,0,0,63,63,63,63
Los Angeles,33,2022-08-01,30608,30645,30640,5,308962,309338,309290,48,1105,129,129,137,32840,32840,32711,32711
Madera,33,2022-08-01,463,463,463,0,3481,3485,3483,2,10,0,0,7,371,371,371,371
Marin,33,2022-08-01,411,411,411,0,5134,5140,5137,3,32,1,1,4,309,309,308,308
Mariposa,33,2022-08-01,22,22,22,0,225,226,225,1,0,0,0,0,29,29,29,29
Mendocino,33,2022-08-01,174,174,174,0,1257,1257,1256,1,6,1,1,1,134,134,133,133
Merced,33,2022-08-01,643,643,643,0,3566,3571,3569,2,22,6,6,2,849,849,843,843
Modoc,33,2022-08-01,16,16,16,0,31,32,31,1,0,0,0,0,9,9,9,9
Mono,33,2022-08-01,9,9,9,0,67,68,67,1,0,0,0,0,7,7,7,7
Monterey,33,2022-08-01,930,930,929,1,6430,6437,6431,6,33,2,2,1,760,760,758,758
Napa,33,2022-08-01,287,287,287,0,2853,2858,2857,1,8,0,0,2,154,154,154,154
Nevada,33,2022-08-01,125,125,125,0,1404,1404,1403,1,12,0,0,0,135,135,135,135
Orange,33,2022-08-01,6539,6547,6545,2,52466,52529,52510,19,246,34,34,49,7361,7361,7327,7327
Placer,33,2022-08-01,588,588,588,0,4744,4750,4747,3,71,1,1,11,652,652,651,651
Plumas,33,2022-08-01,23,23,23,0,162,163,162,1,0,0,0,0,13,13,13,13
Riverside,33,2022-08-01,6128,6135,6132,3,42292,42345,42324,21,200,5,5,23,6565,6565,6560,6560
Sacramento,33,2022-08-01,3098,3103,3101,2,27845,27879,27864,15,179,18,18,26,3240,3240,3222,3222
San Benito,33,2022-08-01,177,177,177,0,1561,1561,1560,1,2,1,1,0,98,98,97,97
San Bernardino,33,2022-08-01,6072,6079,6077,2,48925,48986,48967,19,184,26,26,23,7987,7987,7961,7961
San Diego,33,2022-08-01,9366,9378,9376,2,68651,68734,68723,11,396,16,16,46,5490,5490,5474,5474
San Francisco,33,2022-08-01,1815,1815,1813,2,21993,22020,21996,24,105,13,13,20,988,988,975,975
San Joaquin,33,2022-08-01,1734,1734,1733,1,16113,16133,16124,9,69,7,7,11,2301,2301,2294,2294
San Luis Obispo,33,2022-08-01,578,578,578,0,4141,4146,4144,2,14,3,3,0,514,514,511,511
San Mateo,33,2022-08-01,1774,1774,1773,1,20333,20358,20351,7,67,1,1,3,735,735,734,734
Santa Barbara,33,2022-08-01,1119,1119,1118,1,7779,7789,7785,4,40,1,1,3,716,716,715,715
Santa Clara,33,2022-08-01,4827,4834,4833,1,45490,45545,45537,8,230,19,19,36,2457,2457,2438,2438
Santa Cruz,33,2022-08-01,748,748,748,0,6877,6885,6882,3,20,1,1,3,269,269,268,268
Shasta,33,2022-08-01,247,247,247,0,2968,2971,2969,2,34,1,1,7,582,582,581,581
Siskiyou,33,2022-08-01,29,29,29,0,298,299,298,1,2,0,0,0,86,86,86,86
Solano,33,2022-08-01,1146,1146,1145,1,9147,9158,9153,5,53,0,0,4,455,455,455,455
Sonoma,33,2022-08-01,921,921,921,0,8186,8197,8193,4,46,3,3,3,512,512,509,509
Stanislaus,33,2022-08-01,1233,1233,1232,1,7720,7730,7724,6,115,6,6,8,1743,1743,1737,1737
Sutter,33,2022-08-01,232,232,232,0,1634,1635,1634,1,0,3,3,0,231,231,228,228
Tehama,33,2022-08-01,89,89,89,0,757,757,756,1,4,0,0,0,213,213,213,213
Trinity,33,2022-08-01,11,11,11,0,71,72,71,1,0,1,1,0,21,21,20,20
Tulare,33,2022-08-01,1035,1035,1034,1,7478,7486,7480,6,46,1,1,3,1522,1522,1521,1521
Tuolumne,33,2022-08-01,144,144,144,0,1111,1111,1110,1,4,0,0,1,196,196,196,196
Ventura,33,2022-08-01,1808,1808,1807,1,16970,16991,16985,6,75,10,10,10,1555,1555,1545,1545
Yolo,33,2022-08-01,334,334,334,0,4177,4182,4180,2,3,3,3,1,382,382,379,379
Yuba,33,2022-08-01,159,159,159,0,1215,1215,1214,1,10,0,0,3,121,121,121,121
Alameda,34,2022-08-08,3318,3323,3322,1,35422,35467,35456,11,133,15,15,20,1995,1995,1980,1980
Amador,34,2022-08-08,50,50,50,0,852,853,852,1,3,0,0,1,88,88,88,88
Butte,34,2022-08-08,334,334,334,0,2494,2497,2496,1,33,1,1,1,456,456,455,455
Calaveras,34,2022-08-08,57,57,57,0,559,560,559,1,1,1,1,0,133,133,132,132
Colusa,34,2022-08-08,15,15,15,0,362,363,362,1,0,0,0,0,22,22,22,22
Contra Costa,34,2022-08-08,2178,2179,2178,1,19805,19830,19820,10,102,4,4,14,1419,1419,1415,1415
Del Norte,34,2022-08-08,49,49,49,0,498,499,498,1,4,1,1,1,54,54,53,53
El Dorado,34,2022-08-08,191,191,191,0,2317,2319,2318,1,4,0,0,2,231,231,231,231
Fresno,34,2022-08-08,2420,2424,2423,1,17743,17766,17757,9,207,9,9,25,2838,2838,2829,2829
Glenn,34,2022-08-08,22,22,22,0,249,250,249,1,0,0,0,0,53,53,53,53
Humboldt,34,2022-08-08,208,208,208,0,1920,1920,1919,1,12,1,1,2,157,157,156,156
Imperial,34,2022-08-08,548,548,548,0,3279,3284,3283,1,16,2,2,2,959,959,957,957
Inyo,34,2022-08-08,8,8,8,0,276,277,276,1,1,0,0,1,58,58,58,58
Kern,34,2022-08-08,1339,1339,1339,0,13982,14001,13996,5,61,6,6,16,2396,2396,2390,2390
Kings,34,2022-08-08,467,467,467,0,3326,3331,3330,1,20,1,1,2,459,459,458,458
Lake,34,2022-08-08,106,106,106,0,893,894,893,1,4,0,0,1,143,143,143,143
Lassen,34,2022-08-08,132,132,132,0,1023,1024,1023,1,1,0,0,0,63,63,63,63
Los Angeles,34,2022-08-08,25786,25819,25816,3,293383,293753,293718,35,1030,129,129,121,32969,32969,32840,32840
Madera,34,2022-08-08,380,380,380,0,3175,3179,3177,2,16,0,0,3,371,371,371,371
Marin,34,2022-08-08,361,361,361,0,4485,4491,4489,2,26,2,2,2,311,311,309,309
Mariposa,34,2022-08-08,28,28,28,0,197,198,197,1,0,0,0,0,29,29,29,29
Mendocino,34,2022-08-08,132,132,132,0,1128,1128,1127,1,3,1,1,1,135,135,134,134
Merced,34,2022-08-08,538,538,538,0,3396,3401,3400,1,17,1,1,5,850,850,849,849
Modoc,34,2022-08-08,2,2,2,0,22,23,22,1,0,0,0,0,9,9,9,9
Mono,34,2022-08-08,10,10,10,0,85,86,85,1,0,0,0,0,7,7,7,7
Monterey,34,2022-08-08,737,737,736,1,5773,5779,5775,4,28,1,1,0,761,761,760,760
Napa,34,2022-08-08,263,263,263,0,2629,2633,2632,1,10,2,2,3,156,156,154,154
Nevada,34,2022-08-08,94,94,94,0,1290,1290,1289,1,4,0,0,0,135,135,135,135
Orange,34,2022-08-08,5474,5481,5479,2,49031,49091,49077,14,242,29,29,40,7390,7390,7361,7361
Placer,34,2022-08-08,513,513,513,0,4519,4525,4523,2,65,3,3,9,655,655,652,652
Plumas,34,2022-08-08,23,23,23,0,190,191,190,1,1,0,0,0,13,13,13,13
Riverside,34,2022-08-08,5569,5576,5574,2,40851,40904,40888,16,174,13,13,13,6578,6578,6565,6565
Sacramento,34,2022-08-08,2625,2630,2629,1,26972,27007,26996,11,156,17,17,20,3257,3257,3240,3240
San Benito,34,2022-08-08,186,186,186,0,1433,1434,1433,1,1,0,0,0,98,98,98,98
San Bernardino,34,2022-08-08,5112,5119,5117,2,46298,46356,46342,14,204,20,20,15,8007,8007,7987,7987
San Diego,34,2022-08-08,7270,7280,7279,1,64802,64884,64876,8,337,11,11,30,5501,5501,5490,5490
San Francisco,34,2022-08-08,1495,1495,1494,1,20636,20661,20644,17,94,11,11,21,999,999,988,988
San Joaquin,34,2022-08-08,1522,1522,1521,1,15717,15736,15729,7,55,6,6,12,2307,2307,2301,2301
San Luis Obispo,34,2022-08-08,509,509,509,0,3613,3618,3617,1,14,0,0,2,514,514,514,514
San Mateo,34,2022-08-08,1527,1527,1527,0,18587,18610,18605,5,60,0,0,5,735,735,735,735
Santa Barbara,34,2022-08-08,964,964,964,0,7525,7535,7532,3,46,3,3,4,719,719,716,716
Santa Clara,34,2022-08-08,4184,4191,4190,1,41197,41248,41242,6,203,17,17,40,2474,2474,2457,2457
Santa Cruz,34,2022-08-08,619,619,619,0,6060,6067,6065,2,28,1,1,0,270,270,269,269
Shasta,34,2022-08-08,198,198,198,0,2833,2836,2835,1,33,1,1,3,583,583,582,582
Siskiyou,34,2022-08-08,27,27,27,0,291,292,291,1,0,1,1,0,87,87,86,86
Solano,34,2022-08-08,883,883,883,0,7969,7979,7976,3,54,0,0,9,455,455,455,455
Sonoma,34,2022-08-08,840,840,840,0,7727,7738,7735,3,34,4,4,3,516,516,512,512
Stanislaus,34,2022-08-08,1035,1035,1034,1,7175,7184,7180,4,90,7,7,11,1750,1750,1743,1743
Sutter,34,2022-08-08,223,223,223,0,1552,1553,1552,1,0,0,0,0,231,231,231,231
Tehama,34,2022-08-08,78,78,78,0,681,682,681,1,0,0,0,1,213,213,213,213
Trinity,34,2022-08-08,5,5,5,0,71,72,71,1,0,0,0,0,21,21,21,21
Tulare,34,2022-08-08,886,886,885,1,7339,7347,7343,4,46,4,4,3,1526,1526,1522,1522
Tuolumne,34,2022-08-08,118,118,118,0,1054,1054,1053,1,4,2,2,0,198,198,196,196
Ventura,34,2022-08-08,1503,1503,1503,0,15933,15952,15948,4,67,7,7,7,1562,1562,1555,1555
Yolo,34,2022-08-08,287,287,287,0,3882,3887,3886,1,4,1,1,3,383,383,382,382
Yuba,34,2022-08-08,136,136,136,0,1086,1087,1086,1,6,1,1,0,122,122,121,121
Alameda,35,2022-08-15,2595,2599,2598,1,33887,33931,33923,8,105,9,9,22,2004,2004,1995,1995
Amador,35,2022-08-15,47,47,47,0,848,849,848,1,2,0,0,0,88,88,88,88
Butte,35,2022-08-15,262,262,262,0,2245,2249,2248,1,19,0,0,2,456,456,456,456
Calaveras,35,2022-08-15,46,46,46,0,528,529,528,1,0,0,0,0,133,133,133,133
Colusa,35,2022-08-15,16,16,16,0,359,360,359,1,1,0,0,0,22,22,22,22
Contra Costa,35,2022-08-15,1778,1778,1777,1,18972,18997,18989,8,72,7,7,9,1426,1426,1419,1419
Del Norte,35,2022-08-15,53,53,53,0,499,500,499,1,2,0,0,1,54,54,54,54
El Dorado,35,2022-08-15,178,178,178,0,2304,2306,2305,1,5,0,0,3,231,231,231,231
Fresno,35,2022-08-15,1871,1871,1870,1,16162,16183,16177,6,170,7,7,17,2845,2845,2838,2838
Glenn,35,2022-08-15,15,15,15,0,225,226,225,1,3,0,0,0,53,53,53,53
Humboldt,35,2022-08-15,179,179,179,0,1587,1588,1587,1,16,0,0,2,157,157,157,157
Imperial,35,2022-08-15,365,365,365,0,3101,3106,3105,1,11,0,0,2,959,959,959,959
Inyo,35,2022-08-15,14,14,14,0,238,239,238,1,2,1,1,0,59,59,58,58
Kern,35,2022-08-15,1238,1238,1238,0,13701,13720,13716,4,59,7,7,16,2403,2403,2396,2396
Kings,35,2022-08-15,332,332,332,0,3235,3240,3239,1,9,0,0,1,459,459,459,459
Lake,35,2022-08-15,104,104,104,0,1028,1029,1028,1,3,1,1,2,144,144,143,143
Lassen,35,2022-08-15,59,59,59,0,898,899,898,1,0,0,0,0,63,63,63,63
Los Angeles,35,2022-08-15,20954,20982,20980,2,289559,289935,289908,27,905,110,110,117,33079,33079,32969,32969
Madera,35,2022-08-15,305,305,305,0,2954,2958,2957,1,12,0,0,3,371,371,371,371
Marin,35,2022-08-15,295,295,295,0,4114,4119,4117,2,15,0,0,0,311,311,311,311
Mariposa,35,2022-08-15,15,15,15,0,192,193,192,1,0,0,0,0,29,29,29,29
Mendocino,35,2022-08-15,104,104,104,0,996,996,995,1,7,0,0,3,135,135,135,135
Merced,35,2022-08-15,453,453,453,0,3427,3432,3431,1,12,2,2,1,852,852,850,850
Modoc,35,2022-08-15,4,4,4,0,23,24,23,1,0,0,0,0,9,9,9,9
Mono,35,2022-08-15,4,4,4,0,61,62,61,1,0,0,0,0,7,7,7,7
Monterey,35,2022-08-15,662,662,662,0,5824,5831,5828,3,30,0,0,1,761,761,761,761
Napa,35,2022-08-15,212,212,212,0,2291,2295,2294,1,13,0,0,0,156,156,156,156
Nevada,35,2022-08-15,98,98,98,0,1209,1210,1209,1,7,0,0,0,135,135,135,135
Orange,35,2022-08-15,4684,4691,4690,1,43770,43827,43817,10,270,31,31,44,7421,7421,7390,7390
Placer,35,2022-08-15,411,411,411,0,4469,4475,4473,2,61,1,1,11,656,656,655,655
Plumas,35,2022-08-15,17,17,17,0,184,185,184,1,0,0,0,0,13,13,13,13
Riverside,35,2022-08-15,4600,4607,4606,1,38262,38310,38299,11,143,16,16,22,6594,6594,6578,6578
Sacramento,35,2022-08-15,2359,2362,2361,1,25434,25467,25459,8,149,12,12,22,3269,3269,3257,3257
San Benito,35,2022-08-15,140,140,140,0,1336,1337,1336,1,3,1,1,1,99,99,98,98
San Bernardino,35,2022-08-15,4738,4745,4744,1,44509,44567,44556,11,144,14,14,22,8021,8021,8007,8007
San Diego,35,2022-08-15,5502,5509,5508,1,59795,59873,59867,6,288,14,14,34,5515,5515,5501,5501
San Francisco,35,2022-08-15,1267,1267,1266,1,19588,19612,19599,13,103,15,15,11,1014,1014,999,999
San Joaquin,35,2022-08-15,1443,1443,1442,1,15216,15235,15230,5,64,8,8,8,2315,2315,2307,2307
San Luis Obispo,35,2022-08-15,325,325,325,0,3302,3307,3306,1,15,4,4,3,518,518,514,514
San Mateo,35,2022-08-15,1235,1235,1235,0,17463,17486,17482,4,56,1,1,5,736,736,735,735
Santa Barbara,35,2022-08-15,831,831,831,0,7130,7140,7138,2,44,1,1,4,720,720,719,719
Santa Clara,35,2022-08-15,3399,3404,3404,0,40109,40163,40159,4,200,8,8,24,2482,2482,2474,2474
Santa Cruz,35,2022-08-15,493,493,493,0,7545,7554,7552,2,23,3,3,1,273,273,270,270
Shasta,35,2022-08-15,194,194,194,0,2788,2791,2790,1,19,1,1,1,584,584,583,583
Siskiyou,35,2022-08-15,19,19,19,0,284,285,284,1,3,0,0,1,87,87,87,87
Solano,35,2022-08-15,662,662,662,0,7461,7471,7469,2,45,0,0,10,455,455,455,455
Sonoma,35,2022-08-15,632,632,632,0,7289,7299,7297,2,39,2,2,2,518,518,516,516
Stanislaus,35,2022-08-15,940,940,940,0,7658,7669,7665,4,99,9,9,11,1759,1759,1750,1750
Sutter,35,2022-08-15,197,197,197,0,1587,1589,1588,1,0,1,1,0,232,232,231,231
Tehama,35,2022-08-15,60,60,60,0,645,646,645,1,1,0,0,0,213,213,213,213
Trinity,35,2022-08-15,8,8,8,0,58,59,58,1,0,0,0,0,21,21,21,21
Tulare,35,2022-08-15,736,736,736,0,7348,7357,7354,3,32,3,3,1,1529,1529,1526,1526
Tuolumne,35,2022-08-15,110,110,110,0,991,992,991,1,1,0,0,0,198,198,198,198
Ventura,35,2022-08-15,1494,1494,1494,0,15264,15282,15279,3,70,6,6,7,1568,1568,1562,1562
Yolo,35,2022-08-15,264,264,264,0,3539,3544,3543,1,2,4,4,1,387,387,383,383
Yuba,35,2022-08-15,128,128,128,0,1080,1081,1080,1,9,0,0,0,122,122,122,122
Alameda,36,2022-08-22,2263,2265,2265,0,33319,33364,33358,6,117,9,9,21,2013,2013,2004,2004
Amador,36,2022-08-22,49,49,49,0,817,818,817,1,2,1,1,0,89,89,88,88
Butte,36,2022-08-22,222,222,222,0,2131,2135,2134,1,17,1,1,2,457,457,456,456
Calaveras,36,2022-08-22,43,43,43,0,572,573,572,1,1,0,0,0,133,133,133,133
Colusa,36,2022-08-22,16,16,16,0,394,395,394,1,0,0,0,0,22,22,22,22
Contra Costa,36,2022-08-22,1531,1531,1531,0,18846,18871,18865,6,56,5,5,9,1431,1431,1426,1426
Del Norte,36,2022-08-22,32,32,32,0,462,463,462,1,3,1,1,0,55,55,54,54
El Dorado,36,2022-08-22,152,152,152,0,2220,2222,2221,1,4,1,1,0,232,232,231,231
Fresno,36,2022-08-22,1597,1597,1597,0,15770,15790,15785,5,162,6,6,14,2851,2851,2845,2845
Glenn,36,2022-08-22,23,23,23,0,227,228,227,1,1,0,0,0,53,53,53,53
Humboldt,36,2022-08-22,151,151,151,0,1679,1680,1679,1,6,1,1,3,158,158,157,157
Imperial,36,2022-08-22,291,291,291,0,2844,2849,2848,1,15,0,0,0,959,959,959,959
Inyo,36,2022-08-22,8,8,8,0,214,215,214,1,0,0,0,0,59,59,59,59
Kern,36,2022-08-22,999,999,999,0,13976,13995,13992,3,69,6,6,10,2409,2409,2403,2403
Kings,36,2022-08-22,369,369,369,0,3636,3641,3640,1,10,2,2,0,461,461,459,459
Lake,36,2022-08-22,104,104,104,0,884,885,884,1,5,0,0,0,144,144,144,144
Lassen,36,2022-08-22,37,37,37,0,834,835,834,1,0,0,0,0,63,63,63,63
Los Angeles,36,2022-08-22,18495,18519,18518,1,276820,277189,277169,20,811,122,122,104,33201,33201,33079,33079
Madera,36,2022-08-22,300,300,300,0,2613,2617,2616,1,14,2,2,4,373,373,371,371
Marin,36,2022-08-22,250,250,250,0,3968,3973,3972,1,17,0,0,3,311,311,311,311
Mariposa,36,2022-08-22,14,14,14,0,172,173,172,1,0,0,0,0,29,29,29,29
Mendocino,36,2022-08-22,121,121,121,0,1145,1146,1145,1,3,0,0,2,135,135,135,135
Merced,36,2022-08-22,447,447,447,0,3659,3664,3663,1,12,4,4,1,856,856,852,852
Modoc,36,2022-08-22,6,6,6,0,27,28,27,1,0,0,0,0,9,9,9,9
Mono,36,2022-08-22,4,4,4,0,63,64,63,1,0,0,0,0,7,7,7,7
Monterey,36,2022-08-22,549,549,549,0,5928,5935,5932,3,27,1,1,2,762,762,761,761
Napa,36,2022-08-22,127,127,127,0,2010,2012,2011,1,5,2,2,1,158,158,156,156
Nevada,36,2022-08-22,84,84,84,0,1180,1181,1180,1,6,0,0,0,135,135,135,135
Orange,36,2022-08-22,3926,3932,3931,1,41464,41520,41513,7,224,21,21,35,7442,7442,7421,7421
Placer,36,2022-08-22,384,384,384,0,4307,4313,4312,1,61,1,1,14,657,657,656,656
Plumas,36,2022-08-22,20,20,20,0,175,176,175,1,1,0,0,0,13,13,13,13
Riverside,36,2022-08-22,4421,4428,4427,1,37725,37776,37767,9,142,14,14,19,6608,6608,6594,6594
Sacramento,36,2022-08-22,2089,2090,2089,1,25029,25062,25056,6,144,15,15,25,3284,3284,3269,3269
San Benito,36,2022-08-22,102,102,102,0,1268,1269,1268,1,1,1,1,1,100,100,99,99
San Bernardino,36,2022-08-22,4696,4703,4702,1,44669,44730,44722,8,160,18,18,22,8039,8039,8021,8021
San Diego,36,2022-08-22,4783,4790,4790,0,57818,57896,57892,4,287,6,6,28,5521,5521,5515,5515
San Francisco,36,2022-08-22,1097,1097,1096,1,18875,18900,18890,10,81,16,16,12,1030,1030,1014,1014
San Joaquin,36,2022-08-22,1195,1195,1195,0,15725,15745,15741,4,56,1,1,8,2316,2316,2315,2315
San Luis Obispo,36,2022-08-22,259,259,259,0,3090,3095,3094,1,16,1,1,0,519,519,518,518
San Mateo,36,2022-08-22,1028,1028,1028,0,17321,17344,17341,3,42,0,0,2,736,736,736,736
Santa Barbara,36,2022-08-22,736,736,736,0,7443,7454,7452,2,37,1,1,2,721,721,720,720
Santa Clara,36,2022-08-22,3079,3084,3084,0,40561,40615,40612,3,173,10,10,27,2492,2492,2482,2482
Santa Cruz,36,2022-08-22,502,502,502,0,11965,11981,11979,2,13,0,0,0,273,273,273,273
Shasta,36,2022-08-22,174,174,174,0,2760,2763,2762,1,10,2,2,2,586,586,584,584
Siskiyou,36,2022-08-22,25,25,25,0,249,250,249,1,4,1,1,2,88,88,87,87
Solano,36,2022-08-22,534,534,534,0,7222,7232,7230,2,35,0,0,12,455,455,455,455
Sonoma,36,2022-08-22,605,605,605,0,7374,7385,7383,2,42,1,1,1,519,519,518,518
Stanislaus,36,2022-08-22,894,894,894,0,7651,7663,7660,3,79,7,7,16,1766,1766,1759,1759
Sutter,36,2022-08-22,189,189,189,0,1657,1659,1658,1,0,0,0,0,232,232,232,232
Tehama,36,2022-08-22,54,54,54,0,629,630,629,1,1,0,0,0,213,213,213,213
Trinity,36,2022-08-22,10,10,10,0,63,64,63,1,0,0,0,0,21,21,21,21
Tulare,36,2022-08-22,731,731,731,0,6804,6812,6810,2,33,4,4,1,1533,1533,1529,1529
Tuolumne,36,2022-08-22,106,106,106,0,1018,1019,1018,1,0,1,1,0,199,199,198,198
Ventura,36,2022-08-22,1319,1319,1319,0,15001,15019,15017,2,59,4,4,9,1572,1572,1568,1568
Yolo,36,2022-08-22,200,200,200,0,3491,3496,3495,1,10,1,1,1,388,388,387,387
Yuba,36,2022-08-22,127,127,127,0,1106,1107,1106,1,13,0,0,3,122,122,122,122
Alameda,37,2022-08-29,2002,2002,2002,0,34349,34396,34391,5,99,11,11,20,2024,2024,2013,2013
Amador,37,2022-08-29,46,46,46,0,804,805,804,1,2,1,1,0,90,90,89,89
Butte,37,2022-08-29,236,236,236,0,2173,2177,2176,1,18,0,0,3,457,457,457,457
Calaveras,37,2022-08-29,59,59,59,0,593,594,593,1,1,0,0,0,133,133,133,133
Colusa,37,2022-08-29,11,11,11,0,329,330,329,1,3,0,0,0,22,22,22,22
Contra Costa,37,2022-08-29,1359,1359,1359,0,18807,18833,18828,5,44,5,5,7,1436,1436,1431,1431
Del Norte,37,2022-08-29,28,28,28,0,432,433,432,1,5,0,0,1,55,55,55,55
El Dorado,37,2022-08-29,143,143,143,0,1947,1949,1948,1,1,0,0,1,232,232,232,232
Fresno,37,2022-08-29,1419,1419,1419,0,15724,15746,15742,4,159,3,3,15,2854,2854,2851,2851
Glenn,37,2022-08-29,22,22,22,0,220,221,220,1,1,0,0,0,53,53,53,53
Humboldt,37,2022-08-29,124,124,124,0,1664,1665,1664,1,4,0,0,0,158,158,158,158
Imperial,37,2022-08-29,294,294,294,0,2936,2941,2940,1,14,1,1,2,960,960,959,959
Inyo,37,2022-08-29,8,8,8,0,176,177,176,1,0,0,0,0,59,59,59,59
Kern,37,2022-08-29,906,906,906,0,13447,13466,13464,2,50,0,0,8,2409,2409,2409,2409
Kings,37,2022-08-29,314,314,314,0,3490,3495,3494,1,8,0,0,0,461,461,461,461
Lake,37,2022-08-29,93,93,93,0,870,871,870,1,1,1,1,0,145,145,144,144
Lassen,37,2022-08-29,28,28,28,0,772,773,772,1,0,0,0,0,63,63,63,63
Los Angeles,37,2022-08-29,15569,15591,15590,1,273765,274143,274127,16,753,87,87,83,33288,33288,33201,33201
Madera,37,2022-08-29,302,302,302,0,3019,3023,3022,1,13,0,0,3,373,373,373,373
Marin,37,2022-08-29,215,215,215,0,3848,3853,3852,1,16,2,2,2,313,313,311,311
Mariposa,37,2022-08-29,25,25,25,0,186,187,186,1,0,0,0,0,29,29,29,29
Mendocino,37,2022-08-29,87,87,87,0,969,970,969,1,2,0,0,1,135,135,135,135
Merced,37,2022-08-29,393,393,393,0,3418,3423,3422,1,11,3,3,0,859,859,856,856
Modoc,37,2022-08-29,1,1,1,0,30,31,30,1,0,0,0,0,9,9,9,9
Mono,37,2022-08-29,2,2,2,0,45,46,45,1,0,0,0,0,7,7,7,7
Monterey,37,2022-08-29,395,395,395,0,5383,5389,5387,2,33,2,2,5,764,764,762,762
Napa,37,2022-08-29,130,130,130,0,2168,2172,2171,1,10,0,0,1,158,158,158,158
Nevada,37,2022-08-29,116,116,116,0,1206,1208,1207,1,6,0,0,0,135,135,135,135
Orange,37,2022-08-29,3064,3069,3069,0,39990,40046,40041,5,195,18,18,25,7460,7460,7442,7442
Placer,37,2022-08-29,370,370,370,0,4217,4223,4222,1,55,1,1,12,658,658,657,657
Plumas,37,2022-08-29,17,17,17,0,159,160,159,1,1,0,0,0,13,13,13,13
Riverside,37,2022-08-29,3677,3682,3681,1,37023,37073,37066,7,124,9,9,11,6617,6617,6608,6608
Sacramento,37,2022-08-29,1881,1881,1881,0,24822,24856,24851,5,137,11,11,20,3295,3295,3284,3284
San Benito,37,2022-08-29,120,120,120,0,1410,1411,1410,1,1,0,0,0,100,100,100,100
San Bernardino,37,2022-08-29,3681,3686,3685,1,42584,42643,42637,6,156,14,14,18,8053,8053,8039,8039
San Diego,37,2022-08-29,3932,3938,3938,0,56925,57003,57000,3,222,12,12,25,5533,5533,5521,5521
San Francisco,37,2022-08-29,872,872,872,0,19155,19182,19174,8,57,7,7,12,1037,1037,1030,1030
San Joaquin,37,2022-08-29,1005,1005,1005,0,14298,14317,14314,3,27,5,5,11,2321,2321,2316,2316
San Luis Obispo,37,2022-08-29,326,326,326,0,3217,3222,3221,1,17,3,3,0,522,522,519,519
San Mateo,37,2022-08-29,872,872,872,0,16902,16926,16924,2,26,0,0,5,736,736,736,736
Santa Barbara,37,2022-08-29,638,638,638,0,7627,7638,7637,1,24,1,1,3,722,722,721,721
Santa Clara,37,2022-08-29,2357,2360,2360,0,40000,40057,40054,3,135,5,5,24,2497,2497,2492,2492
Santa Cruz,37,2022-08-29,385,385,385,0,12686,12704,12702,2,16,0,0,1,273,273,273,273
Shasta,37,2022-08-29,134,134,134,0,2578,2581,2580,1,19,1,1,1,587,587,586,586
Siskiyou,37,2022-08-29,24,24,24,0,249,250,249,1,0,1,1,0,89,89,88,88
Solano,37,2022-08-29,549,549,549,0,7290,7300,7299,1,33,1,1,8,456,456,455,455
Sonoma,37,2022-08-29,487,487,487,0,7108,7118,7117,1,37,1,1,4,520,520,519,519
Stanislaus,37,2022-08-29,850,850,850,0,8084,8096,8094,2,79,7,7,6,1773,1773,1766,1766
Sutter,37,2022-08-29,170,170,170,0,1638,1640,1639,1,0,0,0,0,232,232,232,232
Tehama,37,2022-08-29,67,67,67,0,738,739,738,1,4,0,0,1,213,213,213,213
Trinity,37,2022-08-29,9,9,9,0,56,57,56,1,0,0,0,0,21,21,21,21
Tulare,37,2022-08-29,683,683,683,0,7395,7405,7403,2,42,0,0,1,1533,1533,1533,1533
Tuolumne,37,2022-08-29,91,91,91,0,856,857,856,1,1,0,0,0,199,199,199,199
Ventura,37,2022-08-29,1021,1021,1021,0,14607,14626,14624,2,71,6,6,7,1578,1578,1572,1572
Yolo,37,2022-08-29,205,205,205,0,3716,3721,3720,1,5,0,0,3,388,388,388,388
Yuba,37,2022-08-29,135,135,135,0,1176,1177,1176,1,14,0,0,1,122,122,122,122
Alameda,38,2022-09-05,1467,1467,1467,0,28345,28386,28383,3,89,4,4,16,2028,2028,2024,2024
Amador,38,2022-09-05,44,44,44,0,748,749,748,1,3,0,0,2,90,90,90,90
Butte,38,2022-09-05,193,193,193,0,2125,2129,2128,1,14,2,2,2,459,459,457,457
Calaveras,38,2022-09-05,22,22,22,0,452,453,452,1,0,0,0,0,133,133,133,133
Colusa,38,2022-09-05,8,8,8,0,197,198,197,1,2,0,0,0,22,22,22,22
Contra Costa,38,2022-09-05,954,954,954,0,15436,15460,15457,3,62,5,5,9,1441,1441,1436,1436
Del Norte,38,2022-09-05,9,9,9,0,347,348,347,1,1,0,0,1,55,55,55,55
El Dorado,38,2022-09-05,91,91,91,0,1524,1526,1525,1,3,1,1,3,233,233,232,232
Fresno,38,2022-09-05,1087,1087,1087,0,13046,13065,13063,2,162,10,10,16,2864,2864,2854,2854
Glenn,38,2022-09-05,11,11,11,0,188,189,188,1,1,0,0,0,53,53,53,53
Humboldt,38,2022-09-05,110,110,110,0,1295,1296,1295,1,9,1,1,2,159,159,158,158
Imperial,38,2022-09-05,235,235,235,0,2522,2527,2526,1,8,1,1,2,961,961,960,960
Inyo,38,2022-09-05,12,12,12,0,139,140,139,1,0,0,0,1,59,59,59,59
Kern,38,2022-09-05,739,739,739,0,11391,11407,11405,2,50,5,5,8,2414,2414,2409,2409
Kings,38,2022-09-05,229,229,229,0,2869,2874,2873,1,8,0,0,0,461,461,461,461
Lake,38,2022-09-05,62,62,62,0,655,656,655,1,1,3,3,1,148,148,145,145
Lassen,38,2022-09-05,19,19,19,0,633,634,633,1,0,0,0,0,63,63,63,63
Los Angeles,38,2022-09-05,10706,10721,10721,0,224274,224601,224591,10,695,96,96,91,33384,33384,33288,33288
Madera,38,2022-09-05,206,206,206,0,2506,2511,2510,1,12,0,0,4,373,373,373,373
Marin,38,2022-09-05,191,191,191,0,3557,3563,3562,1,12,0,0,1,313,313,313,313
Mariposa,38,2022-09-05,16,16,16,0,166,167,166,1,0,0,0,0,29,29,29,29
Mendocino,38,2022-09-05,57,57,57,0,828,829,828,1,2,1,1,1,136,136,135,135
Merced,38,2022-09-05,251,251,251,0,2640,2645,2644,1,12,2,2,1,861,861,859,859
Modoc,38,2022-09-05,3,3,3,0,17,18,17,1,0,0,0,0,9,9,9,9
Mono,38,2022-09-05,4,4,4,0,52,53,52,1,1,0,0,0,7,7,7,7
Monterey,38,2022-09-05,245,245,245,0,4380,4385,4384,1,24,4,4,0,768,768,764,764
Napa,38,2022-09-05,102,102,102,0,1727,1730,1729,1,6,1,1,2,159,159,158,158
Nevada,38,2022-09-05,81,81,81,0,899,900,899,1,3,0,0,0,135,135,135,135
Orange,38,2022-09-05,2259,2262,2262,0,32860,32908,32904,4,169,13,13,34,7473,7473,7460,7460
Placer,38,2022-09-05,238,238,238,0,3479,3485,3484,1,36,0,0,4,658,658,658,658
Plumas,38,2022-09-05,9,9,9,0,130,131,130,1,0,0,0,0,13,13,13,13
Riverside,38,2022-09-05,2433,2437,2437,0,28763,28806,28802,4,99,7,7,14,6624,6624,6617,6617
Sacramento,38,2022-09-05,1273,1273,1273,0,19822,19851,19848,3,139,12,12,22,3307,3307,3295,3295
San Benito,38,2022-09-05,65,65,65,0,1087,1088,1087,1,0,0,0,2,100,100,100,100
San Bernardino,38,2022-09-05,2368,2371,2371,0,34559,34609,34605,4,122,14,14,19,8067,8067,8053,8053
San Diego,38,2022-09-05,2802,2806,2806,0,48507,48578,48576,2,212,15,15,25,5548,5548,5533,5533
San Francisco,38,2022-09-05,681,681,681,0,15741,15765,15760,5,52,9,9,9,1046,1046,1037,1037
San Joaquin,38,2022-09-05,831,831,831,0,11954,11971,11969,2,43,4,4,10,2325,2325,2321,2321
San Luis Obispo,38,2022-09-05,176,176,176,0,2677,2682,2681,1,7,2,2,1,524,524,522,522
San Mateo,38,2022-09-05,632,632,632,0,13669,13690,13689,1,23,1,1,2,737,737,736,736
Santa Barbara,38,2022-09-05,485,485,485,0,6633,6643,6642,1,39,4,4,3,726,726,722,722
Santa Clara,38,2022-09-05,1929,1930,1930,0,33400,33449,33447,2,127,10,10,20,2507,2507,2497,2497
Santa Cruz,38,2022-09-05,282,282,282,0,10222,10236,10235,1,16,0,0,0,273,273,273,273
Shasta,38,2022-09-05,105,105,105,0,2023,2027,2026,1,15,0,0,0,587,587,587,587
Siskiyou,38,2022-09-05,30,30,30,0,216,217,216,1,0,0,0,0,89,89,89,89
Solano,38,2022-09-05,368,368,368,0,5960,5969,5968,1,34,1,1,11,457,457,456,456
Sonoma,38,2022-09-05,368,368,368,0,6007,6016,6015,1,40,0,0,2,520,520,520,520
Stanislaus,38,2022-09-05,548,548,548,0,6350,6360,6359,1,69,5,5,4,1778,1778,1773,1773
Sutter,38,2022-09-05,118,118,118,0,1482,1484,1483,1,0,0,0,0,232,232,232,232
Tehama,38,2022-09-05,50,50,50,0,581,582,581,1,2,1,1,0,214,214,213,213
Trinity,38,2022-09-05,4,4,4,0,51,52,51,1,0,0,0,0,21,21,21,21
Tulare,38,2022-09-05,429,429,429,0,5178,5185,5184,1,37,2,2,1,1535,1535,1533,1533
Tuolumne,38,2022-09-05,68,68,68,0,737,738,737,1,1,0,0,0,199,199,199,199
Ventura,38,2022-09-05,864,864,864,0,12316,12335,12334,1,48,8,8,1,1586,1586,1578,1578
Yolo,38,2022-09-05,140,140,140,0,2908,2913,2912,1,1,3,3,2,391,391,388,388
Yuba,38,2022-09-05,88,88,88,0,977,978,977,1,14,0,0,1,122,122,122,122
Alameda,39,2022-09-12,1637,1637,1637,0,32245,32294,32291,3,94,5,5,16,2033,2033,2028,2028
Amador,39,2022-09-12,32,32,32,0,874,875,874,1,3,0,0,2,90,90,90,90
Butte,39,2022-09-12,196,196,196,0,2469,2474,2473,1,15,3,3,2,462,462,459,459
Calaveras,39,2022-09-12,14,14,14,0,501,502,501,1,1,0,0,0,133,133,133,133
Colusa,39,2022-09-12,17,17,17,0,414,415,414,1,0,0,0,0,22,22,22,22
Contra Costa,39,2022-09-12,979,979,979,0,17344,17370,17367,3,59,6,6,12,1447,1447,1441,1441
Del Norte,39,2022-09-12,34,34,34,0,595,596,595,1,1,0,0,1,55,55,55,55
El Dorado,39,2022-09-12,104,104,104,0,1904,1906,1905,1,3,0,0,1,233,233,233,233
Fresno,39,2022-09-12,907,907,907,0,14660,14682,14680,2,155,6,6,15,2870,2870,2864,2864
Glenn,39,2022-09-12,15,15,15,0,208,209,208,1,0,0,0,0,53,53,53,53
Humboldt,39,2022-09-12,113,113,113,0,1653,1656,1655,1,6,0,0,5,159,159,159,159
Imperial,39,2022-09-12,259,259,259,0,3287,3293,3292,1,10,0,0,2,961,961,961,961
Inyo,39,2022-09-12,15,15,15,0,194,195,194,1,0,1,1,0,60,60,59,59
Kern,39,2022-09-12,646,646,646,0,12995,13014,13013,1,45,7,7,13,2421,2421,2414,2414
Kings,39,2022-09-12,229,229,229,0,3172,3178,3177,1,6,1,1,0,462,462,461,461
Lake,39,2022-09-12,48,48,48,0,882,883,882,1,3,0,0,1,148,148,148,148
Lassen,39,2022-09-12,20,20,20,0,917,918,917,1,0,0,0,0,63,63,63,63
Los Angeles,39,2022-09-12,11025,11042,11042,0,284790,285221,285211,10,652,84,84,83,33468,33468,33384,33384
Madera,39,2022-09-12,242,242,242,0,2923,2929,2928,1,8,0,0,3,373,373,373,373
Marin,39,2022-09-12,174,174,174,0,3915,3920,3919,1,12,2,2,2,315,315,313,313
Mariposa,39,2022-09-12,16,16,16,0,192,193,192,1,0,0,0,0,29,29,29,29
Mendocino,39,2022-09-12,58,58,58,0,952,953,952,1,2,0,0,1,136,136,136,136
Merced,39,2022-09-12,237,237,237,0,3317,3323,3322,1,6,2,2,1,863,863,861,861
Modoc,39,2022-09-12,2,2,2,0,22,23,22,1,0,0,0,0,9,9,9,9
Mono,39,2022-09-12,7,7,7,0,77,78,77,1,0,0,0,0,7,7,7,7
Monterey,39,2022-09-12,229,229,229,0,5128,5135,5134,1,22,1,1,1,769,769,768,768
Napa,39,2022-09-12,120,120,120,0,2257,2262,2261,1,10,0,0,1,159,159,159,159
Nevada,39,2022-09-12,61,61,61,0,1179,1180,1179,1,2,1,1,0,136,136,135,135
Orange,39,2022-09-12,2171,2173,2173,0,37313,37370,37367,3,159,28,28,22,7501,7501,7473,7473
Placer,39,2022-09-12,240,240,240,0,4091,4097,4096,1,38,0,0,5,658,658,658,658
Plumas,39,2022-09-12,22,22,22,0,194,195,194,1,1,0,0,0,13,13,13,13
Riverside,39,2022-09-12,2264,2267,2267,0,33155,33205,33201,4,124,5,5,12,6629,6629,6624,6624
Sacramento,39,2022-09-12,1302,1302,1302,0,23561,23596,23593,3,119,15,15,15,3322,3322,3307,3307
San Benito,39,2022-09-12,96,96,96,0,1508,1511,1510,1,1,0,0,1,100,100,100,100
San Bernardino,39,2022-09-12,1952,1954,1954,0,38932,38990,38987,3,92,13,13,26,8080,8080,8067,8067
San Diego,39,2022-09-12,3034,3039,3039,0,56062,56147,56145,2,194,7,7,24,5555,5555,5548,5548
San Francisco,39,2022-09-12,815,815,815,0,17436,17463,17459,4,58,8,8,15,1054,1054,1046,1046
San Joaquin,39,2022-09-12,644,644,644,0,14281,14303,14301,2,35,6,6,9,2331,2331,2325,2325
San Luis Obispo,39,2022-09-12,187,187,187,0,3219,3225,3224,1,10,0,0,1,524,524,524,524
San Mateo,39,2022-09-12,671,671,671,0,14330,14352,14351,1,20,1,1,2,738,738,737,737
Santa Barbara,39,2022-09-12,329,329,329,0,7232,7243,7242,1,27,1,1,2,727,727,726,726
Santa Clara,39,2022-09-12,1924,1925,1925,0,38434,38492,38490,2,144,8,8,28,2515,2515,2507,2507
Santa Cruz,39,2022-09-12,272,272,272,0,13349,13370,13369,1,15,0,0,0,273,273,273,273
Shasta,39,2022-09-12,182,182,182,0,2592,2597,2596,1,26,1,1,2,588,588,587,587
Siskiyou,39,2022-09-12,27,27,27,0,289,290,289,1,1,0,0,0,89,89,89,89
Solano,39,2022-09-12,415,415,415,0,6740,6750,6749,1,32,0,0,4,457,457,457,457
Sonoma,39,2022-09-12,400,400,400,0,7022,7034,7033,1,39,3,3,1,523,523,520,520
Stanislaus,39,2022-09-12,447,447,447,0,7742,7755,7754,1,73,1,1,4,1779,1779,1778,1778
Sutter,39,2022-09-12,119,119,119,0,1531,1533,1532,1,0,0,0,0,232,232,232,232
Tehama,39,2022-09-12,48,48,48,0,699,700,699,1,2,0,0,0,214,214,214,214
Trinity,39,2022-09-12,2,2,2,0,74,75,74,1,0,0,0,0,21,21,21,21
Tulare,39,2022-09-12,371,371,371,0,6906,6917,6916,1,39,4,4,0,1539,1539,1535,1535
Tuolumne,39,2022-09-12,61,61,61,0,810,811,810,1,2,0,0,1,199,199,199,199
Ventura,39,2022-09-12,842,842,842,0,14808,14830,14829,1,49,1,1,7,1587,1587,1586,1586
Yolo,39,2022-09-12,143,143,143,0,3457,3464,3463,1,1,2,2,3,393,393,391,391
Yuba,39,2022-09-12,93,93,93,0,1164,1165,1164,1,6,0,0,0,122,122,122,122
Alameda,40,2022-09-19,1249,1249,1249,0,29338,29384,29382,2,80,4,4,7,2037,2037,2033,2033
Amador,40,2022-09-19,33,33,33,0,760,761,760,1,1,3,3,1,93,93,90,90
Butte,40,2022-09-19,121,121,121,0,2122,2126,2125,1,18,0,0,1,462,462,462,462
Calaveras,40,2022-09-19,28,28,28,0,477,478,477,1,0,0,0,0,133,133,133,133
Colusa,40,2022-09-19,13,13,13,0,289,290,289,1,3,0,0,0,22,22,22,22
Contra Costa,40,2022-09-19,826,826,826,0,16785,16811,16809,2,52,8,8,8,1455,1455,1447,1447
Del Norte,40,2022-09-19,22,22,22,0,479,480,479,1,2,0,0,0,55,55,55,55
El Dorado,40,2022-09-19,79,79,79,0,1617,1619,1618,1,3,0,0,0,233,233,233,233
Fresno,40,2022-09-19,604,604,604,0,13290,13312,13311,1,110,7,7,14,2877,2877,2870,2870
Glenn,40,2022-09-19,14,14,14,0,201,202,201,1,2,0,0,0,53,53,53,53
Humboldt,40,2022-09-19,105,105,105,0,1458,1459,1458,1,8,0,0,3,159,159,159,159
Imperial,40,2022-09-19,150,150,150,0,2868,2874,2873,1,11,0,0,2,961,961,961,961
Inyo,40,2022-09-19,8,8,8,0,169,170,169,1,0,0,0,0,60,60,60,60
Kern,40,2022-09-19,445,445,445,0,11650,11668,11667,1,34,2,2,6,2423,2423,2421,2421
Kings,40,2022-09-19,137,137,137,0,2642,2648,2647,1,7,2,2,0,464,464,462,462
Lake,40,2022-09-19,37,37,37,0,903,904,903,1,0,0,0,0,148,148,148,148
Lassen,40,2022-09-19,7,7,7,0,704,705,704,1,0,0,0,0,63,63,63,63
Los Angeles,40,2022-09-19,8554,8566,8566,0,256851,257253,257246,7,564,66,66,69,33534,33534,33468,33468
Madera,40,2022-09-19,109,109,109,0,2692,2698,2697,1,9,1,1,2,374,374,373,373
Marin,40,2022-09-19,137,137,137,0,3702,3709,3708,1,6,0,0,0,315,315,315,315
Mariposa,40,2022-09-19,12,12,12,0,170,171,170,1,0,1,1,0,30,30,29,29
Mendocino,40,2022-09-19,43,43,43,0,928,929,928,1,0,0,0,1,136,136,136,136
Merced,40,2022-09-19,170,170,170,0,2914,2920,2919,1,8,3,3,1,866,866,863,863
Modoc,40,2022-09-19,2,2,2,0,17,18,17,1,0,0,0,0,9,9,9,9
Mono,40,2022-09-19,4,4,4,0,63,64,63,1,0,0,0,0,7,7,7,7
Monterey,40,2022-09-19,162,162,162,0,4272,4278,4277,1,14,1,1,2,770,770,769,769
Napa,40,2022-09-19,103,103,103,0,1779,1781,1780,1,4,0,0,0,159,159,159,159
Nevada,40,2022-09-19,66,66,66,0,1111,1112,1111,1,2,0,0,0,136,136,136,136
Orange,40,2022-09-19,1805,1805,1805,0,34587,34642,34640,2,129,16,16,19,7517,7517,7501,7501
Placer,40,2022-09-19,223,223,223,0,3845,3852,3851,1,51,1,1,4,659,659,658,658
Plumas,40,2022-09-19,22,22,22,0,183,184,183,1,1,0,0,0,13,13,13,13
Riverside,40,2022-09-19,1428,1428,1428,0,29210,29255,29253,2,68,4,4,19,6633,6633,6629,6629
Sacramento,40,2022-09-19,1042,1042,1042,0,21424,21457,21455,2,102,8,8,17,3330,3330,3322,3322
San Benito,40,2022-09-19,54,54,54,0,1231,1233,1232,1,0,0,0,0,100,100,100,100
San Bernardino,40,2022-09-19,1486,1486,1486,0,32840,32890,32888,2,83,7,7,19,8087,8087,8080,8080
San Diego,40,2022-09-19,2563,2568,2568,0,56233,56322,56320,2,175,9,9,19,5564,5564,5555,5555
San Francisco,40,2022-09-19,695,695,695,0,16847,16873,16870,3,43,9,9,11,1063,1063,1054,1054
San Joaquin,40,2022-09-19,459,459,459,0,12860,12880,12879,1,35,5,5,2,2336,2336,2331,2331
San Luis Obispo,40,2022-09-19,155,155,155,0,2766,2772,2771,1,8,0,0,0,524,524,524,524
San Mateo,40,2022-09-19,607,607,607,0,13735,13756,13755,1,20,0,0,2,738,738,738,738
Santa Barbara,40,2022-09-19,269,269,269,0,6792,6803,6802,1,34,2,2,0,729,729,727,727
Santa Clara,40,2022-09-19,1450,1450,1450,0,37367,37425,37424,1,137,7,7,21,2522,2522,2515,2515
Santa Cruz,40,2022-09-19,148,148,148,0,12323,12342,12341,1,5,0,0,1,273,273,273,273
Shasta,40,2022-09-19,102,102,102,0,2113,2117,2116,1,21,0,0,3,588,588,588,588
Siskiyou,40,2022-09-19,21,21,21,0,233,234,233,1,2,1,1,0,90,90,89,89
Solano,40,2022-09-19,274,274,274,0,6124,6135,6134,1,24,1,1,5,458,458,457,457
Sonoma,40,2022-09-19,317,317,317,0,6360,6371,6370,1,27,3,3,1,526,526,523,523
Stanislaus,40,2022-09-19,333,333,333,0,6290,6301,6300,1,57,4,4,4,1783,1783,1779,1779
Sutter,40,2022-09-19,76,76,76,0,1388,1390,1389,1,0,0,0,0,232,232,232,232
Tehama,40,2022-09-19,35,35,35,0,599,600,599,1,2,1,1,0,215,215,214,214
Trinity,40,2022-09-19,3,3,3,0,53,54,53,1,0,0,0,0,21,21,21,21
Tulare,40,2022-09-19,234,234,234,0,5732,5740,5739,1,32,1,1,0,1540,1540,1539,1539
Tuolumne,40,2022-09-19,59,59,59,0,717,718,717,1,0,0,0,0,199,199,199,199
Ventura,40,2022-09-19,616,616,616,0,13383,13405,13404,1,42,2,2,6,1589,1589,1587,1587
Yolo,40,2022-09-19,83,83,83,0,3742,3749,3748,1,2,3,3,2,396,396,393,393
Yuba,40,2022-09-19,60,60,60,0,1029,1030,1029,1,3,0,0,0,122,122,122,122
Alameda,41,2022-09-26,1154,1154,1154,0,27840,27885,27884,1,77,2,2,4,2039,2039,2037,2037
Amador,41,2022-09-26,27,27,27,0,721,722,721,1,1,0,0,1,93,93,93,93
Butte,41,2022-09-26,90,90,90,0,1798,1801,1800,1,23,0,0,1,462,462,462,462
Calaveras,41,2022-09-26,20,20,20,0,390,391,390,1,2,1,1,0,134,134,133,133
Colusa,41,2022-09-26,7,7,7,0,299,300,299,1,1,0,0,0,22,22,22,22
Contra Costa,41,2022-09-26,777,777,777,0,16349,16376,16375,1,48,5,5,7,1460,1460,1455,1455
Del Norte,41,2022-09-26,22,22,22,0,469,470,469,1,2,0,0,0,55,55,55,55
El Dorado,41,2022-09-26,86,86,86,0,1580,1583,1582,1,5,0,0,0,233,233,233,233
Fresno,41,2022-09-26,517,517,517,0,12130,12150,12149,1,84,3,3,13,2880,2880,2877,2877
Glenn,41,2022-09-26,7,7,7,0,176,177,176,1,2,0,0,0,53,53,53,53
Humboldt,41,2022-09-26,97,97,97,0,1312,1313,1312,1,10,2,2,0,161,161,159,159
Imperial,41,2022-09-26,115,115,115,0,2630,2636,2635,1,4,1,1,1,962,962,961,961
Inyo,41,2022-09-26,5,5,5,0,165,166,165,1,0,0,0,0,60,60,60,60
Kern,41,2022-09-26,357,357,357,0,10879,10896,10895,1,32,3,3,7,2426,2426,2423,2423
Kings,41,2022-09-26,107,107,107,0,2621,2626,2625,1,2,0,0,0,464,464,464,464
Lake,41,2022-09-26,26,26,26,0,815,816,815,1,0,0,0,0,148,148,148,148
Lassen,41,2022-09-26,13,13,13,0,533,534,533,1,0,0,0,0,63,63,63,63
Los Angeles,41,2022-09-26,7723,7735,7735,0,241353,241743,241738,5,443,63,63,53,33597,33597,33534,33534
Madera,41,2022-09-26,84,84,84,0,2231,2236,2235,1,8,0,0,2,374,374,374,374
Marin,41,2022-09-26,173,173,173,0,3659,3665,3664,1,10,0,0,0,315,315,315,315
Mariposa,41,2022-09-26,4,4,4,0,155,156,155,1,0,0,0,0,30,30,30,30
Mendocino,41,2022-09-26,41,41,41,0,852,853,852,1,1,0,0,0,136,136,136,136
Merced,41,2022-09-26,127,127,127,0,2855,2861,2860,1,10,1,1,0,867,867,866,866
Modoc,41,2022-09-26,0,0,0,0,13,14,13,1,0,0,0,0,9,9,9,9
Mono,41,2022-09-26,1,1,1,0,60,61,60,1,0,0,0,0,7,7,7,7
Monterey,41,2022-09-26,135,135,135,0,4055,4060,4059,1,14,0,0,2,770,770,770,770
Napa,41,2022-09-26,87,87,87,0,1966,1970,1969,1,5,0,0,1,159,159,159,159
Nevada,41,2022-09-26,49,49,49,0,1077,1078,1077,1,1,0,0,0,136,136,136,136
Orange,41,2022-09-26,1737,1738,1738,0,31562,31613,31611,2,117,19,19,23,7536,7536,7517,7517
Placer,41,2022-09-26,209,209,209,0,3611,3618,3617,1,42,1,1,4,660,660,659,659
Plumas,41,2022-09-26,21,21,21,0,151,152,151,1,1,0,0,0,13,13,13,13
Riverside,41,2022-09-26,1289,1289,1289,0,25896,25939,25937,2,55,8,8,15,6641,6641,6633,6633
Sacramento,41,2022-09-26,932,932,932,0,19275,19306,19305,1,106,11,11,20,3341,3341,3330,3330
San Benito,41,2022-09-26,50,50,50,0,1160,1162,1161,1,0,1,1,2,101,101,100,100
San Bernardino,41,2022-09-26,1240,1240,1240,0,28103,28147,28145,2,75,5,5,12,8092,8092,8087,8087
San Diego,41,2022-09-26,2483,2488,2488,0,51220,51302,51301,1,201,7,7,15,5571,5571,5564,5564
San Francisco,41,2022-09-26,678,678,678,0,16224,16249,16247,2,45,2,2,9,1065,1065,1063,1063
San Joaquin,41,2022-09-26,409,409,409,0,11085,11102,11101,1,35,1,1,3,2337,2337,2336,2336
San Luis Obispo,41,2022-09-26,131,131,131,0,2521,2527,2526,1,7,1,1,0,525,525,524,524
San Mateo,41,2022-09-26,617,617,617,0,13188,13208,13207,1,25,0,0,1,738,738,738,738
Santa Barbara,41,2022-09-26,259,259,259,0,6381,6393,6392,1,22,2,2,0,731,731,729,729
Santa Clara,41,2022-09-26,1401,1401,1401,0,36177,36236,36235,1,113,10,10,17,2532,2532,2522,2522
Santa Cruz,41,2022-09-26,225,225,225,0,12507,12527,12526,1,13,0,0,0,273,273,273,273
Shasta,41,2022-09-26,77,77,77,0,1740,1743,1742,1,14,0,0,3,588,588,588,588
Siskiyou,41,2022-09-26,18,18,18,0,183,184,183,1,1,2,2,0,92,92,90,90
Solano,41,2022-09-26,309,309,309,0,5725,5736,5735,1,23,1,1,2,459,459,458,458
Sonoma,41,2022-09-26,292,292,292,0,6334,6346,6345,1,31,1,1,2,527,527,526,526
Stanislaus,41,2022-09-26,261,261,261,0,5814,5823,5822,1,46,2,2,3,1785,1785,1783,1783
Sutter,41,2022-09-26,69,69,69,0,1147,1148,1147,1,0,0,0,0,232,232,232,232
Tehama,41,2022-09-26,36,36,36,0,550,551,550,1,1,2,2,0,217,217,215,215
Trinity,41,2022-09-26,3,3,3,0,44,45,44,1,0,0,0,0,21,21,21,21
Tulare,41,2022-09-26,168,168,168,0,5095,5103,5102,1,18,3,3,2,1543,1543,1540,1540
Tuolumne,41,2022-09-26,44,44,44,0,689,690,689,1,1,0,0,0,199,199,199,199
Ventura,41,2022-09-26,557,557,557,0,11600,11618,11617,1,33,4,4,1,1593,1593,1589,1589
Yolo,41,2022-09-26,130,130,130,0,3986,3993,3992,1,2,3,3,3,399,399,396,396
Yuba,41,2022-09-26,41,41,41,0,933,934,933,1,6,0,0,1,122,122,122,122
Alameda,42,2022-10-03,1146,1146,1146,0,26322,26366,26365,1,54,3,3,5,2042,2042,2039,2039
Amador,42,2022-10-03,14,14,14,0,691,692,691,1,0,0,0,1,93,93,93,93
Butte,42,2022-10-03,67,67,67,0,1754,1758,1757,1,11,2,2,2,464,464,462,462
Calaveras,42,2022-10-03,19,19,19,0,337,338,337,1,1,0,0,0,134,134,134,134
Colusa,42,2022-10-03,7,7,7,0,188,189,188,1,0,0,0,0,22,22,22,22
Contra Costa,42,2022-10-03,740,740,740,0,15785,15812,15811,1,34,3,3,6,1463,1463,1460,1460
Del Norte,42,2022-10-03,12,12,12,0,382,383,382,1,1,0,0,1,55,55,55,55
El Dorado,42,2022-10-03,80,80,80,0,1450,1452,1451,1,3,0,0,1,233,233,233,233
Fresno,42,2022-10-03,462,462,462,0,11227,11245,11244,1,77,2,2,11,2882,2882,2880,2880
Glenn,42,2022-10-03,7,7,7,0,155,156,155,1,0,0,0,0,53,53,53,53
Humboldt,42,2022-10-03,78,78,78,0,1159,1160,1159,1,6,0,0,1,161,161,161,161
Imperial,42,2022-10-03,141,141,141,0,2564,2570,2569,1,6,0,0,0,962,962,962,962
Inyo,42,2022-10-03,5,5,5,0,159,160,159,1,0,0,0,1,60,60,60,60
Kern,42,2022-10-03,295,295,295,0,10110,10128,10127,1,24,4,4,5,2430,2430,2426,2426
Kings,42,2022-10-03,87,87,87,0,2416,2422,2421,1,2,0,0,0,464,464,464,464
Lake,42,2022-10-03,35,35,35,0,759,760,759,1,3,1,1,0,149,149,148,148
Lassen,42,2022-10-03,7,7,7,0,530,531,530,1,2,0,0,0,63,63,63,63
Los Angeles,42,2022-10-03,7020,7032,7032,0,221736,222104,222100,4,439,50,50,69,33647,33647,33597,33597
Madera,42,2022-10-03,65,65,65,0,1565,1567,1566,1,6,0,0,2,374,374,374,374
Marin,42,2022-10-03,191,191,191,0,3475,3481,3480,1,6,0,0,2,315,315,315,315
Mariposa,42,2022-10-03,5,5,5,0,131,132,131,1,0,0,0,0,30,30,30,30
Mendocino,42,2022-10-03,50,50,50,0,778,779,778,1,4,0,0,0,136,136,136,136
Merced,42,2022-10-03,109,109,109,0,2610,2616,2615,1,5,3,3,1,870,870,867,867
Modoc,42,2022-10-03,2,2,2,0,14,15,14,1,0,0,0,0,9,9,9,9
Mono,42,2022-10-03,4,4,4,0,69,70,69,1,0,0,0,0,7,7,7,7
Monterey,42,2022-10-03,111,111,111,0,3790,3796,3795,1,11,1,1,1,771,771,770,770
Napa,42,2022-10-03,89,89,89,0,1701,1704,1703,1,4,0,0,2,159,159,159,159
Nevada,42,2022-10-03,51,51,51,0,954,955,954,1,1,0,0,4,136,136,136,136
Orange,42,2022-10-03,1579,1579,1579,0,28375,28422,28421,1,131,22,22,16,7558,7558,7536,7536
Placer,42,2022-10-03,208,208,208,0,3350,3357,3356,1,41,2,2,3,662,662,660,660
Plumas,42,2022-10-03,12,12,12,0,107,108,107,1,1,0,0,0,13,13,13,13
Riverside,42,2022-10-03,1146,1146,1146,0,22158,22195,22194,1,59,7,7,12,6648,6648,6641,6641
Sacramento,42,2022-10-03,924,924,924,0,18205,18236,18235,1,88,12,12,19,3353,3353,3341,3341
San Benito,42,2022-10-03,34,34,34,0,1105,1107,1106,1,0,0,0,0,101,101,101,101
San Bernardino,42,2022-10-03,1243,1243,1243,0,25069,25111,25110,1,77,4,4,7,8096,8096,8092,8092
San Diego,42,2022-10-03,2086,2090,2090,0,46925,47002,47001,1,162,9,9,18,5580,5580,5571,5571
San Francisco,42,2022-10-03,655,655,655,0,15385,15410,15408,2,44,3,3,9,1068,1068,1065,1065
San Joaquin,42,2022-10-03,342,342,342,0,9930,9946,9945,1,25,4,4,3,2341,2341,2337,2337
San Luis Obispo,42,2022-10-03,150,150,150,0,2383,2389,2388,1,2,1,1,1,526,526,525,525
San Mateo,42,2022-10-03,560,560,560,0,12421,12442,12441,1,22,0,0,2,738,738,738,738
Santa Barbara,42,2022-10-03,254,254,254,0,6290,6303,6302,1,15,0,0,2,731,731,731,731
Santa Clara,42,2022-10-03,1436,1436,1436,0,32448,32502,32501,1,109,6,6,20,2538,2538,2532,2532
Santa Cruz,42,2022-10-03,227,227,227,0,11231,11250,11249,1,10,0,0,1,273,273,273,273
Shasta,42,2022-10-03,57,57,57,0,1444,1447,1446,1,10,0,0,2,588,588,588,588
Siskiyou,42,2022-10-03,10,10,10,0,204,205,204,1,0,0,0,0,92,92,92,92
Solano,42,2022-10-03,251,251,251,0,5361,5370,5369,1,17,0,0,2,459,459,459,459
Sonoma,42,2022-10-03,322,322,322,0,5934,5946,5945,1,17,0,0,3,527,527,527,527
Stanislaus,42,2022-10-03,200,200,200,0,5355,5365,5364,1,49,1,1,6,1786,1786,1785,1785
Sutter,42,2022-10-03,57,57,57,0,1109,1111,1110,1,0,0,0,0,232,232,232,232
Tehama,42,2022-10-03,20,20,20,0,526,527,526,1,1,0,0,0,217,217,217,217
Trinity,42,2022-10-03,1,1,1,0,43,44,43,1,0,0,0,0,21,21,21,21
Tulare,42,2022-10-03,164,164,164,0,5054,5062,5061,1,19,4,4,1,1547,1547,1543,1543
Tuolumne,42,2022-10-03,26,26,26,0,622,623,622,1,0,1,1,0,200,200,199,199
Ventura,42,2022-10-03,479,479,479,0,10442,10460,10459,1,41,2,2,2,1595,1595,1593,1593
Yolo,42,2022-10-03,123,123,123,0,2987,2994,2993,1,3,2,2,2,401,401,399,399
Yuba,42,2022-10-03,35,35,35,0,802,803,802,1,4,0,0,1,122,122,122,122
Alameda,43,2022-10-10,1160,1160,1160,0,28032,28080,28079,1,45,2,2,7,2044,2044,2042,2042
Amador,43,2022-10-10,15,15,15,0,801,802,801,1,0,0,0,2,93,93,93,93
Butte,43,2022-10-10,65,65,65,0,1754,1756,1755,1,12,3,3,1,466,466,463,463
Calaveras,43,2022-10-10,15,15,15,0,374,375,374,1,0,1,1,0,135,135,134,134
Colusa,43,2022-10-10,1,1,1,0,120,121,120,1,1,0,0,0,22,22,22,22
Contra Costa,43,2022-10-10,774,774,774,0,16875,16903,16902,1,31,7,7,6,1468,1468,1461,1461
Del Norte,43,2022-10-10,10,10,10,0,492,493,492,1,1,0,0,1,55,55,55,55
El Dorado,43,2022-10-10,81,81,81,0,1751,1754,1753,1,7,0,0,4,233,233,233,233
Fresno,43,2022-10-10,482,482,482,0,12484,12505,12504,1,60,3,3,9,2885,2885,2882,2882
Glenn,43,2022-10-10,10,10,10,0,226,227,226,1,1,0,0,0,53,53,53,53
Humboldt,43,2022-10-10,98,98,98,0,1420,1421,1420,1,7,1,1,0,162,162,161,161
Imperial,43,2022-10-10,203,203,203,0,2960,2967,2966,1,7,0,0,0,962,962,962,962
Inyo,43,2022-10-10,4,4,4,0,124,125,124,1,0,0,0,0,60,60,60,60
Kern,43,2022-10-10,338,338,338,0,11848,11869,11868,1,24,2,2,2,2432,2432,2430,2430
Kings,43,2022-10-10,102,102,102,0,2751,2757,2756,1,1,1,1,0,465,465,464,464
Lake,43,2022-10-10,33,33,33,0,920,921,920,1,1,0,0,0,149,149,149,149
Lassen,43,2022-10-10,3,3,3,0,573,574,573,1,0,0,0,0,63,63,63,63
Los Angeles,43,2022-10-10,6754,6766,6766,0,228396,228787,228784,3,436,71,71,51,33710,33710,33639,33639
Madera,43,2022-10-10,68,68,68,0,1718,1719,1718,1,7,1,1,2,375,375,374,374
Marin,43,2022-10-10,207,207,207,0,3779,3786,3785,1,9,0,0,0,315,315,315,315
Mariposa,43,2022-10-10,9,9,9,0,128,129,128,1,0,0,0,0,30,30,30,30
Mendocino,43,2022-10-10,32,32,32,0,975,976,975,1,1,0,0,2,136,136,136,136
Merced,43,2022-10-10,111,111,111,0,2789,2795,2794,1,8,1,1,3,871,871,870,870
Modoc,43,2022-10-10,5,5,5,0,12,13,12,1,0,0,0,0,9,9,9,9
Mono,43,2022-10-10,1,1,1,0,55,56,55,1,0,0,0,0,7,7,7,7
Monterey,43,2022-10-10,108,108,108,0,4375,4382,4381,1,9,0,0,1,771,771,771,771
Napa,43,2022-10-10,78,78,78,0,1766,1767,1766,1,3,0,0,2,159,159,159,159
Nevada,43,2022-10-10,42,42,42,0,981,982,981,1,1,0,0,1,136,136,136,136
Orange,43,2022-10-10,1524,1524,1524,0,30120,30171,30170,1,129,14,14,19,7570,7570,7556,7556
Placer,43,2022-10-10,186,186,186,0,3823,3831,3830,1,24,0,0,7,662,662,662,662
Plumas,43,2022-10-10,20,20,20,0,106,107,106,1,0,0,0,0,13,13,13,13
Riverside,43,2022-10-10,1195,1195,1195,0,24021,24063,24062,1,56,5,5,4,6653,6653,6648,6648
Sacramento,43,2022-10-10,959,959,959,0,20477,20512,20511,1,81,5,5,16,3358,3358,3353,3353
San Benito,43,2022-10-10,35,35,35,0,1268,1269,1268,1,3,0,0,0,101,101,101,101
San Bernardino,43,2022-10-10,1112,1112,1112,0,27423,27469,27468,1,66,0,0,13,8096,8096,8096,8096
San Diego,43,2022-10-10,1991,1993,1993,0,51616,51704,51703,1,130,7,7,21,5585,5585,5578,5578
San Francisco,43,2022-10-10,691,691,691,0,16131,16159,16158,1,37,2,2,9,1070,1070,1068,1068
San Joaquin,43,2022-10-10,431,431,431,0,11585,11604,11603,1,17,2,2,8,2343,2343,2341,2341
San Luis Obispo,43,2022-10-10,88,88,88,0,2568,2573,2572,1,2,2,2,0,528,528,526,526
San Mateo,43,2022-10-10,668,668,668,0,13748,13773,13772,1,19,0,0,0,738,738,738,738
Santa Barbara,43,2022-10-10,242,242,242,0,7845,7860,7859,1,20,1,1,1,732,732,731,731
Santa Clara,43,2022-10-10,1457,1457,1457,0,34357,34416,34415,1,107,4,4,18,2542,2542,2538,2538
Santa Cruz,43,2022-10-10,338,338,338,0,12283,12305,12304,1,9,0,0,1,273,273,273,273
Shasta,43,2022-10-10,99,99,99,0,1294,1295,1294,1,13,3,3,1,591,591,588,588
Siskiyou,43,2022-10-10,9,9,9,0,244,245,244,1,0,1,1,0,93,93,92,92
Solano,43,2022-10-10,333,333,333,0,6279,6291,6290,1,23,0,0,4,459,459,459,459
Sonoma,43,2022-10-10,287,287,287,0,6773,6787,6786,1,15,1,1,3,528,528,527,527
Stanislaus,43,2022-10-10,208,208,208,0,5928,5940,5939,1,51,7,7,7,1791,1791,1784,1784
Sutter,43,2022-10-10,58,58,58,0,1127,1128,1127,1,0,0,0,0,232,232,232,232
Tehama,43,2022-10-10,21,21,21,0,567,568,567,1,1,0,0,0,217,217,217,217
Trinity,43,2022-10-10,1,1,1,0,53,54,53,1,0,0,0,0,21,21,21,21
Tulare,43,2022-10-10,167,167,167,0,4982,4991,4990,1,16,1,1,1,1548,1548,1547,1547
Tuolumne,43,2022-10-10,36,36,36,0,660,661,660,1,1,1,1,0,201,201,200,200
Ventura,43,2022-10-10,438,438,438,0,10998,11018,11017,1,41,4,4,1,1598,1598,1594,1594
Yolo,43,2022-10-10,126,126,126,0,3099,3105,3104,1,4,2,2,0,403,403,401,401
Yuba,43,2022-10-10,23,23,23,0,924,925,924,1,0,0,0,0,122,122,122,122
Alameda,44,2022-10-17,945,945,945,0,24697,24741,24740,1,60,5,5,8,2049,2049,2044,2044
Amador,44,2022-10-17,15,15,15,0,592,593,592,1,1,0,0,0,93,93,93,93
Butte,44,2022-10-17,76,76,76,0,1426,1428,1427,1,13,0,0,0,466,466,466,466
Calaveras,44,2022-10-17,19,19,19,0,306,307,306,1,0,0,0,0,135,135,135,135
Colusa,44,2022-10-17,4,4,4,0,80,81,80,1,0,0,0,0,22,22,22,22
Contra Costa,44,2022-10-17,675,675,675,0,14550,14575,14574,1,30,4,4,6,1472,1472,1468,1468
Del Norte,44,2022-10-17,11,11,11,0,381,382,381,1,1,0,0,0,55,55,55,55
El Dorado,44,2022-10-17,89,89,89,0,1381,1383,1382,1,2,0,0,1,233,233,233,233
Fresno,44,2022-10-17,350,350,350,0,10209,10229,10228,1,62,2,2,11,2887,2887,2885,2885
Glenn,44,2022-10-17,6,6,6,0,141,142,141,1,1,0,0,0,53,53,53,53
Humboldt,44,2022-10-17,70,70,70,0,1147,1148,1147,1,1,0,0,0,162,162,162,162
Imperial,44,2022-10-17,117,117,117,0,2321,2327,2326,1,5,0,0,0,962,962,962,962
Inyo,44,2022-10-17,6,6,6,0,123,124,123,1,1,0,0,0,60,60,60,60
Kern,44,2022-10-17,238,238,238,0,9714,9732,9731,1,32,0,0,1,2432,2432,2432,2432
Kings,44,2022-10-17,70,70,70,0,2320,2326,2325,1,2,1,1,0,466,466,465,465
Lake,44,2022-10-17,25,25,25,0,774,775,774,1,1,0,0,0,149,149,149,149
Lassen,44,2022-10-17,7,7,7,0,513,514,513,1,1,0,0,0,63,63,63,63
Los Angeles,44,2022-10-17,5089,5098,5098,0,189697,190030,190028,2,350,42,42,53,33752,33752,33710,33710
Madera,44,2022-10-17,59,59,59,0,1467,1469,1468,1,3,0,0,2,375,375,375,375
Marin,44,2022-10-17,132,132,132,0,3096,3102,3101,1,8,0,0,1,315,315,315,315
Mariposa,44,2022-10-17,6,6,6,0,119,120,119,1,0,0,0,0,30,30,30,30
Mendocino,44,2022-10-17,48,48,48,0,743,744,743,1,2,0,0,0,136,136,136,136
Merced,44,2022-10-17,129,129,129,0,2344,2350,2349,1,15,0,0,2,871,871,871,871
Modoc,44,2022-10-17,1,1,1,0,7,8,7,1,0,0,0,0,9,9,9,9
Mono,44,2022-10-17,6,6,6,0,42,43,42,1,1,0,0,0,7,7,7,7
Monterey,44,2022-10-17,125,125,125,0,3552,3559,3558,1,12,1,1,1,772,772,771,771
Napa,44,2022-10-17,60,60,60,0,1416,1418,1417,1,2,0,0,1,159,159,159,159
Nevada,44,2022-10-17,49,49,49,0,780,781,780,1,0,0,0,5,136,136,136,136
Orange,44,2022-10-17,1137,1137,1137,0,25139,25183,25182,1,91,21,21,18,7591,7591,7570,7570
Placer,44,2022-10-17,149,149,149,0,2932,2939,2938,1,32,0,0,3,662,662,662,662
Plumas,44,2022-10-17,11,11,11,0,98,99,98,1,0,0,0,0,13,13,13,13
Riverside,44,2022-10-17,898,898,898,0,20799,20837,20836,1,66,2,2,2,6655,6655,6653,6653
Sacramento,44,2022-10-17,871,871,871,0,16205,16232,16231,1,84,11,11,14,3369,3369,3358,3358
San Benito,44,2022-10-17,28,28,28,0,881,882,881,1,0,1,1,0,102,102,101,101
San Bernardino,44,2022-10-17,835,835,835,0,23470,23511,23510,1,63,1,1,9,8097,8097,8096,8096
San Diego,44,2022-10-17,1649,1650,1650,0,43737,43814,43813,1,117,8,8,24,5593,5593,5585,5585
San Francisco,44,2022-10-17,568,568,568,0,14501,14527,14526,1,34,3,3,13,1073,1073,1070,1070
San Joaquin,44,2022-10-17,352,352,352,0,9075,9091,9090,1,8,2,2,8,2345,2345,2343,2343
San Luis Obispo,44,2022-10-17,109,109,109,0,2131,2136,2135,1,4,1,1,0,529,529,528,528
San Mateo,44,2022-10-17,552,552,552,0,11333,11354,11353,1,21,0,0,1,738,738,738,738
Santa Barbara,44,2022-10-17,182,182,182,0,5626,5637,5636,1,18,0,0,2,732,732,732,732
Santa Clara,44,2022-10-17,1170,1170,1170,0,28717,28769,28768,1,93,5,5,16,2547,2547,2542,2542
Santa Cruz,44,2022-10-17,284,284,284,0,10290,10310,10309,1,7,1,1,0,274,274,273,273
Shasta,44,2022-10-17,82,82,82,0,1105,1106,1105,1,12,0,0,2,591,591,591,591
Siskiyou,44,2022-10-17,12,12,12,0,181,182,181,1,2,1,1,0,94,94,93,93
Solano,44,2022-10-17,266,266,266,0,4852,4861,4860,1,25,1,1,3,460,460,459,459
Sonoma,44,2022-10-17,246,246,246,0,5371,5382,5381,1,20,1,1,1,529,529,528,528
Stanislaus,44,2022-10-17,222,222,222,0,5295,5305,5304,1,45,1,1,5,1792,1792,1791,1791
Sutter,44,2022-10-17,40,40,40,0,910,911,910,1,0,0,0,0,232,232,232,232
Tehama,44,2022-10-17,21,21,21,0,397,398,397,1,0,0,0,0,217,217,217,217
Trinity,44,2022-10-17,0,0,0,0,34,35,34,1,0,0,0,0,21,21,21,21
Tulare,44,2022-10-17,136,136,136,0,4271,4278,4277,1,11,1,1,1,1549,1549,1548,1548
Tuolumne,44,2022-10-17,35,35,35,0,620,621,620,1,2,0,0,0,201,201,201,201
Ventura,44,2022-10-17,376,376,376,0,9350,9367,9366,1,32,3,3,1,1601,1601,1598,1598
Yolo,44,2022-10-17,102,102,102,0,2211,2216,2215,1,3,2,2,3,405,405,403,403
Yuba,44,2022-10-17,44,44,44,0,767,768,767,1,1,0,0,0,122,122,122,122
Alameda,45,2022-10-24,955,955,955,0,23426,23468,23467,1,46,8,8,10,2057,2057,2049,2049
Amador,45,2022-10-24,18,18,18,0,635,636,635,1,2,0,0,0,93,93,93,93
Butte,45,2022-10-24,68,68,68,0,1405,1407,1406,1,10,1,1,1,467,467,466,466
Calaveras,45,2022-10-24,20,20,20,0,322,323,322,1,0,0,0,0,135,135,135,135
Colusa,45,2022-10-24,3,3,3,0,95,96,95,1,0,0,0,0,22,22,22,22
Contra Costa,45,2022-10-24,627,627,627,0,13919,13944,13943,1,37,5,5,5,1477,1477,1472,1472
Del Norte,45,2022-10-24,6,6,6,0,361,362,361,1,0,0,0,1,55,55,55,55
El Dorado,45,2022-10-24,91,91,91,0,1520,1523,1522,1,1,0,0,0,233,233,233,233
Fresno,45,2022-10-24,380,380,380,0,9763,9781,9780,1,63,0,0,6,2887,2887,2887,2887
Glenn,45,2022-10-24,9,9,9,0,148,149,148,1,0,0,0,0,53,53,53,53
Humboldt,45,2022-10-24,69,69,69,0,1150,1151,1150,1,7,0,0,2,162,162,162,162
Imperial,45,2022-10-24,96,96,96,0,2344,2350,2349,1,8,1,1,0,963,963,962,962
Inyo,45,2022-10-24,8,8,8,0,273,274,273,1,0,0,0,0,60,60,60,60
Kern,45,2022-10-24,279,279,279,0,9715,9734,9733,1,24,2,2,2,2434,2434,2432,2432
Kings,45,2022-10-24,88,88,88,0,2341,2347,2346,1,8,0,0,0,466,466,466,466
Lake,45,2022-10-24,22,22,22,0,643,644,643,1,1,1,1,1,150,150,149,149
Lassen,45,2022-10-24,16,16,16,0,484,485,484,1,1,0,0,0,63,63,63,63
Los Angeles,45,2022-10-24,5338,5347,5347,0,187326,187664,187662,2,332,54,54,43,33806,33806,33752,33752
Madera,45,2022-10-24,61,61,61,0,1388,1389,1388,1,4,0,0,2,375,375,375,375
Marin,45,2022-10-24,138,138,138,0,3081,3088,3087,1,12,1,1,2,316,316,315,315
Mariposa,45,2022-10-24,12,12,12,0,120,121,120,1,0,0,0,0,30,30,30,30
Mendocino,45,2022-10-24,42,42,42,0,771,772,771,1,2,0,0,0,136,136,136,136
Merced,45,2022-10-24,88,88,88,0,2410,2416,2415,1,7,3,3,3,874,874,871,871
Modoc,45,2022-10-24,1,1,1,0,13,14,13,1,0,0,0,0,9,9,9,9
Mono,45,2022-10-24,3,3,3,0,64,65,64,1,0,1,1,0,8,8,7,7
Monterey,45,2022-10-24,131,131,131,0,3719,3727,3726,1,18,0,0,0,772,772,772,772
Napa,45,2022-10-24,51,51,51,0,1467,1469,1468,1,3,0,0,0,159,159,159,159
Nevada,45,2022-10-24,38,38,38,0,784,785,784,1,6,0,0,0,136,136,136,136
Orange,45,2022-10-24,1160,1160,1160,0,26001,26049,26048,1,84,12,12,14,7603,7603,7591,7591
Placer,45,2022-10-24,192,192,192,0,3034,3041,3040,1,39,0,0,6,662,662,662,662
Plumas,45,2022-10-24,12,12,12,0,91,92,91,1,0,0,0,0,13,13,13,13
Riverside,45,2022-10-24,933,933,933,0,20178,20215,20214,1,53,0,0,6,6655,6655,6655,6655
Sacramento,45,2022-10-24,816,816,816,0,15315,15342,15341,1,84,5,5,19,3374,3374,3369,3369
San Benito,45,2022-10-24,41,41,41,0,845,846,845,1,0,0,0,1,102,102,102,102
San Bernardino,45,2022-10-24,805,805,805,0,21612,21651,21650,1,39,3,3,10,8100,8100,8097,8097
San Diego,45,2022-10-24,1684,1687,1687,0,42143,42218,42217,1,83,5,5,18,5598,5598,5593,5593
San Francisco,45,2022-10-24,511,511,511,0,13947,13973,13972,1,35,1,1,5,1074,1074,1073,1073
San Joaquin,45,2022-10-24,271,271,271,0,8498,8515,8514,1,13,2,2,3,2347,2347,2345,2345
San Luis Obispo,45,2022-10-24,89,89,89,0,2055,2061,2060,1,2,0,0,0,529,529,529,529
San Mateo,45,2022-10-24,473,473,473,0,11148,11169,11168,1,19,0,0,2,738,738,738,738
Santa Barbara,45,2022-10-24,164,164,164,0,5730,5742,5741,1,19,2,2,4,734,734,732,732
Santa Clara,45,2022-10-24,1211,1211,1211,0,29387,29441,29440,1,92,3,3,9,2550,2550,2547,2547
Santa Cruz,45,2022-10-24,240,240,240,0,10203,10222,10221,1,14,1,1,0,275,275,274,274
Shasta,45,2022-10-24,76,76,76,0,984,985,984,1,5,0,0,2,591,591,591,591
Siskiyou,45,2022-10-24,12,12,12,0,171,172,171,1,0,0,0,0,94,94,94,94
Solano,45,2022-10-24,239,239,239,0,5028,5037,5036,1,20,0,0,1,460,460,460,460
Sonoma,45,2022-10-24,242,242,242,0,5438,5450,5449,1,23,0,0,1,529,529,529,529
Stanislaus,45,2022-10-24,199,199,199,0,4851,4861,4860,1,40,3,3,3,1795,1795,1792,1792
Sutter,45,2022-10-24,28,28,28,0,881,882,881,1,0,0,0,0,232,232,232,232
Tehama,45,2022-10-24,36,36,36,0,406,407,406,1,1,0,0,0,217,217,217,217
Trinity,45,2022-10-24,1,1,1,0,35,36,35,1,0,0,0,0,21,21,21,21
Tulare,45,2022-10-24,110,110,110,0,4345,4352,4351,1,16,1,1,1,1550,1550,1549,1549
Tuolumne,45,2022-10-24,33,33,33,0,625,626,625,1,1,1,1,0,202,202,201,201
Ventura,45,2022-10-24,294,294,294,0,9024,9040,9039,1,40,3,3,6,1604,1604,1601,1601
Yolo,45,2022-10-24,91,91,91,0,2048,2053,2052,1,5,1,1,0,406,406,405,405
Yuba,45,2022-10-24,51,51,51,0,799,800,799,1,5,0,0,1,122,122,122,122
Alameda,46,2022-10-31,1059,1059,1059,0,23016,23058,23057,1,57,5,5,4,2062,2062,2057,2057
Amador,46,2022-10-31,18,18,18,0,578,579,578,1,2,1,1,0,94,94,93,93
Butte,46,2022-10-31,82,82,82,0,1458,1460,1459,1,11,0,0,3,467,467,467,467
Calaveras,46,2022-10-31,13,13,13,0,257,258,257,1,0,0,0,0,135,135,135,135
Colusa,46,2022-10-31,11,11,11,0,95,96,95,1,0,0,0,0,22,22,22,22
Contra Costa,46,2022-10-31,747,747,747,0,13902,13928,13927,1,37,6,6,7,1483,1483,1477,1477
Del Norte,46,2022-10-31,16,16,16,0,357,358,357,1,1,0,0,0,55,55,55,55
El Dorado,46,2022-10-31,100,100,100,0,1406,1408,1407,1,2,0,0,0,233,233,233,233
Fresno,46,2022-10-31,427,427,427,0,10498,10518,10517,1,57,4,4,8,2891,2891,2887,2887
Glenn,46,2022-10-31,16,16,16,0,156,157,156,1,1,0,0,0,53,53,53,53
Humboldt,46,2022-10-31,44,44,44,0,1021,1022,1021,1,6,0,0,2,162,162,162,162
Imperial,46,2022-10-31,126,126,126,0,2784,2790,2789,1,7,0,0,0,963,963,963,963
Inyo,46,2022-10-31,7,7,7,0,242,243,242,1,0,0,0,0,60,60,60,60
Kern,46,2022-10-31,341,341,341,0,9872,9892,9891,1,20,2,2,2,2436,2436,2434,2434
Kings,46,2022-10-31,118,118,118,0,2461,2467,2466,1,3,0,0,1,466,466,466,466
Lake,46,2022-10-31,30,30,30,0,752,753,752,1,1,0,0,1,150,150,150,150
Lassen,46,2022-10-31,19,19,19,0,522,523,522,1,1,0,0,0,63,63,63,63
Los Angeles,46,2022-10-31,6228,6240,6240,0,192571,192934,192932,2,344,37,37,44,33843,33843,33806,33806
Madera,46,2022-10-31,54,54,54,0,1433,1435,1434,1,3,0,0,2,375,375,375,375
Marin,46,2022-10-31,137,137,137,0,3509,3516,3515,1,10,1,1,1,317,317,316,316
Mariposa,46,2022-10-31,8,8,8,0,126,127,126,1,0,0,0,0,30,30,30,30
Mendocino,46,2022-10-31,23,23,23,0,709,710,709,1,1,0,0,2,136,136,136,136
Merced,46,2022-10-31,114,114,114,0,2139,2145,2144,1,5,1,1,0,875,875,874,874
Modoc,46,2022-10-31,1,1,1,0,13,14,13,1,0,0,0,0,9,9,9,9
Mono,46,2022-10-31,1,1,1,0,85,86,85,1,1,0,0,0,8,8,8,8
Monterey,46,2022-10-31,150,150,150,0,3693,3701,3700,1,18,2,2,0,774,774,772,772
Napa,46,2022-10-31,54,54,54,0,1505,1507,1506,1,2,0,0,0,159,159,159,159
Nevada,46,2022-10-31,38,38,38,0,775,776,775,1,6,0,0,0,136,136,136,136
Orange,46,2022-10-31,1189,1189,1189,0,27139,27189,27188,1,91,14,14,14,7617,7617,7603,7603
Placer,46,2022-10-31,151,151,151,0,2755,2762,2761,1,40,0,0,5,662,662,662,662
Plumas,46,2022-10-31,5,5,5,0,87,88,87,1,0,0,0,0,13,13,13,13
Riverside,46,2022-10-31,1049,1049,1049,0,19558,19594,19593,1,64,5,5,5,6660,6660,6655,6655
Sacramento,46,2022-10-31,754,754,754,0,14140,14167,14166,1,80,8,8,16,3382,3382,3374,3374
San Benito,46,2022-10-31,33,33,33,0,745,746,745,1,1,0,0,1,102,102,102,102
San Bernardino,46,2022-10-31,1048,1048,1048,0,22481,22522,22521,1,64,2,2,11,8102,8102,8100,8100
San Diego,46,2022-10-31,1772,1776,1776,0,42850,42931,42930,1,109,5,5,13,5603,5603,5598,5598
San Francisco,46,2022-10-31,620,620,620,0,14642,14668,14667,1,45,3,3,3,1077,1077,1074,1074
San Joaquin,46,2022-10-31,332,332,332,0,8598,8616,8615,1,21,6,6,3,2353,2353,2347,2347
San Luis Obispo,46,2022-10-31,81,81,81,0,2013,2018,2017,1,1,1,1,0,530,530,529,529
San Mateo,46,2022-10-31,521,521,521,0,11581,11603,11602,1,30,0,0,2,738,738,738,738
Santa Barbara,46,2022-10-31,181,181,181,0,6036,6049,6048,1,20,1,1,6,735,735,734,734
Santa Clara,46,2022-10-31,1288,1288,1288,0,30978,31037,31036,1,85,3,3,16,2553,2553,2550,2550
Santa Cruz,46,2022-10-31,188,188,188,0,9957,9977,9976,1,7,0,0,0,275,275,275,275
Shasta,46,2022-10-31,66,66,66,0,830,831,830,1,6,2,2,1,593,593,591,591
Siskiyou,46,2022-10-31,17,17,17,0,216,217,216,1,1,1,1,0,95,95,94,94
Solano,46,2022-10-31,310,310,310,0,5255,5266,5265,1,16,0,0,4,460,460,460,460
Sonoma,46,2022-10-31,206,206,206,0,5598,5611,5610,1,24,0,0,3,529,529,529,529
Stanislaus,46,2022-10-31,235,235,235,0,4830,4840,4839,1,49,1,1,8,1796,1796,1795,1795
Sutter,46,2022-10-31,55,55,55,0,902,903,902,1,0,0,0,0,232,232,232,232
Tehama,46,2022-10-31,26,26,26,0,395,396,395,1,1,0,0,0,217,217,217,217
Trinity,46,2022-10-31,18,18,18,0,73,74,73,1,5,0,0,0,21,21,21,21
Tulare,46,2022-10-31,153,153,153,0,3679,3686,3685,1,12,0,0,0,1550,1550,1550,1550
Tuolumne,46,2022-10-31,27,27,27,0,518,519,518,1,3,0,0,0,202,202,202,202
Ventura,46,2022-10-31,378,378,378,0,9550,9568,9567,1,24,2,2,2,1606,1606,1604,1604
Yolo,46,2022-10-31,82,82,82,0,1832,1837,1836,1,3,0,0,1,406,406,406,406
Yuba,46,2022-10-31,46,46,46,0,776,777,776,1,3,0,0,0,122,122,122,122
Alameda,47,2022-11-07,1343,1343,1343,0,24521,24570,24569,1,58,8,8,11,2070,2070,2062,2062
Amador,47,2022-11-07,32,32,32,0,685,686,685,1,3,0,0,0,94,94,94,94
Butte,47,2022-11-07,118,118,118,0,1370,1371,1370,1,11,0,0,2,467,467,467,467
Calaveras,47,2022-11-07,16,16,16,0,334,335,334,1,0,0,0,0,135,135,135,135
Colusa,47,2022-11-07,2,2,2,0,102,103,102,1,0,0,0,0,22,22,22,22
Contra Costa,47,2022-11-07,880,880,880,0,15676,15706,15705,1,43,3,3,4,1486,1486,1483,1483
Del Norte,47,2022-11-07,10,10,10,0,400,401,400,1,0,0,0,0,55,55,55,55
El Dorado,47,2022-11-07,108,108,108,0,1598,1601,1600,1,7,2,2,0,235,235,233,233
Fresno,47,2022-11-07,599,599,599,0,10716,10738,10737,1,61,3,3,9,2894,2894,2891,2891
Glenn,47,2022-11-07,29,29,29,0,131,132,131,1,0,0,0,0,53,53,53,53
Humboldt,47,2022-11-07,85,85,85,0,1025,1026,1025,1,9,0,0,2,162,162,162,162
Imperial,47,2022-11-07,210,210,210,0,3708,3715,3714,1,7,0,0,0,963,963,963,963
Inyo,47,2022-11-07,19,19,19,0,267,268,267,1,0,0,0,0,60,60,60,60
Kern,47,2022-11-07,478,478,478,0,10745,10768,10767,1,29,1,1,5,2437,2437,2436,2436
Kings,47,2022-11-07,148,148,148,0,2457,2463,2462,1,7,1,1,0,467,467,466,466
Lake,47,2022-11-07,51,51,51,0,795,796,795,1,3,0,0,1,150,150,150,150
Lassen,47,2022-11-07,10,10,10,0,451,452,451,1,0,0,0,0,63,63,63,63
Los Angeles,47,2022-11-07,8114,8129,8129,0,192441,192823,192821,2,387,55,55,53,33898,33898,33843,33843
Madera,47,2022-11-07,78,78,78,0,1612,1615,1614,1,3,0,0,4,375,375,375,375
Marin,47,2022-11-07,152,152,152,0,3369,3376,3375,1,9,0,0,0,317,317,317,317
Mariposa,47,2022-11-07,14,14,14,0,121,122,121,1,0,0,0,0,30,30,30,30
Mendocino,47,2022-11-07,37,37,37,0,819,820,819,1,4,1,1,0,137,137,136,136
Merced,47,2022-11-07,142,142,142,0,2592,2598,2597,1,9,4,4,0,879,879,875,875
Modoc,47,2022-11-07,2,2,2,0,6,7,6,1,0,0,0,0,9,9,9,9
Mono,47,2022-11-07,3,3,3,0,96,97,96,1,0,0,0,0,8,8,8,8
Monterey,47,2022-11-07,219,219,219,0,3932,3941,3940,1,18,1,1,0,775,775,774,774
Napa,47,2022-11-07,77,77,77,0,1757,1762,1761,1,6,0,0,0,159,159,159,159
Nevada,47,2022-11-07,60,60,60,0,744,745,744,1,3,0,0,1,136,136,136,136
Orange,47,2022-11-07,1285,1286,1286,0,28967,29025,29024,1,94,11,11,20,7628,7628,7617,7617
Placer,47,2022-11-07,231,231,231,0,3353,3362,3361,1,53,2,2,7,664,664,662,662
Plumas,47,2022-11-07,5,5,5,0,69,70,69,1,0,0,0,0,13,13,13,13
Riverside,47,2022-11-07,1508,1509,1509,0,21688,21731,21730,1,71,2,2,5,6662,6662,6660,6660
Sacramento,47,2022-11-07,1122,1122,1122,0,16054,16086,16085,1,90,8,8,9,3390,3390,3382,3382
San Benito,47,2022-11-07,43,43,43,0,924,925,924,1,1,0,0,0,102,102,102,102
San Bernardino,47,2022-11-07,1463,1464,1464,0,24064,24113,24112,1,76,2,2,17,8104,8104,8102,8102
San Diego,47,2022-11-07,2157,2162,2162,0,45690,45780,45779,1,117,8,8,24,5611,5611,5603,5603
San Francisco,47,2022-11-07,716,716,716,0,14906,14935,14934,1,42,2,2,8,1079,1079,1077,1077
San Joaquin,47,2022-11-07,482,482,482,0,8813,8831,8830,1,24,2,2,3,2355,2355,2353,2353
San Luis Obispo,47,2022-11-07,131,131,131,0,2272,2278,2277,1,4,0,0,2,530,530,530,530
San Mateo,47,2022-11-07,582,582,582,0,12353,12378,12377,1,27,0,0,3,738,738,738,738
Santa Barbara,47,2022-11-07,225,225,225,0,6672,6686,6685,1,18,1,1,2,736,736,735,735
Santa Clara,47,2022-11-07,1675,1677,1677,0,31524,31588,31587,1,76,7,7,19,2560,2560,2553,2553
Santa Cruz,47,2022-11-07,282,282,282,0,11333,11356,11355,1,8,0,0,0,275,275,275,275
Shasta,47,2022-11-07,98,98,98,0,1058,1060,1059,1,11,1,1,3,594,594,593,593
Siskiyou,47,2022-11-07,15,15,15,0,295,296,295,1,1,0,0,0,95,95,95,95
Solano,47,2022-11-07,384,384,384,0,5513,5525,5524,1,22,2,2,3,462,462,460,460
Sonoma,47,2022-11-07,250,250,250,0,5933,5946,5945,1,11,2,2,2,531,531,529,529
Stanislaus,47,2022-11-07,300,300,300,0,4931,4943,4942,1,42,2,2,9,1798,1798,1796,1796
Sutter,47,2022-11-07,86,86,86,0,958,959,958,1,0,0,0,0,232,232,232,232
Tehama,47,2022-11-07,47,47,47,0,472,473,472,1,2,0,0,0,217,217,217,217
Trinity,47,2022-11-07,2,2,2,0,34,35,34,1,0,0,0,0,21,21,21,21
Tulare,47,2022-11-07,160,160,160,0,4366,4374,4373,1,14,0,0,0,1550,1550,1550,1550
Tuolumne,47,2022-11-07,83,83,83,0,682,683,682,1,2,0,0,0,202,202,202,202
Ventura,47,2022-11-07,448,448,448,0,10372,10394,10393,1,36,2,2,1,1608,1608,1606,1606
Yolo,47,2022-11-07,173,173,173,0,2238,2244,2243,1,3,2,2,0,408,408,406,406
Yuba,47,2022-11-07,47,47,47,0,902,903,902,1,3,0,0,2,122,122,122,122
Alameda,48,2022-11-14,1508,1509,1509,0,24309,24359,24358,1,77,3,3,9,2073,2073,2070,2070
Amador,48,2022-11-14,20,20,20,0,656,657,656,1,2,0,0,0,94,94,94,94
Butte,48,2022-11-14,120,120,120,0,1380,1384,1383,1,20,0,0,1,467,467,467,467
Calaveras,48,2022-11-14,30,30,30,0,341,342,341,1,0,0,0,0,135,135,135,135
Colusa,48,2022-11-14,11,11,11,0,100,101,100,1,1,0,0,0,22,22,22,22
Contra Costa,48,2022-11-14,968,968,968,0,15962,15996,15995,1,56,1,1,5,1487,1487,1486,1486
Del Norte,48,2022-11-14,20,20,20,0,429,430,429,1,1,0,0,0,55,55,55,55
El Dorado,48,2022-11-14,143,143,143,0,1591,1595,1594,1,7,0,0,1,235,235,235,235
Fresno,48,2022-11-14,772,772,772,0,11276,11300,11299,1,72,8,8,13,2902,2902,2894,2894
Glenn,48,2022-11-14,20,20,20,0,160,161,160,1,0,0,0,0,53,53,53,53
Humboldt,48,2022-11-14,84,84,84,0,1105,1106,1105,1,6,0,0,0,162,162,162,162
Imperial,48,2022-11-14,251,251,251,0,3220,3228,3227,1,4,0,0,1,963,963,963,963
Inyo,48,2022-11-14,11,11,11,0,543,544,543,1,0,0,0,0,60,60,60,60
Kern,48,2022-11-14,470,470,470,0,10704,10728,10727,1,26,1,1,6,2438,2438,2437,2437
Kings,48,2022-11-14,201,201,201,0,2624,2630,2629,1,6,2,2,0,469,469,467,467
Lake,48,2022-11-14,54,54,54,0,803,804,803,1,2,0,0,1,150,150,150,150
Lassen,48,2022-11-14,35,35,35,0,544,545,544,1,0,1,1,0,64,64,63,63
Los Angeles,48,2022-11-14,9433,9453,9453,0,197408,197818,197816,2,477,49,49,75,33947,33947,33898,33898
Madera,48,2022-11-14,95,95,95,0,1713,1718,1717,1,4,0,0,3,375,375,375,375
Marin,48,2022-11-14,175,175,175,0,3569,3578,3577,1,8,0,0,2,317,317,317,317
Mariposa,48,2022-11-14,18,18,18,0,137,138,137,1,0,0,0,0,30,30,30,30
Mendocino,48,2022-11-14,39,39,39,0,908,909,908,1,3,0,0,1,137,137,137,137
Merced,48,2022-11-14,186,186,186,0,2639,2645,2644,1,6,0,0,0,879,879,879,879
Modoc,48,2022-11-14,3,3,3,0,11,12,11,1,0,0,0,0,9,9,9,9
Mono,48,2022-11-14,10,10,10,0,122,123,122,1,0,0,0,0,8,8,8,8
Monterey,48,2022-11-14,200,200,200,0,4157,4166,4165,1,20,1,1,1,776,776,775,775
Napa,48,2022-11-14,106,106,106,0,1919,1924,1923,1,5,0,0,0,159,159,159,159
Nevada,48,2022-11-14,65,65,65,0,797,799,798,1,3,0,0,2,136,136,136,136
Orange,48,2022-11-14,1618,1621,1621,0,27194,27252,27251,1,118,8,8,21,7636,7636,7628,7628
Placer,48,2022-11-14,320,320,320,0,3855,3864,3863,1,54,1,1,5,665,665,664,664
Plumas,48,2022-11-14,4,4,4,0,80,81,80,1,0,0,0,0,13,13,13,13
Riverside,48,2022-11-14,1662,1664,1664,0,22496,22543,22542,1,95,4,4,10,6666,6666,6662,6662
Sacramento,48,2022-11-14,1213,1214,1214,0,16983,17019,17018,1,82,7,7,18,3397,3397,3390,3390
San Benito,48,2022-11-14,42,42,42,0,979,980,979,1,1,0,0,0,102,102,102,102
San Bernardino,48,2022-11-14,1816,1819,1819,0,24234,24285,24284,1,83,0,0,14,8104,8104,8104,8104
San Diego,48,2022-11-14,2456,2463,2463,0,43913,44004,44003,1,124,7,7,21,5618,5618,5611,5611
San Francisco,48,2022-11-14,717,717,717,0,13762,13791,13790,1,52,7,7,5,1086,1086,1079,1079
San Joaquin,48,2022-11-14,609,609,609,0,9500,9522,9521,1,20,0,0,5,2355,2355,2355,2355
San Luis Obispo,48,2022-11-14,120,120,120,0,2201,2206,2205,1,6,0,0,1,530,530,530,530
San Mateo,48,2022-11-14,662,662,662,0,11419,11445,11444,1,27,0,0,2,738,738,738,738
Santa Barbara,48,2022-11-14,192,192,192,0,5891,5904,5903,1,15,1,1,2,737,737,736,736
Santa Clara,48,2022-11-14,1773,1778,1778,0,30788,30853,30852,1,117,3,3,14,2563,2563,2560,2560
Santa Cruz,48,2022-11-14,249,249,249,0,9607,9627,9626,1,11,1,1,0,276,276,275,275
Shasta,48,2022-11-14,107,107,107,0,1073,1075,1074,1,10,1,1,2,595,595,594,594
Siskiyou,48,2022-11-14,27,27,27,0,397,398,397,1,2,0,0,0,95,95,95,95
Solano,48,2022-11-14,438,438,438,0,5428,5440,5439,1,26,0,0,3,462,462,462,462
Sonoma,48,2022-11-14,269,269,269,0,6037,6050,6049,1,23,1,1,0,532,532,531,531
Stanislaus,48,2022-11-14,328,328,328,0,5223,5236,5235,1,48,0,0,10,1798,1798,1798,1798
Sutter,48,2022-11-14,95,95,95,0,1183,1185,1184,1,0,0,0,0,232,232,232,232
Tehama,48,2022-11-14,49,49,49,0,574,575,574,1,1,0,0,0,217,217,217,217
Trinity,48,2022-11-14,11,11,11,0,52,53,52,1,0,1,1,0,22,22,21,21
Tulare,48,2022-11-14,311,311,311,0,4283,4291,4290,1,16,0,0,1,1550,1550,1550,1550
Tuolumne,48,2022-11-14,77,77,77,0,695,696,695,1,2,0,0,0,202,202,202,202
Ventura,48,2022-11-14,572,572,572,0,10636,10659,10658,1,28,1,1,4,1609,1609,1608,1608
Yolo,48,2022-11-14,152,152,152,0,2164,2169,2168,1,2,6,6,0,414,414,408,408
Yuba,48,2022-11-14,60,60,60,0,987,988,987,1,6,0,0,1,122,122,122,122
Alameda,49,2022-11-21,1744,1749,1749,0,25498,25554,25553,1,82,9,9,16,2082,2082,2073,2073
Amador,49,2022-11-21,28,28,28,0,833,835,834,1,2,0,0,0,94,94,94,94
Butte,49,2022-11-21,143,143,143,0,1328,1330,1329,1,21,0,0,1,467,467,467,467
Calaveras,49,2022-11-21,40,40,40,0,421,422,421,1,2,0,0,0,135,135,135,135
Colusa,49,2022-11-21,9,9,9,0,110,111,110,1,0,0,0,0,22,22,22,22
Contra Costa,49,2022-11-21,1029,1029,1029,0,16521,16556,16555,1,52,3,3,8,1490,1490,1487,1487
Del Norte,49,2022-11-21,18,18,18,0,489,490,489,1,4,0,0,0,55,55,55,55
El Dorado,49,2022-11-21,186,186,186,0,1830,1836,1835,1,10,0,0,1,235,235,235,235
Fresno,49,2022-11-21,1070,1070,1070,0,12149,12175,12174,1,114,5,5,9,2907,2907,2902,2902
Glenn,49,2022-11-21,21,21,21,0,214,215,214,1,0,0,0,0,53,53,53,53
Humboldt,49,2022-11-21,123,123,123,0,1174,1177,1176,1,4,1,1,1,163,163,162,162
Imperial,49,2022-11-21,280,280,280,0,3122,3129,3128,1,3,1,1,1,964,964,963,963
Inyo,49,2022-11-21,29,29,29,0,405,406,405,1,0,1,1,0,61,61,60,60
Kern,49,2022-11-21,506,506,506,0,10333,10357,10356,1,54,3,3,10,2441,2441,2438,2438
Kings,49,2022-11-21,295,295,295,0,2780,2787,2786,1,4,2,2,1,471,471,469,469
Lake,49,2022-11-21,55,55,55,0,929,930,929,1,0,1,1,1,151,151,150,150
Lassen,49,2022-11-21,34,34,34,0,541,542,541,1,0,0,0,0,64,64,64,64
Los Angeles,49,2022-11-21,13235,13263,13263,0,200574,201011,201009,2,648,69,69,93,34016,34016,33947,33947
Madera,49,2022-11-21,168,168,168,0,1861,1867,1866,1,11,0,0,1,375,375,375,375
Marin,49,2022-11-21,179,179,179,0,3353,3360,3359,1,8,0,0,0,317,317,317,317
Mariposa,49,2022-11-21,19,19,19,0,170,171,170,1,0,0,0,0,30,30,30,30
Mendocino,49,2022-11-21,39,39,39,0,890,891,890,1,4,0,0,1,137,137,137,137
Merced,49,2022-11-21,269,269,269,0,2931,2937,2936,1,9,2,2,4,881,881,879,879
Modoc,49,2022-11-21,8,8,8,0,13,14,13,1,0,0,0,0,9,9,9,9
Mono,49,2022-11-21,3,3,3,0,107,108,107,1,0,0,0,0,8,8,8,8
Monterey,49,2022-11-21,227,227,227,0,4444,4455,4454,1,17,1,1,0,777,777,776,776
Napa,49,2022-11-21,146,146,146,0,2040,2046,2045,1,4,0,0,1,159,159,159,159
Nevada,49,2022-11-21,92,92,92,0,935,936,935,1,2,0,0,2,136,136,136,136
Orange,49,2022-11-21,2240,2246,2246,0,28654,28717,28716,1,170,14,14,32,7650,7650,7636,7636
Placer,49,2022-11-21,362,362,362,0,4079,4087,4086,1,53,0,0,6,665,665,665,665
Plumas,49,2022-11-21,7,7,7,0,104,105,104,1,1,0,0,0,13,13,13,13
Riverside,49,2022-11-21,2181,2187,2187,0,24558,24611,24610,1,110,7,7,9,6673,6673,6666,6666
Sacramento,49,2022-11-21,1554,1558,1558,0,19058,19099,19098,1,105,3,3,18,3400,3400,3397,3397
San Benito,49,2022-11-21,64,64,64,0,1156,1158,1157,1,2,0,0,0,102,102,102,102
San Bernardino,49,2022-11-21,2391,2397,2397,0,26915,26972,26971,1,89,1,1,19,8105,8105,8104,8104
San Diego,49,2022-11-21,3174,3182,3182,0,44135,44231,44230,1,198,3,3,26,5621,5621,5618,5618
San Francisco,49,2022-11-21,958,958,958,0,15162,15194,15193,1,54,5,5,7,1091,1091,1086,1086
San Joaquin,49,2022-11-21,764,764,764,0,11080,11105,11104,1,36,1,1,5,2356,2356,2355,2355
San Luis Obispo,49,2022-11-21,170,170,170,0,2352,2358,2357,1,4,1,1,0,531,531,530,530
San Mateo,49,2022-11-21,759,759,759,0,12399,12427,12426,1,36,0,0,1,738,738,738,738
Santa Barbara,49,2022-11-21,321,321,321,0,6109,6123,6122,1,15,3,3,3,740,740,737,737
Santa Clara,49,2022-11-21,2210,2216,2216,0,34650,34726,34725,1,119,10,10,23,2573,2573,2563,2563
Santa Cruz,49,2022-11-21,286,286,286,0,9527,9548,9547,1,12,0,0,2,276,276,276,276
Shasta,49,2022-11-21,99,99,99,0,1056,1058,1057,1,14,2,2,1,597,597,595,595
Siskiyou,49,2022-11-21,24,24,24,0,342,343,342,1,1,0,0,0,95,95,95,95
Solano,49,2022-11-21,490,490,490,0,5667,5680,5679,1,32,1,1,5,463,463,462,462
Sonoma,49,2022-11-21,325,325,325,0,5783,5796,5795,1,22,0,0,4,532,532,532,532
Stanislaus,49,2022-11-21,445,445,445,0,5970,5983,5982,1,51,0,0,10,1798,1798,1798,1798
Sutter,49,2022-11-21,91,91,91,0,1143,1145,1144,1,0,0,0,0,232,232,232,232
Tehama,49,2022-11-21,74,74,74,0,673,674,673,1,3,0,0,2,217,217,217,217
Trinity,49,2022-11-21,5,5,5,0,51,52,51,1,0,0,0,0,22,22,22,22
Tulare,49,2022-11-21,429,429,429,0,5505,5519,5518,1,23,0,0,1,1550,1550,1550,1550
Tuolumne,49,2022-11-21,97,97,97,0,766,767,766,1,3,1,1,0,203,203,202,202
Ventura,49,2022-11-21,728,728,728,0,10731,10755,10754,1,43,1,1,2,1610,1610,1609,1609
Yolo,49,2022-11-21,132,132,132,0,2247,2253,2252,1,7,4,4,2,418,418,414,414
Yuba,49,2022-11-21,70,70,70,0,1027,1028,1027,1,10,0,0,1,122,122,122,122
Alameda,50,2022-11-28,2273,2279,2279,0,22325,22375,22374,1,103,6,6,13,2088,2088,2082,2082
Amador,50,2022-11-28,32,32,32,0,757,758,757,1,5,1,1,1,95,95,94,94
Butte,50,2022-11-28,204,204,204,0,1476,1480,1479,1,41,0,0,1,467,467,467,467
Calaveras,50,2022-11-28,32,32,32,0,402,403,402,1,3,0,0,0,135,135,135,135
Colusa,50,2022-11-28,14,14,14,0,184,185,184,1,0,0,0,0,22,22,22,22
Contra Costa,50,2022-11-28,1470,1473,1473,0,15541,15577,15576,1,67,4,4,8,1494,1494,1490,1490
Del Norte,50,2022-11-28,33,33,33,0,458,459,458,1,1,1,1,0,56,56,55,55
El Dorado,50,2022-11-28,185,185,185,0,1549,1553,1552,1,13,1,1,1,236,236,235,235
Fresno,50,2022-11-28,1322,1323,1323,0,11709,11737,11736,1,136,6,6,19,2913,2913,2907,2907
Glenn,50,2022-11-28,17,17,17,0,194,195,194,1,3,0,0,0,53,53,53,53
Humboldt,50,2022-11-28,114,114,114,0,1045,1047,1046,1,10,0,0,0,163,163,163,163
Imperial,50,2022-11-28,379,379,379,0,2789,2796,2795,1,6,1,1,1,965,965,964,964
Inyo,50,2022-11-28,34,34,34,0,376,377,376,1,2,0,0,0,61,61,61,61
Kern,50,2022-11-28,599,599,599,0,9537,9560,9559,1,60,5,5,6,2446,2446,2441,2441
Kings,50,2022-11-28,246,246,246,0,2545,2551,2550,1,10,0,0,0,471,471,471,471
Lake,50,2022-11-28,49,49,49,0,848,849,848,1,1,0,0,0,151,151,151,151
Lassen,50,2022-11-28,27,27,27,0,493,494,493,1,0,0,0,0,64,64,64,64
Los Angeles,50,2022-11-28,18974,19017,19017,0,185213,185639,185637,2,918,90,90,122,34106,34106,34016,34016
Madera,50,2022-11-28,162,162,162,0,1627,1632,1631,1,13,0,0,2,375,375,375,375
Marin,50,2022-11-28,298,298,298,0,3071,3079,3078,1,19,0,0,1,317,317,317,317
Mariposa,50,2022-11-28,23,23,23,0,136,137,136,1,0,0,0,0,30,30,30,30
Mendocino,50,2022-11-28,49,49,49,0,726,727,726,1,5,0,0,2,137,137,137,137
Merced,50,2022-11-28,349,349,349,0,2552,2560,2559,1,18,5,5,2,886,886,881,881
Modoc,50,2022-11-28,5,5,5,0,10,11,10,1,0,0,0,0,9,9,9,9
Mono,50,2022-11-28,4,4,4,0,94,95,94,1,0,0,0,0,8,8,8,8
Monterey,50,2022-11-28,283,283,283,0,3892,3902,3901,1,26,1,1,0,778,778,777,777
Napa,50,2022-11-28,140,140,140,0,1882,1887,1886,1,6,0,0,3,159,159,159,159
Nevada,50,2022-11-28,118,118,118,0,1008,1010,1009,1,9,0,0,0,136,136,136,136
Orange,50,2022-11-28,3189,3196,3196,0,26616,26676,26675,1,221,17,17,34,7667,7667,7650,7650
Placer,50,2022-11-28,391,391,391,0,3786,3794,3793,1,69,3,3,5,668,668,665,665
Plumas,50,2022-11-28,6,6,6,0,143,144,143,1,0,0,0,0,13,13,13,13
Riverside,50,2022-11-28,3237,3244,3244,0,23436,23490,23489,1,188,12,12,22,6685,6685,6673,6673
Sacramento,50,2022-11-28,1816,1821,1821,0,18077,18118,18117,1,126,9,9,14,3409,3409,3400,3400
San Benito,50,2022-11-28,131,131,131,0,1223,1226,1225,1,1,0,0,0,102,102,102,102
San Bernardino,50,2022-11-28,3368,3375,3375,0,26028,26087,26086,1,146,1,1,20,8106,8106,8105,8105
San Diego,50,2022-11-28,4098,4106,4106,0,32004,32078,32077,1,259,7,7,27,5628,5628,5621,5621
San Francisco,50,2022-11-28,1171,1172,1172,0,12783,12812,12811,1,67,6,6,8,1097,1097,1091,1091
San Joaquin,50,2022-11-28,994,995,995,0,10948,10976,10975,1,50,3,3,11,2359,2359,2356,2356
San Luis Obispo,50,2022-11-28,179,179,179,0,2248,2253,2252,1,9,3,3,1,534,534,531,531
San Mateo,50,2022-11-28,1117,1118,1118,0,11096,11122,11121,1,42,1,1,3,739,739,738,738
Santa Barbara,50,2022-11-28,466,466,466,0,5212,5224,5223,1,27,2,2,5,742,742,740,740
Santa Clara,50,2022-11-28,2941,2948,2948,0,28323,28389,28388,1,159,9,9,22,2582,2582,2573,2573
Santa Cruz,50,2022-11-28,371,371,371,0,6667,6684,6683,1,20,0,0,2,276,276,276,276
Shasta,50,2022-11-28,99,99,99,0,1010,1012,1011,1,16,2,2,3,599,599,597,597
Siskiyou,50,2022-11-28,27,27,27,0,277,278,277,1,2,0,0,0,95,95,95,95
Solano,50,2022-11-28,592,592,592,0,5187,5201,5200,1,34,2,2,7,465,465,463,463
Sonoma,50,2022-11-28,455,455,455,0,5012,5026,5025,1,48,2,2,3,534,534,532,532
Stanislaus,50,2022-11-28,523,523,523,0,5363,5376,5375,1,77,3,3,4,1801,1801,1798,1798
Sutter,50,2022-11-28,83,83,83,0,1120,1123,1122,1,0,0,0,0,232,232,232,232
Tehama,50,2022-11-28,70,70,70,0,632,633,632,1,6,0,0,3,217,217,217,217
Trinity,50,2022-11-28,3,3,3,0,60,61,60,1,0,0,0,0,22,22,22,22
Tulare,50,2022-11-28,509,509,509,0,4932,4945,4944,1,34,0,0,0,1550,1550,1550,1550
Tuolumne,50,2022-11-28,72,72,72,0,676,677,676,1,4,0,0,0,203,203,203,203
Ventura,50,2022-11-28,966,967,967,0,10618,10644,10643,1,58,2,2,2,1612,1612,1610,1610
Yolo,50,2022-11-28,169,169,169,0,2033,2040,2039,1,3,4,4,1,422,422,418,418
Yuba,50,2022-11-28,92,92,92,0,927,928,927,1,12,0,0,0,122,122,122,122
Alameda,51,2022-12-05,2835,2842,2842,0,29280,29352,29351,1,126,7,7,13,2095,2095,2088,2088
Amador,51,2022-12-05,41,41,41,0,812,814,813,1,3,0,0,2,95,95,95,95
Butte,51,2022-12-05,239,239,239,0,1887,1892,1891,1,38,7,7,5,474,474,467,467
Calaveras,51,2022-12-05,45,45,45,0,485,486,485,1,0,0,0,0,135,135,135,135
Colusa,51,2022-12-05,13,13,13,0,206,207,206,1,4,0,0,0,22,22,22,22
Contra Costa,51,2022-12-05,1782,1787,1787,0,19307,19355,19354,1,78,0,0,11,1494,1494,1494,1494
Del Norte,51,2022-12-05,39,39,39,0,566,567,566,1,2,0,0,0,56,56,56,56
El Dorado,51,2022-12-05,182,182,182,0,1577,1583,1582,1,14,1,1,0,237,237,236,236
Fresno,51,2022-12-05,1549,1553,1553,0,14300,14333,14332,1,177,6,6,17,2919,2919,2913,2913
Glenn,51,2022-12-05,24,24,24,0,232,233,232,1,2,0,0,0,53,53,53,53
Humboldt,51,2022-12-05,134,134,134,0,1086,1088,1087,1,17,1,1,2,164,164,163,163
Imperial,51,2022-12-05,587,587,587,0,3397,3405,3404,1,18,2,2,5,967,967,965,965
Inyo,51,2022-12-05,26,26,26,0,333,334,333,1,1,1,1,0,62,62,61,61
Kern,51,2022-12-05,819,819,819,0,10832,10858,10857,1,55,1,1,10,2447,2447,2446,2446
Kings,51,2022-12-05,294,294,294,0,3048,3056,3055,1,8,0,0,0,471,471,471,471
Lake,51,2022-12-05,64,64,64,0,831,832,831,1,2,0,0,0,151,151,151,151
Lassen,51,2022-12-05,14,14,14,0,444,445,444,1,0,0,0,0,64,64,64,64
Los Angeles,51,2022-12-05,22479,22532,22532,0,245079,245668,245665,3,1119,111,111,151,34217,34217,34106,34106
Madera,51,2022-12-05,205,205,205,0,1983,1989,1988,1,12,0,0,3,375,375,375,375
Marin,51,2022-12-05,313,313,313,0,3509,3519,3518,1,14,0,0,2,317,317,317,317
Mariposa,51,2022-12-05,19,19,19,0,174,175,174,1,0,0,0,0,30,30,30,30
Mendocino,51,2022-12-05,47,47,47,0,797,798,797,1,6,1,1,2,138,138,137,137
Merced,51,2022-12-05,352,352,352,0,3211,3220,3219,1,23,2,2,2,888,888,886,886
Modoc,51,2022-12-05,12,12,12,0,13,14,13,1,0,0,0,0,9,9,9,9
Mono,51,2022-12-05,9,9,9,0,91,92,91,1,0,0,0,0,8,8,8,8
Monterey,51,2022-12-05,272,272,272,0,4387,4399,4398,1,34,1,1,0,779,779,778,778
Napa,51,2022-12-05,161,161,161,0,2342,2348,2347,1,7,0,0,0,159,159,159,159
Nevada,51,2022-12-05,115,115,115,0,1126,1129,1128,1,8,0,0,2,136,136,136,136
Orange,51,2022-12-05,4355,4366,4366,0,34730,34814,34813,1,301,22,22,48,7689,7689,7667,7667
Placer,51,2022-12-05,396,396,396,0,4059,4070,4069,1,72,1,1,4,669,669,668,668
Plumas,51,2022-12-05,22,22,22,0,185,186,185,1,1,0,0,0,13,13,13,13
Riverside,51,2022-12-05,4047,4057,4057,0,27545,27612,27611,1,186,13,13,25,6698,6698,6685,6685
Sacramento,51,2022-12-05,2157,2163,2163,0,21272,21323,21322,1,128,9,9,28,3418,3418,3409,3409
San Benito,51,2022-12-05,218,218,218,0,1483,1488,1487,1,6,1,1,3,103,103,102,102
San Bernardino,51,2022-12-05,4125,4136,4136,0,28692,28761,28760,1,167,0,0,34,8106,8106,8106,8106
San Diego,51,2022-12-05,5686,5699,5699,0,44791,44899,44898,1,302,13,13,30,5641,5641,5628,5628
San Francisco,51,2022-12-05,1493,1498,1498,0,16003,16041,16040,1,77,7,7,7,1104,1104,1097,1097
San Joaquin,51,2022-12-05,1121,1121,1121,0,12640,12669,12668,1,70,9,9,16,2368,2368,2359,2359
San Luis Obispo,51,2022-12-05,206,206,206,0,2662,2668,2667,1,15,3,3,1,537,537,534,534
San Mateo,51,2022-12-05,1259,1261,1261,0,13631,13665,13664,1,56,1,1,1,740,740,739,739
Santa Barbara,51,2022-12-05,521,521,521,0,6765,6781,6780,1,38,1,1,9,743,743,742,742
Santa Clara,51,2022-12-05,3530,3538,3538,0,35817,35904,35903,1,207,11,11,26,2593,2593,2582,2582
Santa Cruz,51,2022-12-05,471,471,471,0,12739,12772,12771,1,22,0,0,3,276,276,276,276
Shasta,51,2022-12-05,132,132,132,0,1108,1110,1109,1,23,0,0,5,599,599,599,599
Siskiyou,51,2022-12-05,22,22,22,0,309,310,309,1,2,0,0,0,95,95,95,95
Solano,51,2022-12-05,644,644,644,0,6617,6634,6633,1,33,1,1,7,466,466,465,465
Sonoma,51,2022-12-05,509,509,509,0,5883,5898,5897,1,35,5,5,1,539,539,534,534
Stanislaus,51,2022-12-05,640,640,640,0,6730,6747,6746,1,76,1,1,7,1802,1802,1801,1801
Sutter,51,2022-12-05,96,96,96,0,1173,1175,1174,1,0,1,1,0,233,233,232,232
Tehama,51,2022-12-05,93,93,93,0,817,818,817,1,9,2,2,0,219,219,217,217
Trinity,51,2022-12-05,3,3,3,0,39,40,39,1,0,0,0,0,22,22,22,22
Tulare,51,2022-12-05,525,525,525,0,5951,5967,5966,1,35,0,0,1,1550,1550,1550,1550
Tuolumne,51,2022-12-05,107,107,107,0,852,853,852,1,2,0,0,0,203,203,203,203
Ventura,51,2022-12-05,1102,1102,1102,0,12190,12220,12219,1,71,2,2,6,1614,1614,1612,1612
Yolo,51,2022-12-05,216,216,216,0,2651,2659,2658,1,2,1,1,3,423,423,422,422
Yuba,51,2022-12-05,82,82,82,0,1038,1039,1038,1,11,0,0,1,122,122,122,122
Alameda,52,2022-12-12,2692,2699,2699,0,29594,29668,29667,1,147,11,11,20,2106,2106,2095,2095
Amador,52,2022-12-12,32,32,32,0,790,792,791,1,3,0,0,0,95,95,95,95
Butte,52,2022-12-12,182,182,182,0,1836,1842,1841,1,39,2,2,2,476,476,474,474
Calaveras,52,2022-12-12,41,41,41,0,454,455,454,1,1,0,0,0,135,135,135,135
Colusa,52,2022-12-12,12,12,12,0,272,273,272,1,1,0,0,0,22,22,22,22
Contra Costa,52,2022-12-12,1737,1742,1742,0,18442,18490,18489,1,78,10,10,4,1504,1504,1494,1494
Del Norte,52,2022-12-12,34,34,34,0,534,535,534,1,3,0,0,0,56,56,56,56
El Dorado,52,2022-12-12,146,146,146,0,1410,1415,1414,1,8,1,1,3,238,238,237,237
Fresno,52,2022-12-12,1485,1490,1490,0,13859,13895,13894,1,186,12,12,18,2931,2931,2919,2919
Glenn,52,2022-12-12,17,17,17,0,230,231,230,1,6,0,0,0,53,53,53,53
Humboldt,52,2022-12-12,107,107,107,0,1014,1015,1014,1,13,1,1,2,165,165,164,164
Imperial,52,2022-12-12,455,455,455,0,2940,2948,2947,1,27,3,3,3,970,970,967,967
Inyo,52,2022-12-12,22,22,22,0,303,304,303,1,1,0,0,0,62,62,62,62
Kern,52,2022-12-12,956,957,957,0,11016,11045,11044,1,55,2,2,4,2449,2449,2447,2447
Kings,52,2022-12-12,256,256,256,0,2855,2864,2863,1,8,2,2,0,473,473,471,471
Lake,52,2022-12-12,56,56,56,0,761,762,761,1,3,0,0,1,151,151,151,151
Lassen,52,2022-12-12,15,15,15,0,423,424,423,1,0,0,0,0,64,64,64,64
Los Angeles,52,2022-12-12,17586,17630,17630,0,227709,228287,228284,3,1113,158,158,154,34375,34375,34217,34217
Madera,52,2022-12-12,212,212,212,0,2174,2181,2180,1,15,0,0,2,375,375,375,375
Marin,52,2022-12-12,315,315,315,0,3620,3631,3630,1,24,0,0,2,317,317,317,317
Mariposa,52,2022-12-12,18,18,18,0,122,123,122,1,0,0,0,0,30,30,30,30
Mendocino,52,2022-12-12,53,53,53,0,657,658,657,1,7,1,1,0,139,139,138,138
Merced,52,2022-12-12,318,318,318,0,3324,3335,3334,1,14,0,0,2,888,888,888,888
Modoc,52,2022-12-12,5,5,5,0,10,11,10,1,0,0,0,0,9,9,9,9
Mono,52,2022-12-12,9,9,9,0,122,123,122,1,0,0,0,0,8,8,8,8
Monterey,52,2022-12-12,265,265,265,0,4258,4269,4268,1,25,3,3,2,782,782,779,779
Napa,52,2022-12-12,162,162,162,0,2173,2179,2178,1,9,1,1,0,160,160,159,159
Nevada,52,2022-12-12,90,90,90,0,969,972,971,1,5,0,0,2,136,136,136,136
Orange,52,2022-12-12,3496,3505,3505,0,31465,31545,31544,1,300,35,35,48,7724,7724,7689,7689
Placer,52,2022-12-12,332,332,332,0,3892,3903,3902,1,73,5,5,6,674,674,669,669
Plumas,52,2022-12-12,7,7,7,0,186,187,186,1,2,0,0,0,13,13,13,13
Riverside,52,2022-12-12,3337,3344,3344,0,24681,24745,24744,1,204,20,20,25,6718,6718,6698,6698
Sacramento,52,2022-12-12,1824,1830,1830,0,20159,20210,20209,1,173,7,7,31,3425,3425,3418,3418
San Benito,52,2022-12-12,125,125,125,0,1330,1334,1333,1,2,2,2,2,105,105,103,103
San Bernardino,52,2022-12-12,3602,3611,3611,0,26989,27057,27056,1,226,4,4,36,8110,8110,8106,8106
San Diego,52,2022-12-12,4849,4861,4861,0,40660,40762,40761,1,331,15,15,45,5656,5656,5641,5641
San Francisco,52,2022-12-12,1428,1433,1433,0,16805,16849,16848,1,103,7,7,12,1111,1111,1104,1104
San Joaquin,52,2022-12-12,1000,1001,1001,0,12712,12745,12744,1,68,6,6,19,2374,2374,2368,2368
San Luis Obispo,52,2022-12-12,231,231,231,0,2650,2656,2655,1,10,1,1,0,538,538,537,537
San Mateo,52,2022-12-12,1171,1173,1173,0,12499,12532,12531,1,59,1,1,3,741,741,740,740
Santa Barbara,52,2022-12-12,512,512,512,0,5768,5783,5782,1,36,2,2,6,745,745,743,743
Santa Clara,52,2022-12-12,3260,3268,3268,0,35159,35250,35249,1,198,19,19,30,2612,2612,2593,2593
Santa Cruz,52,2022-12-12,578,578,578,0,12939,12974,12973,1,29,0,0,1,276,276,276,276
Shasta,52,2022-12-12,107,107,107,0,1154,1156,1155,1,22,0,0,5,599,599,599,599
Siskiyou,52,2022-12-12,15,15,15,0,245,246,245,1,2,0,0,0,95,95,95,95
Solano,52,2022-12-12,635,635,635,0,6178,6195,6194,1,42,2,2,7,468,468,466,466
Sonoma,52,2022-12-12,559,559,559,0,5592,5607,5606,1,41,2,2,7,541,541,539,539
Stanislaus,52,2022-12-12,593,593,593,0,6383,6399,6398,1,104,8,8,12,1810,1810,1802,1802
Sutter,52,2022-12-12,114,114,114,0,1156,1158,1157,1,0,0,0,0,233,233,233,233
Tehama,52,2022-12-12,80,80,80,0,774,775,774,1,6,1,1,0,220,220,219,219
Trinity,52,2022-12-12,3,3,3,0,45,46,45,1,0,0,0,0,22,22,22,22
Tulare,52,2022-12-12,440,440,440,0,5892,5908,5907,1,27,2,2,2,1552,1552,1550,1550
Tuolumne,52,2022-12-12,133,133,133,0,936,937,936,1,5,0,0,0,203,203,203,203
Ventura,52,2022-12-12,915,915,915,0,10660,10688,10687,1,72,4,4,7,1618,1618,1614,1614
Yolo,52,2022-12-12,210,210,210,0,2300,2308,2307,1,5,2,2,2,425,425,423,423
Yuba,52,2022-12-12,75,75,75,0,948,949,948,1,13,0,0,0,122,122,122,122
Alameda,53,2022-12-19,2349,2356,2356,0,27041,27114,27113,1,144,11,11,19,2117,2117,2106,2106
Amador,53,2022-12-19,42,42,42,0,807,808,807,1,6,0,0,0,95,95,95,95
Butte,53,2022-12-19,128,128,128,0,1639,1644,1643,1,34,3,3,2,479,479,476,476
Calaveras,53,2022-12-19,29,29,29,0,441,442,441,1,1,1,1,0,136,136,135,135
Colusa,53,2022-12-19,12,12,12,0,214,215,214,1,1,0,0,0,22,22,22,22
Contra Costa,53,2022-12-19,1715,1722,1722,0,17365,17413,17412,1,95,6,6,7,1510,1510,1504,1504
Del Norte,53,2022-12-19,39,39,39,0,553,554,553,1,3,0,0,0,56,56,56,56
El Dorado,53,2022-12-19,160,160,160,0,1632,1638,1637,1,9,1,1,2,239,239,238,238
Fresno,53,2022-12-19,1180,1183,1183,0,12896,12931,12930,1,212,7,7,22,2938,2938,2931,2931
Glenn,53,2022-12-19,21,21,21,0,205,206,205,1,6,0,0,0,53,53,53,53
Humboldt,53,2022-12-19,113,113,113,0,945,947,946,1,9,0,0,1,165,165,165,165
Imperial,53,2022-12-19,262,262,262,0,2546,2553,2552,1,16,1,1,0,971,971,970,970
Inyo,53,2022-12-19,12,12,12,0,324,325,324,1,1,0,0,0,62,62,62,62
Kern,53,2022-12-19,940,940,940,0,10706,10737,10736,1,60,3,3,5,2452,2452,2449,2449
Kings,53,2022-12-19,229,229,229,0,2770,2779,2778,1,6,4,4,1,477,477,473,473
Lake,53,2022-12-19,70,70,70,0,794,795,794,1,4,1,1,0,152,152,151,151
Lassen,53,2022-12-19,8,8,8,0,466,467,466,1,0,0,0,0,64,64,64,64
Los Angeles,53,2022-12-19,15304,15345,15345,0,204268,204821,204819,2,1096,129,129,155,34504,34504,34375,34375
Madera,53,2022-12-19,186,186,186,0,1891,1897,1896,1,10,0,0,1,375,375,375,375
Marin,53,2022-12-19,268,268,268,0,3234,3245,3244,1,17,0,0,0,317,317,317,317
Mariposa,53,2022-12-19,25,25,25,0,133,134,133,1,0,0,0,0,30,30,30,30
Mendocino,53,2022-12-19,66,66,66,0,755,756,755,1,4,0,0,0,139,139,139,139
Merced,53,2022-12-19,262,262,262,0,2773,2781,2780,1,15,2,2,2,890,890,888,888
Modoc,53,2022-12-19,8,8,8,0,21,22,21,1,0,0,0,0,9,9,9,9
Mono,53,2022-12-19,11,11,11,0,121,122,121,1,1,0,0,0,8,8,8,8
Monterey,53,2022-12-19,232,232,232,0,3880,3892,3891,1,13,1,1,1,783,783,782,782
Napa,53,2022-12-19,181,181,181,0,2094,2101,2100,1,8,0,0,0,160,160,160,160
Nevada,53,2022-12-19,72,72,72,0,883,885,884,1,5,0,0,2,136,136,136,136
Orange,53,2022-12-19,3306,3315,3315,0,30248,30330,30329,1,296,33,33,51,7757,7757,7724,7724
Placer,53,2022-12-19,364,364,364,0,3845,3858,3857,1,90,1,1,10,675,675,674,674
Plumas,53,2022-12-19,7,7,7,0,188,189,188,1,0,0,0,0,13,13,13,13
Riverside,53,2022-12-19,3165,3173,3173,0,22873,22935,22934,1,177,21,21,22,6739,6739,6718,6718
Sacramento,53,2022-12-19,1739,1744,1744,0,19756,19810,19809,1,210,15,15,22,3440,3440,3425,3425
San Benito,53,2022-12-19,105,105,105,0,1136,1140,1139,1,0,4,4,1,109,109,105,105
San Bernardino,53,2022-12-19,3215,3224,3224,0,25080,25148,25147,1,200,4,4,38,8114,8114,8110,8110
San Diego,53,2022-12-19,4854,4867,4867,0,39403,39511,39510,1,381,16,16,45,5672,5672,5656,5656
San Francisco,53,2022-12-19,1228,1232,1232,0,15732,15775,15774,1,106,11,11,17,1122,1122,1111,1111
San Joaquin,53,2022-12-19,851,851,851,0,12995,13031,13030,1,58,11,11,19,2385,2385,2374,2374
San Luis Obispo,53,2022-12-19,242,242,242,0,2423,2429,2428,1,17,1,1,0,539,539,538,538
San Mateo,53,2022-12-19,958,959,959,0,11890,11923,11922,1,62,1,1,5,742,742,741,741
Santa Barbara,53,2022-12-19,470,470,470,0,5251,5265,5264,1,35,4,4,5,749,749,745,745
Santa Clara,53,2022-12-19,2837,2844,2844,0,32490,32578,32577,1,205,16,16,30,2628,2628,2612,2612
Santa Cruz,53,2022-12-19,260,260,260,0,11208,11240,11239,1,31,0,0,1,276,276,276,276
Shasta,53,2022-12-19,109,109,109,0,1126,1129,1128,1,24,2,2,4,601,601,599,599
Siskiyou,53,2022-12-19,15,15,15,0,258,259,258,1,2,0,0,0,95,95,95,95
Solano,53,2022-12-19,639,639,639,0,6177,6195,6194,1,41,0,0,6,468,468,468,468
Sonoma,53,2022-12-19,478,478,478,0,5425,5441,5440,1,38,1,1,4,542,542,541,541
Stanislaus,53,2022-12-19,474,474,474,0,5998,6014,6013,1,94,1,1,12,1811,1811,1810,1810
Sutter,53,2022-12-19,81,81,81,0,1074,1076,1075,1,0,1,1,0,234,234,233,233
Tehama,53,2022-12-19,68,68,68,0,676,677,676,1,6,1,1,0,221,221,220,220
Trinity,53,2022-12-19,2,2,2,0,31,32,31,1,0,0,0,0,22,22,22,22
Tulare,53,2022-12-19,466,466,466,0,5382,5399,5398,1,53,5,5,1,1557,1557,1552,1552
Tuolumne,53,2022-12-19,88,88,88,0,841,842,841,1,2,1,1,1,204,204,203,203
Ventura,53,2022-12-19,937,938,938,0,9969,9997,9996,1,81,4,4,9,1622,1622,1618,1618
Yolo,53,2022-12-19,172,172,172,0,1967,1973,1972,1,5,4,4,0,429,429,425,425
Yuba,53,2022-12-19,81,81,81,0,900,901,900,1,7,0,0,0,122,122,122,122
Alameda,54,2022-12-26,1969,1975,1975,0,20711,20771,20770,1,150,11,11,17,2128,2128,2117,2117
Amador,54,2022-12-26,43,43,43,0,758,760,759,1,5,1,1,0,96,96,95,95
Butte,54,2022-12-26,95,95,95,0,1296,1301,1300,1,33,0,0,1,479,479,479,479
Calaveras,54,2022-12-26,24,24,24,0,366,367,366,1,0,1,1,0,137,137,136,136
Colusa,54,2022-12-26,14,14,14,0,150,151,150,1,0,0,0,0,22,22,22,22
Contra Costa,54,2022-12-26,1454,1459,1459,0,13770,13810,13809,1,89,10,10,11,1520,1520,1510,1510
Del Norte,54,2022-12-26,33,33,33,0,420,421,420,1,3,0,0,0,56,56,56,56
El Dorado,54,2022-12-26,152,152,152,0,1317,1323,1322,1,7,1,1,0,240,240,239,239
Fresno,54,2022-12-26,1090,1093,1093,0,10692,10724,10723,1,186,10,10,33,2948,2948,2938,2938
Glenn,54,2022-12-26,12,12,12,0,196,197,196,1,0,0,0,0,53,53,53,53
Humboldt,54,2022-12-26,82,82,82,0,631,632,631,1,5,2,2,2,167,167,165,165
Imperial,54,2022-12-26,234,234,234,0,2164,2172,2171,1,67,2,2,0,973,973,971,971
Inyo,54,2022-12-26,13,13,13,0,158,159,158,1,1,0,0,0,62,62,62,62
Kern,54,2022-12-26,702,702,702,0,8863,8889,8888,1,51,9,9,8,2461,2461,2452,2452
Kings,54,2022-12-26,200,200,200,0,2296,2304,2303,1,5,0,0,2,477,477,477,477
Lake,54,2022-12-26,58,58,58,0,601,602,601,1,3,0,0,1,152,152,152,152
Lassen,54,2022-12-26,27,27,27,0,485,486,485,1,0,0,0,0,64,64,64,64
Los Angeles,54,2022-12-26,13499,13538,13538,0,134739,135131,135129,2,1032,170,170,164,34674,34674,34504,34504
Madera,54,2022-12-26,166,166,166,0,1565,1571,1570,1,6,0,0,1,375,375,375,375
Marin,54,2022-12-26,214,214,214,0,2555,2563,2562,1,29,0,0,2,317,317,317,317
Mariposa,54,2022-12-26,22,22,22,0,105,106,105,1,0,0,0,0,30,30,30,30
Mendocino,54,2022-12-26,75,75,75,0,646,647,646,1,10,0,0,0,139,139,139,139
Merced,54,2022-12-26,212,212,212,0,1965,1971,1970,1,17,5,5,3,895,895,890,890
Modoc,54,2022-12-26,4,4,4,0,11,12,11,1,0,0,0,0,9,9,9,9
Mono,54,2022-12-26,10,10,10,0,83,84,83,1,0,0,0,0,8,8,8,8
Monterey,54,2022-12-26,191,191,191,0,2963,2973,2972,1,21,5,5,0,788,788,783,783
Napa,54,2022-12-26,142,142,142,0,1720,1726,1725,1,12,0,0,0,160,160,160,160
Nevada,54,2022-12-26,66,66,66,0,751,752,751,1,9,0,0,1,136,136,136,136
Orange,54,2022-12-26,3286,3297,3297,0,25032,25105,25104,1,274,38,38,31,7795,7795,7757,7757
Placer,54,2022-12-26,291,291,291,0,3048,3059,3058,1,87,2,2,12,677,677,675,675
Plumas,54,2022-12-26,10,10,10,0,123,124,123,1,0,0,0,0,13,13,13,13
Riverside,54,2022-12-26,2933,2941,2941,0,18672,18727,18726,1,194,12,12,18,6751,6751,6739,6739
Sacramento,54,2022-12-26,1392,1397,1397,0,14559,14601,14600,1,179,14,14,25,3454,3454,3440,3440
San Benito,54,2022-12-26,106,106,106,0,810,812,811,1,1,0,0,1,109,109,109,109
San Bernardino,54,2022-12-26,2957,2965,2965,0,20247,20307,20306,1,210,7,7,26,8121,8121,8114,8114
San Diego,54,2022-12-26,4607,4620,4620,0,28935,29019,29018,1,395,25,25,45,5697,5697,5672,5672
San Francisco,54,2022-12-26,1031,1034,1034,0,11831,11867,11866,1,90,20,20,15,1142,1142,1122,1122
San Joaquin,54,2022-12-26,750,750,750,0,10079,10108,10107,1,60,7,7,10,2392,2392,2385,2385
San Luis Obispo,54,2022-12-26,212,212,212,0,1973,1979,1978,1,20,3,3,0,542,542,539,539
San Mateo,54,2022-12-26,844,845,845,0,8983,9010,9009,1,55,0,0,6,742,742,742,742
Santa Barbara,54,2022-12-26,485,485,485,0,4098,4111,4110,1,40,0,0,4,749,749,749,749
Santa Clara,54,2022-12-26,2340,2346,2346,0,24200,24271,24270,1,179,9,9,35,2637,2637,2628,2628
Santa Cruz,54,2022-12-26,221,221,221,0,4641,4656,4655,1,25,0,0,2,276,276,276,276
Shasta,54,2022-12-26,100,100,100,0,923,927,926,1,18,1,1,1,602,602,601,601
Siskiyou,54,2022-12-26,17,17,17,0,266,267,266,1,1,0,0,0,95,95,95,95
Solano,54,2022-12-26,648,648,648,0,5238,5254,5253,1,59,2,2,7,470,470,468,468
Sonoma,54,2022-12-26,454,454,454,0,4248,4262,4261,1,39,1,1,4,543,543,542,542
Stanislaus,54,2022-12-26,451,451,451,0,4899,4915,4914,1,96,10,10,5,1821,1821,1811,1811
Sutter,54,2022-12-26,128,128,128,0,928,930,929,1,0,0,0,0,234,234,234,234
Tehama,54,2022-12-26,47,47,47,0,607,608,607,1,2,3,3,0,224,224,221,221
Trinity,54,2022-12-26,3,3,3,0,39,40,39,1,0,0,0,0,22,22,22,22
Tulare,54,2022-12-26,439,439,439,0,3936,3949,3948,1,41,7,7,3,1564,1564,1557,1557
Tuolumne,54,2022-12-26,93,93,93,0,758,759,758,1,6,2,2,2,206,206,204,204
Ventura,54,2022-12-26,888,889,889,0,7867,7891,7890,1,71,16,16,11,1638,1638,1622,1622
Yolo,54,2022-12-26,141,141,141,0,1612,1618,1617,1,9,2,2,1,431,431,429,429
Yuba,54,2022-12-26,99,99,99,0,754,755,754,1,14,0,0,0,122,122,122,122
Alameda,55,2023-01-02,1857,1863,1863,0,20044,20106,20105,1,175,14,14,19,2142,2142,2128,2128
Amador,55,2023-01-02,34,34,34,0,677,678,677,1,3,1,1,0,97,97,96,96
Butte,55,2023-01-02,99,99,99,0,1326,1332,1331,1,35,3,3,2,482,482,479,479
Calaveras,55,2023-01-02,33,33,33,0,361,362,361,1,0,2,2,0,139,139,137,137
Colusa,55,2023-01-02,5,5,5,0,94,95,94,1,0,0,0,0,22,22,22,22
Contra Costa,55,2023-01-02,1385,1390,1390,0,14061,14104,14103,1,89,5,5,13,1525,1525,1520,1520
Del Norte,55,2023-01-02,32,32,32,0,408,409,408,1,3,0,0,2,56,56,56,56
El Dorado,55,2023-01-02,147,147,147,0,1408,1414,1413,1,7,1,1,2,241,241,240,240
Fresno,55,2023-01-02,1066,1069,1069,0,11367,11403,11402,1,195,16,16,28,2964,2964,2948,2948
Glenn,55,2023-01-02,12,12,12,0,190,191,190,1,0,0,0,0,53,53,53,53
Humboldt,55,2023-01-02,48,48,48,0,618,619,618,1,2,0,0,2,167,167,167,167
Imperial,55,2023-01-02,205,205,205,0,2031,2039,2038,1,11,0,0,1,973,973,973,973
Inyo,55,2023-01-02,16,16,16,0,226,227,226,1,1,0,0,0,62,62,62,62
Kern,55,2023-01-02,892,895,895,0,9786,9818,9817,1,66,3,3,8,2464,2464,2461,2461
Kings,55,2023-01-02,187,187,187,0,2165,2173,2172,1,4,2,2,1,479,479,477,477
Lake,55,2023-01-02,47,47,47,0,604,605,604,1,3,1,1,0,153,153,152,152
Lassen,55,2023-01-02,13,13,13,0,490,491,490,1,0,0,0,0,64,64,64,64
Los Angeles,55,2023-01-02,13393,13436,13436,0,138288,138722,138720,2,1091,145,145,154,34819,34819,34674,34674
Madera,55,2023-01-02,153,153,153,0,1654,1660,1659,1,7,0,0,0,375,375,375,375
Marin,55,2023-01-02,225,225,225,0,2407,2416,2415,1,24,0,0,2,317,317,317,317
Mariposa,55,2023-01-02,15,15,15,0,94,95,94,1,0,0,0,0,30,30,30,30
Mendocino,55,2023-01-02,59,59,59,0,687,689,688,1,6,1,1,3,140,140,139,139
Merced,55,2023-01-02,193,193,193,0,2012,2018,2017,1,8,2,2,4,897,897,895,895
Modoc,55,2023-01-02,9,9,9,0,14,15,14,1,0,0,0,0,9,9,9,9
Mono,55,2023-01-02,10,10,10,0,66,67,66,1,0,0,0,0,8,8,8,8
Monterey,55,2023-01-02,216,216,216,0,3046,3057,3056,1,27,0,0,0,788,788,788,788
Napa,55,2023-01-02,124,124,124,0,1677,1683,1682,1,8,1,1,1,161,161,160,160
Nevada,55,2023-01-02,54,54,54,0,722,723,722,1,8,0,0,2,136,136,136,136
Orange,55,2023-01-02,3281,3292,3292,0,25267,25346,25345,1,312,38,38,28,7833,7833,7795,7795
Placer,55,2023-01-02,304,304,304,0,3244,3256,3255,1,108,1,1,8,678,678,677,677
Plumas,55,2023-01-02,12,12,12,0,145,146,145,1,1,1,1,0,14,14,13,13
Riverside,55,2023-01-02,3122,3132,3132,0,20087,20150,20149,1,223,9,9,31,6760,6760,6751,6751
Sacramento,55,2023-01-02,1519,1524,1524,0,15309,15358,15357,1,201,19,19,26,3473,3473,3454,3454
San Benito,55,2023-01-02,58,58,58,0,793,796,795,1,1,0,0,1,109,109,109,109
San Bernardino,55,2023-01-02,2872,2881,2881,0,20967,21033,21032,1,183,3,3,31,8124,8124,8121,8121
San Diego,55,2023-01-02,4633,4648,4648,0,29621,29715,29714,1,401,25,25,43,5722,5722,5697,5697
San Francisco,55,2023-01-02,886,887,887,0,10188,10220,10219,1,77,11,11,15,1153,1153,1142,1142
San Joaquin,55,2023-01-02,755,755,755,0,10415,10449,10448,1,62,6,6,12,2398,2398,2392,2392
San Luis Obispo,55,2023-01-02,210,210,210,0,1995,2001,2000,1,17,6,6,0,548,548,542,542
San Mateo,55,2023-01-02,743,744,744,0,8038,8065,8064,1,50,0,0,9,742,742,742,742
Santa Barbara,55,2023-01-02,433,433,433,0,4044,4057,4056,1,47,1,1,5,750,750,749,749
Santa Clara,55,2023-01-02,2445,2452,2452,0,23410,23484,23483,1,200,15,15,32,2652,2652,2637,2637
Santa Cruz,55,2023-01-02,171,171,171,0,3008,3019,3018,1,27,0,0,0,276,276,276,276
Shasta,55,2023-01-02,100,100,100,0,947,949,948,1,20,0,0,1,602,602,602,602
Siskiyou,55,2023-01-02,15,15,15,0,268,269,268,1,1,0,0,0,95,95,95,95
Solano,55,2023-01-02,639,639,639,0,5301,5319,5318,1,60,3,3,11,473,473,470,470
Sonoma,55,2023-01-02,424,424,424,0,4259,4273,4272,1,56,0,0,2,543,543,543,543
Stanislaus,55,2023-01-02,476,476,476,0,5020,5037,5036,1,88,6,6,8,1827,1827,1821,1821
Sutter,55,2023-01-02,97,97,97,0,889,891,890,1,0,0,0,0,234,234,234,234
Tehama,55,2023-01-02,54,54,54,0,621,622,621,1,2,5,5,0,229,229,224,224
Trinity,55,2023-01-02,4,4,4,0,41,42,41,1,0,0,0,0,22,22,22,22
Tulare,55,2023-01-02,468,468,468,0,4718,4734,4733,1,52,3,3,6,1567,1567,1564,1564
Tuolumne,55,2023-01-02,66,66,66,0,662,663,662,1,5,1,1,0,207,207,206,206
Ventura,55,2023-01-02,902,903,903,0,7466,7490,7489,1,87,10,10,13,1648,1648,1638,1638
Yolo,55,2023-01-02,135,135,135,0,1524,1531,1530,1,4,3,3,1,434,434,431,431
Yuba,55,2023-01-02,80,80,80,0,730,732,731,1,19,0,0,1,122,122,122,122
Alameda,56,2023-01-09,1495,1500,1500,0,23363,23445,23444,1,149,12,12,11,2154,2154,2142,2142
Amador,56,2023-01-09,28,28,28,0,706,708,707,1,2,0,0,0,97,97,97,97
Butte,56,2023-01-09,88,88,88,0,1203,1208,1207,1,39,2,2,3,484,484,482,482
Calaveras,56,2023-01-09,19,19,19,0,341,342,341,1,0,0,0,1,139,139,139,139
Colusa,56,2023-01-09,8,8,8,0,92,93,92,1,0,0,0,0,22,22,22,22
Contra Costa,56,2023-01-09,1055,1059,1059,0,15374,15428,15427,1,85,6,6,11,1531,1531,1525,1525
Del Norte,56,2023-01-09,17,17,17,0,367,368,367,1,5,0,0,2,56,56,56,56
El Dorado,56,2023-01-09,87,87,87,0,1453,1459,1458,1,4,0,0,0,241,241,241,241
Fresno,56,2023-01-09,806,807,807,0,11477,11516,11515,1,171,7,7,23,2971,2971,2964,2964
Glenn,56,2023-01-09,8,8,8,0,185,186,185,1,0,0,0,0,53,53,53,53
Humboldt,56,2023-01-09,57,57,57,0,708,710,709,1,7,0,0,4,167,167,167,167
Imperial,56,2023-01-09,161,161,161,0,2438,2447,2446,1,12,2,2,2,975,975,973,973
Inyo,56,2023-01-09,10,10,10,0,205,206,205,1,0,0,0,0,62,62,62,62
Kern,56,2023-01-09,620,620,620,0,10590,10628,10627,1,73,4,4,8,2468,2468,2464,2464
Kings,56,2023-01-09,183,183,183,0,2315,2325,2324,1,9,0,0,0,479,479,479,479
Lake,56,2023-01-09,44,44,44,0,622,623,622,1,3,1,1,0,154,154,153,153
Lassen,56,2023-01-09,19,19,19,0,506,507,506,1,2,0,0,0,64,64,64,64
Los Angeles,56,2023-01-09,10171,10206,10206,0,189837,190498,190496,2,965,142,142,136,34961,34961,34819,34819
Madera,56,2023-01-09,100,100,100,0,1645,1652,1651,1,8,0,0,1,375,375,375,375
Marin,56,2023-01-09,145,145,145,0,2559,2570,2569,1,18,0,0,3,317,317,317,317
Mariposa,56,2023-01-09,9,9,9,0,105,106,105,1,0,1,1,0,31,31,30,30
Mendocino,56,2023-01-09,40,40,40,0,645,646,645,1,10,2,2,3,142,142,140,140
Merced,56,2023-01-09,185,185,185,0,2151,2160,2159,1,11,1,1,1,898,898,897,897
Modoc,56,2023-01-09,8,8,8,0,14,15,14,1,0,0,0,0,9,9,9,9
Mono,56,2023-01-09,12,12,12,0,78,79,78,1,0,0,0,0,8,8,8,8
Monterey,56,2023-01-09,170,170,170,0,3126,3138,3137,1,20,4,4,3,792,792,788,788
Napa,56,2023-01-09,132,132,132,0,1878,1885,1884,1,9,0,0,3,161,161,161,161
Nevada,56,2023-01-09,42,42,42,0,760,762,761,1,6,0,0,0,136,136,136,136
Orange,56,2023-01-09,2450,2458,2458,0,28001,28099,28098,1,267,39,39,34,7872,7872,7833,7833
Placer,56,2023-01-09,260,260,260,0,3404,3417,3416,1,89,0,0,6,678,678,678,678
Plumas,56,2023-01-09,5,5,5,0,89,90,89,1,1,0,0,0,14,14,14,14
Riverside,56,2023-01-09,2002,2010,2010,0,21234,21308,21307,1,186,13,13,26,6773,6773,6760,6760
Sacramento,56,2023-01-09,1023,1027,1027,0,15633,15688,15687,1,178,16,16,28,3489,3489,3473,3473
San Benito,56,2023-01-09,51,51,51,0,817,821,820,1,1,0,0,2,109,109,109,109
San Bernardino,56,2023-01-09,1758,1765,1765,0,20708,20781,20780,1,179,6,6,36,8130,8130,8124,8124
San Diego,56,2023-01-09,3593,3606,3606,0,35162,35286,35285,1,397,25,25,40,5747,5747,5722,5722
San Francisco,56,2023-01-09,791,793,793,0,12768,12813,12812,1,75,7,7,17,1160,1160,1153,1153
San Joaquin,56,2023-01-09,590,590,590,0,10955,10994,10993,1,51,10,10,12,2408,2408,2398,2398
San Luis Obispo,56,2023-01-09,186,186,186,0,2148,2157,2156,1,12,3,3,0,551,551,548,548
San Mateo,56,2023-01-09,614,615,615,0,9704,9740,9739,1,47,0,0,5,742,742,742,742
Santa Barbara,56,2023-01-09,367,367,367,0,4500,4517,4516,1,39,3,3,1,753,753,750,750
Santa Clara,56,2023-01-09,1978,1986,1986,0,28597,28697,28696,1,182,13,13,28,2665,2665,2652,2652
Santa Cruz,56,2023-01-09,152,152,152,0,4064,4081,4080,1,27,0,0,1,276,276,276,276
Shasta,56,2023-01-09,60,60,60,0,890,894,893,1,17,0,0,2,602,602,602,602
Siskiyou,56,2023-01-09,20,20,20,0,233,234,233,1,0,0,0,0,95,95,95,95
Solano,56,2023-01-09,401,401,401,0,5182,5201,5200,1,54,1,1,6,474,474,473,473
Sonoma,56,2023-01-09,284,284,284,0,4752,4769,4768,1,31,3,3,4,546,546,543,543
Stanislaus,56,2023-01-09,303,303,303,0,5178,5196,5195,1,87,6,6,8,1833,1833,1827,1827
Sutter,56,2023-01-09,62,62,62,0,870,872,871,1,0,0,0,0,234,234,234,234
Tehama,56,2023-01-09,28,28,28,0,491,492,491,1,1,2,2,0,231,231,229,229
Trinity,56,2023-01-09,3,3,3,0,30,31,30,1,0,0,0,0,22,22,22,22
Tulare,56,2023-01-09,334,334,334,0,5103,5122,5121,1,53,5,5,2,1572,1572,1567,1567
Tuolumne,56,2023-01-09,74,74,74,0,655,656,655,1,2,1,1,0,208,208,207,207
Ventura,56,2023-01-09,662,662,662,0,9382,9416,9415,1,65,5,5,12,1653,1653,1648,1648
Yolo,56,2023-01-09,108,108,108,0,1664,1671,1670,1,2,2,2,1,436,436,434,434
Yuba,56,2023-01-09,48,48,48,0,735,736,735,1,21,0,0,1,122,122,122,122
Alameda,57,2023-01-16,869,872,872,0,19179,19254,19253,1,105,5,5,11,2159,2159,2154,2154
Amador,57,2023-01-16,20,20,20,0,585,587,586,1,4,0,0,0,97,97,97,97
Butte,57,2023-01-16,59,59,59,0,1161,1167,1166,1,21,1,1,0,485,485,484,484
Calaveras,57,2023-01-16,10,10,10,0,310,311,310,1,2,0,0,1,139,139,139,139
Colusa,57,2023-01-16,7,7,7,0,86,87,86,1,1,0,0,0,22,22,22,22
Contra Costa,57,2023-01-16,615,615,615,0,12113,12161,12160,1,61,5,5,11,1536,1536,1531,1531
Del Norte,57,2023-01-16,10,10,10,0,303,304,303,1,3,2,2,1,58,58,56,56
El Dorado,57,2023-01-16,61,61,61,0,978,983,982,1,2,1,1,1,242,242,241,241
Fresno,57,2023-01-16,463,463,463,0,9741,9781,9780,1,162,7,7,13,2978,2978,2971,2971
Glenn,57,2023-01-16,3,3,3,0,163,164,163,1,0,0,0,0,53,53,53,53
Humboldt,57,2023-01-16,35,35,35,0,499,500,499,1,9,1,1,2,168,168,167,167
Imperial,57,2023-01-16,127,127,127,0,2067,2076,2075,1,10,2,2,2,977,977,975,975
Inyo,57,2023-01-16,11,11,11,0,199,200,199,1,0,0,0,0,62,62,62,62
Kern,57,2023-01-16,386,386,386,0,8285,8319,8318,1,55,4,4,13,2472,2472,2468,2468
Kings,57,2023-01-16,126,126,126,0,1982,1991,1990,1,5,2,2,0,481,481,479,479
Lake,57,2023-01-16,23,23,23,0,576,577,576,1,2,1,1,1,155,155,154,154
Lassen,57,2023-01-16,6,6,6,0,441,442,441,1,0,0,0,0,64,64,64,64
Los Angeles,57,2023-01-16,6121,6145,6145,0,148568,149153,149151,2,855,146,146,113,35107,35107,34961,34961
Madera,57,2023-01-16,67,67,67,0,1350,1358,1357,1,4,0,0,2,375,375,375,375
Marin,57,2023-01-16,125,125,125,0,2138,2147,2146,1,20,0,0,1,317,317,317,317
Mariposa,57,2023-01-16,11,11,11,0,97,98,97,1,0,0,0,0,31,31,31,31
Mendocino,57,2023-01-16,25,25,25,0,499,500,499,1,6,0,0,0,142,142,142,142
Merced,57,2023-01-16,120,120,120,0,1691,1699,1698,1,12,3,3,5,901,901,898,898
Modoc,57,2023-01-16,2,2,2,0,9,10,9,1,0,0,0,0,9,9,9,9
Mono,57,2023-01-16,6,6,6,0,68,69,68,1,0,0,0,0,8,8,8,8
Monterey,57,2023-01-16,112,112,112,0,2603,2614,2613,1,20,3,3,2,795,795,792,792
Napa,57,2023-01-16,63,63,63,0,1512,1518,1517,1,5,0,0,0,161,161,161,161
Nevada,57,2023-01-16,25,25,25,0,565,566,565,1,4,0,0,0,136,136,136,136
Orange,57,2023-01-16,1472,1478,1478,0,24150,24245,24244,1,245,39,39,32,7911,7911,7872,7872
Placer,57,2023-01-16,163,163,163,0,2640,2653,2652,1,68,0,0,6,678,678,678,678
Plumas,57,2023-01-16,2,2,2,0,74,75,74,1,1,0,0,0,14,14,14,14
Riverside,57,2023-01-16,1219,1224,1224,0,17162,17229,17228,1,169,15,15,36,6788,6788,6773,6773
Sacramento,57,2023-01-16,572,572,572,0,12429,12480,12479,1,149,19,19,23,3508,3508,3489,3489
San Benito,57,2023-01-16,28,28,28,0,468,469,468,1,0,1,1,0,110,110,109,109
San Bernardino,57,2023-01-16,993,998,998,0,16755,16823,16822,1,148,2,2,35,8132,8132,8130,8130
San Diego,57,2023-01-16,2065,2073,2073,0,28671,28785,28784,1,327,15,15,39,5762,5762,5747,5747
San Francisco,57,2023-01-16,439,439,439,0,10154,10194,10193,1,75,2,2,12,1162,1162,1160,1160
San Joaquin,57,2023-01-16,356,356,356,0,8792,8828,8827,1,42,8,8,11,2416,2416,2408,2408
San Luis Obispo,57,2023-01-16,108,108,108,0,1777,1785,1784,1,12,2,2,3,553,553,551,551
San Mateo,57,2023-01-16,401,401,401,0,7745,7776,7775,1,37,0,0,3,742,742,742,742
Santa Barbara,57,2023-01-16,242,242,242,0,3919,3935,3934,1,34,2,2,0,755,755,753,753
Santa Clara,57,2023-01-16,1101,1105,1105,0,24075,24171,24170,1,106,17,17,16,2682,2682,2665,2665
Santa Cruz,57,2023-01-16,171,171,171,0,6497,6524,6523,1,23,0,0,1,276,276,276,276
Shasta,57,2023-01-16,41,41,41,0,691,695,694,1,13,3,3,2,605,605,602,602
Siskiyou,57,2023-01-16,6,6,6,0,208,209,208,1,0,0,0,0,95,95,95,95
Solano,57,2023-01-16,222,222,222,0,3711,3727,3726,1,49,0,0,6,474,474,474,474
Sonoma,57,2023-01-16,190,190,190,0,3774,3790,3789,1,26,5,5,2,551,551,546,546
Stanislaus,57,2023-01-16,206,206,206,0,4354,4372,4371,1,72,3,3,3,1836,1836,1833,1833
Sutter,57,2023-01-16,47,47,47,0,716,718,717,1,0,0,0,0,234,234,234,234
Tehama,57,2023-01-16,16,16,16,0,369,370,369,1,1,0,0,0,231,231,231,231
Trinity,57,2023-01-16,3,3,3,0,23,24,23,1,0,0,0,0,22,22,22,22
Tulare,57,2023-01-16,263,263,263,0,4115,4133,4132,1,45,4,4,2,1576,1576,1572,1572
Tuolumne,57,2023-01-16,44,44,44,0,548,549,548,1,1,2,2,0,210,210,208,208
Ventura,57,2023-01-16,413,413,413,0,7843,7874,7873,1,53,4,4,12,1657,1657,1653,1653
Yolo,57,2023-01-16,75,75,75,0,1251,1258,1257,1,2,2,2,0,438,438,436,436
Yuba,57,2023-01-16,38,38,38,0,595,596,595,1,9,0,0,2,122,122,122,122
Alameda,58,2023-01-23,743,746,746,0,21293,21386,21385,1,100,11,11,9,2170,2170,2159,2159
Amador,58,2023-01-23,34,34,34,0,590,592,591,1,1,1,1,0,98,98,97,97
Butte,58,2023-01-23,44,44,44,0,1085,1091,1090,1,13,1,1,0,486,486,485,485
Calaveras,58,2023-01-23,15,15,15,0,280,281,280,1,0,0,0,0,139,139,139,139
Colusa,58,2023-01-23,10,10,10,0,142,143,142,1,0,0,0,0,22,22,22,22
Contra Costa,58,2023-01-23,515,515,515,0,13315,13373,13372,1,61,6,6,6,1542,1542,1536,1536
Del Norte,58,2023-01-23,22,22,22,0,359,360,359,1,1,0,0,0,58,58,58,58
El Dorado,58,2023-01-23,40,40,40,0,1082,1088,1087,1,2,0,0,0,242,242,242,242
Fresno,58,2023-01-23,449,449,449,0,10113,10158,10157,1,117,5,5,19,2983,2983,2978,2978
Glenn,58,2023-01-23,4,4,4,0,154,155,154,1,0,0,0,0,53,53,53,53
Humboldt,58,2023-01-23,34,34,34,0,556,557,556,1,9,1,1,4,169,169,168,168
Imperial,58,2023-01-23,85,85,85,0,2255,2266,2265,1,10,0,0,1,977,977,977,977
Inyo,58,2023-01-23,6,6,6,0,165,166,165,1,0,1,1,0,63,63,62,62
Kern,58,2023-01-23,313,313,313,0,9390,9432,9431,1,34,5,5,8,2477,2477,2472,2472
Kings,58,2023-01-23,107,107,107,0,1985,1996,1995,1,6,0,0,0,481,481,481,481
Lake,58,2023-01-23,28,28,28,0,579,581,580,1,2,2,2,2,157,157,155,155
Lassen,58,2023-01-23,5,5,5,0,465,466,465,1,0,0,0,0,64,64,64,64
Los Angeles,58,2023-01-23,5607,5632,5632,0,169800,170540,170538,2,665,110,110,96,35217,35217,35107,35107
Madera,58,2023-01-23,51,51,51,0,1433,1440,1439,1,6,0,0,2,375,375,375,375
Marin,58,2023-01-23,108,108,108,0,2351,2364,2363,1,18,0,0,3,317,317,317,317
Mariposa,58,2023-01-23,7,7,7,0,105,106,105,1,0,0,0,0,31,31,31,31
Mendocino,58,2023-01-23,21,21,21,0,546,548,547,1,4,0,0,0,142,142,142,142
Merced,58,2023-01-23,126,126,126,0,1924,1933,1932,1,9,2,2,3,903,903,901,901
Modoc,58,2023-01-23,1,1,1,0,11,12,11,1,1,0,0,0,9,9,9,9
Mono,58,2023-01-23,5,5,5,0,73,74,73,1,0,0,0,0,8,8,8,8
Monterey,58,2023-01-23,107,107,107,0,2755,2768,2767,1,15,1,1,2,796,796,795,795
Napa,58,2023-01-23,77,77,77,0,1505,1511,1510,1,4,0,0,1,161,161,161,161
Nevada,58,2023-01-23,20,20,20,0,600,603,602,1,3,0,0,2,136,136,136,136
Orange,58,2023-01-23,1173,1179,1179,0,24083,24189,24188,1,177,27,27,27,7938,7938,7911,7911
Placer,58,2023-01-23,139,139,139,0,2732,2746,2745,1,42,1,1,7,679,679,678,678
Plumas,58,2023-01-23,5,5,5,0,91,92,91,1,1,0,0,0,14,14,14,14
Riverside,58,2023-01-23,1013,1018,1018,0,16229,16299,16298,1,111,14,14,22,6802,6802,6788,6788
Sacramento,58,2023-01-23,598,599,599,0,13720,13780,13779,1,134,9,9,21,3517,3517,3508,3508
San Benito,58,2023-01-23,27,27,27,0,564,567,566,1,0,0,0,0,110,110,110,110
San Bernardino,58,2023-01-23,1030,1034,1034,0,19083,19167,19166,1,127,1,1,33,8133,8133,8132,8132
San Diego,58,2023-01-23,2031,2040,2040,0,33285,33433,33432,1,236,11,11,37,5773,5773,5762,5762
San Francisco,58,2023-01-23,449,449,449,0,11285,11334,11333,1,58,6,6,5,1168,1168,1162,1162
San Joaquin,58,2023-01-23,244,244,244,0,8409,8447,8446,1,29,3,3,8,2419,2419,2416,2416
San Luis Obispo,58,2023-01-23,110,110,110,0,1951,1961,1960,1,8,3,3,2,556,556,553,553
San Mateo,58,2023-01-23,352,352,352,0,8733,8773,8772,1,21,0,0,0,742,742,742,742
Santa Barbara,58,2023-01-23,209,209,209,0,4241,4260,4259,1,28,2,2,4,757,757,755,755
Santa Clara,58,2023-01-23,1018,1024,1024,0,24681,24790,24789,1,119,5,5,23,2687,2687,2682,2682
Santa Cruz,58,2023-01-23,122,122,122,0,9483,9527,9526,1,16,0,0,0,276,276,276,276
Shasta,58,2023-01-23,22,22,22,0,755,759,758,1,6,1,1,1,606,606,605,605
Siskiyou,58,2023-01-23,6,6,6,0,178,179,178,1,0,0,0,0,95,95,95,95
Solano,58,2023-01-23,228,228,228,0,4219,4238,4237,1,33,0,0,2,474,474,474,474
Sonoma,58,2023-01-23,198,198,198,0,4276,4295,4294,1,26,0,0,4,551,551,551,551
Stanislaus,58,2023-01-23,181,181,181,0,4331,4352,4351,1,57,2,2,6,1838,1838,1836,1836
Sutter,58,2023-01-23,41,41,41,0,780,784,783,1,0,1,1,0,235,235,234,234
Tehama,58,2023-01-23,15,15,15,0,341,342,341,1,1,0,0,0,231,231,231,231
Trinity,58,2023-01-23,4,4,4,0,31,32,31,1,0,1,1,0,23,23,22,22
Tulare,58,2023-01-23,221,221,221,0,4167,4186,4185,1,27,3,3,5,1579,1579,1576,1576
Tuolumne,58,2023-01-23,36,36,36,0,484,485,484,1,0,1,1,1,211,211,210,210
Ventura,58,2023-01-23,368,368,368,0,8587,8626,8625,1,57,5,5,3,1662,1662,1657,1657
Yolo,58,2023-01-23,85,85,85,0,1371,1378,1377,1,2,3,3,0,441,441,438,438
Yuba,58,2023-01-23,30,30,30,0,725,729,728,1,3,0,0,0,122,122,122,122
Alameda,59,2023-01-30,848,853,853,0,18459,18551,18550,1,85,4,4,4,2174,2174,2170,2170
Amador,59,2023-01-30,24,24,24,0,620,623,622,1,3,0,0,0,98,98,98,98
Butte,59,2023-01-30,57,57,57,0,1128,1134,1133,1,13,2,2,2,488,488,486,486
Calaveras,59,2023-01-30,16,16,16,0,318,319,318,1,0,1,1,0,140,140,139,139
Colusa,59,2023-01-30,7,7,7,0,169,170,169,1,0,0,0,0,22,22,22,22
Contra Costa,59,2023-01-30,665,668,668,0,12412,12472,12471,1,38,9,9,6,1551,1551,1542,1542
Del Norte,59,2023-01-30,31,31,31,0,382,383,382,1,1,1,1,0,59,59,58,58
El Dorado,59,2023-01-30,61,61,61,0,1190,1198,1197,1,4,2,2,0,244,244,242,242
Fresno,59,2023-01-30,448,448,448,0,9879,9928,9927,1,117,8,8,10,2991,2991,2983,2983
Glenn,59,2023-01-30,3,3,3,0,156,157,156,1,0,0,0,0,53,53,53,53
Humboldt,59,2023-01-30,29,29,29,0,565,567,566,1,6,0,0,1,169,169,169,169
Imperial,59,2023-01-30,104,104,104,0,2067,2078,2077,1,7,1,1,0,978,978,977,977
Inyo,59,2023-01-30,10,10,10,0,202,203,202,1,1,0,0,0,63,63,63,63
Kern,59,2023-01-30,294,294,294,0,8957,9002,9001,1,36,1,1,8,2478,2478,2477,2477
Kings,59,2023-01-30,136,136,136,0,2211,2224,2223,1,7,1,1,1,482,482,481,481
Lake,59,2023-01-30,26,26,26,0,555,558,557,1,5,2,2,1,159,159,157,157
Lassen,59,2023-01-30,4,4,4,0,490,493,492,1,0,0,0,0,64,64,64,64
Los Angeles,59,2023-01-30,5796,5825,5825,0,151780,152521,152519,2,633,109,109,72,35326,35326,35217,35217
Madera,59,2023-01-30,48,48,48,0,1479,1487,1486,1,7,0,0,0,375,375,375,375
Marin,59,2023-01-30,102,102,102,0,2159,2172,2171,1,19,0,0,1,317,317,317,317
Mariposa,59,2023-01-30,5,5,5,0,106,107,106,1,0,0,0,0,31,31,31,31
Mendocino,59,2023-01-30,24,24,24,0,518,521,520,1,2,0,0,1,142,142,142,142
Merced,59,2023-01-30,137,137,137,0,1798,1808,1807,1,11,0,0,3,903,903,903,903
Modoc,59,2023-01-30,0,0,0,0,8,9,8,1,1,0,0,0,9,9,9,9
Mono,59,2023-01-30,2,2,2,0,68,69,68,1,0,0,0,0,8,8,8,8
Monterey,59,2023-01-30,155,155,155,0,2845,2860,2859,1,8,1,1,1,797,797,796,796
Napa,59,2023-01-30,72,72,72,0,1370,1378,1377,1,4,0,0,0,161,161,161,161
Nevada,59,2023-01-30,29,29,29,0,591,593,592,1,2,0,0,1,136,136,136,136
Orange,59,2023-01-30,1204,1211,1211,0,22732,22844,22843,1,136,15,15,25,7953,7953,7938,7938
Placer,59,2023-01-30,170,170,170,0,2707,2721,2720,1,49,2,2,3,681,681,679,679
Plumas,59,2023-01-30,3,3,3,0,75,76,75,1,0,0,0,0,14,14,14,14
Riverside,59,2023-01-30,1071,1078,1078,0,15998,16077,16076,1,84,5,5,17,6807,6807,6802,6802
Sacramento,59,2023-01-30,667,670,670,0,13387,13452,13451,1,117,8,8,13,3525,3525,3517,3517
San Benito,59,2023-01-30,30,30,30,0,563,565,564,1,0,0,0,0,110,110,110,110
San Bernardino,59,2023-01-30,931,937,937,0,17216,17301,17300,1,140,0,0,19,8133,8133,8133,8133
San Diego,59,2023-01-30,1860,1870,1870,0,30194,30341,30340,1,202,11,11,32,5784,5784,5773,5773
San Francisco,59,2023-01-30,473,473,473,0,10900,10954,10953,1,51,2,2,4,1170,1170,1168,1168
San Joaquin,59,2023-01-30,306,306,306,0,7658,7696,7695,1,22,4,4,5,2423,2423,2419,2419
San Luis Obispo,59,2023-01-30,140,140,140,0,1912,1923,1922,1,13,5,5,0,561,561,556,556
San Mateo,59,2023-01-30,432,432,432,0,8645,8688,8687,1,25,0,0,3,742,742,742,742
Santa Barbara,59,2023-01-30,227,227,227,0,4267,4289,4288,1,25,1,1,2,758,758,757,757
Santa Clara,59,2023-01-30,1178,1185,1185,0,23638,23754,23753,1,132,6,6,14,2693,2693,2687,2687
Santa Cruz,59,2023-01-30,133,133,133,0,9330,9378,9377,1,12,0,0,0,276,276,276,276
Shasta,59,2023-01-30,18,18,18,0,665,669,668,1,7,0,0,0,606,606,606,606
Siskiyou,59,2023-01-30,6,6,6,0,195,196,195,1,0,0,0,0,95,95,95,95
Solano,59,2023-01-30,236,236,236,0,4173,4194,4193,1,40,0,0,1,474,474,474,474
Sonoma,59,2023-01-30,158,158,158,0,3597,3615,3614,1,23,1,1,1,552,552,551,551
Stanislaus,59,2023-01-30,230,230,230,0,4128,4149,4148,1,43,2,2,3,1840,1840,1838,1838
Sutter,59,2023-01-30,36,36,36,0,611,614,613,1,0,1,1,0,236,236,235,235
Tehama,59,2023-01-30,8,8,8,0,317,318,317,1,1,1,1,0,232,232,231,231
Trinity,59,2023-01-30,7,7,7,0,26,27,26,1,0,0,0,0,23,23,23,23
Tulare,59,2023-01-30,260,260,260,0,4019,4040,4039,1,28,3,3,3,1582,1582,1579,1579
Tuolumne,59,2023-01-30,45,45,45,0,600,603,602,1,3,0,0,0,211,211,211,211
Ventura,59,2023-01-30,363,363,363,0,8131,8172,8171,1,46,7,7,8,1669,1669,1662,1662
Yolo,59,2023-01-30,87,87,87,0,1298,1306,1305,1,2,1,1,0,442,442,441,441
Yuba,59,2023-01-30,32,32,32,0,656,659,658,1,3,0,0,1,122,122,122,122
Alameda,60,2023-02-06,1109,1116,1116,0,18266,18362,18361,1,86,5,5,9,2179,2179,2174,2174
Amador,60,2023-02-06,29,29,29,0,637,639,638,1,1,0,0,0,98,98,98,98
Butte,60,2023-02-06,85,85,85,0,1209,1216,1215,1,20,0,0,1,488,488,488,488
Calaveras,60,2023-02-06,14,14,14,0,323,324,323,1,0,0,0,0,140,140,140,140
Colusa,60,2023-02-06,6,6,6,0,184,185,184,1,0,0,0,0,22,22,22,22
Contra Costa,60,2023-02-06,715,719,719,0,11856,11918,11917,1,50,2,2,9,1553,1553,1551,1551
Del Norte,60,2023-02-06,58,58,58,0,394,396,395,1,0,0,0,0,59,59,59,59
El Dorado,60,2023-02-06,59,59,59,0,1133,1139,1138,1,3,0,0,0,244,244,244,244
Fresno,60,2023-02-06,514,515,515,0,9046,9095,9094,1,89,4,4,15,2995,2995,2991,2991
Glenn,60,2023-02-06,10,10,10,0,170,172,171,1,0,0,0,0,53,53,53,53
Humboldt,60,2023-02-06,56,56,56,0,566,568,567,1,6,1,1,0,170,170,169,169
Imperial,60,2023-02-06,123,123,123,0,2097,2109,2108,1,7,1,1,0,979,979,978,978
Inyo,60,2023-02-06,9,9,9,0,210,211,210,1,0,0,0,0,63,63,63,63
Kern,60,2023-02-06,326,326,326,0,8601,8648,8647,1,34,2,2,4,2480,2480,2478,2478
Kings,60,2023-02-06,127,127,127,0,2056,2068,2067,1,3,0,0,1,482,482,482,482
Lake,60,2023-02-06,25,25,25,0,561,564,563,1,5,1,1,0,160,160,159,159
Lassen,60,2023-02-06,6,6,6,0,445,447,446,1,0,0,0,0,64,64,64,64
Los Angeles,60,2023-02-06,5904,5934,5934,0,142031,142779,142777,2,609,89,89,83,35415,35415,35326,35326
Madera,60,2023-02-06,55,55,55,0,1308,1316,1315,1,4,1,1,0,376,376,375,375
Marin,60,2023-02-06,144,144,144,0,2132,2144,2143,1,13,0,0,3,317,317,317,317
Mariposa,60,2023-02-06,3,3,3,0,105,106,105,1,0,0,0,0,31,31,31,31
Mendocino,60,2023-02-06,31,31,31,0,513,516,515,1,4,0,0,2,142,142,142,142
Merced,60,2023-02-06,166,166,166,0,1889,1901,1900,1,12,0,0,0,903,903,903,903
Modoc,60,2023-02-06,2,2,2,0,6,7,6,1,0,0,0,0,9,9,9,9
Mono,60,2023-02-06,4,4,4,0,93,94,93,1,0,0,0,0,8,8,8,8
Monterey,60,2023-02-06,227,227,227,0,2938,2953,2952,1,22,3,3,1,800,800,797,797
Napa,60,2023-02-06,110,110,110,0,1404,1411,1410,1,4,0,0,3,161,161,161,161
Nevada,60,2023-02-06,32,32,32,0,572,576,575,1,4,0,0,0,136,136,136,136
Orange,60,2023-02-06,1316,1323,1323,0,22317,22436,22435,1,154,24,24,20,7977,7977,7953,7953
Placer,60,2023-02-06,164,164,164,0,2656,2671,2670,1,41,0,0,4,681,681,681,681
Plumas,60,2023-02-06,2,2,2,0,72,73,72,1,0,1,1,0,15,15,14,14
Riverside,60,2023-02-06,1128,1135,1135,0,15534,15616,15615,1,89,5,5,14,6812,6812,6807,6807
Sacramento,60,2023-02-06,732,737,737,0,13188,13257,13256,1,96,5,5,19,3530,3530,3525,3525
San Benito,60,2023-02-06,50,50,50,0,538,540,539,1,1,0,0,0,110,110,110,110
San Bernardino,60,2023-02-06,1081,1088,1088,0,17437,17527,17526,1,152,0,0,17,8133,8133,8133,8133
San Diego,60,2023-02-06,1873,1883,1883,0,30142,30302,30301,1,230,8,8,23,5792,5792,5784,5784
San Francisco,60,2023-02-06,573,576,576,0,10536,10591,10590,1,58,3,3,2,1173,1173,1170,1170
San Joaquin,60,2023-02-06,435,436,436,0,6930,6968,6967,1,32,1,1,3,2424,2424,2423,2423
San Luis Obispo,60,2023-02-06,150,150,150,0,1906,1917,1916,1,7,1,1,0,562,562,561,561
San Mateo,60,2023-02-06,530,532,532,0,8197,8240,8239,1,42,0,0,1,742,742,742,742
Santa Barbara,60,2023-02-06,239,239,239,0,4366,4390,4389,1,21,1,1,0,759,759,758,758
Santa Clara,60,2023-02-06,1301,1308,1308,0,23468,23593,23592,1,123,10,10,23,2703,2703,2693,2693
Santa Cruz,60,2023-02-06,232,232,232,0,10396,10451,10450,1,11,0,0,0,276,276,276,276
Shasta,60,2023-02-06,24,24,24,0,660,665,664,1,9,0,0,0,606,606,606,606
Siskiyou,60,2023-02-06,11,11,11,0,221,222,221,1,0,0,0,0,95,95,95,95
Solano,60,2023-02-06,288,288,288,0,3852,3873,3872,1,41,0,0,5,474,474,474,474
Sonoma,60,2023-02-06,267,267,267,0,3566,3585,3584,1,17,3,3,1,555,555,552,552
Stanislaus,60,2023-02-06,277,277,277,0,3926,3948,3947,1,54,1,1,6,1841,1841,1840,1840
Sutter,60,2023-02-06,50,50,50,0,706,711,710,1,0,0,0,0,236,236,236,236
Tehama,60,2023-02-06,17,17,17,0,344,345,344,1,2,0,0,0,232,232,232,232
Trinity,60,2023-02-06,1,1,1,0,19,20,19,1,0,0,0,0,23,23,23,23
Tulare,60,2023-02-06,272,272,272,0,4386,4409,4408,1,28,2,2,3,1584,1584,1582,1582
Tuolumne,60,2023-02-06,48,48,48,0,555,557,556,1,1,0,0,0,211,211,211,211
Ventura,60,2023-02-06,326,326,326,0,6936,6973,6972,1,39,1,1,5,1670,1670,1669,1669
Yolo,60,2023-02-06,79,79,79,0,1254,1262,1261,1,4,1,1,2,443,443,442,442
Yuba,60,2023-02-06,22,22,22,0,623,626,625,1,3,0,0,1,122,122,122,122
Alameda,61,2023-02-13,1121,1128,1128,0,17642,17750,17749,1,90,2,2,8,2181,2181,2179,2179
Amador,61,2023-02-13,19,19,19,0,497,499,498,1,0,0,0,0,98,98,98,98
Butte,61,2023-02-13,86,86,86,0,1252,1261,1260,1,25,1,1,2,489,489,488,488
Calaveras,61,2023-02-13,14,14,14,0,295,296,295,1,0,0,0,0,140,140,140,140
Colusa,61,2023-02-13,8,8,8,0,136,137,136,1,0,0,0,0,22,22,22,22
Contra Costa,61,2023-02-13,701,706,706,0,11539,11608,11607,1,44,2,2,10,1555,1555,1553,1553
Del Norte,61,2023-02-13,19,19,19,0,299,300,299,1,2,0,0,0,59,59,59,59
El Dorado,61,2023-02-13,65,65,65,0,1101,1109,1108,1,2,0,0,0,244,244,244,244
Fresno,61,2023-02-13,470,471,471,0,8745,8799,8798,1,106,4,4,7,2999,2999,2995,2995
Glenn,61,2023-02-13,11,11,11,0,175,177,176,1,5,0,0,0,53,53,53,53
Humboldt,61,2023-02-13,37,37,37,0,578,582,581,1,7,0,0,1,170,170,170,170
Imperial,61,2023-02-13,142,142,142,0,1855,1868,1867,1,3,1,1,5,980,980,979,979
Inyo,61,2023-02-13,5,5,5,0,200,201,200,1,0,0,0,0,63,63,63,63
Kern,61,2023-02-13,327,327,327,0,8270,8321,8320,1,37,2,2,6,2482,2482,2480,2480
Kings,61,2023-02-13,88,88,88,0,1900,1912,1911,1,6,1,1,0,483,483,482,482
Lake,61,2023-02-13,20,20,20,0,567,572,571,1,2,0,0,0,160,160,160,160
Lassen,61,2023-02-13,5,5,5,0,361,362,361,1,0,0,0,0,64,64,64,64
Los Angeles,61,2023-02-13,5918,5954,5954,0,130337,131127,131126,1,613,78,78,67,35493,35493,35415,35415
Madera,61,2023-02-13,60,60,60,0,1238,1246,1245,1,7,0,0,2,376,376,376,376
Marin,61,2023-02-13,143,143,143,0,1931,1945,1944,1,19,0,0,3,317,317,317,317
Mariposa,61,2023-02-13,3,3,3,0,102,103,102,1,0,0,0,0,31,31,31,31
Mendocino,61,2023-02-13,28,28,28,0,538,541,540,1,3,2,2,1,144,144,142,142
Merced,61,2023-02-13,167,167,167,0,1857,1870,1869,1,8,0,0,0,903,903,903,903
Modoc,61,2023-02-13,0,0,0,0,2,3,2,1,0,0,0,0,9,9,9,9
Mono,61,2023-02-13,1,1,1,0,66,67,66,1,0,0,0,0,8,8,8,8
Monterey,61,2023-02-13,224,224,224,0,2490,2505,2504,1,25,3,3,1,803,803,800,800
Napa,61,2023-02-13,92,92,92,0,1364,1373,1372,1,4,1,1,0,162,162,161,161
Nevada,61,2023-02-13,37,37,37,0,596,601,600,1,4,0,0,1,136,136,136,136
Orange,61,2023-02-13,1393,1401,1401,0,20604,20729,20728,1,161,12,12,21,7989,7989,7977,7977
Placer,61,2023-02-13,161,161,161,0,2613,2629,2628,1,35,0,0,6,681,681,681,681
Plumas,61,2023-02-13,3,3,3,0,80,81,80,1,1,0,0,0,15,15,15,15
Riverside,61,2023-02-13,1094,1101,1101,0,16098,16196,16195,1,93,7,7,16,6819,6819,6812,6812
Sacramento,61,2023-02-13,810,816,816,0,13050,13129,13128,1,113,5,5,19,3535,3535,3530,3530
San Benito,61,2023-02-13,43,43,43,0,566,570,569,1,1,0,0,0,110,110,110,110
San Bernardino,61,2023-02-13,1020,1027,1027,0,16939,17044,17043,1,134,0,0,18,8133,8133,8133,8133
San Diego,61,2023-02-13,2024,2037,2037,0,29304,29483,29482,1,218,4,4,25,5796,5796,5792,5792
San Francisco,61,2023-02-13,593,597,597,0,10689,10755,10754,1,59,3,3,5,1176,1176,1173,1173
San Joaquin,61,2023-02-13,456,458,458,0,6973,7017,7016,1,28,1,1,3,2425,2425,2424,2424
San Luis Obispo,61,2023-02-13,133,133,133,0,1683,1695,1694,1,4,1,1,4,563,563,562,562
San Mateo,61,2023-02-13,522,523,523,0,8198,8249,8248,1,29,0,0,5,742,742,742,742
Santa Barbara,61,2023-02-13,188,188,188,0,3937,3961,3960,1,16,1,1,5,760,760,759,759
Santa Clara,61,2023-02-13,1370,1378,1378,0,23134,23275,23274,1,114,9,9,25,2712,2712,2703,2703
Santa Cruz,61,2023-02-13,206,206,206,0,9624,9682,9681,1,19,0,0,0,276,276,276,276
Shasta,61,2023-02-13,33,33,33,0,674,680,679,1,7,0,0,0,606,606,606,606
Siskiyou,61,2023-02-13,11,11,11,0,199,200,199,1,0,0,0,0,95,95,95,95
Solano,61,2023-02-13,260,260,260,0,3774,3799,3798,1,28,0,0,3,474,474,474,474
Sonoma,61,2023-02-13,232,232,232,0,3423,3445,3444,1,32,1,1,1,556,556,555,555
Stanislaus,61,2023-02-13,268,268,268,0,3816,3840,3839,1,47,1,1,9,1842,1842,1841,1841
Sutter,61,2023-02-13,46,46,46,0,658,664,663,1,0,1,1,0,237,237,236,236
Tehama,61,2023-02-13,16,16,16,0,346,347,346,1,1,2,2,0,234,234,232,232
Trinity,61,2023-02-13,1,1,1,0,26,27,26,1,0,0,0,0,23,23,23,23
Tulare,61,2023-02-13,248,248,248,0,4114,4140,4139,1,29,3,3,1,1587,1587,1584,1584
Tuolumne,61,2023-02-13,38,38,38,0,508,510,509,1,2,0,0,0,211,211,211,211
Ventura,61,2023-02-13,316,316,316,0,6666,6707,6706,1,29,5,5,6,1675,1675,1670,1670
Yolo,61,2023-02-13,75,75,75,0,1246,1256,1255,1,3,0,0,1,443,443,443,443
Yuba,61,2023-02-13,31,31,31,0,643,649,648,1,8,0,0,0,122,122,122,122
Alameda,62,2023-02-20,1022,1029,1029,0,15453,15564,15563,1,79,3,3,5,2184,2184,2181,2181
Amador,62,2023-02-20,25,25,25,0,496,500,499,1,1,0,0,1,98,98,98,98
Butte,62,2023-02-20,43,43,43,0,1051,1060,1059,1,7,2,2,1,491,491,489,489
Calaveras,62,2023-02-20,17,17,17,0,289,290,289,1,0,0,0,1,140,140,140,140
Colusa,62,2023-02-20,12,12,12,0,92,93,92,1,0,0,0,0,22,22,22,22
Contra Costa,62,2023-02-20,666,673,673,0,10000,10072,10071,1,57,5,5,6,1560,1560,1555,1555
Del Norte,62,2023-02-20,11,11,11,0,258,259,258,1,2,0,0,0,59,59,59,59
El Dorado,62,2023-02-20,51,51,51,0,976,984,983,1,2,1,1,1,245,245,244,244
Fresno,62,2023-02-20,455,457,457,0,8236,8296,8295,1,84,5,5,17,3004,3004,2999,2999
Glenn,62,2023-02-20,5,5,5,0,146,148,147,1,5,0,0,0,53,53,53,53
Humboldt,62,2023-02-20,33,33,33,0,576,582,581,1,7,0,0,1,170,170,170,170
Imperial,62,2023-02-20,121,121,121,0,1780,1794,1793,1,8,0,0,0,980,980,980,980
Inyo,62,2023-02-20,6,6,6,0,162,163,162,1,0,0,0,0,63,63,63,63
Kern,62,2023-02-20,400,401,401,0,7472,7526,7525,1,29,3,3,5,2485,2485,2482,2482
Kings,62,2023-02-20,77,77,77,0,1639,1652,1651,1,5,1,1,0,484,484,483,483
Lake,62,2023-02-20,19,19,19,0,483,488,487,1,2,1,1,1,161,161,160,160
Lassen,62,2023-02-20,1,1,1,0,327,328,327,1,0,0,0,0,64,64,64,64
Los Angeles,62,2023-02-20,5656,5695,5695,0,118502,119345,119344,1,601,80,84,76,35573,35577,35493,35493
Madera,62,2023-02-20,61,61,61,0,1089,1098,1097,1,3,0,0,2,376,376,376,376
Marin,62,2023-02-20,153,153,153,0,1856,1869,1868,1,13,0,0,2,317,317,317,317
Mariposa,62,2023-02-20,6,6,6,0,121,122,121,1,0,0,0,0,31,31,31,31
Mendocino,62,2023-02-20,25,25,25,0,489,494,493,1,3,0,0,0,144,144,144,144
Merced,62,2023-02-20,122,122,122,0,1754,1767,1766,1,19,0,0,1,903,903,903,903
Modoc,62,2023-02-20,1,1,1,0,15,16,15,1,0,0,0,0,9,9,9,9
Mono,62,2023-02-20,2,2,2,0,67,68,67,1,0,0,0,0,8,8,8,8
Monterey,62,2023-02-20,157,157,157,0,2320,2338,2337,1,22,0,0,0,803,803,803,803
Napa,62,2023-02-20,78,78,78,0,1085,1093,1092,1,3,1,1,1,163,163,162,162
Nevada,62,2023-02-20,28,28,28,0,611,616,615,1,7,1,1,1,137,137,136,136
Orange,62,2023-02-20,1347,1357,1357,0,19408,19546,19545,1,158,20,20,21,8009,8009,7989,7989
Placer,62,2023-02-20,162,162,162,0,2422,2439,2438,1,48,1,1,3,682,682,681,681
Plumas,62,2023-02-20,8,8,8,0,75,76,75,1,0,0,0,0,15,15,15,15
Riverside,62,2023-02-20,991,998,998,0,15215,15323,15322,1,92,7,7,9,6826,6826,6819,6819
Sacramento,62,2023-02-20,731,738,738,0,11557,11639,11638,1,103,13,13,16,3548,3548,3535,3535
San Benito,62,2023-02-20,28,28,28,0,476,480,479,1,1,2,2,0,112,112,110,110
San Bernardino,62,2023-02-20,904,911,911,0,15186,15293,15292,1,117,0,0,27,8133,8133,8133,8133
San Diego,62,2023-02-20,1764,1776,1776,0,25420,25600,25599,1,201,7,7,25,5803,5803,5796,5796
San Francisco,62,2023-02-20,591,598,598,0,9927,9997,9996,1,79,0,0,7,1176,1176,1176,1176
San Joaquin,62,2023-02-20,414,416,416,0,7369,7423,7422,1,30,1,1,7,2426,2426,2425,2425
San Luis Obispo,62,2023-02-20,96,96,96,0,1435,1447,1446,1,11,0,0,0,563,563,563,563
San Mateo,62,2023-02-20,467,470,470,0,7433,7487,7486,1,44,0,0,3,742,742,742,742
Santa Barbara,62,2023-02-20,206,206,206,0,3629,3656,3655,1,18,0,0,5,760,760,760,760
Santa Clara,62,2023-02-20,1214,1221,1221,0,19503,19642,19641,1,111,11,11,26,2723,2723,2712,2712
Santa Cruz,62,2023-02-20,136,136,136,0,6262,6307,6306,1,20,0,0,2,276,276,276,276
Shasta,62,2023-02-20,18,18,18,0,728,734,733,1,2,0,0,0,606,606,606,606
Siskiyou,62,2023-02-20,14,14,14,0,198,199,198,1,0,0,0,0,95,95,95,95
Solano,62,2023-02-20,229,229,229,0,3263,3287,3286,1,26,0,0,3,474,474,474,474
Sonoma,62,2023-02-20,262,262,262,0,3199,3223,3222,1,24,1,1,4,557,557,556,556
Stanislaus,62,2023-02-20,264,264,264,0,3643,3669,3668,1,55,0,0,4,1842,1842,1842,1842
Sutter,62,2023-02-20,38,38,38,0,539,544,543,1,0,1,1,0,238,238,237,237
Tehama,62,2023-02-20,13,13,13,0,279,280,279,1,0,0,0,0,234,234,234,234
Trinity,62,2023-02-20,0,0,0,0,30,31,30,1,0,0,0,0,23,23,23,23
Tulare,62,2023-02-20,214,214,214,0,3795,3823,3822,1,23,0,0,0,1587,1587,1587,1587
Tuolumne,62,2023-02-20,32,32,32,0,446,450,449,1,0,0,0,0,211,211,211,211
Ventura,62,2023-02-20,283,283,283,0,5625,5666,5665,1,30,4,4,7,1679,1679,1675,1675
Yolo,62,2023-02-20,87,87,87,0,1279,1289,1288,1,1,2,2,1,445,445,443,443
Yuba,62,2023-02-20,25,25,25,0,507,512,511,1,6,0,0,0,122,122,122,122
Alameda,63,2023-02-27,1131,1140,1140,0,18649,18804,18803,1,96,7,7,9,2191,2191,2184,2184
Amador,63,2023-02-27,19,19,19,0,521,526,525,1,1,0,0,1,98,98,98,98
Butte,63,2023-02-27,55,55,55,0,948,956,955,1,8,1,1,1,492,492,491,491
Calaveras,63,2023-02-27,15,15,15,0,306,307,306,1,1,0,0,0,140,140,140,140
Colusa,63,2023-02-27,12,12,12,0,85,86,85,1,0,0,0,0,22,22,22,22
Contra Costa,63,2023-02-27,725,732,732,0,11446,11541,11540,1,63,4,4,11,1564,1564,1560,1560
Del Norte,63,2023-02-27,7,7,7,0,288,290,289,1,0,0,0,0,59,59,59,59
El Dorado,63,2023-02-27,61,61,61,0,1037,1047,1046,1,2,1,1,0,246,246,245,245
Fresno,63,2023-02-27,468,473,473,0,9004,9079,9078,1,93,2,2,7,3006,3006,3004,3004
Glenn,63,2023-02-27,4,4,4,0,144,146,145,1,1,0,0,0,53,53,53,53
Humboldt,63,2023-02-27,29,29,29,0,490,496,495,1,4,0,0,1,170,170,170,170
Imperial,63,2023-02-27,175,175,175,0,1831,1847,1846,1,13,0,0,0,980,980,980,980
Inyo,63,2023-02-27,4,4,4,0,156,157,156,1,0,0,0,0,63,63,63,63
Kern,63,2023-02-27,401,404,404,0,8254,8323,8322,1,42,3,3,7,2488,2488,2485,2485
Kings,63,2023-02-27,61,61,61,0,1687,1702,1701,1,4,1,1,0,485,485,484,484
Lake,63,2023-02-27,21,21,21,0,465,470,469,1,2,1,1,1,162,162,161,161
Lassen,63,2023-02-27,3,3,3,0,352,355,354,1,0,0,0,0,64,64,64,64
Los Angeles,63,2023-02-27,5361,5404,5404,0,134638,135752,135750,2,573,72,76,75,35645,35653,35573,35577
Madera,63,2023-02-27,62,62,62,0,1187,1198,1197,1,7,0,0,1,376,376,376,376
Marin,63,2023-02-27,146,146,146,0,1966,1982,1981,1,16,0,0,3,317,317,317,317
Mariposa,63,2023-02-27,7,7,7,0,97,98,97,1,0,0,0,0,31,31,31,31
Mendocino,63,2023-02-27,21,21,21,0,492,498,497,1,5,1,1,1,145,145,144,144
Merced,63,2023-02-27,124,124,124,0,1885,1902,1901,1,19,0,0,1,903,903,903,903
Modoc,63,2023-02-27,1,1,1,0,8,9,8,1,0,0,0,0,9,9,9,9
Mono,63,2023-02-27,5,5,5,0,52,53,52,1,0,0,0,0,8,8,8,8
Monterey,63,2023-02-27,181,181,181,0,2579,2602,2601,1,30,2,2,1,805,805,803,803
Napa,63,2023-02-27,79,79,79,0,1316,1329,1328,1,7,2,2,4,165,165,163,163
Nevada,63,2023-02-27,25,25,25,0,566,572,571,1,2,0,0,0,137,137,137,137
Orange,63,2023-02-27,1208,1219,1219,0,19632,19795,19794,1,161,20,20,21,8029,8029,8009,8009
Placer,63,2023-02-27,180,180,180,0,2567,2590,2589,1,44,0,0,7,682,682,682,682
Plumas,63,2023-02-27,3,3,3,0,88,89,88,1,0,0,0,0,15,15,15,15
Riverside,63,2023-02-27,915,922,922,0,15465,15592,15591,1,76,8,8,15,6834,6834,6826,6826
Sacramento,63,2023-02-27,928,935,935,0,12781,12888,12887,1,121,6,6,19,3554,3554,3548,3548
San Benito,63,2023-02-27,29,29,29,0,473,479,478,1,2,0,0,0,112,112,112,112
San Bernardino,63,2023-02-27,868,875,875,0,16328,16465,16464,1,111,0,0,24,8133,8133,8133,8133
San Diego,63,2023-02-27,1810,1824,1824,0,27628,27858,27857,1,210,5,5,21,5808,5808,5803,5803
San Francisco,63,2023-02-27,654,660,660,0,11615,11711,11710,1,76,6,6,8,1182,1182,1176,1176
San Joaquin,63,2023-02-27,416,418,418,0,7519,7583,7582,1,33,3,3,3,2429,2429,2426,2426
San Luis Obispo,63,2023-02-27,83,83,83,0,1670,1685,1684,1,11,2,2,0,565,565,563,563
San Mateo,63,2023-02-27,480,485,485,0,7511,7575,7574,1,43,0,0,4,742,742,742,742
Santa Barbara,63,2023-02-27,176,176,176,0,3562,3592,3591,1,18,2,2,8,762,762,760,760
Santa Clara,63,2023-02-27,1334,1345,1345,0,21573,21754,21753,1,126,8,8,26,2731,2731,2723,2723
Santa Cruz,63,2023-02-27,160,160,160,0,8755,8828,8827,1,7,0,0,1,276,276,276,276
Shasta,63,2023-02-27,37,37,37,0,656,663,662,1,9,0,0,1,606,606,606,606
Siskiyou,63,2023-02-27,11,11,11,0,235,236,235,1,0,0,0,0,95,95,95,95
Solano,63,2023-02-27,297,298,298,0,3679,3709,3708,1,30,0,0,8,474,474,474,474
Sonoma,63,2023-02-27,215,215,215,0,3410,3439,3438,1,33,1,1,5,558,558,557,557
Stanislaus,63,2023-02-27,244,244,244,0,3840,3874,3873,1,58,0,0,3,1842,1842,1842,1842
Sutter,63,2023-02-27,46,46,46,0,503,509,508,1,0,0,0,0,238,238,238,238
Tehama,63,2023-02-27,14,14,14,0,267,269,268,1,2,0,0,1,234,234,234,234
Trinity,63,2023-02-27,0,0,0,0,20,21,20,1,0,0,0,0,23,23,23,23
Tulare,63,2023-02-27,216,216,216,0,4010,4043,4042,1,22,3,3,2,1590,1590,1587,1587
Tuolumne,63,2023-02-27,40,40,40,0,472,476,475,1,0,0,0,1,211,211,211,211
Ventura,63,2023-02-27,275,276,276,0,5916,5966,5965,1,35,2,2,7,1681,1681,1679,1679
Yolo,63,2023-02-27,92,92,92,0,1367,1379,1378,1,3,2,2,1,447,447,445,445
Yuba,63,2023-02-27,36,36,36,0,508,514,513,1,0,0,0,0,122,122,122,122
Alameda,64,2023-03-06,927,936,936,0,16592,16755,16754,1,96,4,4,12,2195,2195,2191,2191
Amador,64,2023-03-06,13,13,13,0,461,468,467,1,0,0,0,0,98,98,98,98
Butte,64,2023-03-06,36,36,36,0,591,597,596,1,5,1,1,0,493,493,492,492
Calaveras,64,2023-03-06,19,19,19,0,269,271,270,1,0,2,2,0,142,142,140,140
Colusa,64,2023-03-06,13,13,13,0,161,163,162,1,0,0,0,0,22,22,22,22
Contra Costa,64,2023-03-06,696,703,703,0,10262,10361,10360,1,64,3,3,8,1567,1567,1564,1564
Del Norte,64,2023-03-06,6,6,6,0,253,254,253,1,1,1,1,1,60,60,59,59
El Dorado,64,2023-03-06,52,52,52,0,955,965,964,1,2,0,0,0,246,246,246,246
Fresno,64,2023-03-06,391,396,396,0,7976,8055,8054,1,77,5,5,16,3011,3011,3006,3006
Glenn,64,2023-03-06,4,4,4,0,163,165,164,1,0,0,0,0,53,53,53,53
Humboldt,64,2023-03-06,21,21,21,0,491,497,496,1,1,0,0,1,170,170,170,170
Imperial,64,2023-03-06,169,169,169,0,1609,1626,1625,1,9,0,0,0,980,980,980,980
Inyo,64,2023-03-06,4,4,4,0,136,137,136,1,1,0,0,0,63,63,63,63
Kern,64,2023-03-06,328,330,330,0,7770,7847,7846,1,35,3,3,4,2491,2491,2488,2488
Kings,64,2023-03-06,65,65,65,0,1566,1582,1581,1,1,0,0,0,485,485,485,485
Lake,64,2023-03-06,19,19,19,0,487,493,492,1,1,0,0,0,162,162,162,162
Lassen,64,2023-03-06,4,4,4,0,306,308,307,1,1,0,0,0,64,64,64,64
Los Angeles,64,2023-03-06,4601,4646,4646,0,123394,124594,124593,1,509,69,74,60,35714,35727,35645,35653
Madera,64,2023-03-06,82,82,82,0,1146,1158,1157,1,5,0,0,0,376,376,376,376
Marin,64,2023-03-06,141,141,141,0,1776,1794,1793,1,21,0,0,2,317,317,317,317
Mariposa,64,2023-03-06,0,0,0,0,69,70,69,1,0,0,0,0,31,31,31,31
Mendocino,64,2023-03-06,26,26,26,0,448,453,452,1,7,0,0,1,145,145,145,145
Merced,64,2023-03-06,147,147,147,0,1718,1735,1734,1,14,0,0,2,903,903,903,903
Modoc,64,2023-03-06,1,1,1,0,9,10,9,1,0,0,0,0,9,9,9,9
Mono,64,2023-03-06,5,5,5,0,56,57,56,1,0,0,0,0,8,8,8,8
Monterey,64,2023-03-06,145,145,145,0,2158,2180,2179,1,29,4,4,3,809,809,805,805
Napa,64,2023-03-06,52,52,52,0,1056,1069,1068,1,9,1,1,2,166,166,165,165
Nevada,64,2023-03-06,18,18,18,0,484,490,489,1,2,0,0,0,137,137,137,137
Orange,64,2023-03-06,994,1004,1004,0,18894,19080,19079,1,111,18,18,18,8047,8047,8029,8029
Placer,64,2023-03-06,172,172,172,0,2461,2486,2485,1,62,0,0,5,682,682,682,682
Plumas,64,2023-03-06,1,1,1,0,68,69,68,1,0,0,0,0,15,15,15,15
Riverside,64,2023-03-06,881,889,889,0,14000,14136,14135,1,78,3,3,8,6837,6837,6834,6834
Sacramento,64,2023-03-06,860,869,869,0,11807,11923,11922,1,113,5,5,6,3559,3559,3554,3554
San Benito,64,2023-03-06,16,16,16,0,465,471,470,1,1,0,0,0,112,112,112,112
San Bernardino,64,2023-03-06,745,752,752,0,15029,15176,15175,1,99,0,0,18,8133,8133,8133,8133
San Diego,64,2023-03-06,1410,1423,1423,0,25372,25619,25618,1,179,12,12,13,5820,5820,5808,5808
San Francisco,64,2023-03-06,599,606,606,0,10702,10805,10804,1,73,5,5,11,1187,1187,1182,1182
San Joaquin,64,2023-03-06,381,384,384,0,6813,6881,6880,1,42,0,0,8,2429,2429,2429,2429
San Luis Obispo,64,2023-03-06,92,92,92,0,1309,1323,1322,1,9,4,4,0,569,569,565,565
San Mateo,64,2023-03-06,425,430,430,0,7227,7299,7298,1,28,0,0,3,742,742,742,742
Santa Barbara,64,2023-03-06,149,149,149,0,3681,3717,3716,1,18,2,2,1,764,764,762,762
Santa Clara,64,2023-03-06,1083,1093,1093,0,20932,21137,21136,1,133,7,7,32,2738,2738,2731,2731
Santa Cruz,64,2023-03-06,133,133,133,0,5124,5174,5173,1,20,0,0,0,276,276,276,276
Shasta,64,2023-03-06,24,24,24,0,633,640,639,1,5,0,0,2,606,606,606,606
Siskiyou,64,2023-03-06,6,6,6,0,223,224,223,1,1,0,0,0,95,95,95,95
Solano,64,2023-03-06,256,257,257,0,3342,3375,3374,1,34,0,0,5,474,474,474,474
Sonoma,64,2023-03-06,210,210,210,0,3228,3261,3260,1,23,0,0,2,558,558,558,558
Stanislaus,64,2023-03-06,259,259,259,0,3547,3583,3582,1,67,0,0,9,1842,1842,1842,1842
Sutter,64,2023-03-06,35,35,35,0,593,601,600,1,0,0,0,0,238,238,238,238
Tehama,64,2023-03-06,12,12,12,0,251,252,251,1,5,0,0,1,234,234,234,234
Trinity,64,2023-03-06,2,2,2,0,18,19,18,1,0,0,0,0,23,23,23,23
Tulare,64,2023-03-06,209,209,209,0,3264,3296,3295,1,29,0,0,3,1590,1590,1590,1590
Tuolumne,64,2023-03-06,37,37,37,0,401,408,407,1,1,0,0,0,211,211,211,211
Ventura,64,2023-03-06,252,252,252,0,4975,5024,5023,1,42,2,2,5,1683,1683,1681,1681
Yolo,64,2023-03-06,64,64,64,0,1260,1273,1272,1,4,1,1,0,448,448,447,447
Yuba,64,2023-03-06,38,38,38,0,509,515,514,1,7,0,0,0,122,122,122,122
Alameda,65,2023-03-13,860,870,870,0,15318,15489,15488,1,76,2,2,18,2197,2197,2195,2195
Amador,65,2023-03-13,14,14,14,0,380,388,387,1,5,0,0,1,98,98,98,98
Butte,65,2023-03-13,38,38,38,0,600,607,606,1,9,1,1,1,494,494,493,493
Calaveras,65,2023-03-13,14,14,14,0,243,246,245,1,0,0,0,0,142,142,142,142
Colusa,65,2023-03-13,4,4,4,0,159,162,161,1,0,1,1,0,23,23,22,22
Contra Costa,65,2023-03-13,585,592,592,0,9862,9972,9971,1,44,2,2,7,1569,1569,1567,1567
Del Norte,65,2023-03-13,8,8,8,0,256,259,258,1,1,0,0,0,60,60,60,60
El Dorado,65,2023-03-13,47,47,47,0,897,908,907,1,1,0,0,0,246,246,246,246
Fresno,65,2023-03-13,385,391,391,0,7768,7856,7855,1,79,0,0,10,3011,3011,3011,3011
Glenn,65,2023-03-13,10,10,10,0,141,143,142,1,0,0,0,0,53,53,53,53
Humboldt,65,2023-03-13,28,28,28,0,505,513,512,1,4,0,0,1,170,170,170,170
Imperial,65,2023-03-13,214,214,214,0,2035,2059,2058,1,12,1,1,0,981,981,980,980
Inyo,65,2023-03-13,0,0,0,0,259,263,262,1,0,0,0,0,63,63,63,63
Kern,65,2023-03-13,335,339,339,0,7630,7716,7715,1,52,0,0,12,2491,2491,2491,2491
Kings,65,2023-03-13,60,60,60,0,1437,1454,1453,1,1,0,0,0,485,485,485,485
Lake,65,2023-03-13,11,11,11,0,410,416,415,1,1,0,0,0,162,162,162,162
Lassen,65,2023-03-13,6,6,6,0,335,340,339,1,0,0,0,0,64,64,64,64
Los Angeles,65,2023-03-13,3874,3917,3917,0,120869,122219,122218,1,418,71,78,56,35785,35805,35714,35727
Madera,65,2023-03-13,50,50,50,0,1149,1163,1162,1,6,0,0,0,376,376,376,376
Marin,65,2023-03-13,98,98,98,0,1720,1740,1739,1,21,0,0,1,317,317,317,317
Mariposa,65,2023-03-13,5,5,5,0,93,94,93,1,0,0,0,0,31,31,31,31
Mendocino,65,2023-03-13,17,17,17,0,458,464,463,1,6,0,0,1,145,145,145,145
Merced,65,2023-03-13,102,102,102,0,1506,1524,1523,1,12,0,0,2,903,903,903,903
Modoc,65,2023-03-13,1,1,1,0,12,13,12,1,0,0,0,0,9,9,9,9
Mono,65,2023-03-13,1,1,1,0,50,51,50,1,0,0,0,0,8,8,8,8
Monterey,65,2023-03-13,72,72,72,0,1810,1832,1831,1,27,0,0,2,809,809,809,809
Napa,65,2023-03-13,55,55,55,0,940,952,951,1,4,3,3,2,169,169,166,166
Nevada,65,2023-03-13,18,18,18,0,478,484,483,1,4,0,0,0,137,137,137,137
Orange,65,2023-03-13,913,923,923,0,18060,18263,18262,1,129,28,29,21,8075,8076,8047,8047
Placer,65,2023-03-13,168,168,168,0,2134,2159,2158,1,66,0,0,8,682,682,682,682
Plumas,65,2023-03-13,5,5,5,0,64,65,64,1,0,0,0,0,15,15,15,15
Riverside,65,2023-03-13,905,915,915,0,14725,14889,14888,1,79,6,6,14,6843,6843,6837,6837
Sacramento,65,2023-03-13,708,716,716,0,10736,10857,10856,1,105,7,7,21,3566,3566,3559,3559
San Benito,65,2023-03-13,13,13,13,0,412,418,417,1,0,0,0,0,112,112,112,112
San Bernardino,65,2023-03-13,708,716,716,0,14704,14869,14868,1,94,0,0,20,8133,8133,8133,8133
San Diego,65,2023-03-13,1317,1333,1333,0,23775,24041,24040,1,177,9,9,13,5829,5829,5820,5820
San Francisco,65,2023-03-13,550,556,556,0,9389,9494,9493,1,73,3,3,14,1190,1190,1187,1187
San Joaquin,65,2023-03-13,371,376,376,0,6808,6886,6885,1,34,4,4,6,2433,2433,2429,2429
San Luis Obispo,65,2023-03-13,78,78,78,0,1326,1342,1341,1,9,0,0,0,569,569,569,569
San Mateo,65,2023-03-13,371,376,376,0,6701,6776,6775,1,24,0,0,5,742,742,742,742
Santa Barbara,65,2023-03-13,150,150,150,0,3416,3455,3454,1,12,0,0,1,764,764,764,764
Santa Clara,65,2023-03-13,1041,1053,1053,0,20666,20898,20897,1,139,10,10,20,2748,2748,2738,2738
Santa Cruz,65,2023-03-13,109,109,109,0,3216,3253,3252,1,21,0,0,1,276,276,276,276
Shasta,65,2023-03-13,27,27,27,0,586,594,593,1,6,0,0,1,606,606,606,606
Siskiyou,65,2023-03-13,10,10,10,0,159,160,159,1,0,0,0,0,95,95,95,95
Solano,65,2023-03-13,229,230,230,0,3081,3118,3117,1,27,0,0,4,474,474,474,474
Sonoma,65,2023-03-13,196,196,196,0,2820,2854,2853,1,41,3,3,4,561,561,558,558
Stanislaus,65,2023-03-13,195,195,195,0,3442,3482,3481,1,52,0,0,4,1842,1842,1842,1842
Sutter,65,2023-03-13,27,27,27,0,518,527,526,1,0,0,0,0,238,238,238,238
Tehama,65,2023-03-13,17,17,17,0,230,232,231,1,1,0,0,0,234,234,234,234
Trinity,65,2023-03-13,0,0,0,0,22,23,22,1,0,0,0,0,23,23,23,23
Tulare,65,2023-03-13,164,164,164,0,3263,3300,3299,1,31,3,3,2,1593,1593,1590,1590
Tuolumne,65,2023-03-13,18,18,18,0,367,372,371,1,2,0,0,0,211,211,211,211
Ventura,65,2023-03-13,230,231,231,0,4367,4417,4416,1,25,4,4,5,1687,1687,1683,1683
Yolo,65,2023-03-13,72,72,72,0,1076,1089,1088,1,2,1,1,0,449,449,448,448
Yuba,65,2023-03-13,33,33,33,0,473,481,480,1,7,0,0,0,122,122,122,122
Alameda,66,2023-03-20,763,773,773,0,14848,15036,15035,1,69,7,7,10,2204,2204,2197,2197
Amador,66,2023-03-20,15,15,15,0,396,403,402,1,3,0,0,1,98,98,98,98
Butte,66,2023-03-20,44,44,44,0,502,511,510,1,5,1,1,3,495,495,494,494
Calaveras,66,2023-03-20,9,9,9,0,246,250,249,1,0,0,0,0,142,142,142,142
Colusa,66,2023-03-20,4,4,4,0,153,156,155,1,0,0,0,0,23,23,23,23
Contra Costa,66,2023-03-20,433,440,440,0,9440,9562,9561,1,31,6,6,8,1575,1575,1569,1569
Del Norte,66,2023-03-20,2,2,2,0,224,227,226,1,0,0,0,1,60,60,60,60
El Dorado,66,2023-03-20,46,46,46,0,849,861,860,1,2,0,0,0,246,246,246,246
Fresno,66,2023-03-20,371,378,378,0,7758,7858,7857,1,66,2,2,16,3013,3013,3011,3011
Glenn,66,2023-03-20,4,4,4,0,132,134,133,1,0,0,0,0,53,53,53,53
Humboldt,66,2023-03-20,21,21,21,0,477,485,484,1,4,0,0,2,170,170,170,170
Imperial,66,2023-03-20,156,156,156,0,1628,1650,1649,1,9,0,0,1,981,981,981,981
Inyo,66,2023-03-20,10,10,10,0,281,286,285,1,0,0,0,0,63,63,63,63
Kern,66,2023-03-20,205,206,206,0,7575,7671,7670,1,29,2,2,8,2493,2493,2491,2491
Kings,66,2023-03-20,40,40,40,0,1448,1467,1466,1,1,1,1,0,486,486,485,485
Lake,66,2023-03-20,12,12,12,0,404,410,409,1,2,0,0,0,162,162,162,162
Lassen,66,2023-03-20,4,4,4,0,307,311,310,1,0,0,0,0,64,64,64,64
Los Angeles,66,2023-03-20,3209,3249,3249,0,109851,111230,111229,1,397,59,66,44,35844,35871,35785,35805
Madera,66,2023-03-20,50,50,50,0,1112,1128,1127,1,4,0,0,0,376,376,376,376
Marin,66,2023-03-20,87,87,87,0,1521,1541,1540,1,25,0,0,2,317,317,317,317
Mariposa,66,2023-03-20,2,2,2,0,91,92,91,1,0,0,0,0,31,31,31,31
Mendocino,66,2023-03-20,11,11,11,0,423,430,429,1,2,0,0,0,145,145,145,145
Merced,66,2023-03-20,104,104,104,0,1471,1491,1490,1,6,0,0,2,903,903,903,903
Modoc,66,2023-03-20,1,1,1,0,10,11,10,1,0,0,0,0,9,9,9,9
Mono,66,2023-03-20,4,4,4,0,53,54,53,1,0,0,0,0,8,8,8,8
Monterey,66,2023-03-20,59,59,59,0,1428,1448,1447,1,21,0,0,1,809,809,809,809
Napa,66,2023-03-20,30,30,30,0,905,919,918,1,3,1,1,1,170,170,169,169
Nevada,66,2023-03-20,17,17,17,0,457,465,464,1,4,0,0,0,137,137,137,137
Orange,66,2023-03-20,742,752,752,0,16301,16507,16506,1,115,11,11,25,8086,8087,8075,8076
Placer,66,2023-03-20,124,124,124,0,2147,2174,2173,1,58,0,0,8,682,682,682,682
Plumas,66,2023-03-20,2,2,2,0,52,53,52,1,0,0,0,0,15,15,15,15
Riverside,66,2023-03-20,590,597,597,0,12324,12480,12479,1,57,1,1,7,6844,6844,6843,6843
Sacramento,66,2023-03-20,488,495,495,0,9731,9854,9853,1,85,4,4,16,3570,3570,3566,3566
San Benito,66,2023-03-20,41,41,41,0,555,564,563,1,0,1,1,0,113,113,112,112
San Bernardino,66,2023-03-20,520,527,527,0,13868,14044,14043,1,77,0,0,12,8133,8133,8133,8133
San Diego,66,2023-03-20,1119,1132,1132,0,22792,23079,23078,1,139,9,9,13,5838,5838,5829,5829
San Francisco,66,2023-03-20,418,425,425,0,8427,8534,8533,1,63,4,4,8,1194,1194,1190,1190
San Joaquin,66,2023-03-20,273,278,278,0,5778,5850,5849,1,28,6,6,5,2439,2439,2433,2433
San Luis Obispo,66,2023-03-20,48,48,48,0,1154,1168,1167,1,9,1,1,0,570,570,569,569
San Mateo,66,2023-03-20,309,314,314,0,6304,6384,6383,1,24,0,0,1,742,742,742,742
Santa Barbara,66,2023-03-20,111,111,111,0,3109,3150,3149,1,15,1,1,1,765,765,764,764
Santa Clara,66,2023-03-20,793,802,802,0,16859,17071,17070,1,151,6,6,22,2754,2754,2748,2748
Santa Cruz,66,2023-03-20,122,122,122,0,3046,3086,3085,1,9,0,0,1,276,276,276,276
Shasta,66,2023-03-20,18,18,18,0,569,577,576,1,2,0,0,3,606,606,606,606
Siskiyou,66,2023-03-20,4,4,4,0,157,158,157,1,0,0,0,0,95,95,95,95
Solano,66,2023-03-20,184,185,185,0,2887,2925,2924,1,26,1,1,5,475,475,474,474
Sonoma,66,2023-03-20,183,184,184,0,2730,2766,2765,1,33,0,0,1,561,561,561,561
Stanislaus,66,2023-03-20,199,199,199,0,3278,3320,3319,1,48,0,0,6,1842,1842,1842,1842
Sutter,66,2023-03-20,38,38,38,0,486,494,493,1,0,0,0,0,238,238,238,238
Tehama,66,2023-03-20,14,14,14,0,218,221,220,1,2,1,1,0,235,235,234,234
Trinity,66,2023-03-20,0,0,0,0,17,18,17,1,0,0,0,0,23,23,23,23
Tulare,66,2023-03-20,119,119,119,0,2675,2709,2708,1,25,1,1,0,1594,1594,1593,1593
Tuolumne,66,2023-03-20,14,14,14,0,387,395,394,1,0,0,0,0,211,211,211,211
Ventura,66,2023-03-20,176,176,176,0,4142,4196,4195,1,39,4,4,2,1691,1691,1687,1687
Yolo,66,2023-03-20,54,54,54,0,1059,1074,1073,1,6,0,0,1,449,449,449,449
Yuba,66,2023-03-20,18,18,18,0,461,469,468,1,7,0,0,0,122,122,122,122
Alameda,67,2023-03-27,594,602,602,0,13358,13551,13550,1,91,3,3,9,2207,2207,2204,2204
Amador,67,2023-03-27,10,10,10,0,359,367,366,1,3,0,0,1,98,98,98,98
Butte,67,2023-03-27,30,30,30,0,500,509,508,1,8,1,1,0,496,496,495,495
Calaveras,67,2023-03-27,12,12,12,0,245,249,248,1,0,1,1,0,143,143,142,142
Colusa,67,2023-03-27,4,4,4,0,162,165,164,1,0,0,0,0,23,23,23,23
Contra Costa,67,2023-03-27,397,403,403,0,8889,9017,9016,1,33,1,1,6,1576,1576,1575,1575
Del Norte,67,2023-03-27,6,6,6,0,206,208,207,1,0,0,0,1,60,60,60,60
El Dorado,67,2023-03-27,35,35,35,0,781,792,791,1,2,0,0,0,246,246,246,246
Fresno,67,2023-03-27,249,253,253,0,7256,7360,7359,1,59,1,1,5,3014,3014,3013,3013
Glenn,67,2023-03-27,6,6,6,0,134,136,135,1,0,0,0,0,53,53,53,53
Humboldt,67,2023-03-27,13,13,13,0,447,454,453,1,5,1,1,1,171,171,170,170
Imperial,67,2023-03-27,150,150,150,0,1679,1704,1703,1,10,0,0,1,981,981,981,981
Inyo,67,2023-03-27,10,10,10,0,224,228,227,1,0,0,0,0,63,63,63,63
Kern,67,2023-03-27,186,187,187,0,6957,7057,7056,1,29,1,1,3,2494,2494,2493,2493
Kings,67,2023-03-27,38,38,38,0,1318,1339,1338,1,2,0,0,1,486,486,486,486
Lake,67,2023-03-27,13,13,13,0,349,355,354,1,2,1,1,0,163,163,162,162
Lassen,67,2023-03-27,7,7,7,0,315,322,321,1,0,0,0,0,64,64,64,64
Los Angeles,67,2023-03-27,2431,2466,2466,0,103833,105323,105322,1,348,31,33,46,35875,35904,35844,35871
Madera,67,2023-03-27,33,33,33,0,958,972,971,1,5,0,0,0,376,376,376,376
Marin,67,2023-03-27,78,78,78,0,1286,1305,1304,1,18,0,0,1,317,317,317,317
Mariposa,67,2023-03-27,0,0,0,0,74,75,74,1,0,0,0,0,31,31,31,31
Mendocino,67,2023-03-27,15,15,15,0,410,418,417,1,1,0,0,1,145,145,145,145
Merced,67,2023-03-27,91,91,91,0,1332,1353,1352,1,6,0,0,2,903,903,903,903
Modoc,67,2023-03-27,0,0,0,0,5,6,5,1,0,0,0,0,9,9,9,9
Mono,67,2023-03-27,1,1,1,0,49,50,49,1,0,0,0,0,8,8,8,8
Monterey,67,2023-03-27,51,51,51,0,1696,1721,1720,1,19,0,0,0,809,809,809,809
Napa,67,2023-03-27,42,42,42,0,886,900,899,1,3,0,0,1,170,170,170,170
Nevada,67,2023-03-27,24,24,24,0,473,481,480,1,3,0,0,0,137,137,137,137
Orange,67,2023-03-27,632,640,640,0,15574,15799,15798,1,112,16,17,19,8102,8104,8086,8087
Placer,67,2023-03-27,103,103,103,0,1878,1906,1905,1,43,0,0,6,682,682,682,682
Plumas,67,2023-03-27,1,1,1,0,55,56,55,1,0,0,0,0,15,15,15,15
Riverside,67,2023-03-27,544,551,551,0,11270,11432,11431,1,41,5,5,6,6849,6849,6844,6844
Sacramento,67,2023-03-27,439,446,446,0,9393,9529,9528,1,79,9,9,11,3579,3579,3570,3570
San Benito,67,2023-03-27,25,25,25,0,753,764,763,1,1,0,0,0,113,113,113,113
San Bernardino,67,2023-03-27,425,432,432,0,12624,12805,12804,1,67,0,0,12,8133,8133,8133,8133
San Diego,67,2023-03-27,880,892,892,0,20626,20922,20921,1,137,3,3,7,5841,5841,5838,5838
San Francisco,67,2023-03-27,369,376,376,0,7828,7940,7939,1,45,3,3,5,1197,1197,1194,1194
San Joaquin,67,2023-03-27,245,249,249,0,5547,5628,5627,1,23,2,2,11,2441,2441,2439,2439
San Luis Obispo,67,2023-03-27,39,39,39,0,1138,1155,1154,1,4,0,0,0,570,570,570,570
San Mateo,67,2023-03-27,270,275,275,0,5700,5783,5782,1,29,0,0,1,742,742,742,742
Santa Barbara,67,2023-03-27,88,88,88,0,3228,3276,3275,1,9,0,0,2,765,765,765,765
Santa Clara,67,2023-03-27,695,705,705,0,15859,16088,16087,1,100,6,6,14,2760,2760,2754,2754
Santa Cruz,67,2023-03-27,128,128,128,0,2965,3009,3008,1,8,0,0,1,276,276,276,276
Shasta,67,2023-03-27,16,16,16,0,536,544,543,1,2,0,0,3,606,606,606,606
Siskiyou,67,2023-03-27,1,1,1,0,147,148,147,1,0,0,0,0,95,95,95,95
Solano,67,2023-03-27,168,169,169,0,2661,2699,2698,1,23,0,0,4,475,475,475,475
Sonoma,67,2023-03-27,152,152,152,0,2420,2456,2455,1,29,2,2,4,563,563,561,561
Stanislaus,67,2023-03-27,150,150,150,0,2573,2611,2610,1,39,0,0,6,1842,1842,1842,1842
Sutter,67,2023-03-27,37,37,37,0,419,427,426,1,0,0,0,0,238,238,238,238
Tehama,67,2023-03-27,5,5,5,0,196,198,197,1,2,1,1,0,236,236,235,235
Trinity,67,2023-03-27,0,0,0,0,24,25,24,1,0,0,0,0,23,23,23,23
Tulare,67,2023-03-27,102,102,102,0,2715,2753,2752,1,25,0,0,1,1594,1594,1594,1594
Tuolumne,67,2023-03-27,8,8,8,0,308,315,314,1,1,0,0,0,211,211,211,211
Ventura,67,2023-03-27,145,145,145,0,4099,4159,4158,1,25,4,4,2,1695,1695,1691,1691
Yolo,67,2023-03-27,61,61,61,0,1064,1080,1079,1,6,1,1,1,450,450,449,449
Yuba,67,2023-03-27,13,13,13,0,417,425,424,1,1,0,0,1,122,122,122,122
Alameda,68,2023-04-03,573,582,582,0,12443,12650,12649,1,58,3,3,9,2210,2210,2207,2207
Amador,68,2023-04-03,16,16,16,0,286,293,292,1,2,0,0,0,98,98,98,98
Butte,68,2023-04-03,22,22,22,0,464,473,472,1,7,1,1,0,497,497,496,496
Calaveras,68,2023-04-03,5,5,5,0,203,207,206,1,0,0,0,0,143,143,143,143
Colusa,68,2023-04-03,9,9,9,0,174,177,176,1,2,0,0,0,23,23,23,23
Contra Costa,68,2023-04-03,391,398,398,0,8666,8811,8810,1,37,3,3,4,1579,1579,1576,1576
Del Norte,68,2023-04-03,5,5,5,0,195,197,196,1,0,0,0,0,60,60,60,60
El Dorado,68,2023-04-03,65,65,65,0,745,760,759,1,4,0,0,0,246,246,246,246
Fresno,68,2023-04-03,276,282,282,0,7090,7209,7208,1,54,4,4,12,3018,3018,3014,3014
Glenn,68,2023-04-03,6,6,6,0,127,129,128,1,0,0,0,0,53,53,53,53
Humboldt,68,2023-04-03,20,20,20,0,451,459,458,1,5,0,0,0,171,171,171,171
Imperial,68,2023-04-03,189,191,191,0,1507,1533,1532,1,14,0,0,1,981,981,981,981
Inyo,68,2023-04-03,2,2,2,0,139,142,141,1,0,0,0,0,63,63,63,63
Kern,68,2023-04-03,156,157,157,0,5610,5704,5703,1,28,2,2,1,2496,2496,2494,2494
Kings,68,2023-04-03,35,35,35,0,1018,1036,1035,1,5,0,0,0,486,486,486,486
Lake,68,2023-04-03,16,16,16,0,342,348,347,1,0,0,0,0,163,163,163,163
Lassen,68,2023-04-03,3,3,3,0,165,168,167,1,0,0,0,0,64,64,64,64
Los Angeles,68,2023-04-03,2415,2455,2455,0,97815,99431,99430,1,318,41,48,40,35916,35952,35875,35904
Madera,68,2023-04-03,38,38,38,0,852,866,865,1,1,0,0,0,376,376,376,376
Marin,68,2023-04-03,105,105,105,0,1243,1264,1263,1,16,0,0,0,317,317,317,317
Mariposa,68,2023-04-03,6,6,6,0,71,72,71,1,0,0,0,0,31,31,31,31
Mendocino,68,2023-04-03,14,14,14,0,362,370,369,1,3,0,0,1,145,145,145,145
Merced,68,2023-04-03,74,74,74,0,925,941,940,1,6,0,0,0,903,903,903,903
Modoc,68,2023-04-03,4,4,4,0,12,13,12,1,0,0,0,0,9,9,9,9
Mono,68,2023-04-03,2,2,2,0,40,41,40,1,0,0,0,0,8,8,8,8
Monterey,68,2023-04-03,59,59,59,0,1644,1673,1672,1,16,2,2,1,811,811,809,809
Napa,68,2023-04-03,40,40,40,0,804,817,816,1,8,2,2,1,172,172,170,170
Nevada,68,2023-04-03,56,56,56,0,433,442,441,1,4,1,1,0,138,138,137,137
Orange,68,2023-04-03,659,669,669,0,15304,15558,15557,1,93,13,15,14,8115,8119,8102,8104
Placer,68,2023-04-03,102,102,102,0,1866,1897,1896,1,39,0,0,5,682,682,682,682
Plumas,68,2023-04-03,2,2,2,0,57,58,57,1,0,0,0,0,15,15,15,15
Riverside,68,2023-04-03,456,464,464,0,10969,11152,11151,1,61,2,2,8,6851,6851,6849,6849
Sacramento,68,2023-04-03,513,521,521,0,8922,9070,9069,1,70,1,1,16,3580,3580,3579,3579
San Benito,68,2023-04-03,24,24,24,0,550,561,560,1,0,0,0,0,113,113,113,113
San Bernardino,68,2023-04-03,465,473,473,0,11770,11965,11964,1,54,0,0,12,8133,8133,8133,8133
San Diego,68,2023-04-03,771,784,784,0,19473,19796,19795,1,128,6,6,10,5847,5847,5841,5841
San Francisco,68,2023-04-03,331,338,338,0,6760,6871,6870,1,37,3,3,9,1200,1200,1197,1197
San Joaquin,68,2023-04-03,216,220,220,0,4980,5063,5062,1,31,2,2,8,2443,2443,2441,2441
San Luis Obispo,68,2023-04-03,45,45,45,0,965,983,982,1,5,3,3,0,573,573,570,570
San Mateo,68,2023-04-03,257,262,262,0,5633,5726,5725,1,29,0,0,0,742,742,742,742
Santa Barbara,68,2023-04-03,95,95,95,0,2626,2671,2670,1,16,0,0,1,765,765,765,765
Santa Clara,68,2023-04-03,657,668,668,0,15162,15412,15411,1,70,1,1,15,2761,2761,2760,2760
Santa Cruz,68,2023-04-03,127,127,127,0,2461,2502,2501,1,15,0,0,0,276,276,276,276
Shasta,68,2023-04-03,21,21,21,0,511,520,519,1,1,0,0,1,606,606,606,606
Siskiyou,68,2023-04-03,2,2,2,0,93,94,93,1,0,0,0,0,95,95,95,95
Solano,68,2023-04-03,124,124,124,0,2336,2376,2375,1,20,0,0,2,475,475,475,475
Sonoma,68,2023-04-03,140,140,140,0,2084,2120,2119,1,27,2,2,0,565,565,563,563
Stanislaus,68,2023-04-03,116,116,116,0,2508,2550,2549,1,33,0,0,4,1842,1842,1842,1842
Sutter,68,2023-04-03,33,33,33,0,399,407,406,1,0,0,0,0,238,238,238,238
Tehama,68,2023-04-03,10,10,10,0,191,194,193,1,0,0,0,0,236,236,236,236
Trinity,68,2023-04-03,0,0,0,0,11,12,11,1,0,0,0,0,23,23,23,23
Tulare,68,2023-04-03,95,95,95,0,2603,2647,2646,1,19,0,0,1,1594,1594,1594,1594
Tuolumne,68,2023-04-03,6,6,6,0,247,253,252,1,1,0,0,0,211,211,211,211
Ventura,68,2023-04-03,144,144,144,0,3518,3578,3577,1,22,4,5,0,1699,1700,1695,1695
Yolo,68,2023-04-03,52,52,52,0,966,983,982,1,3,1,1,0,451,451,450,450
Yuba,68,2023-04-03,23,23,23,0,397,405,404,1,1,0,0,0,122,122,122,122
Alameda,69,2023-04-10,539,549,549,0,11017,11237,11236,1,58,2,2,10,2212,2212,2210,2210
Amador,69,2023-04-10,11,11,11,0,200,206,205,1,1,0,0,0,98,98,98,98
Butte,69,2023-04-10,19,19,19,0,433,443,442,1,4,0,0,0,497,497,497,497
Calaveras,69,2023-04-10,11,11,11,0,185,191,190,1,0,0,0,0,143,143,143,143
Colusa,69,2023-04-10,1,1,1,0,97,99,98,1,1,0,0,0,23,23,23,23
Contra Costa,69,2023-04-10,415,423,423,0,8200,8363,8362,1,42,0,0,2,1579,1579,1579,1579
Del Norte,69,2023-04-10,2,2,2,0,123,125,124,1,0,0,0,0,60,60,60,60
El Dorado,69,2023-04-10,40,40,40,0,657,672,671,1,3,0,0,1,246,246,246,246
Fresno,69,2023-04-10,270,277,277,0,6167,6291,6290,1,63,1,1,3,3019,3019,3018,3018
Glenn,69,2023-04-10,2,2,2,0,131,134,133,1,1,0,0,0,53,53,53,53
Humboldt,69,2023-04-10,16,16,16,0,428,437,436,1,4,0,0,0,171,171,171,171
Imperial,69,2023-04-10,146,147,147,0,1297,1324,1323,1,7,0,0,3,981,981,981,981
Inyo,69,2023-04-10,5,5,5,0,212,216,215,1,0,0,0,0,63,63,63,63
Kern,69,2023-04-10,155,156,156,0,4945,5044,5043,1,28,0,0,2,2496,2496,2496,2496
Kings,69,2023-04-10,44,44,44,0,866,883,882,1,4,0,0,0,486,486,486,486
Lake,69,2023-04-10,14,14,14,0,297,305,304,1,0,0,0,0,163,163,163,163
Lassen,69,2023-04-10,0,0,0,0,109,110,109,1,0,0,0,0,64,64,64,64
Los Angeles,69,2023-04-10,2423,2472,2472,0,88598,90359,90358,1,299,41,50,35,35957,36002,35916,35952
Madera,69,2023-04-10,75,75,75,0,863,880,879,1,0,0,0,0,376,376,376,376
Marin,69,2023-04-10,98,98,98,0,1179,1202,1201,1,12,0,0,2,317,317,317,317
Mariposa,69,2023-04-10,4,4,4,0,64,65,64,1,0,0,0,0,31,31,31,31
Mendocino,69,2023-04-10,14,14,14,0,350,358,357,1,2,0,0,1,145,145,145,145
Merced,69,2023-04-10,50,50,50,0,756,772,771,1,5,0,0,1,903,903,903,903
Modoc,69,2023-04-10,1,1,1,0,6,7,6,1,0,0,0,0,9,9,9,9
Mono,69,2023-04-10,1,1,1,0,45,46,45,1,0,0,0,0,8,8,8,8
Monterey,69,2023-04-10,53,53,53,0,1289,1315,1314,1,12,0,0,1,811,811,811,811
Napa,69,2023-04-10,33,33,33,0,675,689,688,1,5,0,0,0,172,172,172,172
Nevada,69,2023-04-10,43,43,43,0,352,361,360,1,3,0,0,0,138,138,138,138
Orange,69,2023-04-10,510,520,520,0,15068,15367,15366,1,87,11,14,15,8126,8133,8115,8119
Placer,69,2023-04-10,103,104,104,0,1604,1636,1635,1,32,0,0,7,682,682,682,682
Plumas,69,2023-04-10,4,4,4,0,37,38,37,1,0,0,0,0,15,15,15,15
Riverside,69,2023-04-10,399,407,407,0,10946,11164,11163,1,53,1,1,6,6852,6852,6851,6851
Sacramento,69,2023-04-10,447,456,456,0,7721,7874,7873,1,74,5,6,13,3585,3586,3580,3580
San Benito,69,2023-04-10,22,22,22,0,453,464,463,1,2,1,1,0,114,114,113,113
San Bernardino,69,2023-04-10,485,494,494,0,11501,11729,11728,1,71,0,0,11,8133,8133,8133,8133
San Diego,69,2023-04-10,842,858,858,0,20612,21019,21018,1,114,2,2,17,5849,5849,5847,5847
San Francisco,69,2023-04-10,295,302,302,0,6037,6157,6156,1,39,7,7,6,1207,1207,1200,1200
San Joaquin,69,2023-04-10,182,185,185,0,4546,4638,4637,1,22,0,0,10,2443,2443,2443,2443
San Luis Obispo,69,2023-04-10,60,60,60,0,879,898,897,1,3,1,1,1,574,574,573,573
San Mateo,69,2023-04-10,225,231,231,0,5222,5327,5326,1,21,0,0,1,742,742,742,742
Santa Barbara,69,2023-04-10,99,100,100,0,2756,2812,2811,1,16,0,0,3,765,765,765,765
Santa Clara,69,2023-04-10,623,636,636,0,14260,14542,14541,1,95,3,4,14,2764,2765,2761,2761
Santa Cruz,69,2023-04-10,103,103,103,0,1682,1716,1715,1,17,0,0,0,276,276,276,276
Shasta,69,2023-04-10,25,25,25,0,496,506,505,1,3,0,0,1,606,606,606,606
Siskiyou,69,2023-04-10,7,7,7,0,102,103,102,1,0,0,0,0,95,95,95,95
Solano,69,2023-04-10,137,139,139,0,2013,2054,2053,1,20,0,0,2,475,475,475,475
Sonoma,69,2023-04-10,127,128,128,0,1987,2025,2024,1,18,1,1,2,566,566,565,565
Stanislaus,69,2023-04-10,126,126,126,0,2156,2199,2198,1,25,0,0,2,1842,1842,1842,1842
Sutter,69,2023-04-10,30,30,30,0,416,425,424,1,0,0,0,0,238,238,238,238
Tehama,69,2023-04-10,8,8,8,0,173,177,176,1,1,0,0,0,236,236,236,236
Trinity,69,2023-04-10,2,2,2,0,13,14,13,1,0,0,0,0,23,23,23,23
Tulare,69,2023-04-10,91,92,92,0,2351,2398,2397,1,17,0,0,0,1594,1594,1594,1594
Tuolumne,69,2023-04-10,5,5,5,0,193,198,197,1,0,0,0,0,211,211,211,211
Ventura,69,2023-04-10,140,140,140,0,3231,3296,3295,1,22,0,0,0,1699,1700,1699,1700
Yolo,69,2023-04-10,62,62,62,0,876,895,894,1,3,0,0,1,451,451,451,451
Yuba,69,2023-04-10,23,23,23,0,388,397,396,1,3,0,0,0,122,122,122,122
Alameda,70,2023-04-17,564,578,578,0,10699,10970,10969,1,61,1,1,8,2213,2213,2212,2212
Amador,70,2023-04-17,13,13,13,0,192,199,198,1,1,0,0,0,98,98,98,98
Butte,70,2023-04-17,35,35,35,0,443,456,455,1,8,0,0,0,497,497,497,497
Calaveras,70,2023-04-17,8,8,8,0,176,182,181,1,0,0,0,0,143,143,143,143
Colusa,70,2023-04-17,2,2,2,0,44,45,44,1,0,1,2,0,24,25,23,23
Contra Costa,70,2023-04-17,405,416,416,0,7619,7813,7812,1,34,2,3,1,1581,1582,1579,1579
Del Norte,70,2023-04-17,1,1,1,0,104,105,104,1,0,0,0,0,60,60,60,60
El Dorado,70,2023-04-17,43,43,43,0,630,647,646,1,1,0,0,0,246,246,246,246
Fresno,70,2023-04-17,239,246,246,0,6270,6428,6427,1,59,2,2,4,3021,3021,3019,3019
Glenn,70,2023-04-17,7,7,7,0,119,122,121,1,0,0,0,0,53,53,53,53
Humboldt,70,2023-04-17,7,7,7,0,325,333,332,1,1,0,0,0,171,171,171,171
Imperial,70,2023-04-17,171,176,176,0,1192,1224,1223,1,10,0,0,1,981,981,981,981
Inyo,70,2023-04-17,4,4,4,0,121,123,122,1,0,0,0,0,63,63,63,63
Kern,70,2023-04-17,127,130,130,0,4090,4193,4192,1,18,0,0,6,2496,2496,2496,2496
Kings,70,2023-04-17,42,42,42,0,797,818,817,1,1,0,0,0,486,486,486,486
Lake,70,2023-04-17,14,14,14,0,264,273,272,1,1,0,0,0,163,163,163,163
Lassen,70,2023-04-17,3,3,3,0,65,66,65,1,0,0,0,0,64,64,64,64
Los Angeles,70,2023-04-17,2187,2242,2242,0,94813,97194,97193,1,292,34,49,27,35991,36051,35957,36002
Madera,70,2023-04-17,55,55,55,0,836,858,857,1,0,0,0,0,376,376,376,376
Marin,70,2023-04-17,66,66,66,0,947,971,970,1,16,0,0,2,317,317,317,317
Mariposa,70,2023-04-17,2,2,2,0,49,50,49,1,0,0,0,0,31,31,31,31
Mendocino,70,2023-04-17,22,22,22,0,308,316,315,1,2,0,0,2,145,145,145,145
Merced,70,2023-04-17,63,64,64,0,756,777,776,1,8,0,0,0,903,903,903,903
Modoc,70,2023-04-17,1,1,1,0,5,6,5,1,1,0,0,0,9,9,9,9
Mono,70,2023-04-17,1,1,1,0,37,38,37,1,0,0,0,0,8,8,8,8
Monterey,70,2023-04-17,44,44,44,0,1494,1534,1533,1,16,0,0,0,811,811,811,811
Napa,70,2023-04-17,34,34,34,0,719,738,737,1,4,0,0,1,172,172,172,172
Nevada,70,2023-04-17,22,22,22,0,313,322,321,1,4,0,0,0,138,138,138,138
Orange,70,2023-04-17,523,536,536,0,15230,15613,15612,1,91,10,13,9,8136,8146,8126,8133
Placer,70,2023-04-17,95,96,96,0,1489,1528,1527,1,45,1,2,4,683,684,682,682
Plumas,70,2023-04-17,4,4,4,0,51,52,51,1,0,0,0,0,15,15,15,15
Riverside,70,2023-04-17,374,382,382,0,11051,11329,11328,1,55,1,1,4,6853,6853,6852,6852
Sacramento,70,2023-04-17,494,505,505,0,7548,7739,7738,1,73,2,3,10,3587,3589,3585,3586
San Benito,70,2023-04-17,15,15,15,0,442,453,452,1,0,0,0,0,114,114,114,114
San Bernardino,70,2023-04-17,453,464,464,0,11152,11434,11433,1,64,0,0,10,8133,8133,8133,8133
San Diego,70,2023-04-17,834,855,855,0,19446,19934,19933,1,115,2,4,13,5851,5853,5849,5849
San Francisco,70,2023-04-17,301,308,308,0,6146,6301,6300,1,44,1,2,8,1208,1209,1207,1207
San Joaquin,70,2023-04-17,176,180,180,0,4404,4517,4516,1,18,0,0,3,2443,2443,2443,2443
San Luis Obispo,70,2023-04-17,59,59,59,0,863,885,884,1,8,0,0,0,574,574,574,574
San Mateo,70,2023-04-17,190,195,195,0,5121,5250,5249,1,18,0,0,4,742,742,742,742
Santa Barbara,70,2023-04-17,123,124,124,0,2738,2807,2806,1,18,1,2,1,766,767,765,765
Santa Clara,70,2023-04-17,558,573,573,0,12781,13105,13104,1,75,4,6,17,2768,2771,2764,2765
Santa Cruz,70,2023-04-17,93,93,93,0,2198,2255,2254,1,21,0,0,0,276,276,276,276
Shasta,70,2023-04-17,26,26,26,0,480,493,492,1,4,0,0,1,606,606,606,606
Siskiyou,70,2023-04-17,7,7,7,0,78,79,78,1,0,0,0,1,95,95,95,95
Solano,70,2023-04-17,165,169,169,0,1945,1996,1995,1,29,0,0,2,475,475,475,475
Sonoma,70,2023-04-17,163,166,166,0,2173,2229,2228,1,31,0,0,3,566,566,566,566
Stanislaus,70,2023-04-17,112,113,113,0,2059,2113,2112,1,27,0,0,5,1842,1842,1842,1842
Sutter,70,2023-04-17,17,17,17,0,274,282,281,1,0,0,0,0,238,238,238,238
Tehama,70,2023-04-17,11,11,11,0,160,165,164,1,3,0,0,0,236,236,236,236
Trinity,70,2023-04-17,1,1,1,0,13,14,13,1,0,0,0,0,23,23,23,23
Tulare,70,2023-04-17,99,99,99,0,2263,2320,2319,1,14,1,1,1,1595,1595,1594,1594
Tuolumne,70,2023-04-17,6,6,6,0,206,213,212,1,0,0,0,0,211,211,211,211
Ventura,70,2023-04-17,118,120,120,0,3320,3405,3404,1,18,2,2,1,1701,1702,1699,1700
Yolo,70,2023-04-17,50,50,50,0,771,792,791,1,3,0,0,0,451,451,451,451
Yuba,70,2023-04-17,15,15,15,0,266,274,273,1,4,0,0,0,122,122,122,122
Alameda,71,2023-04-24,553,573,573,0,9817,10165,10164,1,67,1,2,5,2214,2215,2213,2213
Amador,71,2023-04-24,14,14,14,0,178,186,185,1,0,0,0,0,98,98,98,98
Butte,71,2023-04-24,27,27,27,0,475,494,493,1,11,1,2,1,498,499,497,497
Calaveras,71,2023-04-24,6,6,6,0,177,185,184,1,0,0,0,0,143,143,143,143
Colusa,71,2023-04-24,0,0,0,0,40,41,40,1,0,0,0,0,24,25,24,25
Contra Costa,71,2023-04-24,348,362,362,0,7150,7403,7402,1,37,4,8,4,1585,1590,1581,1582
Del Norte,71,2023-04-24,5,5,5,0,107,110,109,1,0,0,0,0,60,60,60,60
El Dorado,71,2023-04-24,39,39,39,0,602,625,624,1,5,0,0,1,246,246,246,246
Fresno,71,2023-04-24,237,245,245,0,5998,6213,6212,1,63,1,2,7,3022,3023,3021,3021
Glenn,71,2023-04-24,3,3,3,0,103,107,106,1,0,0,0,0,53,53,53,53
Humboldt,71,2023-04-24,9,9,9,0,262,272,271,1,0,0,0,0,171,171,171,171
Imperial,71,2023-04-24,117,122,122,0,1076,1115,1114,1,7,1,2,0,982,983,981,981
Inyo,71,2023-04-24,5,5,5,0,153,159,158,1,0,0,0,0,63,63,63,63
Kern,71,2023-04-24,85,88,88,0,3676,3806,3805,1,16,0,0,4,2496,2496,2496,2496
Kings,71,2023-04-24,32,32,32,0,764,792,791,1,1,0,0,0,486,486,486,486
Lake,71,2023-04-24,14,14,14,0,327,341,340,1,0,0,0,1,163,163,163,163
Lassen,71,2023-04-24,0,0,0,0,83,86,85,1,0,0,0,0,64,64,64,64
Los Angeles,71,2023-04-24,1914,1982,1982,0,91038,94227,94226,1,224,26,51,27,36017,36102,35991,36051
Madera,71,2023-04-24,33,34,34,0,775,803,802,1,2,0,0,0,376,376,376,376
Marin,71,2023-04-24,64,64,64,0,943,977,976,1,11,0,0,1,317,317,317,317
Mariposa,71,2023-04-24,5,5,5,0,53,54,53,1,0,0,0,0,31,31,31,31
Mendocino,71,2023-04-24,9,9,9,0,264,274,273,1,3,0,0,0,145,145,145,145
Merced,71,2023-04-24,49,49,49,0,666,689,688,1,7,0,0,0,903,903,903,903
Modoc,71,2023-04-24,4,4,4,0,10,11,10,1,0,0,0,0,9,9,9,9
Mono,71,2023-04-24,2,2,2,0,43,44,43,1,0,0,0,0,8,8,8,8
Monterey,71,2023-04-24,63,64,64,0,1425,1478,1477,1,14,0,0,2,811,811,811,811
Napa,71,2023-04-24,25,25,25,0,698,725,724,1,4,0,0,1,172,172,172,172
Nevada,71,2023-04-24,36,36,36,0,281,293,292,1,1,0,0,1,138,138,138,138
Orange,71,2023-04-24,496,514,514,0,13984,14474,14473,1,88,10,21,11,8146,8167,8136,8146
Placer,71,2023-04-24,105,109,109,0,1412,1463,1462,1,33,1,2,2,684,686,683,684
Plumas,71,2023-04-24,4,4,4,0,75,78,77,1,1,0,0,0,15,15,15,15
Riverside,71,2023-04-24,319,329,329,0,11117,11504,11503,1,49,0,0,5,6853,6853,6853,6853
Sacramento,71,2023-04-24,490,507,507,0,7340,7602,7601,1,64,2,4,10,3589,3593,3587,3589
San Benito,71,2023-04-24,11,11,11,0,354,367,366,1,1,0,0,0,114,114,114,114
San Bernardino,71,2023-04-24,379,391,391,0,10380,10746,10745,1,132,0,0,15,8133,8133,8133,8133
San Diego,71,2023-04-24,702,727,727,0,18742,19400,19399,1,95,5,10,10,5856,5863,5851,5853
San Francisco,71,2023-04-24,320,332,332,0,5696,5899,5898,1,63,2,4,6,1210,1213,1208,1209
San Joaquin,71,2023-04-24,153,159,159,0,4238,4390,4389,1,18,0,0,1,2443,2443,2443,2443
San Luis Obispo,71,2023-04-24,40,40,40,0,768,796,795,1,10,0,0,0,574,574,574,574
San Mateo,71,2023-04-24,197,205,205,0,4745,4913,4912,1,19,0,0,1,742,742,742,742
Santa Barbara,71,2023-04-24,92,95,95,0,2790,2887,2886,1,11,1,3,2,767,770,766,767
Santa Clara,71,2023-04-24,522,540,540,0,11985,12408,12407,1,82,2,5,17,2770,2776,2768,2771
Santa Cruz,71,2023-04-24,57,57,57,0,1527,1582,1581,1,24,0,0,1,276,276,276,276
Shasta,71,2023-04-24,18,18,18,0,409,425,424,1,2,0,0,0,606,606,606,606
Siskiyou,71,2023-04-24,7,7,7,0,92,95,94,1,3,0,0,0,95,95,95,95
Solano,71,2023-04-24,138,144,144,0,1984,2056,2055,1,18,0,0,6,475,475,475,475
Sonoma,71,2023-04-24,158,164,164,0,2022,2094,2093,1,29,0,0,2,566,566,566,566
Stanislaus,71,2023-04-24,109,112,112,0,2104,2181,2180,1,22,0,0,2,1842,1842,1842,1842
Sutter,71,2023-04-24,24,24,24,0,284,295,294,1,0,0,0,0,238,238,238,238
Tehama,71,2023-04-24,6,6,6,0,156,164,163,1,0,0,0,0,236,236,236,236
Trinity,71,2023-04-24,1,1,1,0,13,14,13,1,0,0,0,0,23,23,23,23
Tulare,71,2023-04-24,76,77,77,0,2185,2265,2264,1,17,0,0,0,1595,1595,1595,1595
Tuolumne,71,2023-04-24,5,5,5,0,152,160,159,1,0,0,0,0,211,211,211,211
Ventura,71,2023-04-24,137,142,142,0,3034,3141,3140,1,18,0,0,2,1701,1702,1701,1702
Yolo,71,2023-04-24,38,38,38,0,823,852,851,1,1,1,2,0,452,453,451,451
Yuba,71,2023-04-24,17,17,17,0,264,274,273,1,5,0,0,0,122,122,122,122
Alameda,72,2023-05-01,441,469,469,0,8889,9464,9463,1,60,1,3,5,2215,2218,2214,2215
Amador,72,2023-05-01,6,6,6,0,140,150,149,1,2,0,0,0,98,98,98,98
Butte,72,2023-05-01,21,21,21,0,383,412,411,1,18,0,0,0,498,499,498,499
Calaveras,72,2023-05-01,1,1,1,0,154,165,164,1,0,0,0,1,143,143,143,143
Colusa,72,2023-05-01,4,4,4,0,47,51,50,1,0,0,0,0,24,25,24,25
Contra Costa,72,2023-05-01,339,361,361,0,6830,7274,7273,1,34,1,3,5,1586,1593,1585,1590
Del Norte,72,2023-05-01,1,1,1,0,84,90,89,1,0,0,0,0,60,60,60,60
El Dorado,72,2023-05-01,39,40,40,0,603,644,643,1,3,0,0,1,246,246,246,246
Fresno,72,2023-05-01,260,277,277,0,5906,6300,6299,1,62,0,0,6,3022,3023,3022,3023
Glenn,72,2023-05-01,6,6,6,0,115,125,124,1,1,0,0,0,53,53,53,53
Humboldt,72,2023-05-01,10,10,10,0,232,248,247,1,0,0,0,0,171,171,171,171
Imperial,72,2023-05-01,92,99,99,0,1110,1184,1183,1,12,0,0,0,982,983,982,983
Inyo,72,2023-05-01,7,7,7,0,165,177,176,1,1,0,0,0,63,63,63,63
Kern,72,2023-05-01,82,87,87,0,3581,3814,3813,1,10,0,0,3,2496,2496,2496,2496
Kings,72,2023-05-01,28,28,28,0,649,691,690,1,0,0,0,0,486,486,486,486
Lake,72,2023-05-01,9,9,9,0,273,291,290,1,1,0,0,0,163,163,163,163
Lassen,72,2023-05-01,3,3,3,0,67,73,72,1,0,0,0,0,64,64,64,64
Los Angeles,72,2023-05-01,1814,1931,1931,0,60868,64281,64280,1,249,15,57,28,36032,36159,36017,36102
Madera,72,2023-05-01,49,51,51,0,777,828,827,1,2,0,0,0,376,376,376,376
Marin,72,2023-05-01,67,71,71,0,849,906,905,1,9,0,0,1,317,317,317,317
Mariposa,72,2023-05-01,0,0,0,0,67,73,72,1,0,0,0,0,31,31,31,31
Mendocino,72,2023-05-01,10,10,10,0,221,237,236,1,1,0,0,0,145,145,145,145
Merced,72,2023-05-01,42,44,44,0,714,761,760,1,2,0,0,1,903,903,903,903
Modoc,72,2023-05-01,3,3,3,0,6,7,6,1,0,0,0,0,9,9,9,9
Mono,72,2023-05-01,1,1,1,0,30,31,30,1,0,0,0,0,8,8,8,8
Monterey,72,2023-05-01,52,57,57,0,1341,1436,1435,1,18,0,0,1,811,811,811,811
Napa,72,2023-05-01,32,33,33,0,653,697,696,1,1,1,5,0,173,177,172,172
Nevada,72,2023-05-01,26,26,26,0,235,251,250,1,6,0,0,0,138,138,138,138
Orange,72,2023-05-01,420,446,446,0,14054,14969,14968,1,60,1,4,12,8147,8171,8146,8167
Placer,72,2023-05-01,92,99,99,0,1418,1513,1512,1,45,0,0,0,684,686,684,686
Plumas,72,2023-05-01,5,5,5,0,43,46,45,1,0,0,0,0,15,15,15,15
Riverside,72,2023-05-01,269,286,286,0,10187,10834,10833,1,47,0,0,8,6853,6853,6853,6853
Sacramento,72,2023-05-01,508,541,541,0,6775,7224,7223,1,73,3,12,5,3592,3605,3589,3593
San Benito,72,2023-05-01,12,12,12,0,323,345,344,1,0,0,0,0,114,114,114,114
San Bernardino,72,2023-05-01,349,374,374,0,10560,11257,11256,1,54,0,0,12,8133,8133,8133,8133
San Diego,72,2023-05-01,568,604,604,0,17713,18858,18857,1,90,0,0,7,5856,5863,5856,5863
San Francisco,72,2023-05-01,231,246,246,0,5442,5802,5801,1,38,1,3,4,1211,1216,1210,1213
San Joaquin,72,2023-05-01,146,156,156,0,3936,4203,4202,1,15,0,0,2,2443,2443,2443,2443
San Luis Obispo,72,2023-05-01,38,39,39,0,710,757,756,1,3,1,3,0,575,577,574,574
San Mateo,72,2023-05-01,195,207,207,0,4323,4602,4601,1,15,0,0,2,742,742,742,742
Santa Barbara,72,2023-05-01,71,75,75,0,2248,2386,2385,1,16,1,7,1,768,777,767,770
Santa Clara,72,2023-05-01,541,578,578,0,11467,12199,12198,1,95,0,0,15,2770,2776,2770,2776
Santa Cruz,72,2023-05-01,46,48,48,0,1402,1498,1497,1,14,1,7,1,277,283,276,276
Shasta,72,2023-05-01,7,7,7,0,394,423,422,1,3,0,0,1,606,606,606,606
Siskiyou,72,2023-05-01,8,8,8,0,111,120,119,1,3,0,0,0,95,95,95,95
Solano,72,2023-05-01,84,91,91,0,1671,1782,1781,1,19,0,0,4,475,475,475,475
Sonoma,72,2023-05-01,99,106,106,0,1885,2008,2007,1,12,0,0,1,566,566,566,566
Stanislaus,72,2023-05-01,91,99,99,0,1862,1990,1989,1,24,0,0,4,1842,1842,1842,1842
Sutter,72,2023-05-01,14,14,14,0,221,237,236,1,0,0,0,0,238,238,238,238
Tehama,72,2023-05-01,10,10,10,0,145,156,155,1,0,0,0,0,236,236,236,236
Trinity,72,2023-05-01,2,2,2,0,10,11,10,1,0,0,0,0,23,23,23,23
Tulare,72,2023-05-01,64,69,69,0,1886,2011,2010,1,9,0,0,0,1595,1595,1595,1595
Tuolumne,72,2023-05-01,15,16,16,0,177,190,189,1,1,0,0,0,211,211,211,211
Ventura,72,2023-05-01,108,115,115,0,2763,2950,2949,1,15,0,0,1,1701,1702,1701,1702
Yolo,72,2023-05-01,43,44,44,0,835,890,889,1,3,0,0,1,452,453,452,453
Yuba,72,2023-05-01,19,19,19,0,253,271,270,1,3,0,0,0,122,122,122,122
Alameda,73,2023-05-08,373,1210,1210,0,7064,18711,18710,1,53,0,0,6,2215,2218,2215,2218
Amador,73,2023-05-08,5,6,6,0,123,306,305,1,1,0,0,0,98,98,98,98
Butte,73,2023-05-08,22,73,73,0,360,931,930,1,9,0,0,0,498,499,498,499
Calaveras,73,2023-05-08,5,6,6,0,127,256,255,1,1,0,0,0,143,143,143,143
Colusa,73,2023-05-08,2,2,2,0,27,112,111,1,1,0,0,0,24,25,24,25
Contra Costa,73,2023-05-08,190,733,733,0,5064,14008,14007,1,39,0,0,11,1586,1593,1586,1593
Del Norte,73,2023-05-08,5,9,9,0,72,187,186,1,1,0,0,0,60,60,60,60
El Dorado,73,2023-05-08,27,97,97,0,388,961,960,1,0,0,0,0,246,246,246,246
Fresno,73,2023-05-08,172,588,588,0,4299,10649,10648,1,61,0,0,7,3022,3023,3022,3023
Glenn,73,2023-05-08,5,6,6,0,48,154,153,1,1,0,0,0,53,53,53,53
Humboldt,73,2023-05-08,8,25,25,0,185,585,584,1,0,0,0,0,171,171,171,171
Imperial,73,2023-05-08,63,264,264,0,884,3380,3379,1,8,0,0,1,982,983,982,983
Inyo,73,2023-05-08,2,3,3,0,148,311,310,1,0,0,0,0,63,63,63,63
Kern,73,2023-05-08,74,184,184,0,2659,4696,4695,1,8,0,0,3,2496,2496,2496,2496
Kings,73,2023-05-08,30,90,90,0,584,1561,1560,1,0,0,0,1,486,486,486,486
Lake,73,2023-05-08,7,24,24,0,229,662,661,1,1,0,0,0,163,163,163,163
Lassen,73,2023-05-08,6,9,9,0,55,121,120,1,0,0,0,0,64,64,64,64
Los Angeles,73,2023-05-08,955,1652,1652,0,4315,8398,8397,1,225,10,177,25,36042,36336,36032,36159
Madera,73,2023-05-08,25,52,52,0,558,1355,1354,1,0,0,0,0,376,376,376,376
Marin,73,2023-05-08,43,127,127,0,673,2263,2262,1,12,0,0,2,317,317,317,317
Mariposa,73,2023-05-08,0,0,0,0,42,100,99,1,0,0,0,0,31,31,31,31
Mendocino,73,2023-05-08,7,24,24,0,219,593,592,1,0,0,0,0,145,145,145,145
Merced,73,2023-05-08,29,55,55,0,472,1174,1173,1,4,0,0,0,903,903,903,903
Modoc,73,2023-05-08,10,12,12,0,11,15,14,1,0,0,0,0,9,9,9,9
Mono,73,2023-05-08,0,0,0,0,40,96,95,1,0,0,0,0,8,8,8,8
Monterey,73,2023-05-08,32,93,93,0,986,2914,2913,1,15,0,0,0,811,811,811,811
Napa,73,2023-05-08,43,99,99,0,578,1401,1400,1,0,0,0,0,173,177,173,177
Nevada,73,2023-05-08,14,46,46,0,174,318,317,1,4,0,0,0,138,138,138,138
Orange,73,2023-05-08,375,998,998,0,10413,26312,26311,1,71,0,0,10,8147,8171,8147,8171
Placer,73,2023-05-08,98,327,327,0,1145,3354,3353,1,29,0,0,2,684,686,684,686
Plumas,73,2023-05-08,6,8,8,0,40,125,124,1,0,0,0,0,15,15,15,15
Riverside,73,2023-05-08,189,416,416,0,6611,12174,12173,1,37,0,0,4,6853,6853,6853,6853
Sacramento,73,2023-05-08,285,928,928,0,4972,12684,12683,1,56,0,0,9,3592,3605,3592,3605
San Benito,73,2023-05-08,8,44,44,0,257,970,969,1,1,0,0,0,114,114,114,114
San Bernardino,73,2023-05-08,173,413,413,0,6648,12818,12817,1,49,0,0,10,8133,8133,8133,8133
San Diego,73,2023-05-08,469,1084,1084,0,13979,31021,31020,1,88,1,9,12,5857,5872,5856,5863
San Francisco,73,2023-05-08,182,697,697,0,3650,9469,9468,1,42,0,0,5,1211,1216,1211,1216
San Joaquin,73,2023-05-08,156,455,455,0,2770,6914,6913,1,14,0,0,2,2443,2443,2443,2443
San Luis Obispo,73,2023-05-08,28,121,121,0,550,1396,1395,1,8,0,0,0,575,577,575,577
San Mateo,73,2023-05-08,173,417,417,0,2983,7244,7243,1,21,0,0,2,742,742,742,742
Santa Barbara,73,2023-05-08,67,246,246,0,1441,3597,3596,1,10,0,0,1,768,777,768,777
Santa Clara,73,2023-05-08,384,1275,1275,0,8199,19722,19721,1,94,0,0,11,2770,2776,2770,2776
Santa Cruz,73,2023-05-08,48,67,67,0,1003,1800,1799,1,10,0,0,0,277,283,277,283
Shasta,73,2023-05-08,8,8,8,0,235,321,320,1,4,0,0,1,606,606,606,606
Siskiyou,73,2023-05-08,7,12,12,0,94,327,326,1,1,0,0,0,95,95,95,95
Solano,73,2023-05-08,78,333,333,0,1337,4006,4005,1,11,0,0,2,475,475,475,475
Sonoma,73,2023-05-08,76,261,261,0,1476,4422,4421,1,15,0,0,1,566,566,566,566
Stanislaus,73,2023-05-08,70,318,318,0,1544,4331,4330,1,25,0,0,2,1842,1842,1842,1842
Sutter,73,2023-05-08,8,12,12,0,258,699,698,1,0,0,0,0,238,238,238,238
Tehama,73,2023-05-08,10,56,56,0,84,147,146,1,2,0,0,0,236,236,236,236
Trinity,73,2023-05-08,0,0,0,0,7,23,22,1,0,0,0,0,23,23,23,23
Tulare,73,2023-05-08,41,178,178,0,1151,2026,2025,1,10,0,0,0,1595,1595,1595,1595
Tuolumne,73,2023-05-08,9,38,38,0,182,635,634,1,0,0,0,0,211,211,211,211
Ventura,73,2023-05-08,80,299,299,0,2258,6565,6564,1,10,0,0,0,1701,1702,1701,1702
Yolo,73,2023-05-08,31,76,76,0,527,1237,1236,1,3,0,0,0,452,453,452,453
Yuba,73,2023-05-08,8,14,14,0,218,575,574,1,2,0,0,1,122,122,122,122
California,1,2021-12-20,84327,84327,47200,37127,2163224,2163242,1234306,928936,2585,503,503,932,77361,77361,76858,76858
California,2,2021-12-27,242048,242049,151981,90068,1954160,1954178,1192536,761642,3348,496,496,1030,77857,77857,77361,77361
California,3,2022-01-03,550118,550122,369607,180515,2956288,2956324,1966428,989896,6125,592,592,1280,78449,78449,77857,77857
California,4,2022-01-10,867719,867725,620138,247587,4666233,4666300,3353707,1312593,10002,946,946,1813,79395,79395,78449,78449
California,5,2022-01-17,662128,662133,493327,168806,3983918,3983978,3022160,961818,12343,1432,1432,2311,80827,80827,79395,79395
California,6,2022-01-24,527613,527618,412729,114889,3988880,3988959,3193323,795636,12648,1778,1778,2600,82605,82605,80827,80827
California,7,2022-01-31,270362,270363,219720,50643,3154812,3154889,2635996,518893,10873,1907,1907,2494,84512,84512,82605,82605
California,8,2022-02-07,149359,149359,125814,23545,2670231,2670306,2318142,352164,8405,1779,1779,2007,86291,86291,84512,84512
California,9,2022-02-14,85831,85831,74819,11012,2322864,2322938,2079748,243190,6407,1435,1435,1564,87726,87726,86291,86291
California,10,2022-02-21,48089,48089,43061,5028,1850756,1850815,1692062,158753,4557,1007,1007,1098,88733,88733,87726,87726
California,11,2022-02-28,32663,32663,29955,2708,2098633,2098709,1961789,136920,3357,696,696,772,89429,89429,88733,88733
California,12,2022-03-07,22985,22985,21477,1508,1819548,1819623,1725039,94584,2435,500,500,581,89929,89929,89429,89429
California,13,2022-03-14,16989,16989,16112,877,1725421,1725512,1655174,70338,1844,359,359,419,90288,90288,89929,89929
California,14,2022-03-21,14646,14646,14062,584,1646377,1646477,1593774,52703,1537,252,252,313,90540,90540,90288,90288
California,15,2022-03-28,15482,15482,15001,481,1463278,1463378,1425778,37600,1150,180,180,264,90720,90720,90540,90540
California,16,2022-04-04,17687,17687,17270,417,1525053,1525179,1495646,29533,943,141,141,211,90861,90861,90720,90720
California,17,2022-04-11,21522,21522,21129,393,1343288,1343423,1322579,20844,905,124,124,148,90985,90985,90861,90861
California,18,2022-04-18,26884,26884,26494,390,1131688,1131815,1116926,14889,823,113,113,141,91098,91098,90985,90985
California,19,2022-04-25,37285,37285,36857,428,1622778,1623003,1608145,14858,838,93,93,112,91191,91191,91098,91098
California,20,2022-05-02,48975,48976,48541,435,1701814,1702131,1689900,12231,950,85,85,143,91276,91276,91191,91191
California,21,2022-05-09,63383,63388,62943,445,1770535,1770959,1760922,10037,1050,84,84,153,91360,91360,91276,91276
California,22,2022-05-16,80370,80380,79928,452,1840137,1840696,1832448,8248,1345,118,118,182,91478,91478,91360,91360
California,23,2022-05-23,97953,97975,97555,420,1870660,1871439,1864846,6593,1714,117,117,217,91595,91595,91478,91478
California,24,2022-05-30,90623,90647,90337,310,1499309,1500064,1495814,4250,1918,152,152,272,91747,91747,91595,91595
California,25,2022-06-06,120669,120721,120403,318,1939422,1940559,1936462,4097,2305,139,139,276,91886,91886,91747,91747
California,26,2022-06-13,105352,105405,105187,218,1406918,1407868,1405384,2484,2471,181,181,291,92067,92067,91886,91886
California,27,2022-06-20,101515,101572,101410,162,1026931,1027688,1026097,1591,2552,209,209,310,92276,92276,92067,92067
California,28,2022-06-27,115613,115690,115551,139,1044158,1045021,1043769,1252,3006,221,221,339,92497,92497,92276,92276
California,29,2022-07-04,108395,108475,108373,102,837122,837902,837096,806,3167,271,271,393,92768,92768,92497,92497
California,30,2022-07-11,141499,141627,141527,100,1082779,1083896,1083105,791,3824,298,298,453,93066,93066,92768,92768
California,31,2022-07-18,129902,130021,129948,73,993218,994312,993748,564,4148,297,297,528,93363,93363,93066,93066
California,32,2022-07-25,117753,117864,117816,48,948808,949917,949493,424,4310,360,360,516,93723,93723,93363,93363
California,33,2022-08-01,99401,99497,99464,33,875886,876951,876638,313,4119,362,362,535,94085,94085,93723,93723
California,34,2022-08-08,83584,83670,83650,20,825587,826626,826394,232,3754,336,336,474,94421,94421,94085,94085
California,35,2022-08-15,69146,69214,69202,12,794571,795609,795427,182,3363,299,299,448,94720,94720,94421,94421
California,36,2022-08-22,61569,61628,61622,6,778870,779916,779770,146,3087,290,290,418,95010,95010,94720,94720
California,37,2022-08-29,51949,51995,51992,3,769276,770345,770224,121,2752,219,219,351,95229,95229,95010,95010
California,38,2022-09-05,36797,36827,36827,0,631247,632187,632098,89,2525,247,247,350,95476,95476,95229,95229
California,39,2022-09-12,36509,36539,36539,0,755997,757157,757072,85,2422,223,223,346,95699,95699,95476,95476
California,40,2022-09-19,27859,27876,27876,0,690257,691354,691283,71,2041,182,182,272,95881,95881,95699,95699
California,41,2022-09-26,25537,25555,25555,0,641884,642934,642870,64,1818,167,167,230,96048,96048,95881,95881
California,42,2022-10-03,23500,23516,23516,0,588076,589078,589018,60,1647,149,149,247,96197,96197,96048,96048
California,43,2022-10-10,23552,23566,23566,0,628778,629866,629808,58,1537,155,155,228,96334,96334,96179,96179
California,44,2022-10-17,18804,18814,18814,0,524236,525182,525125,57,1397,121,121,218,96455,96455,96334,96334
California,45,2022-10-24,18672,18684,18684,0,514509,515462,515405,57,1324,120,120,190,96575,96575,96455,96455
California,46,2022-10-31,20813,20829,20829,0,523949,524953,524896,57,1401,113,113,191,96688,96688,96575,96575
California,47,2022-11-07,27036,27061,27061,0,548906,550016,549959,57,1525,135,135,231,96823,96823,96688,96688
California,48,2022-11-14,30997,31039,31039,0,550761,551931,551874,57,1775,115,115,260,96938,96938,96823,96823
California,49,2022-11-21,40445,40514,40514,0,576894,578162,578105,57,2268,155,155,330,97093,97093,96938,96938
California,50,2022-11-28,54570,54668,54668,0,518876,520092,520035,57,3153,209,209,379,97302,97302,97093,97093
California,51,2022-12-05,66449,66584,66584,0,659707,661314,661256,58,3715,245,245,493,97547,97547,97302,97302
California,52,2022-12-12,56909,57030,57030,0,622028,623631,623573,58,3944,352,352,527,97899,97899,97547,97547
California,53,2022-12-19,51135,51250,51250,0,575739,577321,577264,57,3997,328,328,523,98227,98227,97899,97899
California,54,2022-12-26,45776,45885,45885,0,421283,422536,422479,57,3906,408,408,510,98635,98635,98227,98227
California,55,2023-01-02,45433,45553,45553,0,425500,426858,426801,57,4077,363,363,528,98998,98998,98635,98635
California,56,2023-01-09,33926,34022,34022,0,507692,509489,509432,57,3672,344,344,487,99342,99342,98998,98998
California,57,2023-01-16,20404,20459,20459,0,411274,412923,412866,57,3075,328,328,425,99670,99670,99342,99342
California,58,2023-01-23,18539,18598,18598,0,453726,455740,455683,57,2400,245,245,369,99915,99915,99670,99670
California,59,2023-01-30,19444,19521,19521,0,420120,422206,422149,57,2214,217,217,266,100132,100132,99915,99915
California,60,2023-02-06,21437,21528,21528,0,405476,407632,407575,57,2231,176,176,280,100308,100308,100132,100132
California,61,2023-02-13,21402,21507,21507,0,385518,387894,387838,56,2223,153,153,287,100461,100461,100308,100308
California,62,2023-02-20,19791,19909,19909,0,346193,348687,348631,56,2159,173,177,292,100634,100638,100461,100461
California,63,2023-02-27,19970,20109,20109,0,382499,385709,385652,57,2220,165,169,310,100799,100807,100634,100638
California,64,2023-03-06,17330,17471,17471,0,348490,351921,351865,56,2074,152,157,262,100951,100964,100799,100807
California,65,2023-03-13,15537,15689,15689,0,333856,337641,337585,56,1939,159,167,278,101110,101131,100951,100964
California,66,2023-03-20,12434,12571,12571,0,305503,309407,309351,56,1701,130,137,237,101240,101268,101110,101131
California,67,2023-03-27,10267,10389,10389,0,286198,290349,290293,56,1498,93,96,196,101333,101364,101240,101268
California,68,2023-04-03,10088,10227,10227,0,267188,271650,271594,56,1363,97,107,176,101430,101471,101333,101364
California,69,2023-04-10,9667,9830,9830,0,247260,252202,252146,56,1312,76,90,173,101506,101561,101430,101471
California,70,2023-04-17,9264,9467,9467,0,248095,254378,254322,56,1316,65,93,149,101571,101654,101506,101561
California,71,2023-04-24,8319,8593,8593,0,235859,244200,244144,56,1278,58,118,148,101629,101772,101571,101654
California,72,2023-05-01,7500,7972,7972,0,197803,210193,210137,56,1149,26,104,133,101655,101876,101629,101772
California,73,2023-05-08,5221,14590,14590,0,104416,251132,251076,56,1057,11,186,131,101666,102062,101655,101876
