county,time,date,cases,est_cases,est_omicron_cases,est_other_cases,tests,est_tests,est_omicron_tests,est_other_tests,hospitalizations,deaths,est_deaths,icu,cum_deaths,cum_est_deaths,prev_cum_deaths,prev_cum_est_deaths
Alameda,1,2021-12-19,2359,2359,1092,1267,89356,89425,40759,48666,52,8,8,16,1543,1543,1535,1535
Amador,1,2021-12-19,45,45,16,29,1654,1654,561,1093,2,1,1,2,70,70,69,69
Butte,1,2021-12-19,162,162,83,79,4458,4461,2264,2197,24,5,5,1,358,358,353,353
Calaveras,1,2021-12-19,54,54,20,34,1683,1683,623,1060,1,2,2,0,92,92,90,90
Colusa,1,2021-12-19,16,16,7,9,472,472,196,276,0,0,0,0,21,21,21,21
Contra Costa,1,2021-12-19,1381,1381,467,914,43044,43076,14310,28766,25,4,4,8,1081,1081,1077,1077
Del Norte,1,2021-12-19,18,18,7,11,1389,1389,558,831,0,0,0,0,42,42,42,42
El Dorado,1,2021-12-19,215,215,81,134,4417,4422,1654,2768,7,4,4,2,177,177,173,173
Fresno,1,2021-12-19,977,977,340,637,25837,25857,8925,16932,128,22,22,45,2419,2419,2397,2397
Glenn,1,2021-12-19,19,19,7,12,450,450,171,279,0,0,0,0,38,38,38,38
Humboldt,1,2021-12-19,146,146,58,88,3640,3641,1435,2206,10,0,0,2,119,119,119,119
Imperial,1,2021-12-19,591,591,220,371,5795,5800,2135,3665,37,12,12,27,816,816,804,804
Inyo,1,2021-12-19,27,27,11,16,357,357,148,209,1,0,0,0,48,48,48,48
Kern,1,2021-12-19,895,895,376,519,28628,28649,11902,16747,91,26,26,29,2020,2020,1994,1994
Kings,1,2021-12-19,236,236,88,148,7308,7313,2702,4611,17,6,6,2,387,387,381,381
Lake,1,2021-12-19,35,35,12,23,1435,1435,489,946,0,0,0,0,116,116,116,116
Lassen,1,2021-12-19,8,8,4,4,2481,2481,1099,1382,0,0,0,0,54,54,54,54
Los Angeles,1,2021-12-19,25506,25525,17497,8028,1037050,1037835,703854,333981,569,109,109,172,27358,27358,27249,27249
Madera,1,2021-12-19,163,163,56,107,6024,6029,2058,3971,10,4,4,4,332,332,328,328
Marin,1,2021-12-19,443,443,159,284,11478,11486,4060,7426,3,1,1,1,256,256,255,255
Mariposa,1,2021-12-19,16,16,5,11,450,450,151,299,0,0,0,0,21,21,21,21
Mendocino,1,2021-12-19,87,87,25,62,2628,2628,746,1882,2,2,2,3,103,103,101,101
Merced,1,2021-12-19,261,261,108,153,5603,5608,2277,3331,9,4,4,13,691,691,687,687
Modoc,1,2021-12-19,4,4,2,2,50,50,21,29,2,0,0,0,6,6,6,6
Mono,1,2021-12-19,30,30,7,23,294,294,74,220,1,0,0,0,4,4,4,4
Monterey,1,2021-12-19,431,431,109,322,13056,13068,3264,9804,24,3,3,5,642,642,639,639
Napa,1,2021-12-19,199,199,89,110,5669,5674,2489,3185,2,1,1,1,108,108,107,107
Nevada,1,2021-12-19,152,152,53,99,2658,2658,920,1738,3,2,2,3,110,110,108,108
Orange,1,2021-12-19,3956,3957,1905,2052,96495,96568,45944,50624,139,32,32,56,5993,5993,5961,5961
Placer,1,2021-12-19,491,491,163,328,11082,11091,3613,7478,52,7,7,27,501,501,494,494
Plumas,1,2021-12-19,17,17,6,11,510,510,186,324,0,0,0,0,12,12,12,12
Riverside,1,2021-12-19,4826,4831,1968,2863,78663,78723,31651,47072,235,41,41,82,5573,5573,5532,5532
Sacramento,1,2021-12-19,1916,1916,743,1173,53702,53743,20612,33131,91,21,21,46,2493,2493,2472,2472
San Benito,1,2021-12-19,87,87,38,49,1955,1955,844,1111,3,1,1,2,79,79,78,78
San Bernardino,1,2021-12-19,4321,4323,1988,2335,78324,78384,35609,42775,286,64,64,117,6495,6495,6431,6431
San Diego,1,2021-12-19,7097,7104,4776,2328,146810,146921,98167,48754,258,30,30,93,4475,4475,4445,4445
San Francisco,1,2021-12-19,2358,2358,564,1794,53077,53117,12466,40651,25,3,3,10,691,691,688,688
San Joaquin,1,2021-12-19,844,844,307,537,25799,25818,9266,16552,51,13,13,27,1969,1969,1956,1956
San Luis Obispo,1,2021-12-19,353,353,150,203,9616,9622,4049,5573,12,3,3,4,370,370,367,367
San Mateo,1,2021-12-19,1210,1210,584,626,49873,49912,23671,26241,8,0,0,5,600,600,600,600
Santa Barbara,1,2021-12-19,640,640,257,383,15628,15640,6185,9455,19,7,7,12,569,569,562,562
Santa Clara,1,2021-12-19,2338,2338,1545,793,121506,121598,79456,42142,85,8,8,40,1976,1976,1968,1968
Santa Cruz,1,2021-12-19,354,354,156,198,21095,21111,9127,11984,10,2,2,6,230,230,228,228
Shasta,1,2021-12-19,155,155,60,95,6017,6022,2300,3722,26,6,6,9,446,446,440,440
Siskiyou,1,2021-12-19,17,17,8,9,476,476,213,263,4,1,1,0,62,62,61,61
Solano,1,2021-12-19,440,440,178,262,14697,14709,5876,8833,19,4,4,6,388,388,384,384
Sonoma,1,2021-12-19,660,660,273,387,21228,21244,8622,12622,27,1,1,3,419,419,418,418
Stanislaus,1,2021-12-19,632,632,192,440,13642,13653,4084,9569,91,11,11,22,1428,1428,1417,1417
Sutter,1,2021-12-19,94,94,38,56,2207,2207,877,1330,0,2,2,0,193,193,191,191
Tehama,1,2021-12-19,55,55,17,38,1327,1327,411,916,5,2,2,3,165,165,163,163
Trinity,1,2021-12-19,3,3,1,2,106,106,32,74,0,0,0,0,18,18,18,18
Tulare,1,2021-12-19,387,387,115,272,12498,12507,3683,8824,38,17,17,13,1306,1306,1289,1289
Tuolumne,1,2021-12-19,97,97,34,63,1960,1960,678,1282,6,0,0,1,153,153,153,153
Ventura,1,2021-12-19,1659,1659,833,826,38670,38699,19131,19568,67,9,9,13,1216,1216,1207,1207
Yolo,1,2021-12-19,285,285,123,162,25324,25342,10852,14490,4,0,0,1,270,270,270,270
Yuba,1,2021-12-19,97,97,40,57,1884,1884,780,1104,4,0,0,4,101,101,101,101
Alameda,2,2021-12-26,6205,6212,3247,2965,84848,84919,43805,41114,73,12,12,17,1555,1555,1543,1543
Amador,2,2021-12-26,88,88,36,52,1505,1505,594,911,2,0,0,2,70,70,70,70
Butte,2,2021-12-26,441,441,255,186,4141,4145,2357,1788,35,3,3,3,361,361,358,358
Calaveras,2,2021-12-26,94,94,41,53,999,999,428,571,1,1,1,1,93,93,92,92
Colusa,2,2021-12-26,16,16,8,8,236,236,112,124,2,0,0,0,21,21,21,21
Contra Costa,2,2021-12-26,3863,3866,1529,2337,44460,44497,17284,27213,37,2,2,15,1083,1083,1081,1081
Del Norte,2,2021-12-26,24,24,11,13,1246,1246,574,672,0,0,0,0,42,42,42,42
El Dorado,2,2021-12-26,416,416,182,234,4197,4201,1810,2391,6,1,1,4,178,178,177,177
Fresno,2,2021-12-26,1735,1735,710,1025,23036,23057,9282,13775,121,15,15,40,2434,2434,2419,2419
Glenn,2,2021-12-26,45,45,20,25,444,444,194,250,0,0,0,0,38,38,38,38
Humboldt,2,2021-12-26,400,400,185,215,3247,3250,1468,1782,9,2,2,0,121,121,119,119
Imperial,2,2021-12-26,708,708,307,401,5474,5478,2340,3138,29,11,11,26,827,827,816,816
Inyo,2,2021-12-26,94,94,46,48,411,411,194,217,0,2,2,0,50,50,48,48
Kern,2,2021-12-26,1462,1462,710,752,20572,20591,9846,10745,72,17,17,32,2037,2037,2020,2020
Kings,2,2021-12-26,410,410,180,230,5350,5354,2292,3062,15,1,1,4,388,388,387,387
Lake,2,2021-12-26,54,54,22,32,1154,1154,459,695,0,1,1,0,117,117,116,116
Lassen,2,2021-12-26,19,19,10,9,2325,2325,1171,1154,0,0,0,0,54,54,54,54
Los Angeles,2,2021-12-26,75165,75227,55236,19991,684359,684933,499762,185171,766,104,104,200,27462,27462,27358,27358
Madera,2,2021-12-26,247,247,101,146,4227,4231,1684,2547,6,1,1,5,333,333,332,332
Marin,2,2021-12-26,1404,1404,586,818,15717,15730,6480,9250,3,0,0,1,256,256,256,256
Mariposa,2,2021-12-26,36,36,14,22,505,505,196,309,0,0,0,0,21,21,21,21
Mendocino,2,2021-12-26,118,118,41,77,2485,2486,828,1658,3,1,1,3,104,104,103,103
Merced,2,2021-12-26,495,495,235,260,4938,4942,2302,2640,0,8,8,2,699,699,691,691
Modoc,2,2021-12-26,3,3,1,2,58,58,28,30,3,0,0,0,6,6,6,6
Mono,2,2021-12-26,108,108,33,75,366,366,108,258,1,0,0,0,4,4,4,4
Monterey,2,2021-12-26,831,831,254,577,12611,12621,3759,8862,25,2,2,11,644,644,642,642
Napa,2,2021-12-26,649,649,330,319,5738,5743,2882,2861,5,0,0,1,108,108,108,108
Nevada,2,2021-12-26,212,212,87,125,2535,2536,1014,1522,4,1,1,2,111,111,110,110
Orange,2,2021-12-26,13060,13071,7109,5962,114343,114440,61520,52920,216,32,32,66,6025,6025,5993,5993
Placer,2,2021-12-26,1003,1003,390,613,10362,10372,3947,6425,60,1,1,25,502,502,501,501
Plumas,2,2021-12-26,13,13,6,7,399,399,167,232,0,0,0,0,12,12,12,12
Riverside,2,2021-12-26,10948,10957,5137,5820,80341,80409,37164,43245,283,47,47,88,5620,5620,5573,5573
Sacramento,2,2021-12-26,3962,3965,1785,2180,49200,49242,21779,27463,122,16,16,43,2509,2509,2493,2493
San Benito,2,2021-12-26,253,253,127,126,2207,2207,1092,1115,1,3,3,3,82,82,79,79
San Bernardino,2,2021-12-26,10829,10837,5669,5168,82284,82353,42359,39994,311,72,72,127,6567,6567,6495,6495
San Diego,2,2021-12-26,20586,20604,14910,5694,164508,164646,118437,46209,292,32,32,92,4507,4507,4475,4475
San Francisco,2,2021-12-26,6155,6161,1746,4415,64251,64306,17978,46328,30,1,1,11,692,692,691,691
San Joaquin,2,2021-12-26,1806,1806,770,1036,21531,21550,9009,12541,53,18,18,25,1987,1987,1969,1969
San Luis Obispo,2,2021-12-26,829,829,405,424,10350,10360,4977,5383,14,1,1,8,371,371,370,370
San Mateo,2,2021-12-26,4339,4342,2362,1980,53193,53237,28539,24698,14,2,2,7,602,602,600,600
Santa Barbara,2,2021-12-26,1688,1688,782,906,14421,14431,6562,7869,28,4,4,11,573,573,569,569
Santa Clara,2,2021-12-26,7199,7206,5139,2067,100092,100176,70797,29379,84,10,10,34,1986,1986,1976,1976
Santa Cruz,2,2021-12-26,761,761,384,377,11966,11976,5894,6082,12,0,0,2,230,230,230,230
Shasta,2,2021-12-26,216,216,98,118,4658,4661,2051,2610,28,7,7,12,453,453,446,446
Siskiyou,2,2021-12-26,16,16,8,8,356,356,182,174,0,1,1,0,63,63,62,62
Solano,2,2021-12-26,917,917,427,490,15720,15732,7241,8491,26,3,3,3,391,391,388,388
Sonoma,2,2021-12-26,1600,1600,763,837,20134,20150,9421,10729,15,0,0,5,419,419,419,419
Stanislaus,2,2021-12-26,1016,1016,368,648,10797,10806,3837,6969,88,17,17,16,1445,1445,1428,1428
Sutter,2,2021-12-26,200,200,93,107,2066,2066,944,1122,0,2,2,0,195,195,193,193
Tehama,2,2021-12-26,78,78,29,49,1078,1078,392,686,9,0,0,2,165,165,165,165
Trinity,2,2021-12-26,4,4,2,2,96,96,35,61,0,1,1,0,19,19,18,18
Tulare,2,2021-12-26,657,657,235,422,10621,10629,3694,6935,37,13,13,9,1319,1319,1306,1306
Tuolumne,2,2021-12-26,150,150,62,88,1774,1774,715,1059,5,0,0,1,153,153,153,153
Ventura,2,2021-12-26,4466,4469,2525,1944,36826,36857,20519,16338,61,7,7,17,1223,1223,1216,1216
Yolo,2,2021-12-26,615,615,304,311,18964,18979,9182,9797,5,0,0,2,270,270,270,270
Yuba,2,2021-12-26,130,130,63,67,1521,1521,719,802,8,1,1,3,102,102,101,101
Alameda,3,2022-01-02,15073,15087,8765,6322,105276,105376,60979,44397,144,7,7,29,1562,1562,1555,1555
Amador,3,2022-01-02,166,166,77,89,1892,1892,867,1025,4,1,1,2,71,71,70,70
Butte,3,2022-01-02,1015,1015,645,370,6160,6166,3882,2284,27,1,1,6,362,362,361,361
Calaveras,3,2022-01-02,185,185,93,92,1144,1144,563,581,1,1,1,1,94,94,93,93
Colusa,3,2022-01-02,52,52,28,24,320,320,172,148,5,0,0,0,21,21,21,21
Contra Costa,3,2022-01-02,11672,11683,5278,6405,60918,60976,27414,33562,69,9,9,22,1092,1092,1083,1083
Del Norte,3,2022-01-02,59,59,31,28,2007,2007,1045,962,0,0,0,0,42,42,42,42
El Dorado,3,2022-01-02,1099,1099,548,551,5471,5476,2710,2766,12,4,4,5,182,182,178,178
Fresno,3,2022-01-02,5386,5392,2519,2873,35850,35883,16671,19212,155,12,12,38,2446,2446,2434,2434
Glenn,3,2022-01-02,69,69,35,34,551,551,275,276,0,0,0,0,38,38,38,38
Humboldt,3,2022-01-02,781,781,406,375,4858,4863,2508,2355,8,0,0,3,121,121,121,121
Imperial,3,2022-01-02,1523,1523,748,775,8289,8297,4057,4240,28,12,12,30,839,839,827,827
Inyo,3,2022-01-02,219,219,119,100,612,612,327,285,2,0,0,0,50,50,50,50
Kern,3,2022-01-02,4641,4647,2535,2112,30746,30775,16630,14145,90,15,15,34,2052,2052,2037,2037
Kings,3,2022-01-02,924,924,460,464,7678,7686,3778,3908,12,3,3,2,391,391,388,388
Lake,3,2022-01-02,171,171,80,91,1494,1494,687,807,1,0,0,1,117,117,117,117
Lassen,3,2022-01-02,51,51,29,22,2662,2662,1503,1159,2,0,0,0,54,54,54,54
Los Angeles,3,2022-01-02,182661,182836,142153,40683,948825,949725,737920,211805,1716,137,137,278,27599,27599,27462,27462
Madera,3,2022-01-02,698,698,324,374,5830,5835,2684,3151,14,3,3,4,336,336,333,333
Marin,3,2022-01-02,2182,2182,1031,1151,17069,17085,8026,9059,18,1,1,1,257,257,256,256
Mariposa,3,2022-01-02,78,78,36,42,538,538,242,296,0,0,0,0,21,21,21,21
Mendocino,3,2022-01-02,379,379,151,228,3178,3181,1253,1928,8,0,0,2,104,104,104,104
Merced,3,2022-01-02,1256,1256,668,588,7490,7495,3966,3529,13,8,8,13,707,707,699,699
Modoc,3,2022-01-02,14,14,8,6,52,52,28,24,0,0,0,0,6,6,6,6
Mono,3,2022-01-02,177,177,62,115,396,396,138,258,1,0,0,0,4,4,4,4
Monterey,3,2022-01-02,2115,2115,755,1360,18467,18483,6553,11930,26,5,5,10,649,649,644,644
Napa,3,2022-01-02,1553,1553,878,675,10208,10217,5743,4474,8,1,1,3,109,109,108,108
Nevada,3,2022-01-02,518,518,245,273,2244,2246,1052,1194,4,1,1,4,112,112,111,111
Orange,3,2022-01-02,40797,40835,24456,16379,202379,202570,121037,81533,441,31,31,104,6056,6056,6025,6025
Placer,3,2022-01-02,2494,2494,1112,1382,14250,14264,6295,7969,104,14,14,25,516,516,502,502
Plumas,3,2022-01-02,46,46,23,23,363,363,176,187,1,0,0,0,12,12,12,12
Riverside,3,2022-01-02,27874,27901,14705,13196,128327,128450,67371,61079,494,57,57,101,5677,5677,5620,5620
Sacramento,3,2022-01-02,11759,11770,5980,5790,73369,73439,37091,36348,206,27,27,61,2536,2536,2509,2509
San Benito,3,2022-01-02,645,645,361,284,3145,3148,1755,1393,3,3,3,3,85,85,82,82
San Bernardino,3,2022-01-02,30519,30548,17690,12858,125488,125608,72448,53160,514,87,87,141,6654,6654,6567,6567
San Diego,3,2022-01-02,55040,55091,42293,12798,235541,235764,180859,54905,542,32,32,122,4539,4539,4507,4507
San Francisco,3,2022-01-02,10065,10075,3380,6695,76786,76858,25605,51253,78,5,5,18,697,697,692,692
San Joaquin,3,2022-01-02,5900,5907,2868,3039,33051,33083,15915,17168,66,9,9,26,1996,1996,1987,1987
San Luis Obispo,3,2022-01-02,2182,2182,1188,994,14872,14886,8081,6805,16,6,6,6,377,377,371,371
San Mateo,3,2022-01-02,9463,9472,5688,3784,71281,71349,42693,28656,28,4,4,8,606,606,602,602
Santa Barbara,3,2022-01-02,4564,4569,2385,2184,24551,24575,12788,11787,49,7,7,8,580,580,573,573
Santa Clara,3,2022-01-02,19226,19244,14616,4628,140547,140681,106466,34215,169,8,8,56,1994,1994,1986,1986
Santa Cruz,3,2022-01-02,2020,2020,1138,882,16687,16702,9322,7380,18,4,4,4,234,234,230,230
Shasta,3,2022-01-02,488,488,251,237,5597,5601,2825,2776,30,1,1,13,454,454,453,453
Siskiyou,3,2022-01-02,57,57,33,24,460,460,263,197,0,0,0,0,63,63,63,63
Solano,3,2022-01-02,3626,3629,1899,1730,24330,24353,12706,11647,57,3,3,9,394,394,391,391
Sonoma,3,2022-01-02,3717,3720,1980,1740,28212,28240,14948,13292,26,7,7,3,426,426,419,419
Stanislaus,3,2022-01-02,2850,2850,1193,1657,16392,16408,6801,9607,111,9,9,19,1454,1454,1445,1445
Sutter,3,2022-01-02,439,439,231,208,2723,2723,1417,1306,0,2,2,0,197,197,195,195
Tehama,3,2022-01-02,181,181,78,103,1213,1213,513,700,1,3,3,2,168,168,165,165
Trinity,3,2022-01-02,11,11,5,6,100,100,42,58,0,0,0,0,19,19,19,19
Tulare,3,2022-01-02,1718,1718,711,1007,14920,14933,6078,8855,52,5,5,7,1324,1324,1319,1319
Tuolumne,3,2022-01-02,314,314,148,166,1968,1968,918,1050,6,1,1,0,154,154,153,153
Ventura,3,2022-01-02,11578,11589,7170,4419,55416,55469,34178,21291,120,9,9,33,1232,1232,1223,1223
Yolo,3,2022-01-02,1933,1933,1076,857,30071,30099,16561,13538,5,3,3,3,273,273,270,270
Yuba,3,2022-01-02,399,399,217,182,2113,2113,1134,979,18,1,1,6,103,103,102,102
Alameda,4,2022-01-09,30886,30919,19780,11139,191286,191485,122390,69095,277,13,13,45,1575,1575,1562,1562
Amador,4,2022-01-09,371,371,194,177,2750,2753,1425,1328,4,0,0,4,71,71,71,71
Butte,4,2022-01-09,1948,1948,1340,608,10291,10302,7065,3237,43,2,2,5,364,364,362,362
Calaveras,4,2022-01-09,463,463,259,204,2460,2462,1365,1097,0,1,1,2,95,95,94,94
Colusa,4,2022-01-09,82,82,50,32,679,679,405,274,5,0,0,0,21,21,21,21
Contra Costa,4,2022-01-09,20089,20110,10328,9782,102889,102997,52793,50204,144,12,12,23,1104,1104,1092,1092
Del Norte,4,2022-01-09,171,171,100,71,3830,3834,2251,1583,1,0,0,0,42,42,42,42
El Dorado,4,2022-01-09,2171,2171,1214,957,9000,9011,5025,3986,16,6,6,2,188,188,182,182
Fresno,4,2022-01-09,12267,12279,6506,5773,58182,58243,30770,27473,258,15,15,47,2461,2461,2446,2446
Glenn,4,2022-01-09,181,181,103,78,897,897,505,392,2,1,1,0,39,39,38,38
Humboldt,4,2022-01-09,1398,1398,811,587,8303,8312,4812,3500,14,6,6,2,127,127,121,121
Imperial,4,2022-01-09,3444,3449,1904,1545,13674,13690,7546,6144,49,12,12,24,851,851,839,839
Inyo,4,2022-01-09,375,375,223,152,1238,1238,737,501,3,1,1,0,51,51,50,50
Kern,4,2022-01-09,11400,11412,6890,4522,55743,55802,33551,22251,170,23,23,29,2075,2075,2052,2052
Kings,4,2022-01-09,2060,2060,1151,909,12175,12188,6770,5418,26,1,1,3,392,392,391,391
Lake,4,2022-01-09,459,459,241,218,2700,2703,1409,1294,0,3,3,2,120,120,117,117
Lassen,4,2022-01-09,146,146,92,54,3520,3523,2189,1334,2,0,0,0,54,54,54,54
Los Angeles,4,2022-01-09,331965,332312,271709,60603,1898758,1900737,1553788,346949,2990,266,266,482,27865,27865,27599,27599
Madera,4,2022-01-09,1782,1782,939,843,10201,10213,5345,4868,22,2,2,6,338,338,336,336
Marin,4,2022-01-09,3053,3055,1633,1422,21418,21441,11444,9997,18,2,2,5,259,259,257,257
Mariposa,4,2022-01-09,180,180,92,88,1101,1101,565,536,0,1,1,0,22,22,21,21
Mendocino,4,2022-01-09,790,790,361,429,5299,5304,2408,2896,4,3,3,3,107,107,104,104
Merced,4,2022-01-09,3344,3349,1986,1363,13786,13802,8167,5635,33,11,11,12,718,718,707,707
Modoc,4,2022-01-09,13,13,8,5,98,98,59,39,0,0,0,0,6,6,6,6
Mono,4,2022-01-09,247,247,101,146,825,825,338,487,1,1,1,0,5,5,4,4
Monterey,4,2022-01-09,4538,4543,1881,2662,31866,31899,13158,18741,42,4,4,10,653,653,649,649
Napa,4,2022-01-09,2695,2698,1682,1016,14968,14985,9320,5665,16,1,1,1,110,110,109,109
Nevada,4,2022-01-09,1119,1119,595,524,4917,4922,2597,2325,10,2,2,3,114,114,112,112
Orange,4,2022-01-09,61036,61099,40083,21016,311104,311428,204253,107175,824,88,88,140,6144,6144,6056,6056
Placer,4,2022-01-09,4956,4962,2518,2444,21510,21533,10879,10654,163,8,8,26,524,524,516,516
Plumas,4,2022-01-09,119,119,65,54,784,784,425,359,4,0,0,0,12,12,12,12
Riverside,4,2022-01-09,47600,47651,27969,19682,184727,184919,108452,76467,749,77,77,137,5754,5754,5677,5677
Sacramento,4,2022-01-09,26759,26786,15230,11556,120339,120465,68357,52108,354,35,35,72,2571,2571,2536,2536
San Benito,4,2022-01-09,1031,1031,639,392,4477,4483,2774,1709,4,0,0,2,85,85,85,85
San Bernardino,4,2022-01-09,50293,50344,32139,18205,190040,190238,121322,68916,760,108,108,177,6762,6762,6654,6654
San Diego,4,2022-01-09,84680,84768,68539,16229,337741,338094,273391,64703,820,48,48,168,4587,4587,4539,4539
San Francisco,4,2022-01-09,16144,16161,6316,9845,120654,120779,47192,73587,148,12,12,30,709,709,697,697
San Joaquin,4,2022-01-09,13240,13253,7235,6018,61379,61443,33460,27983,117,18,18,39,2014,2014,1996,1996
San Luis Obispo,4,2022-01-09,4264,4269,2589,1680,21462,21485,13008,8477,29,2,2,8,379,379,377,377
San Mateo,4,2022-01-09,15037,15053,9885,5168,113224,113344,74301,39043,96,4,4,14,610,610,606,606
Santa Barbara,4,2022-01-09,8282,8291,4815,3476,45241,45288,26299,18989,77,7,7,10,587,587,580,580
Santa Clara,4,2022-01-09,35005,35040,28034,7006,262903,263176,210375,52801,339,25,25,66,2019,2019,1994,1994
Santa Cruz,4,2022-01-09,4458,4464,2771,1693,41636,41678,25758,15920,20,3,3,2,237,237,234,234
Shasta,4,2022-01-09,1007,1007,575,432,8272,8279,4695,3584,34,8,8,12,462,462,454,454
Siskiyou,4,2022-01-09,116,116,73,43,887,887,557,330,5,1,1,1,64,64,63,63
Solano,4,2022-01-09,6699,6705,3933,2772,36575,36612,21437,15175,81,5,5,11,399,399,394,394
Sonoma,4,2022-01-09,8505,8514,5040,3474,46460,46508,27464,19044,69,9,9,7,435,435,426,426
Stanislaus,4,2022-01-09,6218,6225,2982,3243,27473,27501,13111,14390,154,13,13,24,1467,1467,1454,1454
Sutter,4,2022-01-09,1132,1132,662,470,4711,4716,2743,1973,0,1,1,0,198,198,197,197
Tehama,4,2022-01-09,458,458,224,234,2419,2420,1175,1245,11,1,1,1,169,169,168,168
Trinity,4,2022-01-09,36,36,18,18,266,266,128,138,0,0,0,0,19,19,19,19
Tulare,4,2022-01-09,4448,4453,2110,2343,22641,22664,10661,12003,56,8,8,10,1332,1332,1324,1324
Tuolumne,4,2022-01-09,753,753,400,353,4114,4119,2170,1949,13,3,3,2,157,157,154,154
Ventura,4,2022-01-09,17376,17394,11734,5660,86506,86596,58342,28254,218,21,21,30,1253,1253,1232,1232
Yolo,4,2022-01-09,3853,3858,2364,1494,49045,49098,30058,19040,6,2,2,2,275,275,273,273
Yuba,4,2022-01-09,948,948,570,378,3881,3886,2327,1559,37,0,0,9,103,103,103,103
Alameda,5,2022-01-16,26444,26474,18373,8101,183759,183962,127626,56336,357,29,29,58,1604,1604,1575,1575
Amador,5,2022-01-16,491,491,286,205,3795,3799,2196,1603,8,2,2,4,73,73,71,71
Butte,5,2022-01-16,2110,2110,1556,554,9802,9813,7216,2597,57,3,3,3,367,367,364,364
Calaveras,5,2022-01-16,593,593,364,229,2704,2707,1662,1045,3,2,2,3,97,97,95,95
Colusa,5,2022-01-16,173,173,114,59,842,842,550,292,3,0,0,0,21,21,21,21
Contra Costa,5,2022-01-16,17109,17127,9848,7279,95158,95263,54670,40593,198,22,22,44,1126,1126,1104,1104
Del Norte,5,2022-01-16,197,197,127,70,3948,3952,2521,1431,3,0,0,0,42,42,42,42
El Dorado,5,2022-01-16,2092,2093,1289,804,8802,8812,5426,3386,12,4,4,2,192,192,188,188
Fresno,5,2022-01-16,16824,16842,9932,6910,68117,68192,40153,28039,354,26,26,68,2487,2487,2461,2461
Glenn,5,2022-01-16,307,307,191,116,1104,1104,686,418,1,1,1,0,40,40,39,39
Humboldt,5,2022-01-16,1240,1240,790,450,8847,8858,5641,3217,9,0,0,6,127,127,127,127
Imperial,5,2022-01-16,3671,3676,2245,1431,14111,14127,8629,5498,64,10,10,28,861,861,851,851
Inyo,5,2022-01-16,393,393,256,137,1233,1233,802,431,2,1,1,0,52,52,51,51
Kern,5,2022-01-16,12871,12886,8498,4388,58697,58760,38649,20111,240,27,27,39,2102,2102,2075,2075
Kings,5,2022-01-16,3496,3501,2156,1345,16617,16635,10232,6403,41,3,3,2,395,395,392,392
Lake,5,2022-01-16,590,590,345,245,3178,3182,1858,1324,1,0,0,2,120,120,120,120
Lassen,5,2022-01-16,303,303,206,97,3788,3792,2568,1224,1,0,0,0,54,54,54,54
Los Angeles,5,2022-01-16,243089,243358,207101,36257,1775426,1777381,1512473,264908,3943,468,468,621,28333,28333,27865,27865
Madera,5,2022-01-16,2404,2405,1412,993,11033,11046,6459,4587,30,5,5,6,343,343,338,338
Marin,5,2022-01-16,2577,2579,1534,1045,18912,18933,11250,7683,38,4,4,4,263,263,259,259
Mariposa,5,2022-01-16,186,186,106,80,1216,1216,697,519,0,0,0,0,22,22,22,22
Mendocino,5,2022-01-16,981,981,507,474,5559,5565,2865,2700,18,3,3,3,110,110,107,107
Merced,5,2022-01-16,4205,4210,2734,1476,14902,14920,9684,5236,38,19,19,12,737,737,718,718
Modoc,5,2022-01-16,12,12,8,4,110,110,73,37,0,1,1,0,7,7,6,6
Mono,5,2022-01-16,229,229,107,122,880,880,415,465,1,0,0,0,5,5,5,5
Monterey,5,2022-01-16,6195,6202,2948,3254,30230,30263,14324,15939,58,7,7,13,660,660,653,653
Napa,5,2022-01-16,2160,2161,1467,694,13267,13282,9003,4279,18,2,2,5,112,112,110,110
Nevada,5,2022-01-16,1292,1292,762,530,5656,5661,3325,2336,21,1,1,1,115,115,114,114
Orange,5,2022-01-16,45882,45931,32558,13373,278318,278625,197377,81248,1012,113,113,188,6257,6257,6144,6144
Placer,5,2022-01-16,4613,4618,2615,2003,20996,21019,11874,9145,180,13,13,35,537,537,524,524
Plumas,5,2022-01-16,197,197,119,78,810,810,486,324,4,0,0,0,12,12,12,12
Riverside,5,2022-01-16,44695,44745,28842,15903,180832,181031,116689,64342,871,90,90,152,5844,5844,5754,5754
Sacramento,5,2022-01-16,23247,23272,14587,8685,111507,111630,69895,41735,451,57,57,96,2628,2628,2571,2571
San Benito,5,2022-01-16,879,879,593,286,4231,4236,2853,1383,5,2,2,3,87,87,85,85
San Bernardino,5,2022-01-16,42952,43000,29757,13243,180936,181137,125388,55749,909,136,136,217,6898,6898,6762,6762
San Diego,5,2022-01-16,66274,66346,55988,10358,284530,284844,240429,44415,1067,105,105,189,4692,4692,4587,4587
San Francisco,5,2022-01-16,11600,11612,5258,6354,99489,99598,44956,54642,204,14,14,45,723,723,709,709
San Joaquin,5,2022-01-16,13901,13917,8396,5521,63481,63552,38323,25229,194,20,20,55,2034,2034,2014,2014
San Luis Obispo,5,2022-01-16,4081,4086,2709,1377,22332,22358,14808,7550,38,11,11,8,390,390,379,379
San Mateo,5,2022-01-16,13451,13466,9547,3919,105667,105783,74894,30889,95,10,10,22,620,620,610,610
Santa Barbara,5,2022-01-16,7506,7514,4797,2717,44208,44257,28229,16028,118,11,11,10,598,598,587,587
Santa Clara,5,2022-01-16,30751,30786,25742,5044,250026,250301,209175,41126,437,25,25,78,2044,2044,2019,2019
Santa Cruz,5,2022-01-16,4298,4303,2912,1391,46052,46103,31129,14974,28,3,3,3,240,240,237,237
Shasta,5,2022-01-16,1327,1327,836,491,9667,9677,6065,3612,63,6,6,13,468,468,462,462
Siskiyou,5,2022-01-16,159,159,109,50,1026,1026,698,328,3,1,1,2,65,65,64,64
Solano,5,2022-01-16,6905,6912,4460,2452,37987,38028,24511,13517,103,8,8,21,407,407,399,399
Sonoma,5,2022-01-16,8216,8226,5343,2883,47043,47096,30537,16559,74,8,8,14,443,443,435,435
Stanislaus,5,2022-01-16,7610,7618,4103,3515,30691,30726,16501,14225,200,9,9,31,1476,1476,1467,1467
Sutter,5,2022-01-16,1340,1340,857,483,5100,5105,3259,1846,0,5,5,0,203,203,198,198
Tehama,5,2022-01-16,646,646,355,291,2650,2652,1449,1203,15,4,4,2,173,173,169,169
Trinity,5,2022-01-16,40,40,22,18,268,268,145,123,0,1,1,0,20,20,19,19
Tulare,5,2022-01-16,7570,7579,4041,3538,28098,28128,14946,13182,88,15,15,15,1347,1347,1332,1332
Tuolumne,5,2022-01-16,937,937,554,383,4352,4357,2559,1798,9,8,8,1,165,165,157,157
Ventura,5,2022-01-16,13451,13465,9761,3704,74965,75048,54350,20698,285,38,38,52,1291,1291,1253,1253
Yolo,5,2022-01-16,3033,3036,2028,1008,42821,42868,28657,14211,13,5,5,4,280,280,275,275
Yuba,5,2022-01-16,1082,1082,709,373,3970,3974,2600,1374,39,1,1,5,104,104,103,103
Alameda,6,2022-01-23,20231,20255,15072,5183,160740,160928,119829,41099,381,39,39,61,1643,1643,1604,1604
Amador,6,2022-01-23,562,562,360,202,4356,4360,2792,1568,7,0,0,5,73,73,73,73
Butte,6,2022-01-23,1954,1954,1527,427,9131,9142,7141,2001,79,12,12,12,379,379,367,367
Calaveras,6,2022-01-23,592,592,398,194,2429,2430,1631,799,5,1,1,2,98,98,97,97
Colusa,6,2022-01-23,170,170,121,49,864,864,612,252,5,0,0,0,21,21,21,21
Contra Costa,6,2022-01-23,13356,13370,8480,4890,81051,81145,51480,29665,227,25,25,65,1151,1151,1126,1126
Del Norte,6,2022-01-23,321,321,224,97,3885,3889,2697,1192,4,0,0,1,42,42,42,42
El Dorado,6,2022-01-23,1504,1504,1013,491,7147,7154,4818,2336,14,1,1,5,193,193,192,192
Fresno,6,2022-01-23,17591,17611,11393,6218,67403,67483,43674,23809,485,37,37,83,2524,2524,2487,2487
Glenn,6,2022-01-23,259,259,176,83,976,976,661,315,0,1,1,0,41,41,40,40
Humboldt,6,2022-01-23,940,940,651,289,7219,7228,5006,2222,23,3,3,4,130,130,127,127
Imperial,6,2022-01-23,3583,3588,2404,1184,12924,12941,8664,4277,60,17,17,32,878,878,861,861
Inyo,6,2022-01-23,152,152,107,45,616,616,434,182,1,1,1,0,53,53,52,52
Kern,6,2022-01-23,10465,10477,7477,3000,50383,50442,35968,14474,256,51,51,53,2153,2153,2102,2102
Kings,6,2022-01-23,4039,4043,2719,1324,16902,16921,11385,5536,38,5,5,5,400,400,395,395
Lake,6,2022-01-23,680,680,437,243,3155,3159,2019,1140,5,2,2,3,122,122,120,120
Lassen,6,2022-01-23,414,414,302,112,3660,3665,2674,991,1,0,0,0,54,54,54,54
Los Angeles,6,2022-01-23,167614,167811,147682,20129,1520395,1522179,1339972,182207,3779,604,604,794,28937,28937,28333,28333
Madera,6,2022-01-23,2719,2721,1754,967,11566,11581,7453,4128,45,7,7,12,350,350,343,343
Marin,6,2022-01-23,1895,1895,1237,658,16847,16868,11013,5855,40,5,5,13,268,268,263,263
Mariposa,6,2022-01-23,146,146,92,54,936,936,592,344,0,0,0,0,22,22,22,22
Mendocino,6,2022-01-23,939,939,542,397,4765,4770,2754,2016,20,1,1,3,111,111,110,110
Merced,6,2022-01-23,3167,3172,2234,938,12370,12384,8724,3660,53,9,9,10,746,746,737,737
Modoc,6,2022-01-23,15,15,11,4,104,104,74,30,2,0,0,0,7,7,7,7
Mono,6,2022-01-23,93,93,50,43,441,441,235,206,1,0,0,0,5,5,5,5
Monterey,6,2022-01-23,5006,5012,2684,2328,30653,30689,16436,14253,71,8,8,20,668,668,660,660
Napa,6,2022-01-23,1679,1679,1229,450,11838,11853,8667,3186,16,4,4,6,116,116,112,112
Nevada,6,2022-01-23,1051,1051,682,369,4762,4767,3080,1687,23,1,1,7,116,116,115,115
Orange,6,2022-01-23,28934,28968,21949,7019,224067,224331,170076,54255,967,170,170,195,6427,6427,6257,6257
Placer,6,2022-01-23,3794,3799,2381,1418,18238,18260,11428,6832,206,7,7,47,544,544,537,537
Plumas,6,2022-01-23,216,216,142,74,884,884,580,304,6,0,0,0,12,12,12,12
Riverside,6,2022-01-23,32950,32988,23084,9904,155273,155456,108828,46628,891,128,128,174,5972,5972,5844,5844
Sacramento,6,2022-01-23,17792,17813,12177,5636,95291,95403,65209,30194,513,67,67,110,2695,2695,2628,2628
San Benito,6,2022-01-23,812,812,589,223,3913,3918,2845,1073,5,1,1,3,88,88,87,87
San Bernardino,6,2022-01-23,28569,28603,21259,7344,146172,146343,108802,37541,966,169,169,216,7067,7067,6898,6898
San Diego,6,2022-01-23,52537,52598,45976,6622,243959,244245,213600,30645,1070,120,120,227,4812,4812,4692,4692
San Francisco,6,2022-01-23,8550,8561,4395,4166,85883,85984,44159,41825,239,15,15,39,738,738,723,723
San Joaquin,6,2022-01-23,11135,11148,7373,3775,55755,55820,36907,18913,231,33,33,66,2067,2067,2034,2034
San Luis Obispo,6,2022-01-23,3523,3528,2524,1004,20458,20483,14664,5819,42,11,11,10,401,401,390,390
San Mateo,6,2022-01-23,8900,8911,6748,2163,89950,90055,68233,21822,122,16,16,31,636,636,620,620
Santa Barbara,6,2022-01-23,6387,6395,4440,1955,41078,41126,28546,12580,122,15,15,17,613,613,598,598
Santa Clara,6,2022-01-23,22808,22834,19818,3016,218206,218463,189580,28883,458,49,49,94,2093,2093,2044,2044
Santa Cruz,6,2022-01-23,5136,5143,3754,1389,46346,46401,33902,12499,37,1,1,2,241,241,240,240
Shasta,6,2022-01-23,1458,1458,998,460,9461,9472,6470,3002,65,5,5,10,473,473,468,468
Siskiyou,6,2022-01-23,163,163,120,43,832,832,609,223,5,3,3,1,68,68,65,65
Solano,6,2022-01-23,4992,4997,3497,1500,30866,30903,21619,9284,140,12,12,26,419,419,407,407
Sonoma,6,2022-01-23,7038,7047,4965,2082,40957,41006,28871,12135,91,7,7,15,450,450,443,443
Stanislaus,6,2022-01-23,6565,6573,3939,2634,27609,27641,16549,11092,270,27,27,39,1503,1503,1476,1476
Sutter,6,2022-01-23,1086,1086,755,331,4981,4986,3462,1524,0,2,2,0,205,205,203,203
Tehama,6,2022-01-23,565,565,344,221,2460,2463,1498,965,14,5,5,5,178,178,173,173
Trinity,6,2022-01-23,65,65,39,26,316,316,191,125,0,0,0,0,20,20,20,20
Tulare,6,2022-01-23,7704,7714,4578,3136,28276,28309,16780,11529,119,10,10,14,1357,1357,1347,1347
Tuolumne,6,2022-01-23,864,864,561,303,3500,3504,2267,1237,16,2,2,3,167,167,165,165
Ventura,6,2022-01-23,9805,9817,7588,2229,64829,64904,50161,14743,294,32,32,50,1323,1323,1291,1291
Yolo,6,2022-01-23,2313,2314,1669,645,38557,38603,27883,10720,16,10,10,5,290,290,280,280
Yuba,6,2022-01-23,964,964,684,280,3749,3754,2661,1093,56,2,2,7,106,106,104,104
Alameda,7,2022-01-30,12170,12184,9597,2587,140980,141151,111156,29995,339,53,53,77,1696,1696,1643,1643
Amador,7,2022-01-30,353,353,246,107,3283,3287,2284,1003,12,1,1,4,74,74,73,73
Butte,7,2022-01-30,1266,1266,1039,227,7986,7997,6554,1443,86,7,7,8,386,386,379,379
Calaveras,7,2022-01-30,272,272,197,75,1919,1921,1388,533,1,6,6,2,104,104,98,98
Colusa,7,2022-01-30,110,110,83,27,692,692,523,169,8,0,0,0,21,21,21,21
Contra Costa,7,2022-01-30,8036,8046,5534,2512,71030,71117,48943,22174,217,34,34,57,1185,1185,1151,1151
Del Norte,7,2022-01-30,342,342,254,88,4189,4193,3116,1077,5,2,2,3,44,44,42,42
El Dorado,7,2022-01-30,813,813,589,224,6136,6143,4452,1691,11,5,5,5,198,198,193,193
Fresno,7,2022-01-30,11786,11801,8265,3536,57668,57739,40439,17300,482,45,45,105,2569,2569,2524,2524
Glenn,7,2022-01-30,203,203,148,55,797,797,581,216,2,0,0,0,41,41,41,41
Humboldt,7,2022-01-30,595,595,442,153,6103,6110,4527,1583,23,4,4,2,134,134,130,130
Imperial,7,2022-01-30,2465,2468,1777,691,12086,12102,8722,3380,74,15,15,28,893,893,878,878
Inyo,7,2022-01-30,65,65,49,16,504,504,379,125,4,2,2,0,55,55,53,53
Kern,7,2022-01-30,6146,6154,4678,1476,43369,43422,32989,10433,258,39,39,49,2192,2192,2153,2153
Kings,7,2022-01-30,2670,2673,1932,741,14805,14823,10708,4115,49,4,4,4,404,404,400,400
Lake,7,2022-01-30,559,559,388,171,3381,3385,2349,1036,4,5,5,4,127,127,122,122
Lassen,7,2022-01-30,336,336,261,75,3552,3557,2755,802,6,1,1,0,55,55,54,54
Los Angeles,7,2022-01-30,84749,84853,76647,8206,1326998,1328617,1200129,128488,2971,620,620,749,29557,29557,28937,28937
Madera,7,2022-01-30,1799,1800,1256,544,9665,9678,6742,2936,48,4,4,7,354,354,350,350
Marin,7,2022-01-30,1166,1166,822,344,14176,14193,10015,4178,27,5,5,12,273,273,268,268
Mariposa,7,2022-01-30,104,104,72,32,876,876,603,273,0,1,1,0,23,23,22,22
Mendocino,7,2022-01-30,515,515,327,188,3548,3552,2256,1296,14,4,4,2,115,115,111,111
Merced,7,2022-01-30,2263,2265,1703,562,10852,10864,8172,2692,41,11,11,13,757,757,746,746
Modoc,7,2022-01-30,11,11,8,3,99,99,75,24,2,0,0,0,7,7,7,7
Mono,7,2022-01-30,43,43,25,18,340,340,202,138,0,0,0,0,5,5,5,5
Monterey,7,2022-01-30,3807,3812,2265,1547,26629,26660,15859,10801,79,9,9,16,677,677,668,668
Napa,7,2022-01-30,1085,1085,843,242,9676,9688,7516,2172,17,5,5,5,121,121,116,116
Nevada,7,2022-01-30,638,638,447,191,4116,4121,2882,1239,27,3,3,6,119,119,116,116
Orange,7,2022-01-30,13447,13463,10769,2694,182592,182814,146184,36630,760,170,170,174,6597,6597,6427,6427
Placer,7,2022-01-30,2499,2501,1705,796,15913,15932,10856,5076,163,16,16,40,560,560,544,544
Plumas,7,2022-01-30,145,145,103,42,752,752,532,220,2,0,0,0,12,12,12,12
Riverside,7,2022-01-30,18305,18328,13704,4624,125616,125768,94147,31621,748,111,111,163,6083,6083,5972,5972
Sacramento,7,2022-01-30,11346,11360,8332,3028,81180,81281,59621,21660,494,92,92,101,2787,2787,2695,2695
San Benito,7,2022-01-30,524,524,405,119,3329,3334,2574,760,4,1,1,3,89,89,88,88
San Bernardino,7,2022-01-30,15090,15108,11882,3226,120993,121140,95337,25803,736,183,183,217,7250,7250,7067,7067
San Diego,7,2022-01-30,27986,28020,25169,2851,189533,189764,170521,19243,969,107,107,211,4919,4919,4812,4812
San Francisco,7,2022-01-30,4563,4568,2615,1953,73583,73673,42248,31425,210,23,23,48,761,761,738,738
San Joaquin,7,2022-01-30,6297,6304,4496,1808,45003,45058,32124,12934,218,35,35,72,2102,2102,2067,2067
San Luis Obispo,7,2022-01-30,2277,2279,1736,543,17125,17146,13071,4075,45,11,11,8,412,412,401,401
San Mateo,7,2022-01-30,4852,4857,3882,975,78207,78302,62565,15737,121,14,14,30,650,650,636,636
Santa Barbara,7,2022-01-30,4082,4087,3032,1055,35731,35774,26560,9214,96,20,20,12,633,633,613,613
Santa Clara,7,2022-01-30,15049,15068,13460,1608,207107,207361,185233,22128,429,49,49,94,2142,2142,2093,2093
Santa Cruz,7,2022-01-30,3508,3513,2717,796,46785,46843,36281,10562,38,5,5,5,246,246,241,241
Shasta,7,2022-01-30,1019,1019,748,271,8726,8737,6405,2332,64,15,15,8,488,488,473,473
Siskiyou,7,2022-01-30,115,115,90,25,675,675,524,151,11,1,1,2,69,69,68,68
Solano,7,2022-01-30,4083,4089,3063,1026,29893,29931,22404,7527,126,8,8,31,427,427,419,419
Sonoma,7,2022-01-30,4006,4011,3013,998,33099,33141,24902,8239,82,10,10,12,460,460,450,450
Stanislaus,7,2022-01-30,3897,3902,2559,1343,22538,22565,14796,7769,266,32,32,51,1535,1535,1503,1503
Sutter,7,2022-01-30,684,684,509,175,3887,3892,2893,999,0,2,2,0,207,207,205,205
Tehama,7,2022-01-30,404,404,269,135,2161,2163,1435,728,17,2,2,5,180,180,178,178
Trinity,7,2022-01-30,40,40,27,13,216,216,142,74,0,0,0,0,20,20,20,20
Tulare,7,2022-01-30,5197,5203,3384,1819,24392,24422,15870,8552,141,19,19,17,1376,1376,1357,1357
Tuolumne,7,2022-01-30,790,790,551,239,3400,3404,2380,1024,14,2,2,4,169,169,167,167
Ventura,7,2022-01-30,5204,5210,4234,976,54455,54522,44284,10238,252,33,33,55,1356,1356,1323,1323
Yolo,7,2022-01-30,1514,1514,1161,353,37771,37816,29076,8740,17,1,1,5,291,291,290,290
Yuba,7,2022-01-30,557,557,422,135,3010,3015,2281,734,71,3,3,8,109,109,106,106
Alameda,8,2022-02-06,6627,6636,5482,1154,119972,120122,99228,20894,278,42,42,62,1738,1738,1696,1696
Amador,8,2022-02-06,224,224,166,58,2990,2995,2226,769,12,3,3,4,77,77,74,74
Butte,8,2022-02-06,862,862,736,126,6637,6646,5671,975,73,7,7,10,393,393,386,386
Calaveras,8,2022-02-06,211,211,162,49,1554,1555,1195,360,2,2,2,1,106,106,104,104
Colusa,8,2022-02-06,83,83,66,17,566,566,451,115,3,0,0,0,21,21,21,21
Contra Costa,8,2022-02-06,4347,4352,3216,1136,56348,56418,41671,14747,168,31,31,52,1216,1216,1185,1185
Del Norte,8,2022-02-06,270,270,214,56,4059,4065,3205,860,6,0,0,0,44,44,44,44
El Dorado,8,2022-02-06,486,486,375,111,5129,5134,3959,1175,24,1,1,5,199,199,198,198
Fresno,8,2022-02-06,7003,7011,5256,1755,45449,45505,34121,11384,429,45,45,95,2614,2614,2569,2569
Glenn,8,2022-02-06,132,132,102,30,657,657,509,148,2,0,0,0,41,41,41,41
Humboldt,8,2022-02-06,495,495,390,105,5004,5009,3936,1073,12,1,1,3,135,135,134,134
Imperial,8,2022-02-06,1233,1233,947,286,8770,8782,6744,2038,52,14,14,27,907,907,893,893
Inyo,8,2022-02-06,53,53,42,11,452,452,360,92,5,1,1,1,56,56,55,55
Kern,8,2022-02-06,3786,3791,3042,749,35785,35831,28731,7100,182,41,41,49,2233,2233,2192,2192
Kings,8,2022-02-06,1479,1479,1138,341,10645,10659,8201,2458,47,13,13,6,417,417,404,404
Lake,8,2022-02-06,371,371,277,94,2741,2745,2043,702,7,1,1,5,128,128,127,127
Lassen,8,2022-02-06,144,144,117,27,2963,2967,2413,554,5,2,2,0,57,57,55,55
Los Angeles,8,2022-02-06,41983,42035,38799,3236,1174797,1176271,1085591,90680,2181,651,651,592,30208,30208,29557,29557
Madera,8,2022-02-06,1172,1172,875,297,8434,8446,6308,2138,34,5,5,14,359,359,354,354
Marin,8,2022-02-06,707,707,534,173,11789,11805,8901,2904,28,6,6,6,279,279,273,273
Mariposa,8,2022-02-06,55,55,41,14,621,621,458,163,0,1,1,0,24,24,23,23
Mendocino,8,2022-02-06,357,357,247,110,2933,2937,2027,910,9,1,1,6,116,116,115,115
Merced,8,2022-02-06,1329,1329,1058,271,8363,8374,6663,1711,50,10,10,14,767,767,757,757
Modoc,8,2022-02-06,23,23,18,5,160,160,129,31,3,0,0,0,7,7,7,7
Mono,8,2022-02-06,45,45,29,16,268,268,174,94,0,0,0,0,5,5,5,5
Monterey,8,2022-02-06,2444,2447,1597,850,22867,22896,14937,7959,73,10,10,14,687,687,677,677
Napa,8,2022-02-06,791,791,646,145,8011,8020,6543,1477,12,8,8,1,129,129,121,121
Nevada,8,2022-02-06,379,379,285,94,3262,3266,2447,819,23,3,3,2,122,122,119,119
Orange,8,2022-02-06,7081,7090,5935,1155,154954,155148,129786,25362,497,118,118,123,6715,6715,6597,6597
Placer,8,2022-02-06,1443,1443,1059,384,12536,12552,9194,3358,148,24,24,35,584,584,560,560
Plumas,8,2022-02-06,91,91,69,22,579,579,437,142,1,1,1,0,13,13,12,12
Riverside,8,2022-02-06,9058,9071,7189,1882,97918,98041,77672,20369,564,107,107,122,6190,6190,6083,6083
Sacramento,8,2022-02-06,6662,6671,5204,1467,66011,66094,51509,14585,398,72,72,97,2859,2859,2787,2787
San Benito,8,2022-02-06,322,322,262,60,2757,2760,2242,518,4,1,1,4,90,90,89,89
San Bernardino,8,2022-02-06,7843,7853,6484,1369,93419,93536,77221,16315,527,153,153,170,7403,7403,7250,7250
San Diego,8,2022-02-06,15132,15151,13926,1225,156681,156877,144210,12667,783,115,115,176,5034,5034,4919,4919
San Francisco,8,2022-02-06,2575,2578,1635,943,56703,56774,35964,20810,175,26,26,39,787,787,761,761
San Joaquin,8,2022-02-06,3747,3752,2858,894,38041,38087,29005,9082,193,40,40,59,2142,2142,2102,2102
San Luis Obispo,8,2022-02-06,1374,1374,1105,269,13206,13224,10643,2581,29,15,15,7,427,427,412,412
San Mateo,8,2022-02-06,2698,2701,2260,441,63513,63593,53165,10428,99,16,16,18,666,666,650,650
Santa Barbara,8,2022-02-06,2641,2644,2081,563,33153,33195,26123,7072,79,17,17,19,650,650,633,633
Santa Clara,8,2022-02-06,8789,8799,8050,749,176858,177081,161950,15131,370,32,32,75,2174,2174,2142,2142
Santa Cruz,8,2022-02-06,2046,2047,1666,381,39164,39212,31866,7346,25,3,3,7,249,249,246,246
Shasta,8,2022-02-06,713,713,557,156,7093,7101,5529,1572,62,15,15,13,503,503,488,488
Siskiyou,8,2022-02-06,100,100,82,18,709,709,578,131,8,3,3,0,72,72,69,69
Solano,8,2022-02-06,2464,2466,1950,516,24432,24462,19362,5100,97,5,5,27,432,432,427,427
Sonoma,8,2022-02-06,2266,2268,1805,463,27700,27736,22048,5688,59,8,8,11,468,468,460,460
Stanislaus,8,2022-02-06,2746,2749,1951,798,19548,19573,13879,5694,231,43,43,41,1578,1578,1535,1535
Sutter,8,2022-02-06,411,411,324,87,3461,3466,2730,736,0,7,7,0,214,214,207,207
Tehama,8,2022-02-06,313,313,225,88,1724,1725,1235,490,17,1,1,6,181,181,180,180
Trinity,8,2022-02-06,23,23,16,7,149,149,105,44,0,0,0,0,20,20,20,20
Tulare,8,2022-02-06,3011,3015,2125,890,18537,18560,13069,5491,131,31,31,22,1407,1407,1376,1376
Tuolumne,8,2022-02-06,403,403,301,102,2672,2676,2004,672,11,3,3,1,172,172,169,169
Ventura,8,2022-02-06,2899,2903,2463,440,42918,42972,36406,6566,206,44,44,42,1400,1400,1356,1356
Yolo,8,2022-02-06,948,948,768,180,31953,31992,25900,6092,10,11,11,5,302,302,291,291
Yuba,8,2022-02-06,378,378,302,76,2479,2482,1983,499,50,5,5,13,114,114,109,109
Alameda,9,2022-02-13,3818,3823,3285,538,102240,102373,87931,14442,191,44,44,53,1782,1782,1738,1738
Amador,9,2022-02-13,111,111,87,24,2443,2446,1928,518,7,2,2,4,79,79,77,77
Butte,9,2022-02-13,524,524,462,62,5734,5740,5061,679,66,10,10,8,403,403,393,393
Calaveras,9,2022-02-13,98,98,79,19,1301,1301,1054,247,4,2,2,2,108,108,106,106
Colusa,9,2022-02-13,43,43,36,7,519,519,433,86,4,0,0,0,21,21,21,21
Contra Costa,9,2022-02-13,2652,2655,2082,573,46095,46155,36177,9978,133,25,25,33,1241,1241,1216,1216
Del Norte,9,2022-02-13,233,233,193,40,3536,3541,2924,617,7,0,0,2,44,44,44,44
El Dorado,9,2022-02-13,288,288,234,54,4635,4640,3767,873,22,4,4,3,203,203,199,199
Fresno,9,2022-02-13,4148,4153,3297,856,36591,36639,29077,7562,370,34,34,76,2648,2648,2614,2614
Glenn,9,2022-02-13,65,65,53,12,496,496,404,92,4,1,1,0,42,42,41,41
Humboldt,9,2022-02-13,370,370,305,65,4437,4442,3662,780,17,0,0,2,135,135,135,135
Imperial,9,2022-02-13,676,676,547,129,6553,6560,5309,1251,47,14,14,19,921,921,907,907
Inyo,9,2022-02-13,28,28,23,5,406,406,338,68,3,0,0,0,56,56,56,56
Kern,9,2022-02-13,2314,2316,1943,373,29982,30021,25170,4851,155,30,30,43,2263,2263,2233,2233
Kings,9,2022-02-13,868,868,704,164,8401,8413,6817,1596,44,9,9,5,426,426,417,417
Lake,9,2022-02-13,262,262,207,55,2406,2409,1899,510,6,2,2,5,130,130,128,128
Lassen,9,2022-02-13,149,149,127,22,3127,3131,2655,476,3,2,2,0,59,59,57,57
Los Angeles,9,2022-02-13,23973,24005,22542,1463,1077577,1078978,1012953,66025,1617,516,516,437,30724,30724,30208,30208
Madera,9,2022-02-13,687,687,543,144,6944,6953,5499,1454,35,3,3,9,362,362,359,359
Marin,9,2022-02-13,410,410,327,83,10307,10321,8230,2091,24,7,7,6,286,286,279,279
Mariposa,9,2022-02-13,26,26,20,6,435,435,341,94,0,0,0,0,24,24,24,24
Mendocino,9,2022-02-13,221,221,164,57,2486,2490,1844,646,13,2,2,5,118,118,116,116
Merced,9,2022-02-13,811,811,676,135,7236,7244,6035,1209,40,12,12,7,779,779,767,767
Modoc,9,2022-02-13,19,19,16,3,184,184,154,30,0,0,0,0,7,7,7,7
Mono,9,2022-02-13,14,14,10,4,183,183,129,54,0,0,0,0,5,5,5,5
Monterey,9,2022-02-13,1386,1386,979,407,18541,18565,13099,5466,70,13,13,12,700,700,687,687
Napa,9,2022-02-13,443,443,377,66,6780,6789,5771,1018,15,2,2,2,131,131,129,129
Nevada,9,2022-02-13,200,200,159,41,2704,2707,2145,562,17,0,0,3,122,122,122,122
Orange,9,2022-02-13,4321,4326,3758,568,135758,135934,117897,18037,364,120,120,89,6835,6835,6715,6715
Placer,9,2022-02-13,693,693,540,153,10375,10390,8086,2304,112,14,14,22,598,598,584,584
Plumas,9,2022-02-13,48,48,38,10,442,442,352,90,3,0,0,0,13,13,13,13
Riverside,9,2022-02-13,5147,5153,4281,872,78595,78697,65335,13362,395,91,91,95,6281,6281,6190,6190
Sacramento,9,2022-02-13,3769,3774,3093,681,55955,56028,45895,10133,345,56,56,67,2915,2915,2859,2859
San Benito,9,2022-02-13,179,179,152,27,2266,2269,1922,347,3,1,1,3,91,91,90,90
San Bernardino,9,2022-02-13,4196,4201,3607,594,76504,76603,65766,10837,374,110,110,125,7513,7513,7403,7403
San Diego,9,2022-02-13,9019,9031,8451,580,130896,131066,122662,8404,584,91,91,144,5125,5125,5034,5034
San Francisco,9,2022-02-13,1737,1737,1196,541,48774,48837,33640,15197,128,26,26,39,813,813,787,787
San Joaquin,9,2022-02-13,2248,2249,1810,439,32168,32210,25884,6326,136,37,37,48,2179,2179,2142,2142
San Luis Obispo,9,2022-02-13,878,878,738,140,10473,10485,8820,1665,22,10,10,7,437,437,427,427
San Mateo,9,2022-02-13,1463,1463,1270,193,56556,56628,49113,7515,61,16,16,16,682,682,666,666
Santa Barbara,9,2022-02-13,1210,1210,1000,210,23304,23334,19284,4050,64,8,8,13,658,658,650,650
Santa Clara,9,2022-02-13,5084,5090,4746,344,157749,157955,147218,10737,302,28,28,60,2202,2202,2174,2174
Santa Cruz,9,2022-02-13,1137,1137,964,173,34431,34476,29215,5261,22,4,4,4,253,253,249,249
Shasta,9,2022-02-13,487,487,399,88,6147,6155,5036,1119,60,11,11,13,514,514,503,503
Siskiyou,9,2022-02-13,80,80,68,12,583,583,495,88,3,1,1,2,73,73,72,72
Solano,9,2022-02-13,1338,1338,1110,228,20236,20264,16806,3458,74,1,1,20,433,433,432,432
Sonoma,9,2022-02-13,1307,1307,1089,218,23106,23135,19250,3885,50,9,9,15,477,477,468,468
Stanislaus,9,2022-02-13,1562,1563,1185,378,16034,16054,12160,3894,214,28,28,43,1606,1606,1578,1578
Sutter,9,2022-02-13,232,232,192,40,2955,2960,2446,514,0,3,3,0,217,217,214,214
Tehama,9,2022-02-13,194,194,149,45,1481,1481,1132,349,14,7,7,5,188,188,181,181
Trinity,9,2022-02-13,20,20,15,5,172,172,131,41,0,0,0,0,20,20,20,20
Tulare,9,2022-02-13,1698,1699,1280,419,16178,16198,12211,3987,122,23,23,20,1430,1430,1407,1407
Tuolumne,9,2022-02-13,216,216,171,45,2318,2321,1840,481,11,4,4,1,176,176,172,172
Ventura,9,2022-02-13,1694,1694,1487,207,37965,38015,33322,4693,146,36,36,27,1436,1436,1400,1400
Yolo,9,2022-02-13,552,552,466,86,28581,28617,24187,4430,13,8,8,3,310,310,302,302
Yuba,9,2022-02-13,231,231,193,38,2197,2199,1838,361,24,0,0,12,114,114,114,114
Alameda,10,2022-02-20,2191,2193,1945,248,89588,89707,79510,10197,148,26,26,33,1808,1808,1782,1782
Amador,10,2022-02-20,87,87,72,15,2141,2144,1773,371,6,5,5,3,84,84,79,79
Butte,10,2022-02-20,304,304,275,29,4855,4861,4403,458,64,11,11,5,414,414,403,403
Calaveras,10,2022-02-20,48,48,41,7,937,937,792,145,4,5,5,1,113,113,108,108
Colusa,10,2022-02-20,24,24,21,3,381,381,330,51,4,0,0,0,21,21,21,21
Contra Costa,10,2022-02-20,1541,1541,1268,273,39381,39434,32438,6996,80,18,18,26,1259,1259,1241,1241
Del Norte,10,2022-02-20,145,145,125,20,2967,2971,2550,421,9,0,0,1,44,44,44,44
El Dorado,10,2022-02-20,173,173,147,26,4016,4021,3407,614,5,1,1,4,204,204,203,203
Fresno,10,2022-02-20,2359,2362,1964,398,29991,30032,24971,5061,274,31,31,63,2679,2679,2648,2648
Glenn,10,2022-02-20,32,32,27,5,443,443,376,67,2,0,0,0,42,42,42,42
Humboldt,10,2022-02-20,228,228,196,32,3730,3735,3204,531,17,3,3,2,138,138,135,135
Imperial,10,2022-02-20,424,424,358,66,5250,5255,4444,811,33,6,6,10,927,927,921,921
Inyo,10,2022-02-20,13,13,11,2,372,372,321,51,1,0,0,0,56,56,56,56
Kern,10,2022-02-20,1401,1401,1220,181,25799,25832,22476,3356,94,23,23,26,2286,2286,2263,2263
Kings,10,2022-02-20,553,553,469,84,7338,7348,6224,1124,29,5,5,6,431,431,426,426
Lake,10,2022-02-20,214,214,177,37,2208,2211,1829,382,7,2,2,1,132,132,130,130
Lassen,10,2022-02-20,124,124,109,15,2328,2331,2046,285,4,0,0,0,59,59,59,59
Los Angeles,10,2022-02-20,13727,13744,13083,661,985599,986914,939212,47702,1021,343,343,289,31067,31067,30724,30724
Madera,10,2022-02-20,402,402,333,69,5829,5837,4837,1000,30,2,2,6,364,364,362,362
Marin,10,2022-02-20,252,252,210,42,9912,9926,8286,1640,13,3,3,4,289,289,286,286
Mariposa,10,2022-02-20,23,23,19,4,403,403,332,71,0,1,1,0,25,25,24,24
Mendocino,10,2022-02-20,132,132,104,28,2231,2234,1756,478,9,2,2,3,120,120,118,118
Merced,10,2022-02-20,542,542,469,73,5925,5932,5132,800,32,14,14,7,793,793,779,779
Modoc,10,2022-02-20,10,10,9,1,73,73,63,10,1,0,0,0,7,7,7,7
Mono,10,2022-02-20,8,8,6,2,174,174,131,43,0,1,1,0,6,6,5,5
Monterey,10,2022-02-20,925,925,700,225,15156,15175,11470,3705,53,5,5,7,705,705,700,700
Napa,10,2022-02-20,285,285,250,35,5765,5772,5076,696,6,3,3,3,134,134,131,131
Nevada,10,2022-02-20,124,124,103,21,2378,2380,1977,403,17,3,3,3,125,125,122,122
Orange,10,2022-02-20,2769,2773,2480,293,126427,126595,113109,13486,258,79,79,76,6914,6914,6835,6835
Placer,10,2022-02-20,368,368,302,66,9398,9412,7705,1707,100,10,10,12,608,608,598,598
Plumas,10,2022-02-20,25,25,21,4,391,391,326,65,1,0,0,0,13,13,13,13
Riverside,10,2022-02-20,2755,2760,2381,379,66886,66976,57790,9186,259,53,53,62,6334,6334,6281,6281
Sacramento,10,2022-02-20,2285,2288,1953,335,48859,48925,41746,7179,268,39,39,40,2954,2954,2915,2915
San Benito,10,2022-02-20,135,135,118,17,2037,2039,1789,250,0,0,0,1,91,91,91,91
San Bernardino,10,2022-02-20,2182,2184,1936,248,66166,66254,58739,7515,261,96,96,82,7609,7609,7513,7513
San Diego,10,2022-02-20,5193,5200,4937,263,110492,110640,105026,5614,461,65,65,115,5190,5190,5125,5125
San Francisco,10,2022-02-20,1094,1094,809,285,44519,44577,32956,11621,107,11,11,26,824,824,813,813
San Joaquin,10,2022-02-20,1237,1237,1040,197,27230,27266,22902,4364,89,24,24,34,2203,2203,2179,2179
San Luis Obispo,10,2022-02-20,556,556,485,71,8978,8989,7836,1153,21,14,14,2,451,451,437,437
San Mateo,10,2022-02-20,839,839,749,90,48879,48945,43716,5229,47,5,5,10,687,687,682,682
Santa Barbara,10,2022-02-20,729,729,627,102,21499,21527,18489,3038,41,7,7,11,665,665,658,658
Santa Clara,10,2022-02-20,2841,2845,2693,152,138225,138409,130948,7461,230,25,25,55,2227,2227,2202,2202
Santa Cruz,10,2022-02-20,666,666,584,82,28096,28134,24684,3450,19,1,1,4,254,254,253,253
Shasta,10,2022-02-20,309,309,263,46,5367,5374,4581,793,54,11,11,13,525,525,514,514
Siskiyou,10,2022-02-20,49,49,43,6,532,532,468,64,8,2,2,3,75,75,73,73
Solano,10,2022-02-20,778,778,671,107,16700,16723,14418,2305,52,5,5,15,438,438,433,433
Sonoma,10,2022-02-20,720,720,623,97,18869,18894,16330,2564,35,2,2,9,479,479,477,477
Stanislaus,10,2022-02-20,857,857,686,171,13245,13262,10614,2648,157,29,29,30,1635,1635,1606,1606
Sutter,10,2022-02-20,147,147,126,21,2396,2399,2061,338,0,1,1,0,218,218,217,217
Tehama,10,2022-02-20,109,109,88,21,1270,1270,1024,246,6,7,7,5,195,195,188,188
Trinity,10,2022-02-20,17,17,14,3,217,217,174,43,0,0,0,0,20,20,20,20
Tulare,10,2022-02-20,905,905,721,184,12323,12340,9829,2511,94,16,16,8,1446,1446,1430,1430
Tuolumne,10,2022-02-20,112,112,93,19,1938,1941,1612,329,4,5,5,2,181,181,176,176
Ventura,10,2022-02-20,985,985,889,96,30810,30852,27803,3049,107,21,21,20,1457,1457,1436,1436
Yolo,10,2022-02-20,325,325,284,41,23529,23560,20618,2942,7,4,4,3,314,314,310,310
Yuba,10,2022-02-20,153,153,133,20,1774,1775,1540,235,23,1,1,8,115,115,114,114
Alameda,11,2022-02-27,1419,1419,1292,127,69326,69421,63189,6232,115,16,16,24,1824,1824,1808,1808
Amador,11,2022-02-27,64,64,55,9,1972,1974,1700,274,7,0,0,2,84,84,84,84
Butte,11,2022-02-27,182,182,168,14,4179,4184,3871,313,42,7,7,2,421,421,414,414
Calaveras,11,2022-02-27,35,35,31,4,1074,1074,941,133,0,4,4,0,117,117,113,113
Colusa,11,2022-02-27,11,11,10,1,374,374,334,40,4,0,0,0,21,21,21,21
Contra Costa,11,2022-02-27,935,935,802,133,31710,31754,27231,4523,67,15,15,16,1274,1274,1259,1259
Del Norte,11,2022-02-27,82,82,73,9,2643,2646,2345,301,4,2,2,3,46,46,44,44
El Dorado,11,2022-02-27,110,110,97,13,3344,3349,2940,409,4,2,2,3,206,206,204,204
Fresno,11,2022-02-27,1297,1297,1121,176,25035,25069,21667,3402,198,26,26,51,2705,2705,2679,2679
Glenn,11,2022-02-27,19,19,17,2,394,394,346,48,0,0,0,0,42,42,42,42
Humboldt,11,2022-02-27,146,146,130,16,2761,2766,2451,315,6,1,1,2,139,139,138,138
Imperial,11,2022-02-27,282,282,247,35,4519,4525,3962,563,12,6,6,11,933,933,927,927
Inyo,11,2022-02-27,9,9,8,1,331,331,295,36,0,0,0,0,56,56,56,56
Kern,11,2022-02-27,808,808,724,84,22399,22430,20099,2331,78,17,17,21,2303,2303,2286,2286
Kings,11,2022-02-27,246,246,216,30,5774,5781,5067,714,23,6,6,3,437,437,431,431
Lake,11,2022-02-27,124,124,107,17,1816,1818,1565,253,3,3,3,1,135,135,132,132
Lassen,11,2022-02-27,48,48,43,5,1913,1914,1726,188,1,2,2,0,61,61,59,59
Los Angeles,11,2022-02-27,8267,8279,7968,311,925917,927193,892282,34911,734,223,223,182,31290,31290,31067,31067
Madera,11,2022-02-27,193,193,167,26,4216,4221,3642,579,22,2,2,5,366,366,364,364
Marin,11,2022-02-27,139,139,121,18,7121,7131,6184,947,10,3,3,2,292,292,289,289
Mariposa,11,2022-02-27,32,32,27,5,324,324,278,46,0,1,1,0,26,26,25,25
Mendocino,11,2022-02-27,76,76,63,13,1726,1727,1427,300,12,1,1,4,121,121,120,120
Merced,11,2022-02-27,260,260,232,28,4675,4681,4176,505,25,8,8,3,801,801,793,793
Modoc,11,2022-02-27,6,6,5,1,49,49,44,5,1,0,0,0,7,7,7,7
Mono,11,2022-02-27,4,4,3,1,162,162,129,33,0,0,0,0,6,6,6,6
Monterey,11,2022-02-27,358,358,286,72,12482,12499,9998,2501,27,9,9,6,714,714,705,705
Napa,11,2022-02-27,179,179,162,17,5004,5010,4531,479,8,4,4,2,138,138,134,134
Nevada,11,2022-02-27,74,74,64,10,1954,1956,1690,266,9,0,0,3,125,125,125,125
Orange,11,2022-02-27,1756,1756,1608,148,114433,114591,104964,9627,189,46,46,41,6960,6960,6914,6914
Placer,11,2022-02-27,242,242,207,35,7805,7818,6670,1148,71,3,3,14,611,611,608,608
Plumas,11,2022-02-27,24,24,21,3,338,338,293,45,0,0,0,0,13,13,13,13
Riverside,11,2022-02-27,1711,1712,1525,187,59372,59454,52927,6527,200,41,41,43,6375,6375,6334,6334
Sacramento,11,2022-02-27,1155,1155,1020,135,41442,41499,36628,4871,181,28,28,35,2982,2982,2954,2954
San Benito,11,2022-02-27,51,51,46,5,1572,1573,1420,153,0,0,0,1,91,91,91,91
San Bernardino,11,2022-02-27,1198,1198,1090,108,56455,56532,51433,5099,165,67,67,50,7676,7676,7609,7609
San Diego,11,2022-02-27,3136,3141,3016,125,93727,93856,90129,3727,351,35,35,84,5225,5225,5190,5190
San Francisco,11,2022-02-27,848,848,666,182,36858,36909,29001,7908,76,13,13,20,837,837,824,824
San Joaquin,11,2022-02-27,678,678,591,87,23563,23595,20563,3032,62,14,14,21,2217,2217,2203,2203
San Luis Obispo,11,2022-02-27,315,315,283,32,7532,7543,6775,768,12,8,8,3,459,459,451,451
San Mateo,11,2022-02-27,560,560,513,47,35360,35409,32422,2987,38,7,7,8,694,694,687,687
Santa Barbara,11,2022-02-27,375,375,333,42,19530,19556,17353,2203,31,5,5,11,670,670,665,665
Santa Clara,11,2022-02-27,1713,1713,1641,72,84585,84702,81155,3547,203,21,21,43,2248,2248,2227,2227
Santa Cruz,11,2022-02-27,464,464,419,45,23797,23830,21512,2318,15,2,2,4,256,256,254,254
Shasta,11,2022-02-27,164,164,145,19,4638,4644,4094,550,42,11,11,8,536,536,525,525
Siskiyou,11,2022-02-27,26,26,23,3,403,403,364,39,3,4,4,2,79,79,75,75
Solano,11,2022-02-27,477,477,425,52,14280,14298,12724,1574,45,2,2,17,440,440,438,438
Sonoma,11,2022-02-27,448,448,400,48,14980,15001,13379,1622,27,2,2,5,481,481,479,479
Stanislaus,11,2022-02-27,477,477,400,77,12101,12118,10156,1962,119,15,15,22,1650,1650,1635,1635
Sutter,11,2022-02-27,102,102,91,11,2200,2202,1955,247,0,2,2,0,220,220,218,218
Tehama,11,2022-02-27,59,59,50,9,1133,1133,955,178,7,4,4,2,199,199,195,195
Trinity,11,2022-02-27,5,5,4,1,107,107,90,17,0,0,0,0,20,20,20,20
Tulare,11,2022-02-27,481,481,402,79,11041,11056,9231,1825,68,15,15,9,1461,1461,1446,1446
Tuolumne,11,2022-02-27,75,75,65,10,1429,1429,1234,195,7,3,3,1,184,184,181,181
Ventura,11,2022-02-27,569,569,525,44,27239,27276,25143,2133,72,13,13,17,1470,1470,1457,1457
Yolo,11,2022-02-27,205,205,185,20,22957,22989,20711,2278,6,2,2,4,316,316,314,314
Yuba,11,2022-02-27,80,80,72,8,1703,1704,1523,181,14,1,1,6,116,116,115,115
Alameda,12,2022-03-06,1168,1168,1084,84,73126,73233,67946,5287,83,14,14,19,1838,1838,1824,1824
Amador,12,2022-03-06,76,76,67,9,1434,1434,1272,162,5,2,2,1,86,86,84,84
Butte,12,2022-03-06,123,123,116,7,3830,3835,3607,228,33,4,4,3,425,425,421,421
Calaveras,12,2022-03-06,31,31,28,3,1125,1125,1012,113,1,1,1,0,118,118,117,117
Colusa,12,2022-03-06,9,9,8,1,352,352,322,30,6,0,0,0,21,21,21,21
Contra Costa,12,2022-03-06,642,642,569,73,31593,31639,27986,3653,48,10,10,13,1284,1284,1274,1274
Del Norte,12,2022-03-06,52,52,47,5,1875,1878,1706,172,4,1,1,1,47,47,46,46
El Dorado,12,2022-03-06,86,86,78,8,3236,3241,2921,320,6,3,3,2,209,209,206,206
Fresno,12,2022-03-06,914,914,814,100,22747,22781,20286,2495,139,20,20,29,2725,2725,2705,2705
Glenn,12,2022-03-06,17,17,15,2,409,409,369,40,2,0,0,0,42,42,42,42
Humboldt,12,2022-03-06,93,93,85,8,3081,3086,2805,281,6,3,3,4,142,142,139,139
Imperial,12,2022-03-06,152,152,137,15,4511,4516,4065,451,9,5,5,10,938,938,933,933
Inyo,12,2022-03-06,9,9,8,1,364,364,332,32,0,0,0,0,56,56,56,56
Kern,12,2022-03-06,492,492,451,41,21501,21532,19734,1798,64,9,9,15,2312,2312,2303,2303
Kings,12,2022-03-06,159,159,143,16,5031,5038,4537,501,14,4,4,1,441,441,437,437
Lake,12,2022-03-06,69,69,61,8,1792,1794,1592,202,3,3,3,1,138,138,135,135
Lassen,12,2022-03-06,90,90,83,7,1908,1910,1759,151,0,1,1,0,62,62,61,61
Los Angeles,12,2022-03-06,5929,5938,5762,176,886957,888248,861681,26567,601,179,179,130,31469,31469,31290,31290
Madera,12,2022-03-06,129,129,115,14,4034,4039,3590,449,11,1,1,2,367,367,366,366
Marin,12,2022-03-06,167,167,149,18,7592,7604,6786,818,11,0,0,1,292,292,292,292
Mariposa,12,2022-03-06,13,13,11,2,301,301,266,35,0,1,1,0,27,27,26,26
Mendocino,12,2022-03-06,69,69,59,10,1744,1746,1498,248,7,1,1,1,122,122,121,121
Merced,12,2022-03-06,194,194,177,17,4649,4655,4252,403,19,7,7,6,808,808,801,801
Modoc,12,2022-03-06,1,1,1,0,54,54,49,5,0,0,0,0,7,7,7,7
Mono,12,2022-03-06,3,3,2,1,135,135,113,22,0,0,0,1,6,6,6,6
Monterey,12,2022-03-06,256,256,214,42,11386,11402,9523,1879,22,6,6,3,720,720,714,714
Napa,12,2022-03-06,201,201,186,15,4957,4963,4581,382,4,1,1,2,139,139,138,138
Nevada,12,2022-03-06,47,47,42,5,1737,1739,1548,191,4,1,1,0,126,126,125,125
Orange,12,2022-03-06,1339,1339,1250,89,109088,109246,101890,7356,142,29,29,37,6989,6989,6960,6960
Placer,12,2022-03-06,169,169,149,20,7818,7831,6900,931,57,3,3,12,614,614,611,611
Plumas,12,2022-03-06,5,5,4,1,275,275,245,30,0,0,0,0,13,13,13,13
Riverside,12,2022-03-06,1061,1061,968,93,54786,54866,50029,4837,141,30,30,31,6405,6405,6375,6375
Sacramento,12,2022-03-06,822,822,745,77,40239,40297,36486,3811,132,19,19,28,3001,3001,2982,2982
San Benito,12,2022-03-06,36,36,33,3,1512,1512,1393,119,0,2,2,1,93,93,91,91
San Bernardino,12,2022-03-06,848,848,787,61,53886,53965,50067,3898,88,37,37,45,7713,7713,7676,7676
San Diego,12,2022-03-06,2421,2426,2350,76,96404,96545,93514,3031,246,36,36,62,5261,5261,5225,5225
San Francisco,12,2022-03-06,688,688,567,121,38121,38176,31439,6737,56,8,8,11,845,845,837,837
San Joaquin,12,2022-03-06,461,461,414,47,21555,21586,19351,2235,41,9,9,17,2226,2226,2217,2217
San Luis Obispo,12,2022-03-06,299,299,274,25,7339,7350,6748,602,7,5,5,1,464,464,459,459
San Mateo,12,2022-03-06,564,564,526,38,41540,41601,38778,2823,32,1,1,4,695,695,694,694
Santa Barbara,12,2022-03-06,199,199,181,18,18118,18144,16499,1645,18,4,4,9,674,674,670,670
Santa Clara,12,2022-03-06,1475,1475,1426,49,114969,115136,111285,3851,140,12,12,43,2260,2260,2248,2248
Santa Cruz,12,2022-03-06,344,344,317,27,24969,25006,23044,1962,11,0,0,7,256,256,256,256
Shasta,12,2022-03-06,149,149,135,14,4961,4967,4496,471,33,9,9,4,545,545,536,536
Siskiyou,12,2022-03-06,20,20,18,2,414,414,382,32,2,1,1,0,80,80,79,79
Solano,12,2022-03-06,370,370,337,33,14076,14097,12847,1250,44,4,4,11,444,444,440,440
Sonoma,12,2022-03-06,367,367,335,32,15357,15380,14041,1339,26,4,4,7,485,485,481,481
Stanislaus,12,2022-03-06,296,296,257,39,11044,11060,9602,1458,98,11,11,14,1661,1661,1650,1650
Sutter,12,2022-03-06,86,86,78,8,1982,1984,1804,180,0,2,2,0,222,222,220,220
Tehama,12,2022-03-06,46,46,40,6,1202,1202,1049,153,3,2,2,1,201,201,199,199
Trinity,12,2022-03-06,5,5,4,1,114,114,99,15,0,0,0,0,20,20,20,20
Tulare,12,2022-03-06,316,316,274,42,10273,10289,8910,1379,39,9,9,5,1470,1470,1461,1461
Tuolumne,12,2022-03-06,55,55,49,6,1262,1262,1123,139,1,1,1,2,185,185,184,184
Ventura,12,2022-03-06,422,422,396,26,27154,27193,25496,1697,39,4,4,15,1474,1474,1470,1470
Yolo,12,2022-03-06,162,162,149,13,22261,22294,20512,1782,4,1,1,2,317,317,316,316
Yuba,12,2022-03-06,65,65,60,5,1588,1589,1454,135,17,0,0,6,116,116,116,116
Alameda,13,2022-03-13,912,912,860,52,68450,68554,64634,3920,71,10,10,6,1848,1848,1838,1838
Amador,13,2022-03-13,33,33,30,3,1434,1434,1305,129,4,0,0,0,86,86,86,86
Butte,13,2022-03-13,75,75,72,3,3609,3614,3444,170,22,2,2,1,427,427,425,425
Calaveras,13,2022-03-13,14,14,13,1,1035,1035,953,82,2,1,1,0,119,119,118,118
Colusa,13,2022-03-13,6,6,6,0,256,256,238,18,2,0,0,0,21,21,21,21
Contra Costa,13,2022-03-13,569,569,517,52,29028,29072,26390,2682,20,5,5,9,1289,1289,1284,1284
Del Norte,13,2022-03-13,42,42,39,3,1447,1448,1343,105,3,2,2,1,49,49,47,47
El Dorado,13,2022-03-13,49,49,45,4,3041,3046,2807,239,4,0,0,2,209,209,209,209
Fresno,13,2022-03-13,579,579,528,51,21720,21753,19852,1901,119,11,11,20,2736,2736,2725,2725
Glenn,13,2022-03-13,12,12,11,1,342,342,315,27,1,0,0,0,42,42,42,42
Humboldt,13,2022-03-13,59,59,55,4,2749,2754,2554,200,5,1,1,2,143,143,142,142
Imperial,13,2022-03-13,81,81,75,6,4610,4616,4246,370,5,2,2,8,940,940,938,938
Inyo,13,2022-03-13,8,8,7,1,170,170,158,12,0,0,0,0,56,56,56,56
Kern,13,2022-03-13,302,302,282,20,20209,20240,18902,1338,43,17,17,13,2329,2329,2312,2312
Kings,13,2022-03-13,218,218,201,17,4871,4877,4492,385,16,2,2,1,443,443,441,441
Lake,13,2022-03-13,59,59,54,5,1610,1612,1467,145,0,1,1,0,139,139,138,138
Lassen,13,2022-03-13,17,17,16,1,1484,1485,1392,93,0,0,0,0,62,62,62,62
Los Angeles,13,2022-03-13,4290,4296,4196,100,847821,849105,829188,19917,402,137,137,98,31606,31606,31469,31469
Madera,13,2022-03-13,73,73,66,7,3703,3708,3379,329,11,0,0,3,367,367,367,367
Marin,13,2022-03-13,172,172,157,15,6633,6644,6074,570,6,2,2,0,294,294,292,292
Mariposa,13,2022-03-13,8,8,7,1,226,226,205,21,0,0,0,0,27,27,27,27
Mendocino,13,2022-03-13,40,40,35,5,1481,1482,1313,169,4,0,0,1,122,122,122,122
Merced,13,2022-03-13,143,143,133,10,4203,4208,3920,288,19,2,2,5,810,810,808,808
Modoc,13,2022-03-13,3,3,3,0,56,56,52,4,1,0,0,0,7,7,7,7
Mono,13,2022-03-13,2,2,2,0,103,103,89,14,0,0,0,0,6,6,6,6
Monterey,13,2022-03-13,165,165,143,22,10335,10351,8971,1380,15,4,4,2,724,724,720,720
Napa,13,2022-03-13,141,141,132,9,4260,4266,4005,261,3,1,1,3,140,140,139,139
Nevada,13,2022-03-13,54,54,49,5,1608,1609,1468,141,2,0,0,1,126,126,126,126
Orange,13,2022-03-13,858,858,813,45,102863,103019,97541,5478,108,31,31,31,7020,7020,6989,6989
Placer,13,2022-03-13,152,152,138,14,7527,7540,6824,716,58,4,4,4,618,618,614,614
Plumas,13,2022-03-13,9,9,8,1,310,310,283,27,0,0,0,0,13,13,13,13
Riverside,13,2022-03-13,750,750,698,52,52965,53046,49345,3701,96,15,15,19,6420,6420,6405,6405
Sacramento,13,2022-03-13,601,601,556,45,37420,37476,34653,2823,113,14,14,21,3015,3015,3001,3001
San Benito,13,2022-03-13,27,27,25,2,1446,1446,1356,90,0,0,0,1,93,93,93,93
San Bernardino,13,2022-03-13,586,586,553,33,51387,51466,48520,2946,80,27,27,34,7740,7740,7713,7713
San Diego,13,2022-03-13,1898,1901,1854,47,96857,97003,94608,2395,168,17,17,50,5278,5278,5261,5261
San Francisco,13,2022-03-13,608,608,521,87,34809,34861,29877,4984,35,6,6,8,851,851,845,845
San Joaquin,13,2022-03-13,288,288,264,24,20333,20363,18684,1679,26,5,5,17,2231,2231,2226,2226
San Luis Obispo,13,2022-03-13,169,169,158,11,6923,6933,6481,452,6,7,7,1,471,471,464,464
San Mateo,13,2022-03-13,446,446,422,24,37308,37364,35363,2001,26,1,1,3,696,696,695,695
Santa Barbara,13,2022-03-13,196,196,182,14,17396,17422,16166,1256,17,6,6,2,680,680,674,674
Santa Clara,13,2022-03-13,1115,1115,1086,29,100830,100981,98332,2649,102,14,14,28,2274,2274,2260,2260
Santa Cruz,13,2022-03-13,238,238,223,15,22972,23008,21576,1432,8,3,3,4,259,259,256,256
Shasta,13,2022-03-13,103,103,95,8,4997,5006,4628,378,17,6,6,2,551,551,545,545
Siskiyou,13,2022-03-13,16,16,15,1,409,409,384,25,0,3,3,0,83,83,80,80
Solano,13,2022-03-13,242,242,225,17,12860,12879,11970,909,35,1,1,10,445,445,444,444
Sonoma,13,2022-03-13,228,228,212,16,13825,13846,12886,960,12,0,0,3,485,485,485,485
Stanislaus,13,2022-03-13,228,228,204,24,10160,10176,9100,1076,87,10,10,14,1671,1671,1661,1661
Sutter,13,2022-03-13,47,47,44,3,1806,1807,1677,130,0,0,0,0,222,222,222,222
Tehama,13,2022-03-13,24,24,22,2,1016,1016,912,104,1,2,2,0,203,203,201,201
Trinity,13,2022-03-13,3,3,3,0,97,97,87,10,0,0,0,0,20,20,20,20
Tulare,13,2022-03-13,195,195,174,21,9770,9786,8730,1056,34,4,4,3,1474,1474,1470,1470
Tuolumne,13,2022-03-13,25,25,23,2,1249,1249,1139,110,1,0,0,0,185,185,185,185
Ventura,13,2022-03-13,336,336,320,16,25097,25135,23893,1242,36,5,5,8,1479,1479,1474,1474
Yolo,13,2022-03-13,125,125,117,8,21618,21650,20277,1373,1,1,1,1,318,318,317,317
Yuba,13,2022-03-13,34,34,32,2,1455,1455,1357,98,9,0,0,3,116,116,116,116
Alameda,14,2022-03-20,698,698,667,31,67331,67436,64391,3045,57,6,6,2,1854,1854,1848,1848
Amador,14,2022-03-20,28,28,26,2,1376,1376,1277,99,2,0,0,0,86,86,86,86
Butte,14,2022-03-20,85,85,82,3,3216,3221,3102,119,16,0,0,1,427,427,427,427
Calaveras,14,2022-03-20,13,13,12,1,657,657,616,41,0,0,0,0,119,119,119,119
Colusa,14,2022-03-20,3,3,3,0,249,249,235,14,1,0,0,0,21,21,21,21
Contra Costa,14,2022-03-20,460,460,426,34,27742,27786,25744,2042,24,5,5,11,1294,1294,1289,1289
Del Norte,14,2022-03-20,21,21,20,1,1288,1288,1214,74,0,0,0,1,49,49,49,49
El Dorado,14,2022-03-20,41,41,39,2,2809,2814,2639,175,2,2,2,0,211,211,209,209
Fresno,14,2022-03-20,350,350,326,24,19945,19976,18588,1388,88,12,12,13,2748,2748,2736,2736
Glenn,14,2022-03-20,9,9,8,1,376,376,353,23,1,0,0,0,42,42,42,42
Humboldt,14,2022-03-20,37,37,35,2,2374,2379,2243,136,6,0,0,2,143,143,143,143
Imperial,14,2022-03-20,58,58,54,4,4032,4037,3781,256,5,1,1,4,941,941,940,940
Inyo,14,2022-03-20,1,1,1,0,152,152,144,8,0,0,0,0,56,56,56,56
Kern,14,2022-03-20,215,215,204,11,19675,19706,18675,1031,33,3,3,11,2332,2332,2329,2329
Kings,14,2022-03-20,76,76,71,5,4453,4459,4180,279,5,1,1,1,444,444,443,443
Lake,14,2022-03-20,17,17,16,1,1440,1441,1338,103,0,0,0,0,139,139,139,139
Lassen,14,2022-03-20,9,9,9,0,1449,1450,1378,72,0,0,0,0,62,62,62,62
Los Angeles,14,2022-03-20,4059,4066,3993,73,826865,828157,812930,15227,339,74,74,65,31680,31680,31606,31606
Madera,14,2022-03-20,43,43,40,3,3413,3418,3177,241,9,1,1,2,368,368,367,367
Marin,14,2022-03-20,141,141,131,10,6296,6307,5876,431,4,1,1,0,295,295,294,294
Mariposa,14,2022-03-20,9,9,8,1,250,250,231,19,0,0,0,0,27,27,27,27
Mendocino,14,2022-03-20,27,27,25,2,1490,1491,1356,135,4,2,2,1,124,124,122,122
Merced,14,2022-03-20,98,98,93,5,3880,3885,3674,211,13,4,4,2,814,814,810,810
Modoc,14,2022-03-20,2,2,2,0,53,53,50,3,0,0,0,0,7,7,7,7
Mono,14,2022-03-20,2,2,2,0,132,132,118,14,1,0,0,0,6,6,6,6
Monterey,14,2022-03-20,155,155,139,16,10204,10221,9128,1093,19,0,0,1,724,724,724,724
Napa,14,2022-03-20,56,56,53,3,3472,3477,3309,168,6,1,1,0,141,141,140,140
Nevada,14,2022-03-20,21,21,20,1,1517,1518,1412,106,2,0,0,0,126,126,126,126
Orange,14,2022-03-20,752,752,721,31,97782,97935,93827,4108,102,13,13,24,7033,7033,7020,7020
Placer,14,2022-03-20,117,117,108,9,6596,6608,6109,499,36,2,2,5,620,620,618,618
Plumas,14,2022-03-20,2,2,2,0,232,232,216,16,0,0,0,0,13,13,13,13
Riverside,14,2022-03-20,652,652,616,36,53360,53443,50484,2959,74,10,10,18,6430,6430,6420,6420
Sacramento,14,2022-03-20,473,473,445,28,32764,32815,30863,1952,95,12,12,10,3027,3027,3015,3015
San Benito,14,2022-03-20,24,24,23,1,1389,1389,1321,68,0,1,1,2,94,94,93,93
San Bernardino,14,2022-03-20,483,483,461,22,51285,51365,49046,2319,51,21,21,30,7761,7761,7740,7740
San Diego,14,2022-03-20,1476,1477,1448,29,87944,88081,86377,1704,158,12,12,34,5290,5290,5278,5278
San Francisco,14,2022-03-20,659,659,584,75,33530,33582,29721,3861,33,3,3,2,854,854,851,851
San Joaquin,14,2022-03-20,238,238,223,15,15421,15445,14438,1007,25,9,9,5,2240,2240,2231,2231
San Luis Obispo,14,2022-03-20,112,112,106,6,6574,6583,6244,339,2,5,5,1,476,476,471,471
San Mateo,14,2022-03-20,385,385,369,16,34111,34165,32725,1440,26,1,1,2,697,697,696,696
Santa Barbara,14,2022-03-20,175,175,165,10,15790,15815,14910,905,13,5,5,3,685,685,680,680
Santa Clara,14,2022-03-20,1047,1047,1026,21,94562,94710,92766,1944,104,4,4,22,2278,2278,2274,2274
Santa Cruz,14,2022-03-20,208,208,198,10,20498,20531,19519,1012,8,0,0,2,259,259,259,259
Shasta,14,2022-03-20,49,49,46,3,4219,4225,3971,254,8,5,5,2,556,556,551,551
Siskiyou,14,2022-03-20,10,10,10,0,353,353,336,17,1,0,0,0,83,83,83,83
Solano,14,2022-03-20,192,192,181,11,11708,11726,11072,654,20,1,1,4,446,446,445,445
Sonoma,14,2022-03-20,220,220,208,12,13340,13361,12630,731,14,3,3,2,488,488,485,485
Stanislaus,14,2022-03-20,150,150,137,13,8461,8475,7763,712,56,12,12,10,1683,1683,1671,1671
Sutter,14,2022-03-20,32,32,30,2,1515,1516,1430,86,0,1,1,0,223,223,222,222
Tehama,14,2022-03-20,9,9,8,1,947,947,870,77,1,1,1,0,204,204,203,203
Trinity,14,2022-03-20,0,0,0,0,100,100,92,8,0,0,0,0,20,20,20,20
Tulare,14,2022-03-20,124,124,113,11,8489,8503,7773,730,23,5,5,5,1479,1479,1474,1474
Tuolumne,14,2022-03-20,17,17,16,1,1167,1167,1085,82,2,0,0,0,185,185,185,185
Ventura,14,2022-03-20,297,297,286,11,23865,23902,22973,929,27,5,5,4,1484,1484,1479,1479
Yolo,14,2022-03-20,108,108,103,5,22264,22300,21182,1118,4,1,1,1,319,319,318,318
Yuba,14,2022-03-20,38,38,36,2,1311,1311,1241,70,8,0,0,0,116,116,116,116
Alameda,15,2022-03-27,880,880,849,31,59348,59444,57334,2110,39,3,3,4,1857,1857,1854,1854
Amador,15,2022-03-27,8,8,8,0,1364,1364,1286,78,3,0,0,0,86,86,86,86
Butte,15,2022-03-27,66,66,64,2,2900,2905,2821,84,15,0,0,1,427,427,427,427
Calaveras,15,2022-03-27,13,13,12,1,592,592,562,30,0,0,0,0,119,119,119,119
Colusa,15,2022-03-27,4,4,4,0,210,210,201,9,0,0,0,0,21,21,21,21
Contra Costa,15,2022-03-27,520,520,490,30,24981,25023,23571,1452,29,3,3,7,1297,1297,1294,1294
Del Norte,15,2022-03-27,17,17,16,1,1037,1037,990,47,0,0,0,0,49,49,49,49
El Dorado,15,2022-03-27,54,54,51,3,2823,2828,2689,139,1,1,1,0,212,212,211,211
Fresno,15,2022-03-27,305,305,288,17,18632,18662,17638,1024,79,5,5,12,2753,2753,2748,2748
Glenn,15,2022-03-27,7,7,7,0,334,334,317,17,0,0,0,0,42,42,42,42
Humboldt,15,2022-03-27,25,25,24,1,2610,2615,2496,119,5,1,1,2,144,144,143,143
Imperial,15,2022-03-27,60,60,57,3,3695,3700,3514,186,5,3,3,3,944,944,941,941
Inyo,15,2022-03-27,3,3,3,0,179,179,171,8,0,0,0,0,56,56,56,56
Kern,15,2022-03-27,151,151,145,6,18489,18519,17754,765,18,6,6,7,2338,2338,2332,2332
Kings,15,2022-03-27,59,59,56,3,4325,4331,4117,214,6,2,2,0,446,446,444,444
Lake,15,2022-03-27,13,13,12,1,1157,1157,1091,66,0,0,0,0,139,139,139,139
Lassen,15,2022-03-27,6,6,6,0,1348,1350,1297,53,0,0,0,0,62,62,62,62
Los Angeles,15,2022-03-27,4458,4465,4402,63,787671,788941,777595,11346,269,53,53,60,31733,31733,31680,31680
Madera,15,2022-03-27,25,25,24,1,3392,3397,3208,189,4,0,0,1,368,368,368,368
Marin,15,2022-03-27,158,158,150,8,6017,6027,5703,324,3,0,0,0,295,295,295,295
Mariposa,15,2022-03-27,5,5,5,0,169,169,159,10,0,1,1,0,28,28,27,27
Mendocino,15,2022-03-27,34,34,32,2,1312,1313,1218,95,0,1,1,0,125,125,124,124
Merced,15,2022-03-27,66,66,63,3,3348,3353,3210,143,7,2,2,2,816,816,814,814
Modoc,15,2022-03-27,2,2,2,0,50,50,48,2,0,0,0,0,7,7,7,7
Mono,15,2022-03-27,3,3,3,0,135,135,123,12,0,0,0,0,6,6,6,6
Monterey,15,2022-03-27,160,160,146,14,9411,9427,8624,803,17,1,1,0,725,725,724,724
Napa,15,2022-03-27,63,63,61,2,3364,3369,3241,128,1,2,2,0,143,143,141,141
Nevada,15,2022-03-27,27,27,26,1,1488,1490,1408,82,1,1,1,0,127,127,126,126
Orange,15,2022-03-27,801,801,775,26,90531,90678,87690,2988,75,13,13,20,7046,7046,7033,7033
Placer,15,2022-03-27,109,109,103,6,6158,6169,5800,369,25,4,4,8,624,624,620,620
Plumas,15,2022-03-27,2,2,2,0,274,274,259,15,0,0,0,0,13,13,13,13
Riverside,15,2022-03-27,532,532,509,23,44655,44728,42780,1948,52,10,10,12,6440,6440,6430,6430
Sacramento,15,2022-03-27,451,451,430,21,32088,32140,30629,1511,77,7,7,15,3034,3034,3027,3027
San Benito,15,2022-03-27,9,9,9,0,1311,1311,1260,51,0,0,0,0,94,94,94,94
San Bernardino,15,2022-03-27,505,505,487,18,41576,41644,40167,1477,47,22,22,23,7783,7783,7761,7761
San Diego,15,2022-03-27,1310,1310,1290,20,74600,74723,73595,1128,122,9,9,28,5299,5299,5290,5290
San Francisco,15,2022-03-27,807,807,733,74,32965,33018,29987,3031,24,2,2,3,856,856,854,854
San Joaquin,15,2022-03-27,186,186,177,9,16613,16640,15782,858,26,4,4,5,2244,2244,2240,2240
San Luis Obispo,15,2022-03-27,99,99,95,4,5816,5826,5591,235,3,1,1,1,477,477,476,476
San Mateo,15,2022-03-27,535,535,518,17,34581,34636,33487,1149,27,3,3,4,700,700,697,697
Santa Barbara,15,2022-03-27,124,124,119,5,9248,9263,8850,413,18,2,2,3,687,687,685,685
Santa Clara,15,2022-03-27,1256,1256,1236,20,91768,91915,90443,1472,83,8,8,19,2286,2286,2278,2278
Santa Cruz,15,2022-03-27,139,139,134,5,18842,18874,18144,730,3,0,0,2,259,259,259,259
Shasta,15,2022-03-27,39,39,37,2,3867,3873,3689,184,7,3,3,3,559,559,556,556
Siskiyou,15,2022-03-27,8,8,8,0,310,310,298,12,0,0,0,0,83,83,83,83
Solano,15,2022-03-27,157,157,150,7,10984,11001,10517,484,18,0,0,5,446,446,446,446
Sonoma,15,2022-03-27,246,246,236,10,8241,8255,7902,353,20,0,0,1,488,488,488,488
Stanislaus,15,2022-03-27,121,121,113,8,8029,8043,7506,537,30,3,3,5,1686,1686,1683,1683
Sutter,15,2022-03-27,26,26,25,1,1510,1511,1443,68,0,1,1,0,224,224,223,223
Tehama,15,2022-03-27,15,15,14,1,811,811,759,52,3,0,0,0,204,204,204,204
Trinity,15,2022-03-27,0,0,0,0,95,95,89,6,0,0,0,0,20,20,20,20
Tulare,15,2022-03-27,92,92,86,6,7859,7873,7337,536,19,3,3,0,1482,1482,1479,1479
Tuolumne,15,2022-03-27,11,11,10,1,1129,1129,1067,62,2,0,0,1,185,185,185,185
Ventura,15,2022-03-27,339,339,329,10,21819,21854,21188,666,21,6,6,3,1490,1490,1484,1484
Yolo,15,2022-03-27,103,103,99,4,18804,18835,18102,733,3,2,2,0,321,321,319,319
Yuba,15,2022-03-27,32,32,31,1,1261,1261,1208,53,2,2,2,1,118,118,116,116
Alameda,16,2022-04-03,993,993,966,27,58049,58146,56525,1621,35,4,4,3,1861,1861,1857,1857
Amador,16,2022-04-03,4,4,4,0,1152,1152,1100,52,1,0,0,0,86,86,86,86
Butte,16,2022-04-03,50,50,49,1,2737,2742,2679,63,7,2,2,1,429,429,427,427
Calaveras,16,2022-04-03,10,10,10,0,585,585,562,23,0,0,0,0,119,119,119,119
Colusa,16,2022-04-03,2,2,2,0,193,193,186,7,0,0,0,0,21,21,21,21
Contra Costa,16,2022-04-03,553,553,528,25,24352,24392,23274,1118,13,1,1,4,1298,1298,1297,1297
Del Norte,16,2022-04-03,9,9,9,0,1107,1108,1068,40,0,0,0,1,49,49,49,49
El Dorado,16,2022-04-03,48,48,46,2,2720,2725,2619,106,3,1,1,0,213,213,212,212
Fresno,16,2022-04-03,203,203,194,9,16952,16981,16246,735,63,4,4,14,2757,2757,2753,2753
Glenn,16,2022-04-03,5,5,5,0,296,296,284,12,0,0,0,0,42,42,42,42
Humboldt,16,2022-04-03,21,21,20,1,2479,2484,2395,89,2,0,0,3,144,144,144,144
Imperial,16,2022-04-03,49,49,47,2,3485,3490,3352,138,3,0,0,3,944,944,944,944
Inyo,16,2022-04-03,8,8,8,0,171,171,165,6,0,0,0,0,56,56,56,56
Kern,16,2022-04-03,165,165,160,5,17221,17250,16690,560,17,2,2,6,2340,2340,2338,2338
Kings,16,2022-04-03,50,50,48,2,4183,4189,4026,163,2,0,0,1,446,446,446,446
Lake,16,2022-04-03,13,13,12,1,990,990,946,44,0,0,0,0,139,139,139,139
Lassen,16,2022-04-03,4,4,4,0,1225,1227,1189,38,0,0,0,0,62,62,62,62
Los Angeles,16,2022-04-03,5098,5105,5049,56,733780,734994,726788,8206,244,47,47,43,31780,31780,31733,31733
Madera,16,2022-04-03,29,29,28,1,3308,3313,3168,145,3,0,0,1,368,368,368,368
Marin,16,2022-04-03,169,169,162,7,6461,6473,6199,274,2,0,0,0,295,295,295,295
Mariposa,16,2022-04-03,6,6,6,0,222,222,212,10,0,0,0,0,28,28,28,28
Mendocino,16,2022-04-03,23,23,22,1,1235,1236,1165,71,2,0,0,0,125,125,125,125
Merced,16,2022-04-03,54,54,52,2,3300,3305,3194,111,4,2,2,0,818,818,816,816
Modoc,16,2022-04-03,4,4,4,0,47,47,45,2,0,0,0,0,7,7,7,7
Mono,16,2022-04-03,1,1,1,0,151,151,141,10,0,0,0,0,6,6,6,6
Monterey,16,2022-04-03,132,132,123,9,7498,7511,7005,506,8,3,3,0,728,728,725,725
Napa,16,2022-04-03,72,72,70,2,3235,3240,3143,97,2,0,0,1,143,143,143,143
Nevada,16,2022-04-03,28,28,27,1,1408,1409,1348,61,0,1,1,0,128,128,127,127
Orange,16,2022-04-03,921,921,898,23,88429,88575,86282,2293,52,15,15,14,7061,7061,7046,7046
Placer,16,2022-04-03,121,121,115,6,6657,6668,6354,314,16,1,1,5,625,625,624,624
Plumas,16,2022-04-03,4,4,4,0,232,232,222,10,0,0,0,0,13,13,13,13
Riverside,16,2022-04-03,618,618,597,21,38666,38730,37399,1331,37,5,5,10,6445,6445,6440,6440
Sacramento,16,2022-04-03,436,436,420,16,32822,32876,31657,1219,49,5,5,11,3039,3039,3034,3034
San Benito,16,2022-04-03,14,14,14,0,1233,1233,1195,38,0,0,0,0,94,94,94,94
San Bernardino,16,2022-04-03,583,583,567,16,41515,41584,40424,1160,31,8,8,12,7791,7791,7783,7783
San Diego,16,2022-04-03,1478,1478,1461,17,65130,65237,64468,769,89,6,6,30,5305,5305,5299,5299
San Francisco,16,2022-04-03,954,954,885,69,28468,28516,26429,2087,20,5,5,5,861,861,856,856
San Joaquin,16,2022-04-03,207,207,199,8,15962,15988,15334,654,7,3,3,7,2247,2247,2244,2244
San Luis Obispo,16,2022-04-03,101,101,98,3,5556,5565,5388,177,2,0,0,1,477,477,477,477
San Mateo,16,2022-04-03,680,680,663,17,29501,29550,28781,769,13,2,2,1,702,702,700,700
Santa Barbara,16,2022-04-03,178,178,172,6,15004,15029,14497,532,7,2,2,1,689,689,687,687
Santa Clara,16,2022-04-03,1404,1404,1387,17,90574,90723,89582,1141,80,5,5,22,2291,2291,2286,2286
Santa Cruz,16,2022-04-03,188,188,182,6,20130,20165,19549,616,4,0,0,2,259,259,259,259
Shasta,16,2022-04-03,23,23,22,1,3551,3557,3424,133,2,1,1,2,560,560,559,559
Siskiyou,16,2022-04-03,4,4,4,0,301,301,292,9,0,0,0,0,83,83,83,83
Solano,16,2022-04-03,170,170,164,6,10352,10368,10008,360,17,1,1,7,447,447,446,446
Sonoma,16,2022-04-03,304,304,294,10,10634,10652,10292,360,8,1,1,2,489,489,488,488
Stanislaus,16,2022-04-03,102,102,97,5,7782,7796,7382,414,23,2,2,4,1688,1688,1686,1686
Sutter,16,2022-04-03,27,27,26,1,1284,1284,1239,45,0,0,0,0,224,224,224,224
Tehama,16,2022-04-03,4,4,4,0,786,786,746,40,0,2,2,0,206,206,204,204
Trinity,16,2022-04-03,1,1,1,0,78,78,74,4,0,0,0,0,20,20,20,20
Tulare,16,2022-04-03,51,51,48,3,7606,7620,7209,411,15,5,5,1,1487,1487,1482,1482
Tuolumne,16,2022-04-03,9,9,9,0,961,961,919,42,1,1,1,0,186,186,185,185
Ventura,16,2022-04-03,292,292,285,7,20847,20881,20382,499,18,5,5,4,1495,1495,1490,1490
Yolo,16,2022-04-03,104,104,101,3,26825,26868,26033,835,2,0,0,0,321,321,321,321
Yuba,16,2022-04-03,12,12,12,0,1024,1024,990,34,3,0,0,1,118,118,118,118
Alameda,17,2022-04-10,1410,1410,1380,30,48973,49056,47988,1068,51,5,5,1,1866,1866,1861,1861
Amador,17,2022-04-10,8,8,8,0,1064,1064,1026,38,1,0,0,0,86,86,86,86
Butte,17,2022-04-10,36,36,35,1,2299,2304,2263,41,3,0,0,1,429,429,429,429
Calaveras,17,2022-04-10,11,11,11,0,653,653,633,20,0,0,0,0,119,119,119,119
Colusa,17,2022-04-10,5,5,5,0,206,206,200,6,0,0,0,0,21,21,21,21
Contra Costa,17,2022-04-10,659,659,636,23,19775,19809,19099,710,15,1,1,6,1299,1299,1298,1298
Del Norte,17,2022-04-10,6,6,6,0,1017,1017,988,29,0,0,0,0,49,49,49,49
El Dorado,17,2022-04-10,55,55,53,2,2594,2599,2520,79,1,0,0,0,213,213,213,213
Fresno,17,2022-04-10,188,188,182,6,16719,16747,16177,570,53,1,1,5,2758,2758,2757,2757
Glenn,17,2022-04-10,2,2,2,0,258,258,250,8,0,0,0,0,42,42,42,42
Humboldt,17,2022-04-10,41,41,40,1,2345,2350,2284,66,4,1,1,2,145,145,144,144
Imperial,17,2022-04-10,26,26,25,1,3483,3488,3380,108,2,1,1,1,945,945,944,944
Inyo,17,2022-04-10,6,6,6,0,198,198,193,5,1,0,0,0,56,56,56,56
Kern,17,2022-04-10,142,142,138,4,17252,17282,16842,440,20,1,1,4,2341,2341,2340,2340
Kings,17,2022-04-10,35,35,34,1,4220,4226,4097,129,3,0,0,0,446,446,446,446
Lake,17,2022-04-10,20,20,19,1,852,852,822,30,0,0,0,0,139,139,139,139
Lassen,17,2022-04-10,1,1,1,0,1295,1297,1265,32,1,0,0,0,62,62,62,62
Los Angeles,17,2022-04-10,6633,6645,6588,57,754056,755339,748713,6626,227,46,46,38,31826,31826,31780,31780
Madera,17,2022-04-10,26,26,25,1,3108,3113,3006,107,3,0,0,1,368,368,368,368
Marin,17,2022-04-10,199,199,192,7,5516,5527,5343,184,4,0,0,2,295,295,295,295
Mariposa,17,2022-04-10,6,6,6,0,242,242,233,9,0,0,0,0,28,28,28,28
Mendocino,17,2022-04-10,30,30,29,1,1137,1138,1086,52,0,0,0,0,125,125,125,125
Merced,17,2022-04-10,72,72,70,2,3294,3299,3212,87,0,0,0,2,818,818,818,818
Modoc,17,2022-04-10,1,1,1,0,46,46,45,1,0,0,0,0,7,7,7,7
Mono,17,2022-04-10,6,6,6,0,137,137,130,7,0,0,0,0,6,6,6,6
Monterey,17,2022-04-10,110,110,104,6,7164,7177,6794,383,11,2,2,0,730,730,728,728
Napa,17,2022-04-10,117,117,114,3,3109,3114,3041,73,1,0,0,0,143,143,143,143
Nevada,17,2022-04-10,34,34,33,1,1495,1496,1445,51,2,0,0,1,128,128,128,128
Orange,17,2022-04-10,1110,1110,1088,22,54698,54791,53685,1106,64,10,10,13,7071,7071,7061,7061
Placer,17,2022-04-10,118,118,114,4,6052,6065,5839,226,20,2,2,3,627,627,625,625
Plumas,17,2022-04-10,5,5,5,0,260,260,251,9,0,0,0,0,13,13,13,13
Riverside,17,2022-04-10,731,731,712,19,37660,37725,36706,1019,32,4,4,9,6449,6449,6445,6445
Sacramento,17,2022-04-10,484,484,470,14,31471,31525,30606,919,40,10,10,5,3049,3049,3039,3039
San Benito,17,2022-04-10,17,17,17,0,1169,1169,1141,28,0,0,0,0,94,94,94,94
San Bernardino,17,2022-04-10,825,825,807,18,41959,42030,41111,919,30,9,9,4,7800,7800,7791,7791
San Diego,17,2022-04-10,1841,1845,1828,17,74345,74471,73786,685,86,5,5,22,5310,5310,5305,5305
San Francisco,17,2022-04-10,1168,1168,1101,67,29986,30038,28298,1740,20,6,6,4,867,867,861,861
San Joaquin,17,2022-04-10,233,233,226,7,15423,15450,14953,497,10,0,0,6,2247,2247,2247,2247
San Luis Obispo,17,2022-04-10,104,104,101,3,4927,4935,4812,123,2,2,2,0,479,479,477,477
San Mateo,17,2022-04-10,819,819,803,16,30589,30641,30016,625,4,1,1,1,703,703,702,702
Santa Barbara,17,2022-04-10,264,264,257,7,15191,15216,14793,423,8,2,2,0,691,691,689,689
Santa Clara,17,2022-04-10,1631,1632,1616,16,79544,79679,78898,781,69,3,3,12,2294,2294,2291,2291
Santa Cruz,17,2022-04-10,292,292,285,7,8383,8396,8197,199,6,1,1,0,260,260,259,259
Shasta,17,2022-04-10,21,21,20,1,3237,3242,3147,95,2,1,1,1,561,561,560,560
Siskiyou,17,2022-04-10,1,1,1,0,331,331,323,8,0,0,0,0,83,83,83,83
Solano,17,2022-04-10,243,243,236,7,9875,9893,9624,269,14,0,0,3,447,447,447,447
Sonoma,17,2022-04-10,393,393,383,10,10639,10656,10373,283,8,1,1,1,490,490,489,489
Stanislaus,17,2022-04-10,132,132,127,5,7885,7900,7569,331,19,1,1,1,1689,1689,1688,1688
Sutter,17,2022-04-10,19,19,18,1,1306,1307,1271,36,0,1,1,0,225,225,224,224
Tehama,17,2022-04-10,9,9,9,0,771,771,740,31,1,0,0,0,206,206,206,206
Trinity,17,2022-04-10,0,0,0,0,88,88,84,4,0,0,0,0,20,20,20,20
Tulare,17,2022-04-10,47,47,45,2,7840,7855,7520,335,8,4,4,0,1491,1491,1487,1487
Tuolumne,17,2022-04-10,16,16,15,1,1053,1053,1017,36,1,0,0,0,186,186,186,186
Ventura,17,2022-04-10,297,297,292,5,18026,18057,17720,337,15,2,2,2,1497,1497,1495,1495
Yolo,17,2022-04-10,121,121,118,3,18556,18587,18135,452,0,0,0,1,321,321,321,321
Yuba,17,2022-04-10,16,16,16,0,1086,1086,1058,28,1,0,0,0,118,118,118,118
Alameda,18,2022-04-17,1720,1722,1693,29,54001,54093,53168,925,40,3,3,6,1869,1869,1866,1866
Amador,18,2022-04-17,9,9,9,0,1158,1158,1126,32,2,0,0,0,86,86,86,86
Butte,18,2022-04-17,49,49,48,1,2240,2244,2213,31,6,2,2,0,431,431,429,429
Calaveras,18,2022-04-17,16,16,16,0,598,598,583,15,0,1,1,0,120,120,119,119
Colusa,18,2022-04-17,3,3,3,0,170,170,166,4,0,0,0,0,21,21,21,21
Contra Costa,18,2022-04-17,978,978,951,27,24553,24595,23897,698,26,1,1,4,1300,1300,1299,1299
Del Norte,18,2022-04-17,12,12,12,0,998,998,976,22,0,0,0,0,49,49,49,49
El Dorado,18,2022-04-17,64,64,63,1,2325,2330,2274,56,0,0,0,0,213,213,213,213
Fresno,18,2022-04-17,207,207,202,5,13774,13798,13431,367,42,5,5,4,2763,2763,2758,2758
Glenn,18,2022-04-17,4,4,4,0,276,276,269,7,0,0,0,0,42,42,42,42
Humboldt,18,2022-04-17,81,81,79,2,1942,1946,1903,43,4,0,0,2,145,145,145,145
Imperial,18,2022-04-17,44,44,43,1,3329,3334,3253,81,2,0,0,1,945,945,945,945
Inyo,18,2022-04-17,0,0,0,0,165,165,162,3,0,0,0,0,56,56,56,56
Kern,18,2022-04-17,133,133,130,3,13412,13435,13168,267,8,2,2,6,2343,2343,2341,2341
Kings,18,2022-04-17,35,35,34,1,3551,3556,3471,85,2,1,1,0,447,447,446,446
Lake,18,2022-04-17,19,19,18,1,797,797,775,22,2,0,0,1,139,139,139,139
Lassen,18,2022-04-17,2,2,2,0,1337,1339,1313,26,0,0,0,0,62,62,62,62
Los Angeles,18,2022-04-17,7666,7678,7626,52,369302,369948,367414,2534,190,40,40,31,31866,31866,31826,31826
Madera,18,2022-04-17,22,22,21,1,2603,2608,2537,71,2,0,0,2,368,368,368,368
Marin,18,2022-04-17,285,285,278,7,5975,5985,5828,157,5,0,0,0,295,295,295,295
Mariposa,18,2022-04-17,12,12,12,0,257,257,250,7,0,0,0,0,28,28,28,28
Mendocino,18,2022-04-17,46,46,44,2,1293,1294,1248,46,2,1,1,1,126,126,125,125
Merced,18,2022-04-17,56,56,55,1,3124,3129,3064,65,5,3,3,0,821,821,818,818
Modoc,18,2022-04-17,1,1,1,0,33,33,32,1,0,0,0,0,7,7,7,7
Mono,18,2022-04-17,11,11,11,0,163,163,156,7,0,0,0,0,6,6,6,6
Monterey,18,2022-04-17,140,140,134,6,6207,6219,5957,262,5,0,0,0,730,730,730,730
Napa,18,2022-04-17,141,141,138,3,2648,2653,2605,48,1,0,0,0,143,143,143,143
Nevada,18,2022-04-17,42,42,41,1,1225,1226,1193,33,0,0,0,1,128,128,128,128
Orange,18,2022-04-17,1327,1327,1306,21,81351,81494,80195,1299,51,5,5,9,7076,7076,7071,7071
Placer,18,2022-04-17,155,155,151,4,4669,4677,4541,136,24,0,0,4,627,627,627,627
Plumas,18,2022-04-17,8,8,8,0,206,206,200,6,0,0,0,0,13,13,13,13
Riverside,18,2022-04-17,862,862,844,18,36659,36724,35944,780,41,7,7,4,6456,6456,6449,6449
Sacramento,18,2022-04-17,648,648,633,15,27674,27722,27089,633,48,10,10,8,3059,3059,3049,3049
San Benito,18,2022-04-17,24,24,24,0,1173,1173,1151,22,0,0,0,0,94,94,94,94
San Bernardino,18,2022-04-17,1056,1056,1038,18,39172,39241,38566,675,34,7,7,9,7807,7807,7800,7800
San Diego,18,2022-04-17,1889,1892,1879,13,66854,66972,66488,484,88,8,8,19,5318,5318,5310,5310
San Francisco,18,2022-04-17,1359,1359,1298,61,30352,30405,29015,1390,26,2,2,2,869,869,867,867
San Joaquin,18,2022-04-17,245,245,239,6,14707,14733,14361,372,8,1,1,4,2248,2248,2247,2247
San Luis Obispo,18,2022-04-17,145,145,142,3,4860,4868,4773,95,3,2,2,0,481,481,479,479
San Mateo,18,2022-04-17,1043,1043,1027,16,29440,29491,29021,470,14,3,3,1,706,706,703,703
Santa Barbara,18,2022-04-17,325,325,318,7,14740,14766,14444,322,8,0,0,0,691,691,691,691
Santa Clara,18,2022-04-17,2061,2066,2051,15,73606,73734,73167,567,61,5,5,13,2299,2299,2294,2294
Santa Cruz,18,2022-04-17,404,404,396,8,12225,12246,12011,235,2,0,0,2,260,260,260,260
Shasta,18,2022-04-17,29,29,28,1,2820,2825,2760,65,1,1,1,2,562,562,561,561
Siskiyou,18,2022-04-17,3,3,3,0,322,322,316,6,1,0,0,1,83,83,83,83
Solano,18,2022-04-17,233,233,228,5,9088,9104,8910,194,10,1,1,1,448,448,447,447
Sonoma,18,2022-04-17,491,491,481,10,11144,11163,10930,233,15,1,1,3,491,491,490,490
Stanislaus,18,2022-04-17,155,155,150,5,7664,7678,7425,253,15,1,1,4,1690,1690,1689,1689
Sutter,18,2022-04-17,23,23,23,0,1171,1171,1145,26,0,0,0,0,225,225,225,225
Tehama,18,2022-04-17,8,8,8,0,680,680,658,22,1,0,0,0,206,206,206,206
Trinity,18,2022-04-17,0,0,0,0,68,68,66,2,0,0,0,0,20,20,20,20
Tulare,18,2022-04-17,78,78,75,3,6733,6745,6518,227,12,0,0,0,1491,1491,1491,1491
Tuolumne,18,2022-04-17,26,26,25,1,1070,1070,1041,29,0,0,0,0,186,186,186,186
Ventura,18,2022-04-17,349,349,344,5,15596,15623,15394,229,8,1,1,0,1498,1498,1497,1497
Yolo,18,2022-04-17,200,200,196,4,17655,17686,17346,340,2,1,1,0,322,322,321,321
Yuba,18,2022-04-17,23,23,23,0,973,973,953,20,1,0,0,0,118,118,118,118
Alameda,19,2022-04-24,2335,2340,2309,31,56767,56870,56113,757,39,7,7,3,1876,1876,1869,1869
Amador,19,2022-04-24,22,22,22,0,1312,1312,1283,29,0,0,0,0,86,86,86,86
Butte,19,2022-04-24,52,52,51,1,2476,2481,2454,27,7,1,1,1,432,432,431,431
Calaveras,19,2022-04-24,28,28,27,1,636,636,624,12,0,0,0,0,120,120,120,120
Colusa,19,2022-04-24,3,3,3,0,184,184,181,3,0,0,0,0,21,21,21,21
Contra Costa,19,2022-04-24,1431,1431,1400,31,26229,26275,25693,582,31,2,2,2,1302,1302,1300,1300
Del Norte,19,2022-04-24,21,21,21,0,1092,1092,1073,19,0,0,0,0,49,49,49,49
El Dorado,19,2022-04-24,98,98,96,2,2711,2716,2665,51,0,0,0,0,213,213,213,213
Fresno,19,2022-04-24,328,328,321,7,16000,16028,15693,335,35,3,3,2,2766,2766,2763,2763
Glenn,19,2022-04-24,4,4,4,0,284,284,279,5,0,0,0,0,42,42,42,42
Humboldt,19,2022-04-24,178,178,175,3,2771,2776,2728,48,2,1,1,2,146,146,145,145
Imperial,19,2022-04-24,62,62,61,1,3407,3412,3347,65,3,0,0,1,945,945,945,945
Inyo,19,2022-04-24,5,5,5,0,175,175,172,3,0,0,0,0,56,56,56,56
Kern,19,2022-04-24,232,232,228,4,17304,17334,17064,270,15,2,2,5,2345,2345,2343,2343
Kings,19,2022-04-24,56,56,55,1,4478,4485,4401,84,2,0,0,0,447,447,447,447
Lake,19,2022-04-24,14,14,14,0,819,819,801,18,1,1,1,0,140,140,139,139
Lassen,19,2022-04-24,0,0,0,0,1504,1506,1484,22,0,0,0,0,62,62,62,62
Los Angeles,19,2022-04-24,11049,11069,11011,58,863625,865179,860552,4627,204,25,25,27,31891,31891,31866,31866
Madera,19,2022-04-24,35,35,34,1,2831,2836,2776,60,2,0,0,0,368,368,368,368
Marin,19,2022-04-24,342,342,335,7,6223,6235,6107,128,9,0,0,0,295,295,295,295
Mariposa,19,2022-04-24,14,14,14,0,214,214,209,5,0,0,0,0,28,28,28,28
Mendocino,19,2022-04-24,65,65,63,2,1221,1222,1188,34,0,1,1,1,127,127,126,126
Merced,19,2022-04-24,96,96,94,2,2958,2963,2915,48,6,1,1,0,822,822,821,821
Modoc,19,2022-04-24,1,1,1,0,39,39,38,1,0,0,0,0,7,7,7,7
Mono,19,2022-04-24,3,3,3,0,93,93,90,3,0,0,0,0,6,6,6,6
Monterey,19,2022-04-24,302,302,292,10,7578,7592,7341,251,3,2,2,1,732,732,730,730
Napa,19,2022-04-24,206,206,203,3,3357,3362,3314,48,1,0,0,0,143,143,143,143
Nevada,19,2022-04-24,52,52,51,1,1371,1372,1343,29,1,0,0,0,128,128,128,128
Orange,19,2022-04-24,1912,1916,1893,23,85020,85173,84118,1055,55,9,9,14,7085,7085,7076,7076
Placer,19,2022-04-24,222,222,217,5,5840,5852,5718,134,20,0,0,5,627,627,627,627
Plumas,19,2022-04-24,0,0,0,0,239,239,234,5,0,0,0,0,13,13,13,13
Riverside,19,2022-04-24,1243,1243,1223,20,39812,39883,39222,661,36,3,3,6,6459,6459,6456,6456
Sacramento,19,2022-04-24,969,969,952,17,31346,31403,30843,560,40,5,5,7,3064,3064,3059,3059
San Benito,19,2022-04-24,33,33,33,0,1142,1143,1126,17,0,0,0,0,94,94,94,94
San Bernardino,19,2022-04-24,1297,1297,1280,17,42737,42813,42239,574,23,8,8,5,7815,7815,7807,7807
San Diego,19,2022-04-24,2878,2884,2868,16,73840,73971,73556,415,85,5,5,13,5323,5323,5318,5318
San Francisco,19,2022-04-24,1866,1870,1803,67,31518,31574,30439,1135,29,1,1,2,870,870,869,869
San Joaquin,19,2022-04-24,357,357,350,7,15352,15378,15074,304,11,0,0,2,2248,2248,2248,2248
San Luis Obispo,19,2022-04-24,202,202,199,3,5051,5059,4982,77,4,0,0,0,481,481,481,481
San Mateo,19,2022-04-24,1438,1438,1420,18,32143,32201,31799,402,15,1,1,4,707,707,706,706
Santa Barbara,19,2022-04-24,361,361,355,6,14812,14838,14585,253,8,0,0,0,691,691,691,691
Santa Clara,19,2022-04-24,2946,2953,2936,17,70038,70163,69746,417,79,3,3,10,2302,2302,2299,2299
Santa Cruz,19,2022-04-24,482,482,475,7,19684,19719,19431,288,2,1,1,0,261,261,260,260
Shasta,19,2022-04-24,48,48,47,1,3104,3109,3053,56,0,0,0,0,562,562,562,562
Siskiyou,19,2022-04-24,10,10,10,0,324,324,319,5,0,0,0,0,83,83,83,83
Solano,19,2022-04-24,433,433,426,7,10303,10322,10150,172,9,0,0,2,448,448,448,448
Sonoma,19,2022-04-24,648,648,638,10,11859,11879,11686,193,18,0,0,2,491,491,491,491
Stanislaus,19,2022-04-24,219,219,214,5,7713,7727,7528,199,23,3,3,0,1693,1693,1690,1690
Sutter,19,2022-04-24,35,35,34,1,1350,1350,1327,23,0,1,1,0,226,226,225,225
Tehama,19,2022-04-24,14,14,14,0,697,697,680,17,1,0,0,0,206,206,206,206
Trinity,19,2022-04-24,2,2,2,0,73,73,71,2,0,0,0,0,20,20,20,20
Tulare,19,2022-04-24,77,77,75,2,7025,7039,6854,185,12,0,0,0,1491,1491,1491,1491
Tuolumne,19,2022-04-24,36,36,35,1,1124,1124,1100,24,1,1,1,0,187,187,186,186
Ventura,19,2022-04-24,589,589,582,7,18903,18937,18720,217,15,3,3,2,1501,1501,1498,1498
Yolo,19,2022-04-24,280,280,276,4,19551,19586,19293,293,1,0,0,0,322,322,322,322
Yuba,19,2022-04-24,33,33,32,1,1116,1116,1098,18,0,0,0,0,118,118,118,118
Alameda,20,2022-05-01,3243,3250,3217,33,69243,69373,68647,726,45,2,2,4,1878,1878,1876,1876
Amador,20,2022-05-01,28,28,28,0,1335,1336,1313,23,0,0,0,0,86,86,86,86
Butte,20,2022-05-01,80,80,79,1,2456,2461,2440,21,4,2,2,0,434,434,432,432
Calaveras,20,2022-05-01,28,28,28,0,729,729,718,11,0,0,0,0,120,120,120,120
Colusa,20,2022-05-01,3,3,3,0,211,211,208,3,0,0,0,0,21,21,21,21
Contra Costa,20,2022-05-01,1800,1801,1770,31,28901,28957,28454,503,39,3,3,5,1305,1305,1302,1302
Del Norte,20,2022-05-01,41,41,40,1,1200,1200,1184,16,0,0,0,0,49,49,49,49
El Dorado,20,2022-05-01,123,123,121,2,2727,2732,2692,40,1,1,1,0,214,214,213,213
Fresno,20,2022-05-01,472,472,464,8,16829,16860,16584,276,35,3,3,4,2769,2769,2766,2766
Glenn,20,2022-05-01,4,4,4,0,261,261,257,4,0,0,0,0,42,42,42,42
Humboldt,20,2022-05-01,229,229,226,3,2944,2949,2909,40,6,0,0,2,146,146,146,146
Imperial,20,2022-05-01,110,110,108,2,3648,3655,3600,55,1,0,0,1,945,945,945,945
Inyo,20,2022-05-01,5,5,5,0,207,207,204,3,0,0,0,0,56,56,56,56
Kern,20,2022-05-01,280,280,277,3,17960,17994,17774,220,12,0,0,5,2345,2345,2345,2345
Kings,20,2022-05-01,46,46,45,1,4713,4722,4653,69,4,0,0,1,447,447,447,447
Lake,20,2022-05-01,30,30,29,1,1014,1014,997,17,1,0,0,0,140,140,140,140
Lassen,20,2022-05-01,9,9,9,0,1614,1616,1597,19,0,0,0,0,62,62,62,62
Los Angeles,20,2022-05-01,14205,14230,14172,58,926152,927887,924008,3879,201,25,25,24,31916,31916,31891,31891
Madera,20,2022-05-01,72,72,71,1,3285,3291,3237,54,4,0,0,1,368,368,368,368
Marin,20,2022-05-01,394,394,388,6,6443,6456,6352,104,10,0,0,0,295,295,295,295
Mariposa,20,2022-05-01,9,9,9,0,240,240,236,4,0,0,0,0,28,28,28,28
Mendocino,20,2022-05-01,46,46,45,1,1269,1269,1241,28,0,0,0,0,127,127,127,127
Merced,20,2022-05-01,120,120,119,1,3248,3253,3212,41,7,3,3,0,825,825,822,822
Modoc,20,2022-05-01,0,0,0,0,41,41,40,1,0,0,0,0,7,7,7,7
Mono,20,2022-05-01,5,5,5,0,85,85,83,2,0,0,0,0,6,6,6,6
Monterey,20,2022-05-01,328,328,320,8,8305,8321,8104,217,8,1,1,0,733,733,732,732
Napa,20,2022-05-01,220,220,218,2,3522,3527,3488,39,5,0,0,0,143,143,143,143
Nevada,20,2022-05-01,77,77,76,1,1506,1508,1483,25,2,0,0,0,128,128,128,128
Orange,20,2022-05-01,2503,2510,2486,24,88090,88256,87400,856,67,5,5,14,7090,7090,7085,7085
Placer,20,2022-05-01,285,285,280,5,6226,6239,6127,112,24,0,0,5,627,627,627,627
Plumas,20,2022-05-01,10,10,10,0,252,252,248,4,0,0,0,0,13,13,13,13
Riverside,20,2022-05-01,1860,1864,1840,24,42309,42388,41838,550,31,5,5,6,6464,6464,6459,6459
Sacramento,20,2022-05-01,1260,1260,1243,17,32807,32869,32410,459,43,5,5,10,3069,3069,3064,3064
San Benito,20,2022-05-01,47,47,46,1,1229,1229,1215,14,0,0,0,0,94,94,94,94
San Bernardino,20,2022-05-01,1405,1405,1391,14,43193,43274,42821,453,26,8,8,10,7823,7823,7815,7815
San Diego,20,2022-05-01,3880,3887,3870,17,71345,71478,71164,314,71,3,3,13,5326,5326,5323,5323
San Francisco,20,2022-05-01,2364,2370,2304,66,35274,35339,34341,998,38,1,1,6,871,871,870,870
San Joaquin,20,2022-05-01,488,488,481,7,15284,15314,15078,236,12,1,1,3,2249,2249,2248,2248
San Luis Obispo,20,2022-05-01,253,253,250,3,5142,5153,5091,62,8,2,2,0,483,483,481,481
San Mateo,20,2022-05-01,1741,1744,1727,17,36111,36179,35826,353,22,2,2,2,709,709,707,707
Santa Barbara,20,2022-05-01,404,404,399,5,15560,15590,15381,209,8,2,2,2,693,693,691,691
Santa Clara,20,2022-05-01,4071,4078,4059,19,95745,95924,95477,447,85,4,4,18,2306,2306,2302,2302
Santa Cruz,20,2022-05-01,639,639,632,7,22127,22168,21914,254,2,0,0,0,261,261,261,261
Shasta,20,2022-05-01,63,63,62,1,3397,3403,3355,48,8,0,0,1,562,562,562,562
Siskiyou,20,2022-05-01,10,10,10,0,324,324,320,4,0,0,0,0,83,83,83,83
Solano,20,2022-05-01,598,598,590,8,11551,11573,11422,151,9,0,0,2,448,448,448,448
Sonoma,20,2022-05-01,814,814,804,10,12448,12471,12312,159,14,1,1,3,492,492,491,491
Stanislaus,20,2022-05-01,265,265,260,5,8206,8221,8055,166,18,0,0,3,1693,1693,1693,1693
Sutter,20,2022-05-01,48,48,47,1,1258,1259,1242,17,0,1,1,0,227,227,226,226
Tehama,20,2022-05-01,20,20,20,0,698,698,684,14,0,0,0,0,206,206,206,206
Trinity,20,2022-05-01,1,1,1,0,88,88,86,2,0,0,0,0,20,20,20,20
Tulare,20,2022-05-01,157,157,154,3,7167,7181,7033,148,11,3,3,0,1494,1494,1491,1491
Tuolumne,20,2022-05-01,86,86,85,1,1229,1229,1209,20,5,0,0,0,187,187,187,187
Ventura,20,2022-05-01,683,683,677,6,19434,19471,19297,174,15,3,3,2,1504,1504,1501,1501
Yolo,20,2022-05-01,328,328,324,4,18973,19009,18786,223,1,1,1,0,323,323,322,322
Yuba,20,2022-05-01,41,41,41,0,1062,1062,1049,13,1,0,0,1,118,118,118,118
Alameda,21,2022-05-08,3957,3964,3932,32,70333,70472,69899,573,61,5,5,6,1883,1883,1878,1878
Amador,21,2022-05-08,14,14,14,0,1428,1430,1411,19,0,0,0,0,86,86,86,86
Butte,21,2022-05-08,119,119,118,1,2403,2408,2392,16,4,0,0,0,434,434,434,434
Calaveras,21,2022-05-08,30,30,30,0,691,691,683,8,1,0,0,0,120,120,120,120
Colusa,21,2022-05-08,2,2,2,0,216,216,214,2,0,0,0,0,21,21,21,21
Contra Costa,21,2022-05-08,2387,2392,2360,32,30517,30577,30162,415,34,4,4,12,1309,1309,1305,1305
Del Norte,21,2022-05-08,41,41,41,0,1230,1230,1217,13,0,0,0,0,49,49,49,49
El Dorado,21,2022-05-08,170,170,168,2,2819,2824,2792,32,4,0,0,0,214,214,214,214
Fresno,21,2022-05-08,678,678,669,9,17894,17929,17699,230,33,2,2,2,2771,2771,2769,2769
Glenn,21,2022-05-08,6,6,6,0,231,231,228,3,0,0,0,0,42,42,42,42
Humboldt,21,2022-05-08,284,284,281,3,3258,3263,3229,34,2,0,0,2,146,146,146,146
Imperial,21,2022-05-08,120,120,119,1,3770,3777,3733,44,0,0,0,1,945,945,945,945
Inyo,21,2022-05-08,20,20,20,0,199,199,197,2,1,0,0,0,56,56,56,56
Kern,21,2022-05-08,435,435,431,4,18462,18498,18322,176,19,1,1,2,2346,2346,2345,2345
Kings,21,2022-05-08,95,95,94,1,4919,4929,4872,57,2,0,0,0,447,447,447,447
Lake,21,2022-05-08,30,30,30,0,1009,1009,996,13,1,0,0,0,140,140,140,140
Lassen,21,2022-05-08,2,2,2,0,1697,1700,1685,15,0,0,0,0,62,62,62,62
Los Angeles,21,2022-05-08,17909,17945,17888,57,917483,919296,916302,2994,215,28,28,27,31944,31944,31916,31916
Madera,21,2022-05-08,128,128,126,2,3691,3697,3649,48,3,0,0,0,368,368,368,368
Marin,21,2022-05-08,670,670,662,8,7624,7639,7543,96,10,0,0,1,295,295,295,295
Mariposa,21,2022-05-08,26,26,26,0,268,268,264,4,0,0,0,0,28,28,28,28
Mendocino,21,2022-05-08,92,92,90,2,1220,1221,1200,21,0,1,1,0,128,128,127,127
Merced,21,2022-05-08,182,182,180,2,3422,3427,3393,34,5,1,1,0,826,826,825,825
Modoc,21,2022-05-08,2,2,2,0,41,42,41,1,0,0,0,0,7,7,7,7
Mono,21,2022-05-08,11,11,11,0,127,127,124,3,0,0,0,0,6,6,6,6
Monterey,21,2022-05-08,425,425,416,9,9154,9173,8985,188,9,0,0,0,733,733,733,733
Napa,21,2022-05-08,236,236,234,2,3234,3239,3211,28,3,0,0,0,143,143,143,143
Nevada,21,2022-05-08,96,96,95,1,1625,1628,1607,21,4,0,0,0,128,128,128,128
Orange,21,2022-05-08,3378,3385,3360,25,91111,91292,90602,690,100,7,7,17,7097,7097,7090,7090
Placer,21,2022-05-08,493,493,486,7,6714,6727,6633,94,27,0,0,3,627,627,627,627
Plumas,21,2022-05-08,10,10,10,0,275,275,271,4,0,0,0,0,13,13,13,13
Riverside,21,2022-05-08,2370,2376,2352,24,44939,45030,44574,456,35,4,4,8,6468,6468,6464,6464
Sacramento,21,2022-05-08,2063,2069,2047,22,36550,36623,36223,400,63,3,3,10,3072,3072,3069,3069
San Benito,21,2022-05-08,66,66,65,1,1435,1437,1424,13,0,0,0,0,94,94,94,94
San Bernardino,21,2022-05-08,1818,1823,1808,15,45661,45751,45377,374,35,6,6,4,7829,7829,7823,7823
San Diego,21,2022-05-08,5077,5087,5070,17,86573,86743,86446,297,85,3,3,12,5329,5329,5326,5326
San Francisco,21,2022-05-08,2879,2886,2823,63,37566,37641,36808,833,51,8,8,7,879,879,871,871
San Joaquin,21,2022-05-08,731,731,722,9,15807,15839,15649,190,13,0,0,2,2249,2249,2249,2249
San Luis Obispo,21,2022-05-08,290,290,287,3,5210,5221,5172,49,0,0,0,0,483,483,483,483
San Mateo,21,2022-05-08,2203,2209,2193,16,36885,36956,36675,281,25,1,1,1,710,710,709,709
Santa Barbara,21,2022-05-08,608,608,602,6,15352,15382,15221,161,9,0,0,2,693,693,693,693
Santa Clara,21,2022-05-08,5473,5485,5465,20,102979,103184,102809,375,82,2,2,25,2308,2308,2306,2306
Santa Cruz,21,2022-05-08,701,701,695,6,22964,23009,22803,206,4,1,1,0,262,262,261,261
Shasta,21,2022-05-08,94,94,93,1,3451,3457,3419,38,3,0,0,2,562,562,562,562
Siskiyou,21,2022-05-08,15,15,15,0,285,285,282,3,0,0,0,0,83,83,83,83
Solano,21,2022-05-08,875,875,866,9,12359,12383,12257,126,18,0,0,0,448,448,448,448
Sonoma,21,2022-05-08,1180,1180,1168,12,13973,13999,13860,139,0,1,1,23,493,493,492,492
Stanislaus,21,2022-05-08,407,407,401,6,8752,8769,8631,138,25,0,0,1,1693,1693,1693,1693
Sutter,21,2022-05-08,48,48,48,0,1543,1545,1529,16,0,0,0,0,227,227,227,227
Tehama,21,2022-05-08,23,23,23,0,685,685,675,10,1,0,0,0,206,206,206,206
Trinity,21,2022-05-08,3,3,3,0,68,68,67,1,0,0,0,0,20,20,20,20
Tulare,21,2022-05-08,175,175,172,3,7577,7592,7470,122,13,2,2,0,1496,1496,1494,1494
Tuolumne,21,2022-05-08,77,77,76,1,1319,1321,1304,17,2,1,1,0,188,188,187,187
Ventura,21,2022-05-08,1086,1086,1079,7,21159,21202,21054,148,12,0,0,2,1504,1504,1504,1504
Yolo,21,2022-05-08,452,452,448,4,19673,19712,19532,180,1,0,0,1,323,323,323,323
Yuba,21,2022-05-08,65,65,64,1,1198,1198,1186,12,2,0,0,0,118,118,118,118
Alameda,22,2022-05-15,4798,4809,4779,30,74414,74568,74094,474,65,7,7,4,1890,1890,1883,1883
Amador,22,2022-05-15,49,49,48,1,1684,1688,1670,18,1,0,0,0,86,86,86,86
Butte,22,2022-05-15,170,170,169,1,2633,2638,2624,14,5,2,2,1,436,436,434,434
Calaveras,22,2022-05-15,31,31,31,0,764,764,757,7,1,1,1,1,121,121,120,120
Colusa,22,2022-05-15,5,5,5,0,213,213,211,2,0,0,0,0,21,21,21,21
Contra Costa,22,2022-05-15,3229,3236,3202,34,32682,32750,32402,348,48,4,4,8,1313,1313,1309,1309
Del Norte,22,2022-05-15,116,116,115,1,1750,1755,1740,15,0,0,0,0,49,49,49,49
El Dorado,22,2022-05-15,244,244,242,2,3057,3062,3035,27,6,0,0,1,214,214,214,214
Fresno,22,2022-05-15,1034,1034,1024,10,19084,19124,18933,191,45,2,2,4,2773,2773,2771,2771
Glenn,22,2022-05-15,14,14,14,0,258,258,256,2,0,0,0,0,42,42,42,42
Humboldt,22,2022-05-15,277,277,275,2,3238,3243,3216,27,9,1,1,2,147,147,146,146
Imperial,22,2022-05-15,205,205,203,2,4216,4224,4186,38,3,0,0,1,945,945,945,945
Inyo,22,2022-05-15,22,22,22,0,225,225,223,2,1,0,0,0,56,56,56,56
Kern,22,2022-05-15,598,598,594,4,19796,19838,19691,147,18,4,4,3,2350,2350,2346,2346
Kings,22,2022-05-15,179,179,177,2,5329,5341,5293,48,0,0,0,0,447,447,447,447
Lake,22,2022-05-15,64,64,63,1,1127,1127,1115,12,0,0,0,0,140,140,140,140
Lassen,22,2022-05-15,16,16,16,0,1682,1685,1673,12,0,0,0,0,62,62,62,62
Los Angeles,22,2022-05-15,20449,20492,20441,51,938028,939973,937585,2388,268,38,38,44,31982,31982,31944,31944
Madera,22,2022-05-15,179,179,177,2,3632,3638,3601,37,2,0,0,0,368,368,368,368
Marin,22,2022-05-15,766,766,759,7,8192,8208,8127,81,12,0,0,0,295,295,295,295
Mariposa,22,2022-05-15,25,25,25,0,351,351,347,4,0,0,0,0,28,28,28,28
Mendocino,22,2022-05-15,98,98,97,1,1347,1348,1330,18,0,1,1,3,129,129,128,128
Merced,22,2022-05-15,281,281,279,2,3865,3872,3842,30,9,2,2,1,828,828,826,826
Modoc,22,2022-05-15,3,3,3,0,43,44,43,1,0,0,0,0,7,7,7,7
Mono,22,2022-05-15,9,9,9,0,109,109,107,2,0,0,0,0,6,6,6,6
Monterey,22,2022-05-15,493,493,485,8,9568,9588,9435,153,7,1,1,0,734,734,733,733
Napa,22,2022-05-15,285,285,283,2,3502,3507,3483,24,2,0,0,0,143,143,143,143
Nevada,22,2022-05-15,140,140,139,1,1850,1855,1836,19,1,0,0,0,128,128,128,128
Orange,22,2022-05-15,4280,4287,4262,25,93965,94161,93606,555,74,8,8,13,7105,7105,7097,7097
Placer,22,2022-05-15,672,672,665,7,7462,7478,7396,82,40,1,1,3,628,628,627,627
Plumas,22,2022-05-15,46,46,46,0,257,257,254,3,1,0,0,0,13,13,13,13
Riverside,22,2022-05-15,3098,3105,3081,24,46934,47031,46659,372,49,1,1,8,6469,6469,6468,6468
Sacramento,22,2022-05-15,2917,2924,2899,25,39044,39124,38791,333,86,8,8,15,3080,3080,3072,3072
San Benito,22,2022-05-15,100,100,99,1,1542,1546,1535,11,0,0,0,1,94,94,94,94
San Bernardino,22,2022-05-15,2355,2362,2347,15,48496,48596,48286,310,40,7,7,4,7836,7836,7829,7829
San Diego,22,2022-05-15,6201,6213,6197,16,92830,93022,92774,248,87,5,5,23,5334,5334,5329,5329
San Francisco,22,2022-05-15,3339,3346,3288,58,38737,38818,38143,675,51,5,5,6,884,884,879,879
San Joaquin,22,2022-05-15,1146,1146,1135,11,18155,18191,18020,171,12,1,1,1,2250,2250,2249,2249
San Luis Obispo,22,2022-05-15,369,369,366,3,5774,5787,5745,42,4,0,0,0,483,483,483,483
San Mateo,22,2022-05-15,2681,2688,2672,16,39718,39799,39563,236,37,3,3,1,713,713,710,710
Santa Barbara,22,2022-05-15,816,816,809,7,16588,16621,16486,135,10,0,0,2,693,693,693,693
Santa Clara,22,2022-05-15,6822,6836,6817,19,110548,110778,110464,314,95,10,10,20,2318,2318,2308,2308
Santa Cruz,22,2022-05-15,883,883,877,6,24927,24980,24806,174,4,0,0,1,262,262,262,262
Shasta,22,2022-05-15,115,115,114,1,3765,3773,3741,32,5,0,0,1,562,562,562,562
Siskiyou,22,2022-05-15,20,20,20,0,392,392,389,3,0,0,0,0,83,83,83,83
Solano,22,2022-05-15,1120,1120,1111,9,13605,13632,13524,108,24,0,0,2,448,448,448,448
Sonoma,22,2022-05-15,1461,1462,1451,11,15251,15283,15164,119,24,0,0,5,493,493,493,493
Stanislaus,22,2022-05-15,680,680,672,8,9812,9832,9711,121,31,1,1,6,1694,1694,1693,1693
Sutter,22,2022-05-15,103,103,102,1,1756,1761,1747,14,0,0,0,0,227,227,227,227
Tehama,22,2022-05-15,26,26,26,0,809,809,799,10,1,1,1,2,207,207,206,206
Trinity,22,2022-05-15,5,5,5,0,66,66,65,1,0,0,0,0,20,20,20,20
Tulare,22,2022-05-15,330,330,326,4,7848,7865,7766,99,11,1,1,1,1497,1497,1496,1496
Tuolumne,22,2022-05-15,98,98,97,1,1462,1464,1449,15,2,1,1,0,189,189,188,188
Ventura,22,2022-05-15,1443,1443,1435,8,23190,23238,23112,126,22,1,1,3,1505,1505,1504,1504
Yolo,22,2022-05-15,680,680,675,5,21609,21654,21500,154,1,0,0,0,323,323,323,323
Yuba,22,2022-05-15,107,107,106,1,1270,1270,1260,10,4,0,0,0,118,118,118,118
Alameda,23,2022-05-22,5584,5596,5568,28,76383,76549,76169,380,78,5,5,5,1895,1895,1890,1890
Amador,23,2022-05-22,79,79,78,1,1558,1562,1549,13,0,0,0,0,86,86,86,86
Butte,23,2022-05-22,290,290,289,1,2731,2736,2725,11,8,1,1,0,437,437,436,436
Calaveras,23,2022-05-22,60,60,60,0,757,757,752,5,0,1,1,0,122,122,121,121
Colusa,23,2022-05-22,6,6,6,0,224,224,223,1,0,0,0,0,21,21,21,21
Contra Costa,23,2022-05-22,3868,3876,3844,32,35076,35153,34861,292,64,10,10,8,1323,1323,1313,1313
Del Norte,23,2022-05-22,121,121,120,1,1578,1580,1570,10,1,1,1,0,50,50,49,49
El Dorado,23,2022-05-22,344,344,342,2,3355,3360,3337,23,6,2,2,0,216,216,214,214
Fresno,23,2022-05-22,1555,1559,1547,12,21176,21223,21057,166,52,1,1,8,2774,2774,2773,2773
Glenn,23,2022-05-22,19,19,19,0,269,269,267,2,0,0,0,0,42,42,42,42
Humboldt,23,2022-05-22,241,241,239,2,2871,2876,2858,18,10,1,1,5,148,148,147,147
Imperial,23,2022-05-22,309,309,307,2,4728,4739,4705,34,2,0,0,2,945,945,945,945
Inyo,23,2022-05-22,23,23,23,0,239,239,238,1,0,0,0,0,56,56,56,56
Kern,23,2022-05-22,944,944,939,5,20651,20695,20575,120,32,0,0,6,2350,2350,2350,2350
Kings,23,2022-05-22,247,247,245,2,5597,5610,5571,39,0,0,0,0,447,447,447,447
Lake,23,2022-05-22,81,81,80,1,1250,1253,1243,10,0,0,0,2,140,140,140,140
Lassen,23,2022-05-22,34,34,34,0,1733,1737,1727,10,0,0,0,0,62,62,62,62
Los Angeles,23,2022-05-22,26567,26625,26573,52,942490,944535,942665,1870,338,29,29,53,32011,32011,31982,31982
Madera,23,2022-05-22,210,210,208,2,3717,3724,3695,29,0,0,0,1,368,368,368,368
Marin,23,2022-05-22,824,824,818,6,8898,8916,8848,68,13,0,0,1,295,295,295,295
Mariposa,23,2022-05-22,33,33,33,0,338,338,335,3,0,0,0,0,28,28,28,28
Mendocino,23,2022-05-22,141,141,140,1,1613,1616,1599,17,3,1,1,1,130,130,129,129
Merced,23,2022-05-22,415,415,413,2,4131,4140,4115,25,4,0,0,0,828,828,828,828
Modoc,23,2022-05-22,2,2,2,0,39,40,39,1,0,0,0,0,7,7,7,7
Mono,23,2022-05-22,16,16,16,0,163,163,161,2,0,0,0,0,6,6,6,6
Monterey,23,2022-05-22,648,648,640,8,9656,9676,9555,121,14,1,1,1,735,735,734,734
Napa,23,2022-05-22,316,316,314,2,4037,4047,4026,21,5,0,0,0,143,143,143,143
Nevada,23,2022-05-22,146,146,145,1,1830,1834,1820,14,1,0,0,0,128,128,128,128
Orange,23,2022-05-22,5417,5429,5404,25,95566,95774,95333,441,104,9,9,22,7114,7114,7105,7105
Placer,23,2022-05-22,901,901,893,8,7944,7962,7894,68,36,3,3,5,631,631,628,628
Plumas,23,2022-05-22,45,45,45,0,259,259,257,2,0,0,0,0,13,13,13,13
Riverside,23,2022-05-22,4303,4312,4286,26,51266,51378,51061,317,69,5,5,11,6474,6474,6469,6469
Sacramento,23,2022-05-22,3785,3793,3768,25,41058,41148,40874,274,104,7,7,12,3087,3087,3080,3080
San Benito,23,2022-05-22,161,161,160,1,1558,1563,1555,8,0,0,0,0,94,94,94,94
San Bernardino,23,2022-05-22,3158,3165,3149,16,49653,49761,49513,248,48,4,4,8,7840,7840,7836,7836
San Diego,23,2022-05-22,8732,8751,8733,18,102238,102461,102248,213,121,2,2,21,5336,5336,5334,5334
San Francisco,23,2022-05-22,3626,3635,3586,49,41583,41674,41108,566,81,6,6,11,890,890,884,884
San Joaquin,23,2022-05-22,1477,1482,1471,11,20551,20596,20445,151,19,3,3,9,2253,2253,2250,2250
San Luis Obispo,23,2022-05-22,640,640,636,4,7083,7098,7058,40,11,3,3,0,486,486,483,483
San Mateo,23,2022-05-22,3085,3092,3078,14,40520,40607,40419,188,35,0,0,2,713,713,713,713
Santa Barbara,23,2022-05-22,1062,1062,1055,7,17941,17980,17866,114,17,0,0,3,693,693,693,693
Santa Clara,23,2022-05-22,7758,7775,7758,17,111795,112036,111788,248,109,7,7,22,2325,2325,2318,2318
Santa Cruz,23,2022-05-22,519,519,516,3,7963,7981,7938,43,13,0,0,2,262,262,262,262
Shasta,23,2022-05-22,189,189,188,1,3550,3558,3534,24,4,1,1,3,563,563,562,562
Siskiyou,23,2022-05-22,22,22,22,0,346,346,344,2,1,0,0,0,83,83,83,83
Solano,23,2022-05-22,1537,1541,1531,10,14781,14813,14721,92,24,1,1,3,449,449,448,448
Sonoma,23,2022-05-22,1524,1527,1518,9,16386,16422,16323,99,34,2,2,3,495,495,493,493
Stanislaus,23,2022-05-22,862,862,854,8,10407,10429,10329,100,36,3,3,5,1697,1697,1694,1694
Sutter,23,2022-05-22,138,138,137,1,1805,1810,1798,12,0,1,1,0,228,228,227,227
Tehama,23,2022-05-22,58,58,57,1,815,815,807,8,0,0,0,1,207,207,207,207
Trinity,23,2022-05-22,4,4,4,0,89,89,88,1,0,0,0,0,20,20,20,20
Tulare,23,2022-05-22,547,547,542,5,9064,9085,8995,90,24,0,0,0,1497,1497,1497,1497
Tuolumne,23,2022-05-22,171,171,170,1,1607,1610,1597,13,0,1,1,0,190,190,189,189
Ventura,23,2022-05-22,1916,1921,1913,8,24188,24241,24138,103,36,2,2,2,1507,1507,1505,1505
Yolo,23,2022-05-22,723,723,719,4,22717,22766,22639,127,0,0,0,0,323,323,323,323
Yuba,23,2022-05-22,157,157,156,1,1442,1445,1436,9,5,0,0,1,118,118,118,118
Alameda,24,2022-05-29,5499,5511,5490,21,73134,73301,73016,285,91,4,4,11,1899,1899,1895,1895
Amador,24,2022-05-29,100,100,99,1,1280,1282,1274,8,0,1,1,0,87,87,86,86
Butte,24,2022-05-29,311,311,310,1,3137,3143,3133,10,13,0,0,1,437,437,437,437
Calaveras,24,2022-05-29,54,54,54,0,720,720,716,4,0,0,0,0,122,122,122,122
Colusa,24,2022-05-29,16,16,16,0,208,208,207,1,0,0,0,0,21,21,21,21
Contra Costa,24,2022-05-29,3697,3706,3682,24,34214,34292,34069,223,70,7,7,8,1330,1330,1323,1323
Del Norte,24,2022-05-29,50,50,50,0,1132,1134,1128,6,1,1,1,1,51,51,50,50
El Dorado,24,2022-05-29,383,383,381,2,3425,3432,3413,19,4,2,2,1,218,218,216,216
Fresno,24,2022-05-29,1876,1881,1870,11,22373,22424,22287,137,57,6,6,9,2780,2780,2774,2774
Glenn,24,2022-05-29,32,32,32,0,323,323,321,2,2,0,0,0,42,42,42,42
Humboldt,24,2022-05-29,215,215,214,1,2799,2804,2790,14,10,0,0,5,148,148,148,148
Imperial,24,2022-05-29,364,364,362,2,4918,4929,4902,27,2,0,0,2,945,945,945,945
Inyo,24,2022-05-29,25,25,25,0,191,191,190,1,0,0,0,0,56,56,56,56
Kern,24,2022-05-29,1215,1216,1211,5,21091,21139,21043,96,32,0,0,4,2350,2350,2350,2350
Kings,24,2022-05-29,327,327,325,2,5331,5343,5314,29,2,0,0,1,447,447,447,447
Lake,24,2022-05-29,112,112,111,1,1153,1155,1148,7,1,0,0,0,140,140,140,140
Lassen,24,2022-05-29,62,62,62,0,1925,1930,1922,8,1,0,0,0,62,62,62,62
Los Angeles,24,2022-05-29,29723,29791,29745,46,926044,928150,926714,1436,434,43,43,52,32054,32054,32011,32011
Madera,24,2022-05-29,258,258,256,2,3751,3762,3739,23,5,0,0,1,368,368,368,368
Marin,24,2022-05-29,724,724,720,4,8211,8230,8181,49,17,3,3,1,298,298,295,295
Mariposa,24,2022-05-29,38,38,38,0,344,344,342,2,0,0,0,0,28,28,28,28
Mendocino,24,2022-05-29,144,144,143,1,1442,1444,1432,12,4,0,0,1,130,130,130,130
Merced,24,2022-05-29,428,428,426,2,4109,4118,4099,19,7,0,0,2,828,828,828,828
Modoc,24,2022-05-29,5,5,5,0,44,45,44,1,0,0,0,0,7,7,7,7
Mono,24,2022-05-29,6,6,6,0,107,107,106,1,0,0,0,0,6,6,6,6
Monterey,24,2022-05-29,618,618,612,6,8821,8840,8754,86,14,1,1,1,736,736,735,735
Napa,24,2022-05-29,357,357,356,1,3765,3774,3758,16,4,0,0,0,143,143,143,143
Nevada,24,2022-05-29,200,200,199,1,1966,1971,1959,12,2,2,2,0,130,130,128,128
Orange,24,2022-05-29,6104,6116,6094,22,95041,95257,94915,342,118,10,10,19,7124,7124,7114,7114
Placer,24,2022-05-29,836,836,830,6,7308,7324,7275,49,51,0,0,7,631,631,631,631
Plumas,24,2022-05-29,35,35,35,0,262,262,260,2,1,0,0,0,13,13,13,13
Riverside,24,2022-05-29,4325,4336,4315,21,51767,51885,51634,251,86,4,4,10,6478,6478,6474,6474
Sacramento,24,2022-05-29,4179,4190,4168,22,39179,39268,39063,205,123,7,7,16,3094,3094,3087,3087
San Benito,24,2022-05-29,179,179,178,1,1555,1559,1552,7,0,0,0,0,94,94,94,94
San Bernardino,24,2022-05-29,3773,3781,3766,15,49697,49811,49617,194,50,4,4,10,7844,7844,7840,7840
San Diego,24,2022-05-29,9302,9324,9309,15,99262,99487,99325,162,150,11,11,24,5347,5347,5336,5336
San Francisco,24,2022-05-29,3376,3384,3348,36,38071,38160,37754,406,85,8,8,9,898,898,890,890
San Joaquin,24,2022-05-29,1532,1537,1528,9,19728,19773,19659,114,28,0,0,5,2253,2253,2253,2253
San Luis Obispo,24,2022-05-29,749,749,746,3,6742,6758,6728,30,13,1,1,0,487,487,486,486
San Mateo,24,2022-05-29,3039,3046,3035,11,37585,37671,37534,137,39,2,2,1,715,715,713,713
Santa Barbara,24,2022-05-29,1133,1135,1129,6,17147,17186,17101,85,28,1,1,6,694,694,693,693
Santa Clara,24,2022-05-29,7629,7646,7633,13,99647,99873,99700,173,150,10,10,20,2335,2335,2325,2325
Santa Cruz,24,2022-05-29,544,544,542,2,7440,7457,7425,32,8,1,1,0,263,263,262,262
Shasta,24,2022-05-29,169,169,168,1,3566,3574,3555,19,5,3,3,4,566,566,563,563
Siskiyou,24,2022-05-29,59,59,59,0,386,386,384,2,3,0,0,0,83,83,83,83
Solano,24,2022-05-29,1401,1404,1397,7,14047,14077,14008,69,33,0,0,5,449,449,449,449
Sonoma,24,2022-05-29,1393,1395,1388,7,15611,15647,15573,74,37,2,2,5,497,497,495,495
Stanislaus,24,2022-05-29,875,875,868,7,10356,10380,10302,78,59,2,2,4,1699,1699,1697,1697
Sutter,24,2022-05-29,166,166,165,1,1969,1973,1963,10,0,0,0,0,228,228,228,228
Tehama,24,2022-05-29,60,60,60,0,879,879,873,6,2,0,0,0,207,207,207,207
Trinity,24,2022-05-29,7,7,7,0,100,100,99,1,0,0,0,0,20,20,20,20
Tulare,24,2022-05-29,618,618,613,5,9064,9086,9016,70,22,0,0,0,1497,1497,1497,1497
Tuolumne,24,2022-05-29,126,126,125,1,1531,1535,1526,9,3,0,0,0,190,190,190,190
Ventura,24,2022-05-29,1886,1891,1885,6,22918,22970,22894,76,33,1,1,3,1508,1508,1507,1507
Yolo,24,2022-05-29,686,686,683,3,20811,20858,20767,91,2,0,0,2,323,323,323,323
Yuba,24,2022-05-29,155,155,154,1,1446,1450,1443,7,11,0,0,0,118,118,118,118
Alameda,25,2022-06-05,5897,5910,5892,18,64507,64663,64470,193,103,4,4,14,1903,1903,1899,1899
Amador,25,2022-06-05,82,82,82,0,1597,1601,1593,8,1,0,0,1,87,87,87,87
Butte,25,2022-06-05,389,389,388,1,3197,3206,3198,8,22,1,1,1,438,438,437,437
Calaveras,25,2022-06-05,68,68,68,0,618,618,615,3,0,2,2,0,124,124,122,122
Colusa,25,2022-06-05,17,17,17,0,235,235,234,1,3,0,0,0,21,21,21,21
Contra Costa,25,2022-06-05,3866,3876,3857,19,31361,31436,31278,158,102,8,8,12,1338,1338,1330,1330
Del Norte,25,2022-06-05,54,54,54,0,1108,1109,1105,4,2,0,0,0,51,51,51,51
El Dorado,25,2022-06-05,362,362,360,2,3153,3162,3149,13,7,0,0,3,218,218,218,218
Fresno,25,2022-06-05,2105,2110,2100,10,20343,20392,20296,96,95,2,2,6,2782,2782,2780,2780
Glenn,25,2022-06-05,39,39,39,0,290,290,289,1,3,0,0,0,42,42,42,42
Humboldt,25,2022-06-05,232,232,231,1,2590,2594,2584,10,11,1,1,2,149,149,148,148
Imperial,25,2022-06-05,405,405,403,2,4238,4250,4232,18,5,1,1,0,946,946,945,945
Inyo,25,2022-06-05,17,17,17,0,166,166,165,1,0,0,0,0,56,56,56,56
Kern,25,2022-06-05,1395,1399,1394,5,20251,20299,20228,71,34,0,0,7,2350,2350,2350,2350
Kings,25,2022-06-05,348,348,347,1,4895,4908,4887,21,7,0,0,1,447,447,447,447
Lake,25,2022-06-05,126,126,125,1,1022,1023,1018,5,3,0,0,2,140,140,140,140
Lassen,25,2022-06-05,65,65,65,0,2011,2015,2008,7,1,0,0,0,62,62,62,62
Los Angeles,25,2022-06-05,31269,31344,31307,37,886498,888629,887574,1055,467,43,43,63,32097,32097,32054,32054
Madera,25,2022-06-05,312,312,311,1,3579,3588,3571,17,6,0,0,0,368,368,368,368
Marin,25,2022-06-05,691,691,688,3,7092,7108,7075,33,10,1,1,3,299,299,298,298
Mariposa,25,2022-06-05,61,61,61,0,366,366,364,2,0,0,0,0,28,28,28,28
Mendocino,25,2022-06-05,194,194,193,1,1515,1519,1509,10,8,0,0,2,130,130,130,130
Merced,25,2022-06-05,464,464,462,2,3757,3769,3755,14,12,0,0,0,828,828,828,828
Modoc,25,2022-06-05,10,10,10,0,35,36,35,1,0,0,0,0,7,7,7,7
Mono,25,2022-06-05,13,13,13,0,111,111,110,1,0,0,0,0,6,6,6,6
Monterey,25,2022-06-05,905,905,898,7,9021,9044,8976,68,18,1,1,1,737,737,736,736
Napa,25,2022-06-05,442,442,441,1,3436,3445,3434,11,7,1,1,0,144,144,143,143
Nevada,25,2022-06-05,219,219,218,1,1820,1824,1815,9,4,0,0,1,130,130,130,130
Orange,25,2022-06-05,6872,6889,6870,19,65578,65735,65553,182,130,12,12,21,7136,7136,7124,7124
Placer,25,2022-06-05,797,797,793,4,6670,6685,6651,34,67,0,0,11,631,631,631,631
Plumas,25,2022-06-05,39,39,39,0,261,261,260,1,0,0,0,0,13,13,13,13
Riverside,25,2022-06-05,4740,4751,4734,17,48346,48463,48283,180,93,5,5,9,6483,6483,6478,6478
Sacramento,25,2022-06-05,4477,4488,4470,18,37496,37586,37435,151,131,14,14,19,3108,3108,3094,3094
San Benito,25,2022-06-05,233,233,232,1,1749,1752,1746,6,0,0,0,0,94,94,94,94
San Bernardino,25,2022-06-05,4483,4494,4481,13,48119,48235,48090,145,78,5,5,11,7849,7849,7844,7844
San Diego,25,2022-06-05,9635,9658,9646,12,91321,91540,91425,115,187,5,5,26,5352,5352,5347,5347
San Francisco,25,2022-06-05,3357,3366,3338,28,34962,35047,34759,288,73,3,3,8,901,901,898,898
San Joaquin,25,2022-06-05,1849,1853,1845,8,19386,19432,19346,86,35,4,4,9,2257,2257,2253,2253
San Luis Obispo,25,2022-06-05,787,787,784,3,6520,6536,6514,22,11,1,1,1,488,488,487,487
San Mateo,25,2022-06-05,2934,2942,2934,8,32827,32906,32814,92,29,3,3,4,718,718,715,715
Santa Barbara,25,2022-06-05,1183,1185,1180,5,13675,13708,13655,53,16,2,2,6,696,696,694,694
Santa Clara,25,2022-06-05,7884,7904,7894,10,90699,90917,90796,121,163,6,6,19,2341,2341,2335,2335
Santa Cruz,25,2022-06-05,780,780,777,3,7469,7487,7463,24,19,0,0,2,263,263,263,263
Shasta,25,2022-06-05,180,180,179,1,3723,3731,3716,15,9,1,1,1,567,567,566,566
Siskiyou,25,2022-06-05,40,40,40,0,391,391,390,1,2,0,0,0,83,83,83,83
Solano,25,2022-06-05,1438,1442,1437,5,12993,13024,12975,49,38,2,2,1,451,451,449,449
Sonoma,25,2022-06-05,1445,1449,1444,5,12088,12116,12072,44,31,1,1,2,498,498,497,497
Stanislaus,25,2022-06-05,1089,1089,1083,6,9626,9650,9594,56,56,1,1,2,1700,1700,1699,1699
Sutter,25,2022-06-05,194,194,193,1,1821,1826,1819,7,0,0,0,0,228,228,228,228
Tehama,25,2022-06-05,74,74,74,0,914,914,909,5,1,0,0,0,207,207,207,207
Trinity,25,2022-06-05,8,8,8,0,111,111,110,1,0,0,0,0,20,20,20,20
Tulare,25,2022-06-05,758,758,754,4,8926,8948,8895,53,27,0,0,1,1497,1497,1497,1497
Tuolumne,25,2022-06-05,109,109,108,1,1455,1459,1452,7,2,0,0,1,190,190,190,190
Ventura,25,2022-06-05,1764,1768,1764,4,21959,22012,21956,56,45,1,1,2,1509,1509,1508,1508
Yolo,25,2022-06-05,751,751,748,3,18911,18957,18893,64,3,1,1,0,324,324,323,323
Yuba,25,2022-06-05,162,162,161,1,1409,1412,1407,5,9,0,0,0,118,118,118,118
Alameda,26,2022-06-12,5303,5316,5304,12,57289,57434,57299,135,116,5,5,17,1908,1908,1903,1903
Amador,26,2022-06-12,145,145,144,1,1433,1437,1431,6,2,0,0,0,87,87,87,87
Butte,26,2022-06-12,416,416,415,1,3427,3436,3429,7,30,3,3,0,441,441,438,438
Calaveras,26,2022-06-12,71,71,71,0,695,695,693,2,0,0,0,0,124,124,124,124
Colusa,26,2022-06-12,17,17,17,0,276,276,275,1,17,0,0,0,21,21,21,21
Contra Costa,26,2022-06-12,3527,3536,3522,14,29249,29323,29207,116,89,8,8,11,1346,1346,1338,1338
Del Norte,26,2022-06-12,76,76,76,0,651,651,649,2,3,0,0,0,51,51,51,51
El Dorado,26,2022-06-12,347,347,346,1,3386,3394,3383,11,6,3,3,3,221,221,218,218
Fresno,26,2022-06-12,2384,2391,2382,9,20942,20995,20917,78,119,5,5,9,2787,2787,2782,2782
Glenn,26,2022-06-12,36,36,36,0,327,327,326,1,5,0,0,0,42,42,42,42
Humboldt,26,2022-06-12,246,246,245,1,2433,2438,2431,7,16,0,0,2,149,149,149,149
Imperial,26,2022-06-12,465,465,463,2,4544,4556,4541,15,5,1,1,1,947,947,946,946
Inyo,26,2022-06-12,15,15,15,0,207,207,206,1,0,0,0,0,56,56,56,56
Kern,26,2022-06-12,1588,1593,1589,4,21299,21353,21294,59,28,2,2,7,2352,2352,2350,2350
Kings,26,2022-06-12,356,356,355,1,5129,5143,5126,17,6,1,1,0,448,448,447,447
Lake,26,2022-06-12,133,133,132,1,1214,1217,1212,5,1,0,0,0,140,140,140,140
Lassen,26,2022-06-12,67,67,67,0,1992,1996,1991,5,3,0,0,0,62,62,62,62
Los Angeles,26,2022-06-12,31120,31198,31169,29,761068,762987,762268,719,531,50,50,62,32147,32147,32097,32097
Madera,26,2022-06-12,349,349,348,1,4000,4011,3996,15,8,0,0,1,368,368,368,368
Marin,26,2022-06-12,690,690,688,2,6977,6995,6970,25,16,3,3,2,302,302,299,299
Mariposa,26,2022-06-12,41,41,41,0,378,378,376,2,0,0,0,0,28,28,28,28
Mendocino,26,2022-06-12,174,174,173,1,1613,1618,1610,8,7,1,1,1,131,131,130,130
Merced,26,2022-06-12,538,538,536,2,4082,4094,4082,12,16,0,0,2,828,828,828,828
Modoc,26,2022-06-12,8,8,8,0,35,36,35,1,1,1,1,0,8,8,7,7
Mono,26,2022-06-12,18,18,18,0,83,83,82,1,0,0,0,0,6,6,6,6
Monterey,26,2022-06-12,837,837,832,5,8723,8744,8692,52,26,4,4,1,741,741,737,737
Napa,26,2022-06-12,498,498,497,1,4115,4127,4117,10,3,1,1,1,145,145,144,144
Nevada,26,2022-06-12,186,186,185,1,1895,1900,1893,7,6,0,0,0,130,130,130,130
Orange,26,2022-06-12,6983,7002,6987,15,66046,66212,66068,144,186,14,14,20,7150,7150,7136,7136
Placer,26,2022-06-12,818,818,815,3,6985,7003,6974,29,75,2,2,7,633,633,631,631
Plumas,26,2022-06-12,36,36,36,0,286,286,285,1,0,0,0,0,13,13,13,13
Riverside,26,2022-06-12,5035,5047,5032,15,49055,49180,49036,144,95,2,2,10,6485,6485,6483,6483
Sacramento,26,2022-06-12,4331,4342,4328,14,37922,38018,37898,120,151,14,14,25,3122,3122,3108,3108
San Benito,26,2022-06-12,210,210,209,1,1773,1778,1773,5,0,0,0,2,94,94,94,94
San Bernardino,26,2022-06-12,4716,4728,4717,11,49416,49541,49424,117,83,7,7,15,7856,7856,7849,7849
San Diego,26,2022-06-12,9796,9821,9811,10,85647,85864,85780,84,178,12,12,30,5364,5364,5352,5352
San Francisco,26,2022-06-12,3073,3080,3060,20,31694,31775,31569,206,68,9,9,12,910,910,901,901
San Joaquin,26,2022-06-12,1985,1990,1983,7,19294,19343,19276,67,34,6,6,3,2263,2263,2257,2257
San Luis Obispo,26,2022-06-12,686,686,684,2,6184,6200,6183,17,18,0,0,0,488,488,488,488
San Mateo,26,2022-06-12,2676,2683,2677,6,29722,29797,29732,65,44,3,3,2,721,721,718,718
Santa Barbara,26,2022-06-12,950,950,947,3,9881,9907,9877,30,22,1,1,5,697,697,696,696
Santa Clara,26,2022-06-12,7241,7258,7250,8,79833,80035,79951,84,171,9,9,24,2350,2350,2341,2341
Santa Cruz,26,2022-06-12,874,874,872,2,10544,10572,10545,27,23,1,1,1,264,264,263,263
Shasta,26,2022-06-12,213,213,212,1,3529,3536,3525,11,0,2,2,0,569,569,567,567
Siskiyou,26,2022-06-12,47,47,47,0,374,374,373,1,1,0,0,0,83,83,83,83
Solano,26,2022-06-12,1722,1727,1722,5,13269,13302,13263,39,38,0,0,3,451,451,451,451
Sonoma,26,2022-06-12,1360,1363,1359,4,11971,12003,11969,34,35,1,1,5,499,499,498,498
Stanislaus,26,2022-06-12,1130,1130,1125,5,9565,9590,9546,44,59,1,1,6,1701,1701,1700,1700
Sutter,26,2022-06-12,185,185,184,1,1800,1805,1800,5,0,0,0,0,228,228,228,228
Tehama,26,2022-06-12,87,87,87,0,1002,1005,1001,4,3,0,0,0,207,207,207,207
Trinity,26,2022-06-12,8,8,8,0,79,80,79,1,0,0,0,0,20,20,20,20
Tulare,26,2022-06-12,809,809,805,4,9585,9609,9564,45,23,2,2,1,1499,1499,1497,1497
Tuolumne,26,2022-06-12,148,148,147,1,1512,1516,1510,6,2,0,0,0,190,190,190,190
Ventura,26,2022-06-12,1933,1938,1934,4,21105,21158,21115,43,39,5,5,5,1514,1514,1509,1509
Yolo,26,2022-06-12,780,780,778,2,15263,15302,15261,41,2,0,0,0,324,324,324,324
Yuba,26,2022-06-12,200,200,199,1,1467,1472,1468,4,9,0,0,1,118,118,118,118
Alameda,27,2022-06-19,4838,4850,4841,9,50983,51121,51027,94,93,11,11,13,1919,1919,1908,1908
Amador,27,2022-06-19,77,77,77,0,1235,1239,1235,4,1,0,0,0,87,87,87,87
Butte,27,2022-06-19,410,410,409,1,3608,3619,3614,5,25,4,4,0,445,445,441,441
Calaveras,27,2022-06-19,78,78,78,0,616,616,614,2,0,0,0,0,124,124,124,124
Colusa,27,2022-06-19,13,13,13,0,258,258,257,1,18,0,0,0,21,21,21,21
Contra Costa,27,2022-06-19,3236,3245,3235,10,26375,26445,26364,81,68,7,7,7,1353,1353,1346,1346
Del Norte,27,2022-06-19,79,79,79,0,616,616,615,1,2,1,1,1,52,52,51,51
El Dorado,27,2022-06-19,330,330,329,1,3042,3049,3041,8,7,1,1,1,222,222,221,221
Fresno,27,2022-06-19,2473,2480,2473,7,20406,20462,20403,59,85,2,2,15,2789,2789,2787,2787
Glenn,27,2022-06-19,34,34,34,0,317,317,316,1,3,0,0,0,42,42,42,42
Humboldt,27,2022-06-19,292,292,291,1,2278,2283,2278,5,14,0,0,3,149,149,149,149
Imperial,27,2022-06-19,556,556,555,1,4090,4102,4091,11,7,0,0,0,947,947,947,947
Inyo,27,2022-06-19,19,19,19,0,185,186,185,1,0,0,0,0,56,56,56,56
Kern,27,2022-06-19,1565,1570,1567,3,20647,20702,20658,44,35,5,5,10,2357,2357,2352,2352
Kings,27,2022-06-19,397,397,396,1,5013,5028,5015,13,4,1,1,0,449,449,448,448
Lake,27,2022-06-19,130,130,130,0,1185,1189,1185,4,2,0,0,1,140,140,140,140
Lassen,27,2022-06-19,48,48,48,0,1280,1282,1279,3,1,0,0,0,62,62,62,62
Los Angeles,27,2022-06-19,27594,27669,27649,20,367760,368752,368483,269,610,56,56,61,32203,32203,32147,32147
Madera,27,2022-06-19,336,336,335,1,4126,4136,4124,12,6,0,0,0,368,368,368,368
Marin,27,2022-06-19,671,671,669,2,6494,6512,6494,18,19,0,0,2,302,302,302,302
Mariposa,27,2022-06-19,52,52,52,0,343,343,342,1,0,0,0,0,28,28,28,28
Mendocino,27,2022-06-19,174,174,173,1,1569,1574,1568,6,5,0,0,1,131,131,131,131
Merced,27,2022-06-19,555,555,554,1,4130,4143,4134,9,11,3,3,1,831,831,828,828
Modoc,27,2022-06-19,2,2,2,0,34,35,34,1,1,0,0,0,8,8,8,8
Mono,27,2022-06-19,8,8,8,0,91,92,91,1,0,1,1,0,7,7,6,6
Monterey,27,2022-06-19,903,903,899,4,8956,8981,8940,41,35,1,1,2,742,742,741,741
Napa,27,2022-06-19,364,364,363,1,3282,3291,3285,6,0,1,1,3,146,146,145,145
Nevada,27,2022-06-19,184,184,183,1,1726,1731,1726,5,7,1,1,0,131,131,130,130
Orange,27,2022-06-19,6994,7013,7001,12,61643,61809,61704,105,158,9,9,21,7159,7159,7150,7150
Placer,27,2022-06-19,666,666,664,2,6116,6133,6114,19,65,1,1,6,634,634,633,633
Plumas,27,2022-06-19,37,37,37,0,231,231,230,1,0,0,0,0,13,13,13,13
Riverside,27,2022-06-19,5026,5040,5029,11,44446,44566,44464,102,103,6,6,8,6491,6491,6485,6485
Sacramento,27,2022-06-19,3931,3943,3933,10,35771,35868,35780,88,156,9,9,25,3131,3131,3122,3122
San Benito,27,2022-06-19,187,187,187,0,1670,1675,1672,3,0,1,1,1,95,95,94,94
San Bernardino,27,2022-06-19,4598,4610,4602,8,46336,46462,46377,85,102,11,11,14,7867,7867,7856,7856
San Diego,27,2022-06-19,9895,9923,9915,8,80296,80514,80452,62,203,6,6,17,5370,5370,5364,5364
San Francisco,27,2022-06-19,3095,3102,3086,16,29819,29898,29747,151,70,13,13,15,923,923,910,910
San Joaquin,27,2022-06-19,1694,1699,1694,5,18091,18140,18091,49,37,4,4,7,2267,2267,2263,2263
San Luis Obispo,27,2022-06-19,594,594,593,1,5828,5844,5832,12,30,9,9,0,497,497,488,488
San Mateo,27,2022-06-19,2620,2627,2623,4,27256,27330,27283,47,47,2,2,4,723,723,721,721
Santa Barbara,27,2022-06-19,936,936,934,2,8593,8617,8597,20,31,2,2,6,699,699,697,697
Santa Clara,27,2022-06-19,6782,6801,6796,5,64689,64864,64811,53,156,8,8,20,2358,2358,2350,2350
Santa Cruz,27,2022-06-19,815,815,813,2,9285,9310,9291,19,18,1,1,2,265,265,264,264
Shasta,27,2022-06-19,229,229,228,1,3289,3297,3289,8,8,1,1,1,570,570,569,569
Siskiyou,27,2022-06-19,57,57,57,0,399,399,398,1,2,1,1,0,84,84,83,83
Solano,27,2022-06-19,1439,1444,1441,3,11749,11781,11754,27,38,0,0,6,451,451,451,451
Sonoma,27,2022-06-19,1409,1414,1411,3,10973,11002,10977,25,34,2,2,2,501,501,499,499
Stanislaus,27,2022-06-19,1052,1053,1049,4,8892,8917,8885,32,72,6,6,6,1707,1707,1701,1701
Sutter,27,2022-06-19,202,202,202,0,1869,1875,1871,4,0,0,0,0,228,228,228,228
Tehama,27,2022-06-19,108,108,108,0,924,925,922,3,2,0,0,0,207,207,207,207
Trinity,27,2022-06-19,10,10,10,0,108,109,108,1,0,0,0,0,20,20,20,20
Tulare,27,2022-06-19,884,885,882,3,9345,9370,9336,34,31,6,6,0,1505,1505,1499,1499
Tuolumne,27,2022-06-19,142,142,142,0,1556,1560,1555,5,2,0,0,1,190,190,190,190
Ventura,27,2022-06-19,1837,1843,1840,3,19137,19189,19159,30,52,1,1,4,1515,1515,1514,1514
Yolo,27,2022-06-19,715,715,714,1,11765,11798,11774,24,1,1,1,2,325,325,324,324
Yuba,27,2022-06-19,145,145,145,0,1378,1383,1380,3,9,0,0,6,118,118,118,118
Alameda,28,2022-06-26,5307,5322,5314,8,46588,46725,46658,67,134,8,8,14,1927,1927,1919,1919
Amador,28,2022-06-26,99,99,99,0,1163,1166,1163,3,1,0,0,2,87,87,87,87
Butte,28,2022-06-26,397,397,397,0,3375,3386,3382,4,27,2,2,0,447,447,445,445
Calaveras,28,2022-06-26,71,71,71,0,575,575,574,1,1,2,2,0,126,126,124,124
Colusa,28,2022-06-26,24,24,24,0,188,189,188,1,8,1,1,0,22,22,21,21
Contra Costa,28,2022-06-26,3579,3591,3582,9,25311,25384,25323,61,93,10,10,5,1363,1363,1353,1353
Del Norte,28,2022-06-26,135,135,135,0,664,664,663,1,5,1,1,0,53,53,52,52
El Dorado,28,2022-06-26,430,430,429,1,3145,3154,3148,6,7,0,0,1,222,222,222,222
Fresno,28,2022-06-26,2716,2723,2717,6,19979,20038,19993,45,129,3,3,14,2792,2792,2789,2789
Glenn,28,2022-06-26,33,33,33,0,296,296,295,1,2,0,0,0,42,42,42,42
Humboldt,28,2022-06-26,271,271,271,0,2213,2218,2214,4,4,0,0,2,149,149,149,149
Imperial,28,2022-06-26,679,679,678,1,3853,3866,3858,8,7,0,0,2,947,947,947,947
Inyo,28,2022-06-26,22,22,22,0,233,234,233,1,0,0,0,0,56,56,56,56
Kern,28,2022-06-26,1867,1873,1870,3,18204,18257,18226,31,43,6,6,10,2363,2363,2357,2357
Kings,28,2022-06-26,454,454,453,1,4139,4152,4144,8,8,0,0,0,449,449,449,449
Lake,28,2022-06-26,116,116,116,0,1129,1132,1129,3,1,0,0,0,140,140,140,140
Lassen,28,2022-06-26,55,55,55,0,1095,1096,1094,2,1,0,0,0,62,62,62,62
Los Angeles,28,2022-06-26,31031,31122,31105,17,353489,354519,354319,200,690,72,72,69,32275,32275,32203,32203
Madera,28,2022-06-26,435,435,434,1,4307,4320,4310,10,7,0,0,0,368,368,368,368
Marin,28,2022-06-26,666,666,665,1,6213,6231,6217,14,23,1,1,3,303,303,302,302
Mariposa,28,2022-06-26,54,54,54,0,303,303,302,1,0,0,0,0,28,28,28,28
Mendocino,28,2022-06-26,151,151,151,0,1421,1426,1422,4,4,0,0,0,131,131,131,131
Merced,28,2022-06-26,582,582,581,1,4016,4029,4022,7,5,2,2,3,833,833,831,831
Modoc,28,2022-06-26,9,9,9,0,33,34,33,1,0,0,0,0,8,8,8,8
Mono,28,2022-06-26,16,16,16,0,80,81,80,1,0,0,0,0,7,7,7,7
Monterey,28,2022-06-26,908,908,905,3,8442,8467,8437,30,36,2,2,5,744,744,742,742
Napa,28,2022-06-26,372,372,371,1,3194,3204,3199,5,2,2,2,1,148,148,146,146
Nevada,28,2022-06-26,175,175,175,0,1583,1588,1584,4,3,0,0,1,131,131,131,131
Orange,28,2022-06-26,7302,7324,7314,10,58290,58459,58382,77,172,13,13,25,7172,7172,7159,7159
Placer,28,2022-06-26,788,788,786,2,6124,6142,6127,15,87,6,6,7,640,640,634,634
Plumas,28,2022-06-26,46,46,46,0,263,263,262,1,0,0,0,0,13,13,13,13
Riverside,28,2022-06-26,5831,5849,5839,10,43714,43841,43763,78,125,10,10,21,6501,6501,6491,6491
Sacramento,28,2022-06-26,4056,4068,4060,8,34517,34617,34550,67,181,12,12,23,3143,3143,3131,3131
San Benito,28,2022-06-26,195,195,195,0,1535,1540,1538,2,0,0,0,2,95,95,95,95
San Bernardino,28,2022-06-26,5320,5335,5327,8,46806,46943,46876,67,120,12,12,21,7879,7879,7867,7867
San Diego,28,2022-06-26,10214,10244,10238,6,77733,77960,77914,46,249,9,9,22,5379,5379,5370,5370
San Francisco,28,2022-06-26,3165,3173,3161,12,27725,27806,27697,109,95,4,4,18,927,927,923,923
San Joaquin,28,2022-06-26,1830,1836,1832,4,18046,18098,18060,38,39,3,3,9,2270,2270,2267,2267
San Luis Obispo,28,2022-06-26,648,648,647,1,5805,5822,5812,10,26,4,4,0,501,501,497,497
San Mateo,28,2022-06-26,2810,2817,2813,4,25592,25667,25633,34,37,1,1,1,724,724,723,723
Santa Barbara,28,2022-06-26,1107,1108,1106,2,9278,9305,9288,17,26,2,2,2,701,701,699,699
Santa Clara,28,2022-06-26,7284,7304,7299,5,58555,58727,58690,37,185,11,11,13,2369,2369,2358,2358
Santa Cruz,28,2022-06-26,867,867,866,1,9078,9106,9092,14,21,2,2,1,267,267,265,265
Shasta,28,2022-06-26,317,317,316,1,3304,3312,3306,6,21,0,0,3,570,570,570,570
Siskiyou,28,2022-06-26,57,57,57,0,344,344,343,1,1,1,1,0,85,85,84,84
Solano,28,2022-06-26,1580,1585,1582,3,12673,12710,12687,23,39,0,0,4,451,451,451,451
Sonoma,28,2022-06-26,1378,1383,1381,2,10007,10035,10018,17,36,2,2,3,503,503,501,501
Stanislaus,28,2022-06-26,1196,1201,1198,3,8788,8813,8789,24,95,2,2,6,1709,1709,1707,1707
Sutter,28,2022-06-26,192,192,192,0,1840,1846,1843,3,0,0,0,0,228,228,228,228
Tehama,28,2022-06-26,83,83,83,0,829,831,829,2,3,0,0,0,207,207,207,207
Trinity,28,2022-06-26,22,22,22,0,139,140,139,1,1,0,0,0,20,20,20,20
Tulare,28,2022-06-26,905,906,903,3,7797,7818,7796,22,38,2,2,1,1507,1507,1505,1505
Tuolumne,28,2022-06-26,170,170,170,0,1410,1415,1412,3,1,3,3,0,193,193,190,190
Ventura,28,2022-06-26,2047,2054,2052,2,18759,18813,18790,23,58,2,2,1,1517,1517,1515,1515
Yolo,28,2022-06-26,766,766,765,1,10384,10416,10399,17,8,1,1,1,326,326,325,325
Yuba,28,2022-06-26,165,165,165,0,1400,1405,1403,2,8,2,2,2,120,120,118,118
Alameda,29,2022-07-03,5337,5355,5349,6,44935,45077,45027,50,126,12,12,11,1939,1939,1927,1927
Amador,29,2022-07-03,97,97,97,0,1661,1667,1664,3,3,1,1,2,88,88,87,87
Butte,29,2022-07-03,342,342,342,0,3090,3101,3098,3,24,2,2,1,449,449,447,447
Calaveras,29,2022-07-03,81,81,81,0,563,563,562,1,0,2,2,0,128,128,126,126
Colusa,29,2022-07-03,28,28,28,0,263,264,263,1,3,0,0,0,22,22,22,22
Contra Costa,29,2022-07-03,3592,3604,3597,7,24444,24522,24476,46,78,9,9,18,1372,1372,1363,1363
Del Norte,29,2022-07-03,151,151,151,0,667,667,666,1,4,0,0,0,53,53,53,53
El Dorado,29,2022-07-03,359,359,358,1,3017,3026,3021,5,11,1,1,0,223,223,222,222
Fresno,29,2022-07-03,2743,2751,2746,5,18273,18332,18300,32,146,4,4,18,2796,2796,2792,2792
Glenn,29,2022-07-03,28,28,28,0,267,268,267,1,1,0,0,0,42,42,42,42
Humboldt,29,2022-07-03,201,201,201,0,1908,1913,1910,3,8,2,2,4,151,151,149,149
Imperial,29,2022-07-03,768,768,767,1,3814,3827,3821,6,8,1,1,3,948,948,947,947
Inyo,29,2022-07-03,48,48,48,0,366,366,365,1,2,0,0,0,56,56,56,56
Kern,29,2022-07-03,1921,1927,1925,2,16248,16299,16278,21,53,5,5,6,2368,2368,2363,2363
Kings,29,2022-07-03,520,520,519,1,3915,3927,3921,6,5,0,0,0,449,449,449,449
Lake,29,2022-07-03,115,115,115,0,1016,1019,1017,2,2,2,2,1,142,142,140,140
Lassen,29,2022-07-03,37,37,37,0,819,821,820,1,2,0,0,0,62,62,62,62
Los Angeles,29,2022-07-03,35895,36007,35991,16,340381,341446,341295,151,759,82,82,87,32357,32357,32275,32275
Madera,29,2022-07-03,383,383,382,1,4047,4059,4052,7,10,0,0,1,368,368,368,368
Marin,29,2022-07-03,658,658,657,1,5686,5704,5694,10,24,1,1,2,304,304,303,303
Mariposa,29,2022-07-03,40,40,40,0,251,252,251,1,0,0,0,0,28,28,28,28
Mendocino,29,2022-07-03,180,180,180,0,1310,1315,1312,3,5,3,3,0,134,134,131,131
Merced,29,2022-07-03,680,680,679,1,3680,3693,3688,5,12,1,1,1,834,834,833,833
Modoc,29,2022-07-03,11,11,11,0,34,35,34,1,1,0,0,0,8,8,8,8
Mono,29,2022-07-03,31,31,31,0,119,120,119,1,1,0,0,0,7,7,7,7
Monterey,29,2022-07-03,899,900,897,3,7270,7294,7273,21,47,2,2,3,746,746,744,744
Napa,29,2022-07-03,400,400,400,0,3136,3146,3142,4,12,0,0,0,148,148,148,148
Nevada,29,2022-07-03,202,202,202,0,1525,1530,1527,3,6,0,0,1,131,131,131,131
Orange,29,2022-07-03,7883,7908,7900,8,58029,58211,58151,60,195,26,26,35,7198,7198,7172,7172
Placer,29,2022-07-03,856,857,855,2,5827,5846,5835,11,78,2,2,5,642,642,640,640
Plumas,29,2022-07-03,36,36,36,0,222,223,222,1,5,0,0,0,13,13,13,13
Riverside,29,2022-07-03,7038,7061,7051,10,44346,44486,44424,62,128,5,5,8,6506,6506,6501,6501
Sacramento,29,2022-07-03,4107,4120,4114,6,31928,32029,31981,48,165,12,12,24,3155,3155,3143,3143
San Benito,29,2022-07-03,248,248,248,0,1576,1581,1579,2,2,0,0,1,95,95,95,95
San Bernardino,29,2022-07-03,6674,6694,6687,7,47645,47794,47740,54,138,12,12,24,7891,7891,7879,7879
San Diego,29,2022-07-03,11059,11094,11089,5,76285,76524,76488,36,262,9,9,41,5388,5388,5379,5379
San Francisco,29,2022-07-03,3153,3164,3154,10,26888,26973,26890,83,104,9,9,16,936,936,927,927
San Joaquin,29,2022-07-03,1874,1879,1876,3,16481,16532,16505,27,43,4,4,6,2274,2274,2270,2270
San Luis Obispo,29,2022-07-03,680,680,679,1,4973,4989,4983,6,23,0,0,0,501,501,501,501
San Mateo,29,2022-07-03,2753,2761,2758,3,24514,24590,24564,26,34,1,1,3,725,725,724,724
Santa Barbara,29,2022-07-03,1157,1161,1159,2,9107,9135,9122,13,25,4,4,5,705,705,701,701
Santa Clara,29,2022-07-03,7440,7462,7458,4,56551,56728,56700,28,195,16,16,32,2385,2385,2369,2369
Santa Cruz,29,2022-07-03,828,829,828,1,8843,8869,8858,11,21,0,0,1,267,267,267,267
Shasta,29,2022-07-03,326,326,326,0,3092,3101,3096,5,14,4,4,2,574,574,570,570
Siskiyou,29,2022-07-03,62,62,62,0,387,388,387,1,1,0,0,1,85,85,85,85
Solano,29,2022-07-03,1513,1519,1517,2,11625,11661,11645,16,49,0,0,6,451,451,451,451
Sonoma,29,2022-07-03,1209,1214,1212,2,9593,9624,9611,13,38,1,1,0,504,504,503,503
Stanislaus,29,2022-07-03,1249,1254,1251,3,7951,7977,7960,17,88,6,6,14,1715,1715,1709,1709
Sutter,29,2022-07-03,250,250,250,0,1846,1852,1849,3,0,0,0,0,228,228,228,228
Tehama,29,2022-07-03,131,131,131,0,984,988,986,2,4,1,1,0,208,208,207,207
Trinity,29,2022-07-03,21,21,21,0,150,151,150,1,2,0,0,0,20,20,20,20
Tulare,29,2022-07-03,1026,1029,1027,2,7582,7606,7589,17,30,2,2,3,1509,1509,1507,1507
Tuolumne,29,2022-07-03,169,169,169,0,1169,1171,1169,2,8,0,0,1,193,193,193,193
Ventura,29,2022-07-03,2132,2139,2137,2,17747,17804,17787,17,86,3,3,3,1520,1520,1517,1517
Yolo,29,2022-07-03,607,607,606,1,8355,8380,8369,11,5,1,1,2,327,327,326,326
Yuba,29,2022-07-03,190,190,190,0,1239,1243,1241,2,6,0,0,2,120,120,120,120
Alameda,30,2022-07-10,5349,5368,5363,5,41814,41959,41923,36,120,7,7,19,1946,1946,1939,1939
Amador,30,2022-07-10,89,89,89,0,1440,1445,1443,2,0,0,0,2,88,88,88,88
Butte,30,2022-07-10,411,411,411,0,2716,2726,2724,2,26,1,1,3,450,450,449,449
Calaveras,30,2022-07-10,85,85,85,0,493,493,492,1,0,1,1,0,129,129,128,128
Colusa,30,2022-07-10,24,24,24,0,360,361,360,1,0,0,0,0,22,22,22,22
Contra Costa,30,2022-07-10,3417,3428,3423,5,22964,23045,23012,33,98,13,13,13,1385,1385,1372,1372
Del Norte,30,2022-07-10,143,143,143,0,589,589,588,1,6,0,0,2,53,53,53,53
El Dorado,30,2022-07-10,330,330,330,0,2676,2687,2684,3,14,0,0,2,223,223,223,223
Fresno,30,2022-07-10,3228,3239,3235,4,18625,18690,18665,25,156,8,8,13,2804,2804,2796,2796
Glenn,30,2022-07-10,41,41,41,0,283,284,283,1,0,0,0,0,42,42,42,42
Humboldt,30,2022-07-10,254,254,254,0,1830,1835,1833,2,8,1,1,2,152,152,151,151
Imperial,30,2022-07-10,966,969,968,1,3923,3937,3932,5,9,0,0,1,948,948,948,948
Inyo,30,2022-07-10,37,37,37,0,329,330,329,1,0,1,1,0,57,57,56,56
Kern,30,2022-07-10,2077,2083,2081,2,14563,14614,14599,15,70,2,2,11,2370,2370,2368,2368
Kings,30,2022-07-10,578,579,578,1,3793,3807,3802,5,11,3,3,1,452,452,449,449
Lake,30,2022-07-10,112,112,112,0,969,973,972,1,1,0,0,0,142,142,142,142
Lassen,30,2022-07-10,47,47,47,0,700,702,701,1,5,1,1,0,63,63,62,62
Los Angeles,30,2022-07-10,38688,38823,38810,13,326686,327823,327712,111,982,89,89,97,32446,32446,32357,32357
Madera,30,2022-07-10,450,450,449,1,3425,3438,3433,5,12,0,0,4,368,368,368,368
Marin,30,2022-07-10,576,576,575,1,5357,5374,5367,7,17,1,1,2,305,305,304,304
Mariposa,30,2022-07-10,49,49,49,0,267,268,267,1,0,0,0,0,28,28,28,28
Mendocino,30,2022-07-10,172,172,172,0,1247,1251,1249,2,6,0,0,0,134,134,134,134
Merced,30,2022-07-10,651,651,650,1,3587,3600,3596,4,16,5,5,1,839,839,834,834
Modoc,30,2022-07-10,27,27,27,0,53,54,53,1,0,0,0,0,8,8,8,8
Mono,30,2022-07-10,11,11,11,0,85,86,85,1,0,0,0,0,7,7,7,7
Monterey,30,2022-07-10,996,1000,998,2,6895,6920,6905,15,46,3,3,1,749,749,746,746
Napa,30,2022-07-10,323,323,323,0,3070,3081,3078,3,11,1,1,2,149,149,148,148
Nevada,30,2022-07-10,179,179,179,0,1529,1533,1531,2,5,0,0,1,131,131,131,131
Orange,30,2022-07-10,8555,8584,8577,7,56595,56793,56748,45,245,22,22,31,7220,7220,7198,7198
Placer,30,2022-07-10,755,756,755,1,5230,5248,5240,8,87,3,3,8,645,645,642,642
Plumas,30,2022-07-10,65,65,65,0,245,246,245,1,0,0,0,0,13,13,13,13
Riverside,30,2022-07-10,8169,8197,8188,9,44646,44802,44754,48,200,12,12,13,6518,6518,6506,6506
Sacramento,30,2022-07-10,3744,3757,3753,4,30668,30774,30738,36,191,23,23,23,3178,3178,3155,3155
San Benito,30,2022-07-10,206,206,206,0,1446,1450,1449,1,1,0,0,0,95,95,95,95
San Bernardino,30,2022-07-10,7563,7589,7583,6,48320,48488,48446,42,174,12,12,24,7903,7903,7891,7891
San Diego,30,2022-07-10,11912,11954,11950,4,74618,74877,74850,27,316,7,7,50,5395,5395,5388,5388
San Francisco,30,2022-07-10,2741,2750,2743,7,24026,24110,24053,57,107,14,14,19,950,950,936,936
San Joaquin,30,2022-07-10,1918,1925,1923,2,16971,17030,17008,22,58,7,7,7,2281,2281,2274,2274
San Luis Obispo,30,2022-07-10,700,702,701,1,4706,4723,4718,5,25,3,3,0,504,504,501,501
San Mateo,30,2022-07-10,2564,2573,2571,2,21572,21647,21630,17,36,3,3,12,728,728,725,725
Santa Barbara,30,2022-07-10,1201,1205,1204,1,8341,8368,8359,9,37,4,4,11,709,709,705,705
Santa Clara,30,2022-07-10,6967,6992,6989,3,52862,53046,53026,20,203,11,11,42,2396,2396,2385,2385
Santa Cruz,30,2022-07-10,897,901,900,1,7905,7932,7925,7,16,0,0,0,267,267,267,267
Shasta,30,2022-07-10,295,295,295,0,2918,2928,2925,3,18,3,3,5,577,577,574,574
Siskiyou,30,2022-07-10,41,41,41,0,318,319,318,1,1,1,1,1,86,86,85,85
Solano,30,2022-07-10,1408,1412,1410,2,9906,9941,9930,11,48,1,1,6,452,452,451,451
Sonoma,30,2022-07-10,1204,1208,1207,1,8736,8766,8757,9,39,1,1,6,505,505,504,504
Stanislaus,30,2022-07-10,1375,1381,1379,2,7967,7993,7980,13,101,7,7,10,1722,1722,1715,1715
Sutter,30,2022-07-10,260,260,260,0,1612,1617,1615,2,0,0,0,0,228,228,228,228
Tehama,30,2022-07-10,125,125,125,0,782,785,784,1,6,0,0,1,208,208,208,208
Trinity,30,2022-07-10,30,30,30,0,113,114,113,1,0,0,0,0,20,20,20,20
Tulare,30,2022-07-10,1225,1229,1227,2,7601,7626,7613,13,46,5,5,1,1514,1514,1509,1509
Tuolumne,30,2022-07-10,238,238,238,0,1123,1127,1125,2,5,0,0,0,193,193,193,193
Ventura,30,2022-07-10,2284,2292,2290,2,17304,17364,17351,13,78,4,4,4,1524,1524,1520,1520
Yolo,30,2022-07-10,464,464,464,0,4745,4761,4756,5,7,2,2,3,329,329,327,327
Yuba,30,2022-07-10,193,193,193,0,1256,1260,1259,1,6,0,0,2,120,120,120,120
Alameda,31,2022-07-17,5021,5042,5039,3,43349,43519,43490,29,141,7,7,29,1953,1953,1946,1946
Amador,31,2022-07-17,86,86,86,0,1262,1268,1267,1,3,0,0,2,88,88,88,88
Butte,31,2022-07-17,372,372,372,0,2914,2926,2924,2,28,1,1,3,451,451,450,450
Calaveras,31,2022-07-17,71,71,71,0,548,548,547,1,0,0,0,0,129,129,129,129
Colusa,31,2022-07-17,21,21,21,0,347,349,348,1,0,0,0,0,22,22,22,22
Contra Costa,31,2022-07-17,3097,3109,3105,4,22944,23034,23008,26,92,3,3,15,1388,1388,1385,1385
Del Norte,31,2022-07-17,180,180,180,0,689,690,689,1,7,0,0,0,53,53,53,53
El Dorado,31,2022-07-17,314,314,314,0,2678,2689,2686,3,8,2,2,0,225,225,223,223
Fresno,31,2022-07-17,3657,3672,3668,4,21161,21244,21221,23,180,9,9,15,2813,2813,2804,2804
Glenn,31,2022-07-17,33,33,33,0,264,265,264,1,0,0,0,0,42,42,42,42
Humboldt,31,2022-07-17,296,296,296,0,2017,2023,2021,2,8,0,0,4,152,152,152,152
Imperial,31,2022-07-17,1053,1058,1057,1,4635,4653,4648,5,17,3,3,0,951,951,948,948
Inyo,31,2022-07-17,25,25,25,0,329,330,329,1,1,0,0,0,57,57,57,57
Kern,31,2022-07-17,2311,2320,2318,2,16028,16091,16078,13,71,8,8,17,2378,2378,2370,2370
Kings,31,2022-07-17,744,746,745,1,4161,4177,4173,4,12,0,0,0,452,452,452,452
Lake,31,2022-07-17,125,125,125,0,934,939,938,1,0,0,0,0,142,142,142,142
Lassen,31,2022-07-17,66,66,66,0,992,995,994,1,1,0,0,0,63,63,63,63
Los Angeles,31,2022-07-17,41729,41894,41883,11,351470,352855,352760,95,1142,113,113,131,32559,32559,32446,32446
Madera,31,2022-07-17,527,527,526,1,3859,3874,3870,4,9,0,0,5,368,368,368,368
Marin,31,2022-07-17,513,513,512,1,5448,5470,5464,6,12,1,1,6,306,306,305,305
Mariposa,31,2022-07-17,42,42,42,0,247,248,247,1,0,1,1,0,29,29,28,28
Mendocino,31,2022-07-17,174,174,174,0,1452,1457,1455,2,7,0,0,2,134,134,134,134
Merced,31,2022-07-17,769,771,770,1,3920,3935,3932,3,16,2,2,1,841,841,839,839
Modoc,31,2022-07-17,11,11,11,0,31,32,31,1,1,0,0,0,8,8,8,8
Mono,31,2022-07-17,9,9,9,0,82,83,82,1,0,0,0,1,7,7,7,7
Monterey,31,2022-07-17,979,983,981,2,7124,7153,7141,12,49,7,7,7,756,756,749,749
Napa,31,2022-07-17,321,321,321,0,3094,3106,3104,2,9,0,0,0,149,149,149,149
Nevada,31,2022-07-17,169,169,169,0,1343,1349,1348,1,10,0,0,2,131,131,131,131
Orange,31,2022-07-17,8887,8921,8915,6,59564,59799,59762,37,255,22,22,40,7242,7242,7220,7220
Placer,31,2022-07-17,709,709,708,1,5324,5344,5338,6,86,1,1,4,646,646,645,645
Plumas,31,2022-07-17,58,58,58,0,256,257,256,1,1,0,0,0,13,13,13,13
Riverside,31,2022-07-17,8377,8410,8403,7,47828,48017,47977,40,214,14,14,15,6532,6532,6518,6518
Sacramento,31,2022-07-17,3558,3572,3569,3,30419,30540,30512,28,172,13,13,25,3191,3191,3178,3178
San Benito,31,2022-07-17,207,207,207,0,1603,1608,1607,1,0,0,0,0,95,95,95,95
San Bernardino,31,2022-07-17,7967,7999,7994,5,53446,53656,53620,36,190,15,15,26,7918,7918,7903,7903
San Diego,31,2022-07-17,13206,13258,13254,4,80428,80745,80722,23,388,12,12,46,5407,5407,5395,5395
San Francisco,31,2022-07-17,2529,2540,2535,5,24860,24957,24910,47,111,10,10,25,960,960,950,950
San Joaquin,31,2022-07-17,2035,2042,2040,2,17793,17863,17845,18,66,3,3,14,2284,2284,2281,2281
San Luis Obispo,31,2022-07-17,561,561,561,0,4607,4624,4620,4,16,3,3,1,507,507,504,504
San Mateo,31,2022-07-17,2366,2376,2375,1,22940,23030,23016,14,45,1,1,2,729,729,728,728
Santa Barbara,31,2022-07-17,1260,1266,1265,1,9250,9288,9280,8,43,2,2,6,711,711,709,709
Santa Clara,31,2022-07-17,6246,6271,6269,2,53394,53604,53588,16,195,10,10,34,2406,2406,2396,2396
Santa Cruz,31,2022-07-17,867,871,870,1,7656,7685,7679,6,22,1,1,3,268,268,267,267
Shasta,31,2022-07-17,336,336,336,0,3200,3213,3210,3,37,2,2,4,579,579,577,577
Siskiyou,31,2022-07-17,41,41,41,0,324,325,324,1,1,1,1,0,87,87,86,86
Solano,31,2022-07-17,1278,1284,1283,1,9623,9662,9654,8,47,1,1,6,453,453,452,452
Sonoma,31,2022-07-17,1059,1065,1064,1,8852,8886,8879,7,40,0,0,5,505,505,505,505
Stanislaus,31,2022-07-17,1373,1380,1378,2,8097,8129,8118,11,111,4,4,8,1726,1726,1722,1722
Sutter,31,2022-07-17,247,247,247,0,1665,1671,1670,1,0,0,0,0,228,228,228,228
Tehama,31,2022-07-17,113,113,113,0,903,907,906,1,5,1,1,1,209,209,208,208
Trinity,31,2022-07-17,23,23,23,0,108,109,108,1,1,0,0,0,20,20,20,20
Tulare,31,2022-07-17,1215,1221,1219,2,8409,8441,8429,12,40,1,1,1,1515,1515,1514,1514
Tuolumne,31,2022-07-17,240,240,240,0,1154,1159,1158,1,5,0,0,0,193,193,193,193
Ventura,31,2022-07-17,2341,2350,2349,1,19080,19155,19144,11,81,4,4,6,1528,1528,1524,1524
Yolo,31,2022-07-17,433,433,433,0,4610,4628,4624,4,4,2,2,1,331,331,329,329
Yuba,31,2022-07-17,212,212,212,0,1259,1264,1263,1,15,0,0,0,120,120,120,120
Alameda,32,2022-07-24,4494,4514,4512,2,41197,41375,41353,22,138,11,11,20,1964,1964,1953,1953
Amador,32,2022-07-24,76,76,76,0,1299,1304,1303,1,3,0,0,1,88,88,88,88
Butte,32,2022-07-24,356,356,356,0,2983,2996,2995,1,28,1,1,2,452,452,451,451
Calaveras,32,2022-07-24,82,82,82,0,552,553,552,1,1,2,2,0,131,131,129,129
Colusa,32,2022-07-24,26,26,26,0,374,376,375,1,1,0,0,0,22,22,22,22
Contra Costa,32,2022-07-24,2847,2859,2856,3,22385,22481,22461,20,91,6,6,17,1394,1394,1388,1388
Del Norte,32,2022-07-24,75,75,75,0,578,580,579,1,7,0,0,0,53,53,53,53
El Dorado,32,2022-07-24,273,273,273,0,2489,2500,2498,2,9,1,1,0,226,226,225,225
Fresno,32,2022-07-24,3389,3404,3401,3,20451,20541,20524,17,203,7,7,28,2820,2820,2813,2813
Glenn,32,2022-07-24,32,32,32,0,269,270,269,1,1,0,0,0,42,42,42,42
Humboldt,32,2022-07-24,252,252,252,0,2006,2013,2012,1,14,2,2,4,154,154,152,152
Imperial,32,2022-07-24,903,907,906,1,4386,4404,4401,3,20,1,1,1,952,952,951,951
Inyo,32,2022-07-24,24,24,24,0,309,310,309,1,1,0,0,0,57,57,57,57
Kern,32,2022-07-24,2021,2029,2028,1,15743,15811,15801,10,77,3,3,13,2381,2381,2378,2378
Kings,32,2022-07-24,585,586,586,0,3951,3968,3965,3,14,2,2,0,454,454,452,452
Lake,32,2022-07-24,134,134,134,0,993,997,996,1,4,0,0,2,142,142,142,142
Lassen,32,2022-07-24,52,52,52,0,1095,1099,1098,1,0,0,0,0,63,63,63,63
Los Angeles,32,2022-07-24,37836,37998,37990,8,340035,341501,341430,71,1111,112,112,124,32671,32671,32559,32559
Madera,32,2022-07-24,545,545,545,0,3779,3796,3793,3,11,0,0,4,368,368,368,368
Marin,32,2022-07-24,516,516,516,0,5559,5584,5579,5,18,2,2,3,308,308,306,306
Mariposa,32,2022-07-24,44,44,44,0,231,232,231,1,0,0,0,0,29,29,29,29
Mendocino,32,2022-07-24,186,186,186,0,1378,1383,1381,2,7,0,0,1,134,134,134,134
Merced,32,2022-07-24,702,704,704,0,3839,3856,3854,2,18,2,2,2,843,843,841,841
Modoc,32,2022-07-24,8,8,8,0,29,30,29,1,0,1,1,0,9,9,8,8
Mono,32,2022-07-24,16,16,16,0,91,92,91,1,0,0,0,0,7,7,7,7
Monterey,32,2022-07-24,946,951,950,1,7119,7150,7140,10,38,1,1,4,757,757,756,756
Napa,32,2022-07-24,301,301,301,0,2886,2899,2897,2,5,5,5,0,154,154,149,149
Nevada,32,2022-07-24,124,124,124,0,1359,1365,1364,1,8,1,1,0,132,132,131,131
Orange,32,2022-07-24,8205,8240,8236,4,58628,58882,58853,29,271,33,33,37,7275,7275,7242,7242
Placer,32,2022-07-24,569,569,568,1,4985,5005,5000,5,78,3,3,10,649,649,646,646
Plumas,32,2022-07-24,39,39,39,0,212,213,212,1,0,0,0,0,13,13,13,13
Riverside,32,2022-07-24,7673,7706,7701,5,46442,46642,46611,31,242,16,16,19,6548,6548,6532,6532
Sacramento,32,2022-07-24,3608,3624,3621,3,29922,30052,30031,21,194,17,17,27,3208,3208,3191,3191
San Benito,32,2022-07-24,201,201,201,0,1411,1417,1416,1,1,1,1,1,96,96,95,95
San Bernardino,32,2022-07-24,7121,7152,7148,4,50979,51199,51172,27,196,25,25,23,7943,7943,7918,7918
San Diego,32,2022-07-24,12209,12262,12259,3,76634,76966,76949,17,397,16,16,43,5423,5423,5407,5407
San Francisco,32,2022-07-24,2311,2322,2319,3,24533,24639,24603,36,120,8,8,26,968,968,960,960
San Joaquin,32,2022-07-24,1841,1849,1848,1,16838,16909,16896,13,74,4,4,9,2288,2288,2284,2284
San Luis Obispo,32,2022-07-24,509,509,509,0,4416,4436,4433,3,15,4,4,1,511,511,507,507
San Mateo,32,2022-07-24,2025,2034,2033,1,21680,21772,21761,11,51,1,1,9,730,730,729,729
Santa Barbara,32,2022-07-24,1219,1224,1223,1,9026,9066,9060,6,39,2,2,3,713,713,711,711
Santa Clara,32,2022-07-24,5864,5889,5888,1,50918,51138,51126,12,234,16,16,25,2422,2422,2406,2406
Santa Cruz,32,2022-07-24,857,861,861,0,7753,7786,7782,4,26,0,0,0,268,268,268,268
Shasta,32,2022-07-24,295,295,295,0,3138,3152,3150,2,38,1,1,6,580,580,579,579
Siskiyou,32,2022-07-24,58,58,58,0,367,368,367,1,2,0,0,0,87,87,87,87
Solano,32,2022-07-24,1171,1177,1176,1,9594,9635,9629,6,56,0,0,6,453,453,453,453
Sonoma,32,2022-07-24,1057,1062,1061,1,8612,8649,8643,6,45,0,0,4,505,505,505,505
Stanislaus,32,2022-07-24,1353,1360,1359,1,8064,8098,8090,8,102,8,8,11,1734,1734,1726,1726
Sutter,32,2022-07-24,224,224,224,0,1708,1714,1713,1,0,0,0,0,228,228,228,228
Tehama,32,2022-07-24,115,115,115,0,898,902,901,1,6,0,0,0,209,209,209,209
Trinity,32,2022-07-24,14,14,14,0,98,99,98,1,0,0,0,0,20,20,20,20
Tulare,32,2022-07-24,1157,1164,1163,1,8022,8055,8046,9,37,1,1,1,1516,1516,1515,1515
Tuolumne,32,2022-07-24,199,199,199,0,1157,1162,1161,1,5,0,0,0,193,193,193,193
Ventura,32,2022-07-24,2204,2213,2212,1,18808,18890,18881,9,70,4,4,7,1532,1532,1528,1528
Yolo,32,2022-07-24,414,414,414,0,4534,4553,4550,3,5,2,2,2,333,333,331,331
Yuba,32,2022-07-24,187,187,187,0,1328,1333,1332,1,13,0,0,1,120,120,120,120
Alameda,33,2022-07-31,3890,3910,3908,2,37457,37639,37624,15,174,11,11,20,1975,1975,1964,1964
Amador,33,2022-07-31,62,62,62,0,1142,1147,1146,1,4,1,1,0,89,89,88,88
Butte,33,2022-07-31,357,357,357,0,2774,2788,2787,1,34,1,1,1,453,453,452,452
Calaveras,33,2022-07-31,73,73,73,0,562,565,564,1,1,1,1,2,132,132,131,131
Colusa,33,2022-07-31,28,28,28,0,375,377,376,1,5,0,0,0,22,22,22,22
Contra Costa,33,2022-07-31,2668,2681,2679,2,21249,21352,21337,15,92,12,12,19,1406,1406,1394,1394
Del Norte,33,2022-07-31,58,58,58,0,478,480,479,1,4,0,0,2,53,53,53,53
El Dorado,33,2022-07-31,254,254,254,0,2483,2496,2495,1,3,3,3,2,229,229,226,226
Fresno,33,2022-07-31,3072,3087,3085,2,19027,19120,19108,12,217,8,8,18,2828,2828,2820,2820
Glenn,33,2022-07-31,31,31,31,0,249,251,250,1,0,0,0,0,42,42,42,42
Humboldt,33,2022-07-31,216,216,216,0,1870,1880,1879,1,9,0,0,4,154,154,154,154
Imperial,33,2022-07-31,693,696,696,0,3704,3723,3721,2,23,3,3,4,955,955,952,952
Inyo,33,2022-07-31,19,19,19,0,287,288,287,1,2,1,1,0,58,58,57,57
Kern,33,2022-07-31,1742,1751,1750,1,14588,14658,14651,7,78,6,6,12,2387,2387,2381,2381
Kings,33,2022-07-31,622,626,626,0,4002,4021,4019,2,7,0,0,1,454,454,454,454
Lake,33,2022-07-31,135,135,135,0,1037,1042,1041,1,5,1,1,1,143,143,142,142
Lassen,33,2022-07-31,49,49,49,0,911,916,915,1,1,0,0,0,63,63,63,63
Los Angeles,33,2022-07-31,31742,31896,31891,5,312319,313833,313782,51,1071,132,132,129,32803,32803,32671,32671
Madera,33,2022-07-31,471,471,471,0,3550,3567,3565,2,9,0,0,5,368,368,368,368
Marin,33,2022-07-31,409,409,409,0,5191,5216,5213,3,32,0,0,3,308,308,308,308
Mariposa,33,2022-07-31,19,19,19,0,208,209,208,1,0,0,0,0,29,29,29,29
Mendocino,33,2022-07-31,205,205,205,0,1367,1372,1371,1,4,1,1,0,135,135,134,134
Merced,33,2022-07-31,666,669,669,0,3681,3700,3698,2,23,6,6,3,849,849,843,843
Modoc,33,2022-07-31,12,12,12,0,31,32,31,1,0,0,0,0,9,9,9,9
Mono,33,2022-07-31,8,8,8,0,78,79,78,1,0,0,0,0,7,7,7,7
Monterey,33,2022-07-31,941,946,945,1,6678,6710,6703,7,39,1,1,2,758,758,757,757
Napa,33,2022-07-31,269,269,269,0,2846,2861,2860,1,14,0,0,0,154,154,154,154
Nevada,33,2022-07-31,105,105,105,0,1369,1376,1375,1,10,0,0,0,132,132,132,132
Orange,33,2022-07-31,6786,6819,6816,3,53445,53705,53685,20,253,36,36,43,7311,7311,7275,7275
Placer,33,2022-07-31,608,610,610,0,4906,4931,4927,4,75,3,3,9,652,652,649,649
Plumas,33,2022-07-31,19,19,19,0,178,179,178,1,0,0,0,0,13,13,13,13
Riverside,33,2022-07-31,6321,6352,6349,3,42382,42587,42565,22,204,5,5,20,6553,6553,6548,6548
Sacramento,33,2022-07-31,3176,3192,3190,2,28715,28855,28839,16,161,18,18,26,3226,3226,3208,3208
San Benito,33,2022-07-31,158,158,158,0,730,735,734,1,2,2,2,0,98,98,96,96
San Bernardino,33,2022-07-31,6291,6322,6319,3,48548,48784,48764,20,183,29,29,24,7972,7972,7943,7943
San Diego,33,2022-07-31,9850,9898,9896,2,70028,70368,70356,12,377,17,17,48,5440,5440,5423,5423
San Francisco,33,2022-07-31,1847,1855,1853,2,22001,22109,22084,25,100,13,13,21,981,981,968,968
San Joaquin,33,2022-07-31,1724,1732,1731,1,15675,15751,15741,10,74,6,6,15,2294,2294,2288,2288
San Luis Obispo,33,2022-07-31,574,576,576,0,4112,4132,4130,2,14,3,3,0,514,514,511,511
San Mateo,33,2022-07-31,1852,1861,1860,1,20494,20593,20585,8,66,0,0,4,730,730,730,730
Santa Barbara,33,2022-07-31,1104,1110,1109,1,7827,7865,7861,4,30,2,2,3,715,715,713,713
Santa Clara,33,2022-07-31,4994,5017,5016,1,45634,45856,45848,8,219,16,16,42,2438,2438,2422,2422
Santa Cruz,33,2022-07-31,752,756,756,0,7103,7138,7135,3,17,1,1,0,269,269,268,268
Shasta,33,2022-07-31,254,254,254,0,2981,2997,2995,2,41,1,1,8,581,581,580,580
Siskiyou,33,2022-07-31,40,40,40,0,286,287,286,1,1,0,0,0,87,87,87,87
Solano,33,2022-07-31,1153,1159,1158,1,9168,9213,9208,5,45,0,0,5,453,453,453,453
Sonoma,33,2022-07-31,968,974,974,0,8346,8386,8382,4,47,4,4,3,509,509,505,505
Stanislaus,33,2022-07-31,1291,1298,1297,1,7773,7810,7804,6,116,8,8,10,1742,1742,1734,1734
Sutter,33,2022-07-31,238,238,238,0,1654,1661,1660,1,0,3,3,0,231,231,228,228
Tehama,33,2022-07-31,92,92,92,0,795,799,798,1,2,2,2,0,211,211,209,209
Trinity,33,2022-07-31,10,10,10,0,80,81,80,1,0,0,0,0,20,20,20,20
Tulare,33,2022-07-31,1027,1033,1032,1,7538,7575,7569,6,39,1,1,2,1517,1517,1516,1516
Tuolumne,33,2022-07-31,153,153,153,0,1089,1094,1093,1,5,0,0,0,193,193,193,193
Ventura,33,2022-07-31,1894,1903,1902,1,17185,17268,17262,6,76,9,9,6,1541,1541,1532,1532
Yolo,33,2022-07-31,343,343,343,0,4135,4156,4154,2,4,2,2,1,335,335,333,333
Yuba,33,2022-07-31,155,155,155,0,1204,1209,1208,1,9,0,0,0,120,120,120,120
Alameda,34,2022-08-07,3453,3471,3470,1,35482,35667,35656,11,128,11,11,21,1986,1986,1975,1975
Amador,34,2022-08-07,56,56,56,0,875,881,880,1,3,0,0,0,89,89,89,89
Butte,34,2022-08-07,337,337,337,0,2614,2627,2626,1,28,1,1,1,454,454,453,453
Calaveras,34,2022-08-07,56,56,56,0,565,568,567,1,1,1,1,0,133,133,132,132
Colusa,34,2022-08-07,15,15,15,0,350,352,351,1,2,0,0,0,22,22,22,22
Contra Costa,34,2022-08-07,2248,2259,2258,1,20046,20151,20140,11,96,5,5,16,1411,1411,1406,1406
Del Norte,34,2022-08-07,49,49,49,0,500,503,502,1,5,0,0,0,53,53,53,53
El Dorado,34,2022-08-07,182,182,182,0,2284,2297,2296,1,7,0,0,0,229,229,229,229
Fresno,34,2022-08-07,2526,2539,2538,1,17367,17458,17449,9,207,6,6,25,2834,2834,2828,2828
Glenn,34,2022-08-07,22,22,22,0,253,255,254,1,2,0,0,0,42,42,42,42
Humboldt,34,2022-08-07,203,203,203,0,1979,1991,1990,1,9,1,1,3,155,155,154,154
Imperial,34,2022-08-07,571,573,573,0,3340,3357,3355,2,19,3,3,3,958,958,955,955
Inyo,34,2022-08-07,13,13,13,0,258,259,258,1,0,0,0,1,58,58,58,58
Kern,34,2022-08-07,1385,1393,1392,1,14213,14287,14282,5,63,6,6,15,2393,2393,2387,2387
Kings,34,2022-08-07,496,497,497,0,3468,3487,3485,2,9,0,0,3,454,454,454,454
Lake,34,2022-08-07,103,103,103,0,930,936,935,1,2,0,0,1,143,143,143,143
Lassen,34,2022-08-07,155,155,155,0,1095,1101,1100,1,0,0,0,0,63,63,63,63
Los Angeles,34,2022-08-07,26451,26591,26588,3,291130,292655,292618,37,975,127,129,122,32930,32932,32803,32803
Madera,34,2022-08-07,409,409,409,0,3139,3155,3153,2,18,0,0,5,368,368,368,368
Marin,34,2022-08-07,370,370,370,0,4596,4621,4619,2,25,2,2,3,310,310,308,308
Mariposa,34,2022-08-07,28,28,28,0,221,222,221,1,0,0,0,0,29,29,29,29
Mendocino,34,2022-08-07,129,129,129,0,1136,1141,1140,1,1,1,1,1,136,136,135,135
Merced,34,2022-08-07,528,530,530,0,3447,3465,3464,1,16,0,0,6,849,849,849,849
Modoc,34,2022-08-07,5,5,5,0,28,29,28,1,0,0,0,0,9,9,9,9
Mono,34,2022-08-07,7,7,7,0,70,71,70,1,1,0,0,0,7,7,7,7
Monterey,34,2022-08-07,758,763,762,1,5828,5859,5854,5,34,2,2,0,760,760,758,758
Napa,34,2022-08-07,274,274,274,0,2663,2677,2676,1,6,2,2,1,156,156,154,154
Nevada,34,2022-08-07,104,104,104,0,1339,1346,1345,1,6,0,0,0,132,132,132,132
Orange,34,2022-08-07,5377,5405,5403,2,48605,48860,48845,15,231,25,25,43,7336,7336,7311,7311
Placer,34,2022-08-07,517,518,518,0,4522,4546,4543,3,66,2,2,8,654,654,652,652
Plumas,34,2022-08-07,28,28,28,0,183,184,183,1,1,0,0,0,13,13,13,13
Riverside,34,2022-08-07,5653,5683,5681,2,40251,40464,40448,16,188,9,9,16,6562,6562,6553,6553
Sacramento,34,2022-08-07,2717,2730,2729,1,26742,26881,26869,12,179,19,19,24,3245,3245,3226,3226
San Benito,34,2022-08-07,173,173,173,0,705,710,709,1,1,0,0,0,98,98,98,98
San Bernardino,34,2022-08-07,5248,5275,5273,2,44553,44786,44772,14,204,17,17,15,7989,7989,7972,7972
San Diego,34,2022-08-07,7608,7647,7646,1,64252,64588,64579,9,329,8,8,33,5448,5448,5440,5440
San Francisco,34,2022-08-07,1596,1604,1603,1,20380,20489,20471,18,89,13,13,22,994,994,981,981
San Joaquin,34,2022-08-07,1563,1571,1570,1,15721,15803,15795,8,61,6,6,7,2300,2300,2294,2294
San Luis Obispo,34,2022-08-07,545,546,546,0,3716,3735,3734,1,15,0,0,0,514,514,514,514
San Mateo,34,2022-08-07,1499,1507,1507,0,18344,18440,18434,6,56,0,0,3,730,730,730,730
Santa Barbara,34,2022-08-07,994,1000,1000,0,7573,7613,7610,3,36,2,2,1,717,717,715,715
Santa Clara,34,2022-08-07,4194,4217,4216,1,40176,40386,40380,6,206,19,19,37,2457,2457,2438,2438
Santa Cruz,34,2022-08-07,662,664,664,0,6043,6075,6073,2,24,1,1,0,270,270,269,269
Shasta,34,2022-08-07,192,192,192,0,2907,2923,2922,1,32,1,1,3,582,582,581,581
Siskiyou,34,2022-08-07,55,55,55,0,283,284,283,1,0,1,1,0,88,88,87,87
Solano,34,2022-08-07,910,915,915,0,8016,8058,8055,3,52,0,0,10,453,453,453,453
Sonoma,34,2022-08-07,862,867,867,0,7803,7843,7840,3,40,3,3,2,512,512,509,509
Stanislaus,34,2022-08-07,1070,1077,1076,1,7258,7295,7290,5,92,7,7,11,1749,1749,1742,1742
Sutter,34,2022-08-07,231,231,231,0,1577,1584,1583,1,0,0,0,0,231,231,231,231
Tehama,34,2022-08-07,73,73,73,0,685,689,688,1,4,0,0,0,211,211,211,211
Trinity,34,2022-08-07,5,5,5,0,72,73,72,1,0,0,0,0,20,20,20,20
Tulare,34,2022-08-07,914,919,918,1,7414,7452,7447,5,41,5,5,3,1522,1522,1517,1517
Tuolumne,34,2022-08-07,124,124,124,0,1130,1136,1135,1,5,0,0,0,193,193,193,193
Ventura,34,2022-08-07,1543,1551,1551,0,16078,16162,16158,4,67,6,6,7,1547,1547,1541,1541
Yolo,34,2022-08-07,292,292,292,0,3822,3842,3841,1,6,0,0,1,335,335,335,335
Yuba,34,2022-08-07,147,147,147,0,1130,1136,1135,1,5,0,0,0,120,120,120,120
Alameda,35,2022-08-14,2655,2672,2671,1,33994,34199,34190,9,118,8,8,21,1994,1994,1986,1986
Amador,35,2022-08-14,45,45,45,0,810,817,816,1,3,0,0,0,89,89,89,89
Butte,35,2022-08-14,276,276,276,0,2366,2382,2381,1,18,0,0,2,454,454,454,454
Calaveras,35,2022-08-14,49,49,49,0,548,551,550,1,0,0,0,1,133,133,133,133
Colusa,35,2022-08-14,20,20,20,0,378,381,380,1,1,0,0,0,22,22,22,22
Contra Costa,35,2022-08-14,1877,1889,1888,1,19140,19254,19246,8,69,6,6,11,1417,1417,1411,1411
Del Norte,35,2022-08-14,53,53,53,0,496,500,499,1,3,1,1,1,54,54,53,53
El Dorado,35,2022-08-14,186,186,186,0,2295,2309,2308,1,6,0,0,3,229,229,229,229
Fresno,35,2022-08-14,1976,1988,1987,1,16762,16862,16855,7,165,9,9,17,2843,2843,2834,2834
Glenn,35,2022-08-14,14,14,14,0,239,241,240,1,2,0,0,0,42,42,42,42
Humboldt,35,2022-08-14,182,182,182,0,1629,1641,1640,1,12,0,0,2,155,155,155,155
Imperial,35,2022-08-14,379,379,379,0,3139,3157,3156,1,15,1,1,2,959,959,958,958
Inyo,35,2022-08-14,6,6,6,0,245,247,246,1,0,1,1,0,59,59,58,58
Kern,35,2022-08-14,1223,1230,1230,0,13460,13540,13536,4,69,8,8,11,2401,2401,2393,2393
Kings,35,2022-08-14,373,374,374,0,3229,3248,3247,1,8,0,0,1,454,454,454,454
Lake,35,2022-08-14,99,99,99,0,955,961,960,1,3,0,0,2,143,143,143,143
Lassen,35,2022-08-14,95,95,95,0,979,987,986,1,1,0,0,0,63,63,63,63
Los Angeles,35,2022-08-14,21705,21837,21835,2,289417,291147,291118,29,888,114,119,123,33044,33051,32930,32932
Madera,35,2022-08-14,297,297,297,0,2975,2993,2992,1,12,0,0,4,368,368,368,368
Marin,35,2022-08-14,301,301,301,0,4021,4045,4043,2,16,0,0,0,310,310,310,310
Mariposa,35,2022-08-14,12,12,12,0,204,205,204,1,0,0,0,0,29,29,29,29
Mendocino,35,2022-08-14,99,99,99,0,1030,1035,1034,1,6,0,0,2,136,136,136,136
Merced,35,2022-08-14,452,453,453,0,3374,3393,3392,1,11,3,3,3,852,852,849,849
Modoc,35,2022-08-14,4,4,4,0,19,20,19,1,0,0,0,0,9,9,9,9
Mono,35,2022-08-14,5,5,5,0,77,78,77,1,0,0,0,0,7,7,7,7
Monterey,35,2022-08-14,668,673,673,0,5766,5800,5796,4,36,0,0,0,760,760,760,760
Napa,35,2022-08-14,216,216,216,0,2370,2385,2384,1,12,0,0,0,156,156,156,156
Nevada,35,2022-08-14,98,98,98,0,1219,1226,1225,1,6,0,0,0,132,132,132,132
Orange,35,2022-08-14,4717,4746,4745,1,43955,44218,44208,10,261,34,34,38,7370,7370,7336,7336
Placer,35,2022-08-14,433,434,434,0,4468,4494,4492,2,62,2,2,11,656,656,654,654
Plumas,35,2022-08-14,16,16,16,0,176,177,176,1,0,0,0,0,13,13,13,13
Riverside,35,2022-08-14,4671,4699,4698,1,37466,37691,37679,12,141,11,11,18,6573,6573,6562,6562
Sacramento,35,2022-08-14,2352,2365,2364,1,25776,25930,25921,9,159,8,8,16,3253,3253,3245,3245
San Benito,35,2022-08-14,136,136,136,0,644,650,649,1,2,1,1,1,99,99,98,98
San Bernardino,35,2022-08-14,4676,4705,4704,1,43595,43855,43844,11,147,16,16,24,8005,8005,7989,7989
San Diego,35,2022-08-14,5866,5900,5899,1,59730,60089,60083,6,281,13,13,34,5461,5461,5448,5448
San Francisco,35,2022-08-14,1291,1299,1298,1,19304,19420,19407,13,100,14,14,13,1008,1008,994,994
San Joaquin,35,2022-08-14,1444,1453,1452,1,15021,15110,15104,6,60,9,9,8,2309,2309,2300,2300
San Luis Obispo,35,2022-08-14,356,357,357,0,3372,3392,3391,1,15,4,4,2,518,518,514,514
San Mateo,35,2022-08-14,1240,1247,1247,0,16959,17061,17057,4,50,0,0,5,730,730,730,730
Santa Barbara,35,2022-08-14,871,878,878,0,7206,7248,7246,2,47,2,2,3,719,719,717,717
Santa Clara,35,2022-08-14,3459,3479,3479,0,38397,38627,38623,4,203,6,6,24,2463,2463,2457,2457
Santa Cruz,35,2022-08-14,507,508,508,0,5996,6032,6030,2,24,2,2,1,272,272,270,270
Shasta,35,2022-08-14,192,192,192,0,2756,2773,2772,1,17,1,1,0,583,583,582,582
Siskiyou,35,2022-08-14,26,26,26,0,289,290,289,1,0,0,0,3,88,88,88,88
Solano,35,2022-08-14,672,676,676,0,7458,7503,7501,2,46,0,0,7,453,453,453,453
Sonoma,35,2022-08-14,631,636,636,0,7311,7354,7352,2,37,2,2,2,514,514,512,512
Stanislaus,35,2022-08-14,943,950,950,0,7425,7469,7465,4,93,7,7,12,1756,1756,1749,1749
Sutter,35,2022-08-14,189,189,189,0,1572,1582,1581,1,0,1,1,0,232,232,231,231
Tehama,35,2022-08-14,61,61,61,0,622,627,626,1,2,0,0,0,211,211,211,211
Trinity,35,2022-08-14,9,9,9,0,58,59,58,1,0,0,0,0,20,20,20,20
Tulare,35,2022-08-14,715,720,720,0,6999,7042,7038,4,26,2,2,3,1524,1524,1522,1522
Tuolumne,35,2022-08-14,105,105,105,0,996,1002,1001,1,1,0,0,0,193,193,193,193
Ventura,35,2022-08-14,1471,1478,1478,0,15469,15561,15558,3,72,4,4,8,1551,1551,1547,1547
Yolo,35,2022-08-14,264,264,264,0,3714,3737,3736,1,3,1,1,0,336,336,335,335
Yuba,35,2022-08-14,125,125,125,0,1091,1098,1097,1,6,0,0,0,120,120,120,120
Alameda,36,2022-08-21,2259,2276,2276,0,32152,32379,32373,6,111,8,8,21,2002,2002,1994,1994
Amador,36,2022-08-21,51,51,51,0,847,854,853,1,1,1,1,0,90,90,89,89
Butte,36,2022-08-21,221,221,221,0,2112,2128,2127,1,16,1,1,2,455,455,454,454
Calaveras,36,2022-08-21,39,39,39,0,541,547,546,1,2,0,0,0,133,133,133,133
Colusa,36,2022-08-21,10,10,10,0,380,384,383,1,0,0,0,0,22,22,22,22
Contra Costa,36,2022-08-21,1499,1511,1511,0,18581,18714,18708,6,48,6,6,13,1423,1423,1417,1417
Del Norte,36,2022-08-21,32,32,32,0,483,486,485,1,2,1,1,1,55,55,54,54
El Dorado,36,2022-08-21,145,145,145,0,2271,2287,2286,1,7,0,0,0,229,229,229,229
Fresno,36,2022-08-21,1598,1610,1610,0,15885,15997,15992,5,151,3,3,16,2846,2846,2843,2843
Glenn,36,2022-08-21,23,23,23,0,223,225,224,1,1,0,0,0,42,42,42,42
Humboldt,36,2022-08-21,152,152,152,0,1695,1708,1707,1,4,1,1,4,156,156,155,155
Imperial,36,2022-08-21,291,291,291,0,2878,2898,2897,1,10,0,0,0,959,959,959,959
Inyo,36,2022-08-21,15,15,15,0,252,254,253,1,0,0,0,0,59,59,59,59
Kern,36,2022-08-21,957,964,964,0,13423,13518,13515,3,63,4,4,13,2405,2405,2401,2401
Kings,36,2022-08-21,355,356,356,0,3474,3498,3497,1,5,1,1,1,455,455,454,454
Lake,36,2022-08-21,94,94,94,0,963,970,969,1,2,1,1,1,144,144,143,143
Lassen,36,2022-08-21,50,50,50,0,874,883,882,1,0,0,0,0,63,63,63,63
Los Angeles,36,2022-08-21,18690,18822,18821,1,273796,275728,275707,21,801,111,118,108,33155,33169,33044,33051
Madera,36,2022-08-21,303,303,303,0,2737,2756,2755,1,16,2,2,4,370,370,368,368
Marin,36,2022-08-21,245,245,245,0,3960,3988,3987,1,16,0,0,3,310,310,310,310
Mariposa,36,2022-08-21,13,13,13,0,174,175,174,1,0,0,0,0,29,29,29,29
Mendocino,36,2022-08-21,104,104,104,0,1102,1110,1109,1,3,0,0,3,136,136,136,136
Merced,36,2022-08-21,446,449,449,0,3634,3660,3659,1,11,4,4,1,856,856,852,852
Modoc,36,2022-08-21,6,6,6,0,27,28,27,1,0,0,0,0,9,9,9,9
Mono,36,2022-08-21,6,6,6,0,64,65,64,1,0,0,0,0,7,7,7,7
Monterey,36,2022-08-21,563,567,567,0,5642,5683,5680,3,25,0,0,3,760,760,760,760
Napa,36,2022-08-21,141,141,141,0,2006,2021,2020,1,3,1,1,1,157,157,156,156
Nevada,36,2022-08-21,89,89,89,0,1211,1220,1219,1,4,0,0,1,132,132,132,132
Orange,36,2022-08-21,3847,3874,3873,1,40464,40751,40744,7,220,19,19,33,7389,7389,7370,7370
Placer,36,2022-08-21,371,371,371,0,4342,4374,4373,1,55,1,1,14,657,657,656,656
Plumas,36,2022-08-21,15,15,15,0,174,175,174,1,0,0,0,0,13,13,13,13
Riverside,36,2022-08-21,4354,4384,4383,1,36972,37234,37225,9,150,12,12,16,6585,6585,6573,6573
Sacramento,36,2022-08-21,2184,2198,2197,1,24881,25057,25050,7,137,16,16,24,3269,3269,3253,3253
San Benito,36,2022-08-21,101,101,101,0,585,591,590,1,2,1,1,0,100,100,99,99
San Bernardino,36,2022-08-21,4582,4615,4614,1,42726,43029,43021,8,139,17,17,19,8022,8022,8005,8005
San Diego,36,2022-08-21,4826,4861,4861,0,57212,57617,57612,5,276,5,5,28,5466,5466,5461,5461
San Francisco,36,2022-08-21,1084,1091,1090,1,18509,18641,18631,10,86,14,14,12,1022,1022,1008,1008
San Joaquin,36,2022-08-21,1231,1239,1239,0,15383,15490,15486,4,54,0,0,8,2309,2309,2309,2309
San Luis Obispo,36,2022-08-21,263,263,263,0,3168,3190,3189,1,21,1,1,0,519,519,518,518
San Mateo,36,2022-08-21,1054,1061,1061,0,16775,16893,16890,3,39,0,0,2,730,730,730,730
Santa Barbara,36,2022-08-21,729,736,736,0,7335,7387,7385,2,42,1,1,4,720,720,719,719
Santa Clara,36,2022-08-21,3041,3062,3062,0,38802,39077,39074,3,178,10,10,23,2473,2473,2463,2463
Santa Cruz,36,2022-08-21,489,493,493,0,11472,11554,11552,2,15,1,1,2,273,273,272,272
Shasta,36,2022-08-21,175,175,175,0,2757,2777,2776,1,3,2,2,0,585,585,583,583
Siskiyou,36,2022-08-21,31,31,31,0,262,263,262,1,1,0,0,0,88,88,88,88
Solano,36,2022-08-21,575,580,580,0,7183,7233,7231,2,32,0,0,9,453,453,453,453
Sonoma,36,2022-08-21,596,601,601,0,7285,7337,7335,2,36,2,2,4,516,516,514,514
Stanislaus,36,2022-08-21,900,907,907,0,7620,7673,7670,3,83,7,7,14,1763,1763,1756,1756
Sutter,36,2022-08-21,198,198,198,0,1657,1669,1668,1,0,0,0,0,232,232,232,232
Tehama,36,2022-08-21,48,48,48,0,642,648,647,1,1,0,0,0,211,211,211,211
Trinity,36,2022-08-21,9,9,9,0,63,64,63,1,0,0,0,0,20,20,20,20
Tulare,36,2022-08-21,736,743,743,0,7220,7270,7267,3,31,3,3,1,1527,1527,1524,1524
Tuolumne,36,2022-08-21,107,107,107,0,1033,1041,1040,1,1,0,0,0,193,193,193,193
Ventura,36,2022-08-21,1328,1338,1338,0,14945,15050,15047,3,64,4,4,6,1555,1555,1551,1551
Yolo,36,2022-08-21,206,206,206,0,3414,3438,3437,1,7,1,1,0,337,337,336,336
Yuba,36,2022-08-21,127,127,127,0,1092,1101,1100,1,12,0,0,3,120,120,120,120
Alameda,37,2022-08-28,2065,2082,2082,0,33747,34025,34020,5,101,12,12,22,2014,2014,2002,2002
Amador,37,2022-08-28,46,46,46,0,788,796,795,1,4,1,1,0,91,91,90,90
Butte,37,2022-08-28,230,230,230,0,2157,2175,2174,1,22,0,0,2,455,455,455,455
Calaveras,37,2022-08-28,64,64,64,0,604,610,609,1,1,0,0,0,133,133,133,133
Colusa,37,2022-08-28,14,14,14,0,375,378,377,1,0,0,0,0,22,22,22,22
Contra Costa,37,2022-08-28,1392,1404,1404,0,18774,18930,18925,5,48,4,4,7,1427,1427,1423,1423
Del Norte,37,2022-08-28,28,28,28,0,455,460,459,1,3,0,0,2,55,55,55,55
El Dorado,37,2022-08-28,145,145,145,0,2003,2021,2020,1,6,1,1,1,230,230,229,229
Fresno,37,2022-08-28,1427,1439,1439,0,15840,15971,15967,4,162,4,4,15,2850,2850,2846,2846
Glenn,37,2022-08-28,24,24,24,0,227,229,228,1,0,0,0,0,42,42,42,42
Humboldt,37,2022-08-28,122,122,122,0,1705,1720,1719,1,6,0,0,0,156,156,156,156
Imperial,37,2022-08-28,298,299,299,0,2891,2914,2913,1,0,1,1,0,960,960,959,959
Inyo,37,2022-08-28,6,6,6,0,189,190,189,1,0,0,0,0,59,59,59,59
Kern,37,2022-08-28,865,872,872,0,13440,13550,13548,2,57,2,2,9,2407,2407,2405,2405
Kings,37,2022-08-28,327,328,328,0,3623,3652,3651,1,5,0,0,0,455,455,455,455
Lake,37,2022-08-28,96,96,96,0,904,913,912,1,0,1,1,0,145,145,144,144
Lassen,37,2022-08-28,22,22,22,0,780,787,786,1,0,0,0,0,63,63,63,63
Los Angeles,37,2022-08-28,16025,16157,16156,1,273504,275751,275734,17,703,93,98,77,33248,33267,33155,33169
Madera,37,2022-08-28,295,295,295,0,2912,2935,2934,1,15,0,0,4,370,370,370,370
Marin,37,2022-08-28,227,227,227,0,3921,3953,3952,1,15,2,2,1,312,312,310,310
Mariposa,37,2022-08-28,18,18,18,0,190,191,190,1,0,0,0,0,29,29,29,29
Mendocino,37,2022-08-28,103,103,103,0,1005,1015,1014,1,2,0,0,2,136,136,136,136
Merced,37,2022-08-28,394,396,396,0,3552,3582,3581,1,9,3,3,1,859,859,856,856
Modoc,37,2022-08-28,2,2,2,0,28,29,28,1,0,0,0,0,9,9,9,9
Mono,37,2022-08-28,1,1,1,0,52,53,52,1,0,0,0,0,7,7,7,7
Monterey,37,2022-08-28,427,431,431,0,5587,5633,5631,2,30,3,3,3,763,763,760,760
Napa,37,2022-08-28,121,121,121,0,2080,2098,2097,1,7,0,0,2,157,157,157,157
Nevada,37,2022-08-28,104,104,104,0,1145,1154,1153,1,7,0,0,1,132,132,132,132
Orange,37,2022-08-28,3105,3130,3130,0,39548,39874,39868,6,199,18,18,26,7407,7407,7389,7389
Placer,37,2022-08-28,382,385,385,0,4196,4230,4229,1,60,1,1,10,658,658,657,657
Plumas,37,2022-08-28,22,22,22,0,175,176,175,1,0,0,0,0,13,13,13,13
Riverside,37,2022-08-28,3838,3868,3867,1,36761,37064,37057,7,105,8,8,13,6593,6593,6585,6585
Sacramento,37,2022-08-28,1891,1907,1907,0,24493,24694,24689,5,138,9,9,19,3278,3278,3269,3269
San Benito,37,2022-08-28,127,127,127,0,684,691,690,1,2,0,0,0,100,100,100,100
San Bernardino,37,2022-08-28,3839,3871,3870,1,41297,41637,41631,6,146,16,16,15,8038,8038,8022,8022
San Diego,37,2022-08-28,4029,4063,4063,0,56762,57228,57224,4,220,10,10,27,5476,5476,5466,5466
San Francisco,37,2022-08-28,905,913,913,0,18476,18629,18621,8,40,8,8,8,1030,1030,1022,1022
San Joaquin,37,2022-08-28,1006,1014,1014,0,14212,14328,14325,3,26,5,5,11,2314,2314,2309,2309
San Luis Obispo,37,2022-08-28,318,319,319,0,3248,3275,3274,1,16,1,1,0,520,520,519,519
San Mateo,37,2022-08-28,841,848,848,0,16366,16501,16499,2,27,0,0,3,730,730,730,730
Santa Barbara,37,2022-08-28,625,631,631,0,7594,7657,7656,1,21,1,1,4,721,721,720,720
Santa Clara,37,2022-08-28,2405,2425,2425,0,38358,38673,38670,3,123,4,4,21,2477,2477,2473,2473
Santa Cruz,37,2022-08-28,397,400,400,0,12011,12109,12107,2,16,0,0,0,273,273,273,273
Shasta,37,2022-08-28,131,131,131,0,2686,2707,2706,1,15,1,1,1,586,586,585,585
Siskiyou,37,2022-08-28,19,19,19,0,251,252,251,1,0,2,2,0,90,90,88,88
Solano,37,2022-08-28,530,536,536,0,7251,7310,7309,1,38,0,0,9,453,453,453,453
Sonoma,37,2022-08-28,504,509,509,0,7134,7192,7191,1,33,1,1,3,517,517,516,516
Stanislaus,37,2022-08-28,853,860,860,0,8099,8165,8163,2,75,5,5,3,1768,1768,1763,1763
Sutter,37,2022-08-28,175,175,175,0,1631,1647,1646,1,0,0,0,0,232,232,232,232
Tehama,37,2022-08-28,56,56,56,0,738,744,743,1,5,0,0,0,211,211,211,211
Trinity,37,2022-08-28,9,9,9,0,58,59,58,1,0,0,0,0,20,20,20,20
Tulare,37,2022-08-28,677,684,684,0,7334,7392,7390,2,36,1,1,1,1528,1528,1527,1527
Tuolumne,37,2022-08-28,100,100,100,0,871,879,878,1,2,0,0,0,193,193,193,193
Ventura,37,2022-08-28,1040,1048,1048,0,14838,14961,14959,2,48,3,3,3,1558,1558,1555,1555
Yolo,37,2022-08-28,193,193,193,0,3672,3703,3702,1,3,0,0,3,337,337,337,337
Yuba,37,2022-08-28,139,139,139,0,1142,1154,1153,1,17,0,0,1,120,120,120,120
Alameda,38,2022-09-04,1609,1623,1623,0,32534,32847,32843,4,92,5,5,17,2019,2019,2014,2014
Amador,38,2022-09-04,47,47,47,0,819,828,827,1,3,0,0,2,91,91,91,91
Butte,38,2022-09-04,221,221,221,0,2417,2441,2440,1,17,2,2,1,457,457,455,455
Calaveras,38,2022-09-04,27,27,27,0,523,529,528,1,0,0,0,0,133,133,133,133
Colusa,38,2022-09-04,8,8,8,0,267,271,270,1,2,0,0,0,22,22,22,22
Contra Costa,38,2022-09-04,1056,1067,1067,0,17810,17982,17978,4,56,5,5,11,1432,1432,1427,1427
Del Norte,38,2022-09-04,12,12,12,0,372,377,376,1,2,0,0,1,55,55,55,55
El Dorado,38,2022-09-04,99,99,99,0,1844,1863,1862,1,2,0,0,1,230,230,230,230
Fresno,38,2022-09-04,1222,1234,1234,0,15052,15198,15195,3,167,10,10,12,2860,2860,2850,2850
Glenn,38,2022-09-04,13,13,13,0,203,205,204,1,1,0,0,0,42,42,42,42
Humboldt,38,2022-09-04,122,122,122,0,1509,1526,1525,1,12,0,0,2,156,156,156,156
Imperial,38,2022-09-04,257,257,257,0,2914,2942,2941,1,9,0,0,0,960,960,960,960
Inyo,38,2022-09-04,11,11,11,0,165,166,165,1,0,0,0,0,59,59,59,59
Kern,38,2022-09-04,753,761,761,0,12839,12962,12960,2,52,3,3,9,2410,2410,2407,2407
Kings,38,2022-09-04,272,275,275,0,3219,3250,3249,1,5,0,0,0,455,455,455,455
Lake,38,2022-09-04,68,68,68,0,788,797,796,1,3,2,2,0,147,147,145,145
Lassen,38,2022-09-04,27,27,27,0,752,760,759,1,0,0,0,0,63,63,63,63
Los Angeles,38,2022-09-04,12354,12475,12474,1,259554,262047,262035,12,668,88,94,95,33336,33361,33248,33267
Madera,38,2022-09-04,239,239,239,0,3030,3060,3059,1,11,0,0,5,370,370,370,370
Marin,38,2022-09-04,193,193,193,0,3769,3805,3804,1,11,0,0,1,312,312,312,312
Mariposa,38,2022-09-04,16,16,16,0,195,196,195,1,0,0,0,0,29,29,29,29
Mendocino,38,2022-09-04,64,64,64,0,989,1000,999,1,2,1,1,2,137,137,136,136
Merced,38,2022-09-04,292,294,294,0,3121,3152,3151,1,11,1,1,1,860,860,859,859
Modoc,38,2022-09-04,3,3,3,0,23,24,23,1,0,0,0,0,9,9,9,9
Mono,38,2022-09-04,5,5,5,0,53,54,53,1,0,0,0,0,7,7,7,7
Monterey,38,2022-09-04,273,274,274,0,5089,5138,5136,2,18,2,2,1,765,765,763,763
Napa,38,2022-09-04,119,119,119,0,2127,2150,2149,1,3,1,1,2,158,158,157,157
Nevada,38,2022-09-04,93,93,93,0,1173,1187,1186,1,3,0,0,0,132,132,132,132
Orange,38,2022-09-04,2440,2463,2463,0,36602,36954,36950,4,172,13,13,37,7420,7420,7407,7407
Placer,38,2022-09-04,246,246,246,0,3902,3940,3939,1,42,0,0,7,658,658,658,658
Plumas,38,2022-09-04,10,10,10,0,157,158,157,1,0,0,0,0,13,13,13,13
Riverside,38,2022-09-04,2834,2861,2861,0,33527,33849,33844,5,81,8,8,8,6601,6601,6593,6593
Sacramento,38,2022-09-04,1457,1472,1472,0,22592,22810,22806,4,133,13,13,22,3291,3291,3278,3278
San Benito,38,2022-09-04,72,72,72,0,611,618,617,1,0,0,0,2,100,100,100,100
San Bernardino,38,2022-09-04,2760,2785,2785,0,38339,38709,38704,5,121,13,13,18,8051,8051,8038,8038
San Diego,38,2022-09-04,3311,3344,3344,0,55251,55784,55781,3,211,12,12,27,5488,5488,5476,5476
San Francisco,38,2022-09-04,743,750,750,0,17580,17749,17743,6,50,10,10,11,1040,1040,1030,1030
San Joaquin,38,2022-09-04,930,939,939,0,13276,13403,13401,2,43,5,5,10,2319,2319,2314,2314
San Luis Obispo,38,2022-09-04,206,206,206,0,3149,3181,3180,1,8,4,4,0,524,524,520,520
San Mateo,38,2022-09-04,703,710,710,0,15551,15701,15699,2,21,0,0,3,730,730,730,730
Santa Barbara,38,2022-09-04,560,565,565,0,7590,7664,7663,1,37,2,2,3,723,723,721,721
Santa Clara,38,2022-09-04,2096,2117,2117,0,37040,37397,37395,2,117,9,9,20,2486,2486,2477,2477
Santa Cruz,38,2022-09-04,361,364,364,0,14031,14165,14163,2,14,0,0,1,273,273,273,273
Shasta,38,2022-09-04,125,125,125,0,2457,2482,2481,1,16,0,0,0,586,586,586,586
Siskiyou,38,2022-09-04,33,33,33,0,242,243,242,1,0,0,0,0,90,90,90,90
Solano,38,2022-09-04,440,445,445,0,7189,7258,7257,1,34,2,2,9,455,455,453,453
Sonoma,38,2022-09-04,423,428,428,0,7092,7160,7159,1,34,0,0,2,517,517,517,517
Stanislaus,38,2022-09-04,633,638,638,0,7436,7508,7506,2,66,7,7,5,1775,1775,1768,1768
Sutter,38,2022-09-04,126,126,126,0,1620,1636,1635,1,0,0,0,0,232,232,232,232
Tehama,38,2022-09-04,62,62,62,0,728,736,735,1,3,1,1,0,212,212,211,211
Trinity,38,2022-09-04,4,4,4,0,56,57,56,1,0,0,0,0,20,20,20,20
Tulare,38,2022-09-04,486,491,491,0,6527,6589,6587,2,33,2,2,1,1530,1530,1528,1528
Tuolumne,38,2022-09-04,59,59,59,0,823,833,832,1,2,0,0,0,193,193,193,193
Ventura,38,2022-09-04,955,964,964,0,14151,14287,14286,1,42,8,8,2,1566,1566,1558,1558
Yolo,38,2022-09-04,173,173,173,0,3184,3216,3215,1,4,3,3,0,340,340,337,337
Yuba,38,2022-09-04,102,102,102,0,1130,1142,1141,1,17,0,0,1,120,120,120,120
Alameda,39,2022-09-11,1478,1495,1495,0,28131,28444,28441,3,85,2,2,18,2021,2021,2019,2019
Amador,39,2022-09-11,29,29,29,0,780,790,789,1,3,0,0,2,91,91,91,91
Butte,39,2022-09-11,177,177,177,0,2257,2283,2282,1,15,2,2,1,459,459,457,457
Calaveras,39,2022-09-11,13,13,13,0,455,461,460,1,0,0,0,0,133,133,133,133
Colusa,39,2022-09-11,16,16,16,0,300,303,302,1,2,0,0,0,22,22,22,22
Contra Costa,39,2022-09-11,903,913,913,0,15598,15772,15770,2,45,6,6,12,1438,1438,1432,1432
Del Norte,39,2022-09-11,29,29,29,0,523,529,528,1,2,0,0,1,55,55,55,55
El Dorado,39,2022-09-11,100,100,100,0,1729,1749,1748,1,2,0,0,1,230,230,230,230
Fresno,39,2022-09-11,892,901,901,0,13363,13512,13510,2,143,4,4,13,2864,2864,2860,2860
Glenn,39,2022-09-11,13,13,13,0,196,198,197,1,1,0,0,0,42,42,42,42
Humboldt,39,2022-09-11,98,98,98,0,1416,1433,1432,1,7,1,1,5,157,157,156,156
Imperial,39,2022-09-11,241,243,243,0,2923,2957,2956,1,17,0,0,0,960,960,960,960
Inyo,39,2022-09-11,14,14,14,0,187,189,188,1,1,0,0,0,59,59,59,59
Kern,39,2022-09-11,611,618,618,0,11234,11359,11358,1,44,5,5,10,2415,2415,2410,2410
Kings,39,2022-09-11,205,206,206,0,2827,2859,2858,1,5,1,1,0,456,456,455,455
Lake,39,2022-09-11,39,39,39,0,751,761,760,1,5,0,0,0,147,147,147,147
Lassen,39,2022-09-11,17,17,17,0,774,783,782,1,0,0,0,0,63,63,63,63
Los Angeles,39,2022-09-11,10133,10246,10246,0,244611,247330,247321,9,626,93,100,87,33429,33461,33336,33361
Madera,39,2022-09-11,219,221,221,0,2684,2716,2715,1,8,0,0,3,370,370,370,370
Marin,39,2022-09-11,170,170,170,0,3619,3659,3658,1,12,2,2,0,314,314,312,312
Mariposa,39,2022-09-11,12,12,12,0,186,188,187,1,0,0,0,0,29,29,29,29
Mendocino,39,2022-09-11,46,46,46,0,850,861,860,1,3,0,0,1,137,137,137,137
Merced,39,2022-09-11,218,219,219,0,2788,2820,2819,1,9,3,3,1,863,863,860,860
Modoc,39,2022-09-11,2,2,2,0,18,19,18,1,0,0,0,0,9,9,9,9
Mono,39,2022-09-11,4,4,4,0,65,66,65,1,0,0,0,0,7,7,7,7
Monterey,39,2022-09-11,221,222,222,0,4379,4428,4427,1,23,2,2,1,767,767,765,765
Napa,39,2022-09-11,105,105,105,0,1850,1872,1871,1,9,0,0,0,158,158,158,158
Nevada,39,2022-09-11,55,55,55,0,997,1010,1009,1,3,0,0,0,132,132,132,132
Orange,39,2022-09-11,1940,1961,1961,0,32648,33011,33008,3,155,22,22,24,7442,7442,7420,7420
Placer,39,2022-09-11,237,238,238,0,3694,3736,3735,1,40,0,0,7,658,658,658,658
Plumas,39,2022-09-11,18,18,18,0,152,154,153,1,0,0,0,0,13,13,13,13
Riverside,39,2022-09-11,2137,2161,2161,0,28363,28679,28676,3,117,5,5,10,6606,6606,6601,6601
Sacramento,39,2022-09-11,1167,1180,1180,0,20489,20717,20714,3,125,14,14,15,3305,3305,3291,3291
San Benito,39,2022-09-11,86,86,86,0,508,514,513,1,2,0,0,1,100,100,100,100
San Bernardino,39,2022-09-11,1731,1751,1751,0,32808,33173,33170,3,98,13,13,21,8064,8064,8051,8051
San Diego,39,2022-09-11,2733,2765,2765,0,49409,49960,49958,2,174,5,5,26,5493,5493,5488,5488
San Francisco,39,2022-09-11,721,729,729,0,15123,15291,15287,4,59,7,7,13,1047,1047,1040,1040
San Joaquin,39,2022-09-11,652,660,660,0,12240,12375,12373,2,31,5,5,11,2324,2324,2319,2319
San Luis Obispo,39,2022-09-11,158,159,159,0,2835,2867,2866,1,9,0,0,1,524,524,524,524
San Mateo,39,2022-09-11,587,594,594,0,12265,12402,12401,1,19,0,0,1,730,730,730,730
Santa Barbara,39,2022-09-11,327,330,330,0,6666,6740,6739,1,27,2,2,2,725,725,723,723
Santa Clara,39,2022-09-11,1780,1800,1800,0,33141,33510,33509,1,144,4,4,27,2490,2490,2486,2486
Santa Cruz,39,2022-09-11,252,254,254,0,10367,10482,10481,1,11,0,0,1,273,273,273,273
Shasta,39,2022-09-11,149,150,150,0,2259,2286,2285,1,21,0,0,1,586,586,586,586
Siskiyou,39,2022-09-11,29,29,29,0,265,269,268,1,2,0,0,1,90,90,90,90
Solano,39,2022-09-11,351,355,355,0,5685,5748,5747,1,26,0,0,6,455,455,455,455
Sonoma,39,2022-09-11,348,352,352,0,6063,6131,6130,1,41,3,3,1,520,520,517,517
Stanislaus,39,2022-09-11,435,440,440,0,6854,6930,6929,1,69,1,1,5,1776,1776,1775,1775
Sutter,39,2022-09-11,112,112,112,0,1421,1437,1436,1,0,0,0,0,232,232,232,232
Tehama,39,2022-09-11,41,41,41,0,592,598,597,1,2,0,0,0,212,212,212,212
Trinity,39,2022-09-11,2,2,2,0,60,61,60,1,0,0,0,0,20,20,20,20
Tulare,39,2022-09-11,348,352,352,0,5909,5975,5974,1,40,3,3,0,1533,1533,1530,1530
Tuolumne,39,2022-09-11,65,65,65,0,767,777,776,1,2,0,0,1,193,193,193,193
Ventura,39,2022-09-11,771,780,780,0,13099,13243,13242,1,48,1,1,5,1567,1567,1566,1566
Yolo,39,2022-09-11,124,124,124,0,2646,2676,2675,1,3,1,1,2,341,341,340,340
Yuba,39,2022-09-11,88,88,88,0,1033,1046,1045,1,6,0,0,0,120,120,120,120
Alameda,40,2022-09-18,1284,1300,1300,0,28894,29255,29253,2,78,6,6,7,2027,2027,2021,2021
Amador,40,2022-09-18,34,34,34,0,786,798,797,1,1,3,3,1,94,94,91,91
Butte,40,2022-09-18,133,133,133,0,2159,2189,2188,1,14,0,0,1,459,459,459,459
Calaveras,40,2022-09-18,25,25,25,0,486,492,491,1,0,0,0,0,133,133,133,133
Colusa,40,2022-09-18,13,13,13,0,313,316,315,1,2,0,0,0,22,22,22,22
Contra Costa,40,2022-09-18,828,839,839,0,16620,16828,16826,2,56,6,6,6,1444,1444,1438,1438
Del Norte,40,2022-09-18,20,20,20,0,507,515,514,1,1,0,0,0,55,55,55,55
El Dorado,40,2022-09-18,77,77,77,0,1652,1674,1673,1,3,0,0,0,230,230,230,230
Fresno,40,2022-09-18,603,611,611,0,13635,13805,13803,2,111,10,10,13,2874,2874,2864,2864
Glenn,40,2022-09-18,12,12,12,0,208,210,209,1,1,0,0,0,42,42,42,42
Humboldt,40,2022-09-18,105,105,105,0,1548,1568,1567,1,7,0,0,2,157,157,157,157
Imperial,40,2022-09-18,170,171,171,0,2967,3004,3003,1,12,0,0,0,960,960,960,960
Inyo,40,2022-09-18,7,7,7,0,174,177,176,1,0,1,1,0,60,60,59,59
Kern,40,2022-09-18,468,474,474,0,11834,11980,11979,1,33,5,5,8,2420,2420,2415,2415
Kings,40,2022-09-18,155,155,155,0,2775,2811,2810,1,5,2,2,0,458,458,456,456
Lake,40,2022-09-18,43,43,43,0,888,900,899,1,0,0,0,0,147,147,147,147
Lassen,40,2022-09-18,8,8,8,0,741,751,750,1,0,0,0,0,63,63,63,63
Los Angeles,40,2022-09-18,8675,8784,8784,0,254476,257646,257639,7,529,66,73,78,33495,33534,33429,33461
Madera,40,2022-09-18,114,114,114,0,2737,2772,2771,1,10,1,1,2,371,371,370,370
Marin,40,2022-09-18,141,141,141,0,3694,3741,3740,1,8,0,0,0,314,314,314,314
Mariposa,40,2022-09-18,12,12,12,0,172,173,172,1,0,0,0,0,29,29,29,29
Mendocino,40,2022-09-18,42,42,42,0,949,962,961,1,2,0,0,2,137,137,137,137
Merced,40,2022-09-18,174,174,174,0,2856,2893,2892,1,5,2,2,1,865,865,863,863
Modoc,40,2022-09-18,1,1,1,0,17,18,17,1,0,0,0,0,9,9,9,9
Mono,40,2022-09-18,7,7,7,0,71,72,71,1,0,0,0,0,7,7,7,7
Monterey,40,2022-09-18,159,159,159,0,4411,4465,4464,1,16,0,0,2,767,767,767,767
Napa,40,2022-09-18,103,103,103,0,1862,1887,1886,1,6,0,0,1,158,158,158,158
Nevada,40,2022-09-18,60,60,60,0,1092,1107,1106,1,1,0,0,0,132,132,132,132
Orange,40,2022-09-18,1708,1730,1730,0,33800,34223,34221,2,137,18,19,20,7460,7461,7442,7442
Placer,40,2022-09-18,216,216,216,0,3922,3973,3972,1,56,1,1,4,659,659,658,658
Plumas,40,2022-09-18,22,22,22,0,188,190,189,1,1,0,0,0,13,13,13,13
Riverside,40,2022-09-18,1453,1471,1471,0,29060,29423,29420,3,84,5,5,13,6611,6611,6606,6606
Sacramento,40,2022-09-18,1030,1042,1042,0,21742,22013,22011,2,113,8,8,16,3313,3313,3305,3305
San Benito,40,2022-09-18,57,57,57,0,535,542,541,1,0,0,0,0,100,100,100,100
San Bernardino,40,2022-09-18,1534,1553,1553,0,31914,32312,32310,2,80,7,7,25,8071,8071,8064,8064
San Diego,40,2022-09-18,2629,2662,2662,0,55672,56368,56366,2,179,8,8,21,5501,5501,5493,5493
San Francisco,40,2022-09-18,680,688,688,0,16078,16280,16277,3,45,9,9,8,1056,1056,1047,1047
San Joaquin,40,2022-09-18,468,473,473,0,12941,13102,13101,1,32,4,4,4,2328,2328,2324,2324
San Luis Obispo,40,2022-09-18,159,159,159,0,2869,2906,2905,1,7,0,0,1,524,524,524,524
San Mateo,40,2022-09-18,584,591,591,0,13088,13252,13251,1,14,0,0,0,730,730,730,730
Santa Barbara,40,2022-09-18,256,257,257,0,6877,6963,6962,1,29,2,2,0,727,727,725,725
Santa Clara,40,2022-09-18,1460,1478,1478,0,35584,36027,36026,1,139,6,6,20,2496,2496,2490,2490
Santa Cruz,40,2022-09-18,153,153,153,0,12123,12274,12273,1,7,0,0,0,273,273,273,273
Shasta,40,2022-09-18,107,107,107,0,2112,2139,2138,1,20,1,1,3,587,587,586,586
Siskiyou,40,2022-09-18,20,20,20,0,238,243,242,1,1,1,1,1,91,91,90,90
Solano,40,2022-09-18,298,302,302,0,6218,6295,6294,1,24,0,0,4,455,455,455,455
Sonoma,40,2022-09-18,322,326,326,0,6460,6541,6540,1,27,2,2,3,522,522,520,520
Stanislaus,40,2022-09-18,343,348,348,0,6536,6618,6617,1,59,3,3,7,1779,1779,1776,1776
Sutter,40,2022-09-18,83,83,83,0,1407,1426,1425,1,0,0,0,0,232,232,232,232
Tehama,40,2022-09-18,39,39,39,0,598,606,605,1,2,1,1,0,213,213,212,212
Trinity,40,2022-09-18,3,3,3,0,63,64,63,1,0,0,0,0,20,20,20,20
Tulare,40,2022-09-18,223,225,225,0,5922,5995,5994,1,30,2,2,1,1535,1535,1533,1533
Tuolumne,40,2022-09-18,56,56,56,0,729,740,739,1,0,0,0,0,193,193,193,193
Ventura,40,2022-09-18,624,632,632,0,13705,13875,13874,1,41,2,2,7,1569,1569,1567,1567
Yolo,40,2022-09-18,95,95,95,0,3714,3760,3759,1,3,1,1,1,342,342,341,341
Yuba,40,2022-09-18,59,59,59,0,1061,1076,1075,1,4,0,0,1,120,120,120,120
Alameda,41,2022-09-25,1110,1125,1125,0,27490,27881,27879,2,76,3,3,5,2030,2030,2027,2027
Amador,41,2022-09-25,28,28,28,0,727,739,738,1,1,0,0,1,94,94,94,94
Butte,41,2022-09-25,84,84,84,0,1803,1830,1829,1,28,0,0,1,459,459,459,459
Calaveras,41,2022-09-25,22,22,22,0,383,389,388,1,2,1,1,1,134,134,133,133
Colusa,41,2022-09-25,6,6,6,0,286,290,289,1,1,0,0,0,22,22,22,22
Contra Costa,41,2022-09-25,750,761,761,0,16299,16532,16530,2,45,5,5,9,1449,1449,1444,1444
Del Norte,41,2022-09-25,22,22,22,0,463,471,470,1,1,0,0,0,55,55,55,55
El Dorado,41,2022-09-25,84,84,84,0,1519,1541,1540,1,6,0,0,0,230,230,230,230
Fresno,41,2022-09-25,500,507,507,0,11812,11980,11979,1,90,3,3,11,2877,2877,2874,2874
Glenn,41,2022-09-25,12,12,12,0,175,177,176,1,1,0,0,0,42,42,42,42
Humboldt,41,2022-09-25,98,98,98,0,1318,1338,1337,1,8,1,1,0,158,158,157,157
Imperial,41,2022-09-25,112,112,112,0,2657,2696,2695,1,6,0,0,0,960,960,960,960
Inyo,41,2022-09-25,4,4,4,0,168,171,170,1,0,0,0,0,60,60,60,60
Kern,41,2022-09-25,341,346,346,0,10871,11026,11025,1,33,2,2,8,2422,2422,2420,2420
Kings,41,2022-09-25,105,105,105,0,2587,2624,2623,1,2,1,1,0,459,459,458,458
Lake,41,2022-09-25,24,24,24,0,807,820,819,1,0,0,0,0,147,147,147,147
Lassen,41,2022-09-25,16,16,16,0,571,582,581,1,0,0,0,0,63,63,63,63
Los Angeles,41,2022-09-25,7739,7849,7849,0,243326,246771,246766,5,439,58,65,60,33553,33599,33495,33534
Madera,41,2022-09-25,89,89,89,0,2253,2286,2285,1,9,0,0,2,371,371,371,371
Marin,41,2022-09-25,153,153,153,0,3603,3655,3654,1,7,0,0,0,314,314,314,314
Mariposa,41,2022-09-25,4,4,4,0,159,160,159,1,0,1,1,0,30,30,29,29
Mendocino,41,2022-09-25,29,29,29,0,836,850,849,1,2,0,0,0,137,137,137,137
Merced,41,2022-09-25,123,123,123,0,2763,2803,2802,1,8,2,2,0,867,867,865,865
Modoc,41,2022-09-25,1,1,1,0,15,16,15,1,0,0,0,0,9,9,9,9
Mono,41,2022-09-25,1,1,1,0,64,65,64,1,0,0,0,0,7,7,7,7
Monterey,41,2022-09-25,139,139,139,0,3967,4024,4023,1,16,1,1,2,768,768,767,767
Napa,41,2022-09-25,81,81,81,0,1904,1932,1931,1,3,0,0,1,158,158,158,158
Nevada,41,2022-09-25,47,47,47,0,1101,1118,1117,1,3,0,0,0,132,132,132,132
Orange,41,2022-09-25,1622,1645,1645,0,30951,31391,31389,2,116,14,16,21,7474,7477,7460,7461
Placer,41,2022-09-25,190,190,190,0,3479,3528,3527,1,46,0,0,4,659,659,659,659
Plumas,41,2022-09-25,21,21,21,0,154,156,155,1,1,0,0,0,13,13,13,13
Riverside,41,2022-09-25,1281,1300,1300,0,25404,25765,25763,2,58,6,6,15,6617,6617,6611,6611
Sacramento,41,2022-09-25,928,941,941,0,19135,19406,19405,1,108,11,11,20,3324,3324,3313,3313
San Benito,41,2022-09-25,41,41,41,0,485,492,491,1,0,1,1,2,101,101,100,100
San Bernardino,41,2022-09-25,1199,1216,1216,0,26731,27110,27108,2,71,4,4,15,8075,8075,8071,8071
San Diego,41,2022-09-25,2506,2541,2541,0,51541,52272,52271,1,192,7,7,22,5508,5508,5501,5501
San Francisco,41,2022-09-25,656,665,665,0,15586,15810,15808,2,42,4,4,7,1060,1060,1056,1056
San Joaquin,41,2022-09-25,391,397,397,0,10863,11016,11015,1,38,2,2,2,2330,2330,2328,2328
San Luis Obispo,41,2022-09-25,112,112,112,0,2479,2515,2514,1,6,0,0,1,524,524,524,524
San Mateo,41,2022-09-25,555,562,562,0,12795,12976,12975,1,29,0,0,0,730,730,730,730
Santa Barbara,41,2022-09-25,243,247,247,0,6385,6477,6476,1,23,2,2,0,729,729,727,727
Santa Clara,41,2022-09-25,1360,1379,1379,0,35135,35635,35634,1,115,9,9,17,2505,2505,2496,2496
Santa Cruz,41,2022-09-25,203,205,205,0,12825,13005,13004,1,11,0,0,1,273,273,273,273
Shasta,41,2022-09-25,75,75,75,0,1804,1830,1829,1,15,0,0,5,587,587,587,587
Siskiyou,41,2022-09-25,19,19,19,0,195,198,197,1,1,1,1,2,92,92,91,91
Solano,41,2022-09-25,293,298,298,0,5655,5737,5736,1,25,1,1,2,456,456,455,455
Sonoma,41,2022-09-25,286,290,290,0,6310,6401,6400,1,25,1,1,3,523,523,522,522
Stanislaus,41,2022-09-25,260,264,264,0,5772,5855,5854,1,42,2,2,6,1781,1781,1779,1779
Sutter,41,2022-09-25,66,66,66,0,1153,1170,1169,1,0,0,0,0,232,232,232,232
Tehama,41,2022-09-25,35,35,35,0,588,596,595,1,1,2,2,0,215,215,213,213
Trinity,41,2022-09-25,3,3,3,0,41,42,41,1,0,0,0,0,20,20,20,20
Tulare,41,2022-09-25,178,179,179,0,5163,5235,5234,1,17,1,1,2,1536,1536,1535,1535
Tuolumne,41,2022-09-25,47,47,47,0,676,687,686,1,1,0,0,0,193,193,193,193
Ventura,41,2022-09-25,542,549,549,0,12020,12190,12189,1,33,5,5,3,1574,1574,1569,1569
Yolo,41,2022-09-25,113,113,113,0,3785,3840,3839,1,2,5,5,2,347,347,342,342
Yuba,41,2022-09-25,46,46,46,0,929,944,943,1,6,0,0,0,120,120,120,120
Alameda,42,2022-10-02,1111,1130,1130,0,26312,26742,26741,1,49,2,2,4,2032,2032,2030,2030
Amador,42,2022-10-02,16,16,16,0,684,696,695,1,0,0,0,0,94,94,94,94
Butte,42,2022-10-02,77,77,77,0,1803,1833,1832,1,11,1,1,3,460,460,459,459
Calaveras,42,2022-10-02,18,18,18,0,357,364,363,1,1,0,0,0,134,134,134,134
Colusa,42,2022-10-02,7,7,7,0,277,282,281,1,0,0,0,0,22,22,22,22
Contra Costa,42,2022-10-02,740,753,753,0,15615,15872,15871,1,32,4,4,9,1453,1453,1449,1449
Del Norte,42,2022-10-02,13,13,13,0,404,411,410,1,1,0,0,1,55,55,55,55
El Dorado,42,2022-10-02,69,69,69,0,1422,1446,1445,1,5,0,0,1,230,230,230,230
Fresno,42,2022-10-02,507,516,516,0,11622,11812,11811,1,79,2,2,10,2879,2879,2877,2877
Glenn,42,2022-10-02,3,3,3,0,166,168,167,1,0,0,0,0,42,42,42,42
Humboldt,42,2022-10-02,70,70,70,0,1189,1209,1208,1,6,1,1,0,159,159,158,158
Imperial,42,2022-10-02,125,125,125,0,2502,2544,2543,1,7,0,0,0,960,960,960,960
Inyo,42,2022-10-02,8,8,8,0,150,152,151,1,0,0,0,1,60,60,60,60
Kern,42,2022-10-02,287,291,291,0,10151,10318,10317,1,27,0,0,7,2422,2422,2422,2422
Kings,42,2022-10-02,90,90,90,0,2491,2532,2531,1,2,0,0,0,459,459,459,459
Lake,42,2022-10-02,32,32,32,0,784,799,798,1,2,0,0,0,147,147,147,147
Lassen,42,2022-10-02,7,7,7,0,617,629,628,1,0,0,0,0,63,63,63,63
Los Angeles,42,2022-10-02,7215,7334,7334,0,225610,229291,229287,4,436,53,62,68,33606,33661,33553,33599
Madera,42,2022-10-02,69,69,69,0,1613,1642,1641,1,7,0,0,2,371,371,371,371
Marin,42,2022-10-02,194,195,195,0,3586,3645,3644,1,5,0,0,2,314,314,314,314
Mariposa,42,2022-10-02,5,5,5,0,138,139,138,1,0,0,0,0,30,30,30,30
Mendocino,42,2022-10-02,46,46,46,0,805,819,818,1,2,0,0,0,137,137,137,137
Merced,42,2022-10-02,95,95,95,0,2781,2828,2827,1,5,2,2,0,869,869,867,867
Modoc,42,2022-10-02,2,2,2,0,10,11,10,1,0,0,0,0,9,9,9,9
Mono,42,2022-10-02,4,4,4,0,61,62,61,1,0,0,0,0,7,7,7,7
Monterey,42,2022-10-02,115,115,115,0,3844,3908,3907,1,9,0,0,1,768,768,768,768
Napa,42,2022-10-02,95,95,95,0,1747,1776,1775,1,6,0,0,2,158,158,158,158
Nevada,42,2022-10-02,53,53,53,0,980,996,995,1,1,0,0,4,132,132,132,132
Orange,42,2022-10-02,1544,1570,1570,0,27934,28391,28390,1,132,20,22,19,7494,7499,7474,7477
Placer,42,2022-10-02,181,184,184,0,3132,3185,3184,1,43,3,3,3,662,662,659,659
Plumas,42,2022-10-02,14,14,14,0,122,124,123,1,2,0,0,0,13,13,13,13
Riverside,42,2022-10-02,1163,1182,1182,0,22149,22512,22511,1,56,3,3,10,6620,6620,6617,6617
Sacramento,42,2022-10-02,815,827,827,0,18020,18316,18315,1,87,10,11,19,3334,3335,3324,3324
San Benito,42,2022-10-02,39,39,39,0,459,467,466,1,0,0,0,0,101,101,101,101
San Bernardino,42,2022-10-02,1187,1207,1207,0,23829,24220,24219,1,70,1,1,11,8076,8076,8075,8075
San Diego,42,2022-10-02,2158,2193,2193,0,46209,46965,46964,1,151,8,8,19,5516,5516,5508,5508
San Francisco,42,2022-10-02,595,605,605,0,14768,15010,15008,2,43,3,3,10,1063,1063,1060,1060
San Joaquin,42,2022-10-02,348,355,355,0,9630,9789,9788,1,30,4,4,3,2334,2334,2330,2330
San Luis Obispo,42,2022-10-02,141,142,142,0,2369,2409,2408,1,2,0,0,2,524,524,524,524
San Mateo,42,2022-10-02,543,551,551,0,11907,12103,12102,1,26,0,0,2,730,730,730,730
Santa Barbara,42,2022-10-02,257,263,263,0,6230,6333,6332,1,12,0,0,3,729,729,729,729
Santa Clara,42,2022-10-02,1420,1444,1444,0,31992,32516,32515,1,105,5,5,18,2510,2510,2505,2505
Santa Cruz,42,2022-10-02,229,234,234,0,11188,11370,11369,1,12,0,0,2,273,273,273,273
Shasta,42,2022-10-02,49,49,49,0,1503,1527,1526,1,12,0,0,2,587,587,587,587
Siskiyou,42,2022-10-02,12,12,12,0,198,201,200,1,1,0,0,1,92,92,92,92
Solano,42,2022-10-02,248,253,253,0,5344,5432,5431,1,19,0,0,2,456,456,456,456
Sonoma,42,2022-10-02,325,331,331,0,6093,6194,6193,1,21,0,0,2,523,523,523,523
Stanislaus,42,2022-10-02,213,216,216,0,5505,5597,5596,1,54,0,0,3,1781,1781,1781,1781
Sutter,42,2022-10-02,62,62,62,0,1134,1152,1151,1,0,0,0,0,232,232,232,232
Tehama,42,2022-10-02,23,23,23,0,540,550,549,1,0,0,0,1,215,215,215,215
Trinity,42,2022-10-02,1,1,1,0,46,47,46,1,0,0,0,0,20,20,20,20
Tulare,42,2022-10-02,160,161,161,0,4954,5035,5034,1,20,3,3,2,1539,1539,1536,1536
Tuolumne,42,2022-10-02,24,24,24,0,670,681,680,1,1,0,0,0,193,193,193,193
Ventura,42,2022-10-02,484,492,492,0,10335,10506,10505,1,33,0,0,4,1574,1574,1574,1574
Yolo,42,2022-10-02,137,137,137,0,3193,3245,3244,1,4,2,2,1,349,349,347,347
Yuba,42,2022-10-02,33,33,33,0,835,850,849,1,6,0,0,0,120,120,120,120
Alameda,43,2022-10-09,1015,1035,1035,0,23851,24318,24317,1,42,3,3,13,2035,2035,2032,2032
Amador,43,2022-10-09,11,11,11,0,670,684,683,1,0,0,0,2,94,94,94,94
Butte,43,2022-10-09,62,62,62,0,1662,1694,1693,1,11,0,0,1,460,460,460,460
Calaveras,43,2022-10-09,13,13,13,0,311,319,318,1,0,1,1,0,135,135,134,134
Colusa,43,2022-10-09,4,4,4,0,104,105,104,1,0,0,0,0,22,22,22,22
Contra Costa,43,2022-10-09,621,635,635,0,14702,14991,14990,1,31,3,4,6,1456,1457,1453,1453
Del Norte,43,2022-10-09,11,11,11,0,386,394,393,1,0,0,0,1,55,55,55,55
El Dorado,43,2022-10-09,62,62,62,0,1328,1355,1354,1,5,0,0,1,230,230,230,230
Fresno,43,2022-10-09,365,372,372,0,10430,10635,10634,1,57,3,4,7,2882,2883,2879,2879
Glenn,43,2022-10-09,7,7,7,0,138,140,139,1,0,0,0,0,42,42,42,42
Humboldt,43,2022-10-09,83,83,83,0,1222,1248,1247,1,8,1,1,0,160,160,159,159
Imperial,43,2022-10-09,167,170,170,0,2533,2583,2582,1,7,0,0,0,960,960,960,960
Inyo,43,2022-10-09,3,3,3,0,114,115,114,1,0,0,0,0,60,60,60,60
Kern,43,2022-10-09,291,298,298,0,10087,10285,10284,1,24,0,0,2,2422,2422,2422,2422
Kings,43,2022-10-09,84,84,84,0,2371,2417,2416,1,0,0,0,1,459,459,459,459
Lake,43,2022-10-09,25,25,25,0,721,736,735,1,1,0,0,0,147,147,147,147
Lassen,43,2022-10-09,4,4,4,0,458,467,466,1,1,0,0,0,63,63,63,63
Los Angeles,43,2022-10-09,5843,5958,5958,0,191567,195290,195287,3,433,53,67,48,33659,33728,33606,33661
Madera,43,2022-10-09,53,53,53,0,1485,1515,1514,1,6,0,0,2,371,371,371,371
Marin,43,2022-10-09,171,174,174,0,3195,3258,3257,1,5,0,0,0,314,314,314,314
Mariposa,43,2022-10-09,4,4,4,0,117,119,118,1,0,0,0,0,30,30,30,30
Mendocino,43,2022-10-09,23,23,23,0,817,834,833,1,2,0,0,2,137,137,137,137
Merced,43,2022-10-09,97,97,97,0,2259,2305,2304,1,8,0,0,1,869,869,869,869
Modoc,43,2022-10-09,5,5,5,0,16,17,16,1,0,0,0,0,9,9,9,9
Mono,43,2022-10-09,1,1,1,0,58,59,58,1,0,0,0,0,7,7,7,7
Monterey,43,2022-10-09,89,89,89,0,3658,3732,3731,1,9,1,1,1,769,769,768,768
Napa,43,2022-10-09,61,61,61,0,1580,1612,1611,1,2,0,0,1,158,158,158,158
Nevada,43,2022-10-09,29,29,29,0,890,907,906,1,1,0,0,1,132,132,132,132
Orange,43,2022-10-09,1291,1316,1316,0,25542,26040,26039,1,125,10,12,17,7504,7511,7494,7499
Placer,43,2022-10-09,141,142,142,0,3015,3075,3074,1,25,0,0,6,662,662,662,662
Plumas,43,2022-10-09,20,20,20,0,95,96,95,1,0,0,0,0,13,13,13,13
Riverside,43,2022-10-09,978,998,998,0,20297,20694,20693,1,58,3,3,7,6623,6623,6620,6620
Sacramento,43,2022-10-09,742,757,757,0,16689,17015,17014,1,73,5,6,16,3339,3341,3334,3335
San Benito,43,2022-10-09,35,35,35,0,405,414,413,1,3,0,0,0,101,101,101,101
San Bernardino,43,2022-10-09,1005,1025,1025,0,22205,22638,22637,1,63,0,0,11,8076,8076,8076,8076
San Diego,43,2022-10-09,1782,1817,1817,0,44986,45862,45861,1,122,2,2,20,5518,5518,5516,5516
San Francisco,43,2022-10-09,568,579,579,0,13794,14065,14064,1,47,2,2,7,1065,1065,1063,1063
San Joaquin,43,2022-10-09,342,349,349,0,9594,9782,9781,1,19,0,0,6,2334,2334,2334,2334
San Luis Obispo,43,2022-10-09,105,106,106,0,2223,2267,2266,1,4,1,1,0,525,525,524,524
San Mateo,43,2022-10-09,540,550,550,0,11269,11490,11489,1,22,0,0,0,730,730,730,730
Santa Barbara,43,2022-10-09,215,222,222,0,6609,6738,6737,1,19,1,1,2,730,730,729,729
Santa Clara,43,2022-10-09,1203,1227,1227,0,27724,28267,28266,1,110,1,1,17,2511,2511,2510,2510
Santa Cruz,43,2022-10-09,245,251,251,0,10670,10877,10876,1,9,0,0,1,273,273,273,273
Shasta,43,2022-10-09,61,61,61,0,1168,1192,1191,1,18,3,4,1,590,591,587,587
Siskiyou,43,2022-10-09,10,10,10,0,180,186,185,1,1,1,1,1,93,93,92,92
Solano,43,2022-10-09,278,284,284,0,5225,5327,5326,1,23,0,0,4,456,456,456,456
Sonoma,43,2022-10-09,241,247,247,0,5607,5717,5716,1,18,0,0,1,523,523,523,523
Stanislaus,43,2022-10-09,185,190,190,0,5154,5255,5254,1,54,0,0,7,1781,1781,1781,1781
Sutter,43,2022-10-09,44,44,44,0,973,994,993,1,0,0,0,0,232,232,232,232
Tehama,43,2022-10-09,21,21,21,0,466,477,476,1,0,0,0,0,215,215,215,215
Trinity,43,2022-10-09,1,1,1,0,48,49,48,1,0,0,0,0,20,20,20,20
Tulare,43,2022-10-09,140,141,141,0,4498,4586,4585,1,10,1,1,2,1540,1540,1539,1539
Tuolumne,43,2022-10-09,27,27,27,0,561,573,572,1,1,0,0,0,193,193,193,193
Ventura,43,2022-10-09,406,413,413,0,9897,10091,10090,1,36,3,3,3,1577,1577,1574,1574
Yolo,43,2022-10-09,90,90,90,0,2792,2848,2847,1,2,1,1,0,350,350,349,349
Yuba,43,2022-10-09,25,25,25,0,779,795,794,1,0,0,0,1,120,120,120,120
Alameda,44,2022-10-16,1035,1060,1060,0,27590,28266,28265,1,57,4,6,12,2039,2041,2035,2035
Amador,44,2022-10-16,15,15,15,0,728,747,746,1,1,0,0,0,94,94,94,94
Butte,44,2022-10-16,72,72,72,0,1548,1587,1586,1,13,0,0,0,460,460,460,460
Calaveras,44,2022-10-16,23,23,23,0,347,355,354,1,0,0,0,0,135,135,135,135
Colusa,44,2022-10-16,3,3,3,0,92,93,92,1,1,0,0,0,22,22,22,22
Contra Costa,44,2022-10-16,745,763,763,0,16445,16849,16848,1,25,5,7,5,1459,1461,1454,1454
Del Norte,44,2022-10-16,10,10,10,0,481,494,493,1,1,0,0,0,55,55,55,55
El Dorado,44,2022-10-16,70,70,70,0,1642,1682,1681,1,1,0,0,1,230,230,230,230
Fresno,44,2022-10-16,437,447,447,0,11263,11541,11540,1,58,0,0,13,2882,2883,2882,2883
Glenn,44,2022-10-16,10,10,10,0,225,230,229,1,1,0,0,0,42,42,42,42
Humboldt,44,2022-10-16,77,77,77,0,1293,1326,1325,1,1,0,0,0,160,160,160,160
Imperial,44,2022-10-16,141,144,144,0,2712,2780,2779,1,5,0,0,0,960,960,960,960
Inyo,44,2022-10-16,4,4,4,0,137,140,139,1,1,0,0,0,60,60,60,60
Kern,44,2022-10-16,238,245,245,0,11120,11391,11390,1,27,0,0,3,2422,2422,2422,2422
Kings,44,2022-10-16,93,93,93,0,2700,2766,2765,1,1,0,0,1,459,459,459,459
Lake,44,2022-10-16,34,34,34,0,931,954,953,1,1,0,0,0,147,147,147,147
Lassen,44,2022-10-16,6,6,6,0,579,595,594,1,1,0,0,0,63,63,63,63
Los Angeles,44,2022-10-16,5992,6140,6140,0,221518,226886,226883,3,355,40,55,55,33692,33774,33652,33719
Madera,44,2022-10-16,62,62,62,0,1626,1666,1665,1,3,0,0,2,371,371,371,371
Marin,44,2022-10-16,174,177,177,0,3591,3680,3679,1,6,0,0,1,314,314,314,314
Mariposa,44,2022-10-16,8,8,8,0,133,136,135,1,0,0,0,0,30,30,30,30
Mendocino,44,2022-10-16,48,48,48,0,874,896,895,1,2,0,0,1,137,137,137,137
Merced,44,2022-10-16,139,141,141,0,2767,2835,2834,1,11,0,0,3,869,869,869,869
Modoc,44,2022-10-16,1,1,1,0,7,8,7,1,0,0,0,0,9,9,9,9
Mono,44,2022-10-16,5,5,5,0,47,48,47,1,0,0,0,0,7,7,7,7
Monterey,44,2022-10-16,121,122,122,0,4108,4210,4209,1,18,1,2,1,770,771,769,769
Napa,44,2022-10-16,76,76,76,0,1637,1677,1676,1,2,0,0,1,158,158,158,158
Nevada,44,2022-10-16,52,52,52,0,925,950,949,1,4,0,0,0,132,132,132,132
Orange,44,2022-10-16,1309,1341,1341,0,28371,29064,29063,1,101,14,20,20,7516,7528,7502,7508
Placer,44,2022-10-16,120,121,121,0,3293,3374,3373,1,39,0,0,3,662,662,662,662
Plumas,44,2022-10-16,11,11,11,0,112,113,112,1,0,0,0,0,13,13,13,13
Riverside,44,2022-10-16,1067,1094,1094,0,22678,23234,23233,1,57,2,3,6,6625,6626,6623,6623
Sacramento,44,2022-10-16,922,944,944,0,18954,19417,19416,1,72,4,5,16,3343,3346,3339,3341
San Benito,44,2022-10-16,26,26,26,0,419,431,430,1,0,1,1,0,102,102,101,101
San Bernardino,44,2022-10-16,954,976,976,0,25269,25886,25885,1,70,0,0,8,8076,8076,8076,8076
San Diego,44,2022-10-16,1861,1906,1906,0,50709,51948,51947,1,129,12,17,20,5528,5532,5516,5515
San Francisco,44,2022-10-16,590,604,604,0,15185,15559,15558,1,39,2,3,10,1067,1068,1065,1065
San Joaquin,44,2022-10-16,423,433,433,0,10710,10972,10971,1,13,1,1,5,2335,2335,2334,2334
San Luis Obispo,44,2022-10-16,90,91,91,0,2460,2520,2519,1,6,0,0,0,525,525,525,525
San Mateo,44,2022-10-16,629,643,643,0,13103,13423,13422,1,21,0,0,1,730,730,730,730
Santa Barbara,44,2022-10-16,212,218,218,0,6856,7025,7024,1,16,0,0,3,730,730,730,730
Santa Clara,44,2022-10-16,1344,1379,1379,0,33543,34362,34361,1,100,2,3,14,2513,2514,2511,2511
Santa Cruz,44,2022-10-16,325,333,333,0,11416,11692,11691,1,7,1,2,1,274,275,273,273
Shasta,44,2022-10-16,105,107,107,0,1360,1394,1393,1,9,0,0,3,590,591,590,591
Siskiyou,44,2022-10-16,9,9,9,0,254,261,260,1,3,1,2,1,94,95,93,93
Solano,44,2022-10-16,318,325,325,0,5841,5985,5984,1,24,4,4,3,459,459,455,455
Sonoma,44,2022-10-16,278,286,286,0,6563,6723,6722,1,21,1,1,1,524,524,523,523
Stanislaus,44,2022-10-16,237,244,244,0,6046,6194,6193,1,47,0,0,6,1781,1781,1781,1781
Sutter,44,2022-10-16,54,54,54,0,1022,1049,1048,1,0,0,0,0,232,232,232,232
Tehama,44,2022-10-16,20,20,20,0,521,534,533,1,0,0,0,0,215,215,215,215
Trinity,44,2022-10-16,0,0,0,0,39,40,39,1,0,0,0,0,20,20,20,20
Tulare,44,2022-10-16,156,160,160,0,4919,5040,5039,1,11,1,1,1,1541,1541,1540,1540
Tuolumne,44,2022-10-16,48,48,48,0,706,724,723,1,1,0,0,0,193,193,193,193
Ventura,44,2022-10-16,385,394,394,0,10766,11030,11029,1,37,3,3,2,1579,1579,1576,1576
Yolo,44,2022-10-16,130,133,133,0,2565,2628,2627,1,3,2,2,3,352,352,350,350
Yuba,44,2022-10-16,42,42,42,0,885,907,906,1,1,0,0,0,120,120,120,120
Alameda,45,2022-10-23,861,892,892,0,22535,23306,23305,1,47,2,4,10,2041,2045,2039,2041
Amador,45,2022-10-23,17,17,17,0,621,642,641,1,1,0,0,0,94,94,94,94
Butte,45,2022-10-23,72,73,73,0,1383,1432,1431,1,7,1,2,1,461,462,460,460
Calaveras,45,2022-10-23,15,15,15,0,335,348,347,1,0,0,0,0,135,135,135,135
Colusa,45,2022-10-23,4,4,4,0,96,100,99,1,0,0,0,0,22,22,22,22
Contra Costa,45,2022-10-23,623,646,646,0,13839,14313,14312,1,25,1,2,7,1460,1463,1459,1461
Del Norte,45,2022-10-23,6,6,6,0,360,373,372,1,0,0,0,0,55,55,55,55
El Dorado,45,2022-10-23,76,77,77,0,1426,1476,1475,1,1,0,0,1,230,230,230,230
Fresno,45,2022-10-23,390,403,403,0,9673,10009,10008,1,62,0,0,3,2882,2883,2882,2883
Glenn,45,2022-10-23,8,8,8,0,144,148,147,1,0,0,0,0,42,42,42,42
Humboldt,45,2022-10-23,81,83,83,0,1182,1223,1222,1,8,0,0,2,160,160,160,160
Imperial,45,2022-10-23,108,111,111,0,2288,2366,2365,1,4,0,0,0,960,960,960,960
Inyo,45,2022-10-23,3,3,3,0,185,192,191,1,0,0,0,0,60,60,60,60
Kern,45,2022-10-23,237,244,244,0,9360,9680,9679,1,23,0,0,4,2422,2422,2422,2422
Kings,45,2022-10-23,80,82,82,0,2250,2328,2327,1,6,0,0,0,459,459,459,459
Lake,45,2022-10-23,26,26,26,0,698,722,721,1,1,0,0,1,147,147,147,147
Lassen,45,2022-10-23,14,14,14,0,506,524,523,1,0,0,0,0,63,63,63,63
Los Angeles,45,2022-10-23,4790,4956,4956,0,181080,187213,187211,2,354,25,51,49,33717,33825,33692,33774
Madera,45,2022-10-23,58,58,58,0,1359,1407,1406,1,1,0,0,2,371,371,371,371
Marin,45,2022-10-23,134,141,141,0,3186,3296,3295,1,8,0,0,3,314,314,314,314
Mariposa,45,2022-10-23,10,10,10,0,118,123,122,1,0,0,0,0,30,30,30,30
Mendocino,45,2022-10-23,38,38,38,0,773,799,798,1,2,0,0,0,137,137,137,137
Merced,45,2022-10-23,99,103,103,0,2281,2360,2359,1,8,1,2,2,870,871,869,869
Modoc,45,2022-10-23,1,1,1,0,14,15,14,1,0,0,0,0,9,9,9,9
Mono,45,2022-10-23,3,3,3,0,48,49,48,1,0,0,0,0,7,7,7,7
Monterey,45,2022-10-23,126,130,130,0,3732,3860,3859,1,14,0,0,0,770,771,770,771
Napa,45,2022-10-23,40,40,40,0,1452,1501,1500,1,0,0,0,0,158,158,158,158
Nevada,45,2022-10-23,25,25,25,0,705,730,729,1,3,0,0,0,132,132,132,132
Orange,45,2022-10-23,1093,1131,1131,0,24816,25666,25665,1,88,3,5,12,7519,7533,7516,7528
Placer,45,2022-10-23,140,146,146,0,2795,2893,2892,1,47,0,0,4,662,662,662,662
Plumas,45,2022-10-23,15,15,15,0,83,85,84,1,1,0,0,0,13,13,13,13
Riverside,45,2022-10-23,859,890,890,0,19079,19731,19730,1,49,0,0,7,6625,6626,6625,6626
Sacramento,45,2022-10-23,757,784,784,0,14700,15206,15205,1,74,2,4,19,3345,3350,3343,3346
San Benito,45,2022-10-23,35,35,35,0,427,442,441,1,0,0,0,0,102,102,102,102
San Bernardino,45,2022-10-23,786,812,812,0,19637,20309,20308,1,49,4,8,14,8080,8084,8076,8076
San Diego,45,2022-10-23,1575,1630,1630,0,41218,42624,42623,1,97,4,8,24,5532,5540,5528,5532
San Francisco,45,2022-10-23,450,464,464,0,13224,13679,13678,1,40,0,0,6,1067,1068,1067,1068
San Joaquin,45,2022-10-23,280,289,289,0,8261,8548,8547,1,21,0,0,4,2335,2335,2335,2335
San Luis Obispo,45,2022-10-23,93,95,95,0,2057,2129,2128,1,4,0,0,1,525,525,525,525
San Mateo,45,2022-10-23,457,473,473,0,10548,10907,10906,1,22,0,0,2,730,730,730,730
Santa Barbara,45,2022-10-23,144,151,151,0,5689,5884,5883,1,21,1,2,4,731,732,730,730
Santa Clara,45,2022-10-23,1122,1161,1161,0,27542,28485,28484,1,91,0,0,16,2513,2514,2513,2514
Santa Cruz,45,2022-10-23,267,277,277,0,11149,11522,11521,1,12,0,0,0,274,275,274,275
Shasta,45,2022-10-23,73,74,74,0,914,947,946,1,7,0,0,2,590,591,590,591
Siskiyou,45,2022-10-23,13,13,13,0,160,167,166,1,1,0,0,1,94,95,94,95
Solano,45,2022-10-23,227,234,234,0,4976,5146,5145,1,19,0,0,1,459,459,459,459
Sonoma,45,2022-10-23,234,241,241,0,5303,5486,5485,1,23,0,0,1,524,524,524,524
Stanislaus,45,2022-10-23,178,185,185,0,4847,5014,5013,1,43,0,0,3,1781,1781,1781,1781
Sutter,45,2022-10-23,27,27,27,0,874,906,905,1,0,0,0,0,232,232,232,232
Tehama,45,2022-10-23,33,33,33,0,361,374,373,1,1,0,0,0,215,215,215,215
Trinity,45,2022-10-23,1,1,1,0,36,37,36,1,0,0,0,0,20,20,20,20
Tulare,45,2022-10-23,107,111,111,0,4286,4430,4429,1,16,0,0,1,1541,1541,1541,1541
Tuolumne,45,2022-10-23,28,28,28,0,603,625,624,1,0,0,0,0,193,193,193,193
Ventura,45,2022-10-23,302,311,311,0,9001,9310,9309,1,34,3,6,3,1582,1585,1579,1579
Yolo,45,2022-10-23,82,83,83,0,2022,2092,2091,1,6,1,2,0,353,354,352,352
Yuba,45,2022-10-23,45,45,45,0,787,816,815,1,6,0,0,1,120,120,120,120
Alameda,46,2022-10-30,872,926,926,0,23002,24407,24406,1,50,2,6,5,2043,2051,2041,2045
Amador,46,2022-10-30,10,10,10,0,573,610,609,1,1,1,4,0,95,98,94,94
Butte,46,2022-10-30,59,62,62,0,1441,1532,1531,1,12,0,0,0,461,462,461,462
Calaveras,46,2022-10-30,13,13,13,0,249,266,265,1,0,0,0,0,135,135,135,135
Colusa,46,2022-10-30,9,9,9,0,97,103,102,1,0,0,0,0,22,22,22,22
Contra Costa,46,2022-10-30,587,624,624,0,13495,14330,14329,1,33,0,0,8,1460,1463,1460,1463
Del Norte,46,2022-10-30,15,15,15,0,346,367,366,1,1,0,0,0,55,55,55,55
El Dorado,46,2022-10-30,82,88,88,0,1327,1410,1409,1,2,0,0,0,230,230,230,230
Fresno,46,2022-10-30,323,343,343,0,9635,10239,10238,1,62,0,0,8,2882,2883,2882,2883
Glenn,46,2022-10-30,9,9,9,0,154,165,164,1,1,0,0,0,42,42,42,42
Humboldt,46,2022-10-30,38,39,39,0,1036,1100,1099,1,5,0,0,2,160,160,160,160
Imperial,46,2022-10-30,101,107,107,0,2554,2711,2710,1,11,0,0,0,960,960,960,960
Inyo,46,2022-10-30,6,6,6,0,317,337,336,1,0,0,0,0,60,60,60,60
Kern,46,2022-10-30,258,273,273,0,9292,9849,9848,1,18,0,0,3,2422,2422,2422,2422
Kings,46,2022-10-30,125,132,132,0,2409,2553,2552,1,3,0,0,1,459,459,459,459
Lake,46,2022-10-30,20,20,20,0,714,759,758,1,1,0,0,1,147,147,147,147
Lassen,46,2022-10-30,15,15,15,0,494,523,522,1,1,0,0,0,63,63,63,63
Los Angeles,46,2022-10-30,4701,4986,4986,0,160842,170007,170005,2,350,12,44,42,33729,33869,33717,33825
Madera,46,2022-10-30,47,50,50,0,1374,1463,1462,1,3,0,0,2,371,371,371,371
Marin,46,2022-10-30,115,122,122,0,3285,3490,3489,1,11,0,0,0,314,314,314,314
Mariposa,46,2022-10-30,10,10,10,0,127,135,134,1,0,0,0,0,30,30,30,30
Mendocino,46,2022-10-30,24,24,24,0,715,760,759,1,3,0,0,1,137,137,137,137
Merced,46,2022-10-30,75,81,81,0,1867,1979,1978,1,5,0,0,0,870,871,870,871
Modoc,46,2022-10-30,1,1,1,0,12,13,12,1,0,0,0,0,9,9,9,9
Mono,46,2022-10-30,1,1,1,0,88,94,93,1,0,0,0,1,7,7,7,7
Monterey,46,2022-10-30,95,101,101,0,3456,3669,3668,1,20,0,0,0,770,771,770,771
Napa,46,2022-10-30,45,46,46,0,1481,1572,1571,1,2,0,0,0,158,158,158,158
Nevada,46,2022-10-30,30,30,30,0,749,794,793,1,8,0,0,0,132,132,132,132
Orange,46,2022-10-30,1016,1079,1079,0,24662,26168,26167,1,97,1,3,16,7520,7536,7519,7533
Placer,46,2022-10-30,112,119,119,0,2688,2860,2859,1,38,0,0,7,662,662,662,662
Plumas,46,2022-10-30,5,5,5,0,72,77,76,1,0,0,0,0,13,13,13,13
Riverside,46,2022-10-30,761,809,809,0,17830,18913,18912,1,57,2,10,9,6627,6636,6625,6626
Sacramento,46,2022-10-30,672,714,714,0,13608,14446,14445,1,72,1,4,13,3346,3354,3345,3350
San Benito,46,2022-10-30,32,32,32,0,418,444,443,1,1,0,0,1,102,102,102,102
San Bernardino,46,2022-10-30,780,829,829,0,19026,20177,20176,1,56,0,0,16,8080,8084,8080,8084
San Diego,46,2022-10-30,1591,1689,1689,0,39941,42389,42388,1,115,0,0,19,5532,5540,5532,5540
San Francisco,46,2022-10-30,470,499,499,0,13690,14540,14539,1,42,0,0,4,1067,1068,1067,1068
San Joaquin,46,2022-10-30,278,295,295,0,7797,8271,8270,1,17,0,0,4,2335,2335,2335,2335
San Luis Obispo,46,2022-10-30,65,70,70,0,1870,1983,1982,1,4,0,0,0,525,525,525,525
San Mateo,46,2022-10-30,435,464,464,0,10982,11650,11649,1,31,0,0,0,730,730,730,730
Santa Barbara,46,2022-10-30,161,172,172,0,5747,6100,6099,1,25,1,3,7,732,735,731,732
Santa Clara,46,2022-10-30,1042,1108,1108,0,28781,30525,30524,1,95,0,0,16,2513,2514,2513,2514
Santa Cruz,46,2022-10-30,156,165,165,0,9408,9956,9955,1,10,0,0,0,274,275,274,275
Shasta,46,2022-10-30,45,47,47,0,811,861,860,1,5,0,0,0,590,591,590,591
Siskiyou,46,2022-10-30,14,14,14,0,208,222,221,1,1,0,0,1,94,95,94,95
Solano,46,2022-10-30,281,299,299,0,5125,5434,5433,1,21,0,0,3,459,459,459,459
Sonoma,46,2022-10-30,204,216,216,0,5627,5974,5973,1,25,0,0,3,524,524,524,524
Stanislaus,46,2022-10-30,200,212,212,0,4817,5113,5112,1,50,0,0,6,1781,1781,1781,1781
Sutter,46,2022-10-30,47,50,50,0,937,997,996,1,0,0,0,0,232,232,232,232
Tehama,46,2022-10-30,13,13,13,0,327,348,347,1,1,0,0,0,215,215,215,215
Trinity,46,2022-10-30,15,15,15,0,70,74,73,1,4,0,0,0,20,20,20,20
Tulare,46,2022-10-30,113,120,120,0,3802,4022,4021,1,11,0,0,1,1541,1541,1541,1541
Tuolumne,46,2022-10-30,16,16,16,0,536,569,568,1,3,0,0,0,193,193,193,193
Ventura,46,2022-10-30,281,298,298,0,8978,9528,9527,1,34,0,0,2,1582,1585,1582,1585
Yolo,46,2022-10-30,57,61,61,0,1788,1898,1897,1,3,0,0,1,353,354,353,354
Yuba,46,2022-10-30,39,39,39,0,770,819,818,1,2,0,0,0,120,120,120,120
Alameda,47,2022-10-31,101,113,113,0,1363,1528,1527,1,57,0,0,4,2043,2051,2043,2051
Amador,47,2022-10-31,3,3,3,0,26,30,29,1,2,0,0,0,95,98,95,98
Butte,47,2022-10-31,2,2,2,0,81,92,91,1,11,0,0,3,461,462,461,462
Calaveras,47,2022-10-31,1,1,1,0,42,48,47,1,0,0,0,0,135,135,135,135
Colusa,47,2022-10-31,0,0,0,0,4,5,4,1,0,0,0,0,22,22,22,22
Contra Costa,47,2022-10-31,70,78,78,0,819,919,918,1,37,0,0,7,1460,1463,1460,1463
Del Norte,47,2022-10-31,1,1,1,0,27,31,30,1,1,0,0,0,55,55,55,55
El Dorado,47,2022-10-31,4,4,4,0,88,100,99,1,2,0,0,0,230,230,230,230
Fresno,47,2022-10-31,28,31,31,0,547,614,613,1,57,0,0,8,2882,2883,2882,2883
Glenn,47,2022-10-31,1,1,1,0,6,8,7,1,1,0,0,0,42,42,42,42
Humboldt,47,2022-10-31,1,1,1,0,53,60,59,1,6,0,0,2,160,160,160,160
Imperial,47,2022-10-31,9,10,10,0,334,375,374,1,7,0,0,0,960,960,960,960
Inyo,47,2022-10-31,0,0,0,0,18,21,20,1,0,0,0,0,60,60,60,60
Kern,47,2022-10-31,13,15,15,0,231,260,259,1,20,0,0,2,2422,2422,2422,2422
Kings,47,2022-10-31,5,6,6,0,106,120,119,1,3,0,0,1,459,459,459,459
Lake,47,2022-10-31,4,4,4,0,76,86,85,1,1,0,0,1,147,147,147,147
Lassen,47,2022-10-31,1,1,1,0,8,10,9,1,1,0,0,0,63,63,63,63
Los Angeles,47,2022-10-31,52,58,58,0,458,514,513,1,344,0,0,44,33729,33869,33729,33869
Madera,47,2022-10-31,5,6,6,0,69,78,77,1,3,0,0,2,371,371,371,371
Marin,47,2022-10-31,12,13,13,0,152,171,170,1,10,0,0,1,314,314,314,314
Mariposa,47,2022-10-31,0,0,0,0,1,2,1,1,0,0,0,0,30,30,30,30
Mendocino,47,2022-10-31,0,0,0,0,78,88,87,1,1,0,0,2,137,137,137,137
Merced,47,2022-10-31,5,6,6,0,98,111,110,1,5,0,0,0,870,871,870,871
Modoc,47,2022-10-31,0,0,0,0,0,1,0,1,0,0,0,0,9,9,9,9
Mono,47,2022-10-31,0,0,0,0,12,14,13,1,1,0,0,0,7,7,7,7
Monterey,47,2022-10-31,3,3,3,0,213,240,239,1,18,0,0,0,770,771,770,771
Napa,47,2022-10-31,6,7,7,0,137,155,154,1,2,0,0,0,158,158,158,158
Nevada,47,2022-10-31,1,1,1,0,17,20,19,1,6,0,0,0,132,132,132,132
Orange,47,2022-10-31,45,50,50,0,1163,1304,1303,1,91,0,0,14,7520,7536,7520,7536
Placer,47,2022-10-31,5,6,6,0,158,178,177,1,40,0,0,5,662,662,662,662
Plumas,47,2022-10-31,1,1,1,0,11,13,12,1,0,0,0,0,13,13,13,13
Riverside,47,2022-10-31,74,83,83,0,707,793,792,1,64,0,0,5,6627,6636,6627,6636
Sacramento,47,2022-10-31,57,64,64,0,743,834,833,1,80,0,0,16,3346,3354,3346,3354
San Benito,47,2022-10-31,4,4,4,0,20,23,22,1,1,0,0,1,102,102,102,102
San Bernardino,47,2022-10-31,19,21,21,0,583,654,653,1,64,0,0,11,8080,8084,8080,8084
San Diego,47,2022-10-31,56,63,63,0,1751,1963,1962,1,109,0,0,13,5532,5540,5532,5540
San Francisco,47,2022-10-31,50,56,56,0,753,845,844,1,45,0,0,3,1067,1068,1067,1068
San Joaquin,47,2022-10-31,26,29,29,0,459,515,514,1,21,0,0,3,2335,2335,2335,2335
San Luis Obispo,47,2022-10-31,3,3,3,0,66,75,74,1,1,0,0,0,525,525,525,525
San Mateo,47,2022-10-31,36,40,40,0,716,803,802,1,30,0,0,2,730,730,730,730
Santa Barbara,47,2022-10-31,4,4,4,0,254,286,285,1,20,0,0,6,732,735,732,735
Santa Clara,47,2022-10-31,86,96,96,0,1213,1360,1359,1,85,0,0,16,2513,2514,2513,2514
Santa Cruz,47,2022-10-31,2,2,2,0,45,51,50,1,7,0,0,0,274,275,274,275
Shasta,47,2022-10-31,0,0,0,0,20,23,22,1,6,0,0,1,590,591,590,591
Siskiyou,47,2022-10-31,2,2,2,0,17,20,19,1,1,0,0,0,94,95,94,95
Solano,47,2022-10-31,41,46,46,0,506,568,567,1,16,0,0,4,459,459,459,459
Sonoma,47,2022-10-31,20,22,22,0,396,445,444,1,24,0,0,3,524,524,524,524
Stanislaus,47,2022-10-31,10,11,11,0,350,393,392,1,49,0,0,8,1781,1781,1781,1781
Sutter,47,2022-10-31,7,8,8,0,58,66,65,1,0,0,0,0,232,232,232,232
Tehama,47,2022-10-31,0,0,0,0,4,5,4,1,1,0,0,0,215,215,215,215
Trinity,47,2022-10-31,0,0,0,0,1,2,1,1,5,0,0,0,20,20,20,20
Tulare,47,2022-10-31,5,6,6,0,119,134,133,1,12,0,0,0,1541,1541,1541,1541
Tuolumne,47,2022-10-31,0,0,0,0,33,38,37,1,3,0,0,0,193,193,193,193
Ventura,47,2022-10-31,6,7,7,0,477,536,535,1,24,0,0,2,1582,1585,1582,1585
Yolo,47,2022-10-31,7,8,8,0,89,101,100,1,3,0,0,1,353,354,353,354
Yuba,47,2022-10-31,1,1,1,0,54,62,61,1,3,0,0,0,120,120,120,120
California,1,2021-12-19,69865,69899,38061,31838,2211535,2213194,1248230,964964,2585,501,501,938,77223,77223,76722,76722
California,2,2021-12-26,188838,188978,116115,72863,1841243,1842772,1102406,740366,3020,476,476,981,77699,77699,77223,77223
California,3,2022-01-02,484622,485056,321582,163474,2634377,2636853,1717959,918894,5523,559,559,1266,78258,78258,77699,77699
California,4,2022-01-09,862090,862972,611685,251287,4613325,4618135,3283311,1334824,9338,896,896,1710,79154,79154,78258,78258
California,5,2022-01-16,718877,719650,532860,186790,4343746,4348527,3274435,1074092,12024,1359,1359,2185,80513,80513,79154,79154
California,6,2022-01-23,536762,537370,417404,119966,3749384,3753780,2976865,776915,12602,1753,1753,2602,82266,82266,80513,80513
California,7,2022-01-30,301847,302195,243931,58264,3233127,3237069,2681562,555507,10901,1850,1850,2534,84116,84116,82266,82266
California,8,2022-02-06,165268,165450,138509,26941,2740094,2743528,2364657,378871,8494,1815,1815,2101,85931,85931,84116,84116
California,9,2022-02-13,95577,95666,82925,12741,2404478,2407589,2142749,264840,6560,1477,1477,1629,87408,87408,85931,85931
California,10,2022-02-20,55431,55478,49460,6018,2132222,2135053,1948199,186854,4672,1046,1046,1149,88454,88454,87408,87408
California,11,2022-02-27,32799,32817,30005,2812,1863774,1866322,1738914,127408,3416,722,722,817,89176,89176,88454,88454
California,12,2022-03-06,24281,24295,22635,1660,1843768,1846434,1745621,100813,2519,520,520,620,89696,89696,89176,89176
California,13,2022-03-13,17673,17682,16721,961,1742199,1744815,1669805,75010,1856,382,382,443,90078,90078,89696,89696
California,14,2022-03-20,14783,14791,14174,617,1665713,1668297,1612143,56154,1528,245,245,305,90323,90323,90078,90078
California,15,2022-03-27,15246,15253,14761,492,1546126,1548611,1507955,40656,1209,190,190,261,90513,90513,90323,90323
California,16,2022-04-03,16793,16800,16385,415,1470452,1472869,1442265,30604,907,142,142,223,90655,90655,90513,90513
California,17,2022-04-10,20842,20859,20459,400,1414857,1417251,1394748,22503,863,123,123,152,90778,90778,90655,90655
California,18,2022-04-17,24967,24989,24606,383,1030128,1031907,1016860,15047,818,115,115,145,90893,90893,90778,90778
California,19,2022-04-24,35664,35710,35282,428,1579375,1582184,1566919,15265,848,90,90,119,90983,90983,90893,90893
California,20,2022-05-01,46331,46398,45969,429,1706617,1709796,1696896,12900,904,87,87,148,91070,91070,90983,90983
California,21,2022-05-08,60827,60934,60488,446,1751028,1754466,1744003,10463,1017,81,81,173,91151,91151,91070,91070
California,22,2022-05-15,75692,75822,75376,446,1828451,1832224,1823610,8614,1218,117,117,191,91268,91268,91151,91151
California,23,2022-05-22,95640,95827,95391,436,1861263,1865298,1858391,6907,1562,113,113,239,91381,91381,91268,91268
California,24,2022-05-29,101175,101383,101028,355,1809073,1813181,1807946,5235,1913,137,137,251,91518,91518,91381,91381
California,25,2022-06-05,108109,108344,108051,293,1678217,1682247,1678545,3702,2186,132,132,275,91650,91650,91518,91518
California,26,2022-06-12,107683,107923,107689,234,1522265,1526114,1523376,2738,2419,179,179,297,91829,91829,91650,91650
California,27,2022-06-19,101517,101766,101597,169,1062099,1064970,1063251,1719,2486,195,195,295,92024,92024,91829,91829
California,28,2022-06-26,110995,111288,111147,141,1015966,1018928,1017648,1280,2913,216,216,318,92240,92240,92024,92024
California,29,2022-07-03,120418,120769,120650,119,977640,980709,979744,965,3102,248,248,394,92488,92488,92240,92240
California,30,2022-07-10,126409,126824,126731,93,932800,936040,935333,707,3670,282,282,456,92770,92770,92488,92488
California,31,2022-07-17,130459,130956,130880,76,989974,993868,993278,590,4015,280,280,513,93050,93050,92770,92770
California,32,2022-07-24,119544,120037,119986,51,958070,962198,961746,452,4145,322,322,497,93372,93372,93050,93050
California,33,2022-07-31,102490,102971,102935,36,883525,887822,887494,328,4021,369,369,518,93741,93741,93372,93372
California,34,2022-08-07,85725,86149,86128,21,819157,823455,823208,247,3693,312,314,473,94053,94055,93741,93741
California,35,2022-08-14,70803,71205,71193,12,788961,793695,793504,191,3335,291,296,439,94344,94351,94053,94055
California,36,2022-08-21,61604,62019,62013,6,765360,770788,770637,151,2987,262,269,418,94606,94620,94344,94351
California,37,2022-08-28,53044,53458,53455,3,762364,768646,768522,124,2614,221,226,330,94827,94846,94606,94620
California,38,2022-09-04,41825,42201,42200,1,724983,731986,731882,104,2451,232,238,352,95059,95084,94827,94846
California,39,2022-09-11,33449,33799,33799,0,652852,660139,660058,81,2341,207,214,338,95266,95298,95059,95084
California,40,2022-09-18,28154,28471,28471,0,683680,692235,692162,73,2035,183,191,284,95449,95489,95266,95298
California,41,2022-09-25,24995,25318,25318,0,637966,647046,646980,66,1811,156,165,253,95605,95654,95449,95489
California,42,2022-10-02,23478,23842,23842,0,588009,597653,597593,60,1635,127,139,254,95732,95793,95605,95654
California,43,2022-10-09,19945,20321,20321,0,529195,539544,539486,58,1515,99,119,220,95831,95912,95732,95793
California,44,2022-10-16,21356,21850,21850,0,601631,616317,616259,58,1423,101,138,226,95917,96030,95816,95892
California,45,2022-10-23,17368,17948,17948,0,497024,513995,513938,57,1347,48,96,211,95965,96126,95917,96030
California,46,2022-10-30,16587,17592,17592,0,471447,499595,499538,57,1423,20,74,203,95985,96200,95965,96126
California,47,2022-10-31,895,998,998,0,15830,17791,17735,56,1401,0,0,191,95985,96200,95985,96200
